ZL,UZ,UN/WA,MZ/MH,Vill,RMO,Administrative Unit Residence Community,Literate (can write a letter)-Both-Yes,Literate (can write a letter)-Both-No,Literate (can write a letter)-Male-Yes,Literate (can write a letter)-Male-No,Literate (can write a letter)-Female-Yes,Literate (can write a letter)-Female-No,Literacy Rate (%)-Both,Literacy Rate (%)-Male,Literacy Rate (%)-Female,check_var
47.0,12.0,35.0,052,01,01,  Patharghata,200,60,110,19,90,41,76.9,85.3,68.7,00000
47.0,12.0,35.0,052,02,01,  Baguladanga,72,52,41,20,31,32,58.1,67.2,49.2,00000
47.0,12.0,47.0,359,01,01,  Paschim Halia,471,459,268,196,203,263,50.6,57.8,43.6,00000
47.0,12.0,47.0,359,02,01,  Purba Halia,797,358,433,149,364,209,69.0,74.4,63.5,00000
47.0,12.0,47.0,359,03,01,  Chandmari,182,178,93,85,89,93,50.6,52.2,48.9,00000
47.0,12.0,47.0,710,01,01,  Naoailtala,605,555,298,280,307,275,52.2,51.6,52.7,00000
47.0,12.0,47.0,710,02,01,  Hajirabad,149,142,74,71,75,71,51.2,51.0,51.4,00000
47.0,12.0,59.0,127,01,01,  Barun Para,502,263,298,76,204,187,65.6,79.7,52.2,00000
47.0,12.0,59.0,127,02,01,  Mathbanga,71,65,45,21,26,44,52.2,68.2,37.1,00000
47.0,12.0,59.0,127,03,01,  Masiar Danga,165,97,100,30,65,67,63.0,76.9,49.2,00000
47.0,12.0,59.0,239,01,01,  Charkhali Machaila,156,163,92,73,64,90,48.9,55.8,41.6,00000
47.0,12.0,59.0,239,02,01,  Tengramari,188,103,112,30,76,73,64.6,78.9,51.0,00000
47.0,12.0,59.0,239,03,01,  Jharbhanga,96,50,51,19,45,31,65.8,72.9,59.2,00000
47.0,12.0,59.0,523,01,01,  Katamari,277,103,142,40,135,63,72.9,78.0,68.2,00000
47.0,12.0,59.0,523,02,01,  Gopalkhali,137,140,77,52,60,88,49.5,59.7,40.5,00000
47.0,12.0,59.0,523,03,01,  Deoatala,714,379,403,150,311,229,65.3,72.9,57.6,00000
47.0,12.0,59.0,546,01,01,  Katianangla,752,657,393,286,359,371,53.4,57.9,49.2,00000
47.0,12.0,59.0,546,02,01,  Amtala,686,452,367,189,319,263,60.3,66.0,54.8,00000
47.0,12.0,59.0,546,03,01,  Kodaldhoa,37,23,20,12,17,11,61.7,62.5,60.7,00000
47.0,12.0,59.0,546,04,01,  Gondhamari,148,98,85,31,63,67,60.2,73.3,48.5,00000
47.0,12.0,59.0,546,05,01,  Kanthaltala,90,58,51,20,39,38,60.8,71.8,50.6,00000
47.0,12.0,59.0,546,06,01,  Goalbari,159,61,84,21,75,40,72.3,80.0,65.2,00000
47.0,12.0,59.0,546,07,01,  Gangaram,204,94,108,32,96,62,68.5,77.1,60.8,00000
47.0,12.0,71.0,246,01,01,  Chhaygharia,764,467,439,180,325,287,62.1,70.9,53.1,00000
47.0,12.0,71.0,246,02,01,  Guptamari,250,49,141,17,109,32,83.6,89.2,77.3,00000
47.0,12.0,71.0,246,03,01,  Dauniafad,521,239,250,100,271,139,68.6,71.4,66.1,00000
47.0,12.0,71.0,246,04,01,  Chakrakhali,665,406,352,163,313,243,62.1,68.3,56.3,00000
47.0,12.0,71.0,246,05,01,  Badnakhali,174,175,89,79,85,96,49.9,53.0,47.0,00000
47.0,12.0,71.0,433,01,01,  Uttar Jalma,205,193,122,71,83,122,51.5,63.2,40.5,00000
47.0,12.0,71.0,433,02,01,  Kachubunia,205,70,111,30,94,40,74.5,78.7,70.1,00000
47.0,12.0,71.0,635,01,01,  Krishnanagar,2261,1731,1294,942,967,789,56.6,57.9,55.1,00000
47.0,12.0,71.0,635,02,01,  Mahammad Nagar,3678,1546,2209,750,1469,796,70.4,74.7,64.9,00000
47.0,12.0,71.0,635,03,01,  Saubjpalli,1506,706,791,333,715,373,68.1,70.4,65.7,00000
47.0,12.0,71.0,680,01,01,  Mathabhanga,469,579,242,266,227,313,44.8,47.6,42.0,00000
47.0,12.0,71.0,680,02,01,  Putimari,1240,1177,675,576,565,601,51.3,54.0,48.5,00000
47.0,12.0,71.0,800,01,01,  Uttar Raingamari,221,272,116,145,105,127,44.8,44.4,45.3,00000
47.0,12.0,71.0,800,02,01,  Dakshin Raingamari,113,58,60,21,53,37,66.1,74.1,58.9,00000
47.0,12.0,71.0,800,03,01,  Gajalmari,258,205,135,98,123,107,55.7,57.9,53.5,00000
47.0,12.0,71.0,800,04,01,  Joypur,151,158,83,71,68,87,48.9,53.9,43.9,00000
47.0,12.0,71.0,800,05,01,  Nabojalma,145,142,82,62,63,80,50.5,56.9,44.1,00000
47.0,12.0,71.0,800,06,01,  Santinagar,446,420,218,195,228,225,51.5,52.8,50.3,00000
47.0,12.0,71.0,815,01,01,  Rajbandh,1206,887,681,412,525,475,57.6,62.3,52.5,00000
47.0,12.0,71.0,815,02,01,  Joykhali,478,353,245,165,233,188,57.5,59.8,55.3,00000
47.0,12.0,71.0,815,03,01,  Ghola,642,505,352,229,290,276,56.0,60.6,51.2,00000
47.0,12.0,71.0,815,04,01,  Koiarbazar,329,329,166,139,163,190,50.0,54.4,46.2,00000
47.0,12.0,71.0,860,01,01,  Sanchibunia,1159,932,641,439,518,493,55.4,59.4,51.2,00000
47.0,12.0,71.0,860,02,01,  Nijkhamar,538,339,310,146,228,193,61.3,68.0,54.2,00000
47.0,12.0,71.0,860,03,01,  Chara,417,101,223,40,194,61,80.5,84.8,76.1,00000
47.0,12.0,71.0,860,04,01,  Hogladanga,513,443,273,221,240,222,53.7,55.3,51.9,00000
47.0,12.0,71.0,860,05,01,  Dargatala,247,204,136,84,111,120,54.8,61.8,48.1,00000
47.0,12.0,83.0,201,01,01,  Bunarabad,1003,810,558,333,445,477,55.3,62.6,48.3,00000
47.0,12.0,83.0,201,02,01,  Sankimari,83,65,52,27,31,38,56.1,65.8,44.9,00000
47.0,12.0,83.0,201,03,01,  Nailkhali,155,95,83,43,72,52,62.0,65.9,58.1,00000
47.0,12.0,83.0,314,01,01,  Gaonghara,557,652,285,287,272,365,46.1,49.8,42.7,00000
47.0,12.0,83.0,314,02,01,  Char Danga,95,303,51,148,44,155,23.9,25.6,22.1,00000
47.0,12.0,83.0,314,03,01,  Chandardanga,601,593,286,283,315,310,50.3,50.3,50.4,00000
47.0,12.0,83.0,314,04,01,  Gaonghara Uttar Para,670,909,348,419,322,490,42.4,45.4,39.7,00000
47.0,12.0,83.0,321,01,01,  Gariardanga,388,278,227,110,161,168,58.3,67.4,48.9,00000
47.0,12.0,83.0,321,02,01,  Hoglarbuna,297,209,167,83,130,126,58.7,66.8,50.8,00000
47.0,12.0,83.0,471,01,01,  Kalyansree,366,583,177,266,189,317,38.6,40.0,37.4,00000
47.0,12.0,83.0,471,02,01,  Chhatra Bil,264,363,141,166,123,197,42.1,45.9,38.4,00000
47.0,12.0,83.0,471,03,01,  Udarbanga,104,183,48,78,56,105,36.2,38.1,34.8,00000
47.0,12.0,83.0,807,01,01,  Roypur,475,545,262,236,213,309,46.6,52.6,40.8,00000
47.0,12.0,83.0,807,02,01,  Bhagabatipur,357,308,198,119,159,189,53.7,62.5,45.7,00000
47.0,17.0,10.0,039,01,01,  Paschim Bajua,1226,1046,706,468,520,578,54.0,60.1,47.4,00000
47.0,17.0,10.0,039,02,01,  Purba Bajua,2477,1974,1410,802,1067,1172,55.7,63.7,47.7,00000
47.0,17.0,10.0,039,03,01,  Bererkhali,322,303,180,148,142,155,51.5,54.9,47.8,00000
47.0,17.0,10.0,039,04,01,  Chand Para,289,226,156,107,133,119,56.1,59.3,52.8,00000
47.0,17.0,13.0,079,01,01,  Paschim Banishanta,288,331,155,147,133,184,46.5,51.3,42.0,00000
47.0,17.0,13.0,079,02,01,  Uttar Banishanta,439,459,243,199,196,260,48.9,55.0,43.0,00000
47.0,17.0,13.0,079,03,01,  Andhar Manik,200,217,111,93,89,124,48.0,54.4,41.8,00000
47.0,17.0,13.0,079,04,01,  Jharkhali,277,109,155,51,122,58,71.8,75.2,67.8,00000
47.0,17.0,13.0,079,05,01,  Kakra Bunia,279,359,147,172,132,187,43.7,46.1,41.4,00000
47.0,17.0,13.0,079,06,01,  Purba Amtala,442,916,264,428,178,488,32.5,38.2,26.7,00000
47.0,17.0,13.0,079,07,01,  Paschim Amtala,652,561,357,234,295,327,53.8,60.4,47.4,00000
47.0,17.0,13.0,079,08,01,  Dakshin Banishanta,691,566,374,256,317,310,55.0,59.4,50.6,00000
47.0,17.0,13.0,079,09,01,  Banishanta Bazar,85,236,42,124,43,112,26.5,25.3,27.7,00000
47.0,17.0,13.0,079,10,01,  Purba Banishanta(Pross),14,227,9,80,5,147,5.8,10.1,3.3,00000
47.0,17.0,13.0,079,11,01,  Purba Dangmari,581,550,324,250,257,300,51.4,56.4,46.1,00000
47.0,17.0,13.0,079,12,01,  Purba Bhojankhali,197,261,108,116,89,145,43.0,48.2,38.0,00000
47.0,17.0,13.0,079,13,01,  Paschim Bhojankhali,119,189,71,78,48,111,38.6,47.7,30.2,00000
47.0,17.0,13.0,079,14,01,  Purba Khejuria,615,581,330,268,285,313,51.4,55.2,47.7,00000
47.0,17.0,13.0,079,15,01,  Paschim Khejuria,590,558,338,231,252,327,51.4,59.4,43.5,00000
47.0,17.0,13.0,079,16,01,  Patikhata,192,109,114,36,78,73,63.8,76.0,51.7,00000
47.0,17.0,13.0,079,17,01,  Paschim Dangmari,499,563,301,237,198,326,47.0,55.9,37.8,00000
47.0,17.0,21.0,716,01,01,  Khuthakhali Bazar,704,428,356,183,348,245,62.2,66.0,58.7,00000
47.0,17.0,21.0,716,02,01,  Khuthakhali,1152,762,611,343,541,419,60.2,64.0,56.4,00000
47.0,17.0,21.0,716,03,01,  Laudubi Pasharer Dhar,510,474,299,202,211,272,51.8,59.7,43.7,00000
47.0,17.0,21.0,716,04,01,  Laudubi,959,513,544,201,415,312,65.1,73.0,57.1,00000
47.0,17.0,21.0,716,05,01,  Kalikabati,525,407,292,156,233,251,56.3,65.2,48.1,00000
47.0,17.0,21.0,716,06,01,  Barabak,441,390,238,172,203,218,53.1,58.0,48.2,00000
47.0,17.0,21.0,716,07,01,  Burir Dabar,127,309,77,134,50,175,29.1,36.5,22.2,00000
47.0,17.0,21.0,716,08,01,  Harintani,384,121,209,48,175,73,76.0,81.3,70.6,00000
47.0,17.0,42.0,278,01,01,  Dacope-2,834,325,460,116,374,209,72.0,79.9,64.2,00000
47.0,17.0,42.0,278,02,01,  Singjora,239,130,139,51,100,79,64.8,73.2,55.9,00000
47.0,17.0,42.0,278,03,01,  Madia,268,186,159,74,109,112,59.0,68.2,49.3,00000
47.0,17.0,42.0,278,04,01,  Chhota Bunia,336,121,193,24,143,97,73.5,88.9,59.6,00000
47.0,17.0,42.0,278,05,01,  Dakshin Dacope,219,178,118,76,101,102,55.2,60.8,49.8,00000
47.0,17.0,42.0,875,01,01,  Saheberabad,1642,796,911,287,731,509,67.4,76.0,59.0,00000
47.0,17.0,42.0,875,02,01,  Odabunia,325,256,191,107,134,149,55.9,64.1,47.3,00000
47.0,17.0,42.0,875,03,01,  Bhadla Bunia,170,91,103,34,67,57,65.1,75.2,54.0,00000
47.0,17.0,42.0,875,04,01,  Kakrabunia,178,122,97,50,81,72,59.3,66.0,52.9,00000
47.0,17.0,52.0,318,01,01,  Dhopadihi,1672,883,910,352,762,531,65.4,72.1,58.9,00000
47.0,17.0,52.0,318,02,01,  Ramnagar,1931,1068,1079,393,852,675,64.4,73.3,55.8,00000
47.0,17.0,63.0,915,01,01,  Channir Chak,369,98,210,21,159,77,79.0,90.9,67.4,00000
47.0,17.0,63.0,915,02,01,  Jaliakhali,381,308,236,121,145,187,55.3,66.1,43.7,00000
47.0,17.0,63.0,915,03,01,  Sreenagar,762,593,431,244,331,349,56.2,63.9,48.7,00000
47.0,17.0,63.0,915,04,01,  Satgharia,320,372,185,154,135,218,46.2,54.6,38.2,00000
47.0,17.0,63.0,915,05,01,  Bhitabhanga,347,343,185,142,162,201,50.3,56.6,44.6,00000
47.0,17.0,63.0,915,06,01,  Shibnagar,139,225,80,101,59,124,38.2,44.2,32.2,00000
47.0,17.0,63.0,915,07,01,  Joynagar,852,588,468,251,384,337,59.2,65.1,53.3,00000
47.0,17.0,63.0,915,08,01,  Saharabad,328,350,197,155,131,195,48.4,56.0,40.2,00000
47.0,17.0,63.0,915,09,01,  Rajnagar,114,41,71,11,43,30,73.5,86.6,58.9,00000
47.0,17.0,63.0,915,10,01,  Kalinagar,759,480,444,185,315,295,61.3,70.6,51.6,00000
47.0,17.0,63.0,915,11,01,  Par Joynagar,811,733,455,330,356,403,52.5,58.0,46.9,00000
47.0,17.0,63.0,915,12,01,  Rekhamari,120,71,68,32,52,39,62.8,68.0,57.1,00000
47.0,17.0,63.0,915,13,01,  Fakirdanga,80,56,46,21,34,35,58.8,68.7,49.3,00000
47.0,17.0,69.0,676,01,01,  Kamarabad,363,245,193,102,170,143,59.7,65.4,54.3,00000
47.0,17.0,69.0,676,02,01,  Lakshmikhola,1343,726,731,297,612,429,64.9,71.1,58.8,00000
47.0,17.0,69.0,835,01,01,  Pankhali (Part),1750,1668,935,714,815,954,51.2,56.7,46.1,00000
47.0,17.0,69.0,835,02,01,  Hoglabunia,620,485,357,199,263,286,56.1,64.2,47.9,00000
47.0,17.0,69.0,835,03,01,  Katabunia,355,286,196,122,159,164,55.4,61.6,49.2,00000
47.0,17.0,84.0,159,01,01,  Batbunia,881,552,501,169,380,383,61.5,74.8,49.8,00000
47.0,17.0,84.0,159,02,01,  Badalbunia,214,148,125,62,89,86,59.1,66.8,50.9,00000
47.0,17.0,84.0,159,03,01,  Joynagar,125,108,71,40,54,68,53.6,64.0,44.3,00000
47.0,17.0,84.0,199,01,01,  Kaminibasi,627,135,345,32,282,103,82.3,91.5,73.2,00000
47.0,17.0,84.0,199,02,01,  Raskholarpar,617,363,352,125,265,238,63.0,73.8,52.7,00000
47.0,17.0,84.0,199,03,01,  Nishankhali,208,135,113,46,95,89,60.6,71.1,51.6,00000
47.0,17.0,84.0,199,04,01,  Datta Chak,433,371,246,152,187,219,53.9,61.8,46.1,00000
47.0,17.0,84.0,199,05,01,  Kakrabunia-3,264,70,139,20,125,50,79.0,87.4,71.4,00000
47.0,17.0,84.0,199,06,01,  Arakhali,367,227,210,102,157,125,61.8,67.3,55.7,00000
47.0,17.0,84.0,199,07,01,  Tentultala,233,195,141,64,92,131,54.4,68.8,41.3,00000
47.0,17.0,84.0,199,08,01,  Uder Para,345,288,211,100,134,188,54.5,67.8,41.6,00000
47.0,17.0,84.0,199,09,01,  Chhota Batbunia,200,109,111,43,89,66,64.7,72.1,57.4,00000
47.0,17.0,84.0,358,01,01,  Naldanga,436,349,246,133,190,216,55.5,64.9,46.8,00000
47.0,17.0,84.0,358,02,01,  Andhar Manik,325,169,187,47,138,122,65.8,79.9,53.1,00000
47.0,17.0,84.0,358,03,01,  Humakhali,464,343,248,153,216,190,57.5,61.8,53.2,00000
47.0,17.0,84.0,358,04,01,  Garkhali,177,209,94,102,83,107,45.9,48.0,43.7,00000
47.0,17.0,84.0,358,05,01,  Satyapir,238,144,128,55,110,89,62.3,69.9,55.3,00000
47.0,17.0,84.0,358,06,01,  Sardar Para,129,150,69,73,60,77,46.2,48.6,43.8,00000
47.0,17.0,84.0,358,07,01,  Kakrabunia,675,608,392,247,283,361,52.6,61.3,43.9,00000
47.0,17.0,84.0,358,08,01,  Chhota Balia,436,490,244,231,192,259,47.1,51.4,42.6,00000
47.0,17.0,84.0,995,01,01,  Chardanga,103,47,48,23,55,24,68.7,67.6,69.6,00000
47.0,17.0,84.0,995,02,01,  Mashamari,371,232,222,77,149,155,61.5,74.2,49.0,00000
47.0,17.0,84.0,995,03,01,  Bansh Talardanga,502,243,271,87,231,156,67.4,75.7,59.7,00000
47.0,17.0,84.0,995,04,01,  Majherdanga,279,104,156,20,123,84,72.8,88.6,59.4,00000
47.0,17.0,84.0,995,05,01,  Guchchhagram,50,67,35,20,15,47,42.7,63.6,24.2,00000
47.0,17.0,84.0,995,06,01,  Tildanga,342,171,186,55,156,116,66.7,77.2,57.4,00000
47.0,21.0,10.0,047,01,01,  Aranghata,2591,1278,1387,574,1204,704,67.0,70.7,63.1,00000
47.0,21.0,10.0,047,02,01,  Sarderdanga,645,295,328,142,317,153,68.6,69.8,67.4,00000
47.0,21.0,10.0,047,03,01,  Gaikur,2745,1253,1474,589,1271,664,68.7,71.4,65.7,00000
47.0,30.0,11.0,201,01,01,  Boyarsinga,485,191,283,58,202,133,71.7,83.0,60.3,00000
47.0,30.0,11.0,201,02,01,  Putimari,113,70,66,28,47,42,61.7,70.2,52.8,00000
47.0,30.0,11.0,201,03,01,  Andhar Manik,179,133,105,60,74,73,57.4,63.6,50.3,00000
47.0,30.0,11.0,201,04,01,  Khalsibunia,25,31,14,14,11,17,44.6,50.0,39.3,00000
47.0,30.0,11.0,201,05,01,  Chhota Murabunia,58,62,35,27,23,35,48.3,56.5,39.7,00000
47.0,30.0,11.0,201,06,01,  Sondar Bunia,95,73,54,28,41,45,56.5,65.9,47.7,00000
47.0,30.0,11.0,201,07,01,  Golapdha,205,117,131,38,74,79,63.7,77.5,48.4,00000
47.0,30.0,11.0,201,08,01,  Durgatuni,29,10,17,4,12,6,74.4,81.0,66.7,00000
47.0,30.0,11.0,201,09,01,  Bara Chanmari,96,57,60,21,36,36,62.7,74.1,50.0,00000
47.0,30.0,11.0,201,10,01,  Bara Murabunia,145,107,92,39,53,68,57.5,70.2,43.8,00000
47.0,30.0,11.0,310,01,01,  Chuknagar,2297,1275,1256,525,1041,750,64.3,70.5,58.1,00000
47.0,30.0,11.0,310,02,01,  Putimari,499,465,284,220,215,245,51.8,56.3,46.7,00000
47.0,30.0,11.0,310,03,01,  Dariadanga,342,512,179,247,163,265,40.0,42.0,38.1,00000
47.0,30.0,11.0,635,01,01,  Kulbaria Baratia,570,607,290,287,280,320,48.4,50.3,46.7,00000
47.0,30.0,11.0,635,02,01,  Baratia,1763,1464,1018,755,745,709,54.6,57.4,51.2,00000
47.0,30.0,11.0,635,03,01,  Matbaria,737,787,399,381,338,406,48.4,51.2,45.4,00000
47.0,30.0,11.0,635,04,01,  Gobindakatia,1119,875,624,395,495,480,56.1,61.2,50.8,00000
47.0,30.0,11.0,635,05,01,  Nizkhali,119,158,63,70,56,88,43.0,47.4,38.9,00000
47.0,30.0,20.0,714,01,01,  Mandra,318,275,182,105,136,170,53.6,63.4,44.4,00000
47.0,30.0,20.0,714,02,01,  Mainapur,78,84,41,33,37,51,48.1,55.4,42.0,00000
47.0,30.0,20.0,980,01,01,  Tolna,2010,2544,1085,1116,925,1428,44.1,49.3,39.3,00000
47.0,30.0,20.0,980,02,01,  Mujar Ghuta,77,80,43,31,34,49,49.0,58.1,41.0,00000
47.0,30.0,33.0,197,01,01,  Purba Bil Pabla,481,348,279,136,202,212,58.0,67.2,48.8,00000
47.0,30.0,33.0,197,02,01,  Paschim Bil Pabla,458,361,269,167,189,194,55.9,61.7,49.3,00000
47.0,30.0,33.0,197,03,01,  Line Bil Pabla,643,895,378,420,265,475,41.8,47.4,35.8,00000
47.0,30.0,33.0,197,04,01,  Uttar Bil Pabla,299,412,184,192,115,220,42.1,48.9,34.3,00000
47.0,30.0,33.0,413,01,01,  Gutudia,2441,2313,1319,1073,1122,1240,51.3,55.1,47.5,00000
47.0,30.0,33.0,413,02,01,  Patkelpota,100,140,63,68,37,72,41.7,48.1,33.9,00000
47.0,30.0,33.0,458,01,01,  Jelerdanga,84,87,53,36,31,51,49.1,59.6,37.8,00000
47.0,30.0,33.0,458,02,01,  Baradanga,153,104,90,44,63,60,59.5,67.2,51.2,00000
47.0,30.0,33.0,659,01,01,  Khamar Baria,778,462,439,195,339,267,62.7,69.2,55.9,00000
47.0,30.0,33.0,659,02,01,  Lata,796,242,462,76,334,166,76.7,85.9,66.8,00000
47.0,30.0,33.0,659,03,01,  Paharpur,333,163,183,67,150,96,67.1,73.2,61.0,00000
47.0,30.0,40.0,724,01,01,  Mechhaghuna,690,271,353,122,337,149,71.8,74.3,69.3,00000
47.0,30.0,40.0,724,02,01,  Kartik Danga,111,194,74,87,37,107,36.4,46.0,25.7,00000
47.0,30.0,47.0,004,01,01,  Ahladipur,536,127,289,34,247,93,80.8,89.5,72.6,00000
47.0,30.0,47.0,004,02,01,  Purba Patibunia,220,100,124,25,96,75,68.8,83.2,56.1,00000
47.0,30.0,47.0,004,03,01,  Paschim Patibunia,257,70,132,22,125,48,78.6,85.7,72.3,00000
47.0,30.0,47.0,354,01,01,  Hoglabunia,148,88,84,29,64,59,62.7,74.3,52.0,00000
47.0,30.0,47.0,354,02,01,  Gajalia,159,88,91,29,68,59,64.4,75.8,53.5,00000
47.0,30.0,47.0,615,01,01,  Hatalbunia,221,187,121,79,100,108,54.2,60.5,48.1,00000
47.0,30.0,47.0,615,02,01,  Korakata,151,65,78,19,73,46,69.9,80.4,61.3,00000
47.0,30.0,47.0,615,03,01,  Sokarmari,99,41,52,18,47,23,70.7,74.3,67.1,00000
47.0,30.0,47.0,709,01,01,  Amurbunia,231,112,127,44,104,68,67.3,74.3,60.5,00000
47.0,30.0,47.0,709,02,01,  Shakertak,163,231,96,100,67,131,41.4,49.0,33.8,00000
47.0,30.0,47.0,709,03,01,  Barmarber,86,79,42,41,44,38,52.1,50.6,53.7,00000
47.0,30.0,47.0,709,04,01,  Jharjhria,165,132,102,50,63,82,55.6,67.1,43.4,00000
47.0,30.0,61.0,876,01,01,  Sahapur,2843,1701,1495,741,1348,960,62.6,66.9,58.4,00000
47.0,30.0,61.0,876,02,01,  Bil Patiala,110,120,63,64,47,56,47.8,49.6,45.6,00000
47.0,30.0,67.0,852,01,01,  Rangpur,4733,3407,2679,1407,2054,2000,58.1,65.6,50.7,00000
47.0,30.0,67.0,852,02,01,  Sarabhita,201,242,112,108,89,134,45.4,50.9,39.9,00000
47.0,30.0,67.0,852,03,01,  Mujarguta,232,130,129,48,103,82,64.1,72.9,55.7,00000
47.0,30.0,67.0,852,04,01,  Batbera,230,287,139,122,91,165,44.5,53.3,35.5,00000
47.0,30.0,67.0,852,05,01,  Baranashi,188,146,96,59,92,87,56.3,61.9,51.4,00000
47.0,30.0,81.0,881,01,01,  Charabandha,57,60,33,27,24,33,48.7,55.0,42.1,00000
47.0,30.0,81.0,881,02,01,  Dudhir Hula,57,97,34,42,23,55,37.0,44.7,29.5,00000
47.0,30.0,81.0,881,03,01,  Sahas Ghoshgati,559,461,291,202,268,259,54.8,59.0,50.9,00000
47.0,30.0,81.0,881,04,01,  Kumarghata,456,448,245,203,211,245,50.4,54.7,46.3,00000
47.0,30.0,81.0,881,05,01,  Madhyapara,266,132,154,48,112,84,66.8,76.2,57.1,00000
47.0,30.0,81.0,881,06,01,  Rajapur,733,827,397,394,336,433,47.0,50.2,43.7,00000
47.0,30.0,81.0,881,07,01,  Sahas Joykhali,910,875,486,441,424,434,51.0,52.4,49.4,00000
47.0,30.0,88.0,497,01,01,  Uttar Kalikapur,404,480,190,220,214,260,45.7,46.3,45.1,00000
47.0,30.0,88.0,497,02,01,  Dakshin Kalikapur,838,538,480,233,358,305,60.9,67.3,54.0,00000
47.0,30.0,88.0,497,03,01,  Bosundia Danga,124,116,67,50,57,66,51.7,57.3,46.3,00000
47.0,30.0,88.0,497,04,01,  Dattadanga,84,114,47,56,37,58,42.4,45.6,38.9,00000
47.0,30.0,88.0,497,05,01,  Senpara,736,1065,384,486,352,579,40.9,44.1,37.8,00000
47.0,30.0,88.0,896,01,01,  Uttar Sarappur,797,812,438,384,359,428,49.5,53.3,45.6,00000
47.0,30.0,88.0,896,02,01,  Dakshin Sarappur,925,696,444,335,481,361,57.1,57.0,57.1,00000
47.0,30.0,88.0,896,03,01,  Baniakhali,178,167,106,74,72,93,51.6,58.9,43.6,00000
47.0,30.0,94.0,709,01,01,  Mandartala,532,391,290,157,242,234,57.6,64.9,50.8,00000
47.0,30.0,94.0,709,02,01,  Baruikati,370,278,214,115,156,163,57.1,65.0,48.9,00000
47.0,40.0,17.0,142,01,01,  Barakpur,2243,1470,1199,723,1044,747,60.4,62.4,58.3,00000
47.0,40.0,17.0,142,02,01,  Gousgati,1590,993,827,450,763,543,61.6,64.8,58.4,00000
47.0,40.0,57.0,331,01,01,  Deara,3538,3023,1807,1481,1731,1542,53.9,55.0,52.9,00000
47.0,40.0,57.0,331,02,01,  Farmais Khana,1919,953,997,439,922,514,66.8,69.4,64.2,00000
47.0,40.0,57.0,331,03,01,  Sugandhi,419,196,207,79,212,117,68.1,72.4,64.4,00000
47.0,40.0,66.0,023,01,01,  Abalganti,135,172,67,83,68,89,44.0,44.7,43.3,00000
47.0,40.0,66.0,023,02,01,  Ambaria (Hi),148,253,72,127,76,126,36.9,36.2,37.6,00000
47.0,40.0,66.0,402,01,01,  Domra,711,561,382,250,329,311,55.9,60.4,51.4,00000
47.0,40.0,66.0,402,02,01,  Sonakur,459,316,229,169,230,147,59.2,57.5,61.0,00000
47.0,40.0,66.0,497,01,01,  Jungasia,700,601,378,298,322,303,53.8,55.9,51.5,00000
47.0,40.0,66.0,497,02,01,  Gazir Hat,219,91,113,47,106,44,70.6,70.6,70.7,00000
47.0,40.0,66.0,497,03,01,  Baghmara,165,252,93,121,72,131,39.6,43.5,35.5,00000
47.0,40.0,66.0,497,04,01,  Mahishdia,715,416,388,187,327,229,63.2,67.5,58.8,00000
47.0,40.0,66.0,568,01,01,  Ketla,979,1057,553,499,426,558,48.1,52.6,43.3,00000
47.0,40.0,66.0,568,02,01,  Mollahdanga,599,1278,315,645,284,633,31.9,32.8,31.0,00000
47.0,40.0,66.0,568,03,01,  Islamdanga,158,148,72,75,86,73,51.6,49.0,54.1,00000
47.0,40.0,66.0,734,01,01,  Majhirganti,630,676,355,307,275,369,48.2,53.6,42.7,00000
47.0,40.0,66.0,734,02,01,  Padma Bila,597,398,302,181,295,217,60.0,62.5,57.6,00000
47.0,40.0,66.0,734,03,01,  Muslim Danga,254,155,146,70,108,85,62.1,67.6,56.0,00000
47.0,40.0,66.0,734,04,01,  Ambaria,464,604,253,283,211,321,43.4,47.2,39.7,00000
47.0,40.0,85.0,450,01,01,  Hajigram,2152,3269,1162,1656,990,1613,39.7,41.2,38.0,00000
47.0,40.0,85.0,450,02,01,  Mominpur,135,296,76,174,59,122,31.3,30.4,32.6,00000
47.0,48.0,19.0,497,01,01,  Gilatala,7096,3798,3690,1770,3406,2028,65.1,67.6,62.7,00000
47.0,48.0,19.0,497,02,01,  Matamdanga,2844,1313,1446,601,1398,712,68.4,70.6,66.3,00000
47.0,48.0,19.0,621,01,01,  Masiali,3054,1848,1628,873,1426,975,62.3,65.1,59.4,00000
47.0,48.0,19.0,621,02,01,  Gabtala,1586,616,926,273,660,343,72.0,77.2,65.8,00000
47.0,48.0,19.0,621,03,01,  Pariadanga,989,531,530,246,459,285,65.1,68.3,61.7,00000
47.0,48.0,75.0,437,01,01,  Jugipole,6326,2206,3289,948,3037,1258,74.1,77.6,70.7,00000
47.0,48.0,75.0,437,02,01,  Jabdipur,3026,932,1583,402,1443,530,76.5,79.7,73.1,00000
47.0,48.0,75.0,994,01,01,  Teliganti,3404,1326,1814,575,1590,751,72.0,75.9,67.9,00000
47.0,48.0,75.0,994,02,01,  Rajapur,237,106,124,38,113,68,69.1,76.5,62.4,00000
47.0,48.0,75.0,994,03,01,  Khanabari,2361,87,1760,21,601,66,96.4,98.8,90.1,00000
47.0,53.0,10.0,013,01,01,  Jaigir Mahal,2130,1016,1171,418,959,598,67.7,73.7,61.6,00000
47.0,53.0,10.0,013,02,01,  Garamadi,382,155,205,56,177,99,71.1,78.5,64.1,00000
47.0,53.0,10.0,013,03,01,  Katakhali,288,224,191,100,97,124,56.3,65.6,43.9,00000
47.0,53.0,10.0,013,04,01,  Amadi,1498,1176,815,519,683,657,56.0,61.1,51.0,00000
47.0,53.0,10.0,190,01,01,  Bhandar Pole,759,1052,425,471,334,581,41.9,47.4,36.5,00000
47.0,53.0,10.0,190,02,01,  Channir Chak,1132,1281,682,494,450,787,46.9,58.0,36.4,00000
47.0,53.0,10.0,190,03,01,  Kumarkhali,132,238,73,105,59,133,35.7,41.0,30.7,00000
47.0,53.0,10.0,190,04,01,  Bech Para,406,295,252,115,154,180,57.9,68.7,46.1,00000
47.0,53.0,10.0,190,05,01,  Hadubunia,47,38,25,14,22,24,55.3,64.1,47.8,00000
47.0,53.0,10.0,477,01,01,  Harinagar,747,772,394,317,353,455,49.2,55.4,43.7,00000
47.0,53.0,10.0,477,02,01,  Talbaria,325,127,164,43,161,84,71.9,79.2,65.7,00000
47.0,53.0,10.0,640,01,01,  Khiral,536,691,291,319,245,372,43.7,47.7,39.7,00000
47.0,53.0,10.0,640,02,01,  Patuali,71,49,45,20,26,29,59.2,69.2,47.3,00000
47.0,53.0,10.0,640,03,01,  Dasbaria,193,142,92,56,101,86,57.6,62.2,54.0,00000
47.0,53.0,11.0,136,01,01,  Bamia,1585,1732,868,793,717,939,47.8,52.3,43.3,00000
47.0,53.0,11.0,136,02,01,  Bairagir Chak,237,116,137,42,100,74,67.1,76.5,57.5,00000
47.0,53.0,11.0,136,03,01,  Thakurer Chak,250,80,134,25,116,55,75.8,84.3,67.8,00000
47.0,53.0,11.0,790,01,01,  Mathabhanga,150,119,69,50,81,69,55.8,58.0,54.0,00000
47.0,53.0,11.0,790,02,01,  Gupirerber,344,267,179,114,165,153,56.3,61.1,51.9,00000
47.0,53.0,11.0,790,03,01,  Gazinagar,198,172,102,62,96,110,53.5,62.2,46.6,00000
47.0,53.0,22.0,313,01,01,  Bara Angtihara,730,1315,419,592,311,723,35.7,41.4,30.1,00000
47.0,53.0,22.0,313,02,01,  Jorsing,912,1921,505,876,407,1045,32.2,36.6,28.0,00000
47.0,53.0,22.0,313,03,01,  Golkhali,660,971,358,465,302,506,40.5,43.5,37.4,00000
47.0,53.0,22.0,313,04,01,  Matiabhanga,419,850,222,409,197,441,33.0,35.2,30.9,00000
47.0,53.0,22.0,313,05,01,  Gharilal,432,792,235,388,197,404,35.3,37.7,32.8,00000
47.0,53.0,22.0,313,06,01,  Choramukha,396,284,225,113,171,171,58.2,66.6,50.0,00000
47.0,53.0,22.0,313,07,01,  Patakhali,241,471,116,230,125,241,33.8,33.5,34.2,00000
47.0,53.0,22.0,313,08,01,  Halbunia,145,171,76,83,69,88,45.9,47.8,43.9,00000
47.0,53.0,22.0,313,09,01,  Binapani,669,625,372,266,297,359,51.7,58.3,45.3,00000
47.0,53.0,22.0,313,10,01,  Chhota Angtihara,94,503,42,249,52,254,15.7,14.4,17.0,00000
47.0,53.0,22.0,313,11,01,  Maider Char,189,372,94,176,95,196,33.7,34.8,32.6,00000
47.0,53.0,22.0,313,12,01,  Dakshin Bedkasi,411,901,251,421,160,480,31.3,37.4,25.0,00000
47.0,53.0,55.0,667,01,01,  1 No. Koyra,1865,1361,996,640,869,721,57.8,60.9,54.7,00000
47.0,53.0,55.0,667,02,01,  2 No. Koyra,2309,2606,1124,1207,1185,1399,47.0,48.2,45.9,00000
47.0,53.0,55.0,667,03,01,  3 No. Koyra,836,883,463,415,373,468,48.6,52.7,44.4,00000
47.0,53.0,55.0,667,04,01,  4 No. Koyra,1984,2311,1025,1020,959,1291,46.2,50.1,42.6,00000
47.0,53.0,55.0,667,05,01,  5 No. Koyra,906,1355,433,627,473,728,40.1,40.8,39.4,00000
47.0,53.0,55.0,667,06,01,  6 No. Koyra,1316,949,726,394,590,555,58.1,64.8,51.5,00000
47.0,53.0,55.0,722,01,03,  Dhakin Madinabad,2350,1216,1296,569,1054,647,65.9,69.5,62.0,00000
47.0,53.0,55.0,722,02,03,  Uttar Madinabad,1615,1478,830,618,785,860,52.2,57.3,47.7,00000
47.0,53.0,55.0,722,03,03,  Gobra,1391,1037,704,499,687,538,57.3,58.5,56.1,00000
47.0,53.0,55.0,722,04,03,  Ghatakhali,338,232,152,117,186,115,59.3,56.5,61.8,00000
47.0,53.0,55.0,722,05,03,  Harin Khola,155,250,64,125,91,125,38.3,33.9,42.1,00000
47.0,53.0,72.0,327,01,01,  Dakshin Deara,1037,1515,527,668,510,847,40.6,44.1,37.6,00000
47.0,53.0,72.0,327,02,01,  Madarbaria,525,1001,287,440,238,561,34.4,39.5,29.8,00000
47.0,53.0,72.0,327,04,01,  Kolukhali,155,314,93,137,62,177,33.0,40.4,25.9,00000
47.0,53.0,72.0,327,05,01,  Shyamkhali,281,187,141,78,140,109,60.0,64.4,56.2,00000
47.0,53.0,72.0,613,01,01,  Moraler Chak,140,266,75,131,65,135,34.5,36.4,32.5,00000
47.0,53.0,72.0,613,03,01,  Sutirkona,197,456,112,215,85,241,30.2,34.3,26.1,00000
47.0,53.0,72.0,613,04,01,  Sutirdhar,259,395,139,175,120,220,39.6,44.3,35.3,00000
47.0,53.0,72.0,613,05,01,  Marder Chak,312,597,164,238,148,359,34.3,40.8,29.2,00000
47.0,53.0,72.0,613,06,01,  Moterdanga,406,645,223,288,183,357,38.6,43.6,33.9,00000
47.0,53.0,72.0,613,07,01,  South Motbari,446,349,219,137,227,212,56.1,61.5,51.7,00000
47.0,53.0,72.0,613,08,01,  Purbo Matbari,567,569,338,245,229,324,49.9,58.0,41.4,00000
47.0,53.0,72.0,736,01,01,  Purba Maharajpur,975,1809,485,785,490,1024,35.0,38.2,32.4,00000
47.0,53.0,72.0,736,02,01,  Paschim Maharajpur,757,999,390,422,367,577,43.1,48.0,38.9,00000
47.0,53.0,78.0,749,01,01,  Maheswaripur,2970,2347,1665,997,1305,1350,55.9,62.5,49.2,00000
47.0,53.0,78.0,749,02,01,  Amtali,376,289,205,116,171,173,56.5,63.9,49.7,00000
47.0,53.0,78.0,749,03,01,  Singher Chak,263,255,164,108,99,147,50.8,60.3,40.2,00000
47.0,53.0,78.0,749,04,01,  Gilabari,184,187,100,81,84,106,49.6,55.2,44.2,00000
47.0,53.0,78.0,967,01,01,  Babura Bade,393,420,220,179,173,241,48.3,55.1,41.8,00000
47.0,53.0,78.0,967,02,01,  Tentultalar Char,951,1152,526,542,425,610,45.2,49.3,41.1,00000
47.0,53.0,94.0,994,01,01,  Seikh Sardar Para,780,629,420,286,360,343,55.4,59.5,51.2,00000
47.0,53.0,94.0,994,02,01,  Bedkashi,1145,825,601,364,544,461,58.1,62.3,54.1,00000
47.0,53.0,94.0,994,03,01,  Katmar Char,808,1040,381,458,427,582,43.7,45.4,42.3,00000
47.0,53.0,94.0,994,04,01,  Barabari,1341,634,751,246,590,388,67.9,75.3,60.3,00000
47.0,53.0,94.0,994,05,01,  Botul Bazar,551,444,293,198,258,246,55.4,59.7,51.2,00000
47.0,53.0,94.0,994,06,01,  Patharkhali,489,459,246,212,243,247,51.6,53.7,49.6,00000
47.0,53.0,94.0,994,07,01,  Gazi Para,435,425,233,184,202,241,50.6,55.9,45.6,00000
47.0,53.0,94.0,994,08,01,  Padma Pukur,483,618,273,273,210,345,43.9,50.0,37.8,00000
47.0,53.0,94.0,994,09,01,  Gatir Ghereu,230,178,134,69,96,109,56.4,66.0,46.8,00000
47.0,53.0,94.0,994,10,01,  Hariharpur,265,166,158,66,107,100,61.5,70.5,51.7,00000
47.0,53.0,94.0,994,11,01,  Hazatkhali,549,319,298,136,251,183,63.2,68.7,57.8,00000
47.0,53.0,94.0,994,12,01,  Shakbaria,197,111,124,40,73,71,64.0,75.6,50.7,00000
47.0,53.0,94.0,994,13,01,  Gubbunia,81,49,44,19,37,30,62.3,69.8,55.2,00000
47.0,64.0,16.0,553,01,01,  Kamalapur,926,922,544,404,382,518,50.1,57.4,42.4,00000
47.0,64.0,16.0,553,02,01,  Uttar Garerabad,349,494,187,194,162,300,41.4,49.1,35.1,00000
47.0,64.0,16.0,553,03,01,  Dakshin Garerabad,122,723,71,355,51,368,14.4,16.7,12.2,00000
47.0,64.0,16.0,639,01,01,  Krishnanagar,1103,1109,613,490,490,619,49.9,55.6,44.2,00000
47.0,64.0,16.0,639,02,01,  Dhoha Kula,146,206,83,89,63,117,41.5,48.3,35.0,00000
47.0,64.0,27.0,140,01,01,  Bigardana,366,335,217,139,149,196,52.2,61.0,43.2,00000
47.0,64.0,27.0,140,02,01,  Durgapur,187,163,111,66,76,97,53.4,62.7,43.9,00000
47.0,64.0,27.0,532,01,01,  Kalinagar,535,198,278,73,257,125,73.0,79.2,67.3,00000
47.0,64.0,27.0,532,02,01,  Naldanga,159,44,85,17,74,27,78.3,83.3,73.3,00000
47.0,64.0,27.0,677,01,01,  Madhukhali,211,154,114,65,97,89,57.8,63.7,52.2,00000
47.0,64.0,27.0,677,02,01,  Jokarhula,128,158,81,68,47,90,44.8,54.4,34.3,00000
47.0,64.0,27.0,883,01,01,  Senerbil,102,34,59,9,43,25,75.0,86.8,63.2,00000
47.0,64.0,27.0,883,02,01,  Khejurtala,109,15,53,3,56,12,87.9,94.6,82.4,00000
47.0,64.0,39.0,272,01,01,  Dakshin Bainbari,677,318,379,103,298,215,68.0,78.6,58.1,00000
47.0,64.0,39.0,272,02,01,  Paschim Bainbari,411,444,221,184,190,260,48.1,54.6,42.2,00000
47.0,64.0,39.0,375,01,01,  Garuikhali,1335,1219,743,558,592,661,52.3,57.1,47.2,00000
47.0,64.0,39.0,375,02,01,  Fakirabad,1074,1128,591,503,483,625,48.8,54.0,43.6,00000
47.0,64.0,39.0,375,03,01,  Shanta,506,642,266,298,240,344,44.1,47.2,41.1,00000
47.0,64.0,39.0,648,01,01,  Uttar Kumkhali,1128,624,626,247,502,377,64.4,71.7,57.1,00000
47.0,64.0,39.0,648,02,01,  Dakshin Kumkhali,752,326,413,100,339,226,69.8,80.5,60.0,00000
47.0,64.0,39.0,648,03,01,  Purba Kumkhali,665,384,351,139,314,245,63.4,71.6,56.2,00000
47.0,64.0,39.0,763,01,01,  Dakshin Amirpur,708,342,419,126,289,216,67.4,76.9,57.2,00000
47.0,64.0,39.0,763,02,01,  Patrabunia,849,586,447,223,402,363,59.2,66.7,52.5,00000
47.0,64.0,39.0,763,03,01,  Basha Khali,585,728,320,341,265,387,44.6,48.4,40.6,00000
47.0,64.0,39.0,763,04,01,  Bogra Chak,187,139,102,48,85,91,57.4,68.0,48.3,00000
47.0,64.0,39.0,763,05,01,  Uttar Amirpur,483,479,268,197,215,282,50.2,57.6,43.3,00000
47.0,64.0,39.0,763,06,01,  Kanakhali,516,252,285,79,231,173,67.2,78.3,57.2,00000
47.0,64.0,44.0,838,01,01,  Ramnathpur,447,333,253,145,194,188,57.3,63.6,50.8,00000
47.0,64.0,44.0,838,02,01,  Habibnagar,147,159,76,77,71,82,48.0,49.7,46.4,00000
47.0,64.0,44.0,838,03,01,  Dargah Mahal,255,214,137,95,118,119,54.4,59.1,49.8,00000
47.0,64.0,44.0,838,04,01,  Par Ramnathpur,38,48,18,23,20,25,44.2,43.9,44.4,00000
47.0,64.0,50.0,264,01,01,  Chinamala,152,68,97,24,55,44,69.1,80.2,55.6,00000
47.0,64.0,50.0,264,02,01,  Sreephaltala,149,75,84,31,65,44,66.5,73.0,59.6,00000
47.0,64.0,50.0,829,01,01,  Partapkati,827,852,431,375,396,477,49.3,53.5,45.4,00000
47.0,64.0,50.0,829,02,01,  Naba,424,333,235,145,189,188,56.0,61.8,50.1,00000
47.0,64.0,50.0,829,03,01,  Salua,358,306,188,137,170,169,53.9,57.8,50.1,00000
47.0,64.0,50.0,829,04,01,  Kazimucha,648,1171,330,570,318,601,35.6,36.7,34.6,00000
47.0,64.0,50.0,829,05,01,  Gucchagram,25,85,13,44,12,41,22.7,22.8,22.6,00000
47.0,64.0,50.0,904,01,01,  Silemanpur,578,910,322,410,256,500,38.8,44.0,33.9,00000
47.0,64.0,50.0,904,02,01,  Agraghata,249,254,131,110,118,144,49.5,54.4,45.0,00000
47.0,64.0,61.0,611,01,01,  Kharia Dhemsakhali,395,273,229,92,166,181,59.1,71.3,47.8,00000
47.0,64.0,61.0,611,02,01,  Uttar Kharia,480,251,291,87,189,164,65.7,77.0,53.5,00000
47.0,64.0,61.0,611,03,01,  Purba Kharia,269,158,161,51,108,107,63.0,75.9,50.2,00000
47.0,64.0,61.0,611,04,01,  Bhorengar Purbapar,314,225,182,97,132,128,58.3,65.2,50.8,00000
47.0,64.0,61.0,611,05,01,  Bhorengar Paschimpar,281,102,169,26,112,76,73.4,86.7,59.6,00000
47.0,64.0,61.0,611,06,01,  Lebubunia,335,199,203,77,132,122,62.7,72.5,52.0,00000
47.0,64.0,61.0,611,07,01,  Goalbaria,290,123,156,46,134,77,70.2,77.2,63.5,00000
47.0,64.0,61.0,611,08,01,  Minaj Chak,198,239,115,106,83,133,45.3,52.0,38.4,00000
47.0,64.0,61.0,611,09,01,  Kharia Khaler Purbapar,549,655,327,275,222,380,45.6,54.3,36.9,00000
47.0,64.0,61.0,611,10,01,  Kharia Khaler Paschimpar,923,786,540,324,383,462,54.0,62.5,45.3,00000
47.0,64.0,61.0,611,11,01,  Bara Thakrunbari,102,79,61,31,41,48,56.4,66.3,46.1,00000
47.0,64.0,61.0,611,12,01,  Chhota Thakrunbari,132,110,73,44,59,66,54.5,62.4,47.2,00000
47.0,64.0,61.0,611,13,01,  Basakhali,314,272,179,107,135,165,53.6,62.6,45.0,00000
47.0,64.0,61.0,611,14,01,  Khokai Basia,218,214,133,78,85,136,50.5,63.0,38.5,00000
47.0,64.0,67.0,024,01,01,  Andhar Manik,188,119,120,43,68,76,61.2,73.6,47.2,00000
47.0,64.0,67.0,024,02,01,  Haldar Chak,271,112,164,36,107,76,70.8,82.0,58.5,00000
47.0,64.0,67.0,416,01,01,  Guachhoba,57,20,29,12,28,8,74.0,70.7,77.8,00000
47.0,64.0,67.0,416,02,01,  Asannagar,247,85,137,27,110,58,74.4,83.5,65.5,00000
47.0,64.0,67.0,416,03,01,  Rekhamari,85,89,54,36,31,53,48.9,60.0,36.9,00000
47.0,64.0,67.0,429,01,01,  Hani,349,440,202,224,147,216,44.2,47.4,40.5,00000
47.0,64.0,67.0,429,02,01,  Munkia,468,229,275,87,193,142,67.1,76.0,57.6,00000
47.0,64.0,67.0,429,03,01,  Baincha Para,243,110,139,40,104,70,68.8,77.7,59.8,00000
47.0,64.0,67.0,433,01,01,  Haria,257,109,146,43,111,66,70.2,77.2,62.7,00000
47.0,64.0,67.0,433,02,01,  Schiarband,148,90,97,34,51,56,62.2,74.0,47.7,00000
47.0,64.0,67.0,668,01,01,  Lata,456,500,259,219,197,281,47.7,54.2,41.2,00000
47.0,64.0,67.0,668,02,01,  Putlakhali,301,125,169,46,132,79,70.7,78.6,62.6,00000
47.0,64.0,67.0,668,03,01,  Bamanerabad,144,118,91,49,53,69,55.0,65.0,43.4,00000
47.0,64.0,67.0,961,01,01,  Tentultala,292,245,166,101,126,144,54.4,62.2,46.7,00000
47.0,64.0,67.0,961,02,01,  Gangarkona,88,107,58,47,30,60,45.1,55.2,33.3,00000
47.0,64.0,89.0,115,01,01,  Betbunia,1252,759,649,319,603,440,62.3,67.0,57.8,00000
47.0,64.0,89.0,115,02,01,  Khatuamari,473,556,273,249,200,307,46.0,52.3,39.4,00000
47.0,64.0,89.0,156,01,01,  Boyer Jhapa,637,473,356,202,281,271,57.4,63.8,50.9,00000
47.0,64.0,89.0,156,02,01,  Majherbad,65,28,40,10,25,18,69.9,80.0,58.1,00000
47.0,64.0,89.0,156,03,01,  Tengramari,332,75,182,25,150,50,81.6,87.9,75.0,00000
47.0,64.0,89.0,247,01,01,  Char Banda,418,116,226,27,192,89,78.3,89.3,68.3,00000
47.0,64.0,89.0,247,02,01,  Paschim Bhekatmari,117,163,64,68,53,95,41.8,48.5,35.8,00000
47.0,64.0,89.0,284,01,01,  Dakshin Kanmukhi,325,158,190,53,135,105,67.3,78.2,56.3,00000
47.0,64.0,89.0,284,02,01,  Uttar Kanmukhi,163,127,87,54,76,73,56.2,61.7,51.0,00000
47.0,64.0,89.0,330,01,01,  Digha,759,123,444,17,315,106,86.1,96.3,74.8,00000
47.0,64.0,89.0,330,02,01,  Golbunia,239,52,130,13,109,39,82.1,90.9,73.6,00000
47.0,64.0,89.0,330,03,01,  Nutan Chak,83,56,50,25,33,31,59.7,66.7,51.6,00000
47.0,64.0,89.0,450,01,01,  Harikhali,8,34,2,20,6,14,19.0,9.1,30.0,00000
47.0,64.0,89.0,450,02,01,  Hajuti Vita,41,12,26,3,15,9,77.4,89.7,62.5,00000
47.0,64.0,89.0,454,01,01,  Harikhali Chak,183,119,106,48,77,71,60.6,68.8,52.0,00000
47.0,64.0,89.0,454,02,01,  Shalbunia Haridhali Abation,174,73,96,34,78,39,70.4,73.8,66.7,00000
47.0,64.0,89.0,606,01,01,  Khalia,256,152,140,64,116,88,62.7,68.6,56.9,00000
47.0,64.0,89.0,606,02,01,  Parsemari,478,150,275,53,203,97,76.1,83.8,67.7,00000
47.0,64.0,89.0,606,03,01,  Nune Para,368,277,209,100,159,177,57.1,67.6,47.3,00000
47.0,64.0,89.0,780,01,01,  Par Boyar Jhapa,439,402,237,190,202,212,52.2,55.5,48.8,00000
47.0,64.0,89.0,780,02,01,  Nayebkhali,118,48,65,15,53,33,71.1,81.3,61.6,00000
47.0,64.0,89.0,792,01,01,  Patkelpota,372,424,196,192,176,232,46.7,50.5,43.1,00000
47.0,64.0,89.0,792,02,01,  Narikeltala,206,136,105,58,101,78,60.2,64.4,56.4,00000
47.0,64.0,89.0,792,03,01,  Purba Bhekatmari,454,373,279,158,175,215,54.9,63.8,44.9,00000
47.0,64.0,89.0,792,04,01,  Patnikhali,145,65,89,21,56,44,69.0,80.9,56.0,00000
47.0,69.0,38.0,331,01,03,  Damodar,9835,5914,5164,2570,4671,3344,62.4,66.8,58.3,00000
47.0,69.0,38.0,331,02,03,  Baran Para,1105,907,584,441,521,466,54.9,57.0,52.8,00000
47.0,69.0,38.0,456,01,01,  Garakhola,3253,3095,1717,1419,1536,1676,51.2,54.8,47.8,00000
47.0,69.0,38.0,456,02,01,  Basurabad,27,68,13,39,14,29,28.4,25.0,32.6,00000
47.0,69.0,38.0,456,03,01,  Benepukur,415,407,214,183,201,224,50.5,53.9,47.3,00000
47.0,69.0,57.0,414,01,01,  Dhopakhola,1446,1138,773,496,673,642,56.0,60.9,51.2,00000
47.0,69.0,57.0,414,02,01,  Patia Banda,742,478,405,203,337,275,60.8,66.6,55.1,00000
47.0,69.0,57.0,414,03,01,  Mujar Ghota,20,10,11,2,9,8,66.7,84.6,52.9,00000
47.0,69.0,76.0,290,01,01,  Dakshin Dihi,2180,1474,1114,670,1066,804,59.7,62.4,57.0,00000
47.0,69.0,76.0,290,02,01,  Bajerdanga,222,218,119,93,103,125,50.5,56.1,45.2,00000
47.0,69.0,76.0,290,03,01,  Madhyadanga,270,277,139,133,131,144,49.4,51.1,47.6,00000
47.0,69.0,76.0,580,01,01,  Jogini Pasha,2266,1149,1194,539,1072,610,66.4,68.9,63.7,00000
47.0,69.0,76.0,580,02,01,  Dhakuria,736,598,376,269,360,329,55.2,58.3,52.2,00000
47.0,69.0,76.0,580,03,01,  Rari Para,746,448,421,191,325,257,62.5,68.8,55.8,00000
47.0,69.0,76.0,663,01,01,  Noadari,532,254,279,109,253,145,67.7,71.9,63.6,00000
47.0,69.0,76.0,663,02,01,  Burirdanga,623,317,317,137,306,180,66.3,69.8,63.0,00000
47.0,69.0,76.0,746,01,01,  Paygram Kasba,1175,619,604,294,571,325,65.5,67.3,63.7,00000
47.0,69.0,76.0,746,02,01,  Khanjhanpur,472,287,243,126,229,161,62.2,65.9,58.7,00000
47.0,75.0,13.0,015,01,01,  Aijganti,5467,2919,2871,1324,2596,1595,65.2,68.4,61.9,00000
47.0,75.0,13.0,015,02,01,  Singar Char,600,909,332,427,268,482,39.8,43.7,35.7,00000
47.0,75.0,13.0,352,01,01,  Durjani Mahal,1397,1165,708,578,689,587,54.5,55.1,54.0,00000
47.0,75.0,13.0,352,02,01,  Shirgati,1674,764,852,354,822,410,68.7,70.6,66.7,00000
47.0,75.0,27.0,030,01,01,  Alaipur,1853,1591,926,774,927,817,53.8,54.5,53.2,00000
47.0,75.0,27.0,030,02,01,  Anandangar,1349,1552,657,760,692,792,46.5,46.4,46.6,00000
47.0,75.0,27.0,030,03,01,  Putimari,421,359,224,182,197,177,54.0,55.2,52.7,00000
47.0,75.0,27.0,146,01,01,  Bil Maubgog,31,56,17,26,14,30,35.6,39.5,31.8,00000
47.0,75.0,27.0,146,02,01,  Nornia,207,273,94,136,113,137,43.1,40.9,45.2,00000
47.0,75.0,27.0,306,01,01,  Dhopakhola,489,316,246,141,243,175,60.7,63.6,58.1,00000
47.0,75.0,27.0,306,02,01,  Goal Bari,230,392,99,204,131,188,37.0,32.7,41.1,00000
47.0,75.0,27.0,321,01,01,  Doba,1253,1040,704,467,549,573,54.6,60.1,48.9,00000
47.0,75.0,27.0,321,02,01,  Natundia,302,347,171,160,131,187,46.5,51.7,41.2,00000
47.0,75.0,27.0,397,01,01,  Ghatbhog,911,876,452,448,459,428,51.0,50.2,51.7,00000
47.0,75.0,27.0,397,02,01,  Sindur Danga,387,225,224,97,163,128,63.2,69.8,56.0,00000
47.0,75.0,27.0,397,03,01,  Bandakhal,372,293,204,137,168,156,55.9,59.8,51.9,00000
47.0,75.0,27.0,819,01,01,  Shiali,1319,1288,715,608,604,680,50.6,54.0,47.0,00000
47.0,75.0,27.0,819,02,01,  Chandpur,1497,1168,717,532,780,636,56.2,57.4,55.1,00000
47.0,75.0,27.0,819,03,01,  Buri Gangni,95,342,40,169,55,173,21.7,19.1,24.1,00000
47.0,75.0,54.0,750,01,01,  Nehalpur,975,557,506,252,469,305,63.6,66.8,60.6,00000
47.0,75.0,54.0,750,02,01,  Debipur,789,237,413,117,376,120,76.9,77.9,75.8,00000
47.0,75.0,54.0,841,01,01,  Ramnagar,3566,2095,1852,945,1714,1150,63.0,66.2,59.8,00000
47.0,75.0,54.0,841,02,01,  Rahimnagar,1893,1088,992,485,901,603,63.5,67.2,59.9,00000
47.0,75.0,67.0,688,01,01,  Mochabbarpur,538,702,281,320,257,382,43.4,46.8,40.2,00000
47.0,75.0,67.0,688,02,01,  Singarchar,536,725,284,341,252,384,42.5,45.4,39.6,00000
47.0,94.0,13.0,128,01,01,  Bipra Ajugara,481,722,258,369,223,353,40.0,41.1,38.7,00000
47.0,94.0,13.0,128,02,01,  Asraf Nagar,13,67,3,38,10,29,16.3,7.3,25.6,00000
47.0,94.0,13.0,160,01,01,  Biri Ajugara,1386,1559,791,714,595,845,47.1,52.6,41.3,00000
47.0,94.0,13.0,160,02,01,  Shekpura,384,463,178,248,206,215,45.3,41.8,48.9,00000
47.0,94.0,13.0,545,01,01,  Anandanagar,755,925,339,453,416,472,44.9,42.8,46.8,00000
47.0,94.0,13.0,545,02,01,  Kharbaria,427,412,213,210,214,202,50.9,50.4,51.4,00000
47.0,94.0,13.0,545,03,01,  Shekpura,967,781,470,398,497,383,55.3,54.1,56.5,00000
47.0,94.0,13.0,626,01,01,  Balarampur,454,303,245,141,209,162,60.0,63.5,56.3,00000
47.0,94.0,13.0,626,02,01,  Pramodnagar,80,111,38,53,42,58,41.9,41.8,42.0,00000
47.0,94.0,13.0,626,03,01,  Sreepur,383,523,192,248,191,275,42.3,43.6,41.0,00000
47.0,94.0,13.0,626,04,01,  Amtala,618,349,324,150,294,199,63.9,68.4,59.6,00000
47.0,94.0,27.0,064,01,01,  Barasat,1923,2112,933,1036,990,1076,47.7,47.4,47.9,00000
47.0,94.0,27.0,064,02,01,  Rajapur,46,100,24,41,22,59,31.5,36.9,27.2,00000
47.0,94.0,27.0,064,03,01,  Arrangasia,248,124,145,59,103,65,66.7,71.1,61.3,00000
47.0,94.0,27.0,064,04,01,  Bhabanipur,114,158,67,79,47,79,41.9,45.9,37.3,00000
47.0,94.0,27.0,064,05,01,  Pantita,474,457,270,188,204,269,50.9,59.0,43.1,00000
47.0,94.0,27.0,064,06,01,  Ramchandrapur,47,99,29,42,18,57,32.2,40.8,24.0,00000
47.0,94.0,27.0,064,07,01,  Mathurapur,61,84,39,35,22,49,42.1,52.7,31.0,00000
47.0,94.0,27.0,064,08,01,  Uttar Kalinagar,85,115,47,58,38,57,42.5,44.8,40.0,00000
47.0,94.0,27.0,288,01,01,  Harikhali,1477,1843,693,853,784,990,44.5,44.8,44.2,00000
47.0,94.0,27.0,288,02,01,  Bhujnia,398,530,209,251,189,279,42.9,45.4,40.4,00000
47.0,94.0,27.0,288,03,01,  Sitarampur,179,183,99,80,80,103,49.4,55.3,43.7,00000
47.0,94.0,27.0,288,04,01,  Dakshin Kalinagar,276,250,141,117,135,133,52.5,54.7,50.4,00000
47.0,94.0,27.0,802,01,03,  Purba Katinga,573,553,293,293,280,260,50.9,50.0,51.9,00000
47.0,94.0,27.0,802,02,03,  Nikhari,1285,903,635,412,650,491,58.7,60.6,57.0,00000
47.0,94.0,27.0,802,03,03,  Abnali,164,217,84,109,80,108,43.0,43.5,42.6,00000
47.0,94.0,27.0,802,04,03,  Kagdi,298,243,166,123,132,120,55.1,57.4,52.4,00000
47.0,94.0,40.0,608,01,01,  Parhaji Gram,889,1720,450,920,439,800,34.1,32.8,35.4,00000
47.0,94.0,40.0,608,02,01,  Laskar Pur,1082,1376,601,756,481,620,44.0,44.3,43.7,00000
47.0,94.0,40.0,608,03,01,  Mokam Pur,1417,1912,728,974,689,938,42.6,42.8,42.3,00000
47.0,94.0,40.0,608,04,01,  Mollik Pur,1148,1100,623,592,525,508,51.1,51.3,50.8,00000
47.0,94.0,40.0,608,05,01,  Nishipur,34,48,16,39,18,9,41.5,29.1,66.7,00000
47.0,94.0,40.0,609,01,01,  Naya Barasat,710,1301,387,686,323,615,35.3,36.1,34.4,00000
47.0,94.0,40.0,609,02,01,  Kola,623,686,347,312,276,374,47.6,52.7,42.5,00000
47.0,94.0,40.0,609,03,01,  Patgati,326,324,164,160,162,164,50.2,50.6,49.7,00000
47.0,94.0,40.0,609,04,01,  Santipur,152,89,79,42,73,47,63.1,65.3,60.8,00000
47.0,94.0,40.0,609,05,01,  Madhu Pur,636,1032,308,539,328,493,38.1,36.4,40.0,00000
47.0,94.0,40.0,609,06,01,  Shyam Nagar,45,16,23,6,22,10,73.8,79.3,68.8,00000
47.0,94.0,54.0,192,01,01,  Induhati,482,510,270,232,212,278,48.6,53.8,43.3,00000
47.0,94.0,54.0,192,02,01,  Patla Kapali Para,494,252,280,101,214,151,66.2,73.5,58.6,00000
47.0,94.0,54.0,192,03,01,  Kororiya,230,222,110,118,120,104,50.9,48.2,53.6,00000
47.0,94.0,54.0,481,01,01,  Matiar Kul,110,288,58,148,52,140,27.6,28.2,27.1,00000
47.0,94.0,54.0,481,02,01,  Paschim Noliar Char,212,184,119,89,93,95,53.5,57.2,49.5,00000
47.0,94.0,54.0,481,03,01,  Purba Naliar Char,454,317,211,153,243,164,58.9,58.0,59.7,00000
47.0,94.0,54.0,481,04,01,  Musalman Para,372,812,178,403,194,409,31.4,30.6,32.2,00000
47.0,94.0,54.0,481,05,01,  Bepari Para,186,322,81,163,105,159,36.6,33.2,39.8,00000
47.0,94.0,54.0,481,06,01,  Sachiadah,851,457,478,177,373,280,65.1,73.0,57.1,00000
47.0,94.0,54.0,481,07,01,  Uttar Kamarol,696,671,375,316,321,355,50.9,54.3,47.5,00000
47.0,94.0,54.0,481,08,01,  Madhya Kamarol,269,192,144,95,125,97,58.4,60.3,56.3,00000
47.0,94.0,54.0,481,09,01,  Dakshin Kamarol,154,183,75,87,79,96,45.7,46.3,45.1,00000
47.0,94.0,54.0,481,10,01,  Patgati,384,184,206,87,178,97,67.6,70.3,64.7,00000
47.0,94.0,54.0,930,01,01,  Adalatpur,189,313,88,159,101,154,37.6,35.6,39.6,00000
47.0,94.0,54.0,930,02,01,  Nachunia,955,644,436,284,519,360,59.7,60.6,59.0,00000
47.0,94.0,54.0,930,03,01,  Chomra,154,172,84,78,70,94,47.2,51.9,42.7,00000
47.0,94.0,54.0,930,04,01,  Patla Namasudra Para,589,529,303,260,286,269,52.7,53.8,51.5,00000
47.0,94.0,54.0,930,05,01,  Char Patla,398,636,206,313,192,323,38.5,39.7,37.3,00000
47.0,94.0,54.0,930,06,01,  Boyargati,42,66,21,32,21,34,38.9,39.6,38.2,00000
47.0,94.0,54.0,930,07,01,  Kororiya,307,273,162,128,145,145,52.9,55.9,50.0,00000
47.0,94.0,67.0,096,01,01,  Basundharitala,197,257,96,126,101,131,43.4,43.2,43.5,00000
47.0,94.0,67.0,096,02,01,  Dankhali No.2,205,316,108,145,97,171,39.3,42.7,36.2,00000
47.0,94.0,67.0,353,01,01,  Ichhamati,880,1030,423,487,457,543,46.1,46.5,45.7,00000
47.0,94.0,67.0,353,02,01,  Arkandi,270,509,140,262,130,247,34.7,34.8,34.5,00000
47.0,94.0,67.0,353,03,01,  Sagiadha Bazar,87,219,42,94,45,125,28.4,30.9,26.5,00000
47.0,94.0,67.0,674,01,01,  Kusla Uttar Para,545,798,254,371,291,427,40.6,40.6,40.5,00000
47.0,94.0,67.0,674,02,01,  Dhankhali No.1,361,398,180,176,181,222,47.6,50.6,44.9,00000
47.0,94.0,67.0,674,03,01,  Char Kusla,326,180,143,88,183,92,64.4,61.9,66.5,00000
47.0,94.0,67.0,674,04,01,  Boyergati,51,58,23,25,28,33,46.8,47.9,45.9,00000
47.0,94.0,67.0,674,05,01,  Naodubi,151,110,90,51,61,59,57.9,63.8,50.8,00000
47.0,94.0,67.0,674,06,01,  Rajnagar,29,46,16,19,13,27,38.7,45.7,32.5,00000
47.0,94.0,67.0,674,07,01,  Kusla Hindupara,335,133,186,46,149,87,71.6,80.2,63.1,00000
47.0,94.0,67.0,674,08,01,  Dakshin Kusla,699,606,364,273,335,333,53.6,57.1,50.1,00000
47.0,94.0,67.0,738,01,01,  Masundia,116,207,51,103,65,104,35.9,33.1,38.5,00000
47.0,94.0,67.0,738,02,01,  Pahardanga,260,74,147,38,113,36,77.8,79.5,75.8,00000
47.0,94.0,67.0,770,01,01,  Nebudia,816,1132,418,509,398,623,41.9,45.1,39.0,00000
47.0,94.0,67.0,770,02,01,  Nolamari,78,289,39,148,39,141,21.3,20.9,21.7,00000
47.0,94.0,67.0,770,03,01,  Harikhali,169,148,80,69,89,79,53.3,53.7,53.0,00000
47.0,94.0,81.0,032,01,01,  Atlia,1630,1303,866,600,764,703,55.6,59.1,52.1,00000
47.0,94.0,81.0,032,02,01,  Arjune Bolodhorna,607,315,306,157,301,158,65.8,66.1,65.6,00000
47.0,94.0,81.0,032,03,01,  Salikdha,175,100,95,45,80,55,63.6,67.9,59.3,00000
47.0,94.0,81.0,032,04,01,  Bolodhorna,450,280,221,134,229,146,61.6,62.3,61.1,00000
47.0,94.0,81.0,032,05,01,  Adampur,670,787,371,386,299,401,46.0,49.0,42.7,00000
47.0,94.0,81.0,866,01,01,  Parkhali,311,352,168,171,143,181,46.9,49.6,44.1,00000
47.0,94.0,81.0,866,02,01,  Ram Majhi,276,194,150,86,126,108,58.7,63.6,53.8,00000
47.0,94.0,81.0,866,03,01,  Bijoynagar,42,31,20,16,22,15,57.5,55.6,59.5,00000
47.0,94.0,81.0,866,04,01,  Bil Duria,73,67,35,33,38,34,52.1,51.5,52.8,00000
47.0,94.0,81.0,866,05,01,  Phil Kilagar,55,84,29,39,26,45,39.6,42.6,36.6,00000
18.0,7.0,13.0,116,01,01,  Belgachhi,2056,2787,1047,1356,1009,1431,42.5,43.6,41.4,00000
18.0,7.0,13.0,116,02,01,  Kidarnagar,510,1339,281,634,229,705,27.6,30.7,24.5,00000
18.0,7.0,13.0,116,03,01,  Kashipur,215,342,107,162,108,180,38.6,39.8,37.5,00000
18.0,7.0,13.0,339,01,01,  Faridpur,1815,2249,934,1036,881,1213,44.7,47.4,42.1,00000
18.0,7.0,13.0,339,02,01,  Damose,295,565,164,263,131,302,34.3,38.4,30.3,00000
18.0,7.0,15.0,091,01,01,  Baradi,813,992,402,479,411,513,45.0,45.6,44.5,00000
18.0,7.0,15.0,091,02,01,  Anandabas,100,246,50,117,50,129,28.9,29.9,27.9,00000
18.0,7.0,15.0,091,03,01,  Gopalnagar,312,493,147,253,165,240,38.8,36.8,40.7,00000
18.0,7.0,15.0,729,01,01,  Natidanga,1521,1888,742,953,779,935,44.6,43.8,45.4,00000
18.0,7.0,15.0,729,02,01,  Kachikata,171,233,81,125,90,108,42.3,39.3,45.5,00000
18.0,7.0,23.0,140,01,01,  Bhangabaria,2384,3241,1228,1605,1156,1636,42.4,43.3,41.4,00000
18.0,7.0,23.0,140,02,01,  Bachamari,174,231,88,122,86,109,43.0,41.9,44.1,00000
18.0,7.0,23.0,149,01,01,  Bhogail,653,836,309,423,344,413,43.9,42.2,45.4,00000
18.0,7.0,23.0,149,02,01,  Maheshpur,994,1252,507,643,487,609,44.3,44.1,44.4,00000
18.0,7.0,23.0,389,01,01,  Khurda,437,1027,194,551,243,476,29.8,26.0,33.8,00000
18.0,7.0,23.0,389,02,01,  Gaurihrad,203,400,116,197,87,203,33.7,37.1,30.0,00000
18.0,7.0,23.0,389,03,01,  Radhanagar,102,239,49,125,53,114,29.9,28.2,31.7,00000
18.0,7.0,23.0,464,01,03,  Hat Boalia,826,793,441,384,385,409,51.0,53.5,48.5,00000
18.0,7.0,23.0,464,02,03,  Bara Boalia,661,1117,352,557,309,560,37.2,38.7,35.6,00000
18.0,7.0,23.0,472,01,01,  Hatubhanga,247,300,137,125,110,175,45.2,52.3,38.6,00000
18.0,7.0,23.0,472,02,01,  Amtail,100,169,48,86,52,83,37.2,35.8,38.5,00000
18.0,7.0,27.0,265,01,01,  Chitila,1258,924,615,451,643,473,57.7,57.7,57.6,00000
18.0,7.0,27.0,265,02,01,  Kayradanga,1343,588,714,292,629,296,69.5,71.0,68.0,00000
18.0,7.0,27.0,439,01,01,  Hapania,1730,1331,865,693,865,638,56.5,55.5,57.6,00000
18.0,7.0,27.0,439,02,01,  Noada-Hapania,319,605,162,311,157,294,34.5,34.2,34.8,00000
18.0,7.0,27.0,605,01,03,  Kulpala,1111,1125,555,526,556,599,49.7,51.3,48.1,00000
18.0,7.0,27.0,605,02,03,  Gopinagar,430,307,222,148,208,159,58.3,60.0,56.7,00000
18.0,7.0,27.0,605,03,03,  Gokul Khali,230,84,139,42,91,42,73.2,76.8,68.4,00000
18.0,7.0,27.0,895,01,01,  Ruithanpur,2128,1964,1073,959,1055,1005,52.0,52.8,51.2,00000
18.0,7.0,27.0,895,02,01,  Huda Para,576,723,271,379,305,344,44.3,41.7,47.0,00000
18.0,7.0,31.0,248,01,01,  Chhatra Para,853,1237,446,561,407,676,40.8,44.3,37.6,00000
18.0,7.0,31.0,248,02,01,  Abhaynagar,141,302,73,150,68,152,31.8,32.7,30.9,00000
18.0,7.0,31.0,298,01,01,  Dakai,1033,1276,541,585,492,691,44.7,48.0,41.6,00000
18.0,7.0,31.0,298,02,01,  Binodpur,334,1073,175,509,159,564,23.7,25.6,22.0,00000
18.0,7.0,31.0,298,03,01,  Hauspur,314,397,156,203,158,194,44.2,43.5,44.9,00000
18.0,7.0,31.0,298,04,01,  Badumaju,1227,1471,616,695,611,776,45.5,47.0,44.1,00000
18.0,7.0,31.0,298,05,01,  Puamari,239,570,120,261,119,309,29.5,31.5,27.8,00000
18.0,7.0,31.0,638,01,01,  Madhabpur,282,693,148,336,134,357,28.9,30.6,27.3,00000
18.0,7.0,31.0,638,02,01,  Bura Para,203,295,110,141,93,154,40.8,43.8,37.7,00000
18.0,7.0,39.0,364,01,01,  Bara Gangni,2592,1803,1349,958,1243,845,59.0,58.5,59.5,00000
18.0,7.0,39.0,364,02,01,  Kanainagar,355,161,181,82,174,79,68.8,68.8,68.8,00000
18.0,7.0,39.0,704,01,01,  Nandabari,1754,1368,901,704,853,664,56.2,56.1,56.2,00000
18.0,7.0,39.0,704,02,01,  Salika,1271,790,631,370,640,420,61.7,63.0,60.4,00000
18.0,7.0,39.0,704,03,01,  Asmankhali,299,157,164,75,135,82,65.6,68.6,62.2,00000
18.0,7.0,47.0,290,01,01,  Daspara,262,287,130,144,132,143,47.7,47.4,48.0,00000
18.0,7.0,47.0,290,02,01,  Baman Nagar,224,417,114,215,110,202,34.9,34.7,35.3,00000
18.0,7.0,47.0,447,01,03,  Hardi,2797,3474,1487,1672,1310,1802,44.6,47.1,42.1,00000
18.0,7.0,47.0,447,02,03,  Kuatala,138,254,73,121,65,133,35.2,37.6,32.8,00000
18.0,7.0,47.0,447,03,03,  Mohammadpur,156,386,69,207,87,179,28.8,25.0,32.7,00000
18.0,7.0,47.0,447,04,03,  Baidyanathpur,590,851,277,441,313,410,40.9,38.6,43.3,00000
18.0,7.0,47.0,447,05,03,  Char Jadabpur,489,370,267,177,222,193,56.9,60.1,53.5,00000
18.0,7.0,47.0,679,01,01,  Murbhanga Gopaldiar,486,523,230,277,256,246,48.2,45.4,51.0,00000
18.0,7.0,47.0,679,02,01,  Gopaldiar,270,557,124,285,146,272,32.6,30.3,34.9,00000
18.0,7.0,47.0,754,01,01,  Osmanpur,1591,2383,802,1189,789,1194,40.0,40.3,39.8,00000
18.0,7.0,47.0,754,02,01,  Pragpur,647,1456,353,733,294,723,30.8,32.5,28.9,00000
18.0,7.0,47.0,994,01,01,  Uttar Lakshmipur,398,711,202,350,196,361,35.9,36.6,35.2,00000
18.0,7.0,47.0,994,02,01,  Keshabpur,699,1481,362,732,337,749,32.1,33.1,31.0,00000
18.0,7.0,51.0,285,01,01,  Dhkshin Sreerampur,896,1173,469,547,427,626,43.3,46.2,40.6,00000
18.0,7.0,51.0,285,02,01,  Char Sreerampur,405,826,204,412,201,414,32.9,33.1,32.7,00000
18.0,7.0,51.0,285,03,01,  Dambal Pur,550,1007,272,511,278,496,35.3,34.7,35.9,00000
18.0,7.0,51.0,497,01,01,  Kalidas Pur,1755,1431,895,651,860,780,55.1,57.9,52.4,00000
18.0,7.0,51.0,497,02,01,  Balaram Pur,314,497,153,246,161,251,38.7,38.3,39.1,00000
18.0,7.0,51.0,815,01,01,  Parkula,1079,1269,537,624,542,645,46.0,46.3,45.7,00000
18.0,7.0,51.0,815,02,01,  Munakasa,352,447,166,231,186,216,44.1,41.8,46.3,00000
18.0,7.0,55.0,489,01,03,  Jamjami,777,1257,400,624,377,633,38.2,39.1,37.3,00000
18.0,7.0,55.0,489,02,03,  Bhadua,999,1095,509,525,490,570,47.7,49.2,46.2,00000
18.0,7.0,55.0,489,03,03,  Sohagpur,137,207,60,104,77,103,39.8,36.6,42.8,00000
18.0,7.0,55.0,489,04,03,  Naoda Hamjami,267,292,139,133,128,159,47.8,51.1,44.6,00000
18.0,7.0,55.0,721,01,01,  Narayanpur,210,437,116,220,94,217,32.5,34.5,30.2,00000
18.0,7.0,55.0,721,02,01,  Baninath,148,433,88,220,60,213,25.5,28.6,22.0,00000
18.0,7.0,55.0,771,01,01,  Puratan Panchlia,701,957,376,456,325,501,42.3,45.2,39.3,00000
18.0,7.0,55.0,771,02,01,  Maniknagar,99,188,51,95,48,93,34.5,34.9,34.0,00000
18.0,7.0,55.0,771,03,01,  Naoda Panchlia,310,505,170,239,140,266,38.0,41.6,34.5,00000
18.0,7.0,55.0,771,04,01,  Tekpara,118,143,61,66,57,77,45.2,48.0,42.5,00000
18.0,7.0,55.0,771,05,01,  Hatkhola,205,320,102,154,103,166,39.0,39.8,38.3,00000
18.0,7.0,63.0,273,01,03,  Dakshin Gobindapur,307,487,164,233,143,254,38.7,41.3,36.0,00000
18.0,7.0,63.0,273,02,03,  Dhauniganj,245,255,131,126,114,129,49.0,51.0,46.9,00000
18.0,7.0,63.0,381,01,03,  Gargari,980,1283,522,612,458,671,43.3,46.0,40.6,00000
18.0,7.0,63.0,381,02,03,  Jehala Bazar,562,191,288,83,274,108,74.6,77.6,71.7,00000
18.0,7.0,63.0,820,01,01,  Bara Puntimari,764,803,394,372,370,431,48.8,51.4,46.2,00000
18.0,7.0,63.0,820,02,01,  Chhota Puntimari,339,712,189,355,150,357,32.3,34.7,29.6,00000
18.0,7.0,71.0,099,01,01,  Batia Para,1000,629,517,318,483,311,61.4,61.9,60.8,00000
18.0,7.0,71.0,099,02,01,  Kantapur,303,90,151,36,152,54,77.1,80.7,73.8,00000
18.0,7.0,71.0,099,03,01,  Sialmari,843,481,427,235,416,246,63.7,64.5,62.8,00000
18.0,7.0,71.0,655,01,01,  Majhad,950,539,477,269,473,270,63.8,63.9,63.7,00000
18.0,7.0,71.0,655,02,01,  Krishnapur,406,580,185,286,221,294,41.2,39.3,42.9,00000
18.0,7.0,79.0,281,01,01,  Dakshin Lakshmipur,576,941,273,471,303,470,38.0,36.7,39.2,00000
18.0,7.0,79.0,281,02,01,  Roy Lakshmipur,432,772,216,384,216,388,35.9,36.0,35.8,00000
18.0,7.0,79.0,281,03,01,  Hakimpur,535,738,289,350,246,388,42.0,45.2,38.8,00000
18.0,7.0,79.0,563,01,01,  Khaskarara,1366,1701,730,758,636,943,44.5,49.1,40.3,00000
18.0,7.0,79.0,563,02,01,  Roysa,732,1374,390,667,342,707,34.8,36.9,32.6,00000
18.0,7.0,79.0,970,01,01,  Taluk Karara,259,511,136,243,123,268,33.6,35.9,31.5,00000
18.0,7.0,79.0,970,02,01,  Kabilnagar,765,1022,403,501,362,521,42.8,44.6,41.0,00000
18.0,7.0,79.0,978,01,01,  Tiarbila,702,1106,365,523,337,583,38.8,41.1,36.6,00000
18.0,7.0,79.0,978,02,01,  Bontiarbila,771,1016,379,513,392,503,43.1,42.5,43.8,00000
18.0,7.0,87.0,182,01,01,  Chak Bandabil,141,151,65,79,76,72,48.3,45.1,51.4,00000
18.0,7.0,87.0,182,02,01,  Islampur,264,234,144,99,120,135,53.0,59.3,47.1,00000
18.0,7.0,87.0,306,01,01,  Dighaldanga,82,223,37,123,45,100,26.9,23.1,31.0,00000
18.0,7.0,87.0,306,02,01,  Anandabas,42,41,23,23,19,18,50.6,50.0,51.4,00000
18.0,7.0,87.0,480,01,01,  Jadabpur,530,701,266,349,264,352,43.1,43.3,42.9,00000
18.0,7.0,87.0,480,02,01,  Gopi Ballabhpur,202,214,114,99,88,115,48.6,53.5,43.3,00000
18.0,7.0,87.0,613,01,03,  Uttar Kumari Para,609,688,319,327,290,361,47.0,49.4,44.5,00000
18.0,7.0,87.0,613,02,03,  Dakshin Kumari Para,948,1287,501,608,447,679,42.4,45.2,39.7,00000
18.0,7.0,87.0,613,03,03,  Haregari,450,578,231,277,219,301,43.8,45.5,42.1,00000
18.0,7.0,87.0,613,04,03,  Elahinagar,113,256,64,121,49,135,30.6,34.6,26.6,00000
18.0,7.0,87.0,613,05,03,  Kumari Char Para,158,262,96,113,62,149,37.6,45.9,29.4,00000
18.0,7.0,87.0,613,06,03,  Kumari Kamalpur,265,440,134,215,131,225,37.6,38.4,36.8,00000
18.0,7.0,87.0,779,01,01,  Par Durgapur,1002,787,548,391,454,396,56.0,58.4,53.4,00000
18.0,7.0,87.0,779,02,01,  Naoda Durgapur,473,641,248,307,225,334,42.5,44.7,40.3,00000
18.0,7.0,87.0,779,03,01,  Karimpur,46,56,29,21,17,35,45.1,58.0,32.7,00000
18.0,7.0,94.0,008,01,01,  Ailhas,576,1095,289,528,287,567,34.5,35.4,33.6,00000
18.0,7.0,94.0,008,02,01,  Siaserdiar,214,450,108,213,106,237,32.2,33.6,30.9,00000
18.0,7.0,94.0,058,01,01,  Baliarpur,319,1178,183,584,136,594,21.3,23.9,18.6,00000
18.0,7.0,94.0,058,02,01,  Damdama,87,202,42,101,45,101,30.1,29.4,30.8,00000
18.0,7.0,94.0,058,03,01,  Bangari,48,112,21,62,27,50,30.0,25.3,35.1,00000
18.0,7.0,94.0,165,01,01,  Bura Para,140,428,63,213,77,215,24.6,22.8,26.4,00000
18.0,7.0,94.0,165,02,01,  Mokamtala,152,338,78,172,74,166,31.0,31.2,30.8,00000
18.0,7.0,94.0,240,01,01,  Chhaygharia,135,155,73,77,62,78,46.6,48.7,44.3,00000
18.0,7.0,94.0,240,02,01,  Takpara,336,521,176,258,160,263,39.2,40.6,37.8,00000
18.0,7.0,94.0,240,03,01,  Chhaygharia Bilpura,121,190,73,90,48,100,38.9,44.8,32.4,00000
18.0,7.0,94.0,397,01,01,  Gholdari,264,460,126,244,138,216,36.5,34.1,39.0,00000
18.0,7.0,94.0,397,02,01,  Madhupur,103,206,46,106,57,100,33.3,30.3,36.3,00000
18.0,7.0,94.0,397,03,01,  Hossainpur,200,396,112,187,88,209,33.6,37.5,29.6,00000
18.0,7.0,94.0,497,01,01,  Jahanpur,547,698,280,332,267,366,43.9,45.8,42.2,00000
18.0,7.0,94.0,497,02,01,  Jorgachha,949,1915,463,924,486,991,33.1,33.4,32.9,00000
18.0,7.0,94.0,497,03,01,  Jaralnagar,324,717,160,361,164,356,31.1,30.7,31.5,00000
18.0,7.0,94.0,497,04,01,  Chilabhalki,289,438,140,208,149,230,39.8,40.2,39.3,00000
18.0,7.0,94.0,497,05,01,  Bhedamari,366,399,175,184,191,215,47.8,48.7,47.0,00000
18.0,7.0,94.0,497,06,01,  Khajurtala,631,985,342,444,289,541,39.0,43.5,34.8,00000
18.0,7.0,94.0,497,07,01,  Baragharia,144,254,67,126,77,128,36.2,34.7,37.6,00000
18.0,7.0,94.0,696,01,01,  Nagdaha,1095,1769,564,884,531,885,38.2,39.0,37.5,00000
18.0,7.0,94.0,696,02,01,  Bholardari,522,350,267,176,255,174,59.9,60.3,59.4,00000
18.0,7.0,94.0,762,01,01,  Paik Para,681,1128,353,545,328,583,37.6,39.3,36.0,00000
18.0,7.0,94.0,762,02,01,  Kuti Paik Para,154,525,66,271,88,254,22.7,19.6,25.7,00000
18.0,23.0,11.0,040,01,03,  Alokdia,1436,1651,734,785,702,866,46.5,48.3,44.8,00000
18.0,23.0,11.0,040,02,03,  Hosuk Para,338,593,174,299,164,294,36.3,36.8,35.8,00000
18.0,23.0,11.0,040,03,03,  Joraghata,213,620,107,314,106,306,25.6,25.4,25.7,00000
18.0,23.0,11.0,040,04,03,  Hatekata,1234,1107,594,508,640,599,52.7,53.9,51.7,00000
18.0,23.0,11.0,040,05,03,  Akandabaria,1287,1897,627,957,660,940,40.4,39.6,41.3,00000
18.0,23.0,11.0,743,01,03,  Manirampur,679,779,340,389,339,390,46.6,46.6,46.5,00000
18.0,23.0,11.0,743,02,03,  Rajapur,860,704,440,355,420,349,55.0,55.3,54.6,00000
18.0,23.0,11.0,743,03,03,  Pitambarpur,739,859,347,452,392,407,46.2,43.4,49.1,00000
18.0,23.0,11.0,743,04,03,  Daulatdiar,4613,3244,2417,1526,2196,1718,58.7,61.3,56.1,00000
18.0,23.0,23.0,391,01,01,  Fursetpur,345,775,153,393,192,382,30.8,28.0,33.4,00000
18.0,23.0,23.0,391,02,01,  Harishpur,432,923,194,455,238,468,31.9,29.9,33.7,00000
18.0,23.0,23.0,653,01,01,  Kotali,299,717,140,359,159,358,29.4,28.1,30.8,00000
18.0,23.0,23.0,653,02,01,  Nalbila,86,202,32,106,54,96,29.9,23.2,36.0,00000
18.0,23.0,47.0,030,01,01,  Aliarpur,825,423,503,203,322,220,66.1,71.2,59.4,00000
18.0,23.0,47.0,030,02,01,  Jibna,397,453,186,221,211,232,46.7,45.7,47.6,00000
18.0,23.0,47.0,201,01,01,  Boalia,1787,2155,943,1013,844,1142,45.3,48.2,42.5,00000
18.0,23.0,47.0,201,02,01,  Jalibila,539,457,274,216,265,241,54.1,55.9,52.4,00000
18.0,23.0,47.0,201,03,01,  Jadabpur,520,374,266,172,254,202,58.2,60.7,55.7,00000
18.0,23.0,47.0,201,04,01,  Nabinagar,861,1028,438,477,423,551,45.6,47.9,43.4,00000
18.0,23.0,47.0,321,01,01,  Dattail,241,561,135,256,106,305,30.0,34.5,25.8,00000
18.0,23.0,47.0,321,02,01,  Ashanandapur,184,442,87,220,97,222,29.4,28.3,30.4,00000
18.0,23.0,47.0,894,01,01,  Sinduria,350,566,187,285,163,281,38.2,39.6,36.7,00000
18.0,23.0,47.0,894,02,03,  Martujapur,456,923,225,457,231,466,33.1,33.0,33.1,00000
18.0,23.0,47.0,894,03,03,  Shibpur,96,214,49,104,47,110,31.0,32.0,29.9,00000
18.0,23.0,59.0,251,01,01,  Chandpur,169,335,85,168,84,167,33.5,33.6,33.5,00000
18.0,23.0,59.0,251,02,01,  Tangramari,169,290,81,148,88,142,36.8,35.4,38.3,00000
18.0,23.0,59.0,251,03,01,  Shailgari,403,568,198,265,205,303,41.5,42.8,40.4,00000
18.0,23.0,59.0,251,04,01,  Khejurtala,223,587,122,271,101,316,27.5,31.0,24.2,00000
18.0,23.0,59.0,613,01,01,  Kobikhali,167,632,77,328,90,304,20.9,19.0,22.8,00000
18.0,23.0,59.0,613,02,01,  Maserdari,233,398,130,187,103,211,36.9,41.0,32.8,00000
18.0,23.0,59.0,613,03,01,  Kathuli,473,797,250,394,223,403,37.2,38.8,35.6,00000
18.0,23.0,59.0,904,01,03,  Maminpur,438,425,235,193,203,232,50.8,54.9,46.7,00000
18.0,23.0,59.0,904,02,03,  Nilmaniganj,237,154,122,77,115,77,60.6,61.3,59.9,00000
18.0,23.0,59.0,904,03,03,  Amirpur,382,856,179,407,203,449,30.9,30.5,31.1,00000
18.0,23.0,62.0,020,01,01,  Aliarnagar Baliakandi,833,1157,435,565,398,592,41.9,43.5,40.2,00000
18.0,23.0,62.0,020,02,01,  Nimtali,355,596,197,286,158,310,37.3,40.8,33.8,00000
18.0,23.0,62.0,331,01,01,  Dhuturhat,619,620,308,317,311,303,50.0,49.3,50.7,00000
18.0,23.0,62.0,331,02,01,  Jheelkhali,273,296,137,162,136,134,48.0,45.8,50.4,00000
18.0,23.0,62.0,542,01,01,  Hogladanga,266,354,124,187,142,167,42.9,39.9,46.0,00000
18.0,23.0,62.0,542,02,01,  Perojkhali,796,791,385,394,411,397,50.2,49.4,50.9,00000
18.0,23.0,62.0,542,03,01,  Kushadanga,254,421,144,213,110,208,37.6,40.3,34.6,00000
18.0,23.0,62.0,924,01,01,  Subdia,1150,1564,585,775,565,789,42.4,43.0,41.7,00000
18.0,23.0,62.0,924,02,01,  Baghnagar,328,331,145,175,183,156,49.8,45.3,54.0,00000
18.0,23.0,71.0,060,01,01,  Bahalgachhi,127,415,65,204,62,211,23.4,24.2,22.7,00000
18.0,23.0,71.0,060,02,01,  Kirongachi,269,373,135,174,134,199,41.9,43.7,40.2,00000
18.0,23.0,71.0,060,03,01,  Jadabpur,110,396,55,199,55,197,21.7,21.7,21.8,00000
18.0,23.0,71.0,160,01,01,  Bhandar Daha,441,746,236,358,205,388,37.2,39.7,34.6,00000
18.0,23.0,71.0,160,02,01,  Natun Bhandar Daha,622,1133,310,556,312,577,35.4,35.8,35.1,00000
18.0,23.0,71.0,592,01,03,  Jogirhuda,914,927,491,434,423,493,49.6,53.1,46.2,00000
18.0,23.0,71.0,592,02,03,  Mill Para,171,164,84,83,87,81,51.0,50.3,51.8,00000
18.0,23.0,83.0,281,01,01,  Chhota Salua,910,1866,432,938,478,928,32.8,31.5,34.0,00000
18.0,23.0,83.0,281,02,01,  Baldia Para,547,1066,277,552,270,514,33.9,33.4,34.4,00000
18.0,23.0,83.0,402,01,01,  Gaherpur,912,708,477,342,435,366,56.3,58.2,54.3,00000
18.0,23.0,83.0,402,02,01,  Bittir Dair,88,179,38,93,50,86,33.0,29.0,36.8,00000
18.0,23.0,83.0,623,01,01,  Kharagoda,674,730,346,346,328,384,48.0,50.0,46.1,00000
18.0,23.0,83.0,623,02,01,  Jamalpur,229,141,107,71,122,70,61.9,60.1,63.5,00000
18.0,23.0,83.0,874,01,01,  Sarabaria,662,1580,309,801,353,779,29.5,27.8,31.2,00000
18.0,23.0,83.0,874,02,01,  Khas Para,543,560,252,287,291,273,49.2,46.8,51.6,00000
18.0,23.0,83.0,949,01,01,  Tegharia,1049,896,556,433,493,463,53.9,56.2,51.6,00000
18.0,23.0,83.0,949,02,01,  Kalagachhi,193,156,110,72,83,84,55.3,60.4,49.7,00000
18.0,23.0,83.0,974,01,03,  Titudaha,781,961,383,483,398,478,44.8,44.2,45.4,00000
18.0,23.0,83.0,974,02,03,  Houliamari,634,772,348,359,286,413,45.1,49.2,40.9,00000
18.0,31.0,11.0,012,01,01,  Napitkhali,698,755,340,374,358,381,48.0,47.6,48.4,00000
18.0,31.0,11.0,012,02,01,  Badanpur,305,638,140,335,165,303,32.3,29.5,35.3,00000
18.0,31.0,11.0,306,01,03,  Damurhuda,1914,1666,971,809,943,857,53.5,54.6,52.4,00000
18.0,31.0,11.0,306,02,03,  Keshabpur,279,691,134,355,145,336,28.8,27.4,30.1,00000
18.0,31.0,11.0,331,01,01,  Dewli,936,843,488,428,448,415,52.6,53.3,51.9,00000
18.0,31.0,11.0,331,02,01,  Par Damurhuda,219,336,125,164,94,172,39.5,43.3,35.3,00000
18.0,31.0,11.0,969,01,01,  Ujirpur,1642,2492,838,1309,804,1183,39.7,39.0,40.5,00000
18.0,31.0,11.0,969,02,01,  Fakir Para,734,719,382,354,352,365,50.5,51.9,49.1,00000
18.0,31.0,23.0,165,01,01,  Chhaygharia,789,906,399,455,390,451,46.5,46.7,46.4,00000
18.0,31.0,23.0,165,02,01,  Jhajhadanga,351,634,158,323,193,311,35.6,32.8,38.3,00000
18.0,31.0,23.0,612,01,01,  Kamar Para,621,449,298,224,323,225,58.0,57.1,58.9,00000
18.0,31.0,23.0,612,02,01,  Nastipur,477,902,238,455,239,447,34.6,34.3,34.8,00000
18.0,31.0,35.0,063,01,01,  Puratan Bastupur,1148,1334,561,680,587,654,46.3,45.2,47.3,00000
18.0,31.0,35.0,063,02,01,  Natun Bastupur,740,1138,369,582,371,556,39.4,38.8,40.0,00000
18.0,31.0,35.0,344,01,03,  Bara Dudpatila,717,1399,375,682,342,717,33.9,35.5,32.3,00000
18.0,31.0,35.0,344,02,03,  Chhota Dudpatila,470,897,232,444,238,453,34.4,34.3,34.4,00000
18.0,31.0,35.0,510,01,01,  Puratan Howli,330,940,146,496,184,444,26.0,22.7,29.3,00000
18.0,31.0,35.0,510,02,01,  Natun Howli,385,537,194,275,191,262,41.8,41.4,42.2,00000
18.0,31.0,35.0,574,01,01,  Joyrampur,6194,6713,3097,3310,3097,3403,48.0,48.3,47.6,00000
18.0,31.0,35.0,574,02,01,  Dugdugi,769,662,400,300,369,362,53.7,57.1,50.5,00000
18.0,31.0,35.0,574,03,01,  Tarinpur,332,656,178,327,154,329,33.6,35.2,31.9,00000
18.0,31.0,35.0,739,01,03,  Loknathpur,2065,1583,1031,752,1034,831,56.6,57.8,55.4,00000
18.0,31.0,35.0,739,02,03,  Kadipur,758,1102,377,553,381,549,40.8,40.5,41.0,00000
18.0,31.0,35.0,739,03,03,  Gobindapur,541,705,279,355,262,350,43.4,44.0,42.8,00000
18.0,31.0,35.0,739,04,03,  Rudranagar,476,554,226,287,250,267,46.2,44.1,48.4,00000
18.0,31.0,47.0,586,01,01,  Juranpur,1152,2118,558,1085,594,1033,35.2,34.0,36.5,00000
18.0,31.0,47.0,586,02,01,  Majarpota,328,410,168,209,160,201,44.4,44.6,44.3,00000
18.0,31.0,47.0,867,01,01,  Ramnagar,1026,1267,530,634,496,633,44.7,45.5,43.9,00000
18.0,31.0,47.0,867,02,01,  Gopinathpur,251,449,123,219,128,230,35.9,36.0,35.8,00000
18.0,31.0,59.0,025,01,01,  Baghadanga,636,1042,300,534,336,508,37.9,36.0,39.8,00000
18.0,31.0,59.0,025,02,01,  Kanchantala,164,189,84,95,80,94,46.5,46.9,46.0,00000
18.0,31.0,59.0,523,01,01,  Huda Para,596,1358,269,691,327,667,30.5,28.0,32.9,00000
18.0,31.0,59.0,523,02,01,  Jahajpota,135,128,61,67,74,61,51.3,47.7,54.8,00000
18.0,31.0,59.0,625,01,01,  Kanaidanga,1337,2048,660,1019,677,1029,39.5,39.3,39.7,00000
18.0,31.0,59.0,625,02,01,  Boyra,212,264,107,130,105,134,44.5,45.1,43.9,00000
18.0,31.0,59.0,637,01,01,  Karpasdanga,2963,2460,1477,1233,1486,1227,54.6,54.5,54.8,00000
18.0,31.0,59.0,637,02,01,  Aramdanga,990,1180,501,605,489,575,45.6,45.3,46.0,00000
18.0,31.0,59.0,637,03,01,  Mishan Para,638,427,331,204,307,223,59.9,61.9,57.9,00000
18.0,31.0,59.0,637,04,01,  Osmanpur,116,157,52,82,64,75,42.5,38.8,46.0,00000
18.0,31.0,59.0,694,01,01,  Subalpur,1286,1610,599,834,687,776,44.4,41.8,47.0,00000
18.0,31.0,59.0,694,02,01,  Kanchantala,85,118,41,58,44,60,41.9,41.4,42.3,00000
18.0,31.0,59.0,778,01,01,  Munshipur,947,1290,476,631,471,659,42.3,43.0,41.7,00000
18.0,31.0,59.0,778,02,01,  Jahajpota,288,383,143,196,145,187,42.9,42.2,43.7,00000
18.0,31.0,59.0,778,03,01,  Kutubpur,2219,2651,1048,1368,1171,1283,45.6,43.4,47.7,00000
18.0,31.0,71.0,701,01,01,  Kuralgachhi,2259,3343,1184,1589,1075,1754,40.3,42.7,38.0,00000
18.0,31.0,71.0,701,02,01,  Dhanagahara,811,1128,379,559,432,569,41.8,40.4,43.2,00000
18.0,31.0,71.0,701,03,01,  Harish Chandrapur,514,775,259,392,255,383,39.9,39.8,40.0,00000
18.0,31.0,71.0,701,04,01,  Amdanga,69,222,42,109,27,113,23.7,27.8,19.3,00000
18.0,31.0,71.0,956,01,01,  Thakurpur,689,2318,358,1156,331,1162,22.9,23.6,22.2,00000
18.0,31.0,71.0,956,02,01,  Osmanpur,194,62,101,24,93,38,75.8,80.8,71.0,00000
18.0,31.0,83.0,216,01,01,  Charulia,818,1981,414,948,404,1033,29.2,30.4,28.1,00000
18.0,31.0,83.0,216,02,01,  Chhatantala,543,846,256,422,287,424,39.1,37.8,40.4,00000
18.0,31.0,83.0,216,03,01,  Kunia,363,826,158,445,205,381,30.5,26.2,35.0,00000
18.0,31.0,83.0,790,01,01,  Natipota,867,1206,421,614,446,592,41.8,40.7,43.0,00000
18.0,31.0,83.0,790,02,01,  Bhagirathpur,726,1173,372,576,354,597,38.2,39.2,37.2,00000
18.0,31.0,83.0,790,03,01,  Chhutipur,687,1146,341,575,346,571,37.5,37.2,37.7,00000
18.0,31.0,83.0,790,04,01,  Potar Para,253,699,113,362,140,337,26.6,23.8,29.4,00000
18.0,55.0,19.0,028,01,01,  Andulbaria,3483,3746,1729,1808,1754,1938,48.2,48.9,47.5,00000
18.0,55.0,19.0,028,02,01,  Pokamari,86,65,43,35,43,30,57.0,55.1,58.9,00000
18.0,55.0,19.0,383,01,01,  Karchadanga,523,703,268,329,255,374,42.7,44.9,40.5,00000
18.0,55.0,19.0,383,02,01,  Kubrigari,286,417,141,210,145,207,40.7,40.2,41.2,00000
18.0,55.0,38.0,071,01,01,  Banka,1577,1844,782,917,795,927,46.1,46.0,46.2,00000
18.0,55.0,38.0,071,02,01,  Banka Math Para,587,462,312,195,275,267,56.0,61.5,50.7,00000
18.0,55.0,38.0,099,01,01,  Barandi,380,558,180,283,200,275,40.5,38.9,42.1,00000
18.0,55.0,38.0,099,02,01,  Barandi Math Para,228,395,110,189,118,206,36.6,36.8,36.4,00000
18.0,55.0,38.0,270,01,03,  Jafrabajpur,488,808,263,397,225,411,37.7,39.8,35.4,00000
18.0,55.0,38.0,270,02,03,  Magh Para Bazar,1184,681,649,326,535,355,63.5,66.6,60.1,00000
18.0,55.0,38.0,270,03,03,  Ghushi Para,194,249,90,115,104,134,43.8,43.9,43.7,00000
18.0,55.0,38.0,270,04,03,  Karimpur,194,200,88,106,106,94,49.2,45.4,53.0,00000
18.0,55.0,38.0,270,05,03,  Taranibas,591,219,314,85,277,134,73.0,78.7,67.4,00000
18.0,55.0,38.0,568,01,01,  Marupdaha,407,617,194,312,213,305,39.7,38.3,41.1,00000
18.0,55.0,38.0,568,02,01,  Dholemari,381,191,202,88,179,103,66.6,69.7,63.5,00000
18.0,55.0,38.0,596,01,01,  Minajpur,623,939,311,455,312,484,39.9,40.6,39.2,00000
18.0,55.0,38.0,596,02,01,  Minajpur Math Para,369,518,200,252,169,266,41.6,44.2,38.9,00000
18.0,55.0,38.0,810,01,01,  Balihuda,803,774,413,394,390,380,50.9,51.2,50.6,00000
18.0,55.0,38.0,810,02,01,  Natun Chakla,497,378,247,209,250,169,56.8,54.2,59.7,00000
18.0,55.0,38.0,810,03,01,  Puratan Chakla,522,670,243,331,279,339,43.8,42.3,45.1,00000
18.0,55.0,38.0,810,04,01,  Roypur,922,1032,479,507,443,525,47.2,48.6,45.8,00000
18.0,55.0,57.0,980,01,01,  Gayeshpur,1076,1936,530,976,546,960,35.7,35.2,36.3,00000
18.0,55.0,57.0,980,02,01,  Goal Para,910,1922,437,935,473,987,32.1,31.9,32.4,00000
18.0,55.0,57.0,980,03,01,  Natun Para,329,1023,166,536,163,487,24.3,23.6,25.1,00000
18.0,55.0,57.0,980,04,01,  Sadar Para,197,609,97,286,100,323,24.4,25.3,23.6,00000
18.0,55.0,76.0,412,01,01,  Kashipur,1791,3228,888,1617,903,1611,35.7,35.4,35.9,00000
18.0,55.0,76.0,412,02,01,  Kashipur Mathpara,610,580,300,276,310,304,51.3,52.1,50.5,00000
18.0,55.0,76.0,525,01,01,  Madhabkhali,585,393,291,203,294,190,59.8,58.9,60.7,00000
18.0,55.0,76.0,525,02,01,  Chatenga,436,365,211,182,225,183,54.4,53.7,55.1,00000
18.0,55.0,76.0,781,01,01,  Rajapur,334,316,176,155,158,161,51.4,53.2,49.5,00000
18.0,55.0,76.0,781,02,01,  Manikpur,313,594,158,285,155,309,34.5,35.7,33.4,00000
18.0,55.0,76.0,994,01,03,  Uthali,2179,2748,1111,1337,1068,1411,44.2,45.4,43.1,00000
18.0,55.0,76.0,994,02,03,  Sialmari,52,324,27,159,25,165,13.8,14.5,13.2,00000
18.0,55.0,76.0,994,03,03,  Ektarpur,399,436,196,229,203,207,47.8,46.1,49.5,00000
65.0,28.0,13.0,078,02,01,  Narsingpur,7,22,4,10,3,12,24.1,28.6,20.0,00000
65.0,28.0,13.0,078,03,01,  Singerdanga,158,127,80,64,78,63,55.4,55.6,55.3,00000
65.0,28.0,13.0,438,01,01,  Hachla,724,437,374,206,350,231,62.4,64.5,60.2,00000
65.0,28.0,13.0,438,02,01,  Patkhilbari,689,186,328,84,361,102,78.7,79.6,78.0,00000
65.0,28.0,13.0,438,03,01,  Kalukhali,265,494,154,215,111,279,34.9,41.7,28.5,00000
65.0,28.0,14.0,068,01,01,  Rajapur,503,251,251,122,252,129,66.7,67.3,66.1,00000
65.0,28.0,14.0,068,02,01,  Boranal,534,827,252,412,282,415,39.2,38.0,40.5,00000
65.0,28.0,14.0,068,03,01,  Kunjapur,220,386,110,190,110,196,36.3,36.7,35.9,00000
65.0,28.0,14.0,068,04,01,  Bhabanipur,57,12,29,5,28,7,82.6,85.3,80.0,00000
65.0,28.0,14.0,317,01,03,  Chandinagar,331,391,174,202,157,189,45.8,46.3,45.4,00000
65.0,28.0,14.0,317,02,03,  Hedayetpur,151,240,82,125,69,115,38.6,39.6,37.5,00000
65.0,28.0,14.0,317,03,03,  Bildhuria,299,441,161,203,138,238,40.4,44.2,36.7,00000
65.0,28.0,14.0,565,01,01,  Bijoynagar,56,64,36,39,20,25,46.7,48.0,44.4,00000
65.0,28.0,14.0,565,02,01,  Mathabhanga,177,213,79,120,98,93,45.4,39.7,51.3,00000
65.0,28.0,15.0,165,01,01,  Bauisena,1482,932,749,433,733,499,61.4,63.4,59.5,00000
65.0,28.0,15.0,165,02,01,  Par Bauisena,638,980,303,465,335,515,39.4,39.5,39.4,00000
65.0,28.0,15.0,165,03,01,  Kanaipur,112,34,62,12,50,22,76.7,83.8,69.4,00000
65.0,28.0,15.0,165,04,01,  Khalishakhali,135,56,69,29,66,27,70.7,70.4,71.0,00000
65.0,28.0,15.0,390,01,01,  Uttar Dumaria,695,859,313,425,382,434,44.7,42.4,46.8,00000
65.0,28.0,15.0,390,02,01,  Dakshin Dumaria,1060,337,516,146,544,191,75.9,77.9,74.0,00000
65.0,28.0,15.0,390,03,01,  Ramnagar,256,135,139,66,117,69,65.5,67.8,62.9,00000
65.0,28.0,15.0,390,04,01,  Fulbadina,268,105,135,42,133,63,71.8,76.3,67.9,00000
65.0,28.0,15.0,390,05,01,  Khaljogania,153,205,91,89,62,116,42.7,50.6,34.8,00000
65.0,28.0,15.0,390,06,01,  Nalamara,576,658,300,294,276,364,46.7,50.5,43.1,00000
65.0,28.0,15.0,390,07,01,  Madhupur,145,171,74,83,71,88,45.9,47.1,44.7,00000
65.0,28.0,15.0,468,01,01,  Jogania,1834,2134,944,1005,890,1129,46.2,48.4,44.1,00000
65.0,28.0,15.0,468,02,01,  Dutkora,317,578,171,278,146,300,35.4,38.1,32.7,00000
65.0,28.0,15.0,468,03,01,  Sarippur,203,241,105,109,98,132,45.7,49.1,42.6,00000
65.0,28.0,23.0,643,01,01,  Madhabpasa,1109,1228,553,599,556,629,47.5,48.0,46.9,00000
65.0,28.0,23.0,643,02,01,  Pukurkul,99,127,47,63,52,64,43.8,42.7,44.8,00000
65.0,28.0,23.0,682,01,01,  Madhanganti,153,207,76,106,77,101,42.5,41.8,43.3,00000
65.0,28.0,23.0,682,02,01,  Ramanandapur,262,257,143,111,119,146,50.5,56.3,44.9,00000
65.0,28.0,31.0,146,01,01,  Banagram,671,336,356,153,315,183,66.6,69.9,63.3,00000
65.0,28.0,31.0,146,02,01,  Kaldanga,791,194,442,78,349,116,80.3,85.0,75.1,00000
65.0,28.0,31.0,146,03,01,  Dadhantala,292,224,148,112,144,112,56.6,56.9,56.3,00000
65.0,28.0,31.0,253,01,01,  Chanchari,856,568,447,253,409,315,60.1,63.9,56.5,00000
65.0,28.0,31.0,253,02,01,  Dahar Chachari,154,349,79,170,75,179,30.6,31.7,29.5,00000
65.0,28.0,31.0,269,01,01,  Chapulia,248,192,114,92,134,100,56.4,55.3,57.3,00000
65.0,28.0,31.0,269,02,01,  Langalia,66,92,39,43,27,49,41.8,47.6,35.5,00000
65.0,28.0,39.0,429,01,01,  Gachhbaria,995,424,512,178,483,246,70.1,74.2,66.3,00000
65.0,28.0,39.0,429,02,01,  Gharibhanga,259,89,129,32,130,57,74.4,80.1,69.5,00000
65.0,28.0,39.0,429,03,01,  Bawrir Char,133,27,79,3,54,24,83.1,96.3,69.2,00000
65.0,28.0,39.0,458,01,01,  Joynagar,347,248,181,108,166,140,58.3,62.6,54.2,00000
65.0,28.0,39.0,458,02,01,  Pani Para,735,562,365,258,370,304,56.7,58.6,54.9,00000
65.0,28.0,47.0,175,01,01,  Uttar Bilaphar,112,92,53,43,59,49,54.9,55.2,54.6,00000
65.0,28.0,47.0,175,02,01,  Gauripur,206,135,104,61,102,74,60.4,63.0,58.0,00000
65.0,28.0,47.0,175,03,01,  Nidhipur,366,224,173,101,193,123,62.0,63.1,61.1,00000
65.0,28.0,47.0,175,04,01,  Kholishakhali,61,29,32,13,29,16,67.8,71.1,64.4,00000
65.0,28.0,47.0,175,05,01,  Shyamnagar,25,29,14,12,11,17,46.3,53.8,39.3,00000
65.0,28.0,47.0,175,06,01,  Dakshin Bilayar,41,45,20,21,21,24,47.7,48.8,46.7,00000
65.0,28.0,47.0,175,07,01,  Ghorakhali,28,25,17,11,11,14,52.8,60.7,44.0,00000
65.0,28.0,47.0,175,08,01,  Padmabila,165,384,91,200,74,184,30.1,31.3,28.7,00000
65.0,28.0,47.0,243,01,01,  Chalna,447,208,236,90,211,118,68.2,72.4,64.1,00000
65.0,28.0,47.0,243,02,01,  Lakshmipur,178,211,93,94,85,117,45.8,49.7,42.1,00000
65.0,28.0,47.0,243,03,01,  Harishpur,193,137,109,63,84,74,58.5,63.4,53.2,00000
65.0,28.0,47.0,243,04,01,  Kashipur,192,105,99,53,93,52,64.6,65.1,64.1,00000
65.0,28.0,47.0,517,01,01,  Kalabaria,3038,2066,1452,948,1586,1118,59.5,60.5,58.7,00000
65.0,28.0,47.0,517,02,01,  Kalinagar,705,509,345,235,360,274,58.1,59.5,56.8,00000
65.0,28.0,47.0,517,03,01,  Shibpur,111,94,64,38,47,56,54.1,62.7,45.6,00000
65.0,28.0,47.0,565,01,01,  Kanduri,426,421,198,218,228,203,50.3,47.6,52.9,00000
65.0,28.0,47.0,565,02,01,  Aizpara,278,198,157,90,121,108,58.4,63.6,52.8,00000
65.0,28.0,47.0,565,03,01,  Sreenagar,199,175,76,100,123,75,53.2,43.2,62.1,00000
65.0,28.0,47.0,565,04,01,  Ghanashyampur,56,47,32,26,24,21,54.4,55.2,53.3,00000
65.0,28.0,47.0,585,01,01,  Khamar,70,40,32,20,38,20,63.6,61.5,65.5,00000
65.0,28.0,47.0,585,02,01,  Baledanga,62,37,35,18,27,19,62.6,66.0,58.7,00000
65.0,28.0,47.0,585,03,01,  Parkhali,74,30,42,12,32,18,71.2,77.8,64.0,00000
65.0,28.0,63.0,819,01,01,  Patna,856,287,448,124,408,163,74.9,78.3,71.5,00000
65.0,28.0,63.0,819,02,01,  Brahman Patna,516,323,269,143,247,180,61.5,65.3,57.8,00000
65.0,28.0,63.0,946,01,01,  Pechi Dumuria,294,90,134,37,160,53,76.6,78.4,75.1,00000
65.0,28.0,63.0,946,02,01,  Talbaria,242,23,128,10,114,13,91.3,92.8,89.8,00000
65.0,28.0,71.0,087,02,01,  Gobradanga,157,147,74,71,83,76,51.6,51.0,52.2,00000
65.0,28.0,71.0,419,01,01,  Gandhabaria,217,94,112,38,105,56,69.8,74.7,65.2,00000
65.0,28.0,71.0,419,02,01,  Islampur,629,247,313,112,316,135,71.8,73.6,70.1,00000
65.0,28.0,71.0,673,01,01,  Mauli,2049,843,1037,371,1012,472,70.9,73.7,68.2,00000
65.0,28.0,71.0,673,02,01,  Chandar Char,554,464,275,226,279,238,54.4,54.9,54.0,00000
65.0,28.0,79.0,136,01,01,  Ballahati,365,456,180,225,185,231,44.5,44.4,44.5,00000
65.0,28.0,79.0,136,02,01,  Dar Ballahati,204,264,97,137,107,127,43.6,41.5,45.7,00000
65.0,28.0,79.0,692,01,01,  Mulasree,575,435,296,194,279,241,56.9,60.4,53.7,00000
65.0,28.0,79.0,692,02,01,  Char Madhupur,239,229,105,123,134,106,51.1,46.1,55.8,00000
65.0,28.0,87.0,595,01,01,  Khoraria,3427,2724,1680,1323,1747,1401,55.7,55.9,55.5,00000
65.0,28.0,87.0,595,02,01,  Jadabpur,1069,1064,560,504,509,560,50.1,52.6,47.6,00000
65.0,28.0,87.0,595,03,01,  Kadamtala,813,639,385,317,428,322,56.0,54.8,57.1,00000
65.0,28.0,87.0,595,04,01,  Mahiskhola,1070,399,546,180,524,219,72.8,75.2,70.5,00000
65.0,28.0,87.0,595,05,01,  Pateshwari,319,370,153,187,166,183,46.3,45.0,47.6,00000
65.0,28.0,87.0,595,06,01,  Jamrildanga,1830,1663,890,770,940,893,52.4,53.6,51.3,00000
65.0,28.0,87.0,595,07,01,  Gangarampur,286,198,134,95,152,103,59.1,58.5,59.6,00000
65.0,28.0,87.0,829,01,03,  Peruli,2101,2191,1004,1067,1097,1124,49.0,48.5,49.4,00000
65.0,28.0,87.0,829,02,03,  Satbaria,373,444,184,229,189,215,45.7,44.6,46.8,00000
65.0,28.0,87.0,829,03,03,  Perulisthan,530,297,265,137,265,160,64.1,65.9,62.4,00000
65.0,28.0,94.0,536,01,01,  Kalamankhali,558,305,294,118,264,187,64.7,71.4,58.5,00000
65.0,28.0,94.0,536,02,01,  Amtala,500,633,266,297,234,336,44.1,47.2,41.1,00000
65.0,28.0,94.0,848,01,01,  Purulia,1210,1032,628,490,582,542,54.0,56.2,51.8,00000
65.0,28.0,94.0,848,02,01,  Chandrapur,450,342,268,207,182,135,56.8,56.4,57.4,00000
65.0,28.0,94.0,848,03,01,  Lakshmipur,122,137,67,57,55,80,47.1,54.0,40.7,00000
65.0,28.0,94.0,848,04,01,  Ragunathpur,1158,1513,548,691,610,822,43.4,44.2,42.6,00000
65.0,28.0,94.0,848,05,01,  Chandpur,591,308,277,150,314,158,65.7,64.9,66.5,00000
65.0,28.0,95.0,126,01,01,  Baladanga,89,213,61,102,28,111,29.5,37.4,20.1,00000
65.0,28.0,95.0,126,02,01,  Naldanga,52,137,29,65,23,72,27.5,30.9,24.2,00000
65.0,28.0,95.0,126,03,01,  Munshinagar,2,2,2,0,0,2,50.0,100.0,0.0,00000
65.0,28.0,95.0,126,04,01,  Baidhyabati,107,131,60,60,47,71,45.0,50.0,39.8,00000
65.0,28.0,95.0,126,05,01,  Aka,781,363,414,167,367,196,68.3,71.3,65.2,00000
65.0,28.0,95.0,222,01,03,  Bahirdanga,294,534,132,287,162,247,35.5,31.5,39.6,00000
65.0,28.0,95.0,222,02,03,  Bil Bauchh,686,632,337,298,349,334,52.0,53.1,51.1,00000
65.0,28.0,95.0,222,03,03,  Das Newra,66,32,34,18,32,14,67.3,65.4,69.6,00000
65.0,28.0,95.0,317,02,03,  Harishpur,125,168,71,89,54,79,42.7,44.4,40.6,00000
65.0,28.0,95.0,317,03,03,  Joypur,551,739,269,380,282,359,42.7,41.4,44.0,00000
65.0,28.0,95.0,360,01,01,  Dhusahati,341,306,175,135,166,171,52.7,56.5,49.3,00000
65.0,28.0,95.0,360,02,01,  Roypur,137,142,63,64,74,78,49.1,49.6,48.7,00000
65.0,28.0,95.0,360,03,01,  Bahuri Char,119,123,65,59,54,64,49.2,52.4,45.8,00000
65.0,28.0,95.0,477,01,01,  Joka,333,434,191,209,142,225,43.4,47.8,38.7,00000
65.0,28.0,95.0,477,02,01,  Jokar Char,447,443,227,218,220,225,50.2,51.0,49.4,00000
65.0,52.0,15.0,287,01,01,  Dighalia,3030,1564,1477,675,1553,889,66.0,68.6,63.6,00000
65.0,52.0,15.0,287,02,01,  Char Dighalia,800,423,369,163,431,260,65.4,69.4,62.4,00000
65.0,52.0,18.0,293,01,01,  Daulatpur,266,156,121,62,145,94,63.0,66.1,60.7,00000
65.0,52.0,18.0,293,02,01,  Char Daulatpur,489,433,245,194,244,239,53.0,55.8,50.5,00000
65.0,52.0,18.0,293,03,01,  Dikrir Char,567,565,242,279,325,286,50.1,46.4,53.2,00000
65.0,52.0,18.0,293,04,01,  Fakirer Char,562,472,267,212,295,260,54.4,55.7,53.2,00000
65.0,52.0,18.0,387,01,01,  Itna,3280,1942,1521,876,1759,1066,62.8,63.5,62.3,00000
65.0,52.0,18.0,387,02,01,  Kumardanga,1186,998,586,501,600,497,54.3,53.9,54.7,00000
65.0,52.0,18.0,387,03,01,  Bara Para,20,31,8,13,12,18,39.2,38.1,40.0,00000
65.0,52.0,18.0,587,01,01,  Uttar Lankar Char,713,622,323,280,390,342,53.4,53.6,53.3,00000
65.0,52.0,18.0,587,02,01,  Dakshin Lankar Char,479,255,216,112,263,143,65.3,65.9,64.8,00000
65.0,52.0,18.0,587,03,01,  Par Lankar Char,412,488,189,220,223,268,45.8,46.2,45.4,00000
65.0,52.0,18.0,794,01,01,  Uttar Pankhar Char,974,232,446,97,528,135,80.8,82.1,79.6,00000
65.0,52.0,18.0,794,02,01,  Dakshin Pankhar Char,880,567,395,253,485,314,60.8,61.0,60.7,00000
65.0,52.0,23.0,026,01,01,  Ariara,367,421,183,195,184,226,46.6,48.4,44.9,00000
65.0,52.0,23.0,026,02,01,  Char Ariara,520,639,225,265,295,374,44.9,45.9,44.1,00000
65.0,52.0,23.0,180,01,01,  Chachai,2294,1287,1057,592,1237,695,64.1,64.1,64.0,00000
65.0,52.0,23.0,180,02,01,  Dhanair,694,379,299,158,395,221,64.7,65.4,64.1,00000
65.0,52.0,23.0,400,01,01,  Joypur,1829,344,898,147,931,197,84.2,85.9,82.5,00000
65.0,52.0,23.0,400,02,01,  Narandia,338,72,176,27,162,45,82.4,86.7,78.3,00000
65.0,52.0,23.0,400,03,01,  Purulia,47,20,23,9,24,11,70.1,71.9,68.6,00000
65.0,52.0,31.0,133,01,01,  Batgati,83,48,43,18,40,30,63.4,70.5,57.1,00000
65.0,52.0,31.0,133,02,01,  Barua Para,64,32,33,14,31,18,66.7,70.2,63.3,00000
65.0,52.0,31.0,280,01,01,  Bahir Para,613,454,326,194,287,260,57.5,62.7,52.5,00000
65.0,52.0,31.0,280,02,01,  Dhopadaha,843,340,402,153,441,187,71.3,72.4,70.2,00000
65.0,52.0,31.0,380,01,01,  Isangati,523,297,237,137,286,160,63.8,63.4,64.1,00000
65.0,52.0,31.0,380,02,01,  Gilatala,369,187,187,90,182,97,66.4,67.5,65.2,00000
65.0,52.0,31.0,507,01,01,  Kashipur,531,304,253,133,278,171,63.6,65.5,61.9,00000
65.0,52.0,31.0,507,02,01,  Padmavila,325,421,146,206,179,215,43.6,41.5,45.4,00000
65.0,52.0,31.0,841,01,01,  Ramishwarpur,264,143,130,67,134,76,64.9,66.0,63.8,00000
65.0,52.0,31.0,841,02,01,  Shalbarat,169,173,89,86,80,87,49.4,50.9,47.9,00000
65.0,52.0,39.0,073,01,01,  Bradia,215,140,116,73,99,67,60.6,61.4,59.6,00000
65.0,52.0,39.0,073,02,01,  Mangoalpur,658,293,317,129,341,164,69.2,71.1,67.5,00000
65.0,52.0,39.0,073,03,01,  Baradia Bazar,87,28,46,13,41,15,75.7,78.0,73.2,00000
65.0,52.0,39.0,080,01,01,  Chapulia,410,197,192,91,218,106,67.5,67.8,67.3,00000
65.0,52.0,39.0,080,02,01,  Char Boradia,264,41,127,14,137,27,86.6,90.1,83.5,00000
65.0,52.0,39.0,080,03,01,  Uttar Khashial,32,12,10,8,22,4,72.7,55.6,84.6,00000
65.0,52.0,39.0,333,01,01,  Ghaga,799,557,382,276,417,281,58.9,58.1,59.7,00000
65.0,52.0,39.0,333,02,01,  Dhalaitala,572,250,266,106,306,144,69.6,71.5,68.0,00000
65.0,52.0,39.0,540,01,01,  Kotakhol,626,317,282,146,344,171,66.4,65.9,66.8,00000
65.0,52.0,39.0,540,02,01,  Char Kotakhol,516,263,241,119,275,144,66.2,66.9,65.6,00000
65.0,52.0,39.0,540,03,01,  Taligati,48,18,21,7,27,11,72.7,75.0,71.1,00000
65.0,52.0,39.0,614,01,01,  Maigram,461,337,216,160,245,177,57.8,57.4,58.1,00000
65.0,52.0,39.0,614,02,01,  Matiadanga,121,203,63,95,58,108,37.3,39.9,34.9,00000
65.0,52.0,47.0,407,01,01,  Char Jhamar Ghop,148,228,69,121,79,107,39.4,36.3,42.5,00000
65.0,52.0,47.0,407,02,01,  Jhamar Ghop (2),154,286,101,120,53,166,35.0,45.7,24.2,00000
65.0,52.0,47.0,454,01,01,  Kalyanpur,521,407,279,167,242,240,56.1,62.6,50.2,00000
65.0,52.0,47.0,454,02,01,  Rajapur,471,705,197,328,274,377,40.1,37.5,42.1,00000
65.0,52.0,47.0,574,01,01,  Dinanath Para,631,887,299,425,332,462,41.6,41.3,41.8,00000
65.0,52.0,47.0,574,02,01,  Gobinda Para,123,123,70,60,53,63,50.0,53.8,45.7,00000
65.0,52.0,47.0,574,03,01,  Chymonar Char,438,316,197,153,241,163,58.1,56.3,59.7,00000
65.0,52.0,47.0,574,04,01,  Paschimpara,739,1070,365,482,374,588,40.9,43.1,38.9,00000
65.0,52.0,47.0,574,05,01,  Hindu Para,140,64,68,28,72,36,68.6,70.8,66.7,00000
65.0,52.0,47.0,574,06,01,  Kachubaria,86,222,45,110,41,112,27.9,29.0,26.8,00000
65.0,52.0,47.0,574,07,01,  Sayed Para,365,136,179,48,186,88,72.9,78.9,67.9,00000
65.0,52.0,47.0,574,08,01,  Sekh Para,243,177,120,81,123,96,57.9,59.7,56.2,00000
65.0,52.0,47.0,574,09,01,  Kolu Para,94,374,48,186,46,188,20.1,20.5,19.7,00000
65.0,52.0,47.0,574,10,01,  Majhi Para,116,150,56,65,60,85,43.6,46.3,41.4,00000
65.0,52.0,47.0,574,11,01,  Trilakshmia Para,348,199,182,95,166,104,63.6,65.7,61.5,00000
65.0,52.0,47.0,574,12,01,  Char Trilakshmia Para,138,248,46,124,92,124,35.8,27.1,42.6,00000
65.0,52.0,47.0,574,13,01,  Tentulbaria,176,329,87,171,89,158,34.9,33.7,36.0,00000
65.0,52.0,47.0,574,14,01,  Taluk Para,236,201,113,82,123,119,54.0,57.9,50.8,00000
65.0,52.0,47.0,574,15,01,  Dahar Para,1162,1081,561,493,601,588,51.8,53.2,50.5,00000
65.0,52.0,47.0,574,16,01,  Hechlagati,405,640,194,303,211,337,38.8,39.0,38.5,00000
65.0,52.0,47.0,574,17,01,  Lahuria Pachashipara,541,923,251,433,290,490,37.0,36.7,37.2,00000
65.0,52.0,47.0,574,18,01,  Digrirchar,177,299,68,170,109,129,37.2,28.6,45.8,00000
65.0,52.0,47.0,574,19,01,  Drosonopara,203,237,90,120,113,117,46.1,42.9,49.1,00000
65.0,52.0,47.0,574,20,01,  Naluapara,60,218,34,126,26,92,21.6,21.3,22.0,00000
65.0,52.0,47.0,574,21,01,  Mollapara,215,110,98,36,117,74,66.2,73.1,61.3,00000
65.0,52.0,55.0,427,01,01,  Kachubaria,151,85,69,43,82,42,64.0,61.6,66.1,00000
65.0,52.0,55.0,427,02,01,  Daserdanga,240,119,123,56,117,63,66.9,68.7,65.0,00000
65.0,52.0,55.0,994,01,01,  Uttarpara,49,11,25,6,24,5,81.7,80.6,82.8,00000
65.0,52.0,55.0,994,02,01,  Naora,204,72,108,36,96,36,73.9,75.0,72.7,00000
65.0,52.0,63.0,447,01,01,  Char Karfa,239,121,125,58,114,63,66.4,68.3,64.4,00000
65.0,52.0,63.0,447,02,01,  Dharmadeb Para,100,90,44,44,56,46,52.6,50.0,54.9,00000
65.0,52.0,63.0,447,03,01,  Kalna,648,294,362,148,286,146,68.8,71.0,66.2,00000
65.0,52.0,63.0,447,04,01,  Char Kalna,292,316,145,138,147,178,48.0,51.2,45.2,00000
65.0,52.0,63.0,447,05,01,  Purba Char Kalna,461,69,216,22,245,47,87.0,90.8,83.9,00000
65.0,52.0,63.0,467,01,01,  Kamthana,917,389,471,158,446,231,70.2,74.9,65.9,00000
65.0,52.0,63.0,467,02,01,  Kaurakhola,133,57,70,25,63,32,70.0,73.7,66.3,00000
65.0,52.0,71.0,634,01,01,  Char Mallikpur,1164,497,551,203,613,294,70.1,73.1,67.6,00000
65.0,52.0,71.0,634,02,01,  Par Mallikpur,1156,803,573,365,583,438,59.0,61.1,57.1,00000
65.0,52.0,71.0,634,03,01,  Purba Mallikpur,480,211,250,80,230,131,69.5,75.8,63.7,00000
65.0,52.0,71.0,634,04,01,  Paschim Mallikpur,516,344,241,149,275,195,60.0,61.8,58.5,00000
65.0,52.0,71.0,634,05,01,  Atosh Para,105,67,55,28,50,39,61.0,66.3,56.2,00000
65.0,52.0,71.0,647,01,01,  Mangalhata,1386,820,700,388,686,432,62.8,64.3,61.4,00000
65.0,52.0,71.0,647,02,01,  Char Mangalhata,182,39,83,17,99,22,82.4,83.0,81.8,00000
65.0,52.0,71.0,781,01,01,  Panchuria,577,270,277,126,300,144,68.1,68.7,67.6,00000
65.0,52.0,71.0,781,02,01,  Par Panchuria,118,124,59,55,59,69,48.8,51.8,46.1,00000
65.0,52.0,79.0,153,01,01,  Kalinagar,329,373,176,177,153,196,46.9,49.9,43.8,00000
65.0,52.0,79.0,153,02,01,  Char Balidia,589,559,289,285,300,274,51.3,50.3,52.3,00000
65.0,52.0,79.0,153,03,01,  Baladanga,188,235,99,114,89,121,44.4,46.5,42.4,00000
65.0,52.0,79.0,173,01,01,  Brahmaninagar,538,367,289,164,249,203,59.4,63.8,55.1,00000
65.0,52.0,79.0,173,02,01,  Matinagar,145,145,84,63,61,82,50.0,57.1,42.7,00000
65.0,52.0,79.0,393,01,01,  Barai Para,357,327,211,137,146,190,52.2,60.6,43.5,00000
65.0,52.0,79.0,393,02,01,  Jalalsi,234,138,115,62,119,76,62.9,65.0,61.0,00000
65.0,52.0,79.0,434,01,01,  Kalachandpur,873,869,440,415,433,454,50.1,51.5,48.8,00000
65.0,52.0,79.0,434,02,01,  Naldi,107,64,66,30,41,34,62.6,68.8,54.7,00000
65.0,52.0,79.0,434,03,01,  Mathbari,89,276,44,141,45,135,24.4,23.8,25.0,00000
65.0,52.0,79.0,681,01,01,  Mithapur,813,818,420,399,393,419,49.8,51.3,48.4,00000
65.0,52.0,79.0,681,02,01,  Chakulia,432,332,227,158,205,174,56.5,59.0,54.1,00000
65.0,52.0,79.0,714,01,01,  Nalia,799,469,402,211,397,258,63.0,65.6,60.6,00000
65.0,52.0,79.0,714,02,01,  Madanpur,64,184,35,91,29,93,25.8,27.8,23.8,00000
65.0,52.0,87.0,166,01,01,  Brahmandanga,739,165,380,63,359,102,81.7,85.8,77.9,00000
65.0,52.0,87.0,166,02,01,  Char Brahmandanga,232,149,106,65,126,84,60.9,62.0,60.0,00000
65.0,52.0,87.0,367,01,01,  Handla,428,467,191,248,237,219,47.8,43.5,52.0,00000
65.0,52.0,87.0,367,02,01,  Baribhanga,337,117,159,58,178,59,74.2,73.3,75.1,00000
65.0,52.0,87.0,367,03,01,  Kankul,27,27,11,18,16,9,50.0,37.9,64.0,00000
65.0,52.0,87.0,861,01,01,  Roygram,1022,532,536,246,486,286,65.8,68.5,63.0,00000
65.0,52.0,87.0,861,02,01,  Fhedi Adarshagram,188,49,97,20,91,29,79.3,82.9,75.8,00000
65.0,52.0,87.0,888,01,01,  Samuk Khola,842,359,422,153,420,206,70.1,73.4,67.1,00000
65.0,52.0,87.0,888,02,01,  Char Samuk Khola,329,138,148,60,181,78,70.4,71.2,69.9,00000
65.0,52.0,94.0,093,01,01,  Sekh Para,374,364,170,181,204,183,50.7,48.4,52.7,00000
65.0,52.0,94.0,093,02,01,  Danga Batasi,84,122,55,58,29,64,40.8,48.7,31.2,00000
65.0,52.0,94.0,093,03,01,  Bhadradanga,142,240,75,103,67,137,37.2,42.1,32.8,00000
65.0,52.0,94.0,093,04,01,  Hazi Para,53,71,31,31,22,40,42.7,50.0,35.5,00000
65.0,52.0,94.0,093,05,01,  Bhulbari Batasi,21,26,11,14,10,12,44.7,44.0,45.5,00000
65.0,52.0,94.0,093,06,01,  Uttar Para Batasi,434,470,176,227,258,243,48.0,43.7,51.5,00000
65.0,52.0,94.0,160,01,01,  Buzurg Shalnagar,286,237,143,106,143,131,54.7,57.4,52.2,00000
65.0,52.0,94.0,160,02,01,  Palpara,118,95,72,47,46,48,55.4,60.5,48.9,00000
65.0,52.0,94.0,500,01,01,  Kashipur,348,319,160,139,188,180,52.2,53.5,51.1,00000
65.0,52.0,94.0,500,02,01,  Ramchandrapur,194,132,90,63,104,69,59.5,58.8,60.1,00000
65.0,52.0,94.0,641,01,01,  Mandalbhag,283,110,143,46,140,64,72.0,75.7,68.6,00000
65.0,52.0,94.0,641,02,01,  Jhaudanga,228,177,119,72,109,105,56.3,62.3,50.9,00000
65.0,52.0,94.0,808,01,01,  Par Shalnagar,628,312,285,142,343,170,66.8,66.7,66.9,00000
65.0,52.0,94.0,808,02,01,  Char Shalnagar,500,741,224,329,276,412,40.3,40.5,40.1,00000
65.0,76.0,11.0,331,01,01,  Dakshin Pankabila,314,86,166,38,148,48,78.5,81.4,75.5,00000
65.0,76.0,11.0,331,02,01,  Bajayaput,79,38,34,21,45,17,67.5,61.8,72.6,00000
65.0,76.0,11.0,431,01,01,  Ghoshpur,179,142,88,71,91,71,55.8,55.3,56.2,00000
65.0,76.0,11.0,431,02,01,  Khalishakhali,296,235,128,114,168,121,55.7,52.9,58.1,00000
65.0,76.0,11.0,552,01,01,  Nakashi,678,500,342,233,336,267,57.6,59.5,55.7,00000
65.0,76.0,11.0,552,02,01,  Kamalapur,1155,969,614,484,541,485,54.4,55.9,52.7,00000
65.0,76.0,11.0,674,01,01,  Muldair,1031,752,514,341,517,411,57.8,60.1,55.7,00000
65.0,76.0,11.0,674,02,01,  Paschim Baliadanga,246,157,133,75,113,82,61.0,63.9,57.9,00000
65.0,76.0,11.0,674,03,01,  Ramchandrapur,747,581,352,284,395,297,56.3,55.3,57.1,00000
65.0,76.0,11.0,674,04,01,  Saratala,485,341,237,156,248,185,58.7,60.3,57.3,00000
65.0,76.0,11.0,878,01,01,  Baman Simakhali,234,28,116,12,118,16,89.3,90.6,88.1,00000
65.0,76.0,11.0,878,02,01,  Purba Simakhali,313,45,169,14,144,31,87.4,92.3,82.3,00000
65.0,76.0,11.0,878,03,01,  Paschim Simakhali,787,238,410,102,377,136,76.8,80.1,73.5,00000
65.0,76.0,13.0,292,01,01,  Chandpur,72,50,38,22,34,28,59.0,63.3,54.8,00000
65.0,76.0,13.0,292,02,01,  Bagura,973,657,493,300,480,357,59.7,62.2,57.3,00000
65.0,76.0,13.0,353,01,01,  Dariapur,833,371,418,154,415,217,69.2,73.1,65.7,00000
65.0,76.0,13.0,353,02,01,  Daulatpur,516,109,255,58,261,51,82.6,81.5,83.7,00000
65.0,76.0,13.0,453,01,01,  Gopalpur,436,206,215,87,221,119,67.9,71.2,65.0,00000
65.0,76.0,13.0,453,02,01,  Agrahati,60,46,26,31,34,15,56.6,45.6,69.4,00000
65.0,76.0,13.0,840,01,01,  Shalikha,454,224,212,130,242,94,67.0,62.0,72.0,00000
65.0,76.0,13.0,840,02,01,  Char Shalikha,377,539,190,266,187,273,41.2,41.7,40.7,00000
65.0,76.0,20.0,403,01,01,  Dighalia,398,429,204,214,194,215,48.1,48.8,47.4,00000
65.0,76.0,20.0,403,02,01,  Sarkoldanga,432,363,221,176,211,187,54.3,55.7,53.0,00000
65.0,76.0,20.0,740,01,01,  Palaidanga,881,550,428,247,453,303,61.6,63.4,59.9,00000
65.0,76.0,20.0,740,02,01,  Maharag,201,163,110,72,91,91,55.2,60.4,50.0,00000
65.0,76.0,20.0,801,01,01,  Ramsiddhidanga,658,694,342,304,316,390,48.7,52.9,44.8,00000
65.0,76.0,20.0,801,02,01,  Darah Ramsiddhi,202,383,107,167,95,216,34.5,39.1,30.5,00000
65.0,76.0,27.0,055,01,01,  Arpara,822,329,452,152,370,177,71.4,74.8,67.6,00000
65.0,76.0,27.0,055,02,01,  Mirzapur,2560,2106,1370,903,1190,1203,54.9,60.3,49.7,00000
65.0,76.0,27.0,210,01,01,  Atgara,178,92,87,36,91,56,65.9,70.7,61.9,00000
65.0,76.0,27.0,210,02,01,  Bichhali,974,1191,511,565,463,626,45.0,47.5,42.5,00000
65.0,76.0,27.0,210,03,01,  Kalinagar,239,270,142,132,97,138,47.0,51.8,41.3,00000
65.0,76.0,27.0,624,01,01,  Madhurgati,664,316,338,141,326,175,67.8,70.6,65.1,00000
65.0,76.0,27.0,624,02,01,  Akabpur,346,137,193,51,153,86,71.6,79.1,64.0,00000
65.0,76.0,27.0,823,01,01,  Runthia,355,168,178,64,177,104,67.9,73.6,63.0,00000
65.0,76.0,27.0,823,02,01,  Barali,116,189,58,96,58,93,38.0,37.7,38.4,00000
65.0,76.0,33.0,077,01,01,  Badhal,519,274,268,131,251,143,65.4,67.2,63.7,00000
65.0,76.0,33.0,077,02,01,  Jangalgram,786,306,376,134,410,172,72.0,73.7,70.4,00000
65.0,76.0,33.0,397,01,01,  Dharia,590,310,287,139,303,171,65.6,67.4,63.9,00000
65.0,76.0,33.0,397,02,01,  Ambaria,171,63,88,26,83,37,73.1,77.2,69.2,00000
65.0,76.0,33.0,602,01,01,  Rajapur,195,43,94,19,101,24,81.9,83.2,80.8,00000
65.0,76.0,33.0,602,02,01,  Kuralia,255,127,138,52,117,75,66.8,72.6,60.9,00000
65.0,76.0,33.0,851,01,01,  Fulbari,109,58,57,26,52,32,65.3,68.7,61.9,00000
65.0,76.0,33.0,851,02,01,  Sankarpur,342,83,194,26,148,57,80.5,88.2,72.2,00000
65.0,76.0,40.0,469,01,01,  Haidharkhola,232,157,117,72,115,85,59.6,61.9,57.5,00000
65.0,76.0,40.0,469,02,01,  Elindhi,217,137,113,56,104,81,61.3,66.9,56.2,00000
65.0,76.0,40.0,525,01,01,  Joydebpur,717,402,354,185,363,217,64.1,65.7,62.6,00000
65.0,76.0,40.0,525,02,01,  Domairtala,505,212,233,100,272,112,70.4,70.0,70.8,00000
65.0,76.0,40.0,889,01,01,  Baikhali,109,120,62,59,47,61,47.6,51.2,43.5,00000
65.0,76.0,40.0,889,02,01,  Danga Singia,380,542,179,265,201,277,41.2,40.3,42.1,00000
65.0,76.0,40.0,889,03,01,  Char Para,319,167,164,79,155,88,65.6,67.5,63.8,00000
65.0,76.0,40.0,889,04,01,  Singia Byabsai Para,568,205,305,73,263,132,73.5,80.7,66.6,00000
65.0,76.0,40.0,889,05,01,  Basu Para,209,87,96,44,113,43,70.6,68.6,72.4,00000
65.0,76.0,40.0,889,06,01,  Singia Bazar,406,261,196,135,210,126,60.9,59.2,62.5,00000
65.0,76.0,40.0,889,07,01,  Komkhali,1398,1065,672,534,726,531,56.8,55.7,57.8,00000
65.0,76.0,47.0,016,01,01,  Agdia,2035,2312,1059,1121,976,1191,46.8,48.6,45.0,00000
65.0,76.0,47.0,016,02,01,  Agdia Char,784,599,420,271,364,328,56.7,60.8,52.6,00000
65.0,76.0,47.0,016,03,01,  Ramnagar Char,468,445,244,210,224,235,51.3,53.7,48.8,00000
65.0,76.0,47.0,544,01,01,  Kalora,700,390,348,178,352,212,64.2,66.2,62.4,00000
65.0,76.0,47.0,544,02,01,  Birgram,571,506,294,243,277,263,53.0,54.7,51.3,00000
65.0,76.0,54.0,569,01,01,  Kalukhali,500,356,249,173,251,183,58.4,59.0,57.8,00000
65.0,76.0,54.0,569,02,01,  Magura,823,390,411,175,412,215,67.8,70.1,65.7,00000
65.0,76.0,54.0,569,03,01,  Poradanga,398,442,220,175,178,267,47.4,55.7,40.0,00000
65.0,76.0,54.0,635,01,01,  Lokanathpur,36,46,21,21,15,25,43.9,50.0,37.5,00000
65.0,76.0,54.0,635,02,01,  Kanthalbari,374,289,196,138,178,151,56.4,58.7,54.1,00000
65.0,76.0,54.0,635,03,01,  Maij Para,286,67,141,25,145,42,81.0,84.9,77.5,00000
65.0,76.0,54.0,635,04,01,  Guchchhagram,126,173,76,83,50,90,42.1,47.8,35.7,00000
65.0,76.0,54.0,945,01,01,  Tarasi,1047,735,538,339,509,396,58.8,61.3,56.2,00000
65.0,76.0,54.0,945,02,01,  Kalyankhali,300,91,144,39,156,52,76.7,78.7,75.0,00000
65.0,76.0,54.0,945,03,01,  Dohar Tarasi,136,206,72,103,64,103,39.8,41.1,38.3,00000
65.0,76.0,54.0,945,04,01,  Rameshwarpur,912,423,471,201,441,222,68.3,70.1,66.5,00000
65.0,76.0,54.0,945,05,01,  Saluya,622,285,322,139,300,146,68.6,69.8,67.3,00000
65.0,76.0,54.0,945,06,01,  Par Balarampur,183,137,94,61,89,76,57.2,60.6,53.9,00000
65.0,76.0,54.0,961,01,01,  Urani,721,68,362,29,359,39,91.4,92.6,90.2,00000
65.0,76.0,54.0,961,02,01,  Durgapur,733,502,363,240,370,262,59.4,60.2,58.5,00000
65.0,76.0,61.0,022,01,03,  Akhoda,246,126,145,41,101,85,66.1,78.0,54.3,00000
65.0,76.0,61.0,022,02,03,  Tapari,158,131,83,53,75,78,54.7,61.0,49.0,00000
65.0,76.0,61.0,702,01,03,  Narial (Bangram) Part,235,175,128,81,107,94,57.3,61.2,53.2,00000
65.0,76.0,61.0,702,02,03,  Gohalbari,194,57,89,28,105,29,77.3,76.1,78.4,00000
65.0,76.0,61.0,751,01,03,  Pantita,769,160,411,53,358,107,82.8,88.6,77.0,00000
65.0,76.0,61.0,751,02,03,  Baliadanga,84,48,40,19,44,29,63.6,67.8,60.3,00000
65.0,76.0,61.0,751,03,03,  Mulia,358,186,202,67,156,119,65.8,75.1,56.7,00000
65.0,76.0,61.0,751,04,03,  Salirvita,78,27,45,7,33,20,74.3,86.5,62.3,00000
65.0,76.0,61.0,762,01,03,  Satgahera,333,76,174,22,159,54,81.4,88.8,74.6,00000
65.0,76.0,61.0,762,02,03,  Barander,390,90,211,36,179,54,81.3,85.4,76.8,00000
65.0,76.0,61.0,762,03,03,  Goaldanga,133,59,66,21,67,38,69.3,75.9,63.8,00000
65.0,76.0,74.0,287,01,01,  Cdandpur,553,196,267,85,286,111,73.8,75.9,72.0,00000
65.0,76.0,74.0,287,02,01,  Nayanpur,283,96,142,40,141,56,74.7,78.0,71.6,00000
65.0,76.0,74.0,648,01,01,  Jurulia,1559,334,770,137,789,197,82.4,84.9,80.0,00000
65.0,76.0,74.0,648,02,01,  Mahajan,248,122,122,58,126,64,67.0,67.8,66.3,00000
65.0,76.0,81.0,011,01,01,  Afra,1967,928,1014,438,953,490,67.9,69.8,66.0,00000
65.0,76.0,81.0,011,02,01,  Guakhola,630,191,340,81,290,110,76.7,80.8,72.5,00000
65.0,76.0,81.0,011,03,01,  Basiyardanga,203,110,113,44,90,66,64.9,72.0,57.7,00000
65.0,76.0,81.0,641,01,01,  Maliat,506,300,269,127,237,173,62.8,67.9,57.8,00000
65.0,76.0,81.0,641,02,01,  Bakali,520,129,269,49,251,80,80.1,84.6,75.8,00000
65.0,76.0,81.0,862,01,01,  Shaikhati,1221,469,640,226,581,243,72.2,73.9,70.5,00000
65.0,76.0,81.0,862,02,01,  Mahiskhola,611,582,306,270,305,312,51.2,53.1,49.4,00000
65.0,76.0,81.0,862,03,01,  Sekh Para,1325,610,711,296,614,314,68.5,70.6,66.2,00000
65.0,76.0,81.0,862,04,01,  Dahar Shaikhati,666,297,340,146,326,151,69.2,70.0,68.3,00000
65.0,76.0,88.0,138,01,01,  Baraganti,501,527,242,246,259,281,48.7,49.6,48.0,00000
65.0,76.0,88.0,138,02,01,  Barakula,391,329,211,138,180,191,54.3,60.5,48.5,00000
65.0,76.0,88.0,447,01,01,  Gobra,1397,1205,695,560,702,645,53.7,55.4,52.1,00000
65.0,76.0,88.0,447,02,01,  Khalshakhali,626,614,321,300,305,314,50.5,51.7,49.3,00000
65.0,76.0,88.0,447,03,01,  Naldi Char,600,438,327,171,273,267,57.8,65.7,50.6,00000
65.0,76.0,88.0,912,01,01,  Shulpur,992,1120,493,515,499,605,47.0,48.9,45.2,00000
65.0,76.0,88.0,912,02,01,  Chunkhola,407,495,211,221,196,274,45.1,48.8,41.7,00000
65.0,76.0,88.0,912,03,01,  Tarapur,443,1115,236,569,207,546,28.4,29.3,27.5,00000
65.0,76.0,94.0,116,01,01,  Bara Bamanhat,439,263,242,94,197,169,62.5,72.0,53.8,00000
65.0,76.0,94.0,116,02,01,  Chhota Bamanhat,146,71,79,24,67,47,67.3,76.7,58.8,00000
65.0,76.0,94.0,648,01,01,  Malidanga,771,469,387,218,384,251,62.2,64.0,60.5,00000
65.0,76.0,94.0,648,02,01,  Debipur,208,114,115,40,93,74,64.6,74.2,55.7,00000
65.0,76.0,94.0,648,03,01,  Bamanhat Nabapalli,95,94,49,34,46,60,50.3,59.0,43.4,00000
44.0,14.0,10.0,064,01,01,  Bakchua,1418,1272,773,592,645,680,52.7,56.6,48.7,00000
44.0,14.0,10.0,064,02,01,  Lakshmipur,558,929,298,497,260,432,37.5,37.5,37.6,00000
44.0,14.0,10.0,064,03,01,  Doubila,538,508,266,236,272,272,51.4,53.0,50.0,00000
44.0,14.0,10.0,064,04,01,  Haria Ghata,533,1092,261,547,272,545,32.8,32.3,33.3,00000
44.0,14.0,10.0,064,05,01,  Bahadurpur,347,637,167,322,180,315,35.3,34.2,36.4,00000
44.0,14.0,10.0,607,01,01,  Mali Para,614,440,314,210,300,230,58.3,59.9,56.6,00000
44.0,14.0,10.0,607,02,01,  Rahimpur,221,263,114,138,107,125,45.7,45.2,46.1,00000
44.0,14.0,21.0,090,01,01,  Basudebpur,487,740,239,361,248,379,39.7,39.8,39.6,00000
44.0,14.0,21.0,090,02,01,  Kismat,228,150,127,79,101,71,60.3,61.7,58.7,00000
44.0,14.0,21.0,129,01,01,  Chhota Bhadra,513,536,289,264,224,272,48.9,52.3,45.2,00000
44.0,14.0,21.0,129,02,01,  Bara Bhadra,462,803,223,374,239,429,36.5,37.4,35.8,00000
44.0,14.0,21.0,258,01,01,  Daribinni,385,550,193,275,192,275,41.2,41.2,41.1,00000
44.0,14.0,21.0,258,02,01,  Gopi Para,248,117,124,51,124,66,67.9,70.9,65.3,00000
44.0,14.0,21.0,297,01,01,  Durlabhpur,551,752,273,383,278,369,42.3,41.6,43.0,00000
44.0,14.0,21.0,297,02,01,  Berbinna,563,555,314,267,249,288,50.4,54.0,46.4,00000
44.0,14.0,21.0,297,03,01,  Sekh Para,101,309,59,150,42,159,24.6,28.2,20.9,00000
44.0,14.0,21.0,361,01,01,  Hakimpur,255,678,148,342,107,336,27.3,30.2,24.2,00000
44.0,14.0,21.0,361,02,01,  Shitali Para,120,305,51,152,69,153,28.2,25.1,31.1,00000
44.0,14.0,21.0,839,01,01,  Sabekbinni,707,1088,357,548,350,540,39.4,39.4,39.3,00000
44.0,14.0,21.0,839,02,01,  Lakshmipur,89,306,44,152,45,154,22.5,22.4,22.6,00000
44.0,14.0,21.0,852,01,01,  Sarabaria Satta,155,256,76,132,79,124,37.7,36.5,38.9,00000
44.0,14.0,21.0,852,02,01,  Sarabaria Bara,343,450,187,206,156,244,43.3,47.6,39.0,00000
44.0,14.0,31.0,723,01,03,  Ahadnagar,145,258,73,129,72,129,36.0,36.1,35.8,00000
44.0,14.0,31.0,723,02,03,  Charpara,76,109,44,51,32,58,41.1,46.3,35.6,00000
44.0,14.0,31.0,723,03,03,  Pardakhalpur,1210,1313,572,643,638,670,48.0,47.1,48.8,00000
44.0,14.0,31.0,723,04,03,  Dakhalpur,575,769,293,382,282,387,42.8,43.4,42.2,00000
44.0,14.0,31.0,723,05,03,  Moharajpur,286,320,145,159,141,161,47.2,47.7,46.7,00000
44.0,14.0,31.0,723,06,03,  Pasmaynagar,95,206,57,99,38,107,31.6,36.5,26.2,00000
44.0,14.0,31.0,814,01,01,  Riskhali,481,1019,255,484,226,535,32.1,34.5,29.7,00000
44.0,14.0,31.0,814,02,01,  Kestapur,691,942,338,456,353,486,42.3,42.6,42.1,00000
44.0,14.0,31.0,904,01,01,  Sonatanpur,432,498,223,244,209,254,46.5,47.8,45.1,00000
44.0,14.0,31.0,904,02,01,  Bharakhali,477,982,244,488,233,494,32.7,33.3,32.0,00000
44.0,14.0,31.0,904,03,01,  Ramchandrapur,807,1185,400,606,407,579,40.5,39.8,41.3,00000
44.0,14.0,42.0,568,01,01,  Kulbaria,862,1629,466,814,396,815,34.6,36.4,32.7,00000
44.0,14.0,42.0,568,02,01,  Soratola,713,781,340,390,373,391,47.7,46.6,48.8,00000
44.0,14.0,52.0,400,01,01,  Harispur,2082,3244,1025,1608,1057,1636,39.1,38.9,39.2,00000
44.0,14.0,52.0,400,02,01,  Beltala,292,290,151,152,141,138,50.2,49.8,50.5,00000
44.0,14.0,52.0,465,01,01,  Joradaha,1722,2415,844,1197,878,1218,41.6,41.4,41.9,00000
44.0,14.0,52.0,465,02,01,  Verakhali,804,624,408,298,396,326,56.3,57.8,54.8,00000
44.0,14.0,52.0,465,03,01,  Khamarkhali,235,216,118,113,117,103,52.1,51.1,53.2,00000
44.0,14.0,52.0,465,04,01,  Gobindapur,159,218,78,117,81,101,42.2,40.0,44.5,00000
44.0,14.0,63.0,142,01,01,  Bhalki,626,568,331,253,295,315,52.4,56.7,48.4,00000
44.0,14.0,63.0,142,02,01,  Sitali,1038,1281,554,619,484,662,44.8,47.2,42.2,00000
44.0,14.0,63.0,142,03,01,  Payradanga,827,574,429,271,398,303,59.0,61.3,56.8,00000
44.0,14.0,63.0,155,01,01,  Ghur Para,371,451,201,217,170,234,45.1,48.1,42.1,00000
44.0,14.0,63.0,155,02,01,  Roypara,570,458,290,209,280,249,55.4,58.1,52.9,00000
44.0,14.0,63.0,155,03,01,  Kullagacha,198,481,90,243,108,238,29.2,27.0,31.2,00000
44.0,14.0,63.0,155,04,01,  Gopalnagar,192,368,93,179,99,189,34.3,34.2,34.4,00000
44.0,14.0,63.0,335,01,01,  Ghoragachha,342,397,169,189,173,208,46.3,47.2,45.4,00000
44.0,14.0,63.0,335,02,01,  Ghordaha,321,187,152,92,169,95,63.2,62.3,64.0,00000
44.0,14.0,63.0,335,03,01,  Binodpur,500,384,244,190,256,194,56.6,56.2,56.9,00000
44.0,14.0,63.0,529,01,01,  Kapashati,1123,1104,571,558,552,546,50.4,50.6,50.3,00000
44.0,14.0,63.0,529,02,01,  Rathkhola,206,331,88,177,118,154,38.4,33.2,43.4,00000
44.0,14.0,63.0,827,01,01,  Rupdaha,229,341,113,172,116,169,40.2,39.6,40.7,00000
44.0,14.0,63.0,827,02,01,  Sakharidaha,837,1608,424,815,413,793,34.2,34.2,34.2,00000
44.0,14.0,63.0,827,03,01,  Poylanpur,330,788,179,386,151,402,29.5,31.7,27.3,00000
44.0,14.0,63.0,827,04,01,  Daulatpur,191,208,98,107,93,101,47.9,47.8,47.9,00000
44.0,14.0,73.0,671,01,01,  Nityanandapur,350,631,194,305,156,326,35.7,38.9,32.4,00000
44.0,14.0,73.0,671,02,01,  Sabek Nityanandapur,190,265,94,135,96,130,41.8,41.0,42.5,00000
44.0,14.0,73.0,671,03,01,  Takiarpota,180,291,91,157,89,134,38.2,36.7,39.9,00000
44.0,14.0,73.0,775,01,01,  Porahati,296,454,156,220,140,234,39.5,41.5,37.4,00000
44.0,14.0,73.0,775,02,01,  Char Para,551,644,270,307,281,337,46.1,46.8,45.5,00000
44.0,14.0,73.0,775,03,01,  Char Aruakandi,291,400,138,200,153,200,42.1,40.8,43.3,00000
44.0,14.0,73.0,788,01,01,  Raghunathpur,759,1117,378,542,381,575,40.5,41.1,39.9,00000
44.0,14.0,73.0,788,02,01,  Kashiadanga,375,476,195,241,180,235,44.1,44.7,43.4,00000
44.0,14.0,73.0,994,01,01,  Mandaltala,195,379,101,176,94,203,34.0,36.5,31.6,00000
44.0,14.0,73.0,994,02,01,  Nijtala,366,477,200,232,166,245,43.4,46.3,40.4,00000
44.0,14.0,73.0,994,03,01,  Kacharitala,301,445,166,200,135,245,40.3,45.4,35.5,00000
44.0,14.0,84.0,103,01,01,  Bhabanipur,1819,1397,983,689,836,708,56.6,58.8,54.1,00000
44.0,14.0,84.0,103,02,01,  Notidanga,454,342,221,180,233,162,57.0,55.1,59.0,00000
44.0,14.0,84.0,956,01,01,  Taherhuda,913,1121,484,564,429,557,44.9,46.2,43.5,00000
44.0,14.0,84.0,956,02,01,  Andulia,835,751,423,364,412,387,52.6,53.7,51.6,00000
44.0,14.0,84.0,956,03,01,  Gopinathpur,427,516,206,263,221,253,45.3,43.9,46.6,00000
44.0,14.0,84.0,956,04,01,  Gazipur,335,347,159,172,176,175,49.1,48.0,50.1,00000
44.0,19.0,11.0,831,01,01,  Nizpuntia,659,574,358,264,301,310,53.4,57.6,49.3,00000
44.0,19.0,11.0,831,02,01,  Hudapuntia,905,745,444,374,461,371,54.8,54.3,55.4,00000
44.0,19.0,11.0,831,03,01,  Goal Para Putia,234,254,121,122,113,132,48.0,49.8,46.1,00000
44.0,19.0,11.0,831,04,01,  Durga Narayanpur,523,410,273,203,250,207,56.1,57.4,54.7,00000
44.0,19.0,11.0,924,01,01,  Sonadaha,282,232,149,97,133,135,54.9,60.6,49.6,00000
44.0,19.0,11.0,924,02,01,  Goal Para,359,227,189,103,170,124,61.3,64.7,57.8,00000
44.0,19.0,13.0,813,01,01,  Lakshmipur,369,316,178,152,191,164,53.9,53.9,53.8,00000
44.0,19.0,13.0,813,02,01,  Fursandi,137,339,61,161,76,178,28.8,27.5,29.9,00000
44.0,19.0,15.0,322,01,01,  Paikpara,645,355,339,166,306,189,64.5,67.1,61.8,00000
44.0,19.0,15.0,322,02,01,  Basipara,241,185,121,86,120,99,56.6,58.5,54.8,00000
44.0,19.0,15.0,322,03,01,  Ganna,829,1416,445,703,384,713,36.9,38.8,35.0,00000
44.0,19.0,26.0,371,01,01,  Halidhani,1000,966,505,434,495,532,50.9,53.8,48.2,00000
44.0,19.0,26.0,371,02,01,  Ratanpur,182,223,101,107,81,116,44.9,48.6,41.1,00000
44.0,19.0,26.0,872,01,01,  Ramchandrapur,1217,1246,603,600,614,646,49.4,50.1,48.7,00000
44.0,19.0,26.0,872,02,01,  Basherdair,159,133,94,57,65,76,54.5,62.3,46.1,00000
44.0,19.0,42.0,434,01,01,  Joyrampur,187,168,113,68,74,100,52.7,62.4,42.5,00000
44.0,19.0,42.0,434,02,01,  Nachna,403,429,209,204,194,225,48.4,50.6,46.3,00000
44.0,19.0,42.0,987,01,01,  Uttar Kashtasagara,1081,905,590,411,491,494,54.4,58.9,49.8,00000
44.0,19.0,42.0,987,02,01,  Hazratala,259,118,137,44,122,74,68.7,75.7,62.2,00000
44.0,19.0,47.0,285,01,01,  Dephalbaria,834,750,439,341,395,409,52.7,56.3,49.1,00000
44.0,19.0,47.0,285,02,01,  Gachha,148,240,77,123,71,117,38.1,38.5,37.8,00000
44.0,19.0,47.0,857,01,01,  Lebutala,581,620,311,301,270,319,48.4,50.8,45.8,00000
44.0,19.0,47.0,857,02,01,  Madhabpur,311,185,159,85,152,100,62.7,65.2,60.3,00000
44.0,19.0,47.0,857,03,01,  Radhakantapur,233,228,119,108,114,120,50.5,52.4,48.7,00000
44.0,19.0,47.0,887,01,01,  Rautail,368,662,204,362,164,300,35.7,36.0,35.3,00000
44.0,19.0,47.0,887,02,01,  Japjhpia,205,252,120,112,85,140,44.9,51.7,37.8,00000
44.0,19.0,52.0,204,01,01,  Bagimara,229,333,109,172,120,161,40.7,38.8,42.7,00000
44.0,19.0,52.0,204,02,01,  Chanduali,668,957,326,481,342,476,41.1,40.4,41.8,00000
44.0,19.0,52.0,363,01,01,  Nawda Para,345,587,179,274,166,313,37.0,39.5,34.7,00000
44.0,19.0,52.0,363,02,01,  Gopalpur,1318,1711,720,798,598,913,43.5,47.4,39.6,00000
44.0,19.0,63.0,501,01,01,  Karati Para,501,524,275,246,226,278,48.9,52.8,44.8,00000
44.0,19.0,63.0,501,02,01,  Dakatia,337,243,166,104,171,139,58.1,61.5,55.2,00000
44.0,19.0,63.0,501,03,01,  Naihati,303,371,158,185,145,186,45.0,46.1,43.8,00000
44.0,19.0,63.0,501,04,01,  Arpara,479,160,256,53,223,107,75.0,82.8,67.6,00000
44.0,19.0,63.0,501,05,01,  Sonaikhali,116,166,57,70,59,96,41.1,44.9,38.1,00000
44.0,19.0,68.0,976,01,01,  Tiordah,1258,1035,655,479,603,556,54.9,57.8,52.0,00000
44.0,19.0,68.0,976,02,01,  Hatgopalpur,676,374,373,172,303,202,64.4,68.4,60.0,00000
44.0,19.0,68.0,976,03,01,  Sirfaltala,544,606,276,315,268,291,47.3,46.7,47.9,00000
44.0,19.0,68.0,976,04,01,  Bomardanga,107,165,47,87,60,78,39.3,35.1,43.5,00000
44.0,19.0,73.0,115,01,01,  Bari Bathan,724,881,367,423,357,458,45.1,46.5,43.8,00000
44.0,19.0,73.0,115,02,01,  Bania Kandor,786,751,404,347,382,404,51.1,53.8,48.6,00000
44.0,19.0,73.0,115,03,01,  Rajapur,147,107,73,44,74,63,57.9,62.4,54.0,00000
44.0,19.0,73.0,115,04,01,  Fokirabad,178,160,89,68,89,92,52.7,56.7,49.2,00000
44.0,19.0,73.0,651,01,03,  Khajura,236,889,115,443,121,446,21.0,20.6,21.3,00000
44.0,19.0,73.0,651,02,03,  Char Kajura,451,756,230,362,221,394,37.4,38.9,35.9,00000
44.0,19.0,79.0,397,01,01,  Hiradanda,319,639,179,318,140,321,33.3,36.0,30.4,00000
44.0,19.0,79.0,397,02,01,  Sura Para,376,424,176,216,200,208,47.0,44.9,49.0,00000
44.0,19.0,79.0,891,01,01,  Rupdaha,453,543,237,279,216,264,45.5,45.9,45.0,00000
44.0,19.0,79.0,891,02,01,  Mandartala,128,104,72,40,56,64,55.2,64.3,46.7,00000
44.0,19.0,84.0,348,01,01,  Gilapol,331,589,153,298,178,291,36.0,33.9,38.0,00000
44.0,19.0,84.0,348,02,01,  Radanagar,294,394,148,199,146,195,42.7,42.7,42.8,00000
44.0,19.0,84.0,348,03,01,  Batika Danga,674,592,352,276,322,316,53.2,56.1,50.5,00000
44.0,19.0,84.0,991,01,01,  Uttar Narayanpur,1106,992,564,443,542,549,52.7,56.0,49.7,00000
44.0,19.0,84.0,991,02,01,  Sahebnagar,127,260,59,123,68,137,32.8,32.4,33.2,00000
44.0,19.0,89.0,107,01,01,  Barai,786,1133,415,545,371,588,41.0,43.2,38.7,00000
44.0,19.0,89.0,107,02,01,  Asannagar,482,539,238,242,244,297,47.2,49.6,45.1,00000
44.0,19.0,89.0,894,01,01,  Sadhuhati,609,318,312,141,297,177,65.7,68.9,62.7,00000
44.0,19.0,89.0,894,02,01,  Potahati,1165,880,608,411,557,469,57.0,59.7,54.3,00000
44.0,19.0,89.0,894,03,01,  Magura Para,1605,1299,874,597,731,702,55.3,59.4,51.0,00000
44.0,19.0,89.0,894,04,01,  Panta Para,253,478,118,231,135,247,34.6,33.8,35.3,00000
44.0,19.0,89.0,894,05,01,  Darmatala,551,319,290,140,261,179,63.3,67.4,59.3,00000
44.0,33.0,20.0,359,01,01,  Gopalpur,878,616,467,281,411,335,58.8,62.4,55.1,00000
44.0,33.0,20.0,359,02,01,  Haradebpur,348,455,192,211,156,244,43.3,47.6,39.0,00000
44.0,33.0,20.0,994,01,01,  Ulla,684,482,347,213,337,269,58.7,62.0,55.6,00000
44.0,33.0,20.0,994,02,01,  Joynagar,160,243,84,115,76,128,39.7,42.2,37.3,00000
44.0,33.0,33.0,173,01,01,  Bara Bhat Para,428,668,247,317,181,351,39.1,43.8,34.0,00000
44.0,33.0,33.0,173,02,01,  Chhota Bhat Para,600,696,325,310,275,386,46.3,51.2,41.6,00000
44.0,33.0,33.0,937,01,01,  Sundarpur,435,648,241,311,194,337,40.2,43.7,36.5,00000
44.0,33.0,33.0,937,02,01,  Ichhapur,92,48,53,24,39,24,65.7,68.8,61.9,00000
44.0,33.0,40.0,342,01,01,  Gaurinathpur,585,605,299,306,286,299,49.2,49.4,48.9,00000
44.0,33.0,40.0,342,02,01,  Ghop Para,730,826,373,413,357,413,46.9,47.5,46.4,00000
44.0,33.0,40.0,728,01,01,  Nalbhanga,876,948,449,447,427,501,48.0,50.1,46.0,00000
44.0,33.0,40.0,728,02,01,  Khurda Khamar,154,237,82,115,72,122,39.4,41.6,37.1,00000
44.0,33.0,54.0,870,01,01,  Manoharpur,857,660,455,296,402,364,56.5,60.6,52.5,00000
44.0,33.0,54.0,870,02,01,  Satbaria,625,836,334,378,291,458,42.8,46.9,38.9,00000
44.0,33.0,54.0,870,03,01,  Goyeshpur,290,360,149,174,141,186,44.6,46.1,43.1,00000
44.0,33.0,54.0,897,01,01,  Sasar Para,329,369,157,168,172,201,47.1,48.3,46.1,00000
44.0,33.0,54.0,897,02,01,  Bitakula,425,378,232,159,193,219,52.9,59.3,46.8,00000
44.0,33.0,54.0,897,03,01,  Digar Para,455,643,223,295,232,348,41.4,43.1,40.0,00000
44.0,33.0,61.0,350,01,01,  Ghoshnagar,135,119,70,54,65,65,53.1,56.5,50.0,00000
44.0,33.0,61.0,350,02,01,  Norandrapur,723,531,387,265,336,266,57.7,59.4,55.8,00000
44.0,33.0,61.0,639,01,01,  Mallikpur,620,547,331,269,289,278,53.1,55.2,51.0,00000
44.0,33.0,61.0,639,02,01,  Moturapur,47,140,22,73,25,67,25.1,23.2,27.2,00000
44.0,33.0,74.0,004,01,01,  Agmundia,689,624,352,314,337,310,52.5,52.9,52.1,00000
44.0,33.0,74.0,004,02,01,  Bujidanga Mundia,766,277,407,120,359,157,73.4,77.2,69.6,00000
44.0,33.0,74.0,097,01,01,  Bankhirda,643,855,321,431,322,424,42.9,42.7,43.2,00000
44.0,33.0,74.0,097,02,01,  Ichhakhali,225,181,121,84,104,97,55.4,59.0,51.7,00000
44.0,33.0,74.0,310,01,01,  Ektarpur,904,903,474,445,430,458,50.0,51.6,48.4,00000
44.0,33.0,74.0,310,02,01,  Ghop Para,170,181,87,75,83,106,48.4,53.7,43.9,00000
44.0,33.0,74.0,355,01,01,  Gomrail,413,569,224,274,189,295,42.1,45.0,39.0,00000
44.0,33.0,74.0,355,02,01,  Batadanga,652,646,347,319,305,327,50.2,52.1,48.3,00000
44.0,33.0,81.0,066,01,01,  Bahirgachhi,777,694,372,350,405,344,52.8,51.5,54.1,00000
44.0,33.0,81.0,066,02,01,  Naoda Para,336,320,173,153,163,167,51.2,53.1,49.4,00000
44.0,33.0,81.0,817,01,01,  Raghunathpur,1335,1579,707,782,628,797,45.8,47.5,44.1,00000
44.0,33.0,81.0,817,02,01,  Natabaria,155,120,83,53,72,67,56.4,61.0,51.8,00000
44.0,33.0,88.0,430,01,01,  Ishwarba,782,886,392,453,390,433,46.9,46.4,47.4,00000
44.0,33.0,88.0,430,02,01,  Kashipur,523,686,254,327,269,359,43.3,43.7,42.8,00000
44.0,33.0,94.0,990,01,01,  Trilochanpur,612,793,298,382,314,411,43.6,43.8,43.3,00000
44.0,33.0,94.0,990,02,01,  Gobardanga,329,398,162,197,167,201,45.3,45.1,45.4,00000
44.0,42.0,13.0,909,01,01,  Singia,929,518,487,256,442,262,64.2,65.5,62.8,00000
44.0,42.0,13.0,909,02,01,  Ripan Palli,77,95,38,45,39,50,44.8,45.8,43.8,00000
44.0,42.0,27.0,257,01,01,  Chhaykhada,475,682,251,312,224,370,41.1,44.6,37.7,00000
44.0,42.0,27.0,257,02,01,  Nayada Chhaykhada,679,364,351,176,328,188,65.1,66.6,63.6,00000
44.0,42.0,27.0,896,01,01,  Shibnagar,180,263,103,126,77,137,40.6,45.0,36.0,00000
44.0,42.0,27.0,896,02,01,  Bangalipur,141,373,81,176,60,197,27.4,31.5,23.3,00000
44.0,42.0,40.0,761,01,01,  Paspatila,507,267,274,119,233,148,65.5,69.7,61.2,00000
44.0,42.0,40.0,761,02,01,  Narayanbari,165,84,81,47,84,37,66.3,63.3,69.4,00000
44.0,42.0,81.0,122,01,01,  Balaramnagar,600,675,322,360,278,315,47.1,47.2,46.9,00000
44.0,42.0,81.0,122,02,01,  Durbakunda,355,419,202,189,153,230,45.9,51.7,39.9,00000
44.0,42.0,81.0,515,01,01,  Joydia,432,698,245,337,187,361,38.2,42.1,34.1,00000
44.0,42.0,81.0,515,02,01,  Lakshmikunda,1606,1599,837,783,769,816,50.1,51.7,48.5,00000
44.0,42.0,81.0,515,03,01,  Narayanpur,575,410,324,189,251,221,58.4,63.2,53.2,00000
44.0,71.0,10.0,069,01,01,  Balibhadrapur,215,705,128,340,87,365,23.4,27.4,19.2,00000
44.0,71.0,10.0,069,02,01,  Kashipur,140,381,89,190,51,191,26.9,31.9,21.1,00000
44.0,71.0,10.0,293,01,01,  Gaurinathpur,621,677,318,312,303,365,47.8,50.5,45.4,00000
44.0,71.0,10.0,293,02,01,  Noada Para,146,331,62,171,84,160,30.6,26.6,34.4,00000
44.0,71.0,11.0,089,01,01,  Banshbaria,834,803,397,373,437,430,50.9,51.6,50.4,00000
44.0,71.0,11.0,089,02,01,  Chunirait,325,545,163,261,162,284,37.4,38.4,36.3,00000
44.0,71.0,11.0,144,01,01,  Bhabadia,481,850,236,449,245,401,36.1,34.5,37.9,00000
44.0,71.0,11.0,144,02,01,  Garapota,801,1071,389,536,412,535,42.8,42.1,43.5,00000
44.0,71.0,11.0,159,01,01,  Bhairaba,2080,2258,1082,1088,998,1170,47.9,49.9,46.0,00000
44.0,71.0,11.0,159,02,01,  Balinagar,319,538,158,284,161,254,37.2,35.7,38.8,00000
44.0,71.0,11.0,263,01,01,  Dumurtala,276,583,127,291,149,292,32.1,30.4,33.8,00000
44.0,71.0,11.0,263,02,01,  Tulsitala,228,399,107,190,121,209,36.4,36.0,36.7,00000
44.0,71.0,11.0,263,03,01,  Baganmat,494,936,256,434,238,502,34.5,37.1,32.2,00000
44.0,71.0,11.0,263,04,01,  Kaikhali,91,211,49,99,42,112,30.1,33.1,27.3,00000
44.0,71.0,11.0,626,01,01,  Makardhwajpur,403,1043,195,497,208,546,27.9,28.2,27.6,00000
44.0,71.0,11.0,626,02,01,  Darbeshnagar,280,380,138,183,142,197,42.4,43.0,41.9,00000
44.0,71.0,11.0,626,03,01,  Sundarpur,436,563,226,288,210,275,43.6,44.0,43.3,00000
44.0,71.0,11.0,746,01,01,  Panchpota,376,347,173,184,203,163,52.0,48.5,55.5,00000
44.0,71.0,11.0,746,02,01,  Lakshmipur,118,334,49,164,69,170,26.1,23.0,28.9,00000
44.0,71.0,11.0,746,03,01,  Matilalpur,204,268,96,124,108,144,43.2,43.6,42.9,00000
44.0,71.0,11.0,925,01,01,  Sreepur Bangalini,172,506,84,255,88,251,25.4,24.8,26.0,00000
44.0,71.0,11.0,925,02,01,  Basanpata,233,585,112,304,121,281,28.5,26.9,30.1,00000
44.0,71.0,17.0,213,01,01,  Chandpur,177,102,86,41,91,61,63.4,67.7,59.9,00000
44.0,71.0,17.0,213,02,01,  Rakhal Bhoga,764,672,390,309,374,363,53.2,55.8,50.7,00000
44.0,71.0,17.0,213,03,01,  Krishna Chandrapur,406,713,192,350,214,363,36.3,35.4,37.1,00000
44.0,71.0,17.0,716,01,01,  Fatehapur,1664,2109,846,1009,818,1100,44.1,45.6,42.6,00000
44.0,71.0,17.0,716,02,01,  Barermat,401,477,208,224,193,253,45.7,48.1,43.3,00000
44.0,71.0,23.0,203,01,01,  Kalipur,198,124,105,61,93,63,61.5,63.3,59.6,00000
44.0,71.0,23.0,203,02,01,  Alipur,197,172,93,80,104,92,53.4,53.8,53.1,00000
44.0,71.0,23.0,457,01,01,  Jaluli,1307,1756,642,863,665,893,42.7,42.7,42.7,00000
44.0,71.0,23.0,457,02,01,  Sonaidanga,326,506,164,219,162,287,39.2,42.8,36.1,00000
44.0,71.0,29.0,323,01,01,  Gobindapur,188,215,91,111,97,104,46.7,45.0,48.3,00000
44.0,71.0,29.0,323,02,01,  Islampur,326,188,164,82,162,106,63.4,66.7,60.4,00000
44.0,71.0,29.0,527,01,01,  Kazirber,1218,1479,610,716,608,763,45.2,46.0,44.3,00000
44.0,71.0,29.0,527,02,01,  Mathlarait,111,269,53,150,58,119,29.2,26.1,32.8,00000
44.0,71.0,29.0,552,01,01,  Kola Puratan,543,739,256,377,287,362,42.4,40.4,44.2,00000
44.0,71.0,29.0,552,02,01,  Natun Kola,641,1084,327,533,314,551,37.2,38.0,36.3,00000
44.0,71.0,29.0,860,01,01,  Mathabhanga Para,248,118,122,47,126,71,67.8,72.2,64.0,00000
44.0,71.0,29.0,860,02,01,  Kuti Para,109,320,53,153,56,167,25.4,25.7,25.1,00000
44.0,71.0,29.0,860,03,01,  Gopalpur,308,383,140,198,168,185,44.6,41.4,47.6,00000
44.0,71.0,29.0,860,04,01,  Gopalpur Matpara,166,220,74,100,92,120,43.0,42.5,43.4,00000
44.0,71.0,29.0,860,05,01,  Poti Para,509,371,271,158,238,213,57.8,63.2,52.8,00000
44.0,71.0,29.0,860,06,01,  Nalpara,386,457,193,220,193,237,45.8,46.7,44.9,00000
44.0,71.0,29.0,860,07,01,  Charatala Para,824,1028,395,568,429,460,44.5,41.0,48.3,00000
44.0,71.0,29.0,860,08,01,  Jiban Nagar Para,271,510,128,259,143,251,34.7,33.1,36.3,00000
44.0,71.0,29.0,860,09,01,  Lalpur,267,389,125,193,142,196,40.7,39.3,42.0,00000
44.0,71.0,29.0,860,10,01,  Bagdiar Ati,385,570,195,259,190,311,40.3,43.0,37.9,00000
44.0,71.0,29.0,860,11,01,  Dalbanghi,294,584,145,294,149,290,33.5,33.0,33.9,00000
44.0,71.0,29.0,860,12,01,  Abdulpur,71,113,42,53,29,60,38.6,44.2,32.6,00000
44.0,71.0,29.0,860,13,01,  Kachuar Pota,437,506,206,238,231,268,46.3,46.4,46.3,00000
44.0,71.0,29.0,860,14,01,  Chan Ratanpur,437,474,230,251,207,223,48.0,47.8,48.1,00000
44.0,71.0,29.0,860,15,01,  Pakrail,292,594,136,304,156,290,33.0,30.9,35.0,00000
44.0,71.0,29.0,860,16,01,  Bagan Para,88,169,37,82,51,87,34.2,31.1,37.0,00000
44.0,71.0,35.0,109,01,01,  Bathangachhi,1614,1766,830,898,784,868,47.8,48.0,47.5,00000
44.0,71.0,35.0,109,02,01,  Kaluhuda,505,404,260,206,245,198,55.6,55.8,55.3,00000
44.0,71.0,35.0,850,01,01,  Sahapur,451,675,253,315,198,360,40.1,44.5,35.5,00000
44.0,71.0,35.0,850,02,01,  Kashipur,117,228,56,126,61,102,33.9,30.8,37.4,00000
44.0,71.0,53.0,243,01,01,  Dariapur,396,656,200,319,196,337,37.6,38.5,36.8,00000
44.0,71.0,53.0,243,02,01,  Niwani Para,310,495,143,260,167,235,38.5,35.5,41.5,00000
44.0,71.0,53.0,243,03,01,  Purba Dariapur,185,169,89,81,96,88,52.3,52.4,52.2,00000
44.0,71.0,53.0,243,04,01,  Chandipur,91,99,41,54,50,45,47.9,43.2,52.6,00000
44.0,71.0,53.0,417,01,01,  Idrakpur,404,755,215,362,189,393,34.9,37.3,32.5,00000
44.0,71.0,53.0,417,02,01,  Mandartala Bazar,545,653,290,297,255,356,45.5,49.4,41.7,00000
44.0,71.0,53.0,417,03,01,  Kalipur,73,321,35,165,38,156,18.5,17.5,19.6,00000
44.0,71.0,53.0,417,04,01,  Alipur,283,392,150,176,133,216,41.9,46.0,38.1,00000
44.0,71.0,53.0,895,01,01,  Shibanandapur,1232,971,649,439,583,532,55.9,59.7,52.3,00000
44.0,71.0,53.0,895,02,01,  Rupdaha,342,548,177,262,165,286,38.4,40.3,36.6,00000
44.0,71.0,59.0,059,01,01,  Baghadanga,1647,2415,829,1229,818,1186,40.5,40.3,40.8,00000
44.0,71.0,59.0,059,02,01,  Jinjir Para,66,230,30,126,36,104,22.3,19.2,25.7,00000
44.0,71.0,59.0,119,01,01,  Bauli,494,725,239,366,255,359,40.5,39.5,41.5,00000
44.0,71.0,59.0,119,02,01,  Mohnamadpur,177,468,91,229,86,239,27.4,28.4,26.5,00000
44.0,71.0,59.0,900,01,01,  Aminnagar,201,733,107,385,94,348,21.5,21.7,21.3,00000
44.0,71.0,59.0,900,02,01,  Sijia,1484,2414,742,1201,742,1213,38.1,38.2,38.0,00000
44.0,71.0,65.0,313,01,01,  Ghugri,1018,957,541,442,477,515,51.5,55.0,48.1,00000
44.0,71.0,65.0,313,02,01,  Kagmari,378,478,203,235,175,243,44.2,46.3,41.9,00000
44.0,71.0,83.0,368,01,01,  Hat Khalishpur,843,838,435,429,408,409,50.1,50.3,49.9,00000
44.0,71.0,83.0,368,02,01,  Khalisapur Bazar,727,279,371,115,356,164,72.3,76.3,68.5,00000
44.0,71.0,83.0,940,01,01,  Sundarpur,994,1024,511,463,483,561,49.3,52.5,46.3,00000
44.0,71.0,83.0,940,02,01,  Puranpur,316,422,174,186,142,236,42.8,48.3,37.6,00000
44.0,71.0,83.0,940,03,01,  Bedergari,223,430,132,204,91,226,34.2,39.3,28.7,00000
44.0,80.0,10.0,368,01,01,  Gangutia,216,160,103,76,113,84,57.4,57.5,57.4,00000
44.0,80.0,10.0,368,02,01,  Lakhandia,260,135,145,60,115,75,65.8,70.7,60.5,00000
44.0,80.0,10.0,472,01,01,  Jogini,602,389,355,154,247,235,60.7,69.7,51.2,00000
44.0,80.0,10.0,472,02,01,  Bagni,408,194,228,66,180,128,67.8,77.6,58.4,00000
44.0,80.0,10.0,472,03,01,  Char Bagini,176,236,94,112,82,124,42.7,45.6,39.8,00000
44.0,80.0,10.0,665,01,01,  Ratanpur,121,253,60,114,61,139,32.4,34.5,30.5,00000
44.0,80.0,10.0,665,02,01,  Mingram,1558,988,784,442,774,546,61.2,63.9,58.6,00000
44.0,80.0,18.0,269,01,01,  Arua Para,124,130,67,58,57,72,48.8,53.6,44.2,00000
44.0,80.0,18.0,269,02,01,  Dautia,229,386,123,177,106,209,37.2,41.0,33.7,00000
44.0,80.0,18.0,269,03,01,  Kushabaria,701,940,359,458,342,482,42.7,43.9,41.5,00000
44.0,80.0,18.0,269,04,01,  Char Daulia,222,402,124,194,98,208,35.6,39.0,32.0,00000
44.0,80.0,18.0,280,01,01,  Dhalhara Chandra,318,350,175,150,143,200,47.6,53.8,41.7,00000
44.0,80.0,18.0,280,02,01,  Hatubhanga,52,78,28,39,24,39,40.0,41.8,38.1,00000
44.0,80.0,18.0,280,03,01,  Kashinathpur,342,463,187,221,155,242,42.5,45.8,39.0,00000
44.0,80.0,18.0,280,04,01,  Bara Daulia,36,65,21,32,15,33,35.6,39.6,31.3,00000
44.0,80.0,18.0,280,05,01,  Paiken Para,76,79,39,36,37,43,49.0,52.0,46.3,00000
44.0,80.0,18.0,280,06,01,  Khalkula,153,307,73,133,80,174,33.3,35.4,31.5,00000
44.0,80.0,18.0,280,07,01,  Saibhanga,119,430,65,203,54,227,21.7,24.3,19.2,00000
44.0,80.0,18.0,280,08,01,  Huda Kushabaria,441,728,209,392,232,336,37.7,34.8,40.8,00000
44.0,80.0,18.0,285,01,01,  Chhota Dhalhara,296,608,149,300,147,308,32.7,33.2,32.3,00000
44.0,80.0,18.0,285,02,01,  Char Dhalhara,271,572,118,280,153,292,32.1,29.6,34.4,00000
44.0,80.0,18.0,654,01,01,  Char Malthia,887,634,492,304,395,330,58.3,61.8,54.5,00000
44.0,80.0,18.0,654,02,01,  Kamaria,195,200,111,78,84,122,49.4,58.7,40.8,00000
44.0,80.0,18.0,654,03,01,  Puratan Malthia,704,802,386,351,318,451,46.7,52.4,41.4,00000
44.0,80.0,18.0,654,04,01,  Nutan Malthia,960,780,530,363,430,417,55.2,59.4,50.8,00000
44.0,80.0,18.0,654,05,01,  Thakur Malthia,464,477,257,206,207,271,49.3,55.5,43.3,00000
44.0,80.0,18.0,654,06,01,  Tentulbaria,6,18,5,10,1,8,25.0,33.3,11.1,00000
44.0,80.0,18.0,654,07,01,  Ulubaria,592,486,327,218,265,268,54.9,60.0,49.7,00000
44.0,80.0,18.0,714,01,01,  Nandirgati,297,458,151,220,146,238,39.3,40.7,38.0,00000
44.0,80.0,18.0,714,02,01,  Bondekhali,676,1057,351,486,325,571,39.0,41.9,36.3,00000
44.0,80.0,25.0,241,01,01,  Dahakula,531,283,272,128,259,155,65.2,68.0,62.6,00000
44.0,80.0,25.0,241,02,01,  Harundia,576,357,297,156,279,201,61.7,65.6,58.1,00000
44.0,80.0,31.0,230,01,01,  Chandipur,1070,789,561,381,509,408,57.6,59.6,55.5,00000
44.0,80.0,31.0,230,02,01,  Bajukhali,416,401,216,195,200,206,50.9,52.6,49.3,00000
44.0,80.0,31.0,637,01,01,  Malmali,469,534,267,236,202,298,46.8,53.1,40.4,00000
44.0,80.0,31.0,637,02,01,  Tangbila,14,27,8,15,6,12,34.1,34.8,33.3,00000
44.0,80.0,37.0,170,01,01,  Bijalia,771,767,371,376,400,391,50.1,49.7,50.6,00000
44.0,80.0,37.0,170,02,01,  Char Paik Para,57,40,32,19,25,21,58.8,62.7,54.3,00000
44.0,80.0,37.0,170,03,01,  Maheshdanga,69,336,46,171,23,165,17.0,21.2,12.2,00000
44.0,80.0,37.0,610,01,01,  Madhabpur,545,555,273,287,272,268,49.5,48.8,50.4,00000
44.0,80.0,37.0,610,02,01,  Lakshmipur,346,403,166,206,180,197,46.2,44.6,47.7,00000
44.0,80.0,37.0,918,01,01,  Sondaha,341,490,171,234,170,256,41.0,42.2,39.9,00000
44.0,80.0,37.0,918,02,01,  Char Sondaha,161,135,94,65,67,70,54.4,59.1,48.9,00000
44.0,80.0,44.0,137,01,01,  Bhagaban Nagar,994,1258,530,597,464,661,44.1,47.0,41.2,00000
44.0,80.0,44.0,137,02,01,  Britti Para,513,536,280,262,233,274,48.9,51.7,46.0,00000
44.0,80.0,44.0,137,03,01,  Goalkhali,360,295,181,152,179,143,55.0,54.4,55.6,00000
44.0,80.0,44.0,791,01,01,  Fulhari,1977,2628,1105,1239,872,1389,42.9,47.1,38.6,00000
44.0,80.0,44.0,791,02,01,  Kazi Para,615,770,308,395,307,375,44.4,43.8,45.0,00000
44.0,80.0,44.0,791,03,01,  Debinagar,349,387,199,165,150,222,47.4,54.7,40.3,00000
44.0,80.0,44.0,791,04,01,  Gobindapur,169,231,86,126,83,105,42.3,40.6,44.1,00000
44.0,80.0,44.0,813,01,01,  Putimari,603,600,322,293,281,307,50.1,52.4,47.8,00000
44.0,80.0,44.0,813,02,01,  Gazaria Para,170,203,91,96,79,107,45.6,48.7,42.5,00000
44.0,80.0,44.0,813,03,01,  Mochara Para,243,381,129,190,114,191,38.9,40.4,37.4,00000
44.0,80.0,44.0,813,04,01,  Chandpur,367,495,188,238,179,257,42.6,44.1,41.1,00000
44.0,80.0,50.0,109,01,01,  Baria,646,1041,333,459,313,582,38.3,42.0,35.0,00000
44.0,80.0,50.0,109,02,01,  Shahidnagar,172,447,96,224,76,223,27.8,30.0,25.4,00000
44.0,80.0,50.0,335,01,01,  Doharo,948,1495,494,698,454,797,38.8,41.4,36.3,00000
44.0,80.0,50.0,335,02,01,  Char Para,207,192,104,102,103,90,51.9,50.5,53.4,00000
44.0,80.0,50.0,417,01,01,  Harihara,692,1336,365,634,327,702,34.1,36.5,31.8,00000
44.0,80.0,50.0,417,02,01,  Azadnagar,109,114,58,53,51,61,48.9,52.3,45.5,00000
44.0,80.0,50.0,450,01,01,  Jalsukha,442,523,234,280,208,243,45.8,45.5,46.1,00000
44.0,80.0,50.0,450,02,01,  Gobindapur,357,566,177,268,180,298,38.7,39.8,37.7,00000
44.0,80.0,56.0,978,01,01,  Uttar Boalia,813,1646,459,807,354,839,33.1,36.3,29.7,00000
44.0,80.0,56.0,978,02,01,  Ratidanga,683,877,336,420,347,457,43.8,44.4,43.2,00000
44.0,80.0,56.0,978,03,01,  Baliaghat,244,246,135,110,109,136,49.8,55.1,44.5,00000
44.0,80.0,63.0,060,01,01,  Alamdanga,232,389,112,194,120,195,37.4,36.6,38.1,00000
44.0,80.0,63.0,060,02,01,  Charia,518,584,270,292,248,292,47.0,48.0,45.9,00000
44.0,80.0,63.0,439,01,01,  Huda Mailmari,454,766,230,366,224,400,37.2,38.6,35.9,00000
44.0,80.0,63.0,439,02,01,  Debinagar,196,385,105,183,91,202,33.7,36.5,31.1,00000
44.0,80.0,63.0,439,03,01,  Baliadanga,128,113,70,47,58,66,53.1,59.8,46.8,00000
44.0,80.0,63.0,439,04,01,  Mandari Para,147,265,67,120,80,145,35.7,35.8,35.6,00000
44.0,80.0,63.0,439,05,01,  Kismat Mailmari,370,453,193,220,177,233,45.0,46.7,43.2,00000
44.0,80.0,63.0,439,06,01,  Jadabpur,331,694,167,348,164,346,32.3,32.4,32.2,00000
44.0,80.0,63.0,439,07,01,  Bhala Para,214,301,112,146,102,155,41.6,43.4,39.7,00000
44.0,80.0,63.0,670,01,01,  Mirzapur,917,784,495,364,422,420,53.9,57.6,50.1,00000
44.0,80.0,63.0,670,02,01,  Britti Raninagar,113,106,72,45,41,61,51.6,61.5,40.2,00000
44.0,80.0,63.0,670,03,01,  Kana Pukuria,476,315,253,146,223,169,60.2,63.4,56.9,00000
44.0,80.0,63.0,670,04,01,  Char Para,221,316,113,148,108,168,41.2,43.3,39.1,00000
44.0,80.0,63.0,670,05,01,  Sherpur,344,219,191,97,153,122,61.1,66.3,55.6,00000
44.0,80.0,63.0,769,01,01,  Paramanandapur,32,21,16,11,16,10,60.4,59.3,61.5,00000
44.0,80.0,63.0,769,02,01,  Char Paramanandapur,597,741,296,363,301,378,44.6,44.9,44.3,00000
44.0,80.0,63.0,769,03,01,  Glokenagar,520,555,254,251,266,304,48.4,50.3,46.7,00000
44.0,80.0,63.0,824,01,01,  Ramchandrapur,863,1313,423,601,440,712,39.7,41.3,38.2,00000
44.0,80.0,63.0,824,02,01,  Maheshgari,584,836,311,400,273,436,41.1,43.7,38.5,00000
44.0,80.0,69.0,043,01,01,  Baraichara,24,83,17,38,7,45,22.4,30.9,13.5,00000
44.0,80.0,69.0,043,02,01,  Khalpalia,406,496,257,220,149,276,45.0,53.9,35.1,00000
44.0,80.0,69.0,142,01,01,  Bhandari Para,299,451,167,224,132,227,39.9,42.7,36.8,00000
44.0,80.0,69.0,142,02,01,  Bakshipur,239,255,125,130,114,125,48.4,49.0,47.7,00000
44.0,80.0,69.0,142,03,01,  Raghunandapur,633,785,341,397,292,388,44.6,46.2,42.9,00000
44.0,80.0,69.0,142,04,01,  Royjadapur,107,225,53,117,54,108,32.2,31.2,33.3,00000
44.0,80.0,69.0,494,01,01,  Kakuridanga,111,234,63,119,48,115,32.2,34.6,29.4,00000
44.0,80.0,69.0,494,02,01,  Golaknagar,209,163,105,75,104,88,56.2,58.3,54.2,00000
44.0,80.0,75.0,093,01,01,  Puratan Bakharba,515,570,243,269,272,301,47.5,47.5,47.5,00000
44.0,80.0,75.0,093,02,01,  Char Bakharba,1147,1245,603,592,544,653,48.0,50.5,45.4,00000
44.0,80.0,75.0,093,03,01,  Sekh Para,64,160,34,84,30,76,28.6,28.8,28.3,00000
44.0,80.0,75.0,093,04,01,  Britti Para,167,147,87,70,80,77,53.2,55.4,51.0,00000
44.0,80.0,75.0,659,01,01,  Bara Maukuri,358,651,198,307,160,344,35.5,39.2,31.7,00000
44.0,80.0,75.0,659,02,01,  Chhota Maukuri,374,547,190,261,184,286,40.6,42.1,39.1,00000
44.0,80.0,75.0,659,03,01,  Char Maukuri,169,316,82,155,87,161,34.8,34.6,35.1,00000
44.0,80.0,75.0,681,01,01,  Nabagram,260,380,133,171,127,209,40.6,43.8,37.8,00000
44.0,80.0,75.0,681,02,01,  Brakhpur,753,1167,389,550,364,617,39.2,41.4,37.1,00000
44.0,80.0,75.0,681,03,01,  Goalbaria,276,413,141,201,135,212,40.1,41.2,38.9,00000
44.0,80.0,75.0,879,01,01,  Sarutia,971,1180,520,525,451,655,45.1,49.8,40.8,00000
44.0,80.0,75.0,879,02,01,  Goshaidanga,483,509,233,257,250,252,48.7,47.6,49.8,00000
44.0,80.0,75.0,879,03,01,  Gangkola,142,435,63,213,79,222,24.6,22.8,26.2,00000
44.0,80.0,75.0,879,04,01,  Sabaria,245,241,123,124,122,117,50.4,49.8,51.0,00000
44.0,80.0,75.0,973,01,01,  Krishnanagar,627,463,326,218,301,245,57.5,59.9,55.1,00000
44.0,80.0,75.0,973,02,01,  Katlagari Bazar,159,80,107,35,52,45,66.5,75.4,53.6,00000
44.0,80.0,88.0,120,01,01,  Basantapur,979,714,506,325,473,389,57.8,60.9,54.9,00000
44.0,80.0,88.0,120,02,01,  Ramjoypur,171,221,86,106,85,115,43.6,44.8,42.5,00000
44.0,80.0,88.0,346,01,01,  Dulalpur,2482,283,1556,126,926,157,89.8,92.5,85.5,00000
44.0,80.0,88.0,346,02,01,  Goalpara,42,23,22,11,20,12,64.6,66.7,62.5,00000
44.0,80.0,88.0,346,03,01,  Bhadradanga,140,207,85,102,55,105,40.3,45.5,34.4,00000
44.0,80.0,88.0,346,04,01,  Anandanagar,623,629,415,305,208,324,49.8,57.6,39.1,00000
44.0,80.0,88.0,346,05,01,  Char Para,313,158,202,71,111,87,66.5,74.0,56.1,00000
44.0,80.0,88.0,912,01,01,  Sekh Para,1259,927,691,440,568,487,57.6,61.1,53.8,00000
44.0,80.0,88.0,912,02,01,  Shitalidanga,457,397,260,183,197,214,53.5,58.7,47.9,00000
44.0,80.0,88.0,912,03,01,  Boalia,153,198,90,94,63,104,43.6,48.9,37.7,00000
44.0,80.0,88.0,962,01,01,  Char Tribeni,132,166,73,85,59,81,44.3,46.2,42.1,00000
44.0,80.0,88.0,962,02,01,  Tribeni,1505,2101,766,1001,739,1100,41.7,43.4,40.2,00000
44.0,80.0,94.0,373,01,01,  Garakhola,289,208,145,111,144,97,58.1,56.6,59.8,00000
44.0,80.0,94.0,373,02,01,  Maheshpur,613,608,315,314,298,294,50.2,50.1,50.3,00000
44.0,80.0,94.0,373,03,01,  Garaganj Bazar,293,165,156,73,137,92,64.0,68.1,59.8,00000
44.0,80.0,94.0,373,04,01,  Madhupur,342,403,186,196,156,207,45.9,48.7,43.0,00000
44.0,80.0,94.0,956,01,01,  Umedpur,204,313,107,150,97,163,39.5,41.6,37.3,00000
44.0,80.0,94.0,956,02,01,  Bishnupur,637,720,337,346,300,374,46.9,49.3,44.5,00000
44.0,80.0,94.0,956,03,01,  Lakshmandia,490,412,283,182,207,230,54.3,60.9,47.4,00000
44.0,80.0,94.0,956,04,01,  Kadamtala,338,324,171,149,167,175,51.1,53.4,48.8,00000
44.0,80.0,94.0,956,05,01,  Krishnapur,757,1046,430,472,327,574,42.0,47.7,36.3,00000
44.0,80.0,94.0,956,06,01,  Parbatipur,317,513,172,247,145,266,38.2,41.1,35.3,00000
44.0,80.0,94.0,956,07,01,  Gobindapur,573,940,270,477,303,463,37.9,36.1,39.6,00000
44.0,80.0,94.0,956,08,01,  Goalbari,263,305,137,146,126,159,46.3,48.4,44.2,00000
44.0,80.0,94.0,956,09,01,  Aruakandi,393,478,182,226,211,252,45.1,44.6,45.6,00000
44.0,80.0,94.0,956,10,01,  Khariabari,159,185,97,75,62,110,46.2,56.4,36.0,00000
44.0,80.0,94.0,956,11,01,  Bahir Royra,627,353,309,153,318,200,64.0,66.9,61.4,00000
44.0,80.0,94.0,956,12,01,  Taminagar,445,716,243,358,202,358,38.3,40.4,36.1,00000
44.0,80.0,94.0,956,13,01,  Royra,1027,1041,526,478,501,563,49.7,52.4,47.1,00000
44.0,80.0,94.0,956,14,01,  Bahadurpur,212,305,116,149,96,156,41.0,43.8,38.1,00000
41.0,4.0,10.0,210,01,01,  Vatpara,936,901,488,414,448,487,51.0,54.1,47.9,00000
41.0,4.0,10.0,210,02,01,  Bagura Tala,155,197,75,101,80,96,44.0,42.6,45.5,00000
41.0,4.0,10.0,210,03,01,  Abhaynagar,605,460,302,229,303,231,56.8,56.9,56.7,00000
41.0,4.0,10.0,210,04,01,  Shib Nagar,106,216,45,106,61,110,32.9,29.8,35.7,00000
41.0,4.0,10.0,243,01,01,  Bibhagdi,980,950,517,428,463,522,50.8,54.7,47.0,00000
41.0,4.0,10.0,243,02,01,  Adilpur,270,95,146,46,124,49,74.0,76.0,71.7,00000
41.0,4.0,10.0,740,01,01,  Paik Para,1057,682,571,305,486,377,60.8,65.2,56.3,00000
41.0,4.0,10.0,740,02,01,  Bhugilghat,547,1024,304,485,243,539,34.8,38.5,31.1,00000
41.0,4.0,10.0,740,03,01,  Putpara,451,455,216,222,235,233,49.8,49.3,50.2,00000
41.0,4.0,21.0,818,01,01,  Prembagh,2393,1110,1239,476,1154,634,68.3,72.2,64.5,00000
41.0,4.0,21.0,818,02,01,  Guchchhagram,47,48,18,23,29,25,49.5,43.9,53.7,00000
41.0,4.0,42.0,906,01,01,  Samaspur,1359,945,744,428,615,517,59.0,63.5,54.3,00000
41.0,4.0,42.0,906,02,01,  Kadir Para,928,611,492,266,436,345,60.3,64.9,55.8,00000
41.0,4.0,42.0,906,03,01,  Ghoradari,261,197,139,86,122,111,57.0,61.8,52.4,00000
41.0,4.0,52.0,276,01,01,  Chalishia,1780,1321,958,566,822,755,57.4,62.9,52.1,00000
41.0,4.0,52.0,276,02,01,  Anda,419,344,236,151,183,193,54.9,61.0,48.7,00000
41.0,4.0,52.0,453,01,01,  Ektarpur,603,670,316,327,287,343,47.4,49.1,45.6,00000
41.0,4.0,52.0,453,02,01,  Gramtali,544,589,272,292,272,297,48.0,48.2,47.8,00000
41.0,4.0,52.0,453,03,01,  Bakerdanga,137,265,78,149,59,116,34.1,34.4,33.7,00000
41.0,4.0,52.0,619,01,01,  Kota,2169,2119,1116,1006,1053,1113,50.6,52.6,48.6,00000
41.0,4.0,52.0,619,02,01,  Balarabad,181,163,108,73,73,90,52.6,59.7,44.8,00000
41.0,4.0,63.0,420,01,01,  Ramnagar,401,296,217,129,184,167,57.5,62.7,52.4,00000
41.0,4.0,63.0,420,02,01,  Chandrapur,536,485,282,210,254,275,52.5,57.3,48.0,00000
41.0,4.0,63.0,420,03,01,  Shantipur,21,49,15,19,6,30,30.0,44.1,16.7,00000
41.0,4.0,63.0,729,01,01,  Nauli,2106,1670,1080,822,1026,848,55.8,56.8,54.7,00000
41.0,4.0,63.0,729,02,01,  Chandangati,296,166,159,76,137,90,64.1,67.7,60.4,00000
41.0,4.0,63.0,729,03,01,  Uttar Arpara,13,2,6,0,7,2,86.7,100.0,77.8,00000
41.0,4.0,63.0,729,04,01,  Dakshin Arpara,116,29,56,12,60,17,80.0,82.4,77.9,00000
41.0,4.0,63.0,939,01,01,  Siddhipasha,5833,3998,3049,1865,2784,2133,59.3,62.0,56.6,00000
41.0,4.0,63.0,939,02,01,  Nalamara,313,178,172,80,141,98,63.7,68.3,59.0,00000
41.0,4.0,63.0,939,03,01,  Dighaliarabad,143,251,78,121,65,130,36.3,39.2,33.3,00000
41.0,4.0,63.0,939,04,01,  Joyrabad,373,352,191,170,182,182,51.4,52.9,50.0,00000
41.0,4.0,73.0,110,01,01,  Banagram,410,257,205,117,205,140,61.5,63.7,59.4,00000
41.0,4.0,73.0,110,02,01,  Kamkul,847,596,408,285,439,311,58.7,58.9,58.5,00000
41.0,4.0,73.0,143,01,01,  Barni,666,446,357,224,309,222,59.9,61.4,58.2,00000
41.0,4.0,73.0,143,02,01,  Maldahra,287,204,137,107,150,97,58.5,56.1,60.7,00000
41.0,4.0,73.0,143,03,01,  Baral,156,154,76,75,80,79,50.3,50.3,50.3,00000
41.0,4.0,73.0,143,04,01,  Saradanga,76,40,45,19,31,21,65.5,70.3,59.6,00000
41.0,4.0,73.0,143,05,01,  Kachua,118,35,63,17,55,18,77.1,78.8,75.3,00000
41.0,4.0,84.0,154,01,01,  Basuari,2438,1511,1251,684,1187,827,61.7,64.7,58.9,00000
41.0,4.0,84.0,154,02,01,  Labugati,527,322,287,131,240,191,62.1,68.7,55.7,00000
41.0,4.0,84.0,519,01,01,  Hidia,2585,1611,1368,717,1217,894,61.6,65.6,57.7,00000
41.0,4.0,84.0,519,02,01,  Shyamnagar,342,254,165,122,177,132,57.4,57.5,57.3,00000
41.0,4.0,84.0,983,01,01,  Subharara,2119,1177,1068,563,1051,614,64.3,65.5,63.1,00000
41.0,4.0,84.0,983,02,01,  Sukpara,575,213,288,97,287,116,73.0,74.8,71.2,00000
41.0,9.0,15.0,344,01,01,  Dakshin Sreerampur,1243,1715,633,834,610,881,42.0,43.1,40.9,00000
41.0,9.0,15.0,344,02,01,  Pakarali,461,805,240,373,221,432,36.4,39.2,33.8,00000
41.0,9.0,15.0,344,03,01,  Raghunathpur,301,131,153,58,148,73,69.7,72.5,67.0,00000
41.0,9.0,15.0,344,04,01,  Charavita Bazar,9,5,5,3,4,2,64.3,62.5,66.7,00000
41.0,9.0,15.0,867,01,01,  Rustampur,314,244,169,115,145,129,56.3,59.5,52.9,00000
41.0,9.0,15.0,867,02,01,  Debinagar,190,149,101,66,89,83,56.0,60.5,51.7,00000
41.0,9.0,19.0,401,01,01,  Dharmagati,387,284,221,131,166,153,57.7,62.8,52.0,00000
41.0,9.0,19.0,401,02,01,  Parbatipur,301,92,168,30,133,62,76.6,84.8,68.2,00000
41.0,9.0,19.0,688,01,01,  Mathurapur,802,565,396,263,406,302,58.7,60.1,57.3,00000
41.0,9.0,19.0,688,02,01,  Panta Para,395,100,210,31,185,69,79.8,87.1,72.8,00000
41.0,9.0,19.0,778,01,01,  Pathan Paik Para,1358,1289,662,635,696,654,51.3,51.0,51.6,00000
41.0,9.0,19.0,778,02,01,  Bhabanipur,199,216,102,109,97,107,48.0,48.3,47.5,00000
41.0,9.0,19.0,873,01,01,  Sadipur,804,561,446,233,358,328,58.9,65.7,52.2,00000
41.0,9.0,19.0,873,02,01,  Krishnapur,160,128,88,55,72,73,55.6,61.5,49.7,00000
41.0,9.0,19.0,873,03,01,  Rampur,63,41,37,16,26,25,60.6,69.8,51.0,00000
41.0,9.0,19.0,956,01,01,  Telidhanyapura,840,813,440,390,400,423,50.8,53.0,48.6,00000
41.0,9.0,19.0,956,02,01,  Khezura Bazar,614,299,316,143,298,156,67.3,68.8,65.6,00000
41.0,9.0,28.0,350,01,01,  Darajhat,1277,1324,653,658,624,666,49.1,49.8,48.4,00000
41.0,9.0,28.0,350,02,01,  Satiantala,115,109,57,51,58,58,51.3,52.8,50.0,00000
41.0,9.0,28.0,746,01,01,  Paikpara,753,845,418,361,335,484,47.1,53.7,40.9,00000
41.0,9.0,28.0,746,02,01,  Karaitala,323,211,171,103,152,108,60.5,62.4,58.5,00000
41.0,9.0,28.0,924,01,01,  Sukdebpur,340,221,172,98,168,123,60.6,63.7,57.7,00000
41.0,9.0,28.0,924,02,01,  Ramkrishnapur,83,115,42,57,41,58,41.9,42.4,41.4,00000
41.0,9.0,28.0,924,03,01,  Lakshmi Narayanpur,79,50,46,20,33,30,61.2,69.7,52.4,00000
41.0,9.0,28.0,924,04,01,  Kalikapur,200,116,100,54,100,62,63.3,64.9,61.7,00000
41.0,9.0,38.0,057,01,01,  Antaikhola,924,267,482,121,442,146,77.6,79.9,75.2,00000
41.0,9.0,38.0,057,02,01,  Andarkota,388,50,206,11,182,39,88.6,94.9,82.4,00000
41.0,9.0,38.0,363,01,01,  Daspakhia,1199,1040,613,499,586,541,53.6,55.1,52.0,00000
41.0,9.0,38.0,363,02,01,  Kabirbhita,229,203,103,96,126,107,53.0,51.8,54.1,00000
41.0,9.0,38.0,937,01,01,  Sultannagar,170,77,106,40,64,37,68.8,72.6,63.4,00000
41.0,9.0,38.0,937,02,01,  Natungram,123,98,81,45,42,53,55.7,64.3,44.2,00000
41.0,9.0,38.0,937,03,01,  Sreepur,182,149,111,54,71,95,55.0,67.3,42.8,00000
41.0,9.0,47.0,255,01,01,  Bahrampur,1219,606,633,261,586,345,66.8,70.8,62.9,00000
41.0,9.0,47.0,255,02,01,  Chhota Bahrampur,68,45,37,18,31,27,60.2,67.3,53.4,00000
41.0,9.0,47.0,255,03,01,  Boalia,342,158,190,62,152,96,68.4,75.4,61.3,00000
41.0,9.0,47.0,255,04,01,  Basuari,159,76,86,24,73,52,67.7,78.2,58.4,00000
41.0,9.0,47.0,408,01,01,  Dhepkhali,285,350,163,162,122,188,44.9,50.2,39.4,00000
41.0,9.0,47.0,408,02,01,  Thakurkati,333,455,152,229,181,226,42.3,39.9,44.5,00000
41.0,9.0,47.0,669,01,01,  Mamudalipur,644,555,335,225,309,330,53.7,59.8,48.4,00000
41.0,9.0,47.0,669,02,01,  Baulia,468,278,251,108,217,170,62.7,69.9,56.1,00000
41.0,9.0,47.0,669,03,01,  Baliadanga,162,70,86,31,76,39,69.8,73.5,66.1,00000
41.0,9.0,57.0,529,01,01,  Jamdia,1701,1887,869,871,832,1016,47.4,49.9,45.0,00000
41.0,9.0,57.0,529,02,01,  Dadpur,411,579,207,297,204,282,41.5,41.1,42.0,00000
41.0,9.0,57.0,529,03,01,  Adampur,358,293,193,122,165,171,55.0,61.3,49.1,00000
41.0,9.0,57.0,548,01,01,  Joyrampur,510,363,270,185,240,178,58.4,59.3,57.4,00000
41.0,9.0,57.0,548,02,01,  Barra,576,668,304,332,272,336,46.3,47.8,44.7,00000
41.0,9.0,57.0,548,03,01,  Nittanandapur,488,308,252,166,236,142,61.3,60.3,62.4,00000
41.0,9.0,57.0,561,01,01,  Karimpur,937,1278,461,642,476,636,42.3,41.8,42.8,00000
41.0,9.0,57.0,561,02,01,  Chakerdanga,79,68,50,26,29,42,53.7,65.8,40.8,00000
41.0,9.0,57.0,822,01,01,  Raghurampur,139,137,72,65,67,72,50.4,52.6,48.2,00000
41.0,9.0,57.0,822,02,01,  Kamalapur,215,110,117,45,98,65,66.2,72.2,60.1,00000
41.0,9.0,76.0,663,01,01,  Malanchi,392,661,182,309,210,352,37.2,37.1,37.4,00000
41.0,9.0,76.0,663,02,01,  Baliadanga,152,161,82,77,70,84,48.6,51.6,45.5,00000
41.0,9.0,76.0,663,03,01,  Birampur,354,359,211,145,143,214,49.6,59.3,40.1,00000
41.0,9.0,85.0,637,01,01,  Krishanagar,1303,989,644,497,659,492,56.8,56.4,57.3,00000
41.0,9.0,85.0,637,02,01,  Joynagar,443,521,213,252,230,269,46.0,45.8,46.1,00000
41.0,9.0,85.0,848,01,01,  Ramkrishnapur,476,520,209,268,267,252,47.8,43.8,51.4,00000
41.0,9.0,85.0,848,02,01,  Kalikapur,159,213,70,95,89,118,42.7,42.4,43.0,00000
41.0,9.0,85.0,918,01,01,  Shilumpur,355,549,160,276,195,273,39.3,36.7,41.7,00000
41.0,9.0,85.0,918,02,01,  Arage Shilumpur,196,154,90,76,106,78,56.0,54.2,57.6,00000
41.0,11.0,14.0,550,01,01,  Uttar Karai Para,706,776,389,355,317,421,47.6,52.3,43.0,00000
41.0,11.0,14.0,550,02,01,  Dakshin Karai Para,865,903,455,396,410,507,48.9,53.5,44.7,00000
41.0,11.0,17.0,515,01,01,  Bara Kabilpur,604,742,318,371,286,371,44.9,46.2,43.5,00000
41.0,11.0,17.0,515,02,01,  Chhotto Kabilpur,327,361,166,173,161,188,47.5,49.0,46.1,00000
41.0,11.0,25.0,388,01,01,  Hakimpur,1379,780,694,374,685,406,63.9,65.0,62.8,00000
41.0,11.0,25.0,388,02,01,  Mat Hakimpur,119,282,65,137,54,145,29.7,32.2,27.1,00000
41.0,11.0,25.0,501,01,01,  Jatrapur,657,662,318,296,339,366,49.8,51.8,48.1,00000
41.0,11.0,25.0,501,02,01,  Dulalpur,350,467,176,224,174,243,42.8,44.0,41.7,00000
41.0,11.0,43.0,014,01,01,  Andarkota,454,323,232,150,222,173,58.4,60.7,56.2,00000
41.0,11.0,43.0,014,02,01,  Bagardari,195,309,116,132,79,177,38.7,46.8,30.9,00000
41.0,11.0,43.0,522,01,01,  Bara Kakuria,130,167,68,70,62,97,43.8,49.3,39.0,00000
41.0,11.0,43.0,522,02,01,  Chhota Kakuria,577,797,295,404,282,393,42.0,42.2,41.8,00000
41.0,11.0,43.0,522,03,01,  Tilakpur,149,185,72,85,77,100,44.6,45.9,43.5,00000
41.0,11.0,43.0,522,04,01,  Nayra,101,97,54,41,47,56,51.0,56.8,45.6,00000
41.0,11.0,43.0,522,05,01,  Kakuria Nauda Para,225,288,111,144,114,144,43.9,43.5,44.2,00000
41.0,11.0,43.0,557,01,01,  Kharingcha,1140,1074,640,518,500,556,51.5,55.3,47.3,00000
41.0,11.0,43.0,557,02,01,  Kharingha Nowdapara,130,382,66,182,64,200,25.4,26.6,24.2,00000
41.0,11.0,43.0,557,03,01,  Bahilapola,243,324,154,148,89,176,42.9,51.0,33.6,00000
41.0,11.0,43.0,557,04,01,  Dabalay,484,275,260,135,224,140,63.8,65.8,61.5,00000
41.0,11.0,43.0,557,05,01,  Beja Kharingha,220,291,126,140,94,151,43.1,47.4,38.4,00000
41.0,11.0,43.0,663,01,01,  Masila,541,417,274,190,267,227,56.5,59.1,54.0,00000
41.0,11.0,43.0,663,02,01,  Lakshmipur,201,88,120,40,81,48,69.6,75.0,62.8,00000
41.0,11.0,43.0,938,01,01,  Swarupdaha,1468,616,754,281,714,335,70.4,72.9,68.1,00000
41.0,11.0,43.0,938,02,01,  Kadamtala,185,128,99,57,86,71,59.1,63.5,54.8,00000
41.0,11.0,51.0,381,01,01,  Guatali,577,579,312,274,265,305,49.9,53.2,46.5,00000
41.0,11.0,51.0,381,02,01,  Kismat Khanpur,310,327,164,148,146,179,48.7,52.6,44.9,00000
41.0,11.0,51.0,381,03,01,  Kathbilla,422,558,234,270,188,288,43.1,46.4,39.5,00000
41.0,11.0,51.0,381,04,01,  Mandartala Para,105,105,60,52,45,53,50.0,53.6,45.9,00000
41.0,23.0,25.0,537,01,01,  Khosalnagar,311,265,154,124,157,141,54.0,55.4,52.7,00000
41.0,23.0,25.0,537,02,01,  Balidanga,521,414,293,174,228,240,55.7,62.7,48.7,00000
41.0,23.0,29.0,048,01,01,  Atila,961,1195,500,571,461,624,44.6,46.7,42.5,00000
41.0,23.0,29.0,048,02,01,  Sreechandrapur,553,698,266,362,287,336,44.2,42.4,46.1,00000
41.0,23.0,47.0,595,01,01,  Laujani,525,707,257,359,268,348,42.6,41.7,43.5,00000
41.0,23.0,47.0,595,02,01,  Lakshmipur,820,728,404,341,416,387,53.0,54.2,51.8,00000
41.0,23.0,47.0,595,03,01,  Naodapara,271,128,147,47,124,81,67.9,75.8,60.5,00000
41.0,23.0,47.0,670,01,01,  Chandrapur,288,144,144,53,144,91,66.7,73.1,61.3,00000
41.0,23.0,47.0,670,02,01,  Mirzapur,403,644,208,320,195,324,38.5,39.4,37.6,00000
41.0,23.0,47.0,670,03,01,  Kashipur,1104,944,575,436,529,508,53.9,56.9,51.0,00000
41.0,23.0,53.0,795,01,01,  Phulbari,377,578,196,273,181,305,39.5,41.8,37.2,00000
41.0,23.0,53.0,795,02,01,  Daulatpur,571,522,298,237,273,285,52.2,55.7,48.9,00000
41.0,23.0,59.0,715,01,01,  Nabharan,1340,1219,691,550,649,669,52.4,55.7,49.2,00000
41.0,23.0,59.0,715,02,01,  Belemat,198,226,93,104,105,122,46.7,47.2,46.3,00000
41.0,23.0,59.0,715,03,01,  Dhaka Para,202,326,93,157,109,169,38.3,37.2,39.2,00000
41.0,23.0,59.0,715,04,01,  Islampur,207,455,90,220,117,235,31.3,29.0,33.2,00000
41.0,23.0,59.0,830,01,01,  Kundipur,690,951,341,429,349,522,42.0,44.3,40.1,00000
41.0,23.0,59.0,830,02,01,  Bagh,409,363,203,165,206,198,53.0,55.2,51.0,00000
41.0,23.0,59.0,830,03,01,  Dangi,244,143,126,67,118,76,63.0,65.3,60.8,00000
41.0,23.0,59.0,830,04,01,  Banki,344,459,182,223,162,236,42.8,44.9,40.7,00000
41.0,23.0,83.0,808,01,01,  Chotta Pudaulia,592,644,278,304,314,340,47.9,47.8,48.0,00000
41.0,23.0,83.0,808,02,01,  Haridrapota,502,330,262,133,240,197,60.3,66.3,54.9,00000
41.0,23.0,83.0,808,03,01,  Bara Pudaulia,381,643,180,303,201,340,37.2,37.3,37.2,00000
41.0,23.0,89.0,932,01,01,  Simulia,1255,916,623,402,632,514,57.8,60.8,55.1,00000
41.0,23.0,89.0,932,02,01,  Gopinathpur,191,305,97,147,94,158,38.5,39.8,37.3,00000
41.0,38.0,57.0,217,01,01,  Bramon Danga,321,272,165,124,156,148,54.1,57.1,51.3,00000
41.0,38.0,57.0,217,02,01,  Kamlapur,468,353,258,159,210,194,57.0,61.9,52.0,00000
41.0,38.0,57.0,686,01,01,  Baghdanga,588,678,344,294,244,384,46.4,53.9,38.9,00000
41.0,38.0,57.0,686,02,01,  Monohar Nagar,1275,1680,708,758,567,922,43.1,48.3,38.1,00000
41.0,47.0,10.0,190,01,01,  Brikutia,3139,1858,1570,849,1569,1009,62.8,64.9,60.9,00000
41.0,47.0,10.0,190,02,01,  Balia Bhikotia,2411,1356,1267,619,1144,737,64.0,67.2,60.8,00000
41.0,47.0,10.0,227,01,01,  Pakdia,491,195,252,84,239,111,71.6,75.0,68.3,00000
41.0,47.0,10.0,227,02,01,  Chandpur,274,315,126,162,148,153,46.5,43.8,49.2,00000
41.0,47.0,29.0,004,01,01,  Abdulpur,700,678,360,338,340,340,50.8,51.6,50.0,00000
41.0,47.0,29.0,004,02,01,  Pultadanga,499,414,255,198,244,216,54.7,56.3,53.0,00000
41.0,47.0,29.0,333,01,01,  Dogachhia,1303,1219,662,596,641,623,51.7,52.6,50.7,00000
41.0,47.0,29.0,333,02,01,  Islampur,439,440,203,203,236,237,49.9,50.0,49.9,00000
41.0,47.0,29.0,487,01,01,  Jhaudia,1766,1397,906,691,860,706,55.8,56.7,54.9,00000
41.0,47.0,29.0,487,02,01,  Naldanga,349,298,181,138,168,160,53.9,56.7,51.2,00000
41.0,47.0,29.0,532,01,01,  Kamlapur,547,491,315,223,232,268,52.7,58.6,46.4,00000
41.0,47.0,29.0,532,02,01,  Belearmath,144,172,65,89,79,83,45.6,42.2,48.8,00000
41.0,47.0,29.0,625,01,01,  Khitibdia,2082,862,1083,384,999,478,70.7,73.8,67.6,00000
41.0,47.0,29.0,625,02,01,  Chhayiantala (Part),417,298,220,151,197,147,58.3,59.3,57.3,00000
41.0,47.0,29.0,877,01,01,  Sajiali,996,749,602,356,394,393,57.1,62.8,50.1,00000
41.0,47.0,29.0,877,02,01,  Shyamnagar,613,677,317,316,296,361,47.5,50.1,45.1,00000
41.0,47.0,35.0,231,01,01,  Chandutia,1653,1463,854,682,799,781,53.0,55.6,50.6,00000
41.0,47.0,35.0,231,02,01,  Gobindapur,316,420,150,219,166,201,42.9,40.7,45.2,00000
41.0,47.0,41.0,365,01,01,  Daitala,997,858,516,403,481,455,53.7,56.1,51.4,00000
41.0,47.0,41.0,365,02,01,  Fatehpur,1418,1317,751,628,667,689,51.8,54.5,49.2,00000
41.0,47.0,41.0,832,01,01,  Rajapur,535,467,253,237,282,230,53.4,51.6,55.1,00000
41.0,47.0,41.0,832,02,01,  Baghdanga,704,411,389,169,315,242,63.1,69.7,56.6,00000
41.0,47.0,53.0,828,01,01,  Bara Rajapur,681,687,327,327,354,360,49.8,50.0,49.6,00000
41.0,47.0,53.0,828,02,01,  Hod Rajapur,248,191,138,89,110,102,56.5,60.8,51.9,00000
41.0,47.0,65.0,958,01,01,  Shyamnagar,620,631,317,341,303,290,49.6,48.2,51.1,00000
41.0,47.0,65.0,958,02,01,  Naodagram,876,774,459,359,417,415,53.1,56.1,50.1,00000
41.0,47.0,71.0,523,01,01,  Kaikhali,601,520,325,231,276,289,53.6,58.5,48.8,00000
41.0,47.0,71.0,523,02,01,  Marakola,193,256,107,125,86,131,43.0,46.1,39.6,00000
41.0,47.0,83.0,085,01,01,  Balarampur,1365,1022,705,512,660,510,57.2,57.9,56.4,00000
41.0,47.0,83.0,085,02,01,  Ghatra,198,65,115,25,83,40,75.3,82.1,67.5,00000
41.0,47.0,89.0,980,01,01,  Shekhati (Part),6916,3125,3792,1499,3124,1626,68.9,71.7,65.8,00000
41.0,47.0,89.0,980,02,01,  Chhotashekhati,202,249,105,111,97,138,44.8,48.6,41.3,00000
41.0,47.0,95.0,609,01,03,  Block-B,1280,269,690,110,590,159,82.6,86.3,78.8,00000
41.0,47.0,95.0,609,02,03,  Block-C,1487,177,743,57,744,120,89.4,92.9,86.1,00000
41.0,47.0,95.0,609,03,03,  Block-D,2221,863,1158,390,1063,473,72.0,74.8,69.2,00000
41.0,47.0,95.0,609,04,03,  Block-E (Kismat Noapara),2732,295,1406,129,1326,166,90.3,91.6,88.9,00000
41.0,61.0,22.0,251,01,01,  Durbadanga,967,1172,522,520,445,652,45.2,50.1,40.6,00000
41.0,61.0,22.0,251,02,01,  Zikardanga,409,368,226,153,183,215,52.6,59.6,46.0,00000
41.0,61.0,50.0,527,01,01,  Sekh Para,1141,1336,591,630,550,706,46.1,48.4,43.8,00000
41.0,61.0,50.0,527,02,01,  Manshikhanpur,1049,846,555,405,494,441,55.4,57.8,52.8,00000
41.0,61.0,50.0,527,03,01,  Makomtala,435,468,231,230,204,238,48.2,50.1,46.2,00000
41.0,61.0,50.0,527,04,01,  Gobindapur,1163,1399,585,654,578,745,45.4,47.2,43.7,00000
41.0,61.0,61.0,203,01,01,  Dahakula,273,263,141,118,132,145,50.9,54.4,47.7,00000
41.0,61.0,61.0,203,02,01,  Baghdanga,268,241,130,100,138,141,52.7,56.5,49.5,00000
41.0,61.0,67.0,426,01,01,  Jaljhara,1246,845,644,409,602,436,59.6,61.2,58.0,00000
41.0,61.0,67.0,426,02,01,  Hajrakati,783,444,412,212,371,232,63.8,66.0,61.5,00000
41.0,61.0,67.0,426,03,01,  Khudra Gangra,296,462,160,233,136,229,39.1,40.7,37.3,00000
41.0,90.0,13.0,103,01,01,  Basatpur 2nd Colony,354,491,197,232,157,259,41.9,45.9,37.7,00000
41.0,90.0,13.0,103,02,01,  Basatpur,2089,1558,1060,698,1029,860,57.3,60.3,54.5,00000
41.0,90.0,13.0,103,03,01,  Basatpur 1st Colony,850,1183,458,563,392,620,41.8,44.9,38.7,00000
41.0,90.0,13.0,103,04,01,  Sonatankati,883,793,468,360,415,433,52.7,56.5,48.9,00000
41.0,90.0,13.0,103,05,01,  Bamunia,269,443,139,218,130,225,37.8,38.9,36.6,00000
41.0,90.0,13.0,103,06,01,  Sarifpur,183,122,92,55,91,67,60.0,62.6,57.6,00000
41.0,90.0,17.0,169,01,01,  Boalia Manik,866,911,455,454,411,457,48.7,50.1,47.4,00000
41.0,90.0,17.0,169,02,01,  Manikia,458,439,234,221,224,218,51.1,51.4,50.7,00000
41.0,90.0,25.0,073,01,01,  Bara Achra Part,314,486,154,237,160,249,39.3,39.4,39.1,00000
41.0,90.0,25.0,073,02,01,  Gatipara,836,837,455,387,381,450,50.0,54.0,45.8,00000
41.0,90.0,25.0,449,01,01,  Kakojpukuria,1100,832,563,397,537,435,56.9,58.6,55.2,00000
41.0,90.0,25.0,449,02,01,  Kagmari,483,783,238,403,245,380,38.2,37.1,39.2,00000
41.0,90.0,34.0,825,01,01,  Salkona,984,712,519,334,465,378,58.0,60.8,55.2,00000
41.0,90.0,34.0,825,02,01,  Shibbas,836,326,432,131,404,195,71.9,76.7,67.4,00000
41.0,90.0,43.0,154,01,01,  Pach Bhulat,1093,1835,554,908,539,927,37.3,37.9,36.8,00000
41.0,90.0,43.0,154,02,01,  Agra Bhulat,1393,1337,747,643,646,694,51.0,53.7,48.2,00000
41.0,90.0,51.0,036,01,01,  Baguri,1985,1126,1051,496,934,630,63.8,67.9,59.7,00000
41.0,90.0,51.0,036,02,01,  Kota,1149,1234,594,573,555,661,48.2,50.9,45.6,00000
41.0,90.0,51.0,280,01,01,  Digha,334,483,180,217,154,266,40.9,45.3,36.7,00000
41.0,90.0,51.0,280,02,01,  Chaltabaria,458,400,233,189,225,211,53.4,55.2,51.6,00000
41.0,90.0,51.0,508,01,01,  Kayba,1275,1484,646,732,629,752,46.2,46.9,45.5,00000
41.0,90.0,51.0,508,02,01,  Panch Kayba,762,869,390,410,372,459,46.7,48.8,44.8,00000
41.0,90.0,60.0,685,01,01,  Paraikhupi,645,621,315,271,330,350,50.9,53.8,48.5,00000
41.0,90.0,60.0,685,02,01,  Majamara,89,133,45,60,44,73,40.1,42.9,37.6,00000
41.0,90.0,60.0,685,03,01,  Andalpota,218,184,99,91,119,93,54.2,52.1,56.1,00000
41.0,90.0,69.0,095,01,01,  Bara Basantapur,658,886,311,399,347,487,42.6,43.8,41.6,00000
41.0,90.0,69.0,095,02,01,  Chhota Bashantapur,237,310,112,146,125,164,43.3,43.4,43.3,00000
41.0,90.0,69.0,095,03,01,  Pariarghop,599,591,290,268,309,323,50.3,52.0,48.9,00000
41.0,90.0,69.0,095,04,01,  Nischintapur,638,406,306,202,332,204,61.1,60.2,61.9,00000
41.0,90.0,69.0,655,01,01,  Bara Nizampur,344,431,170,208,174,223,44.4,45.0,43.8,00000
41.0,90.0,69.0,655,02,01,  Chhota Nizampur,619,497,322,231,297,266,55.5,58.2,52.8,00000
41.0,90.0,77.0,066,01,01,  Balanda,2085,2764,1061,1398,1024,1366,43.0,43.1,42.8,00000
41.0,90.0,77.0,066,02,01,  Krishnapur,497,697,249,341,248,356,41.6,42.2,41.1,00000
41.0,90.0,77.0,088,01,01,  Dakshin Barapota,685,767,352,380,333,387,47.2,48.1,46.3,00000
41.0,90.0,77.0,088,02,01,  Uttar Barapota,195,338,99,158,96,180,36.6,38.5,34.8,00000
41.0,90.0,77.0,442,01,01,  Kadamtala,299,275,152,146,147,129,52.1,51.0,53.3,00000
41.0,90.0,77.0,442,02,01,  Mahishadanga,681,569,369,270,312,299,54.5,57.7,51.1,00000
41.0,90.0,77.0,906,01,01,  Shibnathpur,568,431,299,202,269,229,56.9,59.7,54.0,00000
41.0,90.0,77.0,906,02,01,  Khalsi,475,501,252,227,223,274,48.7,52.6,44.9,00000
41.0,90.0,77.0,906,03,01,  Rahamatpur,70,193,31,118,39,75,26.6,20.8,34.2,00000
41.0,90.0,86.0,191,01,01,  Kazirber,1522,652,773,277,749,375,70.0,73.6,66.6,00000
41.0,90.0,86.0,191,02,01,  Uttar Buruz Bagan,1252,604,636,273,616,331,67.5,70.0,65.0,00000
41.0,90.0,86.0,191,03,01,  Dakshin Buruz Bagan,2394,2319,1263,1073,1131,1246,50.8,54.1,47.6,00000
41.0,90.0,86.0,191,04,01,  Rail Bazar,813,449,417,204,396,245,64.4,67.1,61.8,00000
41.0,90.0,86.0,191,05,01,  Jadabpur (Part),732,610,389,287,343,323,54.5,57.5,51.5,00000
41.0,90.0,86.0,560,01,01,  Balidaha,288,428,129,219,159,209,40.2,37.1,43.2,00000
41.0,90.0,86.0,560,02,01,  Baripota,485,395,244,193,241,202,55.1,55.8,54.4,00000
41.0,90.0,86.0,560,03,01,  Gati Para,651,904,321,411,330,493,41.9,43.9,40.1,00000
41.0,90.0,86.0,560,04,01,  Bretibari Pota,231,328,119,169,112,159,41.3,41.3,41.3,00000
41.0,90.0,86.0,560,05,01,  Islampur,244,386,112,185,132,201,38.7,37.7,39.6,00000
41.0,90.0,86.0,560,06,01,  Kulpala,374,435,195,208,179,227,46.2,48.4,44.1,00000
41.0,90.0,86.0,847,01,01,  Samlagachhi,1836,1337,927,631,909,706,57.9,59.5,56.3,00000
41.0,90.0,86.0,847,02,01,  Temohini,697,827,353,383,344,444,45.7,48.0,43.7,00000
41.0,90.0,94.0,081,01,01,  Bara Baria,485,335,242,147,243,188,59.1,62.2,56.4,00000
41.0,90.0,94.0,081,02,01,  Panburi,898,862,450,429,448,433,51.0,51.2,50.9,00000
41.0,90.0,94.0,081,03,01,  Benakheri,362,403,179,188,183,215,47.3,48.8,46.0,00000
41.0,90.0,94.0,257,01,01,  Dhaldaha,906,1194,446,573,460,621,43.1,43.8,42.6,00000
41.0,90.0,94.0,257,02,01,  Ramardanga,129,131,74,55,55,76,49.6,57.4,42.0,00000
41.0,90.0,94.0,840,01,01,  Sambandha Kathi,1286,1143,679,530,607,613,52.9,56.2,49.8,00000
41.0,90.0,94.0,840,02,01,  Kashiadanga,753,915,379,454,374,461,45.1,45.5,44.8,00000
1.0,8.0,17.0,038,01,01,  Kursail,624,456,324,217,300,239,57.8,59.9,55.7,00000
1.0,8.0,17.0,038,02,01,  Par Kursail,534,290,249,146,285,144,64.8,63.0,66.4,00000
1.0,8.0,17.0,038,03,01,  Arpara,928,743,479,397,449,346,55.5,54.7,56.5,00000
1.0,8.0,17.0,588,01,01,  Kodla,669,443,349,207,320,236,60.2,62.8,57.6,00000
1.0,8.0,17.0,588,02,01,  Goalkhali,435,157,238,74,197,83,73.5,76.3,70.4,00000
1.0,8.0,17.0,588,03,01,  Kafurpura,466,670,238,340,228,330,41.0,41.2,40.9,00000
1.0,8.0,17.0,588,04,01,  Chintirkhor,258,227,145,100,113,127,53.2,59.2,47.1,00000
1.0,8.0,17.0,588,05,01,  Bakpura,447,247,232,118,215,129,64.4,66.3,62.5,00000
1.0,8.0,17.0,989,01,01,  Ujalpur,621,267,330,117,291,150,69.9,73.8,66.0,00000
1.0,8.0,17.0,989,02,01,  Sahebar,522,246,277,127,245,119,68.0,68.6,67.3,00000
1.0,8.0,25.0,087,01,01,  Baitpur,1266,753,648,353,618,400,62.7,64.7,60.7,00000
1.0,8.0,25.0,087,02,01,  Bhadrapara,558,332,286,153,272,179,62.7,65.1,60.3,00000
1.0,8.0,25.0,604,01,01,  Kondala,781,764,399,383,382,381,50.6,51.0,50.1,00000
1.0,8.0,25.0,604,02,01,  Khashbari,189,71,99,29,90,42,72.7,77.3,68.2,00000
1.0,8.0,34.0,483,01,01,  Par Kuramara,506,284,250,125,256,159,64.1,66.7,61.7,00000
1.0,8.0,34.0,483,02,01,  Koramara,891,460,451,219,440,241,66.0,67.3,64.6,00000
1.0,8.0,34.0,483,03,01,  Champar Khul,42,59,27,27,15,32,41.6,50.0,31.9,00000
1.0,8.0,34.0,483,04,01,  Sahaspur,420,117,219,56,201,61,78.2,79.6,76.7,00000
1.0,8.0,34.0,577,01,01,  Kismat Halisahar,296,191,164,84,132,107,60.8,66.1,55.2,00000
1.0,8.0,34.0,577,02,01,  Kalipur,367,239,183,122,184,117,60.6,60.0,61.1,00000
1.0,8.0,34.0,593,01,01,  Koekhan,174,348,89,167,85,181,33.3,34.8,32.0,00000
1.0,8.0,34.0,593,02,01,  Basurghat,1147,813,549,436,598,377,58.5,55.7,61.3,00000
1.0,8.0,34.0,593,03,01,  Sajukhali,127,101,64,53,63,48,55.7,54.7,56.8,00000
1.0,8.0,34.0,621,01,01,  Kulia Dair,709,444,370,204,339,240,61.5,64.5,58.5,00000
1.0,8.0,34.0,621,02,01,  Kulia Bishnupur,476,248,216,121,260,127,65.7,64.1,67.2,00000
1.0,8.0,34.0,621,03,01,  Dingsi Para,238,182,127,92,111,90,56.7,58.0,55.2,00000
1.0,8.0,34.0,621,04,01,  Kulia Karamara,427,535,228,248,199,287,44.4,47.9,40.9,00000
1.0,8.0,34.0,698,01,01,  Mulghar,543,411,289,205,254,206,56.9,58.5,55.2,00000
1.0,8.0,34.0,698,02,01,  Shakra,164,328,78,170,86,158,33.3,31.5,35.2,00000
1.0,8.0,34.0,736,01,01,  Paik Para,144,55,60,21,84,34,72.4,74.1,71.2,00000
1.0,8.0,34.0,736,02,01,  Badukhali,628,540,309,283,319,257,53.8,52.2,55.4,00000
1.0,8.0,34.0,896,01,01,  Bara Singha,517,319,260,154,257,165,61.8,62.8,60.9,00000
1.0,8.0,34.0,896,02,01,  Chhota Singha,201,54,105,23,96,31,78.8,82.0,75.6,00000
1.0,8.0,51.0,313,01,01,  Paschim Debpara,708,941,355,498,353,443,42.9,41.6,44.3,00000
1.0,8.0,51.0,313,02,01,  Purba Debpara,999,723,515,375,484,348,58.0,57.9,58.2,00000
1.0,8.0,51.0,434,01,01,  Kaldia,431,143,204,69,227,74,75.1,74.7,75.4,00000
1.0,8.0,51.0,434,02,01,  Keshabpur,248,192,104,91,144,101,56.4,53.3,58.8,00000
1.0,8.0,51.0,725,01,01,  Noapara,1246,852,614,437,632,415,59.4,58.4,60.4,00000
1.0,8.0,51.0,725,02,01,  Par Noapara,588,536,282,279,306,257,52.3,50.3,54.4,00000
1.0,8.0,60.0,538,01,01,  Panchali,328,323,188,159,140,164,50.4,54.2,46.1,00000
1.0,8.0,60.0,538,02,01,  Khalsi,672,358,341,172,331,186,65.2,66.5,64.0,00000
1.0,8.0,94.0,874,01,01,  Purba Sayera,1148,554,611,235,537,319,67.5,72.2,62.7,00000
1.0,8.0,94.0,874,02,01,  Paschim Sayera,1224,722,627,339,597,383,62.9,64.9,60.9,00000
1.0,14.0,15.0,154,01,01,  Nikari Para,190,362,92,150,98,212,34.4,38.0,31.6,00000
1.0,14.0,15.0,154,02,01,  Dakshinpara,339,274,178,124,161,150,55.3,58.9,51.8,00000
1.0,14.0,15.0,154,03,01,  Bawali Para,324,237,179,91,145,146,57.8,66.3,49.8,00000
1.0,14.0,15.0,154,04,01,  Rana Para,87,93,34,46,53,47,48.3,42.5,53.0,00000
1.0,14.0,15.0,154,05,01,  Paschimpara,483,254,259,108,224,146,65.5,70.6,60.5,00000
1.0,14.0,15.0,154,06,01,  Uttarpara,809,310,436,141,373,169,72.3,75.6,68.8,00000
1.0,14.0,15.0,154,07,01,  Madhyapara,372,183,204,78,168,105,67.0,72.3,61.5,00000
1.0,14.0,15.0,154,08,01,  Ashoknagar,367,317,180,164,187,153,53.7,52.3,55.0,00000
1.0,14.0,19.0,058,01,01,  Bara Baria,3019,1447,1464,645,1555,802,67.6,69.4,66.0,00000
1.0,14.0,19.0,058,02,01,  Char Bara Baria,867,668,440,327,427,341,56.5,57.4,55.6,00000
1.0,14.0,19.0,058,03,01,  Dalua Guni,806,526,375,290,431,236,60.5,56.4,64.6,00000
1.0,14.0,19.0,058,04,01,  Lakshmipura,323,72,168,34,155,38,81.8,83.2,80.3,00000
1.0,14.0,19.0,058,05,01,  Kaliani,78,138,42,70,36,68,36.1,37.5,34.6,00000
1.0,14.0,19.0,058,06,01,  Chinani,392,78,210,33,182,45,83.4,86.4,80.2,00000
1.0,14.0,19.0,058,07,01,  Masarkul,436,262,225,117,211,145,62.5,65.8,59.3,00000
1.0,14.0,19.0,058,08,01,  Arua Masua,56,161,31,83,25,78,25.8,27.2,24.3,00000
1.0,14.0,19.0,058,09,01,  Khapra Bunia,388,570,199,285,189,285,40.5,41.1,39.9,00000
1.0,14.0,19.0,058,10,01,  Basabati,398,126,203,58,195,68,76.0,77.8,74.1,00000
1.0,14.0,19.0,058,11,01,  Paddar Para,198,185,102,86,96,99,51.7,54.3,49.2,00000
1.0,14.0,19.0,073,01,01,  Bara Guni,1850,1612,920,767,930,845,53.4,54.5,52.4,00000
1.0,14.0,19.0,073,02,01,  Gholar,674,586,286,293,388,293,53.5,49.4,57.0,00000
1.0,14.0,19.0,073,03,01,  Par Gholar,417,394,204,185,213,209,51.4,52.4,50.5,00000
1.0,14.0,19.0,453,01,01,  Barabari Gangpar,725,859,368,412,357,447,45.8,47.2,44.4,00000
1.0,14.0,19.0,453,02,01,  Paranpur,1206,1246,579,650,627,596,49.2,47.1,51.3,00000
1.0,14.0,19.0,453,03,01,  Hariar Ghop,1196,1027,622,494,574,533,53.8,55.7,51.9,00000
1.0,14.0,19.0,453,04,01,  Char Chinggari,32,21,19,8,13,13,60.4,70.4,50.0,00000
1.0,14.0,31.0,031,01,03,  Aruabanni,201,82,90,47,111,35,71.0,65.7,76.0,00000
1.0,14.0,31.0,031,02,03,  Aruabanni Hindu Para,77,34,39,17,38,17,69.4,69.6,69.1,00000
1.0,14.0,31.0,331,01,01,  Dumuria,592,261,331,120,261,141,69.4,73.4,64.9,00000
1.0,14.0,31.0,331,02,01,  Par Dumuria,334,155,172,71,162,84,68.3,70.8,65.9,00000
1.0,14.0,31.0,442,01,01,  Puran Kalsira,440,209,209,120,231,89,67.8,63.5,72.2,00000
1.0,14.0,31.0,442,02,01,  Barasia Mejha Zila,255,766,131,391,124,375,25.0,25.1,24.8,00000
1.0,14.0,31.0,442,03,01,  Aruabanni Char Para,1591,1914,798,980,793,934,45.4,44.9,45.9,00000
1.0,14.0,31.0,442,04,01,  Aruabanni Dahar Para,903,1255,459,632,444,623,41.8,42.1,41.6,00000
1.0,14.0,31.0,663,01,01,  Kurmani,395,128,219,56,176,72,75.5,79.6,71.0,00000
1.0,14.0,31.0,663,02,01,  Chitalmari Bazar,1070,334,625,155,445,179,76.2,80.1,71.3,00000
1.0,14.0,31.0,795,01,01,  Uttar Patar Para,200,34,110,13,90,21,85.5,89.4,81.1,00000
1.0,14.0,31.0,795,02,01,  Patar Para,1082,277,537,135,545,142,79.6,79.9,79.3,00000
1.0,14.0,31.0,862,01,01,  Sabakhali,676,448,366,205,310,243,60.1,64.1,56.1,00000
1.0,14.0,31.0,862,02,01,  Daneakhali,350,121,203,44,147,77,74.3,82.2,65.6,00000
1.0,14.0,31.0,906,01,01,  Sreerampur,299,384,162,178,137,206,43.8,47.6,39.9,00000
1.0,14.0,31.0,906,02,01,  Kaligati,46,201,28,113,18,88,18.6,19.9,17.0,00000
1.0,14.0,31.0,906,03,01,  Barasia Bara Zila,455,871,232,439,223,432,34.3,34.6,34.0,00000
1.0,14.0,31.0,906,04,01,  Natun Kalsira,519,414,288,197,231,217,55.6,59.4,51.6,00000
1.0,14.0,31.0,906,05,01,  Bennabari,82,89,44,45,38,44,48.0,49.4,46.3,00000
1.0,14.0,31.0,906,06,01,  Sonakhali,91,58,57,33,34,25,61.1,63.3,57.6,00000
1.0,14.0,31.0,906,07,01,  Roiarkhul,309,325,182,141,127,184,48.7,56.3,40.8,00000
1.0,14.0,31.0,906,08,01,  Jaladanga,101,53,48,23,53,30,65.6,67.6,63.9,00000
1.0,14.0,47.0,110,01,01,  Kuralitala,1275,927,667,433,608,494,57.9,60.6,55.2,00000
1.0,14.0,47.0,110,02,01,  Boalia,839,487,411,223,428,264,63.3,64.8,61.8,00000
1.0,14.0,47.0,110,03,01,  Santipur,108,302,54,143,54,159,26.3,27.4,25.4,00000
1.0,14.0,47.0,110,04,01,  Batibunia,161,303,81,148,80,155,34.7,35.4,34.0,00000
1.0,14.0,47.0,110,05,01,  Paranpur,164,131,88,48,76,83,55.6,64.7,47.8,00000
1.0,14.0,47.0,221,01,01,  Char Saildaha,179,271,87,117,92,154,39.8,42.6,37.4,00000
1.0,14.0,47.0,221,02,01,  Char Saildaha Guchchhagram,363,348,155,192,208,156,51.1,44.7,57.1,00000
1.0,14.0,47.0,397,01,01,  Shibpur Kata,381,202,198,89,183,113,65.4,69.0,61.8,00000
1.0,14.0,47.0,397,02,01,  Shantikahli,483,452,242,211,241,241,51.7,53.4,50.0,00000
1.0,14.0,47.0,397,03,01,  Char Latima,632,437,354,182,278,255,59.1,66.0,52.2,00000
1.0,14.0,47.0,397,04,01,  Hijal,2814,2480,1423,1228,1391,1252,53.2,53.7,52.6,00000
1.0,14.0,47.0,397,05,01,  Hasabunia Katakhali,595,356,307,172,288,184,62.6,64.1,61.0,00000
1.0,14.0,63.0,309,01,01,  Dari Umajuri,981,1031,520,501,461,530,48.8,50.9,46.5,00000
1.0,14.0,63.0,309,02,01,  Garibpur,257,119,134,55,123,64,68.4,70.9,65.8,00000
1.0,14.0,63.0,884,01,01,  Santoshpur,500,224,263,89,237,135,69.1,74.7,63.7,00000
1.0,14.0,63.0,884,02,01,  Kati Para,472,339,231,175,241,164,58.2,56.9,59.5,00000
1.0,14.0,63.0,884,03,01,  Adikhali,208,427,103,215,105,212,32.8,32.4,33.1,00000
1.0,14.0,63.0,884,04,01,  Lararkhul,408,429,189,213,219,216,48.7,47.0,50.3,00000
1.0,14.0,63.0,884,05,01,  Babuana,224,226,129,103,95,123,49.8,55.6,43.6,00000
1.0,14.0,63.0,994,01,01,  Umajuri,530,1127,252,574,278,553,32.0,30.5,33.5,00000
1.0,14.0,63.0,994,02,01,  Kachuria,713,409,341,217,372,192,63.5,61.1,66.0,00000
1.0,14.0,63.0,994,03,01,  Char Kachuria,470,654,233,356,237,298,41.8,39.6,44.3,00000
1.0,14.0,63.0,994,04,01,  Battala,447,549,213,292,234,257,44.9,42.2,47.7,00000
1.0,14.0,66.0,254,01,01,  Kunia,1293,795,595,408,698,387,61.9,59.3,64.3,00000
1.0,14.0,66.0,254,02,01,  Chingari,858,760,395,372,463,388,53.0,51.5,54.4,00000
1.0,14.0,66.0,356,01,01,  Rahmatpur,556,698,261,348,295,350,44.3,42.9,45.7,00000
1.0,14.0,66.0,356,02,01,  Char Chingari,1008,1013,492,523,516,490,49.9,48.5,51.3,00000
1.0,14.0,66.0,356,03,01,  Ganga Channa,276,136,127,71,149,65,67.0,64.1,69.6,00000
1.0,14.0,66.0,798,01,01,  Kanan Char,508,248,261,114,247,134,67.2,69.6,64.8,00000
1.0,14.0,66.0,798,02,01,  Bakrandi,214,115,105,56,109,59,65.0,65.2,64.9,00000
1.0,14.0,66.0,798,03,01,  Ambari,254,183,134,94,120,89,58.1,58.8,57.4,00000
1.0,14.0,66.0,798,05,01,  Saildaha,1082,1064,552,516,530,548,50.4,51.7,49.2,00000
1.0,14.0,66.0,798,06,01,  Bakpur,506,285,236,148,270,137,64.0,61.5,66.3,00000
1.0,14.0,66.0,798,07,01,  Rajnagar,234,265,111,137,123,128,46.9,44.8,49.0,00000
1.0,14.0,66.0,798,08,01,  Malarkul,87,162,48,83,39,79,34.9,36.6,33.1,00000
1.0,14.0,66.0,798,09,01,  Duatala,240,246,126,117,114,129,49.4,51.9,46.9,00000
1.0,14.0,66.0,798,10,01,  Saildaha Guchchhagram,181,306,81,160,100,146,37.2,33.6,40.7,00000
1.0,14.0,79.0,420,01,01,  Kaligati,1432,1077,724,537,708,540,57.1,57.4,56.7,00000
1.0,14.0,79.0,420,02,01,  Shibpur,2644,2336,1353,1120,1291,1216,53.1,54.7,51.5,00000
1.0,14.0,79.0,420,03,01,  Naluya,886,694,427,334,459,360,56.1,56.1,56.0,00000
1.0,14.0,79.0,420,04,01,  Gora Naluya,481,373,247,176,234,197,56.3,58.4,54.3,00000
1.0,14.0,79.0,420,05,01,  Barabagh,392,218,197,106,195,112,64.3,65.0,63.5,00000
1.0,34.0,10.0,044,01,03,  Chhota Bahirdia,1418,763,706,325,712,438,65.0,68.5,61.9,00000
1.0,34.0,10.0,044,02,03,  Madhya Bahirdia,772,728,394,352,378,376,51.5,52.8,50.1,00000
1.0,34.0,10.0,044,03,03,  Paschim Bahirdia,1197,730,607,374,590,356,62.1,61.9,62.4,00000
1.0,34.0,21.0,252,01,01,  Dhanpota,1162,742,650,343,512,399,61.0,65.5,56.2,00000
1.0,34.0,21.0,252,02,01,  Chakuli,862,429,431,200,431,229,66.8,68.3,65.3,00000
1.0,34.0,52.0,282,01,01,  Shialikandi,488,400,282,178,206,222,55.0,61.3,48.1,00000
1.0,34.0,52.0,282,02,01,  Kaltita,694,313,364,134,330,179,68.9,73.1,64.8,00000
1.0,34.0,52.0,282,03,01,  Baniakhali,199,63,101,22,98,41,76.0,82.1,70.5,00000
1.0,34.0,52.0,460,01,01,  Kalkalia,807,627,433,300,374,327,56.3,59.1,53.4,00000
1.0,34.0,52.0,460,02,01,  Goalkhali,79,72,41,35,38,37,52.3,53.9,50.7,00000
1.0,34.0,52.0,549,01,03,  Sayed Mahallah,561,212,272,97,289,115,72.6,73.7,71.5,00000
1.0,34.0,52.0,549,02,03,  Kathaldanga,132,83,67,47,65,36,61.4,58.8,64.4,00000
1.0,34.0,52.0,549,03,03,  Moraldanga,109,45,47,25,62,20,70.8,65.3,75.6,00000
1.0,34.0,52.0,549,04,03,  Joypur,121,32,59,14,62,18,79.1,80.8,77.5,00000
1.0,34.0,52.0,683,01,03,  Mulghar,1651,696,888,350,763,346,70.3,71.7,68.8,00000
1.0,34.0,52.0,683,02,03,  Kakdanga,342,194,181,98,161,96,63.8,64.9,62.6,00000
1.0,34.0,52.0,816,01,01,  Rudragati,259,269,156,126,103,143,49.1,55.3,41.9,00000
1.0,34.0,52.0,816,02,01,  Kanthalbari,258,103,128,48,130,55,71.5,72.7,70.3,00000
1.0,34.0,63.0,430,01,01,  Joypur,320,175,178,67,142,108,64.6,72.7,56.8,00000
1.0,34.0,63.0,430,02,01,  Sayed Mahallah,76,26,38,11,38,15,74.5,77.6,71.7,00000
1.0,34.0,63.0,430,03,01,  Jhalhati,83,46,44,12,39,34,64.3,78.6,53.4,00000
1.0,34.0,63.0,504,01,01,  Kathali,549,283,294,142,255,141,66.0,67.4,64.4,00000
1.0,34.0,63.0,504,02,01,  Moraldanga,239,181,120,96,119,85,56.9,55.6,58.3,00000
1.0,34.0,63.0,697,01,03,  Naldha,680,440,374,222,306,218,60.7,62.8,58.4,00000
1.0,34.0,63.0,697,02,03,  Dohazari,548,302,281,151,267,151,64.5,65.0,63.9,00000
1.0,34.0,63.0,697,03,03,  Aruadanga,465,270,253,144,212,126,63.3,63.7,62.7,00000
1.0,34.0,63.0,697,04,03,  Kanthaldanga,42,17,22,7,20,10,71.2,75.9,66.7,00000
1.0,34.0,63.0,697,05,03,  Thikri Para,232,111,116,51,116,60,67.6,69.5,65.9,00000
1.0,34.0,63.0,697,06,03,  Brahmahdanga,376,351,211,161,165,190,51.7,56.7,46.5,00000
1.0,34.0,84.0,297,01,01,  Ganashyampur,1399,736,728,334,671,402,65.5,68.5,62.5,00000
1.0,34.0,84.0,297,02,01,  Kachua,749,457,379,227,370,230,62.1,62.5,61.7,00000
1.0,38.0,15.0,789,01,01,  Pingaria,230,227,118,110,112,117,50.3,51.8,48.9,00000
1.0,38.0,15.0,789,02,01,  Kalmibunia,538,409,251,216,287,193,56.8,53.7,59.8,00000
1.0,38.0,15.0,789,03,01,  Sakharikati,207,146,112,67,95,79,58.6,62.6,54.6,00000
1.0,38.0,15.0,820,01,01,  Raghu Dattakati,316,357,173,162,143,195,47.0,51.6,42.3,00000
1.0,38.0,15.0,820,02,01,  Moshni,640,530,349,237,291,293,54.7,59.6,49.8,00000
1.0,38.0,15.0,861,01,01,  Sangdia (Part),485,345,256,159,229,186,58.4,61.7,55.2,00000
1.0,38.0,15.0,861,02,01,  Bilkul,649,685,332,314,317,371,48.7,51.4,46.1,00000
1.0,38.0,15.0,861,03,01,  Afra,302,263,151,130,151,133,53.5,53.7,53.2,00000
1.0,38.0,15.0,861,04,01,  Abad,109,168,59,80,50,88,39.4,42.4,36.2,00000
1.0,38.0,15.0,861,05,01,  Vatkhola,25,50,11,26,14,24,33.3,29.7,36.8,00000
1.0,38.0,38.0,451,01,01,  Purba Gazalia,888,960,438,487,450,473,48.1,47.4,48.8,00000
1.0,38.0,38.0,451,02,01,  Paschim Gazalia,1204,800,608,386,596,414,60.1,61.2,59.0,00000
1.0,38.0,38.0,451,03,01,  Joby,937,1100,426,541,511,559,46.0,44.1,47.8,00000
1.0,38.0,38.0,451,04,01,  Mathertala,744,1157,342,552,402,605,39.1,38.3,39.9,00000
1.0,38.0,38.0,451,05,01,  Lararkul,650,635,313,337,337,298,50.6,48.2,53.1,00000
1.0,38.0,47.0,482,01,01,  Gopalpur,1327,878,627,419,700,459,60.2,59.9,60.4,00000
1.0,38.0,47.0,482,02,01,  Padmanagar,456,269,215,121,241,148,62.9,64.0,62.0,00000
1.0,38.0,47.0,482,03,01,  Pikjuri,187,72,99,26,88,46,72.2,79.2,65.7,00000
1.0,38.0,47.0,482,04,01,  Ejara,141,173,75,77,66,96,44.9,49.3,40.7,00000
1.0,38.0,57.0,133,01,01,  Purba Baruikhali,446,325,264,131,182,194,57.8,66.8,48.4,00000
1.0,38.0,57.0,133,02,01,  Paschim Baruikhali,685,689,334,317,351,372,49.9,51.3,48.5,00000
1.0,38.0,57.0,974,01,03,  Tengrakhali,2670,1599,1274,804,1396,795,62.5,61.3,63.7,00000
1.0,38.0,57.0,974,02,03,  Char Tengrakhali,699,743,310,402,389,341,48.5,43.5,53.3,00000
1.0,38.0,76.0,153,01,01,  Bhandarkola,1048,647,533,308,515,339,61.8,63.4,60.3,00000
1.0,38.0,76.0,153,02,01,  Khalshakhali,674,237,358,114,316,123,74.0,75.8,72.0,00000
1.0,38.0,76.0,153,03,01,  Dobaria,438,241,219,122,219,119,64.5,64.2,64.8,00000
1.0,38.0,76.0,830,01,01,  Rari Para,573,335,274,165,299,170,63.1,62.4,63.8,00000
1.0,38.0,76.0,830,02,01,  Uttar Rari Para,502,297,245,152,257,145,62.8,61.7,63.9,00000
1.0,38.0,76.0,830,03,01,  Mat Rari Para,167,128,78,61,89,67,56.6,56.1,57.1,00000
1.0,38.0,76.0,830,04,01,  Palpara,391,350,203,165,188,185,52.8,55.2,50.4,00000
1.0,38.0,76.0,830,05,01,  Goalmat,140,73,81,34,59,39,65.7,70.4,60.2,00000
1.0,38.0,76.0,830,06,01,  Solarkola,352,55,162,26,190,29,86.5,86.2,86.8,00000
1.0,56.0,17.0,043,01,01,  Kadamtala,353,329,151,169,202,160,51.8,47.2,55.8,00000
1.0,56.0,17.0,043,02,01,  Atjuri,411,255,224,109,187,146,61.7,67.3,56.2,00000
1.0,56.0,17.0,043,03,01,  Bhirabnagar (Part),50,18,27,8,23,10,73.5,77.1,69.7,00000
1.0,56.0,17.0,043,04,01,  Char Atjuri,271,397,126,201,145,196,40.6,38.5,42.5,00000
1.0,56.0,17.0,087,01,01,  Basuria,194,241,114,119,80,122,44.6,48.9,39.6,00000
1.0,56.0,17.0,087,02,01,  Sonapur,253,533,132,276,121,257,32.2,32.4,32.0,00000
1.0,56.0,17.0,117,01,01,  Bhandarkhola,2143,1995,1065,992,1078,1003,51.8,51.8,51.8,00000
1.0,56.0,17.0,117,02,01,  Bhairabnagar,268,168,149,85,119,83,61.5,63.7,58.9,00000
1.0,56.0,17.0,485,01,01,  Kamargram,985,1171,500,548,485,623,45.7,47.7,43.8,00000
1.0,56.0,17.0,485,02,01,  Katadura,138,77,72,33,66,44,64.2,68.6,60.0,00000
1.0,56.0,17.0,491,01,01,  Kahalpur,2266,1964,1078,949,1188,1015,53.6,53.2,53.9,00000
1.0,56.0,17.0,491,02,01,  Tentulbaria,117,75,55,38,62,37,60.9,59.1,62.6,00000
1.0,56.0,17.0,491,03,01,  Haridha,640,583,348,294,292,289,52.3,54.2,50.3,00000
1.0,56.0,17.0,491,04,01,  Basabari,458,130,228,54,230,76,77.9,80.9,75.2,00000
1.0,56.0,17.0,491,05,01,  Uttar Ambari,244,49,126,21,118,28,83.3,85.7,80.8,00000
1.0,56.0,17.0,491,06,01,  Manikkali,231,101,125,37,106,64,69.6,77.2,62.4,00000
1.0,56.0,17.0,491,07,01,  Dattadanga,444,326,229,150,215,176,57.7,60.4,55.0,00000
1.0,56.0,17.0,491,08,01,  Dakshin Ambari,212,74,104,34,108,40,74.1,75.4,73.0,00000
1.0,56.0,28.0,482,01,01,  Kachna,1037,1653,502,812,535,841,38.6,38.2,38.9,00000
1.0,56.0,28.0,482,02,01,  Chhota Kachna,469,694,224,344,245,350,40.3,39.4,41.2,00000
1.0,56.0,38.0,351,01,01,  Gangni,1944,2583,993,1257,951,1326,42.9,44.1,41.8,00000
1.0,56.0,38.0,351,02,01,  Matar Char,583,783,298,418,285,365,42.7,41.6,43.8,00000
1.0,56.0,38.0,351,03,01,  Burigangni,591,736,295,338,296,398,44.5,46.6,42.7,00000
1.0,56.0,38.0,351,04,01,  Nagarkandi,826,1167,407,565,419,602,41.4,41.9,41.0,00000
1.0,56.0,38.0,351,05,01,  Jirantala,173,285,74,150,99,135,37.8,33.0,42.3,00000
1.0,56.0,38.0,351,06,01,  Joykha,94,71,55,30,39,41,57.0,64.7,48.8,00000
1.0,56.0,38.0,351,07,01,  Andigram,142,206,74,94,68,112,40.8,44.0,37.8,00000
1.0,56.0,38.0,351,08,01,  Rajnagar,74,49,39,28,35,21,60.2,58.2,62.5,00000
1.0,56.0,47.0,365,01,01,  Gaola,1099,583,591,282,508,301,65.3,67.7,62.8,00000
1.0,56.0,47.0,365,02,01,  Majher Gaola,353,1093,181,540,172,553,24.4,25.1,23.7,00000
1.0,56.0,47.0,365,03,01,  Dakshin Gaola,649,745,323,352,326,393,46.6,47.9,45.3,00000
1.0,56.0,47.0,365,04,01,  Surigati,772,444,413,193,359,251,63.5,68.2,58.9,00000
1.0,56.0,47.0,365,05,01,  Chanderhat,489,267,262,127,227,140,64.7,67.4,61.9,00000
1.0,56.0,47.0,512,01,01,  Aga Kendua,146,257,76,136,70,121,36.2,35.8,36.6,00000
1.0,56.0,47.0,512,02,01,  Gora Kendua,167,138,97,63,70,75,54.8,60.6,48.3,00000
1.0,56.0,47.0,599,01,01,  Uttar Matiargati,248,108,134,51,114,57,69.7,72.4,66.7,00000
1.0,56.0,47.0,599,02,01,  Dakshin Matiargati,362,92,196,45,166,47,79.7,81.3,77.9,00000
1.0,56.0,47.0,790,01,01,  Sarulia,800,594,421,281,379,313,57.4,60.0,54.8,00000
1.0,56.0,47.0,790,02,01,  Baraigati,306,136,166,59,140,77,69.2,73.8,64.5,00000
1.0,56.0,76.0,673,01,01,  Joydehi,155,197,85,96,70,101,44.0,47.0,40.9,00000
1.0,56.0,76.0,673,02,01,  Muni Zila,208,132,115,49,93,83,61.2,70.1,52.8,00000
1.0,56.0,76.0,673,03,01,  Sharashpur,1062,1205,536,560,526,645,46.8,48.9,44.9,00000
1.0,56.0,76.0,673,04,01,  Chaulturi,950,903,494,439,456,464,51.3,52.9,49.6,00000
1.0,56.0,76.0,673,05,01,  Brahmandanga,348,253,181,114,167,139,57.9,61.4,54.6,00000
1.0,56.0,76.0,782,01,01,  Panchdanga,217,266,125,130,92,136,44.9,49.0,40.4,00000
1.0,56.0,76.0,782,02,01,  Joteshwari,230,240,130,113,100,127,48.9,53.5,44.1,00000
1.0,56.0,76.0,782,03,01,  Kodalia,2124,2326,995,1221,1129,1105,47.7,44.9,50.5,00000
1.0,56.0,76.0,782,04,01,  Gopalkhali,199,292,91,145,108,147,40.5,38.6,42.4,00000
1.0,56.0,76.0,782,05,01,  Rangamatia,544,391,268,192,276,199,58.2,58.3,58.1,00000
1.0,56.0,76.0,782,06,01,  Kachuria,448,803,218,368,230,435,35.8,37.2,34.6,00000
1.0,56.0,76.0,782,07,01,  Aruadehi,1210,1543,608,827,602,716,44.0,42.4,45.7,00000
1.0,56.0,85.0,424,01,01,  Natun Ghoshgati,1212,1674,615,851,597,823,42.0,42.0,42.0,00000
1.0,56.0,85.0,424,02,01,  Puran Ghoshgati,572,642,272,300,300,342,47.1,47.6,46.7,00000
1.0,56.0,85.0,526,01,01,  Char Kulia,908,750,443,362,465,388,54.8,55.0,54.5,00000
1.0,56.0,85.0,526,02,01,  Takirkul,168,292,72,142,96,150,36.5,33.6,39.0,00000
1.0,56.0,85.0,526,03,01,  Kulia,1277,1457,630,720,647,737,46.7,46.7,46.7,00000
1.0,56.0,85.0,687,01,01,  Narasingpur,575,1055,262,524,313,531,35.3,33.3,37.1,00000
1.0,56.0,85.0,687,02,01,  Rangpur,222,631,107,339,115,292,26.0,24.0,28.3,00000
1.0,56.0,85.0,760,01,01,  Rajpat,742,427,366,200,376,227,63.5,64.7,62.4,00000
1.0,56.0,85.0,760,02,01,  Ghatbila,516,553,251,282,265,271,48.3,47.1,49.4,00000
1.0,56.0,95.0,658,01,01,  Mollarkul,926,734,492,321,434,413,55.8,60.5,51.2,00000
1.0,56.0,95.0,658,02,01,  Shahrabari,71,47,44,22,27,25,60.2,66.7,51.9,00000
1.0,56.0,95.0,658,03,01,  Rajnagar,220,120,99,57,121,63,64.7,63.5,65.8,00000
1.0,58.0,23.0,310,01,01,  Dakshin Chandpi,936,878,499,444,437,434,51.6,52.9,50.2,00000
1.0,58.0,23.0,310,02,01,  Uttar Chandpi,889,1440,422,725,467,715,38.2,36.8,39.5,00000
1.0,58.0,23.0,556,01,01,  Uttar Kainmari,1060,519,559,225,501,294,67.1,71.3,63.0,00000
1.0,58.0,23.0,556,02,01,  Dakshin Kainmari,779,387,406,173,373,214,66.8,70.1,63.5,00000
1.0,58.0,23.0,556,03,01,  Kanainagar,1245,1265,659,610,586,655,49.6,51.9,47.2,00000
1.0,58.0,23.0,556,04,01,  Kalikabari,468,351,252,164,216,187,57.1,60.6,53.6,00000
1.0,58.0,23.0,708,01,01,  Malgazi,1220,480,598,217,622,263,71.8,73.4,70.3,00000
1.0,58.0,23.0,708,02,01,  Brahmanmat,945,1030,447,513,498,517,47.8,46.6,49.1,00000
1.0,58.0,27.0,216,01,01,  Digraj,3225,1582,1858,646,1367,936,67.1,74.2,59.4,00000
1.0,58.0,27.0,216,02,01,  Doanarkul,296,40,167,15,129,25,88.1,91.8,83.8,00000
1.0,58.0,27.0,216,03,01,  Chachanerkul,304,319,170,139,134,180,48.8,55.0,42.7,00000
1.0,58.0,27.0,216,04,01,  Salabunia,378,249,212,98,166,151,60.3,68.4,52.4,00000
1.0,58.0,27.0,216,05,01,  Bidyarbahan,600,392,326,186,274,206,60.5,63.7,57.1,00000
1.0,58.0,27.0,234,01,01,  Uttar Burirdanga,1291,471,739,149,552,322,73.3,83.2,63.2,00000
1.0,58.0,27.0,234,02,01,  Dakshin Burirdanga,537,272,294,105,243,167,66.4,73.7,59.3,00000
1.0,58.0,27.0,836,01,01,  Balarabad,127,82,72,34,55,48,60.8,67.9,53.4,00000
1.0,58.0,27.0,836,02,01,  Shanbandha,433,260,240,120,193,140,62.5,66.7,58.0,00000
1.0,58.0,27.0,836,03,01,  Bairagikhali,546,286,293,113,253,173,65.6,72.2,59.4,00000
1.0,58.0,29.0,368,01,01,  Purba Chila,294,224,155,97,139,127,56.8,61.5,52.3,00000
1.0,58.0,29.0,368,02,01,  Paschim Chila,556,711,292,338,264,373,43.9,46.3,41.4,00000
1.0,58.0,29.0,368,03,01,  Gabguniya,623,622,323,312,300,310,50.0,50.9,49.2,00000
1.0,58.0,29.0,368,04,01,  Amtala,190,470,106,211,84,259,28.8,33.4,24.5,00000
1.0,58.0,29.0,368,05,01,  Dakshin Chila,561,909,291,443,270,466,38.2,39.6,36.7,00000
1.0,58.0,29.0,368,06,01,  Sindur Tala,452,500,247,235,205,265,47.5,51.2,43.6,00000
1.0,58.0,29.0,368,07,01,  Ulukata,104,302,54,143,50,159,25.6,27.4,23.9,00000
1.0,58.0,29.0,479,01,01,  Dakshin Haldibunia,456,433,251,207,205,226,51.3,54.8,47.6,00000
1.0,58.0,29.0,479,02,01,  Madhya Haldibunia,1354,430,662,205,692,225,75.9,76.4,75.5,00000
1.0,58.0,29.0,479,03,01,  Goler Dhanga,173,160,94,72,79,88,52.0,56.6,47.3,00000
1.0,58.0,29.0,479,04,01,  Daser Khonda,187,67,100,37,87,30,73.6,73.0,74.4,00000
1.0,58.0,29.0,479,05,01,  Falur Khonda,126,227,65,114,61,113,35.7,36.3,35.1,00000
1.0,58.0,29.0,479,06,01,  Hitalmarj,259,250,127,114,132,136,50.9,52.7,49.3,00000
1.0,58.0,29.0,479,07,01,  Uttar Haldibunia,464,211,230,97,234,114,68.7,70.3,67.2,00000
1.0,58.0,29.0,526,01,01,  Joymanirgol,1845,2192,935,1125,910,1067,45.7,45.4,46.0,00000
1.0,58.0,29.0,526,02,01,  Chandpai Range,1689,1660,1645,1605,44,55,50.4,50.6,44.4,00000
1.0,58.0,59.0,035,01,01,  Andharia,356,645,187,315,169,330,35.6,37.3,33.9,00000
1.0,58.0,59.0,035,02,01,  Totardanga,424,369,197,191,227,178,53.5,50.8,56.0,00000
1.0,58.0,59.0,035,03,01,  Mithakhali,352,330,192,160,160,170,51.6,54.5,48.5,00000
1.0,58.0,59.0,397,01,01,  Dattermet,579,269,324,94,255,175,68.3,77.5,59.3,00000
1.0,58.0,59.0,397,02,01,  Mokhali,238,113,134,51,104,62,67.8,72.4,62.7,00000
1.0,58.0,59.0,397,03,01,  Satgharia,263,139,135,59,128,80,65.4,69.6,61.5,00000
1.0,58.0,59.0,397,04,01,  Basurkhanda,115,69,63,18,52,51,62.5,77.8,50.5,00000
1.0,58.0,59.0,655,01,01,  Khonkarer Ber,691,424,335,211,356,213,62.0,61.4,62.6,00000
1.0,58.0,59.0,655,02,01,  Goalirmet,808,747,394,384,414,363,52.0,50.6,53.3,00000
1.0,58.0,59.0,655,03,01,  Nitakhali,404,298,216,139,188,159,57.5,60.8,54.2,00000
1.0,58.0,59.0,655,04,01,  Khaserdanga,719,341,383,149,336,192,67.8,72.0,63.6,00000
1.0,58.0,59.0,655,05,01,  Satpukuria,204,119,109,58,95,61,63.2,65.3,60.9,00000
1.0,58.0,59.0,655,06,01,  Dhonkhali,170,85,101,32,69,53,66.7,75.9,56.6,00000
1.0,58.0,59.0,655,07,01,  Kharkharia,253,140,120,77,133,63,64.4,60.9,67.9,00000
1.0,58.0,59.0,655,08,01,  Charidanga,703,464,343,228,360,236,60.2,60.1,60.4,00000
1.0,58.0,59.0,737,01,01,  Mithakhali,446,707,209,357,237,350,38.7,36.9,40.4,00000
1.0,58.0,59.0,737,02,01,  Sonakhali,331,366,160,179,171,187,47.5,47.2,47.8,00000
1.0,58.0,59.0,831,01,01,  Uttar Sahebermet,817,447,409,227,408,220,64.6,64.3,65.0,00000
1.0,58.0,59.0,831,02,01,  Dakshin Sahebermet,719,538,360,271,359,267,57.2,57.1,57.3,00000
1.0,58.0,83.0,945,01,01,  Bara Suniltala,573,619,278,304,295,315,48.1,47.8,48.4,00000
1.0,58.0,83.0,945,02,01,  Chotto Suniltala,488,583,217,285,271,298,45.6,43.2,47.6,00000
1.0,58.0,83.0,989,01,01,  Ulubunia,790,1091,347,534,443,557,42.0,39.4,44.3,00000
1.0,58.0,83.0,989,02,01,  Joykhan,496,371,262,171,234,200,57.2,60.5,53.9,00000
1.0,58.0,89.0,058,01,01,  Madurpalta,302,141,153,64,149,77,68.2,70.5,65.9,00000
1.0,58.0,89.0,058,02,01,  Bajikarkhanda,1261,1059,613,516,648,543,54.4,54.3,54.4,00000
1.0,58.0,89.0,058,03,01,  Kachubunia,729,947,346,480,383,467,43.5,41.9,45.1,00000
1.0,58.0,89.0,058,04,01,  Baraitala,112,267,62,139,50,128,29.6,30.8,28.1,00000
1.0,58.0,89.0,058,05,01,  Golbunia,145,202,58,104,87,98,41.8,35.8,47.0,00000
1.0,58.0,89.0,093,01,01,  Banshtala,1528,1557,744,772,784,785,49.5,49.1,50.0,00000
1.0,58.0,89.0,093,02,01,  Diarkhanda,288,364,132,188,156,176,44.2,41.3,47.0,00000
1.0,58.0,89.0,386,01,01,  Damerkhanda,192,99,101,36,91,63,66.0,73.7,59.1,00000
1.0,58.0,89.0,386,02,01,  Doarij Jora,226,97,120,36,106,61,70.0,76.9,63.5,00000
1.0,58.0,89.0,386,03,01,  Chater Hat,110,191,63,102,47,89,36.5,38.2,34.6,00000
1.0,58.0,89.0,386,04,01,  Dhalirkhanda,149,161,80,82,69,79,48.1,49.4,46.6,00000
1.0,58.0,89.0,386,05,01,  Tegharia,224,105,116,48,108,57,68.1,70.7,65.5,00000
1.0,58.0,89.0,637,01,01,  Burburia,544,171,292,69,252,102,76.1,80.9,71.2,00000
1.0,58.0,89.0,637,02,01,  Gora Burburia,348,437,164,223,184,214,44.3,42.4,46.2,00000
1.0,58.0,89.0,637,03,01,  Hoglabunia,161,190,73,88,88,102,45.9,45.3,46.3,00000
1.0,58.0,89.0,637,04,01,  Katakhali,434,411,213,204,221,207,51.4,51.1,51.6,00000
1.0,58.0,89.0,637,05,01,  Digraj,390,302,209,139,181,163,56.4,60.1,52.6,00000
1.0,58.0,89.0,637,06,01,  Aga Madhur Patla,423,149,212,65,211,84,74.0,76.5,71.5,00000
1.0,60.0,11.0,066,01,01,  Balaibunia,209,173,96,88,113,85,54.7,52.2,57.1,00000
1.0,60.0,11.0,066,02,01,  Banshbaria,285,453,139,194,146,259,38.6,41.7,36.0,00000
1.0,60.0,11.0,066,03,01,  Ambaria,398,300,200,132,198,168,57.0,60.2,54.1,00000
1.0,60.0,11.0,066,04,01,  Dona,1017,583,513,271,504,312,63.6,65.4,61.8,00000
1.0,60.0,11.0,066,05,01,  Chulombaria,158,213,68,107,90,106,42.6,38.9,45.9,00000
1.0,60.0,11.0,066,06,01,  Jamua (Patabari),412,446,197,207,215,239,48.0,48.8,47.4,00000
1.0,60.0,11.0,066,07,01,  Kalaikabari,971,552,489,274,482,278,63.8,64.1,63.4,00000
1.0,60.0,11.0,066,08,01,  Sharnikhali,405,357,206,156,199,201,53.1,56.9,49.8,00000
1.0,60.0,23.0,406,01,01,  Dakshin Sutalari,468,509,256,234,212,275,47.9,52.2,43.5,00000
1.0,60.0,23.0,406,02,01,  Basanda,1019,873,552,396,467,477,53.9,58.2,49.5,00000
1.0,60.0,23.0,406,03,01,  Gabtala,830,156,443,63,387,93,84.2,87.5,80.6,00000
1.0,60.0,23.0,406,04,01,  Tentulbaria,465,151,235,67,230,84,75.5,77.8,73.2,00000
1.0,60.0,23.0,406,05,01,  Tafalbaria,194,178,96,86,98,92,52.2,52.7,51.6,00000
1.0,60.0,23.0,406,06,01,  Goalbaria,684,383,322,188,362,195,64.1,63.1,65.0,00000
1.0,60.0,23.0,406,07,01,  Pailatala,1307,677,665,321,642,356,65.9,67.4,64.3,00000
1.0,60.0,47.0,580,01,01,  Hogla Pasha,1879,743,1006,340,873,403,71.7,74.7,68.4,00000
1.0,60.0,47.0,580,02,01,  Asryon,141,74,83,36,58,38,65.6,69.7,60.4,00000
1.0,60.0,53.0,397,01,01,  Baraikhali,174,200,88,93,86,107,46.5,48.6,44.6,00000
1.0,60.0,53.0,397,02,01,  Bhaijora,449,233,216,121,233,112,65.8,64.1,67.5,00000
1.0,60.0,53.0,397,03,01,  Pashkhali,350,177,186,84,164,93,66.4,68.9,63.8,00000
1.0,60.0,53.0,397,04,01,  Baraitala,559,446,274,217,285,229,55.6,55.8,55.4,00000
1.0,60.0,53.0,397,05,01,  Thakuruntala,404,342,204,163,200,179,54.2,55.6,52.8,00000
1.0,60.0,53.0,397,06,01,  Ekramkhali,311,20,157,12,154,8,94.0,92.9,95.1,00000
1.0,60.0,53.0,431,01,01,  Deuatala,1305,728,652,341,653,387,64.2,65.7,62.8,00000
1.0,60.0,53.0,431,02,01,  Kuruper Daber,210,65,110,22,100,43,76.4,83.3,69.9,00000
1.0,60.0,53.0,431,03,01,  Khanirkhanda,572,255,268,131,304,124,69.2,67.2,71.0,00000
1.0,60.0,53.0,431,04,01,  Kakratali,165,72,90,33,75,39,69.6,73.2,65.8,00000
1.0,60.0,53.0,431,05,01,  Sonatali,508,411,267,191,241,220,55.3,58.3,52.3,00000
1.0,60.0,53.0,431,06,01,  Kalachander Dar,131,66,70,26,61,40,66.5,72.9,60.4,00000
1.0,60.0,53.0,431,07,01,  Dumuria,702,290,396,124,306,166,70.8,76.2,64.8,00000
1.0,60.0,53.0,431,08,01,  Haolardanga,89,29,48,10,41,19,75.4,82.8,68.3,00000
1.0,60.0,53.0,812,01,01,  Palerkhanda,602,224,303,118,299,106,72.9,72.0,73.8,00000
1.0,60.0,53.0,812,02,01,  Lakshmikhali,976,560,522,257,454,303,63.5,67.0,60.0,00000
1.0,60.0,53.0,812,03,01,  Bahantala,191,128,77,69,114,59,59.9,52.7,65.9,00000
1.0,60.0,53.0,812,04,01,  Bayarsingh,481,165,256,75,225,90,74.5,77.3,71.4,00000
1.0,60.0,53.0,812,05,01,  Panjakhala,227,117,107,71,120,46,66.0,60.1,72.3,00000
1.0,60.0,53.0,812,06,01,  Chandantala,369,171,191,78,178,93,68.3,71.0,65.7,00000
1.0,60.0,53.0,812,07,01,  Battala,398,119,204,49,194,70,77.0,80.6,73.5,00000
1.0,60.0,53.0,978,01,01,  Matbaria,471,186,257,85,214,101,71.7,75.1,67.9,00000
1.0,60.0,53.0,978,02,01,  Kalibari,390,46,191,18,199,28,89.4,91.4,87.7,00000
1.0,60.0,53.0,978,03,01,  Pathuria,481,144,245,56,236,88,77.0,81.4,72.8,00000
1.0,60.0,53.0,978,04,01,  Somandarkhali,892,707,467,355,425,352,55.8,56.8,54.7,00000
1.0,60.0,53.0,978,05,01,  Arang Ghata,193,72,111,26,82,46,72.8,81.0,64.1,00000
1.0,60.0,59.0,257,01,01,  Chailtabunia,978,1023,467,479,511,544,48.9,49.4,48.4,00000
1.0,60.0,59.0,257,02,01,  Khablia,1271,1035,594,481,677,554,55.1,55.3,55.0,00000
1.0,60.0,59.0,257,03,01,  Nishanbaria,761,248,350,115,411,133,75.4,75.3,75.6,00000
1.0,60.0,59.0,257,04,01,  Pashuribunia,801,444,356,222,445,222,64.3,61.6,66.7,00000
1.0,60.0,59.0,257,05,01,  Sannyashi,885,738,405,360,480,378,54.5,52.9,55.9,00000
1.0,60.0,59.0,787,01,01,  Kumarkhali,751,931,348,488,403,443,44.6,41.6,47.6,00000
1.0,60.0,59.0,787,02,01,  Khajurbaria,807,578,386,287,421,291,58.3,57.4,59.1,00000
1.0,60.0,59.0,787,03,01,  Manikjor,420,299,205,137,215,162,58.4,59.9,57.0,00000
1.0,60.0,59.0,787,04,01,  Barisal,1695,1261,811,613,884,648,57.3,57.0,57.7,00000
1.0,60.0,59.0,787,05,01,  Kashiatala,306,359,142,195,164,164,46.0,42.1,50.0,00000
1.0,60.0,59.0,787,06,01,  Amtali,728,702,353,371,375,331,50.9,48.8,53.1,00000
1.0,60.0,59.0,878,01,01,  Purba Chipa Baraikhali,924,985,403,446,521,539,48.4,47.5,49.2,00000
1.0,60.0,59.0,878,02,01,  Dansagar,412,411,183,179,229,232,50.1,50.6,49.7,00000
1.0,60.0,59.0,878,03,01,  Bara Pani,981,1008,443,501,538,507,49.3,46.9,51.5,00000
1.0,60.0,59.0,878,04,01,  Chhota Pani,302,314,148,137,154,177,49.0,51.9,46.5,00000
1.0,60.0,59.0,878,05,01,  Baniakhali,825,307,387,127,438,180,72.9,75.3,70.9,00000
1.0,60.0,65.0,033,01,01,  Badurtala,919,943,417,465,502,478,49.4,47.3,51.2,00000
1.0,60.0,65.0,033,02,01,  Bisharighata,1502,1073,718,497,784,576,58.3,59.1,57.6,00000
1.0,60.0,65.0,837,01,01,  Bhaizora,840,670,412,336,428,334,55.6,55.1,56.2,00000
1.0,60.0,65.0,837,02,01,  Kathal Tala,447,522,249,305,198,217,46.1,44.9,47.7,00000
1.0,60.0,65.0,837,03,01,  Gabtala,559,499,294,227,265,272,52.8,56.4,49.3,00000
1.0,60.0,65.0,945,01,01,  Paschim Saralia,941,615,428,286,513,329,60.5,59.9,60.9,00000
1.0,60.0,65.0,945,02,01,  Uttar Saralia,341,175,163,86,178,89,66.1,65.5,66.7,00000
1.0,60.0,65.0,945,03,01,  Madhya Saralia,339,164,153,87,186,77,67.4,63.8,70.7,00000
1.0,60.0,71.0,132,01,01,  Bhashandal,707,508,348,244,359,264,58.2,58.8,57.6,00000
1.0,60.0,71.0,132,02,01,  Hoglapata,710,908,325,440,385,468,43.9,42.5,45.1,00000
1.0,60.0,71.0,132,03,01,  Umajuri,187,402,85,194,102,208,31.7,30.5,32.9,00000
1.0,60.0,71.0,132,04,01,  Nishanbaria,597,356,279,172,318,184,62.6,61.9,63.3,00000
1.0,60.0,71.0,547,01,01,  Guatala,883,822,422,388,461,434,51.8,52.1,51.5,00000
1.0,60.0,71.0,547,02,01,  Hartakitala,745,756,350,353,395,403,49.6,49.8,49.5,00000
1.0,60.0,71.0,547,03,01,  Jamirtala,751,644,352,321,399,323,53.8,52.3,55.3,00000
1.0,60.0,71.0,621,01,01,  Jiudhara,1252,1073,580,499,672,574,53.8,53.8,53.9,00000
1.0,60.0,71.0,621,02,01,  Amrabunia,895,1020,433,517,462,503,46.7,45.6,47.9,00000
1.0,60.0,71.0,854,01,01,  Paschim Chipa Baraikhali,1411,1448,676,708,735,740,49.4,48.8,49.8,00000
1.0,60.0,71.0,854,02,01,  Dhansagar,1225,1006,594,500,631,506,54.9,54.3,55.5,00000
1.0,73.0,11.0,099,01,01,  Banshtali,2141,1344,1074,641,1067,703,61.4,62.6,60.3,00000
1.0,73.0,11.0,099,02,01,  Madnakhali,105,52,47,25,58,27,66.9,65.3,68.2,00000
1.0,73.0,11.0,304,01,01,  Chanditala,551,188,288,75,263,113,74.6,79.3,69.9,00000
1.0,73.0,11.0,304,02,01,  Islamabad,719,112,361,50,358,62,86.5,87.8,85.2,00000
1.0,73.0,11.0,444,01,01,  Gilatala,2114,707,1070,343,1044,364,74.9,75.7,74.1,00000
1.0,73.0,11.0,444,02,01,  Tegaria,202,24,103,11,99,13,89.4,90.4,88.4,00000
1.0,73.0,17.0,087,01,01,  Banshbaria,299,21,157,4,142,17,93.4,97.5,89.3,00000
1.0,73.0,17.0,087,02,01,  Mirkhali,191,58,93,28,98,30,76.7,76.9,76.6,00000
1.0,73.0,17.0,087,03,01,  Chatarjakhali,51,11,33,3,18,8,82.3,91.7,69.2,00000
1.0,73.0,17.0,251,01,01,  Betkanta,1157,549,591,248,566,301,67.8,70.4,65.3,00000
1.0,73.0,17.0,251,02,01,  Jialmari,396,116,203,59,193,57,77.3,77.5,77.2,00000
1.0,73.0,47.0,503,01,01,  Hukra,1017,362,566,164,451,198,73.7,77.5,69.5,00000
1.0,73.0,47.0,503,02,01,  Sreedamkhali,250,153,125,80,125,73,62.0,61.0,63.1,00000
1.0,73.0,47.0,503,03,01,  Bhekotari,538,346,285,162,253,184,60.9,63.8,57.9,00000
1.0,73.0,47.0,503,04,01,  Gajikhali,261,194,125,106,136,88,57.4,54.1,60.7,00000
1.0,73.0,47.0,503,05,01,  Katamari,365,141,215,46,150,95,72.1,82.4,61.2,00000
1.0,73.0,47.0,503,06,01,  Nalbunia,313,72,161,28,152,44,81.3,85.2,77.6,00000
1.0,73.0,47.0,503,07,01,  Gajgajia,154,88,82,35,72,53,63.6,70.1,57.6,00000
1.0,73.0,71.0,357,01,01,  Aruadanga,309,388,157,195,152,193,44.3,44.6,44.1,00000
1.0,73.0,71.0,357,02,01,  Satbakuria,419,376,200,188,219,188,52.7,51.5,53.8,00000
1.0,73.0,71.0,357,03,01,  Jigir Mollah,206,196,93,95,113,101,51.2,49.5,52.8,00000
1.0,73.0,71.0,357,04,01,  Singerbunia,315,415,155,203,160,212,43.2,43.3,43.0,00000
1.0,73.0,71.0,684,01,01,  Kumarkhali,376,204,184,101,192,103,64.8,64.6,65.1,00000
1.0,73.0,71.0,684,02,01,  Dakra,559,425,263,196,296,229,56.8,57.3,56.4,00000
1.0,73.0,71.0,684,03,01,  Ramjoypur,643,393,324,183,319,210,62.1,63.9,60.3,00000
1.0,73.0,94.0,450,01,01,  Gobindapur,1917,1257,1020,567,897,690,60.4,64.3,56.5,00000
1.0,73.0,94.0,450,02,01,  Par Gobindapur,707,595,379,284,328,311,54.3,57.2,51.3,00000
1.0,77.0,19.0,361,01,01,  Dhansagar,1320,1179,624,547,696,632,52.8,53.3,52.4,00000
1.0,77.0,19.0,361,02,01,  Dhansagar Khajurbaria,364,338,179,142,185,196,51.9,55.8,48.6,00000
1.0,77.0,19.0,633,01,01,  Nalbunia,1066,1013,468,493,598,520,51.3,48.7,53.5,00000
1.0,77.0,19.0,633,02,01,  Dakshin Badal,1030,529,490,255,540,274,66.1,65.8,66.3,00000
1.0,77.0,19.0,633,03,01,  Malsa,207,188,85,82,122,106,52.4,50.9,53.5,00000
1.0,77.0,19.0,633,04,01,  Kalibari,241,112,125,53,116,59,68.3,70.2,66.3,00000
1.0,77.0,19.0,633,05,01,  Hagalpati,415,220,185,109,230,111,65.4,62.9,67.4,00000
1.0,77.0,19.0,633,06,01,  Shaylabunia,295,128,136,67,159,61,69.7,67.0,72.3,00000
1.0,77.0,19.0,633,07,01,  Amragachia,855,265,442,124,413,141,76.3,78.1,74.5,00000
1.0,77.0,19.0,633,08,01,  Nalbunia Dhansagar,603,326,280,159,323,167,64.9,63.8,65.9,00000
1.0,77.0,19.0,633,09,01,  Uttar Badal,534,317,265,161,269,156,62.7,62.2,63.3,00000
1.0,77.0,38.0,090,01,03,  Amragachhia,1374,800,605,374,769,426,63.2,61.8,64.4,00000
1.0,77.0,38.0,090,02,03,  Golbunia,1405,545,651,264,754,281,72.1,71.1,72.9,00000
1.0,77.0,38.0,090,03,03,  Nalbunia,719,433,320,214,399,219,62.4,59.9,64.6,00000
1.0,77.0,38.0,090,04,03,  Rajoir,2466,1331,1230,690,1236,641,64.9,64.1,65.8,00000
1.0,77.0,38.0,090,05,03,  Jiban Duari,502,305,222,147,280,158,62.2,60.2,63.9,00000
1.0,77.0,38.0,180,01,01,  Baniakhali,930,462,440,225,490,237,66.8,66.2,67.4,00000
1.0,77.0,38.0,180,02,01,  Janar Para,727,344,331,164,396,180,67.9,66.9,68.8,00000
1.0,77.0,38.0,180,03,01,  Dhansagar,605,442,299,206,306,236,57.8,59.2,56.5,00000
1.0,77.0,38.0,180,04,01,  Baniakhali Nalbunia,1028,665,467,334,561,331,60.7,58.3,62.9,00000
1.0,77.0,38.0,542,01,01,  Morellabad,2916,1863,1388,965,1528,898,61.0,59.0,63.0,00000
1.0,77.0,38.0,542,02,01,  Khontakata,4689,2666,2205,1305,2484,1361,63.8,62.8,64.6,00000
1.0,77.0,57.0,271,01,01,  Dakshin Rajapur,1815,1416,783,741,1032,675,56.2,51.4,60.5,00000
1.0,77.0,57.0,271,02,01,  Malia,1209,985,539,466,670,519,55.1,53.6,56.3,00000
1.0,77.0,57.0,271,03,01,  Uttar Rajapur,1757,1563,794,822,963,741,52.9,49.1,56.5,00000
1.0,77.0,57.0,452,01,01,  Khada,2090,1324,931,682,1159,642,61.2,57.7,64.4,00000
1.0,77.0,57.0,452,02,01,  Uttar Tafalbari,1312,990,628,484,684,506,57.0,56.5,57.5,00000
1.0,77.0,57.0,723,01,03,  Rayenda (Kadamtala),6200,2674,3137,1322,3063,1352,69.9,70.4,69.4,00000
1.0,77.0,57.0,723,02,03,  Chailtabunia,227,144,132,55,95,89,61.2,70.6,51.6,00000
1.0,77.0,57.0,723,03,03,  Madhya Rayenda,655,589,306,313,349,276,52.7,49.4,55.8,00000
1.0,77.0,57.0,723,04,03,  Lakurtala,178,274,86,131,92,143,39.4,39.6,39.1,00000
1.0,77.0,57.0,723,05,03,  Rajeshwar,690,507,317,257,373,250,57.6,55.2,59.9,00000
1.0,77.0,57.0,723,06,03,  Jilbunia,453,506,200,266,253,240,47.2,42.9,51.3,00000
1.0,77.0,76.0,904,01,01,  Dakshin Saudkhali,1065,957,499,505,566,452,52.7,49.7,55.6,00000
1.0,77.0,76.0,904,02,01,  Uttar Saudkhali,429,949,195,493,234,456,31.1,28.3,33.9,00000
1.0,77.0,76.0,904,03,01,  Bogi,830,653,378,324,452,329,56.0,53.8,57.9,00000
1.0,77.0,76.0,904,04,01,  Chalitabunia,1275,807,591,386,684,421,61.2,60.5,61.9,00000
1.0,77.0,76.0,904,05,01,  Khuriakhali,1519,1238,702,643,817,595,55.1,52.2,57.9,00000
1.0,77.0,76.0,994,01,01,  Sonatala,1769,2172,807,1130,962,1042,44.9,41.7,48.0,00000
1.0,77.0,76.0,994,02,01,  Bakultala,888,1016,425,501,463,515,46.6,45.9,47.3,00000
1.0,77.0,76.0,994,03,01,  Uttar Tafalbari,1100,693,543,316,557,377,61.3,63.2,59.6,00000
1.0,77.0,76.0,994,04,01,  Dakshin Tafalbari,1030,613,494,273,536,340,62.7,64.4,61.2,00000
1.0,77.0,76.0,994,05,01,  Rayenda,969,878,440,462,529,416,52.5,48.8,56.0,00000
55.0,57.0,21.0,152,01,01,  Banshkota,415,336,236,141,179,195,55.3,62.6,47.9,00000
55.0,57.0,21.0,152,02,01,  Kalinagar,151,174,82,76,69,98,46.5,51.9,41.3,00000
55.0,57.0,21.0,152,03,01,  Katakhal,241,244,132,107,109,137,49.7,55.2,44.3,00000
55.0,57.0,21.0,152,04,01,  Naliardangi,397,658,188,353,209,305,37.6,34.8,40.7,00000
55.0,57.0,21.0,152,05,01,  Jafrartak,188,151,104,77,84,74,55.5,57.5,53.2,00000
55.0,57.0,21.0,152,06,01,  Krishnabila,232,193,111,97,121,96,54.6,53.4,55.8,00000
55.0,57.0,21.0,152,07,01,  Bijoynagar,190,113,107,46,83,67,62.7,69.9,55.3,00000
55.0,57.0,21.0,152,08,01,  Golaknagar,143,179,75,82,68,97,44.4,47.8,41.2,00000
55.0,57.0,21.0,269,01,01,  Chandan Pratap,1285,982,660,453,625,529,56.7,59.3,54.2,00000
55.0,57.0,21.0,269,02,01,  Gopinathpur,343,608,170,293,173,315,36.1,36.7,35.5,00000
55.0,57.0,21.0,269,03,01,  Gangnalia,245,355,131,169,114,186,40.8,43.7,38.0,00000
55.0,57.0,21.0,269,04,01,  Gobindapur,58,179,35,89,23,90,24.5,28.2,20.4,00000
55.0,57.0,21.0,269,05,01,  Chandpur,23,84,11,41,12,43,21.5,21.2,21.8,00000
55.0,57.0,21.0,651,01,01,  Mrigidanga,302,267,174,111,128,156,53.1,61.1,45.1,00000
55.0,57.0,21.0,651,02,01,  Shyamnagar,174,196,94,87,80,109,47.0,51.9,42.3,00000
55.0,57.0,21.0,651,03,01,  Char Para,210,151,107,58,103,93,58.2,64.8,52.6,00000
55.0,57.0,23.0,173,01,01,  Bara Joka,239,157,118,72,121,85,60.4,62.1,58.7,00000
55.0,57.0,23.0,173,02,01,  Manirampur,238,353,121,181,117,172,40.3,40.1,40.5,00000
55.0,57.0,23.0,225,01,01,  Bhangura,760,564,412,256,348,308,57.4,61.7,53.0,00000
55.0,57.0,23.0,225,02,01,  Chandpur,155,497,84,235,71,262,23.8,26.3,21.3,00000
55.0,57.0,23.0,225,03,01,  Birail Palita(Part),120,71,61,32,59,39,62.8,65.6,60.2,00000
55.0,57.0,23.0,243,01,01,  Birail Palita,1469,1069,671,490,798,579,57.9,57.8,58.0,00000
55.0,57.0,23.0,243,02,01,  Jalia Bhita,72,60,44,25,28,35,54.5,63.8,44.4,00000
55.0,57.0,23.0,299,01,01,  Changardanga,473,614,262,280,211,334,43.5,48.3,38.7,00000
55.0,57.0,23.0,299,02,01,  Ramchandrapur,230,181,132,75,98,106,56.0,63.8,48.0,00000
55.0,57.0,23.0,382,01,01,  Dighalkandi,345,340,181,163,164,177,50.4,52.6,48.1,00000
55.0,57.0,23.0,382,02,01,  Sener Char,146,260,78,123,68,137,36.0,38.8,33.2,00000
55.0,57.0,25.0,099,01,01,  Bagia,614,622,307,299,307,323,49.7,50.7,48.7,00000
55.0,57.0,25.0,099,02,01,  Narayanpur,160,106,84,44,76,62,60.2,65.6,55.1,00000
55.0,57.0,25.0,099,03,01,  Paichal,534,453,282,211,252,242,54.1,57.2,51.0,00000
55.0,57.0,40.0,751,01,01,  Phulbari,649,355,332,142,317,213,64.6,70.0,59.8,00000
55.0,57.0,40.0,751,02,01,  Lakshmikul,899,523,451,238,448,285,63.2,65.5,61.1,00000
55.0,57.0,47.0,812,01,01,  Sachani Rautara,917,1051,459,529,458,522,46.6,46.5,46.7,00000
55.0,57.0,47.0,812,02,01,  Rautara,1334,767,721,326,613,441,63.5,68.9,58.2,00000
55.0,57.0,54.0,008,01,01,  Bil Aski,515,613,253,301,262,312,45.7,45.7,45.6,00000
55.0,57.0,54.0,008,02,01,  Ber Aksi,616,465,312,204,304,261,57.0,60.5,53.8,00000
55.0,57.0,54.0,469,01,01,  Jagdal,932,1518,478,786,454,732,38.0,37.8,38.3,00000
55.0,57.0,54.0,469,02,01,  Ajampur,931,1644,461,829,470,815,36.2,35.7,36.6,00000
55.0,57.0,54.0,469,03,01,  Dakur Bhita,76,245,40,132,36,113,23.7,23.3,24.2,00000
55.0,57.0,54.0,469,04,01,  Damdama,139,351,81,181,58,170,28.4,30.9,25.4,00000
55.0,57.0,54.0,803,01,01,  Rupati,622,870,321,400,301,470,41.7,44.5,39.0,00000
55.0,57.0,54.0,803,02,01,  Said Rupati,410,716,229,319,181,397,36.4,41.8,31.3,00000
55.0,57.0,61.0,525,01,01,  Kasundi,633,684,349,335,284,349,48.1,51.0,44.9,00000
55.0,57.0,61.0,525,02,01,  Khord Kasundi,222,88,110,38,112,50,71.6,74.3,69.1,00000
55.0,57.0,61.0,525,03,01,  Ulinagar,231,209,137,101,94,108,52.5,57.6,46.5,00000
55.0,57.0,61.0,525,04,01,  Kalinagar,514,590,263,282,251,308,46.6,48.3,44.9,00000
55.0,57.0,67.0,316,01,01,  Dakshin Shimulia,307,363,175,156,132,207,45.8,52.9,38.9,00000
55.0,57.0,67.0,316,02,01,  Patkhali,393,639,180,306,213,333,38.1,37.0,39.0,00000
55.0,57.0,67.0,412,01,01,  Gangni,529,1023,261,482,268,541,34.1,35.1,33.1,00000
55.0,57.0,67.0,412,02,01,  Natungram,148,189,76,84,72,105,43.9,47.5,40.7,00000
55.0,57.0,74.0,534,01,01,  Kechuadubi,400,826,210,401,190,425,32.6,34.4,30.9,00000
55.0,57.0,74.0,534,02,01,  Baishkhali,226,215,130,94,96,121,51.2,58.0,44.2,00000
55.0,57.0,74.0,686,01,01,  Nidhipur,146,130,70,62,76,68,52.9,53.0,52.8,00000
55.0,57.0,74.0,686,02,01,  Bishnupur,110,81,59,30,51,51,57.6,66.3,50.0,00000
55.0,57.0,88.0,217,01,01,  Das Berail,181,235,94,105,87,130,43.5,47.2,40.1,00000
55.0,57.0,88.0,217,02,01,  Huda Berail,507,343,257,151,250,192,59.6,63.0,56.6,00000
55.0,57.0,88.0,217,03,01,  Bara Berail,1577,1599,795,753,782,846,49.7,51.4,48.0,00000
55.0,57.0,88.0,217,04,01,  Baliadanga,159,236,95,111,64,125,40.3,46.1,33.9,00000
55.0,57.0,88.0,386,01,01,  Dora,401,534,198,270,203,264,42.9,42.3,43.5,00000
55.0,57.0,88.0,386,02,01,  Mathna,255,340,127,165,128,175,42.9,43.5,42.2,00000
55.0,57.0,88.0,699,01,01,  Kanchanpur,141,216,68,107,73,109,39.5,38.9,40.1,00000
55.0,57.0,88.0,699,02,01,  Paka,323,422,160,223,163,199,43.4,41.8,45.0,00000
55.0,57.0,88.0,825,01,01,  Sangda Lakshmipur,446,445,236,202,210,243,50.1,53.9,46.4,00000
55.0,57.0,88.0,825,02,01,  Sangda,345,418,177,201,168,217,45.2,46.8,43.6,00000
55.0,57.0,88.0,825,03,01,  Bitti Para,143,143,74,74,69,69,50.0,50.0,50.0,00000
55.0,66.0,10.0,030,01,01,  Bahalbaria,146,339,79,178,67,161,30.1,30.7,29.4,00000
55.0,66.0,10.0,030,02,01,  Dhunachia,122,114,65,53,57,61,51.7,55.1,48.3,00000
55.0,66.0,10.0,030,03,01,  Kuli Para,71,61,38,27,33,34,53.8,58.5,49.3,00000
55.0,66.0,10.0,250,01,01,  Char Salamatpur,290,333,158,159,132,174,46.5,49.8,43.1,00000
55.0,66.0,10.0,250,02,01,  Bahir Char,177,264,100,116,77,148,40.1,46.3,34.2,00000
55.0,66.0,10.0,250,03,01,  Aksha,204,209,114,106,90,103,49.4,51.8,46.6,00000
55.0,66.0,10.0,250,04,01,  Brihasnagar,155,196,82,81,73,115,44.2,50.3,38.8,00000
55.0,66.0,10.0,250,05,01,  Madhabpur,410,285,196,151,214,134,59.0,56.5,61.5,00000
55.0,66.0,10.0,296,01,01,  Datiadaha,978,1418,494,662,484,756,40.8,42.7,39.0,00000
55.0,66.0,10.0,296,02,01,  Babukhali,226,158,137,59,89,99,58.9,69.9,47.3,00000
55.0,66.0,10.0,319,01,01,  Dhuljora,195,207,104,102,91,105,48.5,50.5,46.4,00000
55.0,66.0,10.0,319,02,01,  Char Dhuljora,117,208,74,100,43,108,36.0,42.5,28.5,00000
55.0,66.0,10.0,417,01,01,  Hatbaria,118,166,64,72,54,94,41.5,47.1,36.5,00000
55.0,66.0,10.0,417,02,01,  Kauali Para,431,300,247,123,184,177,59.0,66.8,51.0,00000
55.0,66.0,10.0,417,03,01,  Arpara,370,596,211,272,159,324,38.3,43.7,32.9,00000
55.0,66.0,10.0,417,04,01,  Madan Mohanpur,170,151,86,87,84,64,53.0,49.7,56.8,00000
55.0,66.0,10.0,417,05,01,  Shibrampur,244,499,122,249,122,250,32.8,32.9,32.8,00000
55.0,66.0,10.0,417,06,01,  Karinagar,113,392,54,186,59,206,22.4,22.5,22.3,00000
55.0,66.0,10.0,417,07,01,  Ramkrishnapur,492,358,254,173,238,185,57.9,59.5,56.3,00000
55.0,66.0,10.0,417,08,01,  Paruarkul,296,304,152,154,144,150,49.3,49.7,49.0,00000
55.0,66.0,10.0,417,09,01,  Shibpur,172,206,84,82,88,124,45.5,50.6,41.5,00000
55.0,66.0,10.0,417,10,01,  Pachuria,88,131,51,60,37,71,40.2,45.9,34.3,00000
55.0,66.0,10.0,417,11,01,  Rulfalsia,112,1,51,1,61,0,99.1,98.1,100.0,00000
55.0,66.0,10.0,417,12,01,  Sandhai,171,1,82,1,89,0,99.4,98.8,100.0,00000
55.0,66.0,21.0,098,01,01,  Gopalpur,471,393,230,185,241,208,54.5,55.4,53.7,00000
55.0,66.0,21.0,098,02,01,  Baruria,1493,1790,738,851,755,939,45.5,46.4,44.6,00000
55.0,66.0,21.0,098,03,01,  Char Baruria,247,342,117,160,130,182,41.9,42.2,41.7,00000
55.0,66.0,21.0,227,01,01,  Gopinathpur,372,455,201,201,171,254,45.0,50.0,40.2,00000
55.0,66.0,21.0,227,02,01,  Champatala,544,610,258,280,286,330,47.1,48.0,46.4,00000
55.0,66.0,21.0,531,01,01,  Kaora,440,549,225,270,215,279,44.5,45.5,43.5,00000
55.0,66.0,21.0,531,02,01,  Mouli,283,247,148,115,135,132,53.4,56.3,50.6,00000
55.0,66.0,21.0,592,01,01,  Lakshmipur,355,415,163,191,192,224,46.1,46.0,46.2,00000
55.0,66.0,21.0,592,02,01,  Moheshpur(Part),108,130,54,59,54,71,45.4,47.8,43.2,00000
55.0,66.0,31.0,129,01,01,  Bethalia,320,628,166,301,154,327,33.8,35.5,32.0,00000
55.0,66.0,31.0,129,02,01,  Saruppur,98,162,54,73,44,89,37.7,42.5,33.1,00000
55.0,66.0,31.0,129,03,01,  Char Para,281,391,139,198,142,193,41.8,41.2,42.4,00000
55.0,66.0,31.0,265,01,01,  Choubaria,852,983,431,471,421,512,46.4,47.8,45.1,00000
55.0,66.0,31.0,265,02,01,  Panchuria,134,95,78,33,56,62,58.5,70.3,47.5,00000
55.0,66.0,31.0,387,01,01,  Ghullia,1362,1828,715,870,647,958,42.7,45.1,40.3,00000
55.0,66.0,31.0,387,02,01,  Baniagati,70,140,30,71,40,69,33.3,29.7,36.7,00000
55.0,66.0,42.0,182,01,01,  Bil Jhalmal,361,316,188,145,173,171,53.3,56.5,50.3,00000
55.0,66.0,42.0,182,02,01,  Sonapur,188,127,89,55,99,72,59.7,61.8,57.9,00000
55.0,66.0,42.0,797,01,01,  Panchuria,99,74,56,30,43,44,57.2,65.1,49.4,00000
55.0,66.0,42.0,797,02,01,  Bhiti Para,49,67,28,35,21,32,42.2,44.4,39.6,00000
55.0,66.0,42.0,926,01,01,  Sindain,623,601,314,288,309,313,50.9,52.2,49.7,00000
55.0,66.0,42.0,926,02,01,  Chitta Bishrampur,586,458,280,193,306,265,56.1,59.2,53.6,00000
55.0,66.0,52.0,113,01,01,  Basur Dhuljuri,163,49,78,21,85,28,76.9,78.8,75.2,00000
55.0,66.0,52.0,113,02,01,  Bhangaswar,161,112,82,46,79,66,59.0,64.1,54.5,00000
55.0,66.0,52.0,174,01,01,  Bholanathpur,50,48,27,20,23,28,51.0,57.4,45.1,00000
55.0,66.0,52.0,174,02,01,  Raypur(Part),196,379,103,179,93,200,34.1,36.5,31.7,00000
55.0,66.0,52.0,235,01,01,  Char Chhatiani Paschimkhanda,229,177,117,76,112,101,56.4,60.6,52.6,00000
55.0,66.0,52.0,235,02,01,  Roypur(Part),54,32,33,13,21,19,62.8,71.7,52.5,00000
55.0,66.0,52.0,334,01,01,  Dhushrail,384,250,174,110,210,140,60.6,61.3,60.0,00000
55.0,66.0,52.0,334,02,01,  Tali Pukur,319,522,152,256,167,266,37.9,37.3,38.6,00000
55.0,66.0,52.0,615,01,03,  Mohammadpur,1413,891,696,409,717,482,61.3,63.0,59.8,00000
55.0,66.0,52.0,615,02,03,  Baujani,565,523,269,259,296,264,51.9,50.9,52.9,00000
55.0,66.0,52.0,789,01,01,  Panchuria,204,231,115,98,89,133,46.9,54.0,40.1,00000
55.0,66.0,52.0,835,01,01,  Poail,255,235,145,100,110,135,52.0,59.2,44.9,00000
55.0,66.0,52.0,835,02,01,  Raypur(Part),26,41,20,18,6,23,38.8,52.6,20.7,00000
55.0,66.0,52.0,911,01,01,  Ruijani,258,372,122,186,136,186,41.0,39.6,42.2,00000
55.0,66.0,52.0,911,02,01,  Gopalnagar,610,365,326,136,284,229,62.6,70.6,55.4,00000
55.0,66.0,52.0,957,01,01,  Surjyakunda,189,273,88,134,101,139,40.9,39.6,42.1,00000
55.0,66.0,52.0,957,02,01,  Raypur(Part),37,28,19,11,18,17,56.9,63.3,51.4,00000
55.0,66.0,63.0,197,01,01,  Bilwa Para,211,317,95,151,116,166,40.0,38.6,41.1,00000
55.0,66.0,63.0,197,02,01,  Khalisakhali,865,1049,411,522,454,527,45.2,44.1,46.3,00000
55.0,66.0,63.0,425,01,01,  Indrapur,159,208,74,106,85,102,43.3,41.1,45.5,00000
55.0,66.0,63.0,425,02,01,  Ranajitpur,314,241,165,111,149,130,56.6,59.8,53.4,00000
55.0,66.0,63.0,675,01,01,  Mobarakpur,653,1082,343,551,310,531,37.6,38.4,36.9,00000
55.0,66.0,63.0,675,02,01,  Bharisa,164,111,88,53,76,58,59.6,62.4,56.7,00000
55.0,66.0,63.0,675,03,01,  Nabanagar,184,201,107,84,77,117,47.8,56.0,39.7,00000
55.0,66.0,63.0,717,01,01,  Nahata,1420,1222,702,592,718,630,53.7,54.3,53.3,00000
55.0,66.0,63.0,717,02,01,  Panighata,1796,1958,823,969,973,989,47.8,45.9,49.6,00000
55.0,66.0,63.0,736,01,01,  Narandia,735,745,353,379,382,366,49.7,48.2,51.1,00000
55.0,66.0,63.0,736,02,01,  Bejora,668,950,322,475,346,475,41.3,40.4,42.1,00000
55.0,66.0,63.0,919,01,01,  Saldha,283,273,156,116,127,157,50.9,57.4,44.7,00000
55.0,66.0,63.0,919,02,01,  Hariakhali,80,72,38,37,42,35,52.6,50.7,54.5,00000
55.0,66.0,63.0,919,03,01,  Ramdebpur,445,309,219,150,226,159,59.0,59.3,58.7,00000
55.0,66.0,73.0,083,01,01,  Banagram,192,160,101,66,91,94,54.5,60.5,49.2,00000
55.0,66.0,73.0,083,02,01,  Runagar,1088,1106,538,501,550,605,49.6,51.8,47.6,00000
55.0,66.0,73.0,083,03,01,  Jalsuka,86,67,55,27,31,40,56.2,67.1,43.7,00000
55.0,66.0,73.0,083,04,01,  Mahimanagar,152,101,80,43,72,58,60.1,65.0,55.4,00000
55.0,66.0,73.0,083,05,01,  Kalisonkerpur,624,1092,288,542,336,550,36.4,34.7,37.9,00000
55.0,66.0,73.0,144,01,01,  Bhabanipur,310,240,156,117,154,123,56.4,57.1,55.6,00000
55.0,66.0,73.0,144,02,01,  Bilbila,70,64,32,32,38,32,52.2,50.0,54.3,00000
55.0,66.0,73.0,440,01,01,  Jasumantapur,741,1011,351,443,390,568,42.3,44.2,40.7,00000
55.0,66.0,73.0,440,02,01,  Char Jasumantapur,300,338,149,154,151,184,47.0,49.2,45.1,00000
55.0,66.0,73.0,638,01,01,  Mandalgati,1070,1055,505,441,565,614,50.4,53.4,47.9,00000
55.0,66.0,73.0,638,02,01,  Danga Para,319,345,151,162,168,183,48.0,48.2,47.9,00000
55.0,66.0,73.0,881,01,01,  Rampur,341,196,180,87,161,109,63.5,67.4,59.6,00000
55.0,66.0,73.0,881,02,01,  Char Rampur,41,18,21,7,20,11,69.5,75.0,64.5,00000
55.0,66.0,84.0,865,01,01,  Rajapur,695,735,347,354,348,381,48.6,49.5,47.7,00000
55.0,66.0,84.0,865,02,01,  Nityanandapur,454,443,236,187,218,256,50.6,55.8,46.0,00000
55.0,85.0,11.0,278,01,01,  Dari Salai,807,761,428,338,379,423,51.5,55.9,47.3,00000
55.0,85.0,11.0,278,02,01,  Phulbari,144,270,67,136,77,134,34.8,33.0,36.5,00000
55.0,85.0,23.0,179,01,01,  Bunagati,1021,901,530,426,491,475,53.1,55.4,50.8,00000
55.0,85.0,23.0,179,02,01,  Bakalbaria,390,498,220,214,170,284,43.9,50.7,37.4,00000
55.0,85.0,23.0,606,01,01,  Nalia,321,449,173,210,148,239,41.7,45.2,38.2,00000
55.0,85.0,23.0,606,02,01,  Kuatpur,327,371,198,154,129,217,46.8,56.3,37.3,00000
55.0,85.0,35.0,338,01,01,  Dhaneshwargati,1140,1548,660,676,480,872,42.4,49.4,35.5,00000
55.0,85.0,35.0,338,02,01,  Maniknagar,33,60,20,25,13,35,35.5,44.4,27.1,00000
55.0,85.0,35.0,587,01,01,  Kotbag,287,564,138,283,149,281,33.7,32.8,34.7,00000
55.0,85.0,35.0,587,02,01,  Bagura Para,202,258,100,122,102,136,43.9,45.0,42.9,00000
55.0,85.0,35.0,587,03,01,  Baje Masakhali,166,179,80,87,86,92,48.1,47.9,48.3,00000
55.0,85.0,35.0,656,01,01,  Masakhali,306,323,151,158,155,165,48.6,48.9,48.4,00000
55.0,85.0,35.0,656,02,01,  Sreephaltala,146,250,74,122,72,128,36.9,37.8,36.0,00000
55.0,85.0,35.0,965,01,01,  Thai Para,706,772,400,341,306,431,47.8,54.0,41.5,00000
55.0,85.0,35.0,965,02,01,  Nurpur,76,84,43,36,33,48,47.5,54.4,40.7,00000
55.0,85.0,59.0,865,01,01,  Uttar Sarusona,821,1107,432,524,389,583,42.6,45.2,40.0,00000
55.0,85.0,59.0,865,02,01,  Dakshin Sarusona,1894,1940,967,944,927,996,49.4,50.6,48.2,00000
55.0,85.0,83.0,169,01,01,  Hachimpur,109,135,60,58,49,77,44.7,50.8,38.9,00000
55.0,85.0,83.0,169,02,01,  Bhulbaria,255,229,139,92,116,137,52.7,60.2,45.8,00000
55.0,85.0,83.0,208,01,01,  Uttar Chandra,1064,1350,513,626,551,724,44.1,45.0,43.2,00000
55.0,85.0,83.0,208,02,01,  Dakshin Chandra,662,889,333,428,329,461,42.7,43.8,41.6,00000
55.0,85.0,83.0,666,01,01,  Chiladanga,129,311,66,139,63,172,29.3,32.2,26.8,00000
55.0,85.0,83.0,666,02,01,  Sonadanga,325,171,190,57,135,114,65.5,76.9,54.2,00000
55.0,85.0,83.0,666,03,01,  Naghosa,1044,1780,547,863,497,917,37.0,38.8,35.1,00000
55.0,85.0,83.0,835,01,01,  Uttar Sablat,561,464,311,212,250,252,54.7,59.5,49.8,00000
55.0,85.0,83.0,835,02,01,  Dakshin Sablat,668,753,330,353,338,400,47.0,48.3,45.8,00000
55.0,85.0,83.0,875,01,01,  Bahermallick,414,390,239,154,175,236,51.5,60.8,42.6,00000
55.0,85.0,83.0,875,02,01,  Bhanada,113,109,66,48,47,61,50.9,57.9,43.5,00000
55.0,85.0,83.0,895,01,01,  Satnafuria,272,579,145,270,127,309,32.0,34.9,29.1,00000
55.0,85.0,83.0,895,02,01,  Ghoramara,122,150,69,68,53,82,44.9,50.4,39.3,00000
55.0,85.0,83.0,955,01,01,  Talkhari,1062,845,616,379,446,466,55.7,61.9,48.9,00000
55.0,85.0,83.0,955,02,01,  Shibdaspur,32,37,20,13,12,24,46.4,60.6,33.3,00000
55.0,95.0,10.0,011,01,01,  Bil Sonai,172,113,88,48,84,65,60.4,64.7,56.4,00000
55.0,95.0,10.0,011,02,01,  Char Para,248,571,123,277,125,294,30.3,30.8,29.8,00000
55.0,95.0,10.0,011,03,01,  Kachubaria,432,855,183,443,249,412,33.6,29.2,37.7,00000
55.0,95.0,10.0,011,04,01,  Amalsar,1168,1692,588,779,580,913,40.8,43.0,38.8,00000
55.0,95.0,10.0,011,05,01,  Madia Para,191,389,103,176,88,213,32.9,36.9,29.2,00000
55.0,95.0,10.0,011,06,01,  Amalsar Kodla,591,858,306,418,285,440,40.8,42.3,39.3,00000
55.0,95.0,10.0,011,07,01,  Char Islampur,66,167,30,87,36,80,28.3,25.6,31.0,00000
55.0,95.0,10.0,011,08,01,  Charia Para,147,137,83,62,64,75,51.8,57.2,46.0,00000
55.0,95.0,10.0,011,09,01,  Daria Para,123,103,70,49,53,54,54.4,58.8,49.5,00000
55.0,95.0,10.0,011,10,01,  Andharkota,71,93,41,39,30,54,43.3,51.3,35.7,00000
55.0,95.0,10.0,047,01,01,  Badanpur,270,397,138,192,132,205,40.5,41.8,39.2,00000
55.0,95.0,10.0,047,02,01,  Sundarpur,165,135,99,60,66,75,55.0,62.3,46.8,00000
55.0,95.0,10.0,263,01,01,  Chota Udas,224,312,108,145,116,167,41.8,42.7,41.0,00000
55.0,95.0,10.0,263,02,01,  Char Udas,329,526,161,264,168,262,38.5,37.9,39.1,00000
55.0,95.0,10.0,503,01,01,  Karandi,583,592,314,265,269,327,49.6,54.2,45.1,00000
55.0,95.0,10.0,503,02,01,  Karandi Baliaghata,203,315,109,145,94,170,39.2,42.9,35.6,00000
55.0,95.0,10.0,503,03,01,  Karandi Kodla,169,246,86,121,83,125,40.7,41.5,39.9,00000
55.0,95.0,10.0,695,01,01,  Tikar Bila,165,244,83,111,82,133,40.3,42.8,38.1,00000
55.0,95.0,10.0,695,02,01,  Aruadangi,86,168,46,77,40,91,33.9,37.4,30.5,00000
55.0,95.0,10.0,695,03,01,  Paschim Rajapur Baliaghat,118,223,61,102,57,121,34.6,37.4,32.0,00000
55.0,95.0,10.0,695,04,01,  Paschim Rajapur,1003,1153,515,558,488,595,46.5,48.0,45.1,00000
55.0,95.0,10.0,731,01,01,  Purba Rajapur,216,528,109,251,107,277,29.0,30.3,27.9,00000
55.0,95.0,10.0,731,02,01,  Durgapur,224,431,101,212,123,219,34.2,32.3,36.0,00000
55.0,95.0,10.0,767,01,01,  Rakshakandi,171,185,92,78,79,107,48.0,54.1,42.5,00000
55.0,95.0,10.0,767,02,01,  Indur Baria,41,90,19,43,22,47,31.3,30.6,31.9,00000
55.0,95.0,10.0,779,01,01,  Ramchandrapur,154,196,78,92,76,104,44.0,45.9,42.2,00000
55.0,95.0,10.0,779,02,01,  Char Ramchandrapur,117,168,61,87,56,81,41.1,41.2,40.9,00000
55.0,95.0,10.0,779,03,01,  Ramchandrapur Kodla,178,275,105,127,73,148,39.3,45.3,33.0,00000
55.0,95.0,21.0,239,01,01,  Chaugachhi,1300,1073,655,480,645,593,54.8,57.7,52.1,00000
55.0,95.0,21.0,239,02,01,  Char Chaugachhi,587,701,312,321,275,380,45.6,49.3,42.0,00000
55.0,95.0,21.0,239,03,01,  Durgapur,282,129,151,55,131,74,68.6,73.3,63.9,00000
55.0,95.0,21.0,239,04,01,  Anandanagar,207,179,106,79,101,100,53.6,57.3,50.2,00000
55.0,95.0,21.0,275,01,01,  Dariapur,1493,1070,720,487,773,583,58.3,59.7,57.0,00000
55.0,95.0,21.0,275,02,01,  Nalkhola,179,150,91,61,88,89,54.4,59.9,49.7,00000
55.0,95.0,21.0,275,03,01,  Malainagar,193,228,108,102,85,126,45.8,51.4,40.3,00000
55.0,95.0,21.0,275,04,01,  Char Malainagar,126,76,72,27,54,49,62.4,72.7,52.4,00000
55.0,95.0,21.0,275,05,01,  Gangaramkhali,175,345,90,175,85,170,33.7,34.0,33.3,00000
55.0,95.0,21.0,275,06,01,  Baraichara,773,422,349,195,424,227,64.7,64.2,65.1,00000
55.0,95.0,21.0,275,07,01,  Ticketinagar,35,49,19,22,16,27,41.7,46.3,37.2,00000
55.0,95.0,21.0,575,01,01,  Mahishpur,821,903,421,457,400,446,47.6,47.9,47.3,00000
55.0,95.0,21.0,575,02,01,  Goaldaha,390,294,214,113,176,181,57.0,65.4,49.3,00000
55.0,95.0,21.0,575,03,01,  Char Goaldaha,353,238,177,98,176,140,59.7,64.4,55.7,00000
55.0,95.0,21.0,575,04,01,  Shanbadha,65,91,33,44,32,47,41.7,42.9,40.5,00000
55.0,95.0,21.0,575,05,01,  Parpatara,60,188,25,104,35,84,24.2,19.4,29.4,00000
55.0,95.0,31.0,119,01,01,  Baraudas,162,201,89,98,73,103,44.6,47.6,41.5,00000
55.0,95.0,31.0,119,02,01,  Sordar Kalinagar,227,227,132,107,95,120,50.0,55.2,44.2,00000
55.0,95.0,31.0,143,01,01,  Bartala,316,316,162,140,154,176,50.0,53.6,46.7,00000
55.0,95.0,31.0,143,02,01,  Gayeshpur,228,429,126,202,102,227,34.7,38.4,31.0,00000
55.0,95.0,31.0,143,03,01,  Chabinagar,399,655,197,324,202,331,37.9,37.8,37.9,00000
55.0,95.0,31.0,191,01,01,  Chakdaha,455,703,266,332,189,371,39.3,44.5,33.8,00000
55.0,95.0,31.0,191,02,01,  Char Chakdaha,238,439,135,214,103,225,35.2,38.7,31.4,00000
55.0,95.0,31.0,227,01,01,  Chaturia,425,759,232,344,193,415,35.9,40.3,31.7,00000
55.0,95.0,31.0,227,02,01,  Chandikhali,1039,841,541,371,498,470,55.3,59.3,51.4,00000
55.0,95.0,31.0,227,03,01,  Chabinagar,277,238,133,115,144,123,53.8,53.6,53.9,00000
55.0,95.0,31.0,227,04,01,  Tetulbaria,59,74,39,29,20,45,44.4,57.4,30.8,00000
55.0,95.0,31.0,227,05,01,  Par Kalinagar,37,37,16,19,21,18,50.0,45.7,53.8,00000
55.0,95.0,31.0,227,06,01,  Goalbari,121,109,80,49,41,60,52.6,62.0,40.6,00000
55.0,95.0,31.0,419,01,01,  Joka,482,305,240,136,242,169,61.2,63.8,58.9,00000
55.0,95.0,31.0,419,02,01,  Char Joka,323,440,154,228,169,212,42.3,40.3,44.4,00000
55.0,95.0,31.0,419,03,01,  Lat Ramnagar,132,99,78,40,54,59,57.1,66.1,47.8,00000
55.0,95.0,31.0,419,04,01,  Nagar Joka,252,326,131,165,121,161,43.6,44.3,42.9,00000
55.0,95.0,31.0,827,01,01,  Sabhasatdanga,121,246,66,119,55,127,33.0,35.7,30.2,00000
55.0,95.0,31.0,827,02,01,  Baghbaria,117,228,58,109,59,119,33.9,34.7,33.1,00000
55.0,95.0,42.0,311,01,01,  Ghasiara,2085,1874,1058,885,1027,989,52.7,54.5,50.9,00000
55.0,95.0,42.0,311,02,01,  Kamalapur,978,429,491,191,487,238,69.5,72.0,67.2,00000
55.0,95.0,42.0,311,03,01,  Doran Nagar,475,298,253,122,222,176,61.4,67.5,55.8,00000
55.0,95.0,42.0,311,04,01,  Goalbari,142,145,74,69,68,76,49.5,51.7,47.2,00000
55.0,95.0,42.0,311,05,01,  Matikata,92,108,49,45,43,63,46.0,52.1,40.6,00000
55.0,95.0,42.0,455,01,01,  Kadir Para,1073,1455,527,695,546,760,42.4,43.1,41.8,00000
55.0,95.0,42.0,455,02,01,  Radhanagar,947,432,487,201,460,231,68.7,70.8,66.6,00000
55.0,95.0,42.0,539,01,01,  Kapuria,486,611,271,294,215,317,44.3,48.0,40.4,00000
55.0,95.0,42.0,539,02,01,  Tiketinagar,40,59,25,27,15,32,40.4,48.1,31.9,00000
55.0,95.0,42.0,539,03,01,  Mangamdanga,455,583,231,309,224,274,43.8,42.8,45.0,00000
55.0,95.0,52.0,107,01,01,  Baralidaha,2194,1597,1147,763,1047,834,57.9,60.1,55.7,00000
55.0,95.0,52.0,107,02,01,  Debinagar,189,335,111,158,78,177,36.1,41.3,30.6,00000
55.0,95.0,52.0,107,03,01,  Batiakhali,391,217,231,88,160,129,64.3,72.4,55.4,00000
55.0,95.0,52.0,107,04,01,  Goalbari,68,185,36,88,32,97,26.9,29.0,24.8,00000
55.0,95.0,52.0,947,01,01,  Huda Sreepur,136,65,74,27,62,38,67.7,73.3,62.0,00000
55.0,95.0,52.0,947,02,01,  Hajiratala,278,260,158,119,120,141,51.7,57.0,46.0,00000
55.0,95.0,52.0,947,03,01,  Madhupur,175,234,97,110,78,124,42.8,46.9,38.6,00000
55.0,95.0,63.0,407,01,01,  Makardamkhola,215,178,101,78,114,100,54.7,56.4,53.3,00000
55.0,95.0,63.0,407,02,01,  Joynagar,165,172,92,75,73,97,49.0,55.1,42.9,00000
55.0,95.0,63.0,407,03,01,  Aralia,20,25,13,11,7,14,44.4,54.2,33.3,00000
55.0,95.0,63.0,815,01,01,  Sabdalpur,412,438,202,207,210,231,48.5,49.4,47.6,00000
55.0,95.0,63.0,815,02,01,  Durgapur,151,164,74,85,77,79,47.9,46.5,49.4,00000
55.0,95.0,63.0,815,03,01,  Mollahdanga,119,256,77,115,42,141,31.7,40.1,23.0,00000
55.0,95.0,63.0,887,01,01,  Sonaikundi,471,673,264,320,207,353,41.2,45.2,37.0,00000
55.0,95.0,63.0,887,02,01,  Durgapur,45,54,24,28,21,26,45.5,46.2,44.7,00000
55.0,95.0,63.0,971,01,01,  Taraujial,1641,510,808,210,833,300,76.3,79.4,73.5,00000
55.0,95.0,63.0,971,02,01,  Sonaitundi,1057,414,492,179,565,235,71.9,73.3,70.6,00000
55.0,95.0,73.0,515,01,01,  Khalia,339,296,189,123,150,173,53.4,60.6,46.4,00000
55.0,95.0,73.0,515,02,01,  Kharichal,176,326,103,156,73,170,35.1,39.8,30.0,00000
55.0,95.0,73.0,743,01,01,  Khamar Para,1996,747,1004,312,992,435,72.8,76.3,69.5,00000
55.0,95.0,73.0,743,02,01,  Purba Sreekul,530,594,280,287,250,307,47.2,49.4,44.9,00000
55.0,95.0,73.0,911,01,01,  Sreekul,1123,1238,558,599,565,639,47.6,48.2,46.9,00000
55.0,95.0,73.0,911,02,01,  Radhakantapur,176,59,94,23,82,36,74.9,80.3,69.5,00000
55.0,95.0,73.0,911,03,01,  Daribila,390,349,207,167,183,182,52.8,55.3,50.1,00000
55.0,95.0,73.0,911,04,01,  Dairpol,551,692,257,333,294,359,44.3,43.6,45.0,00000
55.0,95.0,84.0,323,01,01,  Goal Para,550,571,262,261,288,310,49.1,50.1,48.2,00000
55.0,95.0,84.0,323,02,01,  Char Goal Para,426,375,234,164,192,211,53.2,58.8,47.6,00000
55.0,95.0,84.0,323,03,01,  Saheb Para,271,244,146,116,125,128,52.6,55.7,49.4,00000
55.0,95.0,84.0,323,04,01,  Kharibari,329,361,173,160,156,201,47.7,52.0,43.7,00000
55.0,95.0,84.0,347,01,01,  Harindi,289,208,148,90,141,118,58.1,62.2,54.4,00000
55.0,95.0,84.0,347,02,01,  Char Harindi,66,101,40,49,26,52,39.5,44.9,33.3,00000
55.0,95.0,84.0,359,01,01,  Hogaldanga,816,706,419,340,397,366,53.6,55.2,52.0,00000
55.0,95.0,84.0,359,02,01,  Chilgari,157,361,89,179,68,182,30.3,33.2,27.2,00000
55.0,95.0,84.0,359,03,01,  Baliaghata,200,249,112,114,88,135,44.5,49.6,39.5,00000
55.0,95.0,84.0,359,04,01,  Natun Para,123,41,65,10,58,31,75.0,86.7,65.2,00000
55.0,95.0,84.0,359,05,01,  Kalinagar,118,60,66,24,52,36,66.3,73.3,59.1,00000
55.0,95.0,84.0,359,06,01,  Kharibari,245,200,118,88,127,112,55.1,57.3,53.1,00000
55.0,95.0,84.0,443,01,01,  Kachua,341,467,164,215,177,252,42.2,43.3,41.3,00000
55.0,95.0,84.0,443,02,01,  Machavanga,72,85,37,41,35,44,45.9,47.4,44.3,00000
55.0,95.0,84.0,443,03,01,  Ashcharjyapur,61,49,30,27,31,22,55.5,52.6,58.5,00000
55.0,95.0,84.0,491,01,01,  Kalyanpur,246,231,131,110,115,121,51.6,54.4,48.7,00000
55.0,95.0,84.0,491,02,01,  Malda,157,170,82,76,75,94,48.0,51.9,44.4,00000
55.0,95.0,84.0,491,03,01,  Hossenpur,28,33,13,13,15,20,45.9,50.0,42.9,00000
55.0,95.0,84.0,635,01,01,  Mujdia,229,252,121,111,108,141,47.6,52.2,43.4,00000
55.0,95.0,84.0,635,02,01,  Kagaje Para,59,46,37,21,22,25,56.2,63.8,46.8,00000
55.0,95.0,84.0,923,01,03,  Sreepur,1806,775,924,329,882,446,70.0,73.7,66.4,00000
55.0,95.0,84.0,923,02,03,  Char Sreepur,214,228,113,109,101,119,48.4,50.9,45.9,00000
55.0,95.0,84.0,959,01,01,  Takhalpur,1094,658,536,293,558,365,62.4,64.7,60.5,00000
55.0,95.0,84.0,959,02,01,  Mahisakhola,78,136,40,63,38,73,36.4,38.8,34.2,00000
50.0,15.0,13.0,071,01,01,  Gosai Para,528,619,270,299,258,320,46.0,47.5,44.6,00000
50.0,15.0,13.0,071,02,01,  Mali Para,623,459,336,222,287,237,57.6,60.2,54.8,00000
50.0,15.0,13.0,071,03,01,  Bansher Diar,426,518,217,248,209,270,45.1,46.7,43.6,00000
50.0,15.0,13.0,071,04,01,  Kazi Para,345,510,177,239,168,271,40.4,42.5,38.3,00000
50.0,15.0,13.0,521,01,01,  Bahadurpur,855,1244,433,598,422,646,40.7,42.0,39.5,00000
50.0,15.0,13.0,521,02,01,  Kaigari Para,494,695,246,321,248,374,41.5,43.4,39.9,00000
50.0,15.0,13.0,521,03,01,  Muslempur,561,529,272,257,289,272,51.5,51.4,51.5,00000
50.0,15.0,13.0,521,04,01,  Jamalpur (Kangali Para),471,644,221,337,250,307,42.2,39.6,44.9,00000
50.0,15.0,13.0,521,05,01,  Kuchiamora,1081,1201,549,557,532,644,47.4,49.6,45.2,00000
50.0,15.0,27.0,213,01,03,  Chak Bheramara (Part),220,281,103,130,117,151,43.9,44.2,43.7,00000
50.0,15.0,27.0,213,02,03,  Paschim Damukdia (Part),290,215,144,101,146,114,57.4,58.8,56.2,00000
50.0,15.0,27.0,355,01,03,  Char Damukdia,528,335,262,148,266,187,61.2,63.9,58.7,00000
50.0,15.0,27.0,355,02,03,  Purba Damukdia,957,676,452,337,505,339,58.6,57.3,59.8,00000
50.0,15.0,27.0,355,03,03,  Paschim Damukdia (Part),246,218,102,117,144,101,53.0,46.6,58.8,00000
50.0,15.0,27.0,902,01,01,  Powar House Colony,295,193,158,93,137,100,60.5,62.9,57.8,00000
50.0,15.0,27.0,902,02,01,  12 Dag,742,467,358,237,384,230,61.4,60.2,62.5,00000
50.0,15.0,27.0,902,03,01,  68 Para,459,169,200,79,259,90,73.1,71.7,74.2,00000
50.0,15.0,27.0,902,04,01,  Moslempur,1209,2098,608,1071,601,1027,36.6,36.2,36.9,00000
50.0,15.0,27.0,902,05,01,  16 Dag Munshi Para,561,422,271,198,290,224,57.1,57.8,56.4,00000
50.0,15.0,27.0,902,06,01,  16 Dag Dakshinpara,1557,950,718,444,839,506,62.1,61.8,62.4,00000
50.0,15.0,27.0,902,07,01,  16 Dag Uttar Para,1596,765,787,355,809,410,67.6,68.9,66.4,00000
50.0,15.0,27.0,902,08,01,  Paschim Bahir Char,1862,3025,879,1621,983,1404,38.1,35.2,41.2,00000
50.0,15.0,54.0,379,01,01,  Dharampur,1158,1151,594,578,564,573,50.2,50.7,49.6,00000
50.0,15.0,54.0,379,02,01,  Ramchandapur,1223,1108,586,536,637,572,52.5,52.2,52.7,00000
50.0,15.0,54.0,379,03,01,  Bil Bhabanipur,602,432,285,205,317,227,58.2,58.2,58.3,00000
50.0,15.0,54.0,379,04,01,  Uttar Bhabanipur,2029,2780,985,1446,1044,1334,42.2,40.5,43.9,00000
50.0,15.0,54.0,379,05,01,  Dakshin Bhabanipur,1693,2414,780,1238,913,1176,41.2,38.7,43.7,00000
50.0,15.0,54.0,923,01,01,  Patuakandi,958,1113,491,554,467,559,46.3,47.0,45.5,00000
50.0,15.0,54.0,923,02,01,  Mahishdhara,606,560,314,291,292,269,52.0,51.9,52.0,00000
50.0,15.0,54.0,923,03,01,  Saruper Ghop,583,661,293,330,290,331,46.9,47.0,46.7,00000
50.0,15.0,67.0,426,01,01,  Daulatpur,692,1211,317,618,375,593,36.4,33.9,38.7,00000
50.0,15.0,67.0,426,02,01,  Bokterpur,229,361,106,191,123,170,38.8,35.7,42.0,00000
50.0,15.0,67.0,615,01,01,  Mowla Habashpur,1017,883,477,439,540,444,53.5,52.1,54.9,00000
50.0,15.0,67.0,615,02,01,  Jhikri Parankhali,1384,2374,685,1213,699,1161,36.8,36.1,37.6,00000
50.0,15.0,67.0,829,01,01,  Nalua,534,1037,259,504,275,533,34.0,33.9,34.0,00000
50.0,15.0,67.0,829,02,01,  Ranapia,411,554,200,261,211,293,42.6,43.4,41.9,00000
50.0,15.0,67.0,829,03,01,  Hossainpur,290,387,129,193,161,194,42.8,40.1,45.4,00000
50.0,15.0,81.0,284,01,01,  Char Golapnagar,306,654,140,313,166,341,31.9,30.9,32.7,00000
50.0,15.0,81.0,284,02,01,  Solemania,112,342,56,168,56,174,24.7,25.0,24.3,00000
50.0,15.0,81.0,284,03,01,  Dhakapara,247,780,141,391,106,389,24.1,26.5,21.4,00000
50.0,15.0,81.0,521,01,01,  Golapnagar,1807,2400,869,1189,938,1211,43.0,42.2,43.6,00000
50.0,15.0,81.0,521,02,01,  Madhya Golapnagar,1231,1083,594,499,637,584,53.2,54.3,52.2,00000
50.0,15.0,81.0,521,03,01,  Islampur,1068,1415,544,673,524,742,43.0,44.7,41.4,00000
50.0,15.0,81.0,521,04,01,  Maharajpur,1066,967,492,447,574,520,52.4,52.4,52.5,00000
50.0,15.0,81.0,781,01,01,  Gopinathpur,713,1289,346,593,367,696,35.6,36.8,34.5,00000
50.0,15.0,81.0,781,02,01,  Ramkrishnapur,1169,1375,549,688,620,687,46.0,44.4,47.4,00000
50.0,15.0,81.0,781,03,01,  Khemir Diar,2463,3114,1195,1532,1268,1582,44.2,43.8,44.5,00000
50.0,15.0,81.0,781,04,01,  Nowda Khemir Diar,1209,1120,613,543,596,577,51.9,53.0,50.8,00000
50.0,39.0,11.0,301,01,01,  Garura Darer Para,1207,1508,608,713,599,795,44.5,46.0,43.0,00000
50.0,39.0,11.0,301,02,01,  Dakshin Garura,1660,2574,863,1202,797,1372,39.2,41.8,36.7,00000
50.0,39.0,13.0,090,01,01,  Bara Ganjdia,1318,1217,735,577,583,640,52.0,56.0,47.7,00000
50.0,39.0,13.0,090,02,01,  Rowshanpur,137,96,72,43,65,53,58.8,62.6,55.1,00000
50.0,39.0,13.0,283,01,01,  Chhatar Para,1115,1363,573,650,542,713,45.0,46.9,43.2,00000
50.0,39.0,13.0,283,02,01,  Hridaypur,429,552,228,253,201,299,43.7,47.4,40.2,00000
50.0,39.0,13.0,470,01,01,  Kalidaspur,794,883,421,422,373,461,47.3,49.9,44.7,00000
50.0,39.0,13.0,470,02,01,  Senpara,170,311,86,150,84,161,35.3,36.4,34.3,00000
50.0,39.0,13.0,693,01,01,  Omarpur,413,371,225,169,188,202,52.7,57.1,48.2,00000
50.0,39.0,13.0,693,02,01,  Ghoramara,730,1115,379,554,351,561,39.6,40.6,38.5,00000
50.0,39.0,13.0,904,01,01,  Pakkala,172,302,100,151,72,151,36.3,39.8,32.3,00000
50.0,39.0,13.0,904,02,01,  Talbaria,942,1545,464,805,478,740,37.9,36.6,39.2,00000
50.0,39.0,13.0,904,03,01,  Lakshmipur,543,567,268,279,275,288,48.9,49.0,48.8,00000
50.0,39.0,20.0,138,01,01,  Boalia,1719,3443,874,1731,845,1712,33.3,33.6,33.0,00000
50.0,39.0,20.0,138,02,01,  Dayer Para,203,357,102,186,101,171,36.3,35.4,37.1,00000
50.0,39.0,20.0,138,03,01,  Kishornagar,81,137,48,72,33,65,37.2,40.0,33.7,00000
50.0,39.0,20.0,862,01,01,  Sehala,1719,3246,870,1592,849,1654,34.6,35.3,33.9,00000
50.0,39.0,20.0,862,02,01,  Natna Para,640,652,331,312,309,340,49.5,51.5,47.6,00000
50.0,39.0,20.0,862,03,01,  Kishorinagar,538,556,281,255,257,301,49.2,52.4,46.1,00000
50.0,39.0,27.0,066,01,01,  Bajumara,159,259,84,118,75,141,38.0,41.6,34.7,00000
50.0,39.0,27.0,066,02,01,  Purba Bajumara,163,306,91,157,72,149,34.8,36.7,32.6,00000
50.0,39.0,27.0,066,03,01,  Jotasai,151,277,77,133,74,144,35.3,36.7,33.9,00000
50.0,39.0,27.0,205,01,01,  Purba Bhabananda Diar,76,231,47,115,29,116,24.8,29.0,20.0,00000
50.0,39.0,27.0,205,02,01,  Paschim Bhabananda Diar,298,761,161,357,137,404,28.1,31.1,25.3,00000
50.0,39.0,27.0,205,03,01,  Purba Char Ramkrishnapur,225,569,125,296,100,273,28.3,29.7,26.8,00000
50.0,39.0,27.0,205,04,01,  Paschim Char Ramkrishnapur,251,447,138,209,113,238,36.0,39.8,32.2,00000
50.0,39.0,27.0,777,01,01,  Purba Amdanighat,548,877,297,411,251,466,38.5,41.9,35.0,00000
50.0,39.0,27.0,777,02,01,  Paschim Amdanighat,626,1366,347,641,279,725,31.4,35.1,27.8,00000
50.0,39.0,27.0,777,03,01,  Char Sarkar Para,116,389,67,182,49,207,23.0,26.9,19.1,00000
50.0,39.0,27.0,952,01,01,  Uttar Udaynagar,79,310,38,140,41,170,20.3,21.3,19.4,00000
50.0,39.0,27.0,952,02,01,  Paschim Udaynagar,443,590,236,278,207,312,42.9,45.9,39.9,00000
50.0,39.0,27.0,952,03,01,  Madhya Udaynagar,275,957,172,440,103,517,22.3,28.1,16.6,00000
50.0,39.0,27.0,952,04,01,  Digreer Char,136,370,79,168,57,202,26.9,32.0,22.0,00000
50.0,39.0,27.0,952,05,01,  Dakshin Khariza Thak,437,1088,243,523,194,565,28.7,31.7,25.6,00000
50.0,39.0,27.0,952,06,01,  Uttar Khariza Thak,382,927,213,441,169,486,29.2,32.6,25.8,00000
50.0,39.0,33.0,060,01,01,  Bajudanga,277,373,158,196,119,177,42.6,44.6,40.2,00000
50.0,39.0,33.0,060,02,01,  Chak Krisnapur,207,419,103,213,104,206,33.1,32.6,33.5,00000
50.0,39.0,33.0,308,01,01,  Daulatpur(Part Of Daulatpur),803,471,408,220,395,251,63.0,65.0,61.1,00000
50.0,39.0,33.0,308,02,01,  Gopinatpur,458,151,263,74,195,77,75.2,78.0,71.7,00000
50.0,39.0,33.0,337,01,03,  Chuamalik Para,523,870,274,421,249,449,37.5,39.4,35.7,00000
50.0,39.0,33.0,337,02,03,  Chak Daulatpur,747,986,392,478,355,508,43.1,45.1,41.1,00000
50.0,39.0,33.0,337,03,03,  Daulatpur,2085,1396,1067,605,1018,791,59.9,63.8,56.3,00000
50.0,39.0,40.0,096,01,01,  Begunbaria,383,651,219,288,164,363,37.0,43.2,31.1,00000
50.0,39.0,40.0,096,02,01,  Taragunia (Part),940,455,489,207,451,248,67.4,70.3,64.5,00000
50.0,39.0,40.0,096,03,01,  Shashidharpur (Part),347,542,179,267,168,275,39.0,40.1,37.9,00000
50.0,39.0,40.0,217,01,01,  Kayamari,543,650,276,312,267,338,45.5,46.9,44.1,00000
50.0,39.0,40.0,217,02,01,  Farakpur,411,612,196,305,215,307,40.2,39.1,41.2,00000
50.0,39.0,40.0,217,03,01,  Gangarampur,919,1017,473,500,446,517,47.5,48.6,46.3,00000
50.0,39.0,40.0,217,04,01,  Char Diar,1004,1496,526,739,478,757,40.2,41.6,38.7,00000
50.0,39.0,40.0,223,01,01,  Sonaikundi,2463,2219,1394,1066,1069,1153,52.6,56.7,48.1,00000
50.0,39.0,40.0,223,02,01,  Gacher Diar,2288,3236,1150,1537,1138,1699,41.4,42.8,40.1,00000
50.0,39.0,40.0,253,01,01,  Char Diar (Part),488,463,257,221,231,242,51.3,53.8,48.8,00000
50.0,39.0,40.0,253,02,01,  Baidyanathtala,563,554,289,258,274,296,50.4,52.8,48.1,00000
50.0,39.0,40.0,434,01,01,  Paschim Taragunia,1502,1318,794,661,708,657,53.3,54.6,51.9,00000
50.0,39.0,40.0,434,02,01,  Purba Taragunia,432,146,222,66,210,80,74.7,77.1,72.4,00000
50.0,39.0,40.0,808,01,01,  Sadipur,806,964,407,466,399,498,45.5,46.6,44.5,00000
50.0,39.0,40.0,808,02,01,  Manikdiar,284,247,136,114,148,133,53.5,54.4,52.7,00000
50.0,39.0,47.0,024,01,01,  Angdia,434,807,237,401,197,406,35.0,37.1,32.7,00000
50.0,39.0,47.0,024,02,01,  Gachher Diar,315,438,168,218,147,220,41.8,43.5,40.1,00000
50.0,39.0,47.0,024,03,01,  Char Para,361,572,190,297,171,275,38.7,39.0,38.3,00000
50.0,39.0,47.0,627,01,01,  Mali Para,461,417,252,193,209,224,52.5,56.6,48.3,00000
50.0,39.0,47.0,627,02,01,  Udaynagar,101,307,54,152,47,155,24.8,26.2,23.3,00000
50.0,39.0,47.0,669,01,01,  Nazirpur,994,910,520,438,474,472,52.2,54.3,50.1,00000
50.0,39.0,47.0,669,02,01,  Abdulpur,259,184,124,81,135,103,58.5,60.5,56.7,00000
50.0,39.0,47.0,741,01,01,  Pipulbaria,504,676,248,329,256,347,42.7,43.0,42.5,00000
50.0,39.0,47.0,741,02,01,  Shyamnagar,263,323,166,154,97,169,44.9,51.9,36.5,00000
50.0,39.0,47.0,892,01,01,  Shyampur,600,1281,318,619,282,662,31.9,33.9,29.9,00000
50.0,39.0,47.0,892,02,01,  Mobaria,457,363,236,175,221,188,55.7,57.4,54.0,00000
50.0,39.0,54.0,542,01,01,  Koldiar,435,802,201,399,234,403,35.2,33.5,36.7,00000
50.0,39.0,54.0,542,02,01,  Purba Koldiar,289,888,158,436,131,452,24.6,26.6,22.5,00000
50.0,39.0,54.0,542,03,01,  Bharaka Para(Part-1),406,777,176,390,230,387,34.3,31.1,37.3,00000
50.0,39.0,54.0,542,04,01,  Hatkhola,630,959,313,458,317,501,39.6,40.6,38.8,00000
50.0,39.0,54.0,621,01,01,  Paschim Majhdiar,428,630,201,298,227,332,40.5,40.3,40.6,00000
50.0,39.0,54.0,621,02,01,  Madhya Majhdiar,604,833,293,398,311,435,42.0,42.4,41.7,00000
50.0,39.0,54.0,621,03,01,  Purba Majhdiar,293,711,152,341,141,370,29.2,30.8,27.6,00000
50.0,39.0,54.0,621,04,01,  Purba Baragir Char,913,1373,443,682,470,691,39.9,39.4,40.5,00000
50.0,39.0,54.0,621,05,01,  Baharaka Para (Part-2),358,1027,185,500,173,527,25.8,27.0,24.7,00000
50.0,39.0,61.0,042,01,01,  Bagoan,2626,3330,1320,1598,1306,1732,44.1,45.2,43.0,00000
50.0,39.0,61.0,042,02,01,  Guchugram,46,168,25,83,21,85,21.5,23.1,19.8,00000
50.0,39.0,61.0,247,01,01,  Farakpur,535,1021,267,510,268,511,34.4,34.4,34.4,00000
50.0,39.0,61.0,247,02,01,  Hisnapara,565,1098,283,567,282,531,34.0,33.3,34.7,00000
50.0,39.0,61.0,265,01,01,  Chak Salimpur,268,182,142,86,126,96,59.6,62.3,56.8,00000
50.0,39.0,61.0,265,02,01,  Farakpur,198,223,93,112,105,111,47.0,45.4,48.6,00000
50.0,39.0,61.0,615,01,01,  Majdia,125,177,72,78,53,99,41.4,48.0,34.9,00000
50.0,39.0,61.0,615,02,01,  Kaipal,968,1524,499,735,469,789,38.8,40.4,37.3,00000
50.0,39.0,61.0,615,03,01,  Hosenabad (Part),146,195,68,99,78,96,42.8,40.7,44.8,00000
50.0,39.0,61.0,615,04,01,  Bejpur(Part),241,429,116,226,125,203,36.0,33.9,38.1,00000
50.0,39.0,61.0,645,01,03,  Mathurapur,4330,4629,2257,2254,2073,2375,48.3,50.0,46.6,00000
50.0,39.0,61.0,645,02,03,  Gabargara,323,456,159,229,164,227,41.5,41.0,41.9,00000
50.0,39.0,61.0,645,03,03,  Mashaura,80,158,41,71,39,87,33.6,36.6,31.0,00000
50.0,39.0,61.0,645,04,03,  Guchchhagram,5,358,2,169,3,189,1.4,1.2,1.6,00000
50.0,39.0,67.0,018,01,01,  Natun Amdaha,1681,2190,865,1084,816,1106,43.4,44.4,42.5,00000
50.0,39.0,67.0,018,02,01,  Puratan Amdaha,1770,2034,923,1017,847,1017,46.5,47.6,45.4,00000
50.0,39.0,67.0,370,01,01,  Gabtala,282,350,138,171,144,179,44.6,44.7,44.6,00000
50.0,39.0,67.0,370,02,01,  Shatgachha,192,277,108,132,84,145,40.9,45.0,36.7,00000
50.0,39.0,67.0,404,01,01,  Allah Dargah,1767,846,942,377,825,469,67.6,71.4,63.8,00000
50.0,39.0,67.0,404,02,01,  Mirpur,765,696,398,348,367,348,52.4,53.4,51.3,00000
50.0,39.0,67.0,416,01,01,  Pura Salua,202,551,102,281,100,270,26.8,26.6,27.0,00000
50.0,39.0,67.0,416,02,01,  Chak Jagannathpur,163,227,78,113,85,114,41.8,40.8,42.7,00000
50.0,39.0,67.0,416,03,01,  Jagannathpur,368,713,169,360,199,353,34.0,31.9,36.1,00000
50.0,39.0,67.0,416,04,01,  Sherpur,716,1951,335,998,381,953,26.8,25.1,28.6,00000
50.0,39.0,67.0,416,05,01,  Kodalia,131,485,68,254,63,231,21.3,21.1,21.4,00000
50.0,39.0,67.0,416,06,01,  Baliashisha,165,325,78,170,87,155,33.7,31.5,36.0,00000
50.0,39.0,67.0,596,01,01,  Chak Madi,336,562,191,275,145,287,37.4,41.0,33.6,00000
50.0,39.0,67.0,596,02,01,  Madia,836,760,426,380,410,380,52.4,52.9,51.9,00000
50.0,39.0,67.0,729,01,01,  Pearpur,702,955,350,465,352,490,42.4,42.9,41.8,00000
50.0,39.0,67.0,729,02,01,  Pachha Bhita,623,1172,305,619,318,553,34.7,33.0,36.5,00000
50.0,39.0,67.0,729,03,01,  Beltala,111,207,52,106,59,101,34.9,32.9,36.9,00000
50.0,39.0,74.0,048,01,01,  Paschim Bahirmadi,1127,2112,555,1036,572,1076,34.8,34.9,34.7,00000
50.0,39.0,74.0,048,02,01,  Purba Bahirmadi,1211,1671,621,776,590,895,42.0,44.5,39.7,00000
50.0,39.0,74.0,048,03,01,  Alinagar,315,525,161,257,154,268,37.5,38.5,36.5,00000
50.0,39.0,74.0,048,04,01,  Shirajnagar,1091,1566,559,717,532,849,41.1,43.8,38.5,00000
50.0,39.0,74.0,735,01,01,  Philipnagar P.D.,733,1420,327,668,406,752,34.0,32.9,35.1,00000
50.0,39.0,74.0,735,02,01,  Purba Philipnagar,1271,1365,637,632,634,733,48.2,50.2,46.4,00000
50.0,39.0,74.0,735,03,01,  Uttar Philipnagar,145,224,62,102,83,122,39.3,37.8,40.5,00000
50.0,39.0,74.0,735,04,01,  Philipnagar,1993,2359,971,1116,1022,1243,45.8,46.5,45.1,00000
50.0,39.0,74.0,735,05,01,  Islampur,1098,1371,536,637,562,734,44.5,45.7,43.4,00000
50.0,39.0,74.0,735,06,01,  Dafadar Para,945,1346,489,654,456,692,41.2,42.8,39.7,00000
50.0,39.0,74.0,735,07,01,  Char Sadipur,924,1371,464,652,460,719,40.3,41.6,39.0,00000
50.0,39.0,81.0,391,01,01,  Gopalpur,542,813,282,367,260,446,40.0,43.5,36.8,00000
50.0,39.0,81.0,391,02,01,  Madapur,997,1371,513,653,484,718,42.1,44.0,40.3,00000
50.0,39.0,81.0,391,03,01,  Mirer Para,546,807,285,364,261,443,40.4,43.9,37.1,00000
50.0,39.0,81.0,391,04,01,  Islamnagar,305,679,177,332,128,347,31.0,34.8,26.9,00000
50.0,39.0,81.0,391,05,01,  Muslimnagar,414,455,210,202,204,253,47.6,51.0,44.6,00000
50.0,39.0,81.0,612,01,01,  Mahishkundi (Part),613,1723,333,843,280,880,26.2,28.3,24.1,00000
50.0,39.0,81.0,612,02,01,  Purba Mahishkundi,1726,1673,886,799,840,874,50.8,52.6,49.0,00000
50.0,39.0,81.0,651,01,01,  Mayarampur,610,1090,313,519,297,571,35.9,37.6,34.2,00000
50.0,39.0,81.0,651,02,01,  Natun Pakuria,543,791,271,372,272,419,40.7,42.1,39.4,00000
50.0,39.0,81.0,651,03,01,  Ghorar Para,380,532,195,251,185,281,41.7,43.7,39.7,00000
50.0,39.0,81.0,651,04,01,  Darar Para,135,125,68,69,67,56,51.9,49.6,54.5,00000
50.0,39.0,81.0,651,05,01,  Bil Gatua,1155,2045,614,970,541,1075,36.1,38.8,33.5,00000
50.0,39.0,81.0,711,01,01,  Pakuria,690,1481,340,716,350,765,31.8,32.2,31.4,00000
50.0,39.0,81.0,711,02,01,  Fakirbad (Jamalpur),553,1498,290,750,263,748,27.0,27.9,26.0,00000
50.0,39.0,88.0,271,01,01,  Char Para,910,1599,481,764,429,835,36.3,38.6,33.9,00000
50.0,39.0,88.0,271,02,01,  Kandir Para,426,819,216,407,210,412,34.2,34.7,33.8,00000
50.0,39.0,88.0,271,03,01,  Uttar Sonatala,275,427,134,202,141,225,39.2,39.9,38.5,00000
50.0,39.0,88.0,271,04,01,  Ramkrishnapur,567,1413,299,679,268,734,28.6,30.6,26.7,00000
50.0,39.0,88.0,271,05,01,  Thotar Para,254,516,135,258,119,258,33.0,34.4,31.6,00000
50.0,39.0,88.0,271,06,01,  Dakshin Sonatala,304,604,159,312,145,292,33.5,33.8,33.2,00000
50.0,39.0,88.0,271,07,01,  Paschim Sonatala,442,560,247,266,195,294,44.1,48.1,39.9,00000
50.0,39.0,88.0,584,01,01,  Mohammadpur,684,1044,341,494,343,550,39.6,40.8,38.4,00000
50.0,39.0,88.0,584,02,01,  Bhagjot,498,803,252,383,246,420,38.3,39.7,36.9,00000
50.0,39.0,88.0,584,04,01,  Kharibona,155,185,82,78,73,107,45.6,51.3,40.6,00000
50.0,39.0,88.0,584,05,01,  Dhaki Para,281,494,149,236,132,258,36.3,38.7,33.8,00000
50.0,39.0,88.0,584,06,01,  Islamnagar,79,323,43,159,36,164,19.7,21.3,18.0,00000
50.0,39.0,88.0,584,07,01,  Islampur,276,713,122,363,154,350,27.9,25.2,30.6,00000
50.0,39.0,88.0,584,08,01,  Chidopa,196,158,109,73,87,85,55.4,59.9,50.6,00000
50.0,39.0,88.0,584,09,01,  Munshiganj,291,473,155,232,136,241,38.1,40.1,36.1,00000
50.0,39.0,88.0,584,10,01,  Insafnagar,987,1932,509,952,478,980,33.8,34.8,32.8,00000
50.0,39.0,94.0,108,01,01,  Bheramara,728,928,405,439,323,489,44.0,48.0,39.8,00000
50.0,39.0,94.0,108,02,01,  Kanchan Nagar,151,234,85,119,66,115,39.2,41.7,36.5,00000
50.0,39.0,94.0,458,01,01,  Jhaudia,530,561,279,268,251,293,48.6,51.0,46.1,00000
50.0,39.0,94.0,458,02,01,  Andal Baria,106,377,53,183,53,194,21.9,22.5,21.5,00000
50.0,39.0,94.0,458,03,01,  Natun Jhaudia,239,341,111,180,128,161,41.2,38.1,44.3,00000
50.0,39.0,94.0,458,04,01,  Bishnupur,183,263,86,121,97,142,41.0,41.5,40.6,00000
50.0,39.0,94.0,464,01,01,  Kaghati,216,166,112,85,104,81,56.5,56.9,56.2,00000
50.0,39.0,94.0,464,02,01,  Natun Kaghnat,205,304,105,155,100,149,40.3,40.4,40.2,00000
50.0,39.0,94.0,464,03,01,  Baha Dalia Para,455,929,257,448,198,481,32.9,36.5,29.2,00000
50.0,39.0,94.0,560,01,01,  Lakshmikhola,935,1322,512,592,423,730,41.4,46.4,36.7,00000
50.0,39.0,94.0,560,02,01,  Nauda Para,225,179,126,85,99,94,55.7,59.7,51.3,00000
50.0,39.0,94.0,560,03,01,  Joardar Para,267,360,144,176,123,184,42.6,45.0,40.1,00000
50.0,63.0,17.0,328,01,01,  Dhokrakul,419,605,243,311,176,294,40.9,43.9,37.4,00000
50.0,63.0,17.0,328,02,01,  Gosaidangi,523,1269,267,618,256,651,29.2,30.2,28.2,00000
50.0,63.0,17.0,328,03,01,  Kuthi Para,265,403,141,206,124,197,39.7,40.6,38.6,00000
50.0,63.0,17.0,328,04,01,  Tahirpur,335,304,184,146,151,158,52.4,55.8,48.9,00000
50.0,63.0,17.0,328,05,01,  Bairagi Para,192,297,102,143,90,154,39.3,41.6,36.9,00000
50.0,63.0,25.0,075,01,01,  Banagram Paschimpara,350,555,194,264,156,291,38.7,42.4,34.9,00000
50.0,63.0,25.0,075,02,01,  Madhya Banagram,222,446,126,206,96,240,33.2,38.0,28.6,00000
50.0,63.0,25.0,075,03,01,  Banagram Purbapara,426,893,226,436,200,457,32.3,34.1,30.4,00000
50.0,63.0,31.0,088,01,01,  Baraichara,449,612,212,306,237,306,42.3,40.9,43.6,00000
50.0,63.0,31.0,088,02,01,  Dangi Para,265,346,136,177,129,169,43.4,43.5,43.3,00000
50.0,63.0,31.0,340,01,01,  Gopagram,1653,2268,852,1069,801,1199,42.2,44.4,40.1,00000
50.0,63.0,31.0,340,02,01,  Shangang,383,459,194,227,189,232,45.5,46.1,44.9,00000
50.0,63.0,31.0,340,03,01,  Santoshpur,336,427,174,204,162,223,44.0,46.0,42.1,00000
50.0,63.0,31.0,566,01,01,  Khurda Sadua,366,494,180,237,186,257,42.6,43.2,42.0,00000
50.0,63.0,31.0,566,02,01,  Muraripur,164,229,73,112,91,117,41.7,39.5,43.8,00000
50.0,63.0,37.0,106,01,01,  Beharia,466,718,244,348,222,370,39.4,41.2,37.5,00000
50.0,63.0,37.0,106,02,01,  Charbeharia,289,197,160,91,129,106,59.5,63.7,54.9,00000
50.0,63.0,37.0,106,03,01,  Nagar Para,80,194,52,95,28,99,29.2,35.4,22.0,00000
50.0,63.0,37.0,302,01,01,  Ektarpur,1142,1843,596,873,546,970,38.3,40.6,36.0,00000
50.0,63.0,37.0,302,02,01,  Barampur,431,552,216,262,215,290,43.8,45.2,42.6,00000
50.0,63.0,37.0,302,03,01,  Machhuaghata,260,205,152,88,108,117,55.9,63.3,48.0,00000
50.0,63.0,43.0,466,01,01,  Jayanti Hajra,558,1069,302,500,256,569,34.3,37.7,31.0,00000
50.0,63.0,43.0,466,02,01,  Radhanagar,391,611,202,289,189,322,39.0,41.1,37.0,00000
50.0,63.0,43.0,969,01,01,  Uthali,493,948,262,451,231,497,34.2,36.7,31.7,00000
50.0,63.0,43.0,969,02,01,  Bhabaniganj,326,602,168,298,158,304,35.1,36.1,34.2,00000
50.0,63.0,57.0,591,01,01,  Kumarbhog Khal Para,652,1035,324,490,328,545,38.6,39.8,37.6,00000
50.0,63.0,57.0,591,02,01,  Kumarbhog,565,477,303,210,262,267,54.2,59.1,49.5,00000
50.0,63.0,77.0,919,01,01,  Shimulia,1403,1912,743,910,660,1002,42.3,44.9,39.7,00000
50.0,63.0,77.0,919,02,01,  Dangi Para,183,324,91,152,92,172,36.1,37.4,34.8,00000
50.0,63.0,77.0,919,03,01,  Kalisankarpur,167,188,96,94,71,94,47.0,50.5,43.0,00000
50.0,71.0,17.0,311,01,01,  Dhalnagar,1063,1337,556,636,507,701,44.3,46.6,42.0,00000
50.0,71.0,17.0,311,02,01,  Pratappur,485,936,246,445,239,491,34.1,35.6,32.7,00000
50.0,71.0,17.0,399,01,01,  Gobra,1222,1234,636,601,586,633,49.8,51.4,48.1,00000
50.0,71.0,17.0,399,02,01,  Anandanagar,252,365,134,165,118,200,40.8,44.8,37.1,00000
50.0,71.0,17.0,464,01,01,  Joydebpur,40,93,19,45,21,48,30.1,29.7,30.4,00000
50.0,71.0,17.0,464,02,01,  Sreepur,310,404,148,194,162,210,43.4,43.3,43.5,00000
50.0,71.0,25.0,202,01,01,  Chapra,540,732,287,352,253,380,42.5,44.9,40.0,00000
50.0,71.0,25.0,202,02,01,  Char Chapra,184,444,88,215,96,229,29.3,29.0,29.5,00000
50.0,71.0,25.0,770,01,01,  Paik Para Ichakhali,282,404,143,197,139,207,41.1,42.1,40.2,00000
50.0,71.0,25.0,770,02,01,  Ichakhali,343,350,179,164,164,186,49.5,52.2,46.9,00000
50.0,71.0,25.0,809,01,01,  Lahini Para,1183,889,621,414,562,475,57.1,60.0,54.2,00000
50.0,71.0,25.0,809,02,01,  Ghoaidandi,316,432,160,200,156,232,42.2,44.4,40.2,00000
50.0,71.0,25.0,869,01,01,  Saota,1159,1732,554,859,605,873,40.1,39.2,40.9,00000
50.0,71.0,25.0,869,02,01,  Par Saota,633,737,330,369,303,368,46.2,47.2,45.2,00000
50.0,71.0,34.0,098,01,01,  Gabindapur,585,625,313,289,272,336,48.3,52.0,44.7,00000
50.0,71.0,34.0,098,02,01,  Paranpur,380,480,183,238,197,242,44.2,43.5,44.9,00000
50.0,71.0,34.0,224,01,01,  D.Lakshmipur,322,508,172,232,150,276,38.8,42.6,35.2,00000
50.0,71.0,34.0,224,02,01,  N.Chhatian,190,240,102,120,88,120,44.2,45.9,42.3,00000
50.0,71.0,43.0,309,01,01,  Char Bhabanipur,242,508,112,263,130,245,32.3,29.9,34.7,00000
50.0,71.0,43.0,309,02,01,  Daya Rampur,1432,1555,710,779,722,776,47.9,47.7,48.2,00000
50.0,71.0,43.0,475,01,01,  Jagannathpur,561,958,304,495,257,463,36.9,38.0,35.7,00000
50.0,71.0,43.0,475,02,01,  Jatpara,768,897,411,454,357,443,46.1,47.5,44.6,00000
50.0,71.0,43.0,658,01,01,  Mahendrapur,1411,1451,751,685,660,766,49.3,52.3,46.3,00000
50.0,71.0,43.0,658,02,01,  Char Mahendrapur,248,560,132,291,116,269,30.7,31.2,30.1,00000
50.0,71.0,51.0,524,01,01,  Kaloa,883,881,436,389,447,492,50.1,52.8,47.6,00000
50.0,71.0,51.0,524,02,01,  Bear Kaloa,614,785,309,368,305,417,43.9,45.6,42.2,00000
50.0,71.0,69.0,218,01,01,  Charikul,1181,1538,600,750,581,788,43.4,44.4,42.4,00000
50.0,71.0,69.0,218,02,01,  Puratan Charikul,824,1329,448,644,376,685,38.3,41.0,35.4,00000
50.0,71.0,86.0,010,01,01,  Agrakunda,43,45,24,19,19,26,48.9,55.8,42.2,00000
50.0,71.0,86.0,010,02,01,  Char Agrakunda,114,166,53,87,61,79,40.7,37.9,43.6,00000
50.0,71.0,86.0,587,01,01,  Kalkutia,252,351,125,177,127,174,41.8,41.4,42.2,00000
50.0,71.0,86.0,587,02,01,  Kanthaldangi,130,301,72,157,58,144,30.2,31.4,28.7,00000
50.0,71.0,86.0,672,01,01,  Maliat,477,851,253,416,224,435,35.9,37.8,34.0,00000
50.0,71.0,86.0,672,02,01,  Dari Maliat,180,145,88,76,92,69,55.4,53.7,57.1,00000
50.0,71.0,86.0,672,03,01,  Santoshpur,124,283,63,136,61,147,30.5,31.7,29.3,00000
50.0,71.0,86.0,841,01,01,  Sadaki,271,533,139,253,132,280,33.7,35.5,32.0,00000
50.0,71.0,86.0,841,02,01,  Char Para,142,198,76,94,66,104,41.8,44.7,38.8,00000
50.0,71.0,86.0,841,03,01,  Dighir Para,327,405,169,214,158,191,44.7,44.1,45.3,00000
50.0,71.0,86.0,841,04,01,  Mamudpur,240,501,116,259,124,242,32.4,30.9,33.9,00000
50.0,79.0,16.0,289,01,01,  Deri Para,812,766,419,338,393,428,51.5,55.4,47.9,00000
50.0,79.0,16.0,289,02,01,  Char Para,505,612,260,303,245,309,45.2,46.2,44.2,00000
50.0,79.0,16.0,620,01,01,  Lakshmipur,1510,2304,787,1141,723,1163,39.6,40.8,38.3,00000
50.0,79.0,16.0,620,02,01,  Madhupur,730,640,392,288,338,352,53.3,57.6,49.0,00000
50.0,79.0,16.0,833,01,01,  Rajapur,270,718,154,379,116,339,27.3,28.9,25.5,00000
50.0,79.0,16.0,833,02,01,  Piarpur,1106,1208,595,582,511,626,47.8,50.6,44.9,00000
50.0,79.0,17.0,085,01,01,  Amanatpur,567,684,302,337,265,347,45.3,47.3,43.3,00000
50.0,79.0,17.0,085,02,01,  Bara Ailchara,3192,3268,1648,1620,1544,1648,49.4,50.4,48.4,00000
50.0,79.0,17.0,085,03,01,  Baghdanga,1167,1279,599,618,568,661,47.7,49.2,46.2,00000
50.0,79.0,17.0,085,04,01,  Ballabhpur,819,958,418,466,401,492,46.1,47.3,44.9,00000
50.0,79.0,17.0,085,05,01,  Santaspur,321,436,153,226,168,210,42.4,40.4,44.4,00000
50.0,79.0,17.0,782,01,01,  Nazirpur Khurda,495,687,253,337,242,350,41.9,42.9,40.9,00000
50.0,79.0,17.0,782,02,01,  Ailcharagram,1519,1794,775,848,744,946,45.8,47.8,44.0,00000
50.0,79.0,17.0,782,03,01,  Goalbari,122,137,66,62,56,75,47.1,51.6,42.7,00000
50.0,79.0,17.0,782,04,01,  Krishnapur,117,192,63,96,54,96,37.9,39.6,36.0,00000
50.0,79.0,17.0,782,05,01,  Sheoratala,197,260,113,128,84,132,43.1,46.9,38.9,00000
50.0,79.0,18.0,017,01,01,  Alampur,1930,2176,1020,1054,910,1122,47.0,49.2,44.8,00000
50.0,79.0,18.0,017,02,01,  Khairpur,238,233,132,117,106,116,50.5,53.0,47.7,00000
50.0,79.0,18.0,017,03,01,  Rajapur,304,244,167,113,137,131,55.5,59.6,51.1,00000
50.0,79.0,18.0,943,01,01,  Dhakulagram,1726,1939,884,939,842,1000,47.1,48.5,45.7,00000
50.0,79.0,18.0,943,02,01,  Katali Para,785,711,408,337,377,374,52.5,54.8,50.2,00000
50.0,79.0,18.0,943,03,01,  Shwargapur,512,569,263,284,249,285,47.4,48.1,46.6,00000
50.0,79.0,18.0,943,04,01,  Darbeshpur,364,511,191,247,173,264,41.6,43.6,39.6,00000
50.0,79.0,18.0,943,05,01,  Simulia,774,885,380,442,394,443,46.7,46.2,47.1,00000
50.0,79.0,25.0,297,01,01,  Dhaka,923,543,475,245,448,298,63.0,66.0,60.1,00000
50.0,79.0,25.0,297,02,01,  Jhala Para,594,421,316,201,278,220,58.5,61.1,55.8,00000
50.0,79.0,37.0,399,01,01,  Harinarayanpur,2356,1306,1229,589,1127,717,64.3,67.6,61.1,00000
50.0,79.0,37.0,399,02,01,  Shibpur,1577,1552,866,713,711,839,50.4,54.8,45.9,00000
50.0,79.0,37.0,399,03,01,  Berba Rade,1653,1739,874,830,779,909,48.7,51.3,46.1,00000
50.0,79.0,37.0,399,04,01,  Padmanagar,639,862,364,431,275,431,42.6,45.8,39.0,00000
50.0,79.0,44.0,178,01,01,  Boaildaha,3090,3606,1620,1753,1470,1853,46.1,48.0,44.2,00000
50.0,79.0,44.0,178,02,01,  Kanti Nagar Boaildaha,799,983,427,492,372,491,44.8,46.5,43.1,00000
50.0,79.0,50.0,110,01,01,  Baria Takimara,609,784,309,380,300,404,43.7,44.8,42.6,00000
50.0,79.0,50.0,110,02,01,  Baria Bhadalia Para,160,252,76,126,84,126,38.8,37.6,40.0,00000
50.0,79.0,50.0,110,03,01,  Baria,733,870,382,440,351,430,45.7,46.5,44.9,00000
50.0,79.0,50.0,136,01,01,  Battail Takimara,360,406,196,179,164,227,47.0,52.3,41.9,00000
50.0,79.0,50.0,136,02,01,  Battail  Bhadalia Para,239,399,115,210,124,189,37.5,35.4,39.6,00000
50.0,79.0,50.0,136,03,01,  Batail,4192,3408,2134,1630,2058,1778,55.2,56.7,53.6,00000
50.0,79.0,50.0,459,01,03,  Jagati Uttar Colony,1602,671,835,291,767,380,70.5,74.2,66.9,00000
50.0,79.0,50.0,459,02,03,  Dakshin Jagati,1708,800,876,380,832,420,68.1,69.7,66.5,00000
50.0,79.0,50.0,493,01,01,  Kaburhat,2387,2096,1250,983,1137,1113,53.2,56.0,50.5,00000
50.0,79.0,50.0,493,02,01,  Dasta Para,1133,1509,582,725,551,784,42.9,44.5,41.3,00000
50.0,79.0,50.0,493,03,01,  Khajanagar,3857,5156,2100,2406,1757,2750,42.8,46.6,39.0,00000
50.0,79.0,56.0,144,01,01,  Belgharia,935,1232,478,603,457,629,43.1,44.2,42.1,00000
50.0,79.0,56.0,144,02,01,  Char Para,669,957,342,456,327,501,41.1,42.9,39.5,00000
50.0,79.0,56.0,484,01,01,  Jiaarakhi,1080,1343,561,671,519,672,44.6,45.5,43.6,00000
50.0,79.0,56.0,484,02,01,  Gopalpur,1029,1557,549,732,480,825,39.8,42.9,36.8,00000
50.0,79.0,56.0,484,03,01,  Motpara,404,509,212,238,192,271,44.2,47.1,41.5,00000
50.0,79.0,56.0,527,01,01,  Kamalapur,822,832,431,385,391,447,49.7,52.8,46.7,00000
50.0,79.0,56.0,527,02,01,  Shibpur,496,433,246,211,250,222,53.4,53.8,53.0,00000
50.0,79.0,56.0,527,03,01,  Lakshmipur,398,590,203,281,195,309,40.3,41.9,38.7,00000
50.0,79.0,56.0,535,01,01,  Kanchanpur,601,922,298,443,303,479,39.5,40.2,38.7,00000
50.0,79.0,56.0,535,02,01,  Jotpara,610,770,295,371,315,399,44.2,44.3,44.1,00000
50.0,79.0,56.0,535,03,01,  Bhabanipur,570,1081,312,507,258,574,34.5,38.1,31.0,00000
50.0,79.0,56.0,535,04,01,  Balia Para,971,1632,484,776,487,856,37.3,38.4,36.3,00000
50.0,79.0,56.0,535,05,01,  Ratul Para,405,828,209,410,196,418,32.8,33.8,31.9,00000
50.0,79.0,56.0,535,06,01,  Shailgari,179,254,99,110,80,144,41.3,47.4,35.7,00000
50.0,79.0,63.0,425,01,01,  Hatia,1407,1756,795,849,612,907,44.5,48.4,40.3,00000
50.0,79.0,63.0,425,02,01,  Badunathpur,624,950,316,466,308,484,39.6,40.4,38.9,00000
50.0,79.0,63.0,688,01,01,  Majh Para,1180,2423,565,1208,615,1215,32.8,31.9,33.6,00000
50.0,79.0,63.0,688,02,01,  Alinagar,136,548,63,286,73,262,19.9,18.1,21.8,00000
50.0,79.0,63.0,688,03,01,  Udaypur,277,580,139,304,138,276,32.3,31.4,33.3,00000
50.0,79.0,75.0,361,01,01,  Chourash,8122,3855,4261,1754,3861,2101,67.8,70.8,64.8,00000
50.0,79.0,75.0,361,02,01,  Udibari,1776,1131,944,527,832,604,61.1,64.2,57.9,00000
50.0,79.0,75.0,450,01,01,  Jagannathpur,430,555,227,260,203,295,43.7,46.6,40.8,00000
50.0,79.0,75.0,450,02,01,  Chak Raja Para,185,213,98,97,87,116,46.5,50.3,42.9,00000
50.0,79.0,75.0,671,01,01,  Purba Mazampur,3018,524,1529,213,1489,311,85.2,87.8,82.7,00000
50.0,79.0,75.0,671,02,01,  Paschim Mazampur,3044,1060,1533,486,1511,574,74.2,75.9,72.5,00000
50.0,79.0,82.0,246,01,01,  Chhayghari,451,647,248,316,203,331,41.1,44.0,38.0,00000
50.0,79.0,82.0,246,02,01,  Fakir Para,185,340,90,169,95,171,35.2,34.7,35.7,00000
50.0,79.0,82.0,790,01,01,  Nrisinghapur,961,1237,513,603,448,634,43.7,46.0,41.4,00000
50.0,79.0,82.0,790,02,01,  Sharifpur,178,494,78,241,100,253,26.5,24.5,28.3,00000
50.0,79.0,88.0,357,01,01,  Gopalpur,266,160,133,77,133,83,62.4,63.3,61.6,00000
50.0,79.0,88.0,357,02,01,  Char Para,313,156,154,74,159,82,66.7,67.5,66.0,00000
50.0,79.0,88.0,408,01,01,  Haruria,617,429,319,206,298,223,59.0,60.8,57.2,00000
50.0,79.0,88.0,408,02,01,  Chandpur,129,99,64,52,65,47,56.6,55.2,58.0,00000
50.0,79.0,88.0,595,01,01,  Khejurtala,1074,1185,549,529,525,656,47.5,50.9,44.5,00000
50.0,79.0,88.0,595,02,01,  Hazratpur,135,210,74,99,61,111,39.1,42.8,35.5,00000
50.0,79.0,94.0,102,01,01,  Durbachara,1360,1235,713,556,647,679,52.4,56.2,48.8,00000
50.0,79.0,94.0,102,02,01,  Barui Tupi,618,736,336,340,282,396,45.6,49.7,41.6,00000
50.0,79.0,94.0,127,01,01,  Barui Para,642,799,328,396,314,403,44.6,45.3,43.8,00000
50.0,79.0,94.0,127,02,01,  Ranjitpur,452,582,228,296,224,286,43.7,43.5,43.9,00000
50.0,79.0,94.0,629,01,01,  Madhupur,566,521,292,254,274,267,52.1,53.5,50.6,00000
50.0,79.0,94.0,629,02,01,  Bitti Para,900,807,455,388,445,419,52.7,54.0,51.5,00000
50.0,79.0,94.0,714,01,01,  Mrittika Para,759,1307,402,649,357,658,36.7,38.2,35.2,00000
50.0,79.0,94.0,714,02,01,  Karimpur,476,328,241,148,235,180,59.2,62.0,56.6,00000
50.0,94.0,13.0,024,01,01,  Ambaria Mirzapur,1067,1303,558,619,509,684,45.0,47.4,42.7,00000
50.0,94.0,13.0,024,02,01,  Bhadamari,651,519,348,241,303,278,55.6,59.1,52.2,00000
50.0,94.0,13.0,415,01,01,  Halsa,457,572,219,261,238,311,44.4,45.6,43.4,00000
50.0,94.0,13.0,415,02,01,  Bamongari,707,1307,365,608,342,699,35.1,37.5,32.9,00000
50.0,94.0,13.0,742,01,01,  Nagar Baka,435,593,229,264,206,329,42.3,46.5,38.5,00000
50.0,94.0,13.0,742,02,01,  Halsa Bazar,339,300,182,132,157,168,53.1,58.0,48.3,00000
50.0,94.0,13.0,742,03,01,  Shakdaha Char,765,1477,407,697,358,780,34.1,36.9,31.5,00000
50.0,94.0,13.0,742,04,01,  Chulkani,2,14,2,8,0,6,12.5,20.0,0.0,00000
50.0,94.0,13.0,742,05,01,  Annadanagar,81,155,43,74,38,81,34.3,36.8,31.9,00000
50.0,94.0,13.0,742,06,01,  Ramjanpur,206,208,101,96,105,112,49.8,51.3,48.4,00000
50.0,94.0,13.0,742,07,01,  Shupukuria,256,294,121,123,135,171,46.5,49.6,44.1,00000
50.0,94.0,13.0,962,01,01,  Sutail Puran,340,398,167,185,173,213,46.1,47.4,44.8,00000
50.0,94.0,13.0,962,02,01,  Sutail Nutan,138,388,76,187,62,201,26.2,28.9,23.6,00000
50.0,94.0,14.0,040,01,03,  Amla,1626,1215,820,573,806,642,57.2,58.9,55.7,00000
50.0,94.0,14.0,040,02,03,  Shahapur,441,502,236,243,205,259,46.8,49.3,44.2,00000
50.0,94.0,14.0,048,01,01,  Anjangachhi,1518,2276,781,1055,737,1221,40.0,42.5,37.6,00000
50.0,94.0,14.0,048,02,01,  Nayanpur,380,491,204,238,176,253,43.6,46.2,41.0,00000
50.0,94.0,14.0,171,01,01,  Bil Amla Paschim,99,303,52,155,47,148,24.6,25.1,24.1,00000
50.0,94.0,14.0,171,02,01,  Bil Amla Purba,281,321,141,163,140,158,46.7,46.4,47.0,00000
50.0,94.0,14.0,464,01,01,  Kachubaria,1401,1694,710,825,691,869,45.3,46.3,44.3,00000
50.0,94.0,14.0,464,02,01,  Chowduar,889,991,429,505,460,486,47.3,45.9,48.6,00000
50.0,94.0,14.0,595,01,01,  Khayerpur,706,1076,365,512,341,564,39.6,41.6,37.7,00000
50.0,94.0,14.0,595,02,01,  Char Para,311,314,182,145,129,169,49.8,55.7,43.3,00000
50.0,94.0,14.0,595,03,01,  Mahadipur,448,560,208,266,240,294,44.4,43.9,44.9,00000
50.0,94.0,14.0,619,01,01,  Kusbaria,641,746,345,371,296,375,46.2,48.2,44.1,00000
50.0,94.0,14.0,619,02,01,  Subalpur,49,166,27,77,22,89,22.8,26.0,19.8,00000
50.0,94.0,21.0,089,01,01,  Nanda Bahalbaria,1327,1691,657,842,670,849,44.0,43.8,44.1,00000
50.0,94.0,21.0,089,02,01,  Bahalbaria,1476,1583,706,815,770,768,48.3,46.4,50.1,00000
50.0,94.0,21.0,089,03,01,  Sahebnagar,1533,1696,687,880,846,816,47.5,43.8,50.9,00000
50.0,94.0,21.0,089,04,01,  Satbaria,273,289,142,161,131,128,48.6,46.9,50.6,00000
50.0,94.0,21.0,562,01,01,  Char Khadimpur,114,126,60,54,54,72,47.5,52.6,42.9,00000
50.0,94.0,21.0,562,02,01,  Khadimpur,1722,1572,858,830,864,742,52.3,50.8,53.8,00000
50.0,94.0,21.0,562,03,01,  Nanda Khadimpur,1425,2163,698,1082,727,1081,39.7,39.2,40.2,00000
50.0,94.0,21.0,587,01,01,  Kharara,1424,1725,706,892,718,833,45.2,44.2,46.3,00000
50.0,94.0,21.0,587,02,01,  Nauda Khara,1015,1320,513,647,502,673,43.5,44.2,42.7,00000
50.0,94.0,29.0,138,01,01,  Barui Para,532,1010,280,507,252,503,34.5,35.6,33.4,00000
50.0,94.0,29.0,138,02,01,  Shatgaji,464,365,244,170,220,195,56.0,58.9,53.0,00000
50.0,94.0,29.0,138,03,01,  Kobarbari,1406,865,737,441,669,424,61.9,62.6,61.2,00000
50.0,94.0,29.0,334,01,01,  Ektarpur,260,608,122,305,138,303,30.0,28.6,31.3,00000
50.0,94.0,29.0,334,02,01,  Tantibanda,428,366,244,176,184,190,53.9,58.1,49.2,00000
50.0,94.0,29.0,554,01,01,  Keopur,742,841,360,439,382,402,46.9,45.1,48.7,00000
50.0,94.0,29.0,554,02,01,  Fakirabad,376,556,200,262,176,294,40.3,43.3,37.4,00000
50.0,94.0,29.0,725,01,01,  Mirzanagar,762,931,376,453,386,478,45.0,45.4,44.7,00000
50.0,94.0,29.0,725,02,01,  Satragachha,567,661,282,365,285,296,46.2,43.6,49.1,00000
50.0,94.0,29.0,725,03,01,  Goda Para,214,211,110,113,104,98,50.4,49.3,51.5,00000
50.0,94.0,36.0,252,01,01,  Chhatian,1631,2239,833,1125,798,1114,42.1,42.5,41.7,00000
50.0,94.0,36.0,252,02,01,  Kalinatpur(Part),436,598,216,318,220,280,42.2,40.4,44.0,00000
50.0,94.0,36.0,252,03,01,  Islampur,157,214,78,110,79,104,42.3,41.5,43.2,00000
50.0,94.0,36.0,611,01,01,  Naoda Kursha,429,467,211,222,218,245,47.9,48.7,47.1,00000
50.0,94.0,36.0,611,02,01,  Baishinagar,327,694,155,352,172,342,32.0,30.6,33.5,00000
50.0,94.0,36.0,880,01,01,  Sarotia,96,432,57,210,39,222,18.2,21.3,14.9,00000
50.0,94.0,36.0,880,02,01,  Mohanpur,85,138,42,75,43,63,38.1,35.9,40.6,00000
50.0,94.0,36.0,913,01,01,  Sondaha,386,798,196,392,190,406,32.6,33.3,31.9,00000
50.0,94.0,36.0,913,02,01,  Bhagaipur,77,130,42,58,35,72,37.2,42.0,32.7,00000
50.0,94.0,36.0,913,03,01,  Kalinathpur,658,1034,330,513,328,521,38.9,39.1,38.6,00000
50.0,94.0,36.0,913,04,01,  Naforkandi,468,1098,260,531,208,567,29.9,32.9,26.8,00000
50.0,94.0,36.0,913,05,01,  Gangatala,102,292,48,142,54,150,25.9,25.3,26.5,00000
50.0,94.0,36.0,913,06,01,  Bhurar Dair,97,167,47,80,50,87,36.7,37.0,36.5,00000
50.0,94.0,43.0,318,01,01,  Dhubali,1431,2350,686,1188,745,1162,37.8,36.6,39.1,00000
50.0,94.0,43.0,318,02,01,  Chak,292,725,132,371,160,354,28.7,26.2,31.1,00000
50.0,94.0,43.0,367,01,01,  Gobindagunia,860,1384,368,742,492,642,38.3,33.2,43.4,00000
50.0,94.0,43.0,367,02,01,  Kaderpur,94,252,36,133,58,119,27.2,21.3,32.8,00000
50.0,94.0,43.0,627,01,01,  Lakshmidhardia,977,993,494,497,483,496,49.6,49.8,49.3,00000
50.0,94.0,43.0,627,02,01,  Kazipur,363,477,175,249,188,228,43.2,41.3,45.2,00000
50.0,94.0,43.0,627,03,01,  Bithi Para,83,324,46,177,37,147,20.4,20.6,20.1,00000
50.0,94.0,43.0,652,01,01,  Mahishakhola,784,1211,371,622,413,589,39.3,37.4,41.2,00000
50.0,94.0,43.0,652,02,01,  Baliashisha,361,724,173,366,188,358,33.3,32.1,34.4,00000
50.0,94.0,43.0,668,01,01,  Majlispur,262,369,135,182,127,187,41.5,42.6,40.4,00000
50.0,94.0,43.0,668,02,01,  Sreenathpur,109,286,50,150,59,136,27.6,25.0,30.3,00000
50.0,94.0,58.0,024,01,01,  Essalmari,600,1260,313,605,287,655,32.3,34.1,30.5,00000
50.0,94.0,58.0,024,02,01,  Bara Bhedmari,257,386,122,190,135,196,40.0,39.1,40.8,00000
50.0,94.0,58.0,114,01,01,  Banshbaria,229,457,124,205,105,252,33.4,37.7,29.4,00000
50.0,94.0,58.0,114,02,01,  Ramnagar,521,812,277,381,244,431,39.1,42.1,36.1,00000
50.0,94.0,58.0,570,01,01,  Hauspur,276,470,154,230,122,240,37.0,40.1,33.7,00000
50.0,94.0,58.0,570,02,01,  Khal Magura,344,522,182,265,162,257,39.7,40.7,38.7,00000
50.0,94.0,58.0,611,01,01,  Kursha,954,2427,468,1166,486,1261,28.2,28.6,27.8,00000
50.0,94.0,58.0,611,02,01,  Mehernagar,12,18,9,9,3,9,40.0,50.0,25.0,00000
50.0,94.0,58.0,611,03,01,  Puthimari,308,552,148,267,160,285,35.8,35.7,36.0,00000
50.0,94.0,58.0,611,04,01,  Mallikpur,140,209,76,93,64,116,40.1,45.0,35.6,00000
50.0,94.0,58.0,611,05,01,  Eassalmari,137,251,70,119,67,132,35.3,37.0,33.7,00000
50.0,94.0,58.0,660,01,01,  Majihat,1924,3479,1013,1638,911,1841,35.6,38.2,33.1,00000
50.0,94.0,58.0,660,02,01,  Kuntir Char,619,1278,320,609,299,669,32.6,34.4,30.9,00000
50.0,94.0,65.0,008,01,01,  Abari,712,1521,373,742,339,779,31.9,33.5,30.3,00000
50.0,94.0,65.0,008,02,01,  Rajnagar,398,965,218,457,180,508,29.2,32.3,26.2,00000
50.0,94.0,65.0,399,01,01,  Gopinathpur,882,1442,432,731,450,711,38.0,37.1,38.8,00000
50.0,94.0,65.0,399,02,01,  Mallikpur,134,350,68,170,66,180,27.7,28.6,26.8,00000
50.0,94.0,65.0,448,01,01,  Jhutiadanga,486,1000,239,511,247,489,32.7,31.9,33.6,00000
50.0,94.0,65.0,448,02,01,  Asannagar,1132,1891,592,926,540,965,37.4,39.0,35.9,00000
50.0,94.0,73.0,521,01,01,  Kamirhat,410,1028,206,546,204,482,28.5,27.4,29.7,00000
50.0,94.0,73.0,521,02,01,  Kachuadaha,425,446,222,231,203,215,48.8,49.0,48.6,00000
50.0,94.0,73.0,888,01,01,  Fulbaria,797,1336,413,663,384,673,37.4,38.4,36.3,00000
50.0,94.0,73.0,888,02,01,  Shimulia,657,607,341,292,316,315,52.0,53.9,50.1,00000
50.0,94.0,73.0,888,03,01,  Madhabpur,85,220,37,106,48,114,27.9,25.9,29.6,00000
50.0,94.0,73.0,888,04,01,  Kamar Para,103,238,49,135,54,103,30.2,26.6,34.4,00000
50.0,94.0,73.0,888,05,01,  Gate Para,286,480,140,254,146,226,37.3,35.5,39.2,00000
50.0,94.0,80.0,269,01,01,  Chithalia,1480,1103,754,499,726,604,57.3,60.2,54.6,00000
50.0,94.0,80.0,269,02,01,  Khayer Chara,370,426,175,200,195,226,46.5,46.7,46.3,00000
50.0,94.0,80.0,831,01,01,  Poradaha,635,716,315,328,320,388,47.0,49.0,45.2,00000
50.0,94.0,80.0,831,02,01,  Tatultala,340,659,165,317,175,342,34.0,34.2,33.8,00000
50.0,94.0,80.0,970,01,01,  Swarupdaha,2591,3052,1320,1511,1271,1541,45.9,46.6,45.2,00000
50.0,94.0,80.0,970,02,01,  Gobindapur,611,1155,303,589,308,566,34.6,34.0,35.2,00000
50.0,94.0,80.0,986,01,01,  Tegharia,1180,1427,614,693,566,734,45.3,47.0,43.5,00000
50.0,94.0,80.0,986,02,01,  Danga Para,434,630,234,305,200,325,40.8,43.4,38.1,00000
50.0,94.0,80.0,986,03,01,  Doapara,161,275,75,134,86,141,36.9,35.9,37.9,00000
50.0,94.0,87.0,073,01,01,  Azampur,983,1766,516,884,467,882,35.8,36.9,34.6,00000
50.0,94.0,87.0,073,02,01,  Nadda Azampur,1346,2068,719,981,627,1087,39.4,42.3,36.6,00000
50.0,94.0,87.0,073,03,01,  Chowdhury Para,242,783,132,375,110,408,23.6,26.0,21.2,00000
50.0,94.0,87.0,073,04,01,  Radhanagar,49,198,32,88,17,110,19.8,26.7,13.4,00000
50.0,94.0,87.0,073,05,01,  Hidirampur,506,408,262,189,244,219,55.4,58.1,52.7,00000
50.0,94.0,87.0,481,01,01,  Kakuliadaha,945,1300,479,607,466,693,42.1,44.1,40.2,00000
50.0,94.0,87.0,481,02,01,  Mehernagar,192,267,108,127,84,140,41.8,46.0,37.5,00000
50.0,94.0,87.0,481,03,01,  Mallikpur,223,302,104,155,119,147,42.5,40.2,44.7,00000
50.0,94.0,87.0,856,01,01,  Sadarpur,1566,1793,799,868,767,925,46.6,47.9,45.3,00000
50.0,94.0,87.0,856,02,01,  Katlamari(Part),681,601,335,300,346,301,53.1,52.8,53.5,00000
50.0,94.0,94.0,375,01,01,  Gobindapur,689,1042,366,518,323,524,39.8,41.4,38.1,00000
50.0,94.0,94.0,375,02,01,  Noda Gobindapur,752,732,385,374,367,358,50.7,50.7,50.6,00000
50.0,94.0,94.0,391,01,01,  Gopalpur,269,521,116,270,153,251,34.1,30.1,37.9,00000
50.0,94.0,94.0,391,02,01,  Noada Gopalpur,480,1026,239,500,241,526,31.9,32.3,31.4,00000
50.0,94.0,94.0,848,01,01,  Paschim Ranakhari,737,837,367,433,370,404,46.8,45.9,47.8,00000
50.0,94.0,94.0,848,02,01,  Ranakhaija Purba,508,795,270,412,238,383,39.0,39.6,38.3,00000
50.0,94.0,94.0,864,01,01,  Samukhia,553,968,295,501,258,467,36.4,37.1,35.6,00000
50.0,94.0,94.0,864,02,01,  Noada Samukhia,419,718,219,386,200,332,36.9,36.2,37.6,00000
50.0,94.0,94.0,978,01,01,  Talbaria,447,903,235,464,212,439,33.1,33.6,32.6,00000
50.0,94.0,94.0,978,02,01,  Noada Talbaria,318,585,150,295,168,290,35.2,33.7,36.7,00000
57.0,47.0,10.0,077,01,01,  Baliaghata,877,1329,409,666,468,663,39.8,38.0,41.4,00000
57.0,47.0,10.0,077,02,01,  Joraghat,325,510,172,244,153,266,38.9,41.3,36.5,00000
57.0,47.0,10.0,792,01,01,  Munda,433,715,225,364,208,351,37.7,38.2,37.2,00000
57.0,47.0,10.0,792,02,01,  Badia Para,836,702,439,328,397,374,54.4,57.2,51.5,00000
57.0,47.0,10.0,869,01,01,  Ramnagar,614,1485,283,724,331,761,29.3,28.1,30.3,00000
57.0,47.0,10.0,869,02,01,  Bholar Dair,83,130,39,67,44,63,39.0,36.8,41.1,00000
57.0,47.0,10.0,869,03,01,  Abhaynagar,88,322,41,154,47,168,21.5,21.0,21.9,00000
57.0,47.0,10.0,869,04,01,  Brajapur Ramnagar(Natunpa,331,536,162,283,169,253,38.2,36.4,40.0,00000
57.0,47.0,10.0,985,01,01,  Terail,1681,2815,819,1453,862,1362,37.4,36.0,38.8,00000
57.0,47.0,10.0,985,02,01,  Durlavpur,131,328,64,159,67,169,28.5,28.7,28.4,00000
57.0,47.0,21.0,173,01,01,  Bhat Para,290,553,134,282,156,271,34.4,32.2,36.5,00000
57.0,47.0,21.0,173,02,01,  Kharampur,459,463,209,237,250,226,49.8,46.9,52.5,00000
57.0,47.0,21.0,396,01,01,  Dhepa,356,630,166,323,190,307,36.1,33.9,38.2,00000
57.0,47.0,21.0,396,02,01,  Panga Shi Para,78,135,37,67,41,68,36.6,35.6,37.6,00000
57.0,47.0,21.0,444,01,01,  Garadob,1955,3027,970,1534,985,1493,39.2,38.7,39.7,00000
57.0,47.0,21.0,444,02,01,  Banshbaria,179,258,83,131,96,127,41.0,38.8,43.0,00000
57.0,47.0,21.0,618,01,01,  Kasba,1461,1916,743,951,718,965,43.3,43.9,42.7,00000
57.0,47.0,21.0,618,02,01,  Jalsuka,121,310,57,151,64,159,28.1,27.4,28.7,00000
57.0,47.0,21.0,676,01,01,  Kuchuikhali,443,386,223,208,220,178,53.4,51.7,55.3,00000
57.0,47.0,21.0,676,02,01,  Dighalkandi,291,426,147,212,144,214,40.6,40.9,40.2,00000
57.0,47.0,21.0,676,03,01,  Guchchhagram,55,165,19,85,36,80,25.0,18.3,31.0,00000
57.0,47.0,21.0,917,01,01,  Sanghat,416,800,195,423,221,377,34.2,31.6,37.0,00000
57.0,47.0,21.0,917,02,01,  Chandamari,269,792,136,392,133,400,25.4,25.8,25.0,00000
57.0,47.0,42.0,193,01,01,  Khar Mahal,416,936,204,486,212,450,30.8,29.6,32.0,00000
57.0,47.0,42.0,193,02,01,  Radha Gobindapur,740,1452,367,730,373,722,33.8,33.5,34.1,00000
57.0,47.0,42.0,193,03,01,  Lakshmi Narayanpur,579,941,281,476,298,465,38.1,37.1,39.1,00000
57.0,47.0,42.0,193,04,01,  Rangmohal,251,446,144,214,107,232,36.0,40.2,31.6,00000
57.0,47.0,42.0,434,01,01,  Garabaria,1905,1913,939,916,966,997,49.9,50.6,49.2,00000
57.0,47.0,42.0,434,02,01,  Ramkrishnapur,555,1293,301,629,254,664,30.0,32.4,27.7,00000
57.0,47.0,52.0,144,01,01,  Betbaria,1897,3440,953,1684,944,1756,35.5,36.1,35.0,00000
57.0,47.0,52.0,144,02,01,  Pirtala,1023,1609,500,730,523,879,38.9,40.7,37.3,00000
57.0,47.0,52.0,144,03,01,  Naoda Para,1243,1554,579,758,664,796,44.4,43.3,45.5,00000
57.0,47.0,52.0,144,04,01,  Guchogram,152,196,82,90,70,106,43.7,47.7,39.8,00000
57.0,47.0,52.0,473,01,01,  Harabhanga,2716,3641,1313,1703,1403,1938,42.7,43.5,42.0,00000
57.0,47.0,52.0,473,02,01,  Natun Brajapur,168,267,74,149,94,118,38.6,33.2,44.3,00000
57.0,47.0,52.0,647,01,01,  Kazipur,4303,6181,2118,2850,2185,3331,41.0,42.6,39.6,00000
57.0,47.0,52.0,647,02,01,  Sahebnagar,1051,1437,494,699,557,738,42.2,41.4,43.0,00000
57.0,47.0,52.0,647,03,01,  Brajapur,172,532,85,268,87,264,24.4,24.1,24.8,00000
57.0,47.0,63.0,521,01,01,  Hogalbaria,1823,2459,928,1193,895,1266,42.6,43.8,41.4,00000
57.0,47.0,63.0,521,02,01,  Shokorkandi,121,547,68,274,53,273,18.1,19.9,16.3,00000
57.0,47.0,63.0,666,01,01,  Kodalkati,1230,1038,618,511,612,527,54.2,54.7,53.7,00000
57.0,47.0,63.0,666,02,01,  Rajapur,506,582,291,271,215,311,46.5,51.8,40.9,00000
57.0,47.0,63.0,763,01,01,  Matmura,1139,1762,567,889,572,873,39.3,38.9,39.6,00000
57.0,47.0,63.0,763,02,01,  Nowda Matmura,915,1252,469,610,446,642,42.2,43.5,41.0,00000
57.0,47.0,69.0,483,01,01,  Hariadaha,581,1002,280,489,301,513,36.7,36.4,37.0,00000
57.0,47.0,69.0,483,02,01,  Gopalnagar,143,395,59,200,84,195,26.6,22.8,30.1,00000
57.0,47.0,69.0,598,01,01,  Karaigachhi,386,642,196,318,190,324,37.5,38.1,37.0,00000
57.0,47.0,69.0,598,02,01,  Jhor Para,283,425,153,212,130,213,40.0,41.9,37.9,00000
57.0,47.0,69.0,879,01,01,  Roypur,586,981,288,477,298,504,37.4,37.6,37.2,00000
57.0,47.0,69.0,879,02,01,  Bathan Para,361,501,177,240,184,261,41.9,42.4,41.3,00000
57.0,47.0,69.0,879,03,01,  Ikuri,198,364,100,173,98,191,35.2,36.6,33.9,00000
57.0,47.0,69.0,879,04,01,  Hemayetpur,730,749,378,386,352,363,49.4,49.5,49.2,00000
57.0,47.0,69.0,879,05,01,  Ruarkandi,86,82,43,39,43,43,51.2,52.4,50.0,00000
57.0,47.0,69.0,908,01,01,  Saldaha,776,719,372,368,404,351,51.9,50.3,53.5,00000
57.0,47.0,69.0,908,02,01,  Anandabas,96,212,36,113,60,99,31.2,24.2,37.7,00000
57.0,47.0,73.0,164,01,01,  Bhamradaha,1216,1352,637,628,579,724,47.4,50.4,44.4,00000
57.0,47.0,73.0,164,02,01,  Durladhpur,219,449,113,205,106,244,32.8,35.5,30.3,00000
57.0,47.0,73.0,502,01,01,  Hijalbaria,989,1355,462,650,527,705,42.2,41.5,42.8,00000
57.0,47.0,73.0,502,02,01,  Dharmachaki,200,277,102,126,98,151,41.9,44.7,39.4,00000
57.0,47.0,73.0,946,01,01,  Bansbaria,214,227,121,100,93,127,48.5,54.8,42.3,00000
57.0,47.0,73.0,946,02,01,  Shaharbari Colony,323,360,171,189,152,171,47.3,47.5,47.1,00000
57.0,47.0,73.0,946,03,01,  Shaharbari,2724,4069,1371,2018,1353,2051,40.1,40.5,39.7,00000
57.0,47.0,73.0,946,04,01,  Bhatpara,344,528,180,259,164,269,39.4,41.0,37.9,00000
57.0,47.0,73.0,946,05,01,  Shaharbati Guscchgram,32,72,16,41,16,31,30.8,28.1,34.0,00000
57.0,47.0,84.0,183,01,01,  Bholadanga,595,1098,284,558,311,540,35.1,33.7,36.5,00000
57.0,47.0,84.0,183,02,01,  Manikdi,126,202,56,97,70,105,38.4,36.6,40.0,00000
57.0,47.0,84.0,627,01,01,  Kastadaha,451,537,214,281,237,256,45.6,43.2,48.1,00000
57.0,47.0,84.0,627,02,01,  Maheshpur,435,476,208,232,227,244,47.7,47.3,48.2,00000
57.0,47.0,84.0,772,01,01,  Mina Para,563,531,291,260,272,271,51.5,52.8,50.1,00000
57.0,47.0,84.0,772,02,01,  Shimultala,416,628,207,304,209,324,39.8,40.5,39.2,00000
57.0,47.0,94.0,608,01,01,  Karamdi,3038,4268,1577,2009,1461,2259,41.6,44.0,39.3,00000
57.0,47.0,94.0,608,02,01,  Bharat,801,1412,397,697,404,715,36.2,36.3,36.1,00000
57.0,47.0,94.0,859,01,01,  Ramdebpur,480,687,246,321,234,366,41.1,43.4,39.0,00000
57.0,47.0,94.0,859,02,01,  Islampur,91,89,40,43,51,46,50.6,48.2,52.6,00000
57.0,47.0,94.0,859,03,01,  Garibpur,161,163,86,77,75,86,49.7,52.8,46.6,00000
57.0,47.0,94.0,975,01,01,  Tentulbaria,1281,2982,631,1469,650,1513,30.0,30.0,30.1,00000
57.0,47.0,94.0,975,02,01,  Palashi Para,648,1123,331,539,317,584,36.6,38.0,35.2,00000
57.0,47.0,94.0,975,03,01,  Mathurapur,306,496,152,244,154,252,38.2,38.4,37.9,00000
57.0,60.0,28.0,891,01,01,  Sonapur,1388,968,716,469,672,499,58.9,60.4,57.4,00000
57.0,60.0,28.0,891,02,01,  Najirakuna,960,738,492,371,468,367,56.5,57.0,56.0,00000
57.0,60.0,76.0,062,01,01,  Babupur,551,831,253,428,298,403,39.9,37.2,42.5,00000
57.0,60.0,76.0,062,02,01,  Paranpur,175,251,80,135,95,116,41.1,37.2,45.0,00000
57.0,60.0,76.0,621,01,01,  Mahajanpur,1860,2179,914,1086,946,1093,46.1,45.7,46.4,00000
57.0,60.0,76.0,621,02,01,  Kamarpur,79,135,46,71,33,64,36.9,39.3,34.0,00000
57.0,60.0,85.0,798,01,01,  Ramnagar,607,654,298,329,309,325,48.1,47.5,48.7,00000
57.0,60.0,85.0,798,02,01,  Gopalnagar,1102,1155,513,572,589,583,48.8,47.3,50.3,00000
57.0,87.0,14.0,020,01,01,  Amda,1251,2028,632,977,619,1051,38.2,39.3,37.1,00000
57.0,87.0,14.0,020,02,01,  Chak Shamnagar,1076,1629,508,827,568,802,39.8,38.1,41.5,00000
57.0,87.0,14.0,020,03,01,  Baman Para (Part),154,203,80,102,74,101,43.1,44.0,42.3,00000
57.0,87.0,14.0,051,01,01,  Ashrafpur,1326,2499,575,1258,751,1241,34.7,31.4,37.7,00000
57.0,87.0,14.0,051,02,01,  Chaltala Para,624,1104,277,558,347,546,36.1,33.2,38.9,00000
57.0,87.0,14.0,114,01,01,  Baman Para,612,1160,336,577,276,583,34.5,36.8,32.1,00000
57.0,87.0,14.0,114,02,01,  Bhandhar,858,832,439,406,419,426,50.8,52.0,49.6,00000
57.0,87.0,14.0,114,03,01,  Khondakar Para,770,1497,354,740,416,757,34.0,32.4,35.5,00000
57.0,87.0,14.0,114,04,01,  Roypur,1032,1603,478,816,554,787,39.2,36.9,41.3,00000
57.0,87.0,14.0,114,05,01,  Dafar Pur (Part),311,811,147,404,164,407,27.7,26.7,28.7,00000
57.0,87.0,14.0,114,06,01,  Baman Para Chalk,27,51,15,30,12,21,34.6,33.3,36.4,00000
57.0,87.0,14.0,176,01,01,  Bhabanandapur,121,495,57,225,64,270,19.6,20.2,19.2,00000
57.0,87.0,14.0,176,02,01,  Sahebpur,241,432,133,186,108,246,35.8,41.7,30.5,00000
57.0,87.0,14.0,176,03,01,  Islampur,776,1285,364,664,412,621,37.7,35.4,39.9,00000
57.0,87.0,14.0,176,04,01,  Tangarmari,865,1057,447,487,418,570,45.0,47.9,42.3,00000
57.0,87.0,19.0,010,01,01,  Alampur,1005,520,483,238,522,282,65.9,67.0,64.9,00000
57.0,87.0,19.0,010,02,01,  Dushar Para,230,170,120,82,110,88,57.5,59.4,55.6,00000
57.0,87.0,19.0,010,03,01,  Nutanmadnadanga(Part),126,85,58,43,68,42,59.7,57.4,61.8,00000
57.0,87.0,19.0,165,01,01,  Basantapur,303,379,148,193,155,186,44.4,43.4,45.5,00000
57.0,87.0,19.0,165,02,01,  Puratan Madnadanga,537,441,265,212,272,229,54.9,55.6,54.3,00000
57.0,87.0,19.0,165,03,01,  Gopalpur(Part),272,284,147,122,125,162,48.9,54.6,43.6,00000
57.0,87.0,19.0,342,01,01,  Kazipur Para,285,184,138,83,147,101,60.8,62.4,59.3,00000
57.0,87.0,19.0,342,02,01,  Beltalapara(Part),42,38,22,15,20,23,52.5,59.5,46.5,00000
57.0,87.0,19.0,404,01,01,  Gopalpur,720,411,340,190,380,221,63.7,64.2,63.2,00000
57.0,87.0,19.0,404,02,01,  Nutan Madnadanga(Part),750,417,353,202,397,215,64.3,63.6,64.9,00000
57.0,87.0,19.0,497,01,01,  Jhaubaria,1818,1240,905,578,913,662,59.5,61.0,58.0,00000
57.0,87.0,19.0,497,02,01,  Dighir Para,448,490,234,235,214,255,47.8,49.9,45.6,00000
57.0,87.0,19.0,570,01,01,  Khoksa,1457,1288,711,639,746,649,53.1,52.7,53.5,00000
57.0,87.0,19.0,570,02,01,  Kadamtalapara,273,191,133,86,140,105,58.8,60.7,57.1,00000
57.0,87.0,19.0,570,03,01,  Nutan Madnadanga(Part),76,46,30,23,46,23,62.3,56.6,66.7,00000
57.0,87.0,19.0,590,01,01,  Kola,1865,1581,945,745,920,836,54.1,55.9,52.4,00000
57.0,87.0,19.0,590,02,01,  Dafarpur,415,364,215,181,200,183,53.3,54.3,52.2,00000
57.0,87.0,19.0,766,01,01,  Raghunathpur,1152,821,603,395,549,426,58.4,60.4,56.3,00000
57.0,87.0,19.0,766,02,01,  Ashrayan Project,151,99,75,53,76,46,60.4,58.6,62.3,00000
57.0,87.0,19.0,808,01,01,  Ramnagar,236,302,114,138,122,164,43.9,45.2,42.7,00000
57.0,87.0,19.0,808,02,01,  Nutanmadnadanga(Part),412,308,201,151,211,157,57.2,57.1,57.3,00000
57.0,87.0,19.0,932,01,01,  Shyampur,2598,2586,1321,1208,1277,1378,50.1,52.2,48.1,00000
57.0,87.0,19.0,932,02,01,  Beltalapara,601,541,282,268,319,273,52.6,51.3,53.9,00000
57.0,87.0,38.0,134,01,01,  Barakpur,698,768,315,373,383,395,47.6,45.8,49.2,00000
57.0,87.0,38.0,134,02,01,  Rajapur,321,539,159,244,162,295,37.3,39.5,35.4,00000
57.0,87.0,38.0,145,01,01,  Baribaka,847,847,429,369,418,478,50.0,53.8,46.7,00000
57.0,87.0,38.0,145,02,01,  Salika,647,1124,321,532,326,592,36.5,37.6,35.5,00000
57.0,87.0,38.0,238,01,01,  Buripota,1211,1773,615,834,596,939,40.6,42.4,38.8,00000
57.0,87.0,38.0,238,02,01,  Bajitpur,352,460,183,211,169,249,43.3,46.4,40.4,00000
57.0,87.0,38.0,238,03,01,  Nabinnagar,63,78,30,39,33,39,44.7,43.5,45.8,00000
57.0,87.0,38.0,435,01,01,  Harirampur,937,1305,523,648,414,657,41.8,44.7,38.7,00000
57.0,87.0,38.0,435,02,01,  Jhaja,444,475,205,233,239,242,48.3,46.8,49.7,00000
57.0,87.0,57.0,601,01,01,  Kulberia,1450,1513,741,739,709,774,48.9,50.1,47.8,00000
57.0,87.0,57.0,601,02,01,  Baikanthapur,280,305,160,150,120,155,47.9,51.6,43.6,00000
57.0,87.0,57.0,611,01,01,  Kutubpur,1119,1427,558,669,561,758,44.0,45.5,42.5,00000
57.0,87.0,57.0,611,02,01,  Radhikanagar,135,338,69,174,66,164,28.5,28.4,28.7,00000
57.0,87.0,57.0,611,03,01,  Ramdaspur,843,750,451,340,392,410,52.9,57.0,48.9,00000
57.0,87.0,57.0,694,01,01,  Manoharpur,564,801,275,397,289,404,41.3,40.9,41.7,00000
57.0,87.0,57.0,694,02,01,  Nischintapur,206,271,99,125,107,146,43.2,44.2,42.3,00000
57.0,87.0,57.0,922,01,01,  Subidpur,1102,1134,538,520,564,614,49.3,50.9,47.9,00000
57.0,87.0,57.0,922,02,01,  Babur Para,253,369,120,174,133,195,40.7,40.8,40.5,00000
57.0,87.0,57.0,922,03,01,  Sisispara,296,599,147,269,149,330,33.1,35.3,31.1,00000
57.0,87.0,95.0,082,01,01,  Baliarpur,1797,2227,851,1154,946,1073,44.7,42.4,46.9,00000
57.0,87.0,95.0,082,02,01,  Gaharpur,754,899,398,439,356,460,45.6,47.6,43.6,00000
57.0,87.0,95.0,124,01,01,  Baradi,385,423,223,225,162,198,47.6,49.8,45.0,00000
57.0,87.0,95.0,124,02,01,  Mominpur,744,987,375,493,369,494,43.0,43.2,42.8,00000
57.0,87.0,95.0,124,03,01,  Patkelpota,438,691,196,361,242,330,38.8,35.2,42.3,00000
57.0,87.0,95.0,155,01,01,  Barshibari,705,774,345,385,360,389,47.7,47.3,48.1,00000
57.0,87.0,95.0,155,02,01,  Hasnabad,425,750,228,368,197,382,36.2,38.3,34.0,00000
57.0,87.0,95.0,735,01,01,  Pirojpur,4251,5296,2122,2626,2129,2670,44.5,44.7,44.4,00000
57.0,87.0,95.0,735,02,01,  Noorpur,371,685,197,355,174,330,35.1,35.7,34.5,00000
57.0,87.0,95.0,746,01,01,  Puran Darbeshpur,390,386,195,204,195,182,50.3,48.9,51.7,00000
57.0,87.0,95.0,746,02,01,  Chandpur,363,409,192,204,171,205,47.0,48.5,45.5,00000
57.0,87.0,95.0,880,01,01,  Singhati,596,780,298,406,298,374,43.3,42.3,44.3,00000
57.0,87.0,95.0,880,02,01,  Purbapara,448,795,204,399,244,396,36.0,33.8,38.1,00000
57.0,87.0,95.0,880,03,01,  Shimultala,134,457,67,236,67,221,22.7,22.1,23.3,00000
87.0,4.0,15.0,025,01,01,  Anulia,751,878,436,414,315,464,46.1,51.3,40.4,00000
87.0,4.0,15.0,025,02,01,  Nayakhali,104,180,67,86,37,94,36.6,43.8,28.2,00000
87.0,4.0,15.0,113,01,01,  Chenchua,498,410,276,182,222,228,54.8,60.3,49.3,00000
87.0,4.0,15.0,113,02,01,  Jaliakhali,260,242,137,120,123,122,51.8,53.3,50.2,00000
87.0,4.0,15.0,321,01,01,  Uttar Eksara,1029,1288,555,591,474,697,44.4,48.4,40.5,00000
87.0,4.0,15.0,321,02,01,  Madhya Eksara,772,979,402,465,370,514,44.1,46.4,41.9,00000
87.0,4.0,15.0,692,01,01,  Manipur,495,601,272,263,223,338,45.2,50.8,39.8,00000
87.0,4.0,15.0,692,02,01,  Ghustia (Khalia),243,213,155,85,88,128,53.3,64.6,40.7,00000
87.0,4.0,15.0,831,01,01,  Rajapur,770,1446,395,653,375,793,34.7,37.7,32.1,00000
87.0,4.0,15.0,831,02,01,  Gorali,268,157,155,68,113,89,63.1,69.5,55.9,00000
87.0,4.0,15.0,957,01,01,  Bagali,179,273,95,111,84,162,39.6,46.1,34.1,00000
87.0,4.0,15.0,957,02,01,  Atali,90,77,37,30,53,47,53.9,55.2,53.0,00000
87.0,4.0,15.0,957,03,01,  Kuitar Bil,55,40,35,11,20,29,57.9,76.1,40.8,00000
87.0,4.0,15.0,957,04,01,  Hamder Kunia,16,11,8,6,8,5,59.3,57.1,61.5,00000
87.0,4.0,17.0,037,01,03,  Assasuni,3260,1903,1827,804,1433,1099,63.1,69.4,56.6,00000
87.0,4.0,17.0,037,02,03,  Manikhali,265,146,141,59,124,87,64.5,70.5,58.8,00000
87.0,4.0,17.0,037,03,03,  Jelekhali,132,137,75,66,57,71,49.1,53.2,44.5,00000
87.0,4.0,17.0,037,04,03,  Doyerghat,40,28,22,9,18,19,58.8,71.0,48.6,00000
87.0,4.0,17.0,037,05,03,  Gucchhagram,81,203,41,93,40,110,28.5,30.6,26.7,00000
87.0,4.0,17.0,289,01,01,  Daserati,120,168,74,62,46,106,41.7,54.4,30.3,00000
87.0,4.0,17.0,289,02,01,  Khaserabad,251,269,144,108,107,161,48.3,57.1,39.9,00000
87.0,4.0,17.0,295,01,01,  Kuri Kahania,153,10,74,4,79,6,93.9,94.9,92.9,00000
87.0,4.0,17.0,295,02,01,  Dhanyahati,596,156,328,46,268,110,79.3,87.7,70.9,00000
87.0,4.0,17.0,295,03,01,  Sodkona,740,413,378,184,362,229,64.2,67.3,61.3,00000
87.0,4.0,17.0,302,01,01,  Durgapur,697,642,380,280,317,362,52.1,57.6,46.7,00000
87.0,4.0,17.0,302,02,01,  Bolabaria,544,589,355,216,189,373,48.0,62.2,33.6,00000
87.0,4.0,17.0,302,03,01,  Thakurabad,203,130,126,44,77,86,61.0,74.1,47.2,00000
87.0,4.0,17.0,302,04,01,  Haskhali,282,182,168,71,114,111,60.8,70.3,50.7,00000
87.0,4.0,17.0,428,01,01,  Hanribhanga,614,322,338,138,276,184,65.6,71.0,60.0,00000
87.0,4.0,17.0,428,02,01,  Natana,637,339,353,132,284,207,65.3,72.8,57.8,00000
87.0,4.0,17.0,591,01,01,  Kodanda,1087,500,578,204,509,296,68.5,73.9,63.2,00000
87.0,4.0,17.0,591,02,01,  Gaiyakhali,277,88,156,26,121,62,75.9,85.7,66.1,00000
87.0,4.0,25.0,107,01,01,  Baradal Bazar,411,228,224,92,187,136,64.3,70.9,57.9,00000
87.0,4.0,25.0,107,02,01,  Uttarpara,570,509,305,221,265,288,52.8,58.0,47.9,00000
87.0,4.0,25.0,107,03,01,  Dakshinpara,977,968,567,419,410,549,50.2,57.5,42.8,00000
87.0,4.0,25.0,107,04,01,  Christian Para,204,292,137,111,67,181,41.1,55.2,27.0,00000
87.0,4.0,25.0,107,05,01,  Madhyapara,1038,1275,578,557,460,718,44.9,50.9,39.0,00000
87.0,4.0,25.0,107,06,01,  Pachpota,168,140,105,57,63,83,54.5,64.8,43.2,00000
87.0,4.0,25.0,207,01,01,  Baintala,1084,666,635,248,449,418,61.9,71.9,51.8,00000
87.0,4.0,25.0,207,02,01,  Gatir Mahal,222,285,129,142,93,143,43.8,47.6,39.4,00000
87.0,4.0,25.0,245,01,01,  Champakhali,114,137,77,50,37,87,45.4,60.6,29.8,00000
87.0,4.0,25.0,245,02,01,  Goaldanga,1705,1633,980,741,725,892,51.1,56.9,44.8,00000
87.0,4.0,25.0,245,03,01,  Kheruadanga,276,118,136,58,140,60,70.1,70.1,70.0,00000
87.0,4.0,25.0,333,01,01,  Fakrabad,1375,1047,760,401,615,646,56.8,65.5,48.8,00000
87.0,4.0,25.0,333,02,01,  Madia,416,275,262,92,154,183,60.2,74.0,45.7,00000
87.0,4.0,25.0,333,03,01,  Murarikati,76,42,44,16,32,26,64.4,73.3,55.2,00000
87.0,4.0,25.0,333,04,01,  Kadamtala,81,34,44,11,37,23,70.4,80.0,61.7,00000
87.0,4.0,25.0,333,05,01,  Lakshmikhola,78,64,44,28,34,36,54.9,61.1,48.6,00000
87.0,4.0,25.0,333,06,01,  Hetalbunia,449,288,261,101,188,187,60.9,72.1,50.1,00000
87.0,4.0,25.0,333,07,01,  Jelputia,388,267,241,104,147,163,59.2,69.9,47.4,00000
87.0,4.0,25.0,554,01,01,  Kearganti,259,506,139,239,120,267,33.9,36.8,31.0,00000
87.0,4.0,25.0,554,02,01,  Dumurpota,396,588,218,260,178,328,40.2,45.6,35.2,00000
87.0,4.0,25.0,554,03,01,  Nurerabad,215,113,133,29,82,84,65.5,82.1,49.4,00000
87.0,4.0,34.0,132,01,01,  Bausali,175,234,101,109,74,125,42.8,48.1,37.2,00000
87.0,4.0,34.0,132,02,01,  Buror Chak,21,17,14,6,7,11,55.3,70.0,38.9,00000
87.0,4.0,34.0,132,03,01,  Tuskhali,59,75,39,31,20,44,44.0,55.7,31.3,00000
87.0,4.0,34.0,138,01,01,  Beula,946,1323,514,621,432,702,41.7,45.3,38.1,00000
87.0,4.0,34.0,138,02,01,  Lambadanga,412,428,229,188,183,240,49.0,54.9,43.3,00000
87.0,4.0,34.0,258,01,01,  Chapra,2146,1988,1168,883,978,1105,51.9,56.9,47.0,00000
87.0,4.0,34.0,258,02,01,  Jhatikata,35,79,17,38,18,41,30.7,30.9,30.5,00000
87.0,4.0,34.0,258,03,01,  Ramdebkati,148,180,97,74,51,106,45.1,56.7,32.5,00000
87.0,4.0,34.0,673,01,01,  Maheswar Kati,268,218,143,105,125,113,55.1,57.7,52.5,00000
87.0,4.0,34.0,673,02,01,  Narayanpur,30,72,16,34,14,38,29.4,32.0,26.9,00000
87.0,4.0,34.0,787,01,01,  Paithali,803,603,437,283,366,320,57.1,60.7,53.4,00000
87.0,4.0,34.0,787,02,01,  Padma Beula,568,575,316,286,252,289,49.7,52.5,46.6,00000
87.0,4.0,34.0,787,03,01,  Chila Dangal,188,187,103,89,85,98,50.1,53.6,46.4,00000
87.0,4.0,34.0,787,04,01,  Hajidanga,96,195,35,110,61,85,33.0,24.1,41.8,00000
87.0,4.0,43.0,453,01,01,  Hossainpur,348,321,204,129,144,192,52.0,61.3,42.9,00000
87.0,4.0,43.0,453,02,01,  Jhaubania,64,40,43,13,21,27,61.5,76.8,43.8,00000
87.0,4.0,43.0,919,01,01,  Sreedharpur,865,949,470,392,395,557,47.7,54.5,41.5,00000
87.0,4.0,43.0,919,02,01,  Khashbagan,397,467,216,184,181,283,45.9,54.0,39.0,00000
87.0,4.0,43.0,919,03,01,  Sonai,173,112,109,36,64,76,60.7,75.2,45.7,00000
87.0,4.0,56.0,497,01,01,  Kadakati,1585,1581,863,719,722,862,50.1,54.6,45.6,00000
87.0,4.0,56.0,497,02,01,  Purba Kadakati,448,209,261,72,187,137,68.2,78.4,57.7,00000
87.0,4.0,56.0,497,03,01,  Jadurdanga,585,308,350,109,235,199,65.5,76.3,54.1,00000
87.0,4.0,56.0,497,04,01,  Tengrakhali,344,175,202,57,142,118,66.3,78.0,54.6,00000
87.0,4.0,56.0,497,05,01,  Karchakhali,153,66,85,21,68,45,69.9,80.2,60.2,00000
87.0,4.0,56.0,717,01,01,  Tentulia Mitra,375,397,204,185,171,212,48.6,52.4,44.6,00000
87.0,4.0,56.0,717,02,01,  Mokamkhali,296,305,164,139,132,166,49.3,54.1,44.3,00000
87.0,4.0,56.0,717,03,01,  Shanagar,151,78,81,34,70,44,65.9,70.4,61.4,00000
87.0,4.0,56.0,837,01,01,  Ramchandra Pur Teka,107,229,52,103,55,126,31.8,33.5,30.4,00000
87.0,4.0,56.0,837,02,01,  Balabunia,72,93,35,44,37,49,43.6,44.3,43.0,00000
87.0,4.0,60.0,226,01,01,  Toardanga,1604,1220,910,470,694,750,56.8,65.9,48.1,00000
87.0,4.0,60.0,226,02,01,  Hetalkhali,136,218,74,103,62,115,38.4,41.8,35.0,00000
87.0,4.0,60.0,226,03,01,  Morarikati,60,62,36,20,24,42,49.2,64.3,36.4,00000
87.0,4.0,60.0,358,01,01,  Gadaipur,1298,2176,723,979,575,1197,37.4,42.5,32.4,00000
87.0,4.0,60.0,358,02,01,  Surerabad,104,91,70,31,34,60,53.3,69.3,36.2,00000
87.0,4.0,60.0,358,03,01,  Ghughumari,94,84,55,30,39,54,52.8,64.7,41.9,00000
87.0,4.0,60.0,358,04,01,  Katamari,64,82,39,31,25,51,43.8,55.7,32.9,00000
87.0,4.0,60.0,358,05,01,  Telikhali,33,34,21,15,12,19,49.3,58.3,38.7,00000
87.0,4.0,60.0,358,06,01,  Chargharia,14,14,6,7,8,7,50.0,46.2,53.3,00000
87.0,4.0,60.0,547,01,01,  Kapsanda,852,1329,453,594,399,735,39.1,43.3,35.2,00000
87.0,4.0,60.0,547,02,01,  Choatua,890,1121,457,499,433,622,44.3,47.8,41.0,00000
87.0,4.0,60.0,547,03,01,  Parikamari,271,209,155,68,116,141,56.5,69.5,45.1,00000
87.0,4.0,60.0,547,04,01,  Noabad,70,87,45,39,25,48,44.6,53.6,34.2,00000
87.0,4.0,60.0,547,05,01,  Phatak Khali,482,379,304,132,178,247,56.0,69.7,41.9,00000
87.0,4.0,60.0,547,06,01,  Deabania,135,218,83,97,52,121,38.2,46.1,30.1,00000
87.0,4.0,60.0,560,01,01,  Khajra,1129,1707,627,781,502,926,39.8,44.5,35.2,00000
87.0,4.0,60.0,560,02,01,  Goaldanga,76,77,43,28,33,49,49.7,60.6,40.2,00000
87.0,4.0,60.0,850,01,01,  Rautara,573,751,300,327,273,424,43.3,47.8,39.2,00000
87.0,4.0,60.0,850,02,01,  Gajuakati,467,81,269,20,198,61,85.2,93.1,76.4,00000
87.0,4.0,60.0,850,03,01,  Khalea,965,761,555,310,410,451,55.9,64.2,47.6,00000
87.0,4.0,69.0,352,01,01,  Bashirabad,40,60,23,30,17,30,40.0,43.4,36.2,00000
87.0,4.0,69.0,352,02,01,  Banshtala,60,80,36,38,24,42,42.9,48.6,36.4,00000
87.0,4.0,69.0,352,03,01,  Gabtala,292,335,171,140,121,195,46.6,55.0,38.3,00000
87.0,4.0,69.0,352,04,01,  Katakhali,393,363,209,162,184,201,52.0,56.3,47.8,00000
87.0,4.0,69.0,491,01,01,  Kachua,936,1310,524,632,412,678,41.7,45.3,37.8,00000
87.0,4.0,69.0,491,02,01,  Hamkura,495,594,264,280,231,314,45.5,48.5,42.4,00000
87.0,4.0,77.0,233,01,01,  Chakla,1082,768,534,395,548,373,58.5,57.5,59.5,00000
87.0,4.0,77.0,233,02,01,  Chaubaria,24,15,13,8,11,7,61.5,61.9,61.1,00000
87.0,4.0,77.0,233,03,01,  Diglarati,575,489,322,238,253,251,54.0,57.5,50.2,00000
87.0,4.0,77.0,233,04,01,  Subhadrakati,468,419,238,187,230,232,52.8,56.0,49.8,00000
87.0,4.0,77.0,233,05,01,  Ruar Bil,199,685,96,343,103,342,22.5,21.9,23.1,00000
87.0,4.0,77.0,806,01,01,  Pratap Nagar,2516,2818,1245,1309,1271,1509,47.2,48.7,45.7,00000
87.0,4.0,77.0,806,02,01,  Madarbaria,124,292,59,149,65,143,29.8,28.4,31.3,00000
87.0,4.0,77.0,806,03,01,  Dargatala,239,283,119,148,120,135,45.8,44.6,47.1,00000
87.0,4.0,86.0,044,01,01,  Badartala,380,255,229,98,151,157,59.8,70.0,49.0,00000
87.0,4.0,86.0,044,02,01,  Basirampur,389,274,219,117,170,157,58.7,65.2,52.0,00000
87.0,4.0,86.0,044,03,01,  Majgurkhali,701,192,381,60,320,132,78.5,86.4,70.8,00000
87.0,4.0,86.0,044,04,01,  Putimari,146,93,85,44,61,49,61.1,65.9,55.5,00000
87.0,4.0,86.0,094,01,01,  Bankra,1479,1237,784,566,695,671,54.5,58.1,50.9,00000
87.0,4.0,86.0,094,02,01,  Baladanga,87,79,38,38,49,41,52.4,50.0,54.4,00000
87.0,4.0,86.0,100,01,01,  Bantra,539,292,263,132,276,160,64.9,66.6,63.3,00000
87.0,4.0,86.0,100,02,01,  Chandidaha,123,115,63,59,60,56,51.7,51.6,51.7,00000
87.0,4.0,86.0,220,01,01,  Sankar Manibhola,46,30,29,14,17,16,60.5,67.4,51.5,00000
87.0,4.0,86.0,220,02,01,  Latakhali,66,131,35,66,31,65,33.5,34.7,32.3,00000
87.0,4.0,86.0,220,03,01,  Balabunia,30,47,16,24,14,23,39.0,40.0,37.8,00000
87.0,4.0,86.0,535,01,01,  Kamalkati,1133,964,636,413,497,551,54.0,60.6,47.4,00000
87.0,4.0,86.0,535,02,01,  Kaikhali,121,82,75,37,46,45,59.6,67.0,50.5,00000
87.0,4.0,86.0,535,03,01,  Sener Chak,50,86,29,46,21,40,36.8,38.7,34.4,00000
87.0,4.0,86.0,535,04,01,  Basukhali,845,642,468,304,377,338,56.8,60.6,52.7,00000
87.0,4.0,94.0,365,01,01,  Baladanga,250,197,117,75,133,122,55.9,60.9,52.2,00000
87.0,4.0,94.0,365,02,01,  Gazipur,667,555,360,260,307,295,54.6,58.1,51.0,00000
87.0,4.0,94.0,365,03,01,  Kakrabunia,500,536,262,276,238,260,48.3,48.7,47.8,00000
87.0,4.0,94.0,705,01,01,  Bara Karati,597,427,337,175,260,252,58.3,65.8,50.8,00000
87.0,4.0,94.0,705,02,01,  Naktara,721,722,387,318,334,404,50.0,54.9,45.3,00000
87.0,4.0,94.0,705,03,01,  Bakchar,789,376,431,172,358,204,67.7,71.5,63.7,00000
87.0,4.0,94.0,705,04,01,  Thanghata,388,8,205,2,183,6,98.0,99.0,96.8,00000
87.0,4.0,94.0,705,05,01,  Dalir Char,279,194,177,73,102,121,59.0,70.8,45.7,00000
87.0,4.0,94.0,705,06,01,  Bil Bakchar,306,196,180,75,126,121,61.0,70.6,51.0,00000
87.0,4.0,94.0,705,07,01,  Mariala,764,799,438,365,326,434,48.9,54.5,42.9,00000
87.0,4.0,94.0,705,08,01,  Hajrakhali,214,164,118,80,96,84,56.6,59.6,53.3,00000
87.0,4.0,94.0,705,09,01,  Bilthanaghata,103,24,61,6,42,18,81.1,91.0,70.0,00000
87.0,4.0,94.0,755,01,01,  Nangal Daria,672,269,343,117,329,152,71.4,74.6,68.4,00000
87.0,4.0,94.0,755,02,01,  Radharati,406,174,214,67,192,107,70.0,76.2,64.2,00000
87.0,4.0,94.0,755,03,01,  Baliakhali,507,133,278,55,229,78,79.2,83.5,74.6,00000
87.0,4.0,94.0,944,01,01,  Sreeula,2024,1255,1113,566,911,689,61.7,66.3,56.9,00000
87.0,4.0,94.0,944,02,01,  Boysin,237,85,131,30,106,55,73.6,81.4,65.8,00000
87.0,4.0,94.0,944,03,01,  Lakshmikhali,224,83,130,28,94,55,73.0,82.3,63.1,00000
87.0,25.0,15.0,446,01,01,  Ghalghalia Rahimpur,714,439,337,183,377,256,61.9,64.8,59.6,00000
87.0,25.0,15.0,446,02,01,  Gopakhali,261,190,143,76,118,114,57.9,65.3,50.9,00000
87.0,25.0,15.0,446,03,01,  Char Rahimpur,255,312,127,135,128,177,45.0,48.5,42.0,00000
87.0,25.0,15.0,446,04,01,  Rahimpur,123,136,68,56,55,80,47.5,54.8,40.7,00000
87.0,25.0,15.0,960,01,01,  Town Sreepur,819,564,425,241,394,323,59.2,63.8,55.0,00000
87.0,25.0,15.0,960,02,01,  Char Sreepur,322,250,167,109,155,141,56.3,60.5,52.4,00000
87.0,25.0,31.0,068,01,01,  Bahera,2022,1756,1063,785,959,971,53.5,57.5,49.7,00000
87.0,25.0,31.0,068,02,01,  Kashkamar,685,392,353,190,332,202,63.6,65.0,62.2,00000
87.0,25.0,31.0,068,03,01,  Baliadanga,797,677,410,309,387,368,54.1,57.0,51.3,00000
87.0,25.0,31.0,068,04,01,  Herar Chak,177,110,93,55,84,55,61.7,62.8,60.4,00000
87.0,25.0,31.0,068,05,01,  Nalbalia,17,9,8,4,9,5,65.4,66.7,64.3,00000
87.0,25.0,31.0,068,06,01,  Kultala,26,8,17,6,9,2,76.5,73.9,81.8,00000
87.0,25.0,31.0,102,01,01,  Char Balitha,244,492,118,236,126,256,33.2,33.3,33.0,00000
87.0,25.0,31.0,102,02,01,  Gobbakhali,109,174,56,90,53,84,38.5,38.4,38.7,00000
87.0,25.0,31.0,154,01,01,  Bil Shimulbaria,113,207,62,107,51,100,35.3,36.7,33.8,00000
87.0,25.0,31.0,154,02,01,  Barbaria,22,27,18,14,4,13,44.9,56.3,23.5,00000
87.0,25.0,31.0,248,01,01,  Kadamkhali,160,312,91,131,69,181,33.9,41.0,27.6,00000
87.0,25.0,31.0,248,02,01,  Shashdanga,454,418,246,190,208,228,52.1,56.4,47.7,00000
87.0,25.0,31.0,248,03,01,  Kurimari,51,13,29,1,22,12,79.7,96.7,64.7,00000
87.0,25.0,31.0,248,04,01,  Bannapota,135,80,68,36,67,44,62.8,65.4,60.4,00000
87.0,25.0,31.0,514,01,01,  Hijaldanga,267,236,154,90,113,146,53.1,63.1,43.6,00000
87.0,25.0,31.0,514,02,01,  Rajaram,77,28,50,10,27,18,73.3,83.3,60.0,00000
87.0,25.0,31.0,634,01,01,  Kulia (Uttar),1259,894,672,407,587,487,58.5,62.3,54.7,00000
87.0,25.0,31.0,634,02,01,  Dattadanga,135,171,87,78,48,93,44.1,52.7,34.0,00000
87.0,25.0,31.0,634,03,01,  Kamot Para,52,49,28,22,24,27,51.5,56.0,47.1,00000
87.0,25.0,31.0,634,04,01,  Nankhola,133,122,78,54,55,68,52.2,59.1,44.7,00000
87.0,25.0,31.0,634,05,01,  Putimari,943,637,535,284,408,353,59.7,65.3,53.6,00000
87.0,25.0,31.0,634,06,01,  Dakshin Kulia,1512,1014,755,483,757,531,59.9,61.0,58.8,00000
87.0,25.0,31.0,634,07,01,  Purba Kula,743,523,422,220,321,303,58.7,65.7,51.4,00000
87.0,25.0,31.0,840,01,01,  Raghunathpur,441,392,256,165,185,227,52.9,60.8,44.9,00000
87.0,25.0,31.0,840,02,01,  Tiket,1027,748,579,306,448,442,57.9,65.4,50.3,00000
87.0,25.0,31.0,857,01,01,  Ramnagar,92,112,45,51,47,61,45.1,46.9,43.5,00000
87.0,25.0,31.0,857,02,01,  Dalirger,115,121,62,62,53,59,48.7,50.0,47.3,00000
87.0,25.0,31.0,857,03,01,  Andulpota,161,120,91,56,70,64,57.3,61.9,52.2,00000
87.0,25.0,31.0,857,04,01,  Shyamnagar,178,199,111,78,67,121,47.2,58.7,35.6,00000
87.0,25.0,47.0,110,01,01,  Jagannathpur,1978,1340,1029,608,949,732,59.6,62.9,56.5,00000
87.0,25.0,47.0,110,02,01,  Paik Para,83,78,43,45,40,33,51.6,48.9,54.8,00000
87.0,25.0,47.0,110,03,01,  Atshatti Bigha,139,172,81,80,58,92,44.7,50.3,38.7,00000
87.0,25.0,47.0,110,04,01,  Kamkatia,152,110,87,51,65,59,58.0,63.0,52.4,00000
87.0,25.0,47.0,257,01,01,  Chandpur,602,803,324,356,278,447,42.8,47.6,38.3,00000
87.0,25.0,47.0,257,02,01,  Harerati,16,33,10,16,6,17,32.7,38.5,26.1,00000
87.0,25.0,47.0,497,01,01,  Bijarati,567,498,324,221,243,277,53.2,59.4,46.7,00000
87.0,25.0,47.0,497,02,01,  Hadipur,903,694,502,302,401,392,56.5,62.4,50.6,00000
87.0,25.0,47.0,874,01,01,  Ramnathpur,780,447,417,181,363,266,63.6,69.7,57.7,00000
87.0,25.0,47.0,874,02,01,  Maji Para,161,58,82,23,79,35,73.5,78.1,69.3,00000
87.0,25.0,47.0,874,03,01,  Shimulia,744,616,382,284,362,332,54.7,57.4,52.2,00000
87.0,25.0,47.0,874,04,01,  Mathi Para,154,102,89,42,65,60,60.2,67.9,52.0,00000
87.0,25.0,47.0,874,05,01,  Shanbaria,458,435,254,172,204,263,51.3,59.6,43.7,00000
87.0,25.0,47.0,874,06,01,  Pukur Para,59,49,29,23,30,26,54.6,55.8,53.6,00000
87.0,25.0,47.0,874,07,01,  Goranbaria,359,495,189,234,170,261,42.0,44.7,39.4,00000
87.0,25.0,47.0,874,08,01,  Barohola,100,69,51,30,49,39,59.2,63.0,55.7,00000
87.0,25.0,47.0,874,09,01,  Khat Mahal,87,65,42,35,45,30,57.2,54.5,60.0,00000
87.0,25.0,47.0,874,10,01,  Kala Baria,312,340,169,151,143,189,47.9,52.8,43.1,00000
87.0,25.0,47.0,874,11,01,  Kameni Basu,74,211,37,117,37,94,26.0,24.0,28.2,00000
87.0,25.0,47.0,874,12,01,  Dhapu Khali,143,281,69,136,74,145,33.7,33.7,33.8,00000
87.0,25.0,63.0,600,01,01,  Uttar Kumarpur,1370,1224,725,576,645,648,52.8,55.7,49.9,00000
87.0,25.0,63.0,600,02,01,  Dakshin Kumarpur,393,427,212,198,181,229,47.9,51.7,44.1,00000
87.0,25.0,63.0,806,01,01,  Uttar Parulia,1434,1517,767,713,667,804,48.6,51.8,45.3,00000
87.0,25.0,63.0,806,02,01,  Sikandara,592,832,294,404,298,428,41.6,42.1,41.0,00000
87.0,25.0,63.0,806,03,01,  Gariadanga,346,646,170,321,176,325,34.9,34.6,35.1,00000
87.0,25.0,63.0,806,04,01,  Majh Parulia,1452,1358,766,629,686,729,51.7,54.9,48.5,00000
87.0,25.0,63.0,806,05,01,  Fulbari,207,169,118,75,89,94,55.1,61.1,48.6,00000
87.0,25.0,63.0,806,06,01,  Khas Para,436,370,204,180,232,190,54.1,53.1,55.0,00000
87.0,25.0,63.0,806,07,01,  Khajurbaria,1500,1241,798,571,702,670,54.7,58.3,51.2,00000
87.0,25.0,63.0,806,08,01,  Nischintapur,74,307,37,144,37,163,19.4,20.4,18.5,00000
87.0,25.0,63.0,806,09,01,  Boysa,16,6,5,4,11,2,72.7,55.6,84.6,00000
87.0,25.0,63.0,806,10,01,  Char Kuni,129,141,61,64,68,77,47.8,48.8,46.9,00000
87.0,25.0,63.0,806,11,01,  Norar Chak,396,396,239,176,157,220,50.0,57.6,41.6,00000
87.0,25.0,63.0,806,12,01,  Guchchhagram,101,259,38,124,63,135,28.1,23.5,31.8,00000
87.0,25.0,63.0,806,13,01,  Nazirerghar,532,295,304,123,228,172,64.3,71.2,57.0,00000
87.0,25.0,63.0,806,14,01,  Bara Shanta,307,219,174,87,133,132,58.4,66.7,50.2,00000
87.0,25.0,63.0,806,15,01,  Chhota Shanta,209,136,115,68,94,68,60.6,62.8,58.0,00000
87.0,25.0,63.0,806,16,01,  Chaltatala,293,578,147,280,146,298,33.6,34.4,32.9,00000
87.0,25.0,63.0,806,17,01,  Khalsha Kali Char,130,203,61,109,69,94,39.0,35.9,42.3,00000
87.0,25.0,63.0,806,18,01,  Ranga Shisha,166,79,103,23,63,56,67.8,81.7,52.9,00000
87.0,25.0,63.0,806,19,01,  Kaikhali,52,51,30,21,22,30,50.5,58.8,42.3,00000
87.0,25.0,63.0,806,20,01,  Ghariadanga,96,391,46,196,50,195,19.7,19.0,20.4,00000
87.0,25.0,63.0,806,21,01,  Khariadanga,25,53,15,24,10,29,32.1,38.5,25.6,00000
87.0,25.0,63.0,806,22,01,  Basirabad,38,96,21,47,17,49,28.4,30.9,25.8,00000
87.0,25.0,63.0,806,23,01,  Patakhali,52,50,27,25,25,25,51.0,51.9,50.0,00000
87.0,25.0,63.0,806,24,01,  Dakshin Parulia,2759,2058,1503,926,1256,1132,57.3,61.9,52.6,00000
87.0,25.0,63.0,806,25,01,  Palgada,166,137,86,69,80,68,54.8,55.5,54.1,00000
87.0,25.0,63.0,806,26,01,  Shak Rasel Nagar,554,747,283,392,271,355,42.6,41.9,43.3,00000
87.0,25.0,79.0,240,01,01,  Chandipur,605,312,318,144,287,168,66.0,68.8,63.1,00000
87.0,25.0,79.0,240,02,01,  Magri,613,166,317,69,296,97,78.7,82.1,75.3,00000
87.0,25.0,79.0,686,01,01,  Mahmud Alipur,400,297,200,149,200,148,57.4,57.3,57.5,00000
87.0,25.0,79.0,686,02,01,  Chinadanga,522,377,295,165,227,212,58.1,64.1,51.7,00000
87.0,25.0,79.0,909,01,01,  Uttar Sakhipur,2190,1076,1163,471,1027,605,67.1,71.2,62.9,00000
87.0,25.0,79.0,909,02,01,  Majh Sakhipur,1558,981,852,424,706,557,61.4,66.8,55.9,00000
87.0,25.0,79.0,909,03,01,  Dakshin Sakhipur,930,738,491,348,439,390,55.8,58.5,53.0,00000
87.0,25.0,79.0,909,04,01,  Kamta,423,479,215,222,208,257,46.9,49.2,44.7,00000
87.0,25.0,79.0,909,05,01,  Kazi Mahallah,273,216,147,93,126,123,55.8,61.3,50.6,00000
87.0,43.0,13.0,127,01,01,  Bikrampur,540,363,274,169,266,194,59.8,61.9,57.8,00000
87.0,43.0,13.0,127,02,01,  Bayerdanga,412,425,197,198,215,227,49.2,49.9,48.6,00000
87.0,43.0,13.0,161,01,01,  Chandanpur,1276,1091,641,509,635,582,53.9,55.7,52.2,00000
87.0,43.0,13.0,161,02,01,  Kadpur,893,1422,464,654,429,768,38.6,41.5,35.8,00000
87.0,43.0,31.0,263,01,01,  Digang  Uttar,690,791,343,377,347,414,46.6,47.6,45.6,00000
87.0,43.0,31.0,263,02,01,  Digang Dakshin,531,631,263,307,268,324,45.7,46.1,45.3,00000
87.0,43.0,31.0,289,01,01,  Ganapatipur,555,700,292,323,263,377,44.2,47.5,41.1,00000
87.0,43.0,31.0,289,02,01,  Cheraghat,315,429,158,205,157,224,42.3,43.5,41.2,00000
87.0,43.0,31.0,952,01,01,  Subhankar Kati,567,598,282,277,285,321,48.7,50.4,47.0,00000
87.0,43.0,31.0,952,02,01,  Kotabari,323,565,169,282,154,283,36.4,37.5,35.2,00000
87.0,43.0,31.0,952,03,01,  Gaog,215,331,120,153,95,178,39.4,44.0,34.8,00000
87.0,43.0,39.0,646,01,01,  Narayanpur,428,470,209,224,219,246,47.7,48.3,47.1,00000
87.0,43.0,39.0,646,02,01,  Foyjullapur,270,361,126,181,144,180,42.8,41.0,44.4,00000
87.0,43.0,39.0,909,01,01,  Singnal,858,891,452,405,406,486,49.1,52.7,45.5,00000
87.0,43.0,39.0,909,02,01,  Asan Nagar,305,403,170,184,135,219,43.1,48.0,38.1,00000
87.0,43.0,47.0,391,01,01,  Kripa Rampur,220,183,118,73,102,110,54.6,61.8,48.1,00000
87.0,43.0,47.0,391,02,01,  Chak Joynagar,145,141,81,66,64,75,50.7,55.1,46.0,00000
87.0,43.0,47.0,510,01,01,  Maniknagar,590,702,283,307,307,395,45.7,48.0,43.7,00000
87.0,43.0,47.0,510,02,01,  Khurda Bantra,557,361,282,160,275,201,60.7,63.8,57.8,00000
87.0,43.0,55.0,671,01,01,  Ophapur,1103,1202,549,516,554,686,47.9,51.5,44.7,00000
87.0,43.0,55.0,671,02,01,  Goachmara,197,147,104,56,93,91,57.3,65.0,50.5,00000
87.0,43.0,55.0,671,03,01,  Bamnali,282,419,140,184,142,235,40.2,43.2,37.7,00000
87.0,43.0,55.0,680,01,01,  Paik Para,472,549,243,249,229,300,46.2,49.4,43.3,00000
87.0,43.0,55.0,680,02,01,  Maniknagar,149,174,73,79,76,95,46.1,48.0,44.4,00000
87.0,43.0,55.0,969,01,01,  Tarulia,215,283,114,127,101,156,43.2,47.3,39.3,00000
87.0,43.0,55.0,969,02,01,  Talundia,138,170,73,76,65,94,44.8,49.0,40.9,00000
87.0,43.0,55.0,969,03,01,  Kamar Ali,939,763,480,345,459,418,55.2,58.2,52.3,00000
87.0,43.0,55.0,969,04,01,  Mirdanga,139,209,65,102,74,107,39.9,38.9,40.9,00000
87.0,43.0,63.0,042,01,01,  Boalia,1820,2409,930,1162,890,1247,43.0,44.5,41.6,00000
87.0,43.0,63.0,042,02,01,  Aijpara,298,157,160,68,138,89,65.5,70.2,60.8,00000
87.0,43.0,63.0,042,03,01,  Baksa,1142,1416,603,660,539,756,44.6,47.7,41.6,00000
87.0,43.0,63.0,042,04,01,  Bagadanga,439,374,228,158,211,216,54.0,59.1,49.4,00000
87.0,43.0,63.0,331,01,01,  Goalchatar,626,647,316,295,310,352,49.2,51.7,46.8,00000
87.0,43.0,63.0,331,02,01,  Harina,223,573,113,285,110,288,28.0,28.4,27.6,00000
87.0,43.0,63.0,459,01,01,  Keragachhi,1000,704,534,319,466,385,58.7,62.6,54.8,00000
87.0,43.0,63.0,459,02,01,  Charabari,304,166,161,74,143,92,64.7,68.5,60.9,00000
87.0,43.0,63.0,459,03,01,  Garakhali,269,174,154,70,115,104,60.7,68.8,52.5,00000
87.0,43.0,63.0,459,04,01,  Kuthibari,220,177,111,90,109,87,55.4,55.2,55.6,00000
87.0,43.0,63.0,459,05,01,  Kakdanga,1475,1592,711,762,764,830,48.1,48.3,47.9,00000
87.0,47.0,13.0,167,01,01,  Braja Patali,242,690,116,339,126,351,26.0,25.5,26.4,00000
87.0,47.0,15.0,053,01,01,  Bandakati,1718,2357,883,1062,835,1295,42.2,45.4,39.2,00000
87.0,47.0,15.0,053,02,01,  Panghat,9,135,5,76,4,59,6.3,6.2,6.3,00000
87.0,47.0,23.0,229,01,01,  Chandulia,366,359,196,165,170,194,50.5,54.3,46.7,00000
87.0,47.0,23.0,229,02,01,  Mosharkatai,100,270,53,133,47,137,27.0,28.5,25.5,00000
87.0,47.0,23.0,229,03,01,  Myrarabad,324,514,179,257,145,257,38.7,41.1,36.1,00000
87.0,47.0,23.0,806,01,01,  Rajapur,870,753,472,326,398,427,53.6,59.1,48.2,00000
87.0,47.0,23.0,806,02,01,  Beledanga,48,77,23,40,25,37,38.4,36.5,40.3,00000
87.0,47.0,23.0,835,01,01,  Sainhati,822,480,453,209,369,271,63.1,68.4,57.7,00000
87.0,47.0,23.0,835,02,01,  Balapota,127,437,71,206,56,231,22.5,25.6,19.5,00000
87.0,47.0,23.0,994,01,01,  Yusufpur,105,206,52,109,53,97,33.8,32.3,35.3,00000
87.0,47.0,23.0,994,02,01,  Doakhali,64,127,37,66,27,61,33.5,35.9,30.7,00000
87.0,47.0,23.0,994,03,01,  Mathbari,63,57,37,27,26,30,52.5,57.8,46.4,00000
87.0,47.0,31.0,904,01,01,  Dakshin Sreepur,1047,1456,554,679,493,777,41.8,44.9,38.8,00000
87.0,47.0,31.0,904,02,01,  Uttar Sreepur,1737,1284,927,553,810,731,57.5,62.6,52.6,00000
87.0,47.0,47.0,712,01,01,  Nengi,570,397,289,166,281,231,58.9,63.5,54.9,00000
87.0,47.0,47.0,712,02,01,  Bamanhat,186,176,95,75,91,101,51.4,55.9,47.4,00000
87.0,47.0,47.0,794,01,01,  Uttar Raghunathpur,1042,909,495,409,547,500,53.4,54.8,52.2,00000
87.0,47.0,47.0,794,02,01,  Dakshin Raghunathpur,1355,1102,657,466,698,636,55.1,58.5,52.3,00000
87.0,47.0,47.0,794,03,01,  Chowdhury Hat,220,241,108,113,112,128,47.7,48.9,46.7,00000
87.0,47.0,47.0,794,04,01,  Sankarpur,504,546,269,242,235,304,48.0,52.6,43.6,00000
87.0,47.0,47.0,794,05,01,  Baliadanga,266,383,128,182,138,201,41.0,41.3,40.7,00000
87.0,47.0,71.0,651,01,01,  Bara Mautala,2631,2111,1351,959,1280,1152,55.5,58.5,52.6,00000
87.0,47.0,71.0,651,02,01,  Namazghar,524,537,292,251,232,286,49.4,53.8,44.8,00000
87.0,47.0,71.0,651,03,01,  Kalikapur,410,479,229,226,181,253,46.1,50.3,41.7,00000
87.0,47.0,71.0,651,04,01,  Ranitala,621,853,297,415,324,438,42.1,41.7,42.5,00000
87.0,47.0,87.0,618,01,01,  Maheshkur,362,671,185,315,177,356,35.0,37.0,33.2,00000
87.0,47.0,87.0,618,02,01,  Majidbati,186,140,109,62,77,78,57.1,63.7,49.7,00000
87.0,47.0,87.0,941,01,01,  Malenga,557,585,277,259,280,326,48.8,51.7,46.2,00000
87.0,47.0,87.0,941,02,01,  Shibpur,330,403,163,196,167,207,45.0,45.4,44.7,00000
87.0,47.0,87.0,941,03,01,  Sathalia,208,413,114,201,94,212,33.5,36.2,30.7,00000
87.0,47.0,87.0,941,04,01,  Baghmari,499,426,257,180,242,246,53.9,58.8,49.6,00000
87.0,47.0,94.0,090,01,01,  Bathuadanga,642,789,344,362,298,427,44.9,48.7,41.1,00000
87.0,47.0,94.0,090,02,01,  Golkhali,219,299,114,145,105,154,42.3,44.0,40.5,00000
87.0,47.0,94.0,933,01,01,  Tarali,1620,1349,889,574,731,775,54.6,60.8,48.5,00000
87.0,47.0,94.0,933,02,01,  Khalishkhali,350,284,182,135,168,149,55.2,57.4,53.0,00000
87.0,82.0,13.0,054,01,01,  Babulia,768,971,393,436,375,535,44.2,47.4,41.2,00000
87.0,82.0,13.0,054,02,01,  Bhabanipur,361,347,170,155,191,192,51.0,52.3,49.9,00000
87.0,82.0,13.0,054,03,01,  Balaidanga,414,609,211,295,203,314,40.5,41.7,39.3,00000
87.0,82.0,13.0,054,04,01,  Kuch Pukur,262,383,147,179,115,204,40.6,45.1,36.1,00000
87.0,82.0,13.0,465,01,01,  Kashimpur,2790,2178,1501,1078,1289,1100,56.2,58.2,54.0,00000
87.0,82.0,13.0,465,02,01,  Bakchara,1427,1906,715,930,712,976,42.8,43.5,42.2,00000
87.0,82.0,13.0,465,03,01,  Nilakhali,84,111,48,53,36,58,43.1,47.5,38.3,00000
87.0,82.0,13.0,465,04,01,  Balidanga,197,283,107,150,90,133,41.0,41.6,40.4,00000
87.0,82.0,13.0,465,05,01,  Dattadanga,105,192,55,97,50,95,35.4,36.2,34.5,00000
87.0,82.0,13.0,657,01,01,  Banshghata,724,889,387,397,337,492,44.9,49.4,40.7,00000
87.0,82.0,13.0,657,02,01,  Betla,340,567,190,285,150,282,37.5,40.0,34.7,00000
87.0,82.0,13.0,684,01,01,  Narayanjol,458,466,247,227,211,239,49.6,52.1,46.9,00000
87.0,82.0,13.0,684,02,01,  Harishpur,313,237,152,101,161,136,56.9,60.1,54.2,00000
87.0,82.0,16.0,027,01,01,  Alipur,3525,2931,1812,1409,1713,1522,54.6,56.3,53.0,00000
87.0,82.0,16.0,027,02,01,  Purba Alipur,1292,928,664,423,628,505,58.2,61.1,55.4,00000
87.0,82.0,16.0,027,03,01,  Chakardanga,216,252,117,125,99,127,46.2,48.3,43.8,00000
87.0,82.0,16.0,027,04,01,  Dakshin Alipur,562,796,273,371,289,425,41.4,42.4,40.5,00000
87.0,82.0,16.0,027,05,01,  Talbaria,641,434,326,191,315,243,59.6,63.1,56.5,00000
87.0,82.0,16.0,027,06,01,  Islampur (Shibpur),121,208,60,102,61,106,36.8,37.0,36.5,00000
87.0,82.0,16.0,027,07,01,  Panchani,276,457,149,237,127,220,37.7,38.6,36.6,00000
87.0,82.0,16.0,575,01,01,  Agunpur,79,50,48,17,31,33,61.2,73.8,48.4,00000
87.0,82.0,16.0,575,02,01,  Sharatala,68,80,37,39,31,41,45.9,48.7,43.1,00000
87.0,82.0,16.0,575,03,01,  Helencha,5,14,4,4,1,10,26.3,50.0,9.1,00000
87.0,82.0,16.0,620,01,01,  Barukhali,1420,1265,711,627,709,638,52.9,53.1,52.6,00000
87.0,82.0,16.0,620,02,01,  Mahmudpur,2395,2297,1257,1136,1138,1161,51.0,52.5,49.5,00000
87.0,82.0,16.0,620,03,01,  Gangania,1324,1453,709,677,615,776,47.7,51.2,44.2,00000
87.0,82.0,16.0,620,04,01,  Bularati,521,528,270,250,251,278,49.7,51.9,47.4,00000
87.0,82.0,16.0,620,05,01,  Ghola,126,165,60,82,66,83,43.3,42.3,44.3,00000
87.0,82.0,16.0,620,06,01,  Dakatpota,148,153,70,66,78,87,49.2,51.5,47.3,00000
87.0,82.0,27.0,045,01,01,  Amtala,548,476,294,204,254,272,53.5,59.0,48.3,00000
87.0,82.0,27.0,045,02,01,  Kanthaltala,104,87,62,43,42,44,54.5,59.0,48.8,00000
87.0,82.0,27.0,045,03,01,  Shialdanga,26,28,14,16,12,12,48.1,46.7,50.0,00000
87.0,82.0,27.0,045,04,01,  Shibnagar,89,116,47,54,42,62,43.4,46.5,40.4,00000
87.0,82.0,27.0,118,01,01,  Balli,484,679,270,302,214,377,41.6,47.2,36.2,00000
87.0,82.0,27.0,118,02,01,  Kanthaltala,96,81,57,38,39,43,54.2,60.0,47.6,00000
87.0,82.0,27.0,118,03,01,  Shyamnagar,205,184,110,76,95,108,52.7,59.1,46.8,00000
87.0,82.0,27.0,118,04,01,  Shibnagar,26,18,18,8,8,10,59.1,69.2,44.4,00000
87.0,82.0,27.0,118,05,01,  Bauldangi,114,127,53,58,61,69,47.3,47.7,46.9,00000
87.0,82.0,27.0,118,06,01,  Mochra,246,332,145,134,101,198,42.6,52.0,33.8,00000
87.0,82.0,27.0,803,01,01,  Raghunathpur,141,127,88,56,53,71,52.6,61.1,42.7,00000
87.0,82.0,27.0,803,02,01,  Hajipur,211,214,110,98,101,116,49.6,52.9,46.5,00000
87.0,82.0,27.0,803,03,01,  Narayanpur,369,460,197,212,172,248,44.5,48.2,41.0,00000
87.0,82.0,27.0,803,04,01,  Amtala,369,530,202,246,167,284,41.0,45.1,37.0,00000
87.0,82.0,27.0,803,05,01,  Bhat Para,168,95,89,35,79,60,63.9,71.8,56.8,00000
87.0,82.0,27.0,876,01,01,  Kushadanga,460,581,236,264,224,317,44.2,47.2,41.4,00000
87.0,82.0,27.0,876,02,01,  Roypur,864,1078,479,503,385,575,44.5,48.8,40.1,00000
87.0,82.0,27.0,876,03,01,  Samandanga,70,79,49,40,21,39,47.0,55.1,35.0,00000
87.0,82.0,27.0,876,04,01,  Gharchala,554,795,295,378,259,417,41.1,43.8,38.3,00000
87.0,82.0,33.0,127,01,01,  Majher Para,791,402,406,161,385,241,66.3,71.6,61.5,00000
87.0,82.0,33.0,127,02,01,  Kazi Para,936,574,476,258,460,316,62.0,64.9,59.3,00000
87.0,82.0,33.0,127,03,01,  Tangra,309,320,143,151,166,169,49.1,48.6,49.6,00000
87.0,82.0,33.0,127,04,01,  Kuliadanga,686,543,341,260,345,283,55.8,56.7,54.9,00000
87.0,82.0,33.0,447,01,01,  Kamar Bayesa,1043,833,543,358,500,475,55.6,60.3,51.3,00000
87.0,82.0,33.0,447,02,01,  Barui Bayesa,109,85,65,31,44,54,56.2,67.7,44.9,00000
87.0,82.0,33.0,456,01,01,  Haulkhali,1448,1269,731,595,717,674,53.3,55.1,51.5,00000
87.0,82.0,33.0,456,02,01,  Kaondanga,687,566,319,270,368,296,54.8,54.2,55.4,00000
87.0,82.0,33.0,456,03,01,  Gariadanga,229,148,120,64,109,84,60.7,65.2,56.5,00000
87.0,82.0,33.0,638,01,01,  Reui,772,481,388,212,384,269,61.6,64.7,58.8,00000
87.0,82.0,33.0,638,02,01,  Aich Para,187,157,100,69,87,88,54.4,59.2,49.7,00000
87.0,82.0,47.0,219,01,01,  Brahma Rajpur,1280,727,682,326,598,401,63.8,67.7,59.9,00000
87.0,82.0,47.0,219,02,01,  Jeala,299,419,170,194,129,225,41.6,46.7,36.4,00000
87.0,82.0,47.0,219,03,01,  Kamardanga,126,87,73,36,53,51,59.2,67.0,51.0,00000
87.0,82.0,47.0,219,04,01,  Gowalpota,788,541,437,213,351,328,59.3,67.2,51.7,00000
87.0,82.0,47.0,219,05,01,  Labangola,337,380,169,189,168,191,47.0,47.2,46.8,00000
87.0,82.0,47.0,219,06,01,  Badhandanga,112,157,63,76,49,81,41.6,45.3,37.7,00000
87.0,82.0,47.0,219,07,01,  Chelardanga,99,387,37,182,62,205,20.4,16.9,23.2,00000
87.0,82.0,47.0,219,08,01,  Omra Para,326,371,172,165,154,206,46.8,51.0,42.8,00000
87.0,82.0,47.0,219,09,01,  Bara Khamar,382,401,197,195,185,206,48.8,50.3,47.3,00000
87.0,82.0,47.0,219,10,01,  Kalerbhanga,159,156,89,84,70,72,50.5,51.4,49.3,00000
87.0,82.0,47.0,282,01,01,  Dohakula,1487,1134,784,531,703,603,56.7,59.6,53.8,00000
87.0,82.0,47.0,282,02,01,  Melek Para,167,505,75,263,92,242,24.9,22.2,27.5,00000
87.0,82.0,47.0,282,03,01,  Bayardara,40,115,23,51,17,64,25.8,31.1,21.0,00000
87.0,82.0,47.0,282,04,01,  Chamta Para,22,101,12,47,10,54,17.9,20.3,15.6,00000
87.0,82.0,47.0,565,01,01,  Machhkhola,2339,1831,1219,828,1120,1003,56.1,59.6,52.8,00000
87.0,82.0,47.0,565,02,01,  Par Machhkhola,400,398,211,206,189,192,50.1,50.6,49.6,00000
87.0,82.0,47.0,565,03,01,  Shalley,891,998,478,470,413,528,47.2,50.4,43.9,00000
87.0,82.0,47.0,565,04,01,  Par Shalley,104,151,65,70,39,81,40.8,48.1,32.5,00000
87.0,82.0,51.0,075,01,01,  Balitha,1440,1599,769,764,671,835,47.4,50.2,44.6,00000
87.0,82.0,51.0,075,02,01,  Ellar Chak,565,875,302,426,263,449,39.2,41.5,36.9,00000
87.0,82.0,51.0,340,01,01,  Uttar Fingri,1594,1323,840,619,754,704,54.6,57.6,51.7,00000
87.0,82.0,51.0,340,02,01,  Dakshin Fingri,866,1242,446,604,420,638,41.1,42.5,39.7,00000
87.0,82.0,54.0,237,01,01,  Chandpur,1774,1684,965,752,809,932,51.3,56.2,46.5,00000
87.0,82.0,54.0,237,02,01,  Darbasia,256,352,133,176,123,176,42.1,43.0,41.1,00000
87.0,82.0,54.0,237,03,01,  Kultia,34,16,17,6,17,10,68.0,73.9,63.0,00000
87.0,82.0,54.0,237,04,01,  Salakerdanga,75,133,38,63,37,70,36.1,37.6,34.6,00000
87.0,82.0,54.0,319,01,01,  Dhulihar,1680,1866,860,913,820,953,47.4,48.5,46.2,00000
87.0,82.0,54.0,319,02,01,  Jahanabaj,544,445,312,209,232,236,55.0,59.9,49.6,00000
87.0,82.0,54.0,319,03,01,  Baluigachha,349,483,201,233,148,250,41.9,46.3,37.2,00000
87.0,82.0,54.0,319,04,01,  Gobindapur,574,620,317,297,257,323,48.1,51.6,44.3,00000
87.0,82.0,54.0,319,05,01,  Baradal,447,621,252,274,195,347,41.9,47.9,36.0,00000
87.0,82.0,54.0,319,06,01,  Damarpota,484,499,281,213,203,286,49.2,56.9,41.5,00000
87.0,82.0,54.0,319,07,01,  Baghdanga,117,166,61,86,56,80,41.3,41.5,41.2,00000
87.0,82.0,54.0,319,08,01,  Matiradanga,692,663,382,293,310,370,51.1,56.6,45.6,00000
87.0,82.0,54.0,319,09,01,  Khariadanga,309,248,185,95,124,153,55.5,66.1,44.8,00000
87.0,82.0,54.0,319,10,01,  Kheruadanga,117,107,59,54,58,53,52.2,52.2,52.3,00000
87.0,82.0,54.0,319,11,01,  Jogipota,222,232,131,102,91,130,48.9,56.2,41.2,00000
87.0,82.0,54.0,319,12,01,  Taltala,79,114,41,58,38,56,40.9,41.4,40.4,00000
87.0,82.0,54.0,319,13,01,  Tentuldanga,249,155,145,54,104,101,61.6,72.9,50.7,00000
87.0,82.0,54.0,319,14,01,  Nehalpur,73,46,43,22,30,24,61.3,66.2,55.6,00000
87.0,82.0,54.0,319,15,01,  Bayar Batan,124,294,62,146,62,148,29.7,29.8,29.5,00000
87.0,82.0,54.0,319,16,01,  Berbari,279,370,149,172,130,198,43.0,46.4,39.6,00000
87.0,82.0,54.0,319,17,01,  Asandanga,161,134,104,41,57,93,54.6,71.7,38.0,00000
87.0,82.0,54.0,319,18,01,  Shukdebpur,245,272,143,119,102,153,47.4,54.6,40.0,00000
87.0,82.0,54.0,319,19,01,  Jiala,70,85,43,38,27,47,45.2,53.1,36.5,00000
87.0,82.0,54.0,319,20,01,  Suparighata,26,117,15,59,11,58,18.2,20.3,15.9,00000
87.0,82.0,54.0,319,21,01,  Per Tenduldanga,72,155,45,73,27,82,31.7,38.1,24.8,00000
87.0,82.0,61.0,611,01,01,  Mahadebnagar,730,531,398,227,332,304,57.9,63.7,52.2,00000
87.0,82.0,61.0,611,02,01,  Bharukhali,1030,916,511,435,519,481,52.9,54.0,51.9,00000
87.0,82.0,67.0,018,01,01,  Akhrakhola,623,472,327,202,296,270,56.9,61.8,52.3,00000
87.0,82.0,67.0,018,02,01,  Boyarkhola,230,120,117,56,113,64,65.7,67.6,63.8,00000
87.0,82.0,67.0,100,01,01,  Baladanga,1292,1153,713,539,579,614,52.8,56.9,48.5,00000
87.0,82.0,67.0,100,02,01,  Digardanga,267,152,127,73,140,79,63.7,63.5,63.9,00000
87.0,82.0,67.0,100,03,01,  Mohanpur,371,489,187,227,184,262,43.1,45.2,41.3,00000
87.0,82.0,67.0,365,01,01,  Hasimpur,152,79,79,40,73,39,65.8,66.4,65.2,00000
87.0,82.0,67.0,365,02,01,  Rajbari,158,80,94,27,64,53,66.4,77.7,54.7,00000
87.0,82.0,67.0,419,01,01,  Jograjpur,489,269,266,115,223,154,64.5,69.8,59.2,00000
87.0,82.0,67.0,419,02,01,  Debnagara,717,396,389,164,328,232,64.4,70.3,58.6,00000
87.0,82.0,67.0,419,03,01,  Chhatiantala,509,430,251,192,258,238,54.2,56.7,52.0,00000
87.0,82.0,67.0,419,04,01,  Dattabagh,170,44,94,15,76,29,79.4,86.2,72.4,00000
87.0,82.0,67.0,593,01,01,  Madhabkati,341,317,164,151,177,166,51.8,52.1,51.6,00000
87.0,82.0,67.0,593,02,01,  Chhaigharia,1264,1402,669,637,595,765,47.4,51.2,43.8,00000
87.0,82.0,74.0,182,01,01,  Bhadra,983,1168,479,538,504,630,45.7,47.1,44.4,00000
87.0,82.0,74.0,182,02,01,  Aruakhali,434,873,229,390,205,483,33.2,37.0,29.8,00000
87.0,82.0,74.0,538,01,01,  Kuskhali,2414,2823,1196,1301,1218,1522,46.1,47.9,44.5,00000
87.0,82.0,74.0,538,02,01,  Chhaygharia,398,682,209,311,189,371,36.9,40.2,33.8,00000
87.0,82.0,74.0,903,01,01,  Satani,2005,1514,969,725,1036,789,57.0,57.2,56.8,00000
87.0,82.0,74.0,903,02,01,  Kanardangi,32,91,15,47,17,44,26.0,24.2,27.9,00000
87.0,82.0,81.0,164,01,01,  Khejurdanga,1311,904,736,391,575,513,59.2,65.3,52.8,00000
87.0,82.0,81.0,164,02,01,  Benerpota,1181,748,686,338,495,410,61.2,67.0,54.7,00000
87.0,82.0,81.0,547,01,01,  Labsa,2369,898,1256,388,1113,510,72.5,76.4,68.6,00000
87.0,82.0,81.0,547,02,01,  Nalkuria,851,294,444,145,407,149,74.3,75.4,73.2,00000
87.0,82.0,81.0,602,01,01,  Thanaghata,1215,917,634,440,581,477,57.0,59.0,54.9,00000
87.0,82.0,81.0,602,02,01,  Magura,4346,1025,2266,381,2080,644,80.9,85.6,76.4,00000
87.0,82.0,81.0,602,03,01,  Taltala,1376,562,800,234,576,328,71.0,77.4,63.7,00000
87.0,82.0,81.0,602,04,01,  Gopinathpur,951,291,506,93,445,198,76.6,84.5,69.2,00000
87.0,82.0,81.0,629,01,01,  Mathurapur,389,347,208,164,181,183,52.9,55.9,49.7,00000
87.0,82.0,81.0,629,02,01,  Debnagar,1696,925,873,407,823,518,64.7,68.2,61.4,00000
87.0,82.0,81.0,629,03,01,  Kheardangi,166,73,91,30,75,43,69.5,75.2,63.6,00000
87.0,82.0,81.0,629,04,01,  Khejurdangi,185,98,101,42,84,56,65.4,70.6,60.0,00000
87.0,82.0,81.0,821,01,01,  Rajnagar,1300,1069,667,494,633,575,54.9,57.5,52.4,00000
87.0,82.0,81.0,821,02,01,  Egarai,148,182,82,77,66,105,44.8,51.6,38.6,00000
87.0,82.0,81.0,821,03,01,  Shibnagar,340,408,169,199,171,209,45.5,45.9,45.0,00000
87.0,82.0,81.0,894,01,01,  Fulbari,164,211,84,94,80,117,43.7,47.2,40.6,00000
87.0,82.0,81.0,894,02,01,  Kaikhali,572,426,303,190,269,236,57.3,61.5,53.3,00000
87.0,82.0,81.0,894,03,01,  Nolkora,205,143,114,58,91,85,58.9,66.3,51.7,00000
87.0,82.0,94.0,136,01,01,  Banshtala,306,202,181,81,125,121,60.2,69.1,50.8,00000
87.0,82.0,94.0,136,02,01,  Nimtala,86,86,42,47,44,39,50.0,47.2,53.0,00000
87.0,82.0,94.0,136,03,01,  Pukurkul,71,69,42,37,29,32,50.7,53.2,47.5,00000
87.0,82.0,94.0,392,01,01,  Jagannathpur,190,181,103,81,87,100,51.2,56.0,46.5,00000
87.0,82.0,94.0,392,02,01,  Nebakhali,439,238,229,98,210,140,64.8,70.0,60.0,00000
87.0,82.0,94.0,392,03,01,  Sonardanga,123,121,72,57,51,64,50.4,55.8,44.3,00000
87.0,82.0,94.0,392,04,01,  Barpota,89,74,58,31,31,43,54.6,65.2,41.9,00000
87.0,82.0,94.0,392,05,01,  Dumurtala,133,204,71,102,62,102,39.5,41.0,37.8,00000
87.0,82.0,94.0,392,06,01,  Tentultala,200,221,113,104,87,117,47.5,52.1,42.6,00000
87.0,82.0,94.0,410,01,01,  Jhitki,275,221,165,99,110,122,55.4,62.5,47.4,00000
87.0,82.0,94.0,410,02,01,  Thektapota,41,70,23,35,18,35,36.9,39.7,34.0,00000
87.0,82.0,94.0,410,03,01,  Andalpota,27,36,15,14,12,22,42.9,51.7,35.3,00000
87.0,82.0,94.0,410,04,01,  Harurdanga,34,38,19,19,15,19,47.2,50.0,44.1,00000
87.0,82.0,94.0,511,01,01,  Khanpur,1484,1600,715,808,769,792,48.1,46.9,49.3,00000
87.0,82.0,94.0,511,02,01,  Naturdanga,72,44,45,20,27,24,62.1,69.2,52.9,00000
87.0,82.0,94.0,766,01,01,  Parandaha,990,795,544,349,446,446,55.5,60.9,50.0,00000
87.0,82.0,94.0,766,02,01,  Sonardangi,46,49,28,22,18,27,48.4,56.0,40.0,00000
87.0,82.0,94.0,766,03,01,  Harishpur,118,128,63,68,55,60,48.0,48.1,47.8,00000
87.0,82.0,94.0,785,01,01,  Godaghata,1153,891,598,413,555,478,56.4,59.1,53.7,00000
87.0,82.0,94.0,785,02,01,  Sialdanga,551,561,278,298,273,263,49.6,48.3,50.9,00000
87.0,82.0,94.0,785,03,01,  Dubordanga,218,78,128,32,90,46,73.6,80.0,66.2,00000
87.0,86.0,11.0,031,01,01,  Atulia Bara Kupat,1198,790,675,328,523,462,60.3,67.3,53.1,00000
87.0,86.0,11.0,031,02,01,  Dakshin Paschim Atulia,1296,1533,719,677,577,856,45.8,51.5,40.3,00000
87.0,86.0,11.0,031,03,01,  Naobeki,745,549,385,223,360,326,57.6,63.3,52.5,00000
87.0,86.0,11.0,031,04,01,  Uttar Atulia,1540,2121,709,828,831,1293,42.1,46.1,39.1,00000
87.0,86.0,11.0,031,05,01,  Haoldangi,989,1381,498,562,491,819,41.7,47.0,37.5,00000
87.0,86.0,11.0,031,06,01,  Mollapara,350,554,158,206,192,348,38.7,43.4,35.6,00000
87.0,86.0,11.0,031,07,01,  Charer Bil,176,156,101,53,75,103,53.0,65.6,42.1,00000
87.0,86.0,11.0,031,08,01,  Magurakoni,224,203,116,83,108,120,52.5,58.3,47.4,00000
87.0,86.0,11.0,031,09,01,  Baduria,249,257,112,86,137,171,49.2,56.6,44.5,00000
87.0,86.0,11.0,031,10,01,  Bharbaria,246,272,118,107,128,165,47.5,52.4,43.7,00000
87.0,86.0,11.0,031,11,01,  Samata Guchchhagram,37,122,20,49,17,73,23.3,29.0,18.9,00000
87.0,86.0,11.0,615,01,01,  Chhota Kupat,623,480,287,176,336,304,56.5,62.0,52.5,00000
87.0,86.0,11.0,615,02,01,  Saperdon,374,399,184,164,190,235,48.4,52.9,44.7,00000
87.0,86.0,11.0,615,03,01,  Soalia,444,213,221,76,223,137,67.6,74.4,61.9,00000
87.0,86.0,11.0,615,04,01,  Jogindra Nagar,620,704,317,277,303,427,46.8,53.4,41.5,00000
87.0,86.0,11.0,615,05,01,  Bara Kupat,859,313,451,101,408,212,73.3,81.7,65.8,00000
87.0,86.0,11.0,979,01,01,  Talbaria,128,98,70,47,58,51,56.6,59.8,53.2,00000
87.0,86.0,11.0,979,02,01,  Bairshing,732,564,368,212,364,352,56.5,63.4,50.8,00000
87.0,86.0,11.0,979,03,01,  Henbchi,207,109,105,45,102,64,65.5,70.0,61.4,00000
87.0,86.0,11.0,979,04,01,  Arpangasia,193,96,105,35,88,61,66.8,75.0,59.1,00000
87.0,86.0,15.0,608,01,01,  Kultukuri,107,331,57,140,50,191,24.4,28.9,20.7,00000
87.0,86.0,15.0,608,02,01,  Gouripur,191,291,105,125,86,166,39.6,45.7,34.1,00000
87.0,86.0,23.0,007,01,01,  Kadamtala,312,407,176,180,136,227,43.4,49.4,37.5,00000
87.0,86.0,23.0,007,02,01,  Khosalkhali,805,919,439,338,366,581,46.7,56.5,38.6,00000
87.0,86.0,23.0,007,03,01,  Pankhali,504,695,299,320,205,375,42.0,48.3,35.3,00000
87.0,86.0,23.0,007,04,01,  Chounar,461,865,248,379,213,486,34.8,39.6,30.5,00000
87.0,86.0,23.0,007,05,01,  Banbebitala,431,536,231,249,200,287,44.6,48.1,41.1,00000
87.0,86.0,23.0,007,06,01,  Abad Chandipur,347,516,185,214,162,302,40.2,46.4,34.9,00000
87.0,86.0,23.0,007,07,01,  Khaskata,278,420,146,164,132,256,39.8,47.1,34.0,00000
87.0,86.0,23.0,118,01,01,  Buri Goalini,384,499,195,222,189,277,43.5,46.8,40.6,00000
87.0,86.0,23.0,118,02,01,  Kalbari,684,879,375,382,309,497,43.8,49.5,38.3,00000
87.0,86.0,23.0,118,03,01,  Are Pangasia,638,381,369,139,269,242,62.6,72.6,52.6,00000
87.0,86.0,23.0,118,04,01,  Media,134,136,83,52,51,84,49.6,61.5,37.8,00000
87.0,86.0,23.0,118,05,01,  Paschim Durgabati,441,281,258,95,183,186,61.1,73.1,49.6,00000
87.0,86.0,23.0,118,06,01,  Purba Durgabati,618,493,350,228,268,265,55.6,60.6,50.3,00000
87.0,86.0,23.0,813,01,01,  Paschim Pura Khatla,617,796,320,343,297,453,43.7,48.3,39.6,00000
87.0,86.0,23.0,813,02,01,  Bhamia,1683,1897,982,861,701,1036,47.0,53.3,40.4,00000
87.0,86.0,23.0,813,03,01,  Purba Pura Khatla,668,449,395,166,273,283,59.8,70.4,49.1,00000
87.0,86.0,23.0,813,04,01,  Datinakhali,610,1255,317,580,293,675,32.7,35.3,30.3,00000
87.0,86.0,31.0,221,01,01,  Dumuria,797,1554,413,728,384,826,33.9,36.2,31.7,00000
87.0,86.0,31.0,221,02,01,  Sora,1503,3108,762,1488,741,1620,32.6,33.9,31.4,00000
87.0,86.0,31.0,260,01,01,  Gabura,1007,1509,542,708,465,801,40.0,43.4,36.7,00000
87.0,86.0,31.0,260,02,01,  Kolpatua,611,1193,330,558,281,635,33.9,37.2,30.7,00000
87.0,86.0,31.0,260,03,01,  Jhalakhali,250,351,140,168,110,183,41.6,45.5,37.5,00000
87.0,86.0,31.0,260,04,01,  Char Jhalakhali,325,234,187,96,138,138,58.1,66.1,50.0,00000
87.0,86.0,31.0,260,05,01,  Nabu Bunia,162,208,81,114,81,94,43.8,41.5,46.3,00000
87.0,86.0,31.0,568,01,01,  Lakshmikhali,202,184,103,83,99,101,52.3,55.4,49.5,00000
87.0,86.0,31.0,568,02,01,  Central Khalisha Bunia,627,1098,352,478,275,620,36.3,42.4,30.7,00000
87.0,86.0,31.0,568,03,01,  Chakbara,834,1212,458,522,376,690,40.8,46.7,35.3,00000
87.0,86.0,31.0,568,04,01,  Khalisha Bunia,577,1080,317,484,260,596,34.8,39.6,30.4,00000
87.0,86.0,31.0,781,01,01,  Gagramari,137,172,74,79,63,93,44.3,48.4,40.4,00000
87.0,86.0,31.0,781,02,01,  Parshemari,705,1321,362,659,343,662,34.8,35.5,34.1,00000
87.0,86.0,31.0,781,03,01,  Napitkhali,256,861,126,436,130,425,22.9,22.4,23.4,00000
87.0,86.0,31.0,781,04,01,  Chandnimukha,733,1534,396,731,337,803,32.3,35.1,29.6,00000
87.0,86.0,31.0,781,05,01,  10 No-Sora,653,1093,340,532,313,561,37.4,39.0,35.8,00000
87.0,86.0,47.0,458,01,01,  Purba Kaikhali,1239,882,632,347,607,535,58.4,64.6,53.2,00000
87.0,86.0,47.0,458,02,01,  Kaikhali,1401,1886,713,788,688,1098,42.6,47.5,38.5,00000
87.0,86.0,47.0,458,03,01,  Joyakhali,789,907,393,382,396,525,46.5,50.7,43.0,00000
87.0,86.0,47.0,458,04,01,  Boskhali,805,1186,402,448,403,738,40.4,47.3,35.3,00000
87.0,86.0,47.0,458,05,01,  Shailakhali,695,605,389,238,306,367,53.5,62.0,45.5,00000
87.0,86.0,47.0,458,06,01,  Sapkhali,655,547,310,167,345,380,54.5,65.0,47.6,00000
87.0,86.0,47.0,773,01,01,  Paranpur,1472,1370,752,507,720,863,51.8,59.7,45.5,00000
87.0,86.0,47.0,773,02,01,  Jadoppur,496,531,262,224,234,307,48.3,53.9,43.3,00000
87.0,86.0,47.0,773,03,01,  Katamari,167,258,75,121,92,137,39.3,38.3,40.2,00000
87.0,86.0,55.0,284,01,01,  Ghola,753,859,358,375,395,484,46.7,48.8,44.9,00000
87.0,86.0,55.0,284,02,01,  Achharyan Proelopo,73,178,24,77,49,101,29.1,23.8,32.7,00000
87.0,86.0,55.0,284,03,01,  Chair Gram,104,149,35,64,69,85,41.1,35.4,44.8,00000
87.0,86.0,55.0,521,01,01,  Kashimari,3392,3925,1571,1520,1821,2405,46.4,50.8,43.1,00000
87.0,86.0,55.0,521,02,01,  Godara,787,780,376,310,411,470,50.2,54.8,46.7,00000
87.0,86.0,55.0,536,01,01,  Kanthal Baria,384,391,203,149,181,242,49.5,57.7,42.8,00000
87.0,86.0,55.0,536,02,01,  Akota Guschogram,79,150,29,55,50,95,34.5,34.5,34.5,00000
87.0,86.0,63.0,355,01,01,  Hetalkhali,650,473,315,186,335,287,57.9,62.9,53.9,00000
87.0,86.0,63.0,355,02,01,  Jatindra Nagar,467,275,240,117,227,158,62.9,67.2,59.0,00000
87.0,86.0,63.0,355,03,01,  Parshikhali,620,758,302,321,318,437,45.0,48.5,42.1,00000
87.0,86.0,63.0,355,04,01,  Mirgang,714,1099,388,502,326,597,39.4,43.6,35.3,00000
87.0,86.0,63.0,355,05,01,  Bara Betkhali,545,464,283,196,262,268,54.0,59.1,49.4,00000
87.0,86.0,63.0,355,06,01,  Chunkuri,584,547,324,226,260,321,51.6,58.9,44.8,00000
87.0,86.0,63.0,355,07,01,  Shinghortali,634,701,384,303,250,398,47.5,55.9,38.6,00000
87.0,86.0,63.0,355,08,01,  Harinagar,1171,1009,625,407,546,602,53.7,60.6,47.6,00000
87.0,86.0,63.0,355,09,01,  Chhota Betkhali,718,864,362,339,356,525,45.4,51.6,40.4,00000
87.0,86.0,63.0,702,01,01,  Dakshin Kadamtala,897,688,502,259,395,429,56.6,66.0,47.9,00000
87.0,86.0,63.0,702,03,01,  Central Kalinagar,853,1070,477,464,376,606,44.4,50.7,38.3,00000
87.0,86.0,63.0,702,04,01,  Dhankhali,1268,1237,734,511,534,726,50.6,59.0,42.4,00000
87.0,86.0,63.0,702,05,01,  Mathurapur,749,1116,412,477,337,639,40.2,46.3,34.5,00000
87.0,86.0,63.0,702,06,01,  Munshiganj,357,488,192,176,165,312,42.2,52.2,34.6,00000
87.0,86.0,63.0,702,07,01,  Kultali,680,508,379,168,301,340,57.2,69.3,47.0,00000
87.0,86.0,63.0,702,08,01,  Jelekhali,1176,892,650,364,526,528,56.9,64.1,49.9,00000
87.0,86.0,63.0,702,09,01,  Uttar Kadamtala,1009,1027,537,437,472,590,49.6,55.1,44.4,00000
87.0,86.0,63.0,702,10,01,  Purba Kalinagar,747,562,438,219,309,343,57.1,66.7,47.4,00000
87.0,86.0,79.0,276,01,01,  Ghar Kumarpur,791,1003,410,474,381,529,44.1,46.4,41.9,00000
87.0,86.0,79.0,276,02,01,  Bainnatala,260,557,139,281,121,276,31.8,33.1,30.5,00000
87.0,86.0,79.0,276,03,01,  Kaker Bazar,156,347,86,167,70,180,31.0,34.0,28.0,00000
87.0,86.0,79.0,276,04,01,  Khutikata,752,519,430,238,322,281,59.2,64.4,53.4,00000
87.0,86.0,79.0,276,05,01,  Choulkhola,51,258,26,124,25,134,16.5,17.3,15.7,00000
87.0,86.0,79.0,758,01,01,  Padma Pukur,905,1030,504,467,401,563,46.8,51.9,41.6,00000
87.0,86.0,79.0,758,02,01,  Kamalkati,699,353,411,122,288,231,66.4,77.1,55.5,00000
87.0,86.0,79.0,758,03,01,  Sonakhali,288,432,171,206,117,226,40.0,45.4,34.1,00000
87.0,86.0,79.0,758,04,01,  Baintala,289,540,169,257,120,283,34.9,39.7,29.8,00000
87.0,86.0,79.0,758,05,01,  Pakhimara,972,1384,543,619,429,765,41.3,46.7,35.9,00000
87.0,86.0,79.0,797,01,01,  Purba Patakhali,1401,1065,711,484,690,581,56.8,59.5,54.3,00000
87.0,86.0,79.0,797,02,01,  Paschim Patakhali,911,990,507,472,404,518,47.9,51.8,43.8,00000
87.0,86.0,79.0,797,03,01,  Chandipur,1398,1662,729,829,669,833,45.7,46.8,44.5,00000
87.0,86.0,87.0,071,01,01,  Patrakola,746,1102,411,483,335,619,40.4,46.0,35.1,00000
87.0,86.0,87.0,071,02,01,  Sonakhali,833,563,457,231,376,332,59.7,66.4,53.1,00000
87.0,86.0,87.0,071,03,01,  Chandkhali,538,475,313,189,225,286,53.1,62.4,44.0,00000
87.0,86.0,87.0,071,04,01,  Bhairabnagar,538,557,295,244,243,313,49.1,54.7,43.7,00000
87.0,86.0,87.0,086,01,01,  Bhetkhali,952,786,544,303,408,483,54.8,64.2,45.8,00000
87.0,86.0,87.0,086,02,01,  Tangrakhali,691,1066,340,442,351,624,39.3,43.5,36.0,00000
87.0,86.0,87.0,465,01,01,  Kalinchi,484,1273,268,565,216,708,27.5,32.2,23.4,00000
87.0,86.0,87.0,465,02,01,  Golakhali,44,209,21,94,23,115,17.4,18.3,16.7,00000
87.0,86.0,87.0,852,01,01,  Ramjan Nagar,1444,1397,777,573,667,824,50.8,57.6,44.7,00000
87.0,86.0,87.0,852,02,01,  Manik Khali,849,402,487,145,362,257,67.9,77.1,58.5,00000
87.0,86.0,87.0,852,03,01,  Sora,871,929,463,425,408,504,48.4,52.1,44.7,00000
87.0,86.0,87.0,852,04,01,  Tarnipur,428,372,224,156,204,216,53.5,58.9,48.6,00000
87.0,86.0,87.0,852,05,01,  Bhetker Chak,594,902,321,395,273,507,39.7,44.8,35.0,00000
87.0,86.0,94.0,426,01,01,  Jadabpur,344,227,176,104,168,123,60.2,62.9,57.7,00000
87.0,86.0,94.0,426,02,01,  Kalmagha,159,109,74,58,85,51,59.3,56.1,62.5,00000
87.0,86.0,94.0,971,01,03,  Nakipur,2597,1021,1431,395,1166,626,71.8,78.4,65.1,00000
87.0,86.0,94.0,971,02,03,  Jabakhali,215,174,114,78,101,96,55.3,59.4,51.3,00000
87.0,86.0,94.0,971,03,03,  Dabaloy,149,149,69,67,80,82,50.0,50.7,49.4,00000
87.0,86.0,94.0,971,04,03,  Betangi,203,193,118,71,85,122,51.3,62.4,41.1,00000
87.0,86.0,94.0,971,05,03,  Thikan Sundarban,56,84,27,33,29,51,40.0,45.0,36.3,00000
87.0,90.0,11.0,258,01,01,  Dhandia,583,610,332,275,251,335,48.9,54.7,42.8,00000
87.0,90.0,11.0,258,02,01,  Krishnanagar,187,590,98,302,89,288,24.1,24.5,23.6,00000
87.0,90.0,11.0,258,03,01,  Katakhali,985,405,524,174,461,231,70.9,75.1,66.6,00000
87.0,90.0,11.0,663,01,01,  Manikhar,1202,740,637,345,565,395,61.9,64.9,58.9,00000
87.0,90.0,11.0,663,02,01,  Garidanga,510,362,280,168,230,194,58.5,62.5,54.2,00000
87.0,90.0,11.0,762,01,01,  Panch Para,484,1109,256,532,228,577,30.4,32.5,28.3,00000
87.0,90.0,11.0,762,02,01,  Alipur,264,327,151,148,113,179,44.7,50.5,38.7,00000
87.0,90.0,11.0,948,01,01,  Senerganti,1246,1787,677,858,569,929,41.1,44.1,38.0,00000
87.0,90.0,11.0,948,02,01,  Omarpur,246,369,141,166,105,203,40.0,45.9,34.1,00000
87.0,90.0,23.0,908,01,01,  Sreemanta Kati,916,1286,498,582,418,704,41.6,46.1,37.3,00000
87.0,90.0,23.0,908,02,01,  Amradanga,177,190,90,87,87,103,48.2,50.8,45.8,00000
87.0,90.0,31.0,404,01,01,  Hajrakati,1267,1319,695,577,572,742,49.0,54.6,43.5,00000
87.0,90.0,31.0,404,02,01,  Katbunia,210,103,117,42,93,61,67.1,73.6,60.4,00000
87.0,90.0,31.0,610,01,01,  Uttar Machhiara,402,840,221,402,181,438,32.4,35.5,29.2,00000
87.0,90.0,31.0,610,02,01,  Dakshin Machhiara,1507,1587,801,743,706,844,48.7,51.9,45.5,00000
87.0,90.0,31.0,716,01,01,  Uttar Nalta,1170,988,622,473,548,515,54.2,56.8,51.6,00000
87.0,90.0,31.0,716,02,01,  Dakshin Nalta,1009,1201,530,549,479,652,45.7,49.1,42.4,00000
87.0,90.0,39.0,311,01,01,  Chhota Gachha,203,74,121,20,82,54,73.3,85.8,60.3,00000
87.0,90.0,39.0,311,02,01,  Durgapur,196,118,104,48,92,70,62.4,68.4,56.8,00000
87.0,90.0,39.0,311,03,01,  Baghdanga,340,91,197,25,143,66,78.9,88.7,68.4,00000
87.0,90.0,39.0,311,04,01,  Krishnanagar,79,77,38,36,41,41,50.6,51.4,50.0,00000
87.0,90.0,39.0,311,05,01,  Baragachha,150,128,87,48,63,80,54.0,64.4,44.1,00000
87.0,90.0,39.0,311,06,01,  Khariadanga,161,190,98,83,63,107,45.9,54.1,37.1,00000
87.0,90.0,39.0,311,07,01,  Gopaldanga,101,123,59,56,42,67,45.1,51.3,38.5,00000
87.0,90.0,39.0,311,08,01,  Durbadanga,40,106,24,55,16,51,27.4,30.4,23.9,00000
87.0,90.0,39.0,311,09,01,  Bisheshkati,61,76,32,33,29,43,44.5,49.2,40.3,00000
87.0,90.0,39.0,537,01,01,  Kahalishkhali,1624,626,893,277,731,349,72.2,76.3,67.7,00000
87.0,90.0,39.0,537,02,01,  Enayetpur,477,604,247,288,230,316,44.1,46.2,42.1,00000
87.0,90.0,39.0,537,03,01,  Ganeshpur,443,828,223,401,220,427,34.9,35.7,34.0,00000
87.0,90.0,39.0,537,04,01,  Baghmara,731,917,388,431,343,486,44.4,47.4,41.4,00000
87.0,90.0,39.0,537,05,01,  Hajra Para,371,240,197,112,174,128,60.7,63.8,57.6,00000
87.0,90.0,39.0,537,06,01,  Saradanga,183,202,98,94,85,108,47.5,51.0,44.0,00000
87.0,90.0,39.0,537,07,01,  Raghabkati,208,472,119,231,89,241,30.6,34.0,27.0,00000
87.0,90.0,39.0,537,08,01,  Kashiadanga,610,806,331,357,279,449,43.1,48.1,38.3,00000
87.0,90.0,39.0,537,09,01,  Dudlai,679,1043,372,491,307,552,39.4,43.1,35.7,00000
87.0,90.0,39.0,537,10,01,  Boyardanga,334,270,188,124,146,146,55.3,60.3,50.0,00000
87.0,90.0,39.0,537,11,01,  Pakshia,279,180,161,66,118,114,60.8,70.9,50.9,00000
87.0,90.0,39.0,537,12,01,  Mangal Anandakati,349,535,182,249,167,286,39.5,42.2,36.9,00000
87.0,90.0,39.0,537,13,01,  Kaihkhali,728,502,430,193,298,309,59.2,69.0,49.1,00000
87.0,90.0,47.0,371,01,01,  Mukundapur,838,843,439,382,399,461,49.9,53.5,46.4,00000
87.0,90.0,47.0,371,02,01,  Harihar Nagar,1548,1242,765,593,783,649,55.5,56.3,54.7,00000
87.0,90.0,47.0,557,01,01,  Khesra,910,733,506,305,404,428,55.4,62.4,48.6,00000
87.0,90.0,47.0,557,02,01,  Shahjadpur,1952,1689,1014,741,938,948,53.6,57.8,49.7,00000
87.0,90.0,47.0,696,01,01,  Muragachha,907,372,469,155,438,217,70.9,75.2,66.9,00000
87.0,90.0,47.0,696,02,01,  Dar Muragachha,165,233,96,93,69,140,41.5,50.8,33.0,00000
87.0,90.0,47.0,822,01,01,  Rajapur(Meser Danga),535,426,322,157,213,269,55.7,67.2,44.2,00000
87.0,90.0,47.0,822,02,01,  Kulpota,136,328,79,150,57,178,29.3,34.5,24.3,00000
87.0,90.0,47.0,822,03,01,  Chak Biswaser,164,154,101,65,63,89,51.6,60.8,41.4,00000
87.0,90.0,47.0,822,04,01,  Batuadanga,293,193,170,79,123,114,60.3,68.3,51.9,00000
87.0,90.0,47.0,968,01,01,  Tegharia (Part),314,184,184,84,130,100,63.1,68.7,56.5,00000
87.0,90.0,47.0,968,02,01,  Balia,939,1511,498,674,441,837,38.3,42.5,34.5,00000
87.0,90.0,55.0,583,01,01,  Kumira,2679,2678,1370,1269,1309,1409,50.0,51.9,48.2,00000
87.0,90.0,55.0,583,02,01,  Bhagbah,453,497,231,242,222,255,47.7,48.8,46.5,00000
87.0,90.0,55.0,835,01,01,  Rari Para,639,1324,314,675,325,649,32.6,31.7,33.4,00000
87.0,90.0,55.0,835,02,01,  Abhaytala,888,583,479,242,409,341,60.4,66.4,54.5,00000
87.0,90.0,63.0,623,01,01,  Magura,1286,965,685,433,601,532,57.1,61.3,53.0,00000
87.0,90.0,63.0,623,02,01,  Chandkati,922,1046,466,509,456,537,46.8,47.8,45.9,00000
87.0,90.0,63.0,623,03,01,  Maguradanga,856,782,453,361,403,421,52.3,55.7,48.9,00000
87.0,90.0,63.0,623,04,01,  Bisukati,61,91,26,45,35,46,40.1,36.6,43.2,00000
87.0,90.0,63.0,623,05,01,  Kashidaha,8,12,6,3,2,9,40.0,66.7,18.2,00000
87.0,90.0,71.0,378,01,01,  Harinkhola,624,393,353,156,271,237,61.4,69.4,53.3,00000
87.0,90.0,71.0,378,02,01,  Goalpota,397,408,236,170,161,238,49.3,58.1,40.4,00000
87.0,90.0,71.0,378,03,01,  Beradangi,100,53,58,19,42,34,65.4,75.3,55.3,00000
87.0,90.0,71.0,378,04,01,  Baghkhali,53,90,33,42,20,48,37.1,44.0,29.4,00000
87.0,90.0,71.0,709,01,01,  Samandanga,35,59,20,29,15,30,37.2,40.8,33.3,00000
87.0,90.0,71.0,709,02,01,  Chakarkanda,658,535,375,252,283,283,55.2,59.8,50.0,00000
87.0,90.0,71.0,709,03,01,  Gabtali,379,434,191,209,188,225,46.6,47.8,45.5,00000
87.0,90.0,71.0,709,04,01,  Nagarghata,485,356,282,158,203,198,57.7,64.1,50.6,00000
87.0,90.0,71.0,709,05,01,  Nagarghata Rishipara,222,232,125,105,97,127,48.9,54.3,43.3,00000
87.0,90.0,71.0,709,06,01,  Kalibari,240,107,125,49,115,58,69.2,71.8,66.5,00000
87.0,90.0,71.0,709,07,01,  Nagarghata Hajratala,391,176,219,77,172,99,69.0,74.0,63.5,00000
87.0,90.0,71.0,709,08,01,  Nagarghata Bagh,452,342,246,159,206,183,56.9,60.7,53.0,00000
87.0,90.0,71.0,709,09,01,  Nagarghata Kanpara,263,347,144,161,119,186,43.1,47.2,39.0,00000
87.0,90.0,71.0,709,10,01,  Dakshin Nagarghata,1220,887,677,405,543,482,57.9,62.6,53.0,00000
87.0,90.0,71.0,709,11,01,  Nimtala,363,110,199,42,164,68,76.7,82.6,70.7,00000
87.0,90.0,71.0,709,12,01,  Rathkhola,168,212,94,101,74,111,44.2,48.2,40.0,00000
87.0,90.0,71.0,709,13,01,  Kapashdanga,762,477,416,201,346,276,61.5,67.4,55.6,00000
87.0,90.0,71.0,709,14,01,  Mathbari,308,341,168,157,140,184,47.5,51.7,43.2,00000
87.0,90.0,71.0,709,15,01,  Asan Nagar,396,308,223,125,173,183,56.3,64.1,48.6,00000
87.0,90.0,71.0,709,16,01,  Basun Dhara,61,187,31,92,30,95,24.6,25.2,24.0,00000
87.0,90.0,79.0,066,01,01,  Baiguni,590,410,319,183,271,227,59.0,63.5,54.4,00000
87.0,90.0,79.0,066,02,01,  Chowgachha,235,156,126,68,109,88,60.1,64.9,55.3,00000
87.0,90.0,79.0,092,01,01,  Bara Bila,1294,1341,725,597,569,744,49.1,54.8,43.3,00000
87.0,90.0,79.0,092,02,01,  Chowgachha,166,149,78,63,88,86,52.7,55.3,50.6,00000
87.0,90.0,79.0,152,01,01,  Bharsha,816,720,404,314,412,406,53.1,56.3,50.4,00000
87.0,90.0,79.0,152,02,01,  Achimtala,371,337,206,160,165,177,52.4,56.3,48.2,00000
87.0,90.0,79.0,504,01,01,  Chhota Kashipur,318,633,167,303,151,330,33.4,35.5,31.4,00000
87.0,90.0,79.0,504,02,01,  Bara Kashipur,1257,1190,668,530,589,660,51.4,55.8,47.2,00000
87.0,90.0,79.0,789,01,01,  Puthikhali,612,898,329,418,283,480,40.5,44.0,37.1,00000
87.0,90.0,79.0,789,02,01,  Par Kumira,683,245,365,101,318,144,73.6,78.3,68.8,00000
87.0,90.0,79.0,789,03,01,  Palkelghata,994,524,539,225,455,299,65.5,70.5,60.3,00000
87.0,90.0,79.0,789,04,01,  Chowgachha,47,10,26,2,21,8,82.5,92.9,72.4,00000
87.0,90.0,79.0,809,01,01,  Rajendrapur,258,182,128,87,130,95,58.6,59.5,57.8,00000
87.0,90.0,79.0,809,02,01,  Amtalardangi,176,176,91,86,85,90,50.0,51.4,48.6,00000
87.0,90.0,79.0,809,03,01,  Shialdangi,143,163,80,77,63,86,46.7,51.0,42.3,00000
87.0,90.0,79.0,809,04,01,  Chamarkhali,84,140,44,72,40,68,37.5,37.9,37.0,00000
87.0,90.0,79.0,809,05,01,  Juskhola,897,864,455,408,442,456,50.9,52.7,49.2,00000
87.0,90.0,79.0,809,06,01,  Gorer Danga,46,31,29,11,17,20,59.7,72.5,45.9,00000
87.0,90.0,79.0,809,07,01,  Lalchandrapur,713,499,375,239,338,260,58.8,61.1,56.5,00000
87.0,90.0,79.0,809,08,01,  Hogladanga,99,133,58,59,41,74,42.7,49.6,35.7,00000
87.0,90.0,79.0,809,09,01,  Patkelghata,605,368,346,213,259,155,62.2,61.9,62.6,00000
87.0,90.0,79.0,868,01,01,  Shan Kdaha,744,531,393,236,351,295,58.4,62.5,54.3,00000
87.0,90.0,79.0,868,02,01,  Jugi Pukuria,1643,2006,858,975,785,1031,45.0,46.8,43.2,00000
87.0,90.0,79.0,868,03,01,  Masadanga,67,79,38,26,29,53,45.9,59.4,35.4,00000
87.0,90.0,79.0,868,04,01,  Tailkupi,1996,1771,1061,825,935,946,53.0,56.3,49.7,00000
87.0,90.0,87.0,139,01,01,  Bhaira,933,746,498,296,435,450,55.6,62.7,49.2,00000
87.0,90.0,87.0,139,02,01,  Agaljhara,425,480,241,219,184,261,47.0,52.4,41.3,00000
87.0,90.0,87.0,643,01,03,  Majhiara,451,136,252,45,199,91,76.8,84.8,68.6,00000
87.0,90.0,87.0,643,02,03,  Kharer Danga,245,214,140,91,105,123,53.4,60.6,46.1,00000
87.0,90.0,87.0,643,03,03,  Shibpur,559,204,288,85,271,119,73.3,77.2,69.5,00000
87.0,90.0,87.0,961,01,03,  Tala,1122,253,663,107,459,146,81.6,86.1,75.9,00000
87.0,90.0,87.0,961,02,03,  Khajra,409,154,207,64,202,90,72.6,76.4,69.2,00000
87.0,90.0,87.0,961,03,03,  Mahallah Para,543,134,282,49,261,85,80.2,85.2,75.4,00000
42.0,40.0,19.0,975,01,01,  Uttam Nagar,225,190,115,83,110,107,54.2,58.1,50.7,00000
42.0,40.0,19.0,975,02,01,  Sanjoypur,246,88,115,39,131,49,73.7,74.7,72.8,00000
42.0,40.0,28.0,172,01,01,  Paschim Binna Para,525,243,246,91,279,152,68.4,73.0,64.7,00000
42.0,40.0,28.0,172,02,01,  Purba Binna Para,289,121,136,56,153,65,70.5,70.8,70.2,00000
42.0,40.0,28.0,357,01,01,  Rupasia,447,173,228,84,219,89,72.1,73.1,71.1,00000
42.0,40.0,28.0,357,02,01,  Gabkhan,1076,505,503,214,573,291,68.1,70.2,66.3,00000
42.0,40.0,28.0,937,01,01,  Baidarapur,949,466,469,213,480,253,67.1,68.8,65.5,00000
42.0,40.0,28.0,937,02,01,  Sultanpur,163,80,74,36,89,44,67.1,67.3,66.9,00000
42.0,40.0,38.0,267,01,01,  Uttar Bharukati,269,286,130,148,139,138,48.5,46.8,50.2,00000
42.0,40.0,38.0,267,02,01,  Dakshin Bharukati,389,82,181,26,208,56,82.6,87.4,78.8,00000
42.0,40.0,38.0,790,01,01,  Uttar Ramchandrapur,530,485,275,212,255,273,52.2,56.5,48.3,00000
42.0,40.0,38.0,790,02,01,  Dakshin Ramchandrapur,765,490,385,221,380,269,61.0,63.5,58.6,00000
42.0,40.0,57.0,287,01,01,  Chouddabram,200,220,83,107,117,113,47.6,43.7,50.9,00000
42.0,40.0,57.0,287,02,01,  Dakshin Pippalita,644,473,301,238,343,235,57.7,55.8,59.3,00000
42.0,40.0,57.0,287,03,01,  Dakua Para,308,96,147,50,161,46,76.2,74.6,77.8,00000
42.0,40.0,57.0,605,01,01,  Mahatpur,96,29,44,12,52,17,76.8,78.6,75.4,00000
42.0,40.0,57.0,605,02,01,  Gaddayklati,145,28,77,19,68,9,83.8,80.2,88.3,00000
42.0,40.0,57.0,707,01,01,  Pakmahar,707,221,345,89,362,132,76.2,79.5,73.3,00000
42.0,40.0,57.0,707,02,01,  Nawhata,94,59,47,30,47,29,61.4,61.0,61.8,00000
42.0,40.0,57.0,746,01,01,  Paschim Taruli,235,18,110,7,125,11,92.9,94.0,91.9,00000
42.0,40.0,57.0,746,02,01,  Sreepatikati,92,9,39,2,53,7,91.1,95.1,88.3,00000
42.0,40.0,57.0,816,01,01,  Ranamati,460,235,244,108,216,127,66.2,69.3,63.0,00000
42.0,40.0,57.0,816,02,01,  Balda Khan,517,59,251,21,266,38,89.8,92.3,87.5,00000
42.0,40.0,57.0,861,01,01,  Sarangal,632,122,320,50,312,72,83.8,86.5,81.3,00000
42.0,40.0,57.0,861,02,01,  Bamnikati,248,95,137,46,111,49,72.3,74.9,69.4,00000
42.0,40.0,66.0,133,01,01,  Beukhir,186,72,82,37,104,35,72.1,68.9,74.8,00000
42.0,40.0,66.0,133,02,01,  Kamil Kandar,90,27,50,12,40,15,76.9,80.6,72.7,00000
42.0,40.0,66.0,184,01,01,  Bisain Khan,716,148,318,71,398,77,82.9,81.7,83.8,00000
42.0,40.0,66.0,184,02,01,  Bairampur,49,19,29,6,20,13,72.1,82.9,60.6,00000
42.0,40.0,66.0,369,01,01,  Gabindadhabal,517,735,257,342,260,393,41.3,42.9,39.8,00000
42.0,40.0,66.0,369,02,01,  Adukati,181,233,85,112,96,121,43.7,43.1,44.2,00000
42.0,40.0,66.0,542,01,01,  Khajura,503,193,240,84,263,109,72.3,74.1,70.7,00000
42.0,40.0,66.0,542,02,01,  Bicumpur,42,35,24,17,18,18,54.5,58.5,50.0,00000
42.0,40.0,66.0,714,01,01,  Uttar Panjipuhari Para,844,484,374,228,470,256,63.6,62.1,64.7,00000
42.0,40.0,66.0,714,02,01,  Dakshin Panjipuhari Para,188,67,88,34,100,33,73.7,72.1,75.2,00000
42.0,40.0,66.0,873,01,01,  Sasahanga,109,59,51,20,58,39,64.9,71.8,59.8,00000
42.0,40.0,66.0,873,02,01,  Alipur,88,49,44,29,44,20,64.2,60.3,68.8,00000
42.0,40.0,66.0,873,03,01,  Gobindapur,22,9,9,4,13,5,71.0,69.2,72.2,00000
42.0,40.0,66.0,950,01,01,  Tarpasa,875,551,426,261,449,290,61.4,62.0,60.8,00000
42.0,40.0,66.0,950,02,01,  Baulkanda,154,86,62,39,92,47,64.2,61.4,66.2,00000
42.0,40.0,76.0,102,01,01,  Daukati,1380,873,692,418,688,455,61.3,62.3,60.2,00000
42.0,40.0,76.0,102,02,01,  Uttar Baukati,176,139,82,74,94,65,55.9,52.6,59.1,00000
42.0,40.0,85.0,210,01,01,  Chandpur,384,233,179,106,205,127,62.2,62.8,61.7,00000
42.0,40.0,85.0,210,02,01,  Khulna,202,34,98,10,104,24,85.6,90.7,81.3,00000
42.0,40.0,85.0,312,01,01,  Deuri,828,1112,393,550,435,562,42.7,41.7,43.6,00000
42.0,40.0,85.0,312,02,01,  Atakati,220,402,106,207,114,195,35.4,33.9,36.9,00000
42.0,40.0,85.0,752,01,01,  Ponabalia,220,83,107,35,113,48,72.6,75.4,70.2,00000
42.0,40.0,85.0,752,02,01,  Protab Mahal,629,288,268,118,361,170,68.6,69.4,68.0,00000
42.0,40.0,95.0,389,01,01,  Garangal,403,176,204,91,199,85,69.6,69.2,70.1,00000
42.0,40.0,95.0,389,02,01,  Sayata,224,213,113,110,111,103,51.3,50.7,51.9,00000
42.0,40.0,95.0,389,03,01,  Rajpasha,1359,660,640,298,719,362,67.3,68.2,66.5,00000
42.0,40.0,95.0,389,04,01,  Bangura,1172,331,586,134,586,197,78.0,81.4,74.8,00000
42.0,40.0,95.0,389,05,01,  Mirzapur,1344,595,662,288,682,307,69.3,69.7,69.0,00000
42.0,40.0,95.0,695,01,01,  Noapara,669,208,347,85,322,123,76.3,80.3,72.4,00000
42.0,40.0,95.0,695,02,01,  Baskhan,404,433,164,212,240,221,48.3,43.6,52.1,00000
42.0,40.0,95.0,905,01,01,  Sirjug,1215,514,557,212,658,302,70.3,72.4,68.5,00000
42.0,40.0,95.0,905,02,01,  Protappur,317,308,156,153,161,155,50.7,50.5,50.9,00000
42.0,40.0,95.0,918,01,01,  Paschim Sreemantakati,572,139,278,65,294,74,80.5,81.0,79.9,00000
42.0,40.0,95.0,918,02,01,  Purba Sreemantakati,553,87,269,41,284,46,86.4,86.8,86.1,00000
42.0,43.0,31.0,084,01,01,  Uttar Awrabunia,1244,832,591,393,653,439,59.9,60.1,59.8,00000
42.0,43.0,31.0,084,02,01,  Maddha Awrebunia,515,251,276,103,239,148,67.2,72.8,61.8,00000
42.0,43.0,31.0,084,03,01,  Dakshin Awrabunia,1340,455,659,185,681,270,74.7,78.1,71.6,00000
42.0,43.0,63.0,105,01,03,  Uttar Aura,1524,332,770,147,754,185,82.1,84.0,80.3,00000
42.0,43.0,63.0,105,02,03,  Paschim Aura,1806,491,873,225,933,266,78.6,79.5,77.8,00000
42.0,43.0,63.0,105,03,03,  Dakshin Aura,903,354,428,180,475,174,71.8,70.4,73.2,00000
42.0,43.0,63.0,529,01,03,  Bara Kanthalia,756,594,366,304,390,290,56.0,54.6,57.4,00000
42.0,43.0,63.0,529,02,03,  Kanthalia Sadar,1590,448,792,211,798,237,78.0,79.0,77.1,00000
42.0,73.0,15.0,133,01,01,  Bharatkati,1219,868,610,401,609,467,58.4,60.3,56.6,00000
42.0,73.0,15.0,133,02,01,  Rajakhali,325,194,159,89,166,105,62.6,64.1,61.3,00000
42.0,73.0,15.0,347,01,01,  Goalkati,1073,857,517,389,556,468,55.6,57.1,54.3,00000
42.0,73.0,15.0,347,02,01,  Norottampur,241,360,137,186,104,174,40.1,42.4,37.4,00000
42.0,73.0,36.0,480,01,01,  Purba Kamdebpur,966,435,468,177,498,258,69.0,72.6,65.9,00000
42.0,73.0,36.0,480,02,01,  Paschim Kamdebpur,1365,855,677,400,688,455,61.5,62.9,60.2,00000
42.0,73.0,36.0,480,03,01,  Madhya Kamdebpur,696,271,309,115,387,156,72.0,72.9,71.3,00000
42.0,73.0,36.0,480,04,01,  Dakshin Kamdebpur,513,359,233,140,280,219,58.8,62.5,56.1,00000
42.0,73.0,36.0,507,01,01,  Katakhali,1723,561,809,254,914,307,75.4,76.1,74.9,00000
42.0,73.0,36.0,507,02,01,  Amtali,938,343,431,155,507,188,73.2,73.5,72.9,00000
42.0,73.0,42.0,614,01,01,  Uttar Magar,782,310,354,164,428,146,71.6,68.3,74.6,00000
42.0,73.0,42.0,614,02,01,  Dakhin Magar,944,627,458,265,486,362,60.1,63.3,57.3,00000
42.0,73.0,42.0,941,01,01,  Suzabad,216,215,98,114,118,101,50.1,46.2,53.9,00000
42.0,73.0,42.0,941,02,01,  Royapur,2543,887,1227,420,1316,467,74.1,74.5,73.8,00000
42.0,73.0,73.0,821,01,01,  Ranapasha Uttar,885,186,420,83,465,103,82.6,83.5,81.9,00000
42.0,73.0,73.0,821,02,01,  Ranapasha Dakshin,1065,324,494,149,571,175,76.7,76.8,76.5,00000
42.0,73.0,73.0,961,01,01,  Tentulbaria Uttar,622,247,274,116,348,131,71.6,70.3,72.7,00000
42.0,73.0,73.0,961,02,01,  Tentulbaria Dakshin,631,341,309,153,322,188,64.9,66.9,63.1,00000
42.0,73.0,84.0,006,01,01,  Abhaynil,789,205,368,97,421,108,79.4,79.1,79.6,00000
42.0,73.0,84.0,006,02,01,  Nargona,208,66,101,27,107,39,75.9,78.9,73.3,00000
42.0,73.0,84.0,233,01,01,  Chauddaburia,492,198,247,83,245,115,71.3,74.8,68.1,00000
42.0,73.0,84.0,233,02,01,  Katgar,232,109,109,58,123,51,68.0,65.3,70.7,00000
42.0,73.0,84.0,233,03,01,  Batajor,149,57,77,26,72,31,72.3,74.8,69.9,00000
42.0,73.0,84.0,233,04,01,  Pitambarganj,143,59,55,31,88,28,70.8,64.0,75.9,00000
42.0,73.0,84.0,454,01,01,  Aorabunia,420,154,207,63,213,91,73.2,76.7,70.1,00000
42.0,73.0,84.0,454,02,01,  Sreerampur,44,10,23,5,21,5,81.5,82.1,80.8,00000
42.0,73.0,84.0,634,01,01,  Maloar,844,303,379,139,465,164,73.6,73.2,73.9,00000
42.0,73.0,84.0,634,02,01,  Chandra Kanda,356,17,168,6,188,11,95.4,96.6,94.5,00000
42.0,73.0,94.0,367,01,01,  Gopalpur,1536,649,735,281,801,368,70.3,72.3,68.5,00000
42.0,73.0,94.0,367,02,01,  Paschim Gopalpur,1155,792,533,373,622,419,59.3,58.8,59.8,00000
42.0,73.0,94.0,367,03,01,  Nelbunia,644,732,329,315,315,417,46.8,51.1,43.0,00000
42.0,73.0,94.0,407,01,01,  Ichhapasha,420,117,218,37,202,80,78.2,85.5,71.6,00000
42.0,73.0,94.0,407,02,01,  Bojpur,114,84,64,31,50,53,57.6,67.4,48.5,00000
42.0,73.0,94.0,621,01,01,  Majkurni,480,171,250,94,230,77,73.7,72.7,74.9,00000
42.0,73.0,94.0,621,02,01,  Baitara,106,51,50,26,56,25,67.5,65.8,69.1,00000
42.0,84.0,27.0,663,01,01,  Nij Galua,911,345,405,165,506,180,72.5,71.1,73.8,00000
42.0,84.0,27.0,663,02,01,  Chhota Galua,288,116,138,64,150,52,71.3,68.3,74.3,00000
42.0,84.0,40.0,345,01,01,  Dahar Shankar,815,439,402,192,413,247,65.0,67.7,62.6,00000
42.0,84.0,40.0,345,02,01,  Manki,348,360,156,157,192,203,49.2,49.8,48.6,00000
42.0,84.0,40.0,469,01,01,  Purba Indrapasha,452,473,204,200,248,273,48.9,50.5,47.6,00000
42.0,84.0,40.0,469,02,01,  Paschim Indrapasha,946,414,476,174,470,240,69.6,73.2,66.2,00000
78.0,38.0,10.0,006,01,01,  Adabaria,650,630,346,258,304,372,50.8,57.3,45.0,00000
78.0,38.0,10.0,006,02,01,  Gulithamouj,247,238,119,92,128,146,50.9,56.4,46.7,00000
78.0,38.0,10.0,006,03,01,  Dakshin Madhabpur,1006,684,512,306,494,378,59.5,62.6,56.7,00000
78.0,38.0,10.0,006,04,01,  Uttar Madhabpur,631,517,332,203,299,314,55.0,62.1,48.8,00000
78.0,38.0,11.0,693,01,01,  Balia,223,369,119,157,104,212,37.7,43.1,32.9,00000
78.0,38.0,11.0,693,02,01,  Chandan Baria,167,432,98,191,69,241,27.9,33.9,22.3,00000
78.0,38.0,11.0,890,01,01,  Sabupur (Part),1291,1182,591,477,700,705,52.2,55.3,49.8,00000
78.0,38.0,11.0,890,02,01,  Dasher Haowla,178,175,89,85,89,90,50.4,51.1,49.7,00000
78.0,38.0,41.0,521,01,01,  Ghurchakati,1617,1135,774,558,843,577,58.8,58.1,59.4,00000
78.0,38.0,41.0,521,02,01,  Jamolkati,1101,512,509,251,592,261,68.3,67.0,69.4,00000
78.0,38.0,47.0,619,01,01,  Karkhana,875,589,433,233,442,356,59.8,65.0,55.4,00000
78.0,38.0,47.0,619,02,01,  Suradi,177,73,77,33,100,40,70.8,70.0,71.4,00000
78.0,38.0,47.0,619,03,01,  Dariabad,322,125,162,53,160,72,72.0,75.3,69.0,00000
78.0,38.0,47.0,619,04,01,  Arazi Baultala,239,10,123,3,116,7,96.0,97.6,94.3,00000
78.0,38.0,47.0,619,05,01,  Bazar Khola,202,178,107,66,95,112,53.2,61.8,45.9,00000
78.0,38.0,65.0,160,01,01,  Ruzna,314,110,134,35,180,75,74.1,79.3,70.6,00000
78.0,38.0,65.0,160,02,01,  Baultali,293,168,125,73,168,95,63.6,63.1,63.9,00000
78.0,38.0,65.0,208,01,01,  Birpasha,1213,466,533,173,680,293,72.2,75.5,69.9,00000
78.0,38.0,65.0,208,02,01,  Joyghara,977,652,456,290,521,362,60.0,61.1,59.0,00000
78.0,52.0,10.0,210,01,01,  Chandpur,1568,1199,860,494,708,705,56.7,63.5,50.1,00000
78.0,52.0,10.0,210,02,01,  Mowbaria,451,339,239,142,212,197,57.1,62.7,51.8,00000
78.0,52.0,10.0,210,03,01,  Madhupur,692,442,360,180,332,262,61.0,66.7,55.9,00000
78.0,52.0,10.0,210,04,01,  Ruhitpur,129,96,71,36,58,60,57.3,66.4,49.2,00000
78.0,52.0,52.0,727,01,03,  Paschim Lakshmipur,1864,1635,957,742,907,893,53.3,56.3,50.4,00000
78.0,52.0,52.0,727,02,03,  Purba Lakshmipur,697,441,378,162,319,279,61.2,70.0,53.3,00000
78.0,55.0,19.0,019,01,01,  Purba Angaria,987,469,496,188,491,281,67.8,72.5,63.6,00000
78.0,55.0,19.0,019,02,01,  Paschim Angaria,658,274,305,112,353,162,70.6,73.1,68.5,00000
78.0,55.0,19.0,481,01,01,  Purba Jalisha,1001,428,472,175,529,253,70.0,73.0,67.6,00000
78.0,55.0,19.0,481,02,01,  Paschim Jalisha,2486,633,1291,255,1195,378,79.7,83.5,76.0,00000
78.0,55.0,93.0,839,01,01,  Rajakhali,2096,658,998,265,1098,393,76.1,79.0,73.6,00000
78.0,55.0,93.0,839,02,01,  Char Boyra,1590,669,707,291,883,378,70.4,70.8,70.0,00000
78.0,57.0,11.0,010,01,01,  Amkhola,723,681,380,296,343,385,51.5,56.2,47.1,00000
78.0,57.0,11.0,010,02,01,  Dakshin Amkhola,1036,1545,571,690,465,855,40.1,45.3,35.2,00000
78.0,57.0,11.0,086,01,01,  Banshbunia,601,826,303,348,298,478,42.1,46.5,38.4,00000
78.0,57.0,11.0,086,02,01,  Ramdula,596,452,299,189,297,263,56.9,61.3,53.0,00000
78.0,57.0,11.0,086,03,01,  Kuralbhanga,37,46,26,18,11,28,44.6,59.1,28.2,00000
78.0,57.0,11.0,086,04,01,  Kalai Kishore,553,752,291,300,262,452,42.4,49.2,36.7,00000
78.0,57.0,11.0,086,05,01,  Dhaki Bunia,63,74,34,33,29,41,46.0,50.7,41.4,00000
78.0,57.0,27.0,027,01,01,  Madbar Kanda,86,160,59,71,27,89,35.0,45.4,23.3,00000
78.0,57.0,27.0,027,02,01,  Kalachanpara,235,115,115,56,120,59,67.1,67.3,67.0,00000
78.0,57.0,27.0,027,03,01,  Ashabaria,31,94,15,42,16,52,24.8,26.3,23.5,00000
78.0,57.0,27.0,102,01,01,  Felabunia,27,25,17,10,10,15,51.9,63.0,40.0,00000
78.0,57.0,27.0,102,02,01,  Dighari,180,179,86,111,94,68,50.1,43.7,58.0,00000
78.0,57.0,27.0,102,03,01,  Mollar Char,111,167,55,83,56,84,39.9,39.9,40.0,00000
78.0,57.0,27.0,362,01,01,  Charkhali,152,130,83,58,69,72,53.9,58.9,48.9,00000
78.0,57.0,27.0,362,02,01,  Chhatian Para,213,346,92,179,121,167,38.1,33.9,42.0,00000
78.0,57.0,27.0,362,03,01,  Makrum Para,136,127,62,62,74,65,51.7,50.0,53.2,00000
78.0,57.0,27.0,454,01,01,  Dakshin Tulatali,133,152,64,78,69,74,46.7,45.1,48.3,00000
78.0,57.0,27.0,454,02,01,  Katakhali,437,528,233,253,204,275,45.3,47.9,42.6,00000
78.0,57.0,27.0,454,03,01,  Modukhali,286,335,145,161,141,174,46.1,47.4,44.8,00000
78.0,57.0,27.0,454,04,01,  Monipara,181,340,101,156,80,184,34.7,39.3,30.3,00000
78.0,57.0,27.0,632,01,01,  Kankani Para,227,243,108,124,119,119,48.3,46.6,50.0,00000
78.0,57.0,27.0,632,02,01,  Teli Para,282,224,140,115,142,109,55.7,54.9,56.6,00000
78.0,57.0,27.0,751,01,01,  Nichkatha,124,209,64,100,60,109,37.2,39.0,35.5,00000
78.0,57.0,27.0,751,02,01,  Mirkanda,175,120,91,59,84,61,59.3,60.7,57.9,00000
78.0,57.0,27.0,751,03,01,  Hafejkanda,102,115,55,54,47,61,47.0,50.5,43.5,00000
78.0,57.0,27.0,751,04,01,  Mridhakanda,473,137,253,67,220,70,77.5,79.1,75.9,00000
78.0,57.0,27.0,751,05,01,  Khash Mahal,624,794,303,401,321,393,44.0,43.0,45.0,00000
78.0,57.0,27.0,762,01,01,  Mukharbanda,245,72,131,38,114,34,77.3,77.5,77.0,00000
78.0,57.0,27.0,762,02,01,  Bailabunia,129,286,76,133,53,153,31.1,36.4,25.7,00000
78.0,57.0,27.0,762,03,01,  Bhuiyankanda,403,432,196,233,207,199,48.3,45.7,51.0,00000
78.0,57.0,27.0,762,04,01,  Khara Deor,227,376,130,181,97,195,37.6,41.8,33.2,00000
78.0,57.0,27.0,957,01,01,  Tungibaria,486,994,272,476,214,518,32.8,36.4,29.2,00000
78.0,57.0,27.0,957,02,01,  Shamchand,126,118,72,47,54,71,51.6,60.5,43.2,00000
78.0,57.0,27.0,957,03,01,  Kalachand Para,239,119,118,58,121,61,66.8,67.0,66.5,00000
78.0,57.0,32.0,189,01,01,  Chalitabunia,475,1016,253,521,222,495,31.9,32.7,31.0,00000
78.0,57.0,32.0,189,02,01,  Chinabunia,529,720,258,374,271,346,42.4,40.8,43.9,00000
78.0,57.0,34.0,302,01,01,  Char Momtaj,1575,2067,864,1035,711,1032,43.2,45.5,40.8,00000
78.0,57.0,34.0,302,02,01,  Mondalkanda,1249,2031,658,1045,591,986,38.1,38.6,37.5,00000
78.0,57.0,34.0,313,01,01,  Undar Char,823,464,425,241,398,223,63.9,63.8,64.1,00000
78.0,57.0,34.0,313,02,01,  Kabiraj Para,129,307,76,149,53,158,29.6,33.8,25.1,00000
78.0,57.0,37.0,432,01,01,  Char Biswas,490,394,231,207,259,187,55.4,52.7,58.1,00000
78.0,57.0,37.0,432,02,01,  Uttar Paschim Char Biswas,439,800,233,404,206,396,35.4,36.6,34.2,00000
78.0,57.0,37.0,432,03,01,  Madhya Char Biswas,244,550,111,281,133,269,30.7,28.3,33.1,00000
78.0,57.0,37.0,432,04,01,  Uttar Purba Char Biswas,481,378,256,166,225,212,56.0,60.7,51.5,00000
78.0,57.0,44.0,556,01,01,  Haridrakhali,227,509,111,245,116,264,30.8,31.2,30.5,00000
78.0,57.0,44.0,556,02,01,  Gouhinkhali,395,812,184,403,211,409,32.7,31.3,34.0,00000
78.0,57.0,44.0,643,01,01,  Kaukhali,512,1118,248,564,264,554,31.4,30.5,32.3,00000
78.0,57.0,44.0,643,02,01,  Bhuiyar Howla,391,396,211,182,180,214,49.7,53.7,45.7,00000
78.0,57.0,44.0,946,01,01,  Tilla,456,937,216,464,240,473,32.7,31.8,33.7,00000
78.0,57.0,44.0,946,02,01,  Koralia,483,744,229,370,254,374,39.4,38.2,40.4,00000
78.0,57.0,44.0,946,03,01,  Shajir Haola,268,363,141,177,127,186,42.5,44.3,40.6,00000
78.0,57.0,55.0,032,01,01,  Paschim Atkhali,1091,1249,557,581,534,668,46.6,48.9,44.4,00000
78.0,57.0,55.0,032,02,01,  Purba Atkhali,892,1398,471,646,421,752,39.0,42.2,35.9,00000
78.0,57.0,55.0,811,01,01,  Purba Pardakua,1399,1152,738,580,661,572,54.8,56.0,53.6,00000
78.0,57.0,55.0,811,02,01,  Paschim Pardakua,1226,1420,630,634,596,786,46.3,49.8,43.1,00000
78.0,57.0,67.0,870,01,03,  Purba Ratandi,357,204,189,97,168,107,63.6,66.1,61.1,00000
78.0,57.0,67.0,870,02,03,  Paschim Ratandi,360,288,188,133,172,155,55.6,58.6,52.6,00000
78.0,57.0,67.0,870,03,03,  Muradnagar,818,415,438,180,380,235,66.3,70.9,61.8,00000
78.0,57.0,67.0,870,04,03,  Gorabala,230,128,113,59,117,69,64.2,65.7,62.9,00000
78.0,57.0,78.0,438,01,01,  Bibirhaola,184,491,104,234,80,257,27.3,30.8,23.7,00000
78.0,57.0,78.0,438,02,01,  Gupterhaola,432,625,204,301,228,324,40.9,40.4,41.3,00000
78.0,57.0,78.0,438,03,01,  Bashtala,253,275,126,140,127,135,47.9,47.4,48.5,00000
78.0,57.0,78.0,438,04,01,  Hularam,279,462,134,229,145,233,37.7,36.9,38.4,00000
78.0,57.0,78.0,438,05,01,  Khurida,168,366,89,175,79,191,31.5,33.7,29.3,00000
78.0,57.0,78.0,438,06,01,  Senerhowla,113,247,60,113,53,134,31.4,34.7,28.3,00000
78.0,57.0,78.0,508,01,01,  Geramarddan,385,456,193,195,192,261,45.8,49.7,42.4,00000
78.0,57.0,78.0,508,02,01,  Jugirhaola,155,303,66,143,89,160,33.8,31.6,35.7,00000
78.0,57.0,78.0,508,03,01,  Nijhaola,481,913,272,429,209,484,34.5,38.8,30.2,00000
78.0,57.0,78.0,951,01,01,  Taltali,82,321,49,148,33,173,20.3,24.9,16.0,00000
78.0,57.0,78.0,951,02,01,  Tulatali,305,702,145,310,160,392,30.3,31.9,29.0,00000
78.0,57.0,78.0,984,01,01,  Satiram,347,435,174,185,173,250,44.4,48.5,40.9,00000
78.0,57.0,78.0,984,02,01,  Joymanik,344,259,178,121,166,138,57.0,59.5,54.6,00000
78.0,57.0,78.0,984,03,01,  Ratneshwar,472,397,229,195,243,202,54.3,54.0,54.6,00000
78.0,57.0,78.0,984,04,01,  Kawkaitabak,413,564,215,253,198,311,42.3,45.9,38.9,00000
78.0,57.0,78.0,984,05,01,  Uttar Panpatty,587,598,301,254,286,344,49.5,54.2,45.4,00000
78.0,57.0,83.0,016,01,01,  Purba Neta,474,745,233,369,241,376,38.9,38.7,39.1,00000
78.0,57.0,83.0,016,02,01,  Paschim Neta,224,337,107,168,117,169,39.9,38.9,40.9,00000
78.0,57.0,83.0,016,03,01,  Gandadula,63,226,29,122,34,104,21.8,19.2,24.6,00000
78.0,57.0,83.0,016,04,01,  Amlibaria,649,806,344,362,305,444,44.6,48.7,40.7,00000
78.0,57.0,83.0,016,05,01,  Mazmeta,203,255,101,138,102,117,44.3,42.3,46.6,00000
78.0,57.0,83.0,016,06,01,  Chowdhury Mutabad,100,149,41,68,59,81,40.2,37.6,42.1,00000
78.0,57.0,83.0,594,01,01,  Jogir Haola,1101,1545,620,992,481,553,41.6,38.5,46.5,00000
78.0,57.0,83.0,594,02,01,  Hapuakhali,170,175,81,80,89,95,49.3,50.3,48.4,00000
78.0,57.0,83.0,648,01,01,  Uttar Kazir Haola,515,943,260,493,255,450,35.3,34.5,36.2,00000
78.0,57.0,83.0,648,02,01,  Dakshin Kazir Haola,276,473,139,221,137,252,36.8,38.6,35.2,00000
78.0,57.0,83.0,865,01,01,  Kachiyabunia,653,566,370,265,283,301,53.6,58.3,48.5,00000
78.0,57.0,83.0,865,02,01,  Pashuribunia,627,511,324,259,303,252,55.1,55.6,54.6,00000
78.0,57.0,83.0,865,03,01,  19 No Rangabali,376,157,172,76,204,81,70.5,69.4,71.6,00000
78.0,57.0,83.0,903,01,01,  Samudafad,488,431,248,213,240,218,53.1,53.8,52.4,00000
78.0,57.0,83.0,903,02,01,  Deorkanda,263,450,132,230,131,220,36.9,36.5,37.3,00000
78.0,57.0,83.0,903,03,01,  Kaonia,141,152,71,76,70,76,48.1,48.3,47.9,00000
78.0,57.0,83.0,908,01,01,  Sener Haola,275,348,151,173,124,175,44.1,46.6,41.5,00000
78.0,57.0,83.0,908,02,01,  Gorakhali,195,336,101,178,94,158,36.7,36.2,37.3,00000
78.0,57.0,83.0,908,03,01,  Charkanda,123,409,57,210,66,199,23.1,21.3,24.9,00000
78.0,57.0,83.0,908,04,01,  Kataban,334,243,171,125,163,118,57.9,57.8,58.0,00000
78.0,57.0,83.0,908,05,01,  Choukha,146,198,71,107,75,91,42.4,39.9,45.2,00000
78.0,57.0,94.0,730,01,01,  Bishnuram,373,430,198,216,175,214,46.5,47.8,45.0,00000
78.0,57.0,94.0,730,02,01,  Kamar Haola,349,198,188,78,161,120,63.8,70.7,57.3,00000
78.0,57.0,94.0,730,03,01,  Chander Haola,130,166,64,79,66,87,43.9,44.8,43.1,00000
78.0,57.0,94.0,730,04,01,  Balir Haola,227,329,107,153,120,176,40.8,41.2,40.5,00000
78.0,57.0,94.0,730,05,01,  Memsaheb,164,357,72,178,92,179,31.5,28.8,33.9,00000
78.0,57.0,94.0,730,06,01,  Chhayani,122,254,61,124,61,130,32.4,33.0,31.9,00000
78.0,57.0,94.0,730,07,01,  Jangla,185,160,91,77,94,83,53.6,54.2,53.1,00000
78.0,57.0,94.0,881,01,01,  Gramarodon,502,473,252,227,250,246,51.5,52.6,50.4,00000
78.0,57.0,94.0,881,02,01,  Nij Haola,456,390,226,196,230,194,53.9,53.6,54.2,00000
78.0,57.0,94.0,881,03,01,  Talukder Haola,217,299,102,149,115,150,42.1,40.6,43.4,00000
78.0,57.0,94.0,881,04,01,  Labubunia,237,155,112,71,125,84,60.5,61.2,59.8,00000
78.0,57.0,94.0,881,05,01,  Gubbunia,83,180,55,85,28,95,31.6,39.3,22.8,00000
78.0,57.0,94.0,881,06,01,  Bhiar Haola,255,290,123,136,132,154,46.8,47.5,46.2,00000
78.0,57.0,94.0,881,07,01,  Chhota Manik Chand,114,103,53,55,61,48,52.5,49.1,56.0,00000
78.0,57.0,94.0,881,08,01,  Bara Manik Chand,361,372,183,175,178,197,49.2,51.1,47.5,00000
78.0,57.0,94.0,962,01,01,  Ulania Bandar,755,274,401,119,354,155,73.4,77.1,69.5,00000
78.0,57.0,94.0,962,02,01,  Chhaykani,327,218,182,91,145,127,60.0,66.7,53.3,00000
78.0,57.0,94.0,967,01,01,  Tattibunia,128,288,55,158,73,130,30.8,25.8,36.0,00000
78.0,57.0,94.0,967,02,01,  Patabunia,560,542,293,254,267,288,50.8,53.6,48.1,00000
78.0,57.0,94.0,967,03,01,  Nim Haola,317,377,172,172,145,205,45.7,50.0,41.4,00000
78.0,57.0,94.0,967,04,01,  Mamuntakti,244,288,113,123,131,165,45.9,47.9,44.3,00000
78.0,57.0,94.0,967,05,01,  Bara Chouddakani,238,269,122,122,116,147,46.9,50.0,44.1,00000
78.0,57.0,94.0,967,06,01,  Chhota Chouddakani,965,681,503,313,462,368,58.6,61.6,55.7,00000
78.0,57.0,94.0,967,07,01,  Satghar,124,330,53,158,71,172,27.3,25.1,29.2,00000
78.0,57.0,94.0,967,08,01,  Kazikanda,166,340,78,157,88,183,32.8,33.2,32.5,00000
78.0,57.0,94.0,967,09,01,  Kacharikanda,659,786,327,376,332,410,45.6,46.5,44.7,00000
47.5,48.3,46.7,078,66,02,Kalapara  Paurashava,11282,3876,6013,1758,5269,2118,75.1,78.0,72.1,00000
78.0,66.0,10.0,084,01,01,  Bara Baliatali,873,1364,436,687,437,677,39.0,38.8,39.2,00000
78.0,66.0,10.0,084,02,01,  Digar Baliatali,259,274,123,140,136,134,48.6,46.8,50.4,00000
78.0,66.0,10.0,084,03,01,  Amtali Para,181,167,83,82,98,85,52.0,50.3,53.6,00000
78.0,66.0,10.0,296,01,01,  Chhota Baliatali,369,327,179,155,190,172,53.0,53.6,52.5,00000
78.0,66.0,10.0,296,02,01,  Hari Para,478,246,254,123,224,123,66.0,67.4,64.6,00000
78.0,66.0,10.0,296,03,01,  Ayum Para,204,221,97,106,107,115,48.0,47.8,48.2,00000
78.0,66.0,10.0,296,04,01,  Kangkani Para,95,202,50,90,45,112,32.0,35.7,28.7,00000
78.0,66.0,10.0,296,05,01,  Compani Para,120,248,65,125,55,123,32.6,34.2,30.9,00000
78.0,66.0,10.0,296,06,01,  Bali Para,289,348,138,174,151,174,45.4,44.2,46.5,00000
78.0,66.0,10.0,296,07,01,  Abashan,75,153,33,78,42,75,32.9,29.7,35.9,00000
78.0,66.0,10.0,571,01,01,  Lemu Para,233,235,105,117,128,118,49.8,47.3,52.0,00000
78.0,66.0,10.0,571,02,01,  Baiddyapara,677,567,324,275,353,292,54.4,54.1,54.7,00000
78.0,66.0,10.0,571,03,01,  Tulatali,575,657,286,287,289,370,46.7,49.9,43.9,00000
78.0,66.0,10.0,571,04,01,  Karamja Para,34,86,20,42,14,44,28.3,32.3,24.1,00000
78.0,66.0,10.0,571,05,01,  Rifujeepara,67,162,32,72,35,90,29.3,30.8,28.0,00000
78.0,66.0,10.0,867,01,01,  Sona Para,379,164,170,80,209,84,69.8,68.0,71.3,00000
78.0,66.0,10.0,867,02,01,  Naya Para,157,250,72,119,85,131,38.6,37.7,39.4,00000
78.0,66.0,10.0,867,03,01,  Majerpara,140,90,66,38,74,52,60.9,63.5,58.7,00000
78.0,66.0,10.0,867,04,01,  Pakhia Para,348,303,135,144,213,159,53.5,48.4,57.3,00000
78.0,66.0,11.0,021,01,01,  Anipara,546,307,277,141,269,166,64.0,66.3,61.8,00000
78.0,66.0,11.0,021,02,01,  Kamra Para,130,87,52,34,78,53,59.9,60.5,59.5,00000
78.0,66.0,11.0,021,03,01,  Naya Para,245,169,107,69,138,100,59.2,60.8,58.0,00000
78.0,66.0,11.0,021,04,01,  Katal Para,404,282,210,125,194,157,58.9,62.7,55.3,00000
78.0,66.0,11.0,021,05,01,  Kashimkhali,312,495,149,227,163,268,38.7,39.6,37.8,00000
78.0,66.0,11.0,021,06,01,  Abashan,141,133,98,54,43,79,51.5,64.5,35.2,00000
78.0,66.0,11.0,127,01,01,  Chakamaiya (Shantipur),360,418,177,197,183,221,46.3,47.3,45.3,00000
78.0,66.0,11.0,127,02,01,  Paschim Chakamaiya,468,362,258,165,210,197,56.4,61.0,51.6,00000
78.0,66.0,11.0,127,03,01,  Uttar Chakamaiya,787,827,421,417,366,410,48.8,50.2,47.2,00000
78.0,66.0,11.0,127,05,01,  Daroga Tabog,82,172,47,92,35,80,32.3,33.8,30.4,00000
78.0,66.0,11.0,359,01,01,  Gamurbunia,514,547,260,279,254,268,48.4,48.2,48.7,00000
78.0,66.0,11.0,359,02,01,  Hosnabad,291,171,141,82,150,89,63.0,63.2,62.8,00000
78.0,66.0,11.0,359,03,01,  Islampur,211,91,117,36,94,55,69.9,76.5,63.1,00000
78.0,66.0,11.0,359,04,01,  Purba Chakamaya,347,342,161,170,186,172,50.4,48.6,52.0,00000
78.0,66.0,11.0,359,05,01,  New Abasan,125,108,62,53,63,55,53.6,53.9,53.4,00000
78.0,66.0,11.0,762,01,01,  Chakamaya Nishanbaria,1071,677,561,313,510,364,61.3,64.2,58.4,00000
78.0,66.0,11.0,762,02,01,  Moulvi Tabog,132,92,62,38,70,54,58.9,62.0,56.5,00000
78.0,66.0,11.0,762,03,01,  Betmour,326,429,156,175,170,254,43.2,47.1,40.1,00000
78.0,66.0,11.0,762,04,01,  Bainbunia,284,389,156,187,128,202,42.2,45.5,38.8,00000
78.0,66.0,11.0,762,05,01,  Chounga Pasha,421,324,194,174,227,150,56.5,52.7,60.2,00000
78.0,66.0,11.0,762,06,01,  Abasan,172,127,80,78,92,49,57.5,50.6,65.2,00000
78.0,66.0,15.0,317,01,01,  Payerpur,415,285,187,135,228,150,59.3,58.1,60.3,00000
78.0,66.0,15.0,317,02,01,  Jamalpur,122,120,57,49,65,71,50.4,53.8,47.8,00000
78.0,66.0,15.0,317,03,01,  Meherpur,427,362,198,168,229,194,54.1,54.1,54.1,00000
78.0,66.0,15.0,317,04,01,  Rasulpur,150,121,64,58,86,63,55.4,52.5,57.7,00000
78.0,66.0,15.0,317,05,01,  Fulbunia,211,459,113,217,98,242,31.5,34.2,28.8,00000
78.0,66.0,15.0,317,06,01,  Nurpur,161,75,75,38,86,37,68.2,66.4,69.9,00000
78.0,66.0,15.0,317,07,01,  Dalbuganj,461,231,222,106,239,125,66.6,67.7,65.7,00000
78.0,66.0,15.0,317,08,01,  Ramjanpur,178,120,93,55,85,65,59.7,62.8,56.7,00000
78.0,66.0,15.0,317,09,01,  Mirpur,213,289,87,131,126,158,42.4,39.9,44.4,00000
78.0,66.0,15.0,317,10,01,  Purbo Dalbuganj,351,316,166,154,185,162,52.6,51.9,53.3,00000
78.0,66.0,15.0,486,01,01,  Harendrapur,538,681,274,321,264,360,44.1,46.1,42.3,00000
78.0,66.0,15.0,486,02,01,  Surdugi,116,255,58,127,58,128,31.3,31.4,31.2,00000
78.0,66.0,15.0,656,01,01,  Manasatali,955,714,481,360,474,354,57.2,57.2,57.2,00000
78.0,66.0,15.0,656,02,01,  Barkatia,313,420,152,205,161,215,42.7,42.6,42.8,00000
78.0,66.0,23.0,804,01,01,  Nizampur,673,678,306,384,367,294,49.8,44.3,55.5,00000
78.0,66.0,23.0,804,02,01,  Manoharpur,617,340,331,173,286,167,64.5,65.7,63.1,00000
78.0,66.0,23.0,804,03,01,  Puran Mohipur,611,362,291,189,320,173,62.8,60.6,64.9,00000
78.0,66.0,23.0,846,01,01,  Bipinpur,1066,768,560,390,506,378,58.1,58.9,57.2,00000
78.0,66.0,23.0,846,02,01,  Serajpur,753,543,370,301,383,242,58.1,55.1,61.3,00000
78.0,66.0,23.0,846,03,01,  Mohipur,1927,1389,1446,1174,481,215,58.1,55.2,69.1,00000
78.0,66.0,23.0,846,04,01,  Nazirpur,1251,1199,636,659,615,540,51.1,49.1,53.2,00000
78.0,66.0,23.0,846,05,01,  Kamalpur,416,714,206,368,210,346,36.8,35.9,37.8,00000
78.0,66.0,23.0,846,06,01,  Sudirpur,872,609,422,331,450,278,58.9,56.0,61.8,00000
78.0,66.0,23.0,994,01,01,  Moazzempur,473,334,222,160,251,174,58.6,58.1,59.1,00000
78.0,66.0,23.0,994,02,01,  Latifpur,433,180,207,98,226,82,70.6,67.9,73.4,00000
78.0,66.0,23.0,994,03,01,  Nij Shibbaria,548,385,248,198,300,187,58.7,55.6,61.6,00000
78.0,66.0,23.0,994,04,01,  Yousufpur,445,280,210,147,235,133,61.4,58.8,63.9,00000
78.0,66.0,29.0,105,01,01,  Nayakata,285,423,132,224,153,199,40.3,37.1,43.5,00000
78.0,66.0,29.0,105,02,01,  Tarikata,407,235,217,115,190,120,63.4,65.4,61.3,00000
78.0,66.0,29.0,105,03,01,  Betkata Char,174,245,89,121,85,124,41.5,42.4,40.7,00000
78.0,66.0,29.0,105,04,01,  Betkata Para,262,263,123,131,139,132,49.9,48.4,51.3,00000
78.0,66.0,29.0,105,05,01,  Betkata Muslum Para,46,31,24,13,22,18,59.7,64.9,55.0,00000
78.0,66.0,29.0,105,06,01,  Baoltali Para,196,151,93,74,103,77,56.5,55.7,57.2,00000
78.0,66.0,29.0,105,07,01,  Baultali Muslim Para,110,79,54,26,56,53,58.2,67.5,51.4,00000
78.0,66.0,29.0,190,01,01,  Char Chapli,622,945,302,463,320,482,39.7,39.5,39.9,00000
78.0,66.0,29.0,190,02,01,  Paschim Char Chapli,417,587,220,306,197,281,41.5,41.8,41.2,00000
78.0,66.0,29.0,190,03,01,  Nutan Para,429,655,218,358,211,297,39.6,37.8,41.5,00000
78.0,66.0,29.0,190,04,01,  Dakshin Chapli,35,276,16,143,19,133,11.3,10.1,12.5,00000
78.0,66.0,29.0,338,01,01,  Ananta Para,407,478,207,229,200,249,46.0,47.5,44.5,00000
78.0,66.0,29.0,338,02,01,  Purba Dhulasar,426,588,197,288,229,300,42.0,40.6,43.3,00000
78.0,66.0,29.0,338,03,01,  Paschim Dhulasar,551,728,293,345,258,383,43.1,45.9,40.2,00000
78.0,66.0,29.0,338,04,01,  Char Dhulasar,414,789,188,400,226,389,34.4,32.0,36.7,00000
78.0,66.0,29.0,381,01,01,  Gangamati,216,766,111,389,105,377,22.0,22.2,21.8,00000
78.0,66.0,29.0,381,02,01,  Barahar Para,76,234,42,119,34,115,24.5,26.1,22.8,00000
78.0,66.0,29.0,381,03,01,  Char Gangamati,151,526,68,291,83,235,22.3,18.9,26.1,00000
78.0,66.0,35.0,063,01,01,  Pasur Bunia,172,263,89,126,83,137,39.5,41.4,37.7,00000
78.0,66.0,35.0,063,02,01,  Chari Para,259,970,141,493,118,477,21.1,22.2,19.8,00000
78.0,66.0,35.0,063,03,01,  Dhanju Para,117,158,59,73,58,85,42.5,44.7,40.6,00000
78.0,66.0,35.0,063,04,01,  Banati Para,284,159,136,80,148,79,64.1,63.0,65.2,00000
78.0,66.0,35.0,063,05,01,  11 No Haola,195,144,90,72,105,72,57.5,55.6,59.3,00000
78.0,66.0,35.0,063,06,01,  Kalau Para(Part),352,335,199,148,153,187,51.2,57.3,45.0,00000
78.0,66.0,35.0,148,01,01,  Chandu Para,729,1556,371,763,358,793,31.9,32.7,31.1,00000
78.0,66.0,35.0,148,02,01,  Kalau Para(Part),84,148,54,68,30,80,36.2,44.3,27.3,00000
78.0,66.0,35.0,148,03,01,  Hasna Para,291,260,141,115,150,145,52.8,55.1,50.8,00000
78.0,66.0,35.0,148,04,01,  Manju Para,368,721,194,374,174,347,33.8,34.2,33.4,00000
78.0,66.0,35.0,402,01,01,  Golbunia,117,174,66,66,51,108,40.2,50.0,32.1,00000
78.0,66.0,35.0,402,02,01,  Majher Haola,334,223,164,107,170,116,60.0,60.5,59.4,00000
78.0,66.0,35.0,402,03,01,  Chingaria,147,347,64,176,83,171,29.8,26.7,32.7,00000
78.0,66.0,35.0,402,04,01,  Chonkhola,270,300,130,135,140,165,47.4,49.1,45.9,00000
78.0,66.0,35.0,550,01,01,  Lalua,165,108,85,53,80,55,60.4,61.6,59.3,00000
78.0,66.0,35.0,550,02,01,  Merau Para,81,230,44,115,37,115,26.0,27.7,24.3,00000
78.0,66.0,35.0,550,03,01,  Mahallah Para,265,354,120,168,145,186,42.8,41.7,43.8,00000
78.0,66.0,35.0,550,04,01,  Naya Para,108,156,54,73,54,83,40.9,42.5,39.4,00000
78.0,66.0,35.0,550,05,01,  Daskani,77,163,37,84,40,79,32.1,30.6,33.6,00000
78.0,66.0,35.0,550,06,01,  Manirgutia,47,42,28,26,19,16,52.8,51.9,54.3,00000
78.0,66.0,35.0,635,01,01,  Madhu Para,366,361,179,167,187,194,50.3,51.7,49.1,00000
78.0,66.0,35.0,635,02,01,  Machhuakhali,236,173,120,78,116,95,57.7,60.6,55.0,00000
78.0,66.0,35.0,635,03,01,  Garadkhali,90,113,46,47,44,66,44.3,49.5,40.0,00000
78.0,66.0,35.0,719,01,01,  Nayakata,17,77,7,44,10,33,18.1,13.7,23.3,00000
78.0,66.0,35.0,719,02,01,  Chowdhury Para,127,287,58,142,69,145,30.7,29.0,32.2,00000
78.0,66.0,35.0,719,03,01,  Munshi Para,206,432,100,222,106,210,32.3,31.1,33.5,00000
78.0,66.0,35.0,719,04,01,  Naowa Para,180,504,141,386,39,118,26.3,26.8,24.8,00000
78.0,66.0,35.0,719,05,01,  Bara No-5,261,229,135,103,126,126,53.3,56.7,50.0,00000
78.0,66.0,35.0,719,06,01,  Chhota No.5,100,261,52,124,48,137,27.7,29.5,25.9,00000
78.0,66.0,35.0,783,01,01,  Nishanbaria,213,324,109,151,104,173,39.7,41.9,37.5,00000
78.0,66.0,35.0,783,02,01,  Gandamari,252,450,133,239,119,211,35.9,35.8,36.1,00000
78.0,66.0,35.0,783,03,01,  Marichbunia,250,285,124,141,126,144,46.7,46.8,46.7,00000
78.0,66.0,35.0,783,04,01,  Daser Haola,300,220,148,96,152,124,57.7,60.7,55.1,00000
78.0,66.0,47.0,592,01,01,  Tulatali,557,156,304,55,253,101,78.1,84.7,71.5,00000
78.0,66.0,47.0,592,02,01,  Mambi Para,329,606,157,317,172,289,35.2,33.1,37.3,00000
78.0,66.0,47.0,592,03,01,  Achalat Para,389,218,201,104,188,114,64.1,65.9,62.3,00000
78.0,66.0,47.0,592,04,01,  Pauragoza,143,145,75,72,68,73,49.7,51.0,48.2,00000
78.0,66.0,47.0,592,05,01,  Misri Para,504,360,273,176,231,184,58.3,60.8,55.7,00000
78.0,66.0,47.0,592,06,01,  Naya Misri Para,360,387,175,205,185,182,48.2,46.1,50.4,00000
78.0,66.0,47.0,592,07,01,  Danku Para,225,215,114,110,111,105,51.1,50.9,51.4,00000
78.0,66.0,47.0,592,08,01,  Panau Para,226,133,132,68,94,65,63.0,66.0,59.1,00000
78.0,66.0,47.0,592,09,01,  Maitbhanga,602,251,310,135,292,116,70.6,69.7,71.6,00000
78.0,66.0,47.0,592,10,01,  Azimpur,499,387,262,177,237,210,56.3,59.7,53.0,00000
78.0,66.0,47.0,592,11,01,  Tajpara,214,141,109,70,105,71,60.3,60.9,59.7,00000
78.0,66.0,47.0,592,12,01,  Lakshmi Para,163,116,90,62,73,54,58.4,59.2,57.5,00000
78.0,66.0,47.0,592,13,01,  Biuramkhola,810,1101,371,578,439,523,42.4,39.1,45.6,00000
78.0,66.0,47.0,592,14,01,  Gora Amkhola Para,138,241,71,120,67,121,36.4,37.2,35.6,00000
78.0,66.0,47.0,592,15,01,  Reserve Forest,134,192,48,117,86,75,41.1,29.1,53.4,00000
78.0,66.0,47.0,592,16,01,  Thobashi Para,343,153,209,74,134,79,69.2,73.9,62.9,00000
78.0,66.0,47.0,592,17,01,  Kachopkhali,440,418,238,184,202,234,51.3,56.4,46.3,00000
78.0,66.0,47.0,592,18,01,  Thanju Para,226,340,117,165,109,175,39.9,41.5,38.4,00000
78.0,66.0,47.0,592,19,01,  Naya Para,317,251,164,143,153,108,55.8,53.4,58.6,00000
78.0,66.0,47.0,592,20,01,  Kalachan Para,388,236,213,120,175,116,62.2,64.0,60.1,00000
78.0,66.0,47.0,592,21,01,  Ali Pur,1166,785,641,399,525,386,59.8,61.6,57.6,00000
78.0,66.0,47.0,592,22,01,  Khanabad,279,512,140,268,139,244,35.3,34.3,36.3,00000
78.0,66.0,47.0,592,23,01,  Tulatali-2,209,100,111,53,98,47,67.6,67.7,67.6,00000
78.0,66.0,47.0,592,24,01,  Sarifpur,289,186,135,115,154,71,60.8,54.0,68.4,00000
78.0,66.0,47.0,592,25,01,  Fashi Para,436,338,239,167,197,171,56.3,58.9,53.5,00000
78.0,66.0,47.0,592,26,01,  Nayuri Para,545,168,272,74,273,94,76.4,78.6,74.4,00000
78.0,66.0,47.0,592,27,01,  Khazura,1221,1718,595,927,626,791,41.5,39.1,44.2,00000
78.0,66.0,47.0,592,28,01,  Mothey Para,219,185,113,91,106,94,54.2,55.4,53.0,00000
78.0,66.0,47.0,592,29,01,  Kalai Para,305,91,154,56,151,35,77.0,73.3,81.2,00000
78.0,66.0,59.0,613,01,01,  Purba Madhukhali,629,630,306,294,323,336,50.0,51.0,49.0,00000
78.0,66.0,59.0,613,02,01,  Mithaganj,420,513,222,247,198,266,45.0,47.3,42.7,00000
78.0,66.0,59.0,613,03,01,  Baysakhala,161,177,81,93,80,84,47.6,46.6,48.8,00000
78.0,66.0,59.0,677,01,01,  Aliganj,209,587,106,290,103,297,26.3,26.8,25.8,00000
78.0,66.0,59.0,677,02,01,  Aramganj,414,420,208,216,206,204,49.6,49.1,50.2,00000
78.0,66.0,59.0,677,03,01,  Golbunia,447,360,230,176,217,184,55.4,56.7,54.1,00000
78.0,66.0,59.0,677,04,01,  Paschim Madhukhali,369,524,172,244,197,280,41.3,41.3,41.3,00000
78.0,66.0,59.0,910,01,01,  Tegachhia,540,187,284,96,256,91,74.3,74.7,73.8,00000
78.0,66.0,59.0,910,02,01,  Azimuddin,188,166,95,78,93,88,53.1,54.9,51.4,00000
78.0,66.0,59.0,910,03,01,  Mela Para,142,331,67,171,75,160,30.0,28.2,31.9,00000
78.0,66.0,59.0,910,04,01,  Safakhali,292,442,155,218,137,224,39.8,41.6,38.0,00000
78.0,66.0,59.0,910,05,01,  Islampur,69,193,29,107,40,86,26.3,21.3,31.7,00000
78.0,66.0,59.0,910,06,01,  Uttar Char Para,234,249,123,119,111,130,48.4,50.8,46.1,00000
78.0,66.0,59.0,910,07,01,  Dakshin Char Para,285,437,152,205,133,232,39.5,42.6,36.4,00000
39.5,42.6,36.4,078,66,02,Kuakata  Paurashava,4430,3437,2561,1782,1869,1655,57.6,60.6,54.5,00000
78.0,66.0,71.0,423,01,01,  Purba Hajipur,267,45,131,27,136,18,85.6,82.9,88.3,00000
78.0,66.0,71.0,423,02,01,  Paschim Hajipur,289,198,141,89,148,109,59.3,61.3,57.6,00000
78.0,66.0,71.0,423,03,01,  Uttar Haldibaria,277,191,113,106,164,85,59.2,51.6,65.9,00000
78.0,66.0,71.0,423,04,01,  Dakshin Haldibaria,355,238,137,117,218,121,59.9,53.9,64.3,00000
78.0,66.0,71.0,423,05,01,  Saidpur,187,105,76,47,111,58,64.0,61.8,65.7,00000
78.0,66.0,71.0,423,06,01,  Sadarpur,159,90,86,45,73,45,63.9,65.6,61.9,00000
78.0,66.0,71.0,423,07,01,  Dariapur,293,121,127,73,166,48,70.8,63.5,77.6,00000
78.0,66.0,71.0,423,08,01,  Jalalpur,287,226,111,129,176,97,55.9,46.3,64.5,00000
78.0,66.0,71.0,423,09,01,  Majidbaria,219,164,108,83,111,81,57.2,56.5,57.8,00000
78.0,66.0,71.0,423,10,01,  Akkalpur,232,199,109,102,123,97,53.8,51.7,55.9,00000
78.0,66.0,71.0,529,01,01,  Kumirmara,555,285,276,149,279,136,66.1,64.9,67.2,00000
78.0,66.0,71.0,529,02,01,  Majidpur,173,96,79,46,94,50,64.3,63.2,65.3,00000
78.0,66.0,71.0,529,03,01,  Alempur,333,211,157,110,176,101,61.2,58.8,63.5,00000
78.0,66.0,71.0,529,04,01,  Baintala,165,150,68,80,97,70,52.4,45.9,58.1,00000
78.0,66.0,71.0,698,01,01,  Purba Nabipur,229,27,120,10,109,17,89.5,92.3,86.5,00000
78.0,66.0,71.0,698,02,01,  Gamurtala,263,93,125,48,138,45,73.9,72.3,75.4,00000
78.0,66.0,71.0,698,03,01,  Islampur,206,136,101,65,105,71,60.2,60.8,59.7,00000
78.0,66.0,71.0,698,04,01,  Ghutabachha,197,128,91,61,106,67,60.6,59.9,61.3,00000
78.0,66.0,71.0,698,05,01,  Niamatpur,225,62,120,24,105,38,78.4,83.3,73.4,00000
78.0,66.0,71.0,698,06,01,  Paschim Nabipur,315,111,143,60,172,51,73.9,70.4,77.1,00000
78.0,66.0,71.0,740,01,01,  Nilganj,774,493,403,246,371,247,61.1,62.1,60.0,00000
78.0,66.0,71.0,740,02,01,  Nababganj,267,196,141,101,126,95,57.7,58.3,57.0,00000
78.0,66.0,71.0,740,03,01,  Sultanganj,218,86,106,44,112,42,71.7,70.7,72.7,00000
78.0,66.0,71.0,740,04,01,  Faridganj,328,259,168,133,160,126,55.9,55.8,55.9,00000
78.0,66.0,71.0,740,05,01,  Salimpur,656,334,327,168,329,166,66.3,66.1,66.5,00000
78.0,66.0,71.0,740,06,01,  Abason,285,501,139,241,146,260,36.3,36.6,36.0,00000
78.0,66.0,71.0,889,01,01,  Paschim Sonatala,361,192,188,88,173,104,65.3,68.1,62.5,00000
78.0,66.0,71.0,889,02,01,  Dakshin Sonatala,159,102,88,49,71,53,60.9,64.2,57.3,00000
78.0,66.0,71.0,889,03,01,  Rahmatpur,176,157,72,95,104,62,52.9,43.1,62.7,00000
78.0,66.0,71.0,889,04,01,  Fatehpur,287,254,155,132,132,122,53.0,54.0,52.0,00000
78.0,66.0,71.0,889,05,01,  Adampur,220,25,126,10,94,15,89.8,92.6,86.2,00000
78.0,66.0,71.0,889,06,01,  Rosnabad,193,98,79,47,114,51,66.3,62.7,69.1,00000
78.0,66.0,71.0,889,07,01,  Amirabad,454,241,232,127,222,114,65.3,64.6,66.1,00000
78.0,66.0,71.0,889,08,01,  Khalilpur,379,199,177,98,202,101,65.6,64.4,66.7,00000
78.0,66.0,71.0,889,09,01,  Dakshin Daulatpur,184,202,74,112,110,90,47.7,39.8,55.0,00000
78.0,66.0,71.0,889,10,01,  Purba Daulutpur,104,110,52,49,52,61,48.6,51.5,46.0,00000
78.0,66.0,71.0,889,11,01,  Uttar Daulatpur,82,136,36,74,46,62,37.6,32.7,42.6,00000
78.0,66.0,71.0,952,01,01,  Tungibaria,365,292,177,130,188,162,55.6,57.7,53.7,00000
78.0,66.0,71.0,952,02,01,  Hossainpur,184,100,81,45,103,55,64.8,64.3,65.2,00000
78.0,66.0,71.0,952,03,01,  Makimpur,276,23,146,12,130,11,92.3,92.4,92.2,00000
78.0,66.0,71.0,952,04,01,  Naobhanga,327,187,162,83,165,104,63.6,66.1,61.3,00000
78.0,66.0,71.0,952,05,01,  Nijkata,200,32,102,8,98,24,86.2,92.7,80.3,00000
78.0,66.0,71.0,952,06,01,  Chan Para,162,42,80,16,82,26,79.4,83.3,75.9,00000
78.0,66.0,71.0,952,07,01,  Pakhimara,569,241,288,128,281,113,70.2,69.2,71.3,00000
78.0,66.0,71.0,973,01,01,  Umedpur,500,140,233,72,267,68,78.1,76.4,79.7,00000
78.0,66.0,71.0,973,02,01,  Taherpur,411,240,201,124,210,116,63.1,61.8,64.4,00000
78.0,66.0,71.0,973,03,01,  Mohonpur,178,87,81,45,97,42,67.2,64.3,69.8,00000
78.0,66.0,71.0,973,04,01,  Laskarpur,245,144,112,66,133,78,63.0,62.9,63.0,00000
78.0,66.0,71.0,973,05,01,  Purba Mostafapur,306,231,162,115,144,116,57.0,58.5,55.4,00000
78.0,66.0,71.0,973,06,01,  Paschim Mostafapur,209,227,105,99,104,128,47.9,51.5,44.8,00000
78.0,66.0,71.0,973,07,01,  Hakimpur,117,139,44,78,73,61,45.7,36.1,54.5,00000
78.0,66.0,71.0,973,08,01,  Mohammadpur,200,121,98,61,102,60,62.3,61.6,63.0,00000
78.0,66.0,71.0,973,09,01,  Uttar Gayatala,194,155,98,71,96,84,55.6,58.0,53.3,00000
78.0,66.0,71.0,973,10,01,  Dakshin Gayatala,253,82,114,43,139,39,75.5,72.6,78.1,00000
78.0,66.0,71.0,973,11,01,  Purba Sonatala,176,163,69,88,107,75,51.9,43.9,58.8,00000
78.0,66.0,83.0,931,01,01,  East Tiakhali,517,683,274,340,243,343,43.1,44.6,41.5,00000
78.0,66.0,83.0,931,02,01,  Middle Tiakhali,326,587,175,275,151,312,35.7,38.9,32.6,00000
78.0,66.0,83.0,931,03,01,  West Tiakhali,346,364,183,169,163,195,48.7,52.0,45.5,00000
78.0,76.0,40.0,351,01,01,  Uttar Gabua,1072,356,559,145,513,211,75.1,79.4,70.9,00000
78.0,76.0,40.0,351,02,01,  Dakshin Gabua,1194,1229,633,580,561,649,49.3,52.2,46.4,00000
78.0,76.0,40.0,453,01,01,  Uttar Kakrabunia,1157,908,631,392,526,516,56.0,61.7,50.5,00000
78.0,76.0,40.0,453,02,01,  Dakshin Kakrabunia,711,526,358,228,353,298,57.5,61.1,54.2,00000
78.0,76.0,54.0,204,01,01,  Purba Chaita,770,255,384,113,386,142,75.1,77.3,73.1,00000
78.0,76.0,54.0,204,02,01,  Paschim Chaita,537,610,279,266,258,344,46.8,51.2,42.9,00000
78.0,76.0,54.0,731,01,01,  Nutan Sreenagar,528,237,274,98,254,139,69.0,73.7,64.6,00000
78.0,76.0,54.0,731,02,01,  Labubunia,260,49,120,17,140,32,84.1,87.6,81.4,00000
78.0,76.0,67.0,541,01,01,  Khatasaia,606,359,326,140,280,219,62.8,70.0,56.1,00000
78.0,76.0,67.0,541,02,01,  Sultana Bad,420,304,225,123,195,181,58.0,64.7,51.9,00000
78.0,95.0,10.0,789,01,01,  Pacha Koralia,1550,1427,746,618,804,809,52.1,54.7,49.8,00000
78.0,95.0,10.0,789,02,01,  Paschim Pacha Koralia,822,811,399,356,423,455,50.3,52.8,48.2,00000
78.0,95.0,10.0,973,01,01,  Uttar Badura,1637,1052,864,461,773,591,60.9,65.2,56.7,00000
78.0,95.0,10.0,973,02,01,  Dakshin Badura,927,1053,473,457,454,596,46.8,50.9,43.2,00000
78.0,95.0,11.0,556,01,01,  Khalisakhali,2883,1790,1495,827,1388,963,61.7,64.4,59.0,00000
78.0,95.0,11.0,556,02,01,  Siali,1493,1316,758,612,735,704,53.2,55.3,51.1,00000
78.0,95.0,11.0,556,03,01,  Haktulla,704,678,363,301,341,377,50.9,54.7,47.5,00000
78.0,95.0,11.0,556,04,01,  Majkhali,245,383,134,177,111,206,39.0,43.1,35.0,00000
78.0,95.0,20.0,766,01,01,  Pukurjana,1125,683,574,271,551,412,62.2,67.9,57.2,00000
78.0,95.0,20.0,766,02,01,  Baniakati,488,431,226,172,262,259,53.1,56.8,50.3,00000
78.0,95.0,20.0,766,03,01,  Kichabania,666,354,344,151,322,203,65.3,69.5,61.3,00000
78.0,95.0,27.0,547,01,03,  Pirtala,372,310,184,138,188,172,54.5,57.1,52.2,00000
78.0,95.0,27.0,547,02,03,  Talbaria,107,129,60,63,47,66,45.3,48.8,41.6,00000
78.0,95.0,27.0,547,03,03,  Bagirabad,136,156,76,60,60,96,46.6,55.9,38.5,00000
78.0,95.0,27.0,547,04,03,  Thangai,517,573,259,266,258,307,47.4,49.3,45.7,00000
78.0,95.0,27.0,547,05,03,  Keshabpur,760,667,403,292,357,375,53.3,58.0,48.8,00000
78.0,95.0,27.0,547,06,03,  Chamta,167,264,106,113,61,151,38.7,48.4,28.8,00000
78.0,95.0,27.0,812,01,01,  Purba Jainkati,1863,1871,958,828,905,1043,49.9,53.6,46.5,00000
78.0,95.0,27.0,812,02,01,  Paschim Jainkati,78,74,38,37,40,37,51.3,50.7,51.9,00000
78.0,95.0,31.0,061,01,01,  Bara Bighai,1001,739,500,302,501,437,57.5,62.3,53.4,00000
78.0,95.0,31.0,061,02,01,  Jorkhali,946,648,495,256,451,392,59.3,65.9,53.5,00000
78.0,95.0,31.0,294,01,01,  Patukhali,346,533,170,224,176,309,39.4,43.1,36.3,00000
78.0,95.0,31.0,294,02,01,  Paksia,326,514,160,256,166,258,38.8,38.5,39.2,00000
78.0,95.0,31.0,294,03,01,  Dakshin Bighai,685,669,337,329,348,340,50.6,50.6,50.6,00000
78.0,95.0,31.0,294,04,01,  Saisabunia,340,224,151,99,189,125,60.3,60.4,60.2,00000
78.0,95.0,31.0,798,01,01,  Paschim Kewabania,1118,1110,537,501,581,609,50.2,51.7,48.8,00000
78.0,95.0,31.0,798,02,01,  Purba Kewabunia,1297,952,647,410,650,542,57.7,61.2,54.5,00000
78.0,95.0,31.0,958,01,01,  Dakshin Titkata,867,788,432,355,435,433,52.4,54.9,50.1,00000
78.0,95.0,31.0,958,02,01,  Uttar Titkata,928,762,485,332,443,430,54.9,59.4,50.7,00000
78.0,95.0,54.0,611,01,01,  Lohalia,1734,1416,899,683,835,733,55.0,56.8,53.3,00000
78.0,95.0,54.0,611,02,01,  Nazirpur,694,604,357,287,337,317,53.5,55.4,51.5,00000
78.0,95.0,54.0,693,01,01,  Pajakhali Hazara,932,727,463,314,469,413,56.2,59.6,53.2,00000
78.0,95.0,54.0,693,02,01,  Uttar Lohalia,291,106,167,35,124,71,73.3,82.7,63.6,00000
78.0,95.0,61.0,337,01,01,  Dheukhali,1653,697,863,336,790,361,70.3,72.0,68.6,00000
78.0,95.0,61.0,337,02,01,  Golbonia,293,304,168,139,125,165,49.1,54.7,43.1,00000
78.0,95.0,74.0,127,01,01,  Dakshin Bazarghona,817,1167,399,549,418,618,41.2,42.1,40.3,00000
78.0,95.0,74.0,127,02,01,  Uttar Bazarghona,538,669,248,285,290,384,44.6,46.5,43.0,00000
6.0,2.0,13.0,049,01,01,  Paschim Bagdha,1656,1082,819,519,837,563,60.5,61.2,59.8,00000
6.0,2.0,13.0,049,02,01,  Purba Bagdha,1395,1203,672,612,723,591,53.7,52.3,55.0,00000
6.0,2.0,13.0,049,03,01,  Khajuria,1031,1362,523,677,508,685,43.1,43.6,42.6,00000
6.0,2.0,13.0,401,01,01,  Gopal Sen,179,221,92,97,87,124,44.8,48.7,41.2,00000
6.0,2.0,13.0,401,02,01,  Khachikandi,248,188,123,83,125,105,56.9,59.7,54.3,00000
6.0,2.0,13.0,401,03,01,  Nimarpar,130,63,67,24,63,39,67.4,73.6,61.8,00000
6.0,2.0,13.0,436,01,01,  Jobarpar,1480,569,745,216,735,353,72.2,77.5,67.6,00000
6.0,2.0,13.0,436,02,01,  Somairpar,629,223,307,103,322,120,73.8,74.9,72.9,00000
6.0,2.0,13.0,436,03,01,  Nagirpar,536,226,261,103,275,123,70.3,71.7,69.1,00000
6.0,2.0,13.0,475,01,01,  Kalirbari,2586,1068,1286,441,1300,627,70.8,74.5,67.5,00000
6.0,2.0,13.0,475,02,01,  Chakribari,469,255,256,104,213,151,64.8,71.1,58.5,00000
6.0,2.0,15.0,529,01,01,  Kodal Dhoa,1455,713,732,301,723,412,67.1,70.9,63.7,00000
6.0,2.0,15.0,529,02,01,  Ambari,435,438,212,204,223,234,49.8,51.0,48.8,00000
6.0,2.0,15.0,529,03,01,  Andhar Manik,268,169,143,70,125,99,61.3,67.1,55.8,00000
6.0,2.0,15.0,529,04,01,  Kadambari,253,189,129,81,124,108,57.2,61.4,53.4,00000
6.0,2.0,15.0,529,05,01,  Phanabari,323,185,176,83,147,102,63.6,68.0,59.0,00000
6.0,2.0,15.0,529,06,01,  Rajapur,181,83,90,33,91,50,68.6,73.2,64.5,00000
6.0,2.0,15.0,529,07,01,  Shimulbari,197,26,104,6,93,20,88.3,94.5,82.3,00000
6.0,2.0,79.0,014,01,01,  Ahuti Bhatra,802,248,380,104,422,144,76.4,78.5,74.6,00000
6.0,2.0,79.0,014,02,01,  Ahuti,383,140,185,62,198,78,73.2,74.9,71.7,00000
6.0,2.0,79.0,014,03,01,  Bahadurpur,1449,654,754,264,695,390,68.9,74.1,64.1,00000
6.0,2.0,79.0,014,04,01,  Magura,277,361,143,167,134,194,43.4,46.1,40.9,00000
6.0,2.0,87.0,612,01,01,  Nagar,430,337,230,141,200,196,56.1,62.0,50.5,00000
6.0,2.0,87.0,612,02,01,  Dighibali,250,111,139,49,111,62,69.3,73.9,64.2,00000
6.0,2.0,87.0,926,01,01,  Sundargaon,284,59,132,25,152,34,82.8,84.1,81.7,00000
6.0,2.0,87.0,926,02,01,  Thaneshwar Kati,299,260,177,123,122,137,53.5,59.0,47.1,00000
6.0,3.0,27.0,178,01,01,  Chand Pasha,866,383,413,175,453,208,69.3,70.2,68.5,00000
6.0,3.0,27.0,178,02,01,  Sreemantory,482,168,228,75,254,93,74.2,75.2,73.2,00000
6.0,3.0,27.0,178,03,01,  Degreer Char,488,285,235,141,253,144,63.1,62.5,63.7,00000
6.0,3.0,27.0,178,04,01,  Aichar Haola,314,405,151,201,163,204,43.7,42.9,44.4,00000
6.0,3.0,27.0,178,05,01,  Ghatker Char,602,277,306,120,296,157,68.5,71.8,65.3,00000
6.0,3.0,67.0,676,01,01,  Madhab Pasha,1175,235,563,114,612,121,83.3,83.2,83.5,00000
6.0,3.0,67.0,676,02,01,  Baroikhali,1175,329,561,159,614,170,78.1,77.9,78.3,00000
6.0,3.0,67.0,676,03,01,  Bir Pasha,720,226,326,100,394,126,76.1,76.5,75.8,00000
6.0,3.0,67.0,676,04,01,  Fultala,613,180,302,88,311,92,77.3,77.4,77.2,00000
6.0,3.0,67.0,676,05,01,  Goal Battan,248,86,127,36,121,50,74.3,77.9,70.8,00000
6.0,3.0,81.0,867,01,01,  Rajguru,1196,703,563,328,633,375,63.0,63.2,62.8,00000
6.0,3.0,81.0,867,02,01,  Boalia,247,24,116,11,131,13,91.1,91.3,91.0,00000
6.0,7.0,12.0,147,01,03,  Bhar Pasha (Part),958,559,506,283,452,276,63.2,64.1,62.1,00000
6.0,7.0,12.0,147,02,03,  Khejura Bhar Pasha,1028,383,482,173,546,210,72.9,73.6,72.2,00000
6.0,7.0,13.0,449,01,01,  Halta,889,477,452,223,437,254,65.1,67.0,63.2,00000
6.0,7.0,13.0,449,02,01,  Gpalpur,904,494,435,216,469,278,64.7,66.8,62.8,00000
6.0,7.0,20.0,250,01,01,  Diar Char,646,449,277,233,369,216,59.0,54.3,63.1,00000
6.0,7.0,20.0,250,02,01,  Paschim Charamaddi,575,205,252,92,323,113,73.7,73.3,74.1,00000
6.0,7.0,20.0,250,03,01,  Char Amaddi,864,423,398,209,466,214,67.1,65.6,68.5,00000
6.0,7.0,20.0,250,04,01,  Majhgram,646,120,316,57,330,63,84.3,84.7,84.0,00000
6.0,7.0,20.0,250,05,01,  Satikhola,1371,569,613,260,758,309,70.7,70.2,71.0,00000
6.0,7.0,20.0,250,06,01,  Kalidasia,1340,553,636,238,704,315,70.8,72.8,69.1,00000
6.0,7.0,20.0,558,01,01,  Uttar Katadia,1424,610,682,308,742,302,70.0,68.9,71.1,00000
6.0,7.0,20.0,558,02,01,  Dakshin Katadia,950,378,451,191,499,187,71.5,70.2,72.7,00000
6.0,7.0,33.0,096,01,01,  Uttar Dudhal,1340,884,601,395,739,489,60.3,60.3,60.2,00000
6.0,7.0,33.0,096,02,01,  Dakshin Dudhal,1307,712,589,309,718,403,64.7,65.6,64.0,00000
6.0,7.0,33.0,096,03,01,  Madhya Dudhal,775,458,343,205,432,253,62.9,62.6,63.1,00000
6.0,7.0,33.0,430,01,01,  Goma,831,439,379,208,452,231,65.4,64.6,66.2,00000
6.0,7.0,33.0,430,02,01,  Char Goma,527,211,238,97,289,114,71.4,71.0,71.7,00000
6.0,7.0,33.0,911,01,01,  Sataraj,114,252,51,119,63,133,31.1,30.0,32.1,00000
6.0,7.0,33.0,911,02,01,  Pratappur,175,180,88,79,87,101,49.3,52.7,46.3,00000
6.0,7.0,40.0,423,01,01,  Gobindapur,2236,1367,1058,634,1178,733,62.1,62.5,61.6,00000
6.0,7.0,40.0,423,02,01,  Bataspur,204,135,106,69,98,66,60.2,60.6,59.8,00000
6.0,7.0,47.0,154,01,01,  Kakardha,523,269,262,133,261,136,66.0,66.3,65.7,00000
6.0,7.0,47.0,154,02,01,  Sonapura,573,275,288,121,285,154,67.6,70.4,64.9,00000
6.0,7.0,47.0,154,03,01,  Bhatsala,2119,1580,1089,719,1030,861,57.3,60.2,54.5,00000
6.0,7.0,67.0,044,01,01,  Uttar Baghdia,1304,673,649,319,655,354,66.0,67.0,64.9,00000
6.0,7.0,67.0,044,02,01,  Dakshin Baghdia,1634,1109,811,489,823,620,59.6,62.4,57.0,00000
6.0,7.0,67.0,269,01,01,  Chhota Dudhal,444,571,201,272,243,299,43.7,42.5,44.8,00000
6.0,7.0,67.0,269,02,01,  Kchnagar,237,259,129,92,108,167,47.8,58.4,39.3,00000
6.0,7.0,74.0,680,01,01,  Nalua,2469,2101,1171,923,1298,1178,54.0,55.9,52.4,00000
6.0,7.0,74.0,680,02,01,  Bair Howla,188,211,94,95,94,116,47.1,49.7,44.8,00000
6.0,7.0,81.0,693,01,01,  Niamati,2823,1469,1407,610,1416,859,65.8,69.8,62.2,00000
6.0,7.0,81.0,693,02,01,  Chamta,1434,578,667,238,767,340,71.3,73.7,69.3,00000
6.0,7.0,81.0,860,01,01,  Ramnagar,2634,1014,1231,425,1403,589,72.2,74.3,70.4,00000
6.0,7.0,81.0,860,02,01,  Dalmara,487,330,241,136,246,194,59.6,63.9,55.9,00000
6.0,7.0,81.0,860,03,01,  Rupargor,708,462,344,223,364,239,60.5,60.7,60.4,00000
6.0,7.0,94.0,686,01,01,  Nanda Para,1307,472,625,215,682,257,73.5,74.4,72.6,00000
6.0,7.0,94.0,686,02,01,  Auliapur,1224,503,563,221,661,282,70.9,71.8,70.1,00000
6.0,7.0,94.0,948,01,01,  Tabirkati,683,246,318,116,365,130,73.5,73.3,73.7,00000
6.0,7.0,94.0,948,02,01,  Nagerkati,281,91,135,48,146,43,75.5,73.8,77.2,00000
6.0,32.0,71.0,617,01,01,  Nalchira,725,409,346,194,379,215,63.9,64.1,63.8,00000
6.0,32.0,71.0,617,02,01,  Nalchira Guchchhagram,41,65,24,35,17,30,38.7,40.7,36.2,00000
6.0,51.0,32.0,138,01,01,  Uttar Chandpura,593,465,268,235,325,230,56.0,53.3,58.6,00000
6.0,51.0,32.0,138,02,01,  Chandpura,1464,670,685,318,779,352,68.6,68.3,68.9,00000
6.0,51.0,32.0,640,01,01,  Uttar Kundial Para,941,463,410,235,531,228,67.0,63.6,70.0,00000
6.0,51.0,32.0,640,02,01,  Dakshin Kundial Para,162,200,72,94,90,106,44.8,43.4,45.9,00000
6.0,51.0,32.0,840,01,01,  Purba Roypura,514,219,245,109,269,110,70.1,69.2,71.0,00000
6.0,51.0,32.0,840,02,01,  Paschim Roypura,580,146,283,78,297,68,79.9,78.4,81.4,00000
6.0,51.0,34.0,971,01,01,  Ullan Batna,314,177,143,88,171,89,64.0,61.9,65.8,00000
6.0,51.0,34.0,971,02,01,  Boghaishar,30,27,17,12,13,15,52.6,58.6,46.4,00000
6.0,51.0,43.0,331,01,01,  Dakshin Char Aicha,2930,1860,1574,932,1356,928,61.2,62.8,59.4,00000
6.0,51.0,43.0,331,02,01,  Dinar,1220,1406,624,678,596,728,46.5,47.9,45.0,00000
6.0,62.0,13.0,232,01,01,  Char Mahisha,296,345,157,162,139,183,46.2,49.2,43.2,00000
6.0,62.0,13.0,232,02,01,  Char Mitua,539,848,261,448,278,400,38.9,36.8,41.0,00000
6.0,62.0,13.0,232,03,01,  Patabunia,199,273,89,143,110,130,42.2,38.4,45.8,00000
6.0,62.0,15.0,066,01,01,  Azimpur,2911,1817,1346,865,1565,952,61.6,60.9,62.2,00000
6.0,62.0,15.0,066,02,01,  Katabhanga,313,294,134,150,179,144,51.6,47.2,55.4,00000
6.0,62.0,23.0,339,01,01,  Hajikanda,199,121,94,59,105,62,62.2,61.4,62.9,00000
6.0,62.0,23.0,339,02,01,  Khalisar Uttar Para,597,704,259,344,338,360,45.9,43.0,48.4,00000
6.0,62.0,23.0,339,03,01,  Akonkanda,217,138,94,57,123,81,61.1,62.3,60.3,00000
6.0,62.0,23.0,339,04,01,  Raghuga,592,541,260,275,332,266,52.3,48.6,55.5,00000
6.0,62.0,23.0,339,05,01,  Majhgram,341,380,149,192,192,188,47.3,43.7,50.5,00000
6.0,62.0,23.0,339,06,01,  Khalisar Dakshin Para,401,378,180,190,221,188,51.5,48.6,54.0,00000
6.0,62.0,23.0,339,07,01,  Nama Para,300,330,129,162,171,168,47.6,44.3,50.4,00000
6.0,62.0,23.0,339,08,01,  Kadamakha,145,231,66,107,79,124,38.6,38.2,38.9,00000
6.0,62.0,23.0,339,09,01,  Madarbunia,239,697,109,332,130,365,25.5,24.7,26.3,00000
6.0,62.0,23.0,339,10,01,  Hessamdi,731,351,320,161,411,190,67.6,66.5,68.4,00000
6.0,62.0,31.0,223,01,01,  Char Madhab Roy,358,970,180,463,178,507,27.0,28.0,26.0,00000
6.0,62.0,31.0,223,02,01,  Madhab Roy,328,515,138,242,190,273,38.9,36.3,41.0,00000
6.0,62.0,31.0,721,01,01,  Purba Ratanpur,871,1149,390,524,481,625,43.1,42.7,43.5,00000
6.0,62.0,31.0,721,02,01,  Silmari,250,312,110,144,140,168,44.5,43.3,45.5,00000
6.0,62.0,39.0,538,01,01,  Purba Khagata,633,776,267,365,366,411,44.9,42.2,47.1,00000
6.0,62.0,39.0,538,02,01,  Madhya Khagata,257,384,91,184,166,200,40.1,33.1,45.4,00000
6.0,62.0,39.0,538,03,01,  Paschim Khagata,1088,988,523,471,565,517,52.4,52.6,52.2,00000
6.0,62.0,39.0,588,01,01,  Kulchari,516,581,229,279,287,302,47.0,45.1,48.7,00000
6.0,62.0,39.0,588,02,01,  Shyam Roy Char,857,671,384,324,473,347,56.1,54.2,57.7,00000
6.0,62.0,47.0,373,01,01,  Uttar Char Ekkuria,506,981,257,516,249,465,34.0,33.2,34.9,00000
6.0,62.0,47.0,373,02,01,  Dakhin Char Ekkariai,514,834,198,394,316,440,38.1,33.4,41.8,00000
6.0,62.0,47.0,373,03,01,  Chunar Char,720,698,315,364,405,334,50.8,46.4,54.8,00000
6.0,62.0,47.0,373,04,01,  Nalbunia,26,199,14,108,12,91,11.6,11.5,11.7,00000
6.0,62.0,55.0,456,01,01,  Prba Jaliar Char,1555,1100,775,516,780,584,58.6,60.0,57.2,00000
6.0,62.0,55.0,456,02,01,  Paschim Jaliar Char,779,586,351,292,428,294,57.1,54.6,59.3,00000
6.0,62.0,55.0,530,01,01,  Purba Kazir Char,49,276,21,137,28,139,15.1,13.3,16.8,00000
6.0,62.0,55.0,530,02,01,  Paschim Kazir Char,1002,883,468,431,534,452,53.2,52.1,54.2,00000
6.0,62.0,55.0,530,03,01,  Uttar Kazir Char,1212,966,558,508,654,458,55.6,52.3,58.8,00000
6.0,62.0,71.0,464,01,01,  Uttar Char Paschim,607,530,299,290,308,240,53.4,50.8,56.2,00000
6.0,62.0,71.0,464,02,01,  Uttar Langutia,912,514,396,236,516,278,64.0,62.7,65.0,00000
6.0,62.0,71.0,464,03,01,  Langutia,975,567,514,271,461,296,63.2,65.5,60.9,00000
6.0,62.0,71.0,464,04,01,  Dakshin Jangalia,1128,1218,556,613,572,605,48.1,47.6,48.6,00000
6.0,62.0,71.0,464,05,01,  Char Paschim,1412,1598,739,959,673,639,46.9,43.5,51.3,00000
6.0,69.0,23.0,208,01,01,  Char Kalekhan,1084,958,510,424,574,534,53.1,54.6,51.8,00000
6.0,69.0,23.0,208,02,01,  Paschim Char Kalekhan,1042,696,511,309,531,387,60.0,62.3,57.8,00000
6.0,69.0,23.0,208,03,01,  Nayakandi,306,259,143,109,163,150,54.2,56.7,52.1,00000
6.0,69.0,23.0,208,04,01,  Barakandi,1166,658,547,299,619,359,63.9,64.7,63.3,00000
6.0,69.0,23.0,208,05,01,  Baruakandi,219,122,103,52,116,70,64.2,66.5,62.4,00000
6.0,69.0,23.0,467,01,01,  Dakshin Lakshmipur,375,374,165,182,210,192,50.1,47.6,52.2,00000
6.0,69.0,23.0,467,02,01,  Paschim Lakshmipur,650,635,321,289,329,346,50.6,52.6,48.7,00000
6.0,69.0,23.0,467,03,01,  Uttar Lakshmipur,153,266,62,113,91,153,36.5,35.4,37.3,00000
6.0,69.0,23.0,467,04,01,  Madhya Lakshmipur,214,122,106,66,108,56,63.7,61.6,65.9,00000
6.0,69.0,23.0,467,05,01,  Purba Lakshmipur,153,175,78,65,75,110,46.6,54.5,40.5,00000
6.0,69.0,23.0,467,06,01,  Nayeb Nazir,80,186,34,84,46,102,30.1,28.8,31.1,00000
6.0,69.0,47.0,517,01,01,  Kazir Char,974,511,499,258,475,253,65.6,65.9,65.2,00000
6.0,69.0,47.0,517,02,01,  Dakshin Kazir Char,1163,932,557,447,606,485,55.5,55.5,55.5,00000
6.0,69.0,47.0,517,03,01,  Dakshinpurba Kazir Char,585,247,289,115,296,132,70.3,71.5,69.2,00000
6.0,69.0,47.0,517,04,01,  Uttar Kazir Char,748,439,337,198,411,241,63.0,63.0,63.0,00000
6.0,69.0,47.0,517,05,01,  Kolania,333,453,138,231,195,222,42.4,37.4,46.8,00000
6.0,69.0,47.0,517,06,01,  Peshkarkandi,498,345,234,148,264,197,59.1,61.3,57.3,00000
6.0,69.0,47.0,517,07,01,  Ragla Kazir Char,394,357,168,159,226,198,52.5,51.4,53.3,00000
6.0,69.0,47.0,517,08,01,  Baria Nalikandi,118,260,50,126,68,134,31.2,28.4,33.7,00000
6.0,69.0,47.0,517,09,01,  Baria Kazir Char,405,555,182,253,223,302,42.2,41.8,42.5,00000
6.0,69.0,59.0,228,01,01,  Char Lakshmipura,4085,2315,1933,1104,2152,1211,63.8,63.6,64.0,00000
6.0,69.0,59.0,228,02,01,  Khalasir Char,784,984,322,487,462,497,44.3,39.8,48.2,00000
6.0,69.0,59.0,378,01,01,  Dari Char Lakshmipur,1127,473,525,223,602,250,70.4,70.2,70.7,00000
6.0,69.0,59.0,378,02,01,  Bazaisduli,1037,904,466,420,571,484,53.4,52.6,54.1,00000
6.0,69.0,71.0,437,01,01,  Paschim Nazirpur,1122,507,508,206,614,301,68.9,71.1,67.1,00000
6.0,69.0,71.0,437,02,01,  Madhya Nazirpur,370,419,162,206,208,213,46.9,44.0,49.4,00000
6.0,69.0,71.0,437,03,01,  Purba Nazirpur,306,241,138,113,168,128,55.9,55.0,56.8,00000
6.0,69.0,71.0,437,04,01,  Daskhin Nazirpur,264,235,118,120,146,115,52.9,49.6,55.9,00000
6.0,69.0,71.0,437,05,01,  Char Nazirpur,1059,748,532,350,527,398,58.6,60.3,57.0,00000
6.0,69.0,71.0,437,06,01,  Ghosher Char,779,872,361,416,418,456,47.2,46.5,47.8,00000
6.0,69.0,71.0,437,07,01,  Jalalpur,445,424,198,197,247,227,51.2,50.1,52.1,00000
6.0,94.0,31.0,387,01,01,  Guthia,1189,403,576,184,613,219,74.7,75.8,73.7,00000
6.0,94.0,31.0,387,02,01,  Bario Kandi,206,79,88,35,118,44,72.3,71.5,72.8,00000
6.0,94.0,52.0,075,01,01,  Bahirghat,2276,1167,1152,490,1124,677,66.1,70.2,62.4,00000
6.0,94.0,52.0,075,02,01,  Mozum,499,317,236,120,263,197,61.2,66.3,57.2,00000
6.0,94.0,52.0,177,01,01,  Bhaudwar,514,296,267,131,247,165,63.5,67.1,60.0,00000
6.0,94.0,52.0,177,02,01,  Indur Kani,275,139,140,65,135,74,66.4,68.3,64.6,00000
6.0,94.0,52.0,674,01,01,  Munshir Taluk,1685,1497,838,701,847,796,53.0,54.5,51.6,00000
6.0,94.0,52.0,674,02,01,  Kazisha,608,213,302,94,306,119,74.1,76.3,72.0,00000
6.0,94.0,94.0,311,01,01,  Dhamura,1846,951,958,450,888,501,66.0,68.0,63.9,00000
6.0,94.0,94.0,311,02,01,  Uttar Dhamurh,867,688,431,308,436,380,55.8,58.3,53.4,00000
6.0,94.0,94.0,311,03,01,  Purba Dhamurh,935,751,482,361,453,390,55.5,57.2,53.7,00000
6.0,94.0,94.0,311,04,01,  Dakshin Dhamurh,1105,470,538,209,567,261,70.2,72.0,68.5,00000
79.0,14.0,11.0,080,01,03,  Bhandaria,5985,1021,3035,478,2950,543,85.4,86.4,84.5,00000
79.0,14.0,11.0,080,02,03,  Uttar Purba Bhandaria,1916,909,991,438,925,471,67.8,69.3,66.3,00000
79.0,14.0,11.0,080,03,03,  Purba Bhandaria,1239,370,594,178,645,192,77.0,76.9,77.1,00000
79.0,14.0,11.0,080,04,03,  Dakshin Purba Bhandaria,1521,455,735,231,786,224,77.0,76.1,77.8,00000
79.0,14.0,11.0,080,05,03,  Dakshin Bhandaria,1837,527,958,234,879,293,77.7,80.4,75.0,00000
79.0,14.0,11.0,510,01,01,  Choto Kanua,1056,349,526,185,530,164,75.2,74.0,76.4,00000
79.0,14.0,11.0,510,02,01,  Bhara Kanua,550,312,311,149,239,163,63.8,67.6,59.5,00000
79.0,14.0,11.0,510,03,01,  Kanua Gussogram,53,48,31,25,22,23,52.5,55.4,48.9,00000
79.0,14.0,47.0,726,01,01,  Uttor Paikkhali,1598,322,788,156,810,166,83.2,83.5,83.0,00000
79.0,14.0,47.0,726,02,01,  Paikkhali,1783,522,859,251,924,271,77.4,77.4,77.3,00000
79.0,14.0,47.0,914,01,01,  Sreepur,671,311,329,144,342,167,68.3,69.6,67.2,00000
79.0,14.0,47.0,914,02,01,  Sreepur Gussogram,82,40,40,14,42,26,67.2,74.1,61.8,00000
79.0,47.0,15.0,432,01,01,  Gandharbba,223,448,116,218,107,230,33.2,34.7,31.8,00000
79.0,47.0,15.0,432,02,01,  Rongakati,203,158,103,82,100,76,56.2,55.7,56.8,00000
79.0,47.0,15.0,821,01,03,  Purba Amrajuri,356,391,182,222,174,169,47.7,45.0,50.7,00000
79.0,47.0,15.0,821,02,03,  Magura,410,491,189,256,221,235,45.5,42.5,48.5,00000
79.0,47.0,15.0,821,03,03,  Kumian,739,265,381,122,358,143,73.6,75.7,71.5,00000
79.0,47.0,31.0,302,01,01,  Chira Para,1929,756,987,358,942,398,71.8,73.4,70.3,00000
79.0,47.0,31.0,302,02,01,  Parsatura,829,412,425,206,404,206,66.8,67.4,66.2,00000
79.0,47.0,47.0,021,01,01,  Airan Jhaparsi,363,245,165,129,198,116,59.7,56.1,63.1,00000
79.0,47.0,47.0,021,02,01,  Badarpur,214,145,100,74,114,71,59.6,57.5,61.6,00000
79.0,47.0,47.0,021,03,01,  Airan,352,206,169,91,183,115,63.1,65.0,61.4,00000
79.0,47.0,47.0,086,01,03,  Aspaddi,1060,416,521,204,539,212,71.8,71.9,71.8,00000
79.0,47.0,47.0,086,02,03,  Gandappur,272,72,116,36,156,36,79.1,76.3,81.3,00000
79.0,47.0,47.0,648,01,01,  Kachuakati,1163,637,584,326,579,311,64.6,64.2,65.1,00000
79.0,47.0,47.0,648,02,01,  Balbadrahpur,580,112,290,46,290,66,83.8,86.3,81.5,00000
79.0,47.0,47.0,670,01,01,  Kanthalia,271,383,136,182,135,201,41.4,42.8,40.2,00000
79.0,47.0,47.0,670,02,01,  Paikaran,172,172,83,78,89,94,50.0,51.6,48.6,00000
79.0,47.0,47.0,692,01,01,  Keundia,1505,786,679,387,826,399,65.7,63.7,67.4,00000
79.0,47.0,47.0,692,02,01,  Madahur Kati,32,9,16,4,16,5,78.0,80.0,76.2,00000
79.0,47.0,47.0,994,01,03,  Uzial Khan,1554,276,745,103,809,173,84.9,87.9,82.4,00000
79.0,47.0,47.0,994,02,03,  Kawkhali Bandar,1751,461,877,219,874,242,79.2,80.0,78.3,00000
79.0,47.0,63.0,886,01,01,  Raghunathpur,888,359,432,172,456,187,71.2,71.5,70.9,00000
79.0,47.0,63.0,886,02,01,  Sayna,415,192,230,87,185,105,68.4,72.6,63.8,00000
79.0,47.0,63.0,886,03,01,  Meghpal,330,417,168,199,162,218,44.2,45.8,42.6,00000
79.0,47.0,79.0,800,01,01,  Phalaibunia,1191,666,561,333,630,333,64.1,62.8,65.4,00000
79.0,47.0,79.0,800,02,01,  Saplaja,133,121,69,63,64,58,52.4,52.3,52.5,00000
79.0,58.0,15.0,030,01,01,  Golbunia,1233,740,598,337,635,403,62.5,64.0,61.2,00000
79.0,58.0,15.0,030,02,01,  Hogalpati,1177,1156,524,592,653,564,50.5,47.0,53.7,00000
79.0,58.0,15.0,030,03,01,  Kalikabari,1049,704,486,318,563,386,59.8,60.4,59.3,00000
79.0,58.0,15.0,030,04,01,  Amragachhia,1125,652,499,315,626,337,63.3,61.3,65.0,00000
79.0,58.0,15.0,030,05,01,  Manikkhali,833,655,353,343,480,312,56.0,50.7,60.6,00000
79.0,58.0,15.0,030,06,01,  Dhupati,892,153,395,68,497,85,85.4,85.3,85.4,00000
79.0,58.0,15.0,030,07,01,  Pashuria,612,639,284,316,328,323,48.9,47.3,50.4,00000
79.0,58.0,17.0,587,01,01,  Hejurbaria,1188,687,600,344,588,343,63.4,63.6,63.2,00000
79.0,58.0,17.0,587,02,01,  Uttar Bara Machhua,1728,1256,851,615,877,641,57.9,58.0,57.8,00000
79.0,58.0,25.0,165,01,01,  Betmore,1441,1044,688,480,753,564,58.0,58.9,57.2,00000
79.0,58.0,25.0,165,02,01,  Rajpara,2342,1750,1091,842,1251,908,57.2,56.4,57.9,00000
79.0,58.0,25.0,753,01,01,  Ghopkhali,1074,1067,464,511,610,556,50.2,47.6,52.3,00000
79.0,58.0,25.0,753,02,01,  Nujamia,397,578,164,285,233,293,40.7,36.5,44.3,00000
79.0,58.0,25.0,753,03,01,  Jankhali,201,270,90,119,111,151,42.7,43.1,42.4,00000
79.0,58.0,25.0,753,04,01,  Charkhali,389,529,180,254,209,275,42.4,41.5,43.2,00000
79.0,58.0,25.0,753,05,01,  Ulubaria,651,618,309,340,342,278,51.3,47.6,55.2,00000
79.0,58.0,34.0,497,01,01,  Loder Hawla,207,91,99,43,108,48,69.5,69.7,69.2,00000
79.0,58.0,34.0,497,02,01,  Bara Harji,1023,636,503,310,520,326,61.7,61.9,61.5,00000
79.0,58.0,34.0,497,03,01,  Harji,937,628,460,300,477,328,59.9,60.5,59.3,00000
79.0,58.0,34.0,497,04,01,  Thutakhali,342,140,177,61,165,79,71.0,74.4,67.6,00000
79.0,58.0,51.0,331,01,01,  Tiarkhali,1459,597,763,305,696,292,71.0,71.4,70.4,00000
79.0,58.0,51.0,331,02,01,  Lakshana,873,596,430,287,443,309,59.4,60.0,58.9,00000
79.0,58.0,51.0,331,03,01,  Hothkhali,2033,1180,989,577,1044,603,63.3,63.2,63.4,00000
79.0,58.0,51.0,964,01,01,  Uttar Halta,1205,860,608,435,597,425,58.4,58.3,58.4,00000
79.0,58.0,51.0,964,02,01,  Halta,834,860,426,368,408,492,49.2,53.7,45.3,00000
79.0,58.0,51.0,964,03,01,  Durgapur,988,561,508,255,480,306,63.8,66.6,61.1,00000
79.0,58.0,86.0,195,01,01,  Uttar Bhechhki,1804,864,892,407,912,457,67.6,68.7,66.6,00000
79.0,58.0,86.0,195,02,01,  Dakshin Bhechhki,1083,556,483,296,600,260,66.1,62.0,69.8,00000
79.0,58.0,86.0,452,01,01,  Ghosher Tikikata,1353,808,629,383,724,425,62.6,62.2,63.0,00000
79.0,58.0,86.0,452,02,01,  Kakrabunia,641,298,294,136,347,162,68.3,68.4,68.2,00000
79.0,58.0,86.0,618,01,01,  Dakshin Kumirmara,868,584,436,283,432,301,59.8,60.6,58.9,00000
79.0,58.0,86.0,618,02,01,  Uttar Kumirmara,629,394,290,191,339,203,61.5,60.3,62.5,00000
79.0,58.0,86.0,874,01,01,  Paschim Sener Tikikata,1810,1093,817,541,993,552,62.3,60.2,64.3,00000
79.0,58.0,86.0,874,02,01,  Surjyamani,1074,948,513,437,561,511,53.1,54.0,52.3,00000
79.0,58.0,86.0,874,03,01,  Purba Sener Tikikata,1240,1091,592,515,648,576,53.2,53.5,52.9,00000
79.0,58.0,86.0,889,01,01,  Chhota Singa,995,425,491,199,504,226,70.1,71.2,69.0,00000
79.0,58.0,86.0,889,02,01,  Bara Singa,581,417,278,214,303,203,58.2,56.5,59.9,00000
79.0,58.0,94.0,934,01,01,  Tushkhali,1358,504,680,249,678,255,72.9,73.2,72.7,00000
79.0,58.0,94.0,934,02,01,  Middle Tushkhali,1634,1210,794,564,840,646,57.5,58.5,56.5,00000
79.0,76.0,10.0,118,01,01,  Belua,162,100,93,40,69,60,61.8,69.9,53.5,00000
79.0,76.0,10.0,118,02,01,  Chhaygharia,378,66,195,30,183,36,85.1,86.7,83.6,00000
79.0,76.0,10.0,118,03,01,  Patitbari,294,109,149,40,145,69,73.0,78.8,67.8,00000
79.0,76.0,10.0,118,04,01,  Baniakati,441,176,232,63,209,113,71.5,78.6,64.9,00000
79.0,76.0,10.0,118,05,01,  Motharbari,488,216,258,93,230,123,69.3,73.5,65.2,00000
79.0,76.0,10.0,118,06,01,  Gobardhan,227,69,114,36,113,33,76.7,76.0,77.4,00000
79.0,76.0,10.0,193,01,01,  Chandkati,172,47,91,16,81,31,78.5,85.0,72.3,00000
79.0,76.0,10.0,193,02,01,  Tutakhali,184,54,95,16,89,38,77.3,85.6,70.1,00000
79.0,76.0,10.0,267,01,01,  Uttar Chhaila Bunia,200,72,114,22,86,50,73.5,83.8,63.2,00000
79.0,76.0,10.0,267,02,01,  Purba Chhaila,175,111,83,49,92,62,61.2,62.9,59.7,00000
79.0,76.0,10.0,267,03,01,  Dakshin Chhaila Bunia,107,55,48,24,59,31,66.0,66.7,65.6,00000
79.0,76.0,10.0,267,04,01,  Chhaila Bunia Adarsha,34,32,14,18,20,14,51.5,43.8,58.8,00000
79.0,76.0,10.0,341,01,01,  Dighia,1213,732,607,320,606,412,62.4,65.5,59.5,00000
79.0,76.0,10.0,341,02,01,  Madhupura,104,36,56,15,48,21,74.3,78.9,69.6,00000
79.0,76.0,10.0,341,03,01,  Narikelbari,254,104,115,47,139,57,70.9,71.0,70.9,00000
79.0,76.0,10.0,490,01,01,  Jilbunia,265,111,139,42,126,69,70.5,76.8,64.6,00000
79.0,76.0,10.0,490,02,01,  Gajalia,89,33,44,18,45,15,73.0,71.0,75.0,00000
79.0,76.0,10.0,490,03,01,  Ramnagar,293,150,157,73,136,77,66.1,68.3,63.8,00000
79.0,76.0,10.0,490,04,01,  Naotana,270,183,142,78,128,105,59.6,64.5,54.9,00000
79.0,76.0,10.0,564,01,01,  Kumarkhali,200,101,105,44,95,57,66.4,70.5,62.5,00000
79.0,76.0,10.0,564,02,01,  Dirgha Kumarkhali,460,185,254,75,206,110,71.3,77.2,65.2,00000
79.0,76.0,10.0,564,03,01,  Labue Jilbunia,2042,814,1000,375,1042,439,71.5,72.7,70.4,00000
79.0,76.0,10.0,965,01,01,  Uttar Ghoshkati,756,405,401,170,355,235,65.1,70.2,60.2,00000
79.0,76.0,10.0,965,02,01,  Ghoshkati Kalibari,460,223,265,91,195,132,67.3,74.4,59.6,00000
79.0,76.0,21.0,148,01,01,  Badokhali,435,193,215,99,220,94,69.3,68.5,70.1,00000
79.0,76.0,21.0,148,02,01,  Bil Dumuria,324,302,173,172,151,130,51.8,50.1,53.7,00000
79.0,76.0,21.0,148,03,01,  Das Para,459,148,238,77,221,71,75.6,75.6,75.7,00000
79.0,76.0,21.0,148,04,01,  Sarker Para,601,388,321,195,280,193,60.8,62.2,59.2,00000
79.0,76.0,21.0,148,05,01,  Halder Para,192,218,103,109,89,109,46.8,48.6,44.9,00000
79.0,76.0,21.0,326,01,01,  Deulbari,392,171,189,85,203,86,69.6,69.0,70.2,00000
79.0,76.0,21.0,326,02,01,  Dumuria,157,285,87,154,70,131,35.5,36.1,34.8,00000
79.0,76.0,21.0,326,03,01,  Jasimabad,434,687,202,390,232,297,38.7,34.1,43.9,00000
79.0,76.0,21.0,326,04,01,  Sonapur,200,571,104,291,96,280,25.9,26.3,25.5,00000
79.0,76.0,21.0,341,01,01,  Munira Bnd,655,455,344,219,311,236,59.0,61.1,56.9,00000
79.0,76.0,21.0,341,02,01,  Bahadura Bad,881,318,485,148,396,170,73.5,76.6,70.0,00000
79.0,76.0,21.0,341,03,01,  Mehera Bad,651,425,317,214,334,211,60.5,59.7,61.3,00000
79.0,76.0,21.0,341,04,01,  Jahira Bad,568,88,294,40,274,48,86.6,88.0,85.1,00000
79.0,76.0,21.0,371,01,01,  Gaokhali Dumuria,661,300,360,144,301,156,68.8,71.4,65.9,00000
79.0,76.0,21.0,371,02,01,  Gaokhali,1367,1033,723,512,644,521,57.0,58.5,55.3,00000
79.0,76.0,21.0,371,03,01,  Madhu Bhunga,545,219,288,89,257,130,71.3,76.4,66.4,00000
79.0,76.0,21.0,519,01,01,  Purba Kalardoania,381,260,204,135,177,125,59.4,60.2,58.6,00000
79.0,76.0,21.0,519,02,01,  Paschim Kalerdoania,413,459,216,227,197,232,47.4,48.8,45.9,00000
79.0,76.0,21.0,519,03,01,  Uttar Kalerdoania,945,1019,388,620,557,399,48.1,38.5,58.3,00000
79.0,76.0,21.0,519,04,01,  Khalni,741,488,394,264,347,224,60.3,59.9,60.8,00000
79.0,76.0,21.0,519,05,01,  Kachubunia,793,484,420,215,373,269,62.1,66.1,58.1,00000
79.0,76.0,21.0,519,06,01,  Chandkati,510,358,245,186,265,172,58.8,56.8,60.6,00000
79.0,76.0,21.0,519,07,01,  Kokrakati,340,235,162,127,178,108,59.1,56.1,62.2,00000
79.0,76.0,21.0,697,01,01,  Mugarjhor,1778,1203,863,662,915,541,59.6,56.6,62.8,00000
79.0,76.0,21.0,697,02,01,  Elua Mugarjhor,1073,633,532,361,541,272,62.9,59.6,66.5,00000
79.0,76.0,31.0,252,01,01,  Chatar,233,174,116,82,117,92,57.2,58.6,56.0,00000
79.0,76.0,31.0,252,02,01,  Pena Khali (Part),316,164,157,82,159,82,65.8,65.7,66.0,00000
79.0,76.0,31.0,460,01,01,  Dakshin Jhanjhania,650,178,344,78,306,100,78.5,81.5,75.4,00000
79.0,76.0,31.0,460,02,01,  Madhya Jhanjhania,230,526,115,276,115,250,30.4,29.4,31.5,00000
79.0,76.0,31.0,460,03,01,  Uttar Jhanjhania,1121,548,577,263,544,285,67.2,68.7,65.6,00000
79.0,76.0,31.0,460,04,01,  Turbari,285,408,146,206,139,202,41.1,41.5,40.8,00000
79.0,76.0,31.0,460,05,01,  Mitharkul (Part),146,224,68,120,78,104,39.5,36.2,42.9,00000
79.0,76.0,31.0,504,01,01,  Pacshim Jugia,911,620,440,300,471,320,59.5,59.5,59.5,00000
79.0,76.0,31.0,504,02,01,  Purba Jugia,750,511,349,241,401,270,59.5,59.2,59.8,00000
79.0,76.0,31.0,504,03,01,  Lara (Part),707,367,383,157,324,210,65.8,70.9,60.7,00000
79.0,76.0,31.0,608,01,01,  Malikhali,716,433,393,195,323,238,62.3,66.8,57.6,00000
79.0,76.0,31.0,608,02,01,  Chapakhali (Part),97,14,53,6,44,8,87.4,89.8,84.6,00000
79.0,76.0,31.0,772,01,01,  Penakhali,547,510,268,272,279,238,51.8,49.6,54.0,00000
79.0,76.0,31.0,772,02,01,  Arua Sachia,875,636,452,286,423,350,57.9,61.2,54.7,00000
79.0,76.0,31.0,772,03,01,  Mitharkul (Part),580,305,278,172,302,133,65.5,61.8,69.4,00000
79.0,76.0,31.0,831,01,01,  Sachia (Part),986,528,517,241,469,287,65.1,68.2,62.0,00000
79.0,76.0,31.0,831,02,01,  Lara (Part),557,180,290,76,267,104,75.6,79.2,72.0,00000
79.0,76.0,31.0,831,03,01,  Turuk Khali(Purba Lara),164,136,89,57,75,79,54.7,61.0,48.7,00000
79.0,76.0,31.0,980,01,01,  Kenua Bhanga,293,31,143,13,150,18,90.4,91.7,89.3,00000
79.0,76.0,31.0,980,02,01,  Chapakhali (Part),221,182,106,76,115,106,54.8,58.2,52.0,00000
79.0,76.0,42.0,074,01,01,  Dighirjan,588,359,304,156,284,203,62.1,66.1,58.3,00000
79.0,76.0,42.0,074,02,01,  Ghinaidah,355,246,167,110,188,136,59.1,60.3,58.0,00000
79.0,76.0,42.0,074,03,01,  Nagerhaowla,391,264,173,136,218,128,59.7,56.0,63.0,00000
79.0,76.0,42.0,074,04,01,  Munshiganj,321,217,162,102,159,115,59.7,61.4,58.0,00000
79.0,76.0,42.0,074,05,01,  Kirtankhola,250,281,130,131,120,150,47.1,49.8,44.4,00000
79.0,76.0,42.0,074,06,01,  Kabikhola,398,430,210,200,188,230,48.1,51.2,45.0,00000
79.0,76.0,42.0,074,07,01,  Kalmibunia,210,430,97,226,113,204,32.8,30.0,35.6,00000
79.0,76.0,42.0,103,01,01,  Uttar Baraibunia,593,369,265,187,328,182,61.6,58.6,64.3,00000
79.0,76.0,42.0,103,02,01,  Dakshin Baraibunia,348,310,178,130,170,180,52.9,57.8,48.6,00000
79.0,76.0,42.0,237,01,01,  Char Baniari,838,658,405,336,433,322,56.0,54.7,57.4,00000
79.0,76.0,42.0,237,02,01,  Paschim Baniari,752,851,370,427,382,424,46.9,46.4,47.4,00000
79.0,76.0,42.0,594,01,01,  Mahmudkanda,478,450,238,214,240,236,51.5,52.7,50.4,00000
79.0,76.0,42.0,594,02,01,  Kadambari,162,173,73,78,89,95,48.4,48.3,48.4,00000
79.0,76.0,42.0,668,01,01,  Matibhanga,940,486,500,227,440,259,65.9,68.8,62.9,00000
79.0,76.0,42.0,668,02,01,  Atulnagar,186,380,109,186,77,194,32.9,36.9,28.4,00000
79.0,76.0,52.0,089,01,01,  Bara Buichakati,201,107,95,47,106,60,65.3,66.9,63.9,00000
79.0,76.0,52.0,089,02,01,  Kalatala,110,459,43,229,67,230,19.3,15.8,22.6,00000
79.0,76.0,52.0,089,03,01,  Ruhitalabunia,608,528,310,250,298,278,53.5,55.4,51.7,00000
79.0,76.0,52.0,089,04,01,  Dasher Hawla,164,82,91,41,73,41,66.7,68.9,64.0,00000
79.0,76.0,52.0,089,05,01,  Bethbari,372,216,180,98,192,118,63.3,64.7,61.9,00000
79.0,76.0,52.0,282,01,03,  Chhota Buichakati,644,325,332,184,312,141,66.5,64.3,68.9,00000
79.0,76.0,52.0,282,02,03,  Patilakhali,221,192,117,89,104,103,53.5,56.8,50.2,00000
79.0,76.0,52.0,282,03,03,  Nazirpur,1376,392,722,181,654,211,77.8,80.0,75.6,00000
79.0,76.0,52.0,282,04,03,  Satkachima,620,339,346,159,274,180,64.7,68.5,60.4,00000
79.0,76.0,52.0,297,01,01,  Kumarkhali,574,774,292,390,282,384,42.6,42.8,42.3,00000
79.0,76.0,52.0,297,02,01,  Hari Pagla,321,229,186,98,135,131,58.4,65.5,50.8,00000
79.0,76.0,52.0,876,01,01,  Satkachhima,923,726,426,369,497,357,56.0,53.6,58.2,00000
79.0,76.0,52.0,876,02,01,  Kanthalia,370,237,173,117,197,120,61.0,59.7,62.1,00000
79.0,76.0,52.0,876,03,01,  Chithalia,742,669,358,339,384,330,52.6,51.4,53.8,00000
79.0,76.0,52.0,876,04,01,  Bainkati,458,98,224,41,234,57,82.4,84.5,80.4,00000
79.0,76.0,52.0,950,01,01,  Tarabunia,222,154,115,62,107,92,59.0,65.0,53.8,00000
79.0,76.0,52.0,950,02,01,  Katabunia,236,79,117,36,119,43,74.9,76.5,73.5,00000
79.0,76.0,63.0,044,01,01,  Bakshi,593,566,283,294,310,272,51.2,49.0,53.3,00000
79.0,76.0,63.0,044,02,01,  Mokhali,172,215,81,112,91,103,44.4,42.0,46.9,00000
79.0,76.0,63.0,044,03,01,  Purba Bakshi,262,97,137,47,125,50,73.0,74.5,71.4,00000
79.0,76.0,63.0,663,01,01,  Mirzapur Charkhali,368,497,198,243,170,254,42.5,44.9,40.1,00000
79.0,76.0,63.0,663,02,01,  Garghata,427,231,225,108,202,123,64.9,67.6,62.2,00000
79.0,76.0,63.0,816,01,01,  Ramnagar,1079,640,529,325,550,315,62.8,61.9,63.6,00000
79.0,76.0,63.0,816,02,01,  Amtala,262,468,138,225,124,243,35.9,38.0,33.8,00000
79.0,76.0,63.0,891,01,01,  Sekhmatia,673,827,333,372,340,455,44.9,47.2,42.8,00000
79.0,76.0,63.0,891,02,01,  Agailbunia,141,85,77,43,64,42,62.4,64.2,60.4,00000
79.0,76.0,63.0,905,01,01,  Sholasat,636,431,303,216,333,215,59.6,58.4,60.8,00000
79.0,76.0,63.0,905,02,01,  Lakshmidia,67,236,30,125,37,111,22.1,19.4,25.0,00000
79.0,76.0,73.0,029,01,01,  Baghajora,850,596,354,302,496,294,58.8,54.0,62.8,00000
79.0,76.0,73.0,029,02,01,  Baibunia,253,56,130,24,123,32,81.9,84.4,79.4,00000
79.0,76.0,73.0,029,03,01,  Bhaijora,798,844,349,419,449,425,48.6,45.4,51.4,00000
79.0,76.0,73.0,029,04,01,  Matibhanga,169,281,97,129,72,152,37.6,42.9,32.1,00000
79.0,76.0,73.0,163,01,01,  Burikhali,553,462,239,219,314,243,54.5,52.2,56.4,00000
79.0,76.0,73.0,163,02,01,  Maduliharania,270,275,138,115,132,160,49.5,54.5,45.2,00000
79.0,76.0,73.0,163,03,01,  Hoglabunia,1484,938,652,479,832,459,61.3,57.6,64.4,00000
79.0,76.0,73.0,386,01,01,  Gilatala,723,698,342,309,381,389,50.9,52.5,49.5,00000
79.0,76.0,73.0,386,02,01,  Bakarkhal,173,103,92,43,81,60,62.7,68.1,57.4,00000
79.0,76.0,73.0,386,03,01,  Uttar Hoglabunia,211,226,117,119,94,107,48.3,49.6,46.8,00000
79.0,76.0,73.0,386,04,01,  Tarabunia,276,211,130,95,146,116,56.7,57.8,55.7,00000
79.0,76.0,73.0,861,01,01,  Goperkhal,357,137,194,57,163,80,72.3,77.3,67.1,00000
79.0,76.0,73.0,861,02,01,  Shankharikati,1194,763,614,377,580,386,61.0,62.0,60.0,00000
79.0,76.0,84.0,356,01,01,  Dumuria,260,129,124,61,136,68,66.8,67.0,66.7,00000
79.0,76.0,84.0,356,02,01,  Gabtala,329,126,156,58,173,68,72.3,72.9,71.8,00000
79.0,76.0,84.0,356,03,01,  Bhubankhali,155,175,69,94,86,81,47.0,42.3,51.5,00000
79.0,76.0,84.0,445,01,01,  Udaytara,254,204,110,101,144,103,55.5,52.1,58.3,00000
79.0,76.0,84.0,445,02,01,  Uttar Joypur,730,447,365,213,365,234,62.0,63.1,60.9,00000
79.0,76.0,84.0,445,03,01,  Dakshin Joypur,242,144,119,61,123,83,62.7,66.1,59.7,00000
79.0,76.0,84.0,445,04,01,  Madhya Joypur,909,517,483,211,426,306,63.7,69.6,58.2,00000
79.0,76.0,84.0,445,05,01,  Chalitabari,29,43,12,22,17,21,40.3,35.3,44.7,00000
79.0,76.0,84.0,475,01,01,  Jibagram,220,92,114,43,106,49,70.5,72.6,68.4,00000
79.0,76.0,84.0,475,02,01,  Labubari,64,17,26,5,38,12,79.0,83.9,76.0,00000
79.0,76.0,84.0,712,01,01,  Nailtala,218,79,115,27,103,52,73.4,81.0,66.5,00000
79.0,76.0,84.0,712,02,01,  Chowthai Mahal,934,579,469,297,465,282,61.7,61.2,62.2,00000
79.0,76.0,84.0,712,03,01,  Dariabad,376,38,190,10,186,28,90.8,95.0,86.9,00000
79.0,76.0,84.0,712,04,01,  Pajra Para,119,64,66,25,53,39,65.0,72.5,57.6,00000
79.0,76.0,84.0,712,05,01,  Chougachha,88,63,34,32,54,31,58.3,51.5,63.5,00000
79.0,76.0,84.0,712,06,01,  Khejurtala,185,91,90,36,95,55,67.0,71.4,63.3,00000
79.0,76.0,84.0,712,07,01,  Ghoshkati,77,104,33,51,44,53,42.5,39.3,45.4,00000
79.0,76.0,84.0,712,08,01,  Charkhola,187,282,97,137,90,145,39.9,41.5,38.3,00000
79.0,76.0,84.0,935,01,01,  Uttar Sreeramkati,321,30,162,8,159,22,91.5,95.3,87.8,00000
79.0,76.0,84.0,935,02,01,  Dakshin Sreeramkati,711,274,358,107,353,167,72.2,77.0,67.9,00000
79.0,76.0,84.0,935,03,01,  Sreeramkati Bazar,912,182,529,80,383,102,83.4,86.9,79.0,00000
79.0,76.0,84.0,935,04,01,  Chalisha,298,153,124,79,174,74,66.1,61.1,70.2,00000
79.0,80.0,17.0,017,01,01,  Kachubunia,269,144,132,71,137,73,65.1,65.0,65.2,00000
79.0,80.0,17.0,017,02,01,  Katulia,468,283,223,136,245,147,62.3,62.1,62.5,00000
79.0,80.0,17.0,017,03,01,  Narikebari,154,31,72,13,82,18,83.2,84.7,82.0,00000
79.0,80.0,17.0,017,04,01,  Sabikdanga,70,22,40,8,30,14,76.1,83.3,68.2,00000
79.0,80.0,17.0,355,01,01,  Dakshin Jibgram,366,134,196,50,170,84,73.2,79.7,66.9,00000
79.0,80.0,17.0,355,02,01,  Bagri,108,26,56,8,52,18,80.6,87.5,74.3,00000
79.0,80.0,17.0,355,03,01,  Zabar,107,5,58,2,49,3,95.5,96.7,94.2,00000
79.0,80.0,25.0,533,01,01,  Uttar  Kadamtala,1005,350,484,179,521,171,74.2,73.0,75.3,00000
79.0,80.0,25.0,533,02,01,  Paschim Kadamtala,827,202,424,107,403,95,80.4,79.8,80.9,00000
79.0,80.0,25.0,533,03,01,  Dakshin Kadamtala,1227,269,617,121,610,148,82.0,83.6,80.5,00000
79.0,80.0,25.0,799,01,01,  Uttar Porgola,677,396,334,200,343,196,63.1,62.5,63.6,00000
79.0,80.0,25.0,799,02,01,  Dakshin Porgola,964,544,473,261,491,283,63.9,64.4,63.4,00000
79.0,80.0,34.0,852,01,01,  Kalakhali,1090,539,559,257,531,282,66.9,68.5,65.3,00000
79.0,80.0,34.0,852,02,01,  Panthadubi,447,123,202,65,245,58,78.4,75.7,80.9,00000
79.0,80.0,34.0,959,01,01,  Udaykati,481,263,225,126,256,137,64.7,64.1,65.1,00000
79.0,80.0,34.0,959,02,01,  Gazalia,598,156,297,64,301,92,79.3,82.3,76.6,00000
79.0,80.0,69.0,568,01,01,  Uttar Kalikati,788,552,380,268,408,284,58.8,58.6,59.0,00000
79.0,80.0,69.0,568,02,01,  Dakshin Kalikati,672,413,307,205,365,208,61.9,60.0,63.7,00000
79.0,80.0,69.0,861,01,01,  Uttar Shankarpasha,1021,471,512,216,509,255,68.4,70.3,66.6,00000
79.0,80.0,69.0,861,02,01,  Dakshin Shankarpasha,1524,581,719,285,805,296,72.4,71.6,73.1,00000
79.0,80.0,77.0,159,01,01,  Bhattacharjyer Purba Harina,689,241,312,110,377,131,74.1,73.9,74.2,00000
79.0,80.0,77.0,159,02,01,  Paschim Harina,765,287,347,140,418,147,72.7,71.3,74.0,00000
79.0,80.0,77.0,364,01,01,  Dakshin Ranipur,366,202,183,100,183,102,64.4,64.7,64.2,00000
79.0,80.0,77.0,364,02,01,  Matha Bera,156,129,77,64,79,65,54.7,54.6,54.9,00000
79.0,80.0,77.0,444,01,01,  Purba Dumaritala,726,135,374,56,352,79,84.3,87.0,81.7,00000
79.0,80.0,77.0,444,02,01,  Sariktala,576,223,277,99,299,124,72.1,73.7,70.7,00000
79.0,80.0,77.0,444,03,01,  Paschim Dumaritala,532,251,251,120,281,131,67.9,67.7,68.2,00000
79.0,80.0,77.0,630,01,01,  Kumirmara,119,284,54,144,65,140,29.5,27.3,31.7,00000
79.0,80.0,77.0,630,02,01,  Dawla,90,89,45,51,45,38,50.3,46.9,54.2,00000
79.0,80.0,86.0,142,01,01,  Bara Jujkhola,251,116,117,45,134,71,68.4,72.2,65.4,00000
79.0,80.0,86.0,142,02,01,  Razer Esha,296,295,151,169,145,126,50.1,47.2,53.5,00000
79.0,80.0,86.0,142,03,01,  Goger Aga,119,34,57,16,62,18,77.8,78.1,77.5,00000
79.0,80.0,86.0,142,04,01,  Barjala Juj Kholahowla,230,81,101,41,129,40,74.0,71.1,76.3,00000
79.0,80.0,86.0,142,05,01,  Khontaghata,341,187,140,91,201,96,64.6,60.6,67.7,00000
79.0,80.0,86.0,142,06,01,  Jaboramal,429,282,207,144,222,138,60.3,59.0,61.7,00000
79.0,80.0,86.0,142,07,01,  Mirua Jujkhola,386,197,197,97,189,100,66.2,67.0,65.4,00000
79.0,80.0,86.0,142,08,01,  Khul Bunia,311,249,143,126,168,123,55.5,53.2,57.7,00000
79.0,80.0,86.0,142,09,01,  Sayghore,200,114,103,46,97,68,63.7,69.1,58.8,00000
79.0,80.0,86.0,142,10,01,  Semultala Jujkhola,220,91,104,39,116,52,70.7,72.7,69.0,00000
79.0,80.0,86.0,142,11,01,  Maidho Jujkhola,277,82,135,33,142,49,77.2,80.4,74.3,00000
79.0,80.0,86.0,142,12,01,  Purba Jujkhola,820,582,393,265,427,317,58.5,59.7,57.4,00000
79.0,80.0,86.0,142,13,01,  Kumir Chira Jujkhola,432,457,223,204,209,253,48.6,52.2,45.2,00000
79.0,80.0,86.0,906,01,01,  Sikdar Mallik Ganak Para,773,396,382,196,391,200,66.1,66.1,66.2,00000
79.0,80.0,86.0,906,02,01,  Sikdar Mallik,1016,678,528,314,488,364,60.0,62.7,57.3,00000
79.0,80.0,86.0,906,03,01,  Sikdar Mallik Howla,600,323,291,152,309,171,65.0,65.7,64.4,00000
79.0,80.0,86.0,977,01,01,  Jabaramala,106,12,59,5,47,7,89.8,92.2,87.0,00000
79.0,80.0,86.0,977,02,01,  Uttar Gabtala,356,144,185,60,171,84,71.2,75.5,67.1,00000
79.0,80.0,94.0,932,01,01,  Purba Tejdaskati,996,286,471,129,525,157,77.7,78.5,77.0,00000
79.0,80.0,94.0,932,02,01,  Paschim Tejdaskati,813,292,384,129,429,163,73.6,74.9,72.5,00000
79.0,80.0,94.0,950,01,01,  Purba Tona,1140,338,566,141,574,197,77.1,80.1,74.4,00000
79.0,80.0,94.0,950,02,01,  Paschim Tona,1001,616,501,306,500,310,61.9,62.1,61.7,00000
79.0,87.0,17.0,594,01,01,  Mohamudkati,2267,1317,1120,641,1147,676,63.3,63.6,62.9,00000
79.0,87.0,17.0,594,02,01,  Hariharkati,398,91,179,45,219,46,81.4,79.9,82.6,00000
79.0,87.0,17.0,812,01,01,  Brahmankati,526,133,280,61,246,72,79.8,82.1,77.4,00000
79.0,87.0,17.0,812,02,01,  Katuakati,246,138,127,57,119,81,64.1,69.0,59.5,00000
79.0,87.0,17.0,812,03,01,  Kuriana,470,206,253,103,217,103,69.5,71.1,67.8,00000
79.0,87.0,17.0,812,04,01,  Purba Brahmankati,217,43,104,29,113,14,83.5,78.2,89.0,00000
79.0,87.0,17.0,812,05,01,  Adamkati,401,120,211,50,190,70,77.0,80.8,73.1,00000
79.0,87.0,17.0,812,06,01,  Rajapur,79,44,47,14,32,30,64.2,77.0,51.6,00000
79.0,87.0,17.0,812,07,01,  Muslim Para,345,230,151,130,194,100,60.0,53.7,66.0,00000
79.0,87.0,17.0,812,08,01,  Paschim Kuriana,388,271,211,125,177,146,58.9,62.8,54.8,00000
79.0,87.0,19.0,109,01,01,  Gagan,590,1044,247,546,343,498,36.1,31.1,40.8,00000
79.0,87.0,19.0,109,02,01,  Chame,2433,1814,1102,1000,1331,814,57.3,52.4,62.1,00000
79.0,87.0,19.0,109,03,01,  Baldia,875,864,360,464,515,400,50.3,43.7,56.3,00000
79.0,87.0,19.0,109,04,01,  Dube,795,550,334,319,461,231,59.1,51.1,66.6,00000
79.0,87.0,19.0,800,01,01,  Dakshin Paschim Dubi,746,549,330,268,416,281,57.6,55.2,59.7,00000
79.0,87.0,19.0,800,02,01,  Boya,1598,465,691,242,907,223,77.5,74.1,80.3,00000
79.0,87.0,19.0,800,03,01,  Panchabaki,927,634,366,308,561,326,59.4,54.3,63.2,00000
79.0,87.0,19.0,800,04,01,  Rajabari,2638,791,1231,401,1407,390,76.9,75.4,78.3,00000
79.0,87.0,19.0,800,05,01,  Jirbari,398,90,196,49,202,41,81.6,80.0,83.1,00000
79.0,87.0,19.0,800,06,01,  Purba Binna,988,592,440,311,548,281,62.5,58.6,66.1,00000
79.0,87.0,19.0,922,01,01,  Sonarghop,228,133,107,56,121,77,63.2,65.6,61.1,00000
79.0,87.0,19.0,922,02,01,  Kata Petania,361,220,182,88,179,132,62.1,67.4,57.6,00000
79.0,87.0,19.0,922,03,01,  Khajurbari,392,199,200,108,192,91,66.3,64.9,67.8,00000
79.0,87.0,19.0,922,04,01,  Labubari,144,154,82,67,62,87,48.3,55.0,41.6,00000
79.0,87.0,19.0,922,05,01,  Uribunia,1937,1268,878,667,1059,601,60.4,56.8,63.8,00000
79.0,87.0,19.0,922,06,01,  Gilbari,682,814,320,415,362,399,45.6,43.5,47.6,00000
79.0,87.0,19.0,922,07,01,  Paschim Binna,906,718,418,375,488,343,55.8,52.7,58.7,00000
79.0,87.0,28.0,254,01,01,  Chinabunia,227,235,120,118,107,117,49.1,50.4,47.8,00000
79.0,87.0,28.0,254,02,01,  Boraibari,792,337,362,182,430,155,70.2,66.5,73.5,00000
79.0,87.0,28.0,254,03,01,  Kharabagh,257,198,129,88,128,110,56.5,59.4,53.8,00000
79.0,87.0,28.0,254,04,01,  Chiltola,778,622,370,308,408,314,55.6,54.6,56.5,00000
79.0,87.0,28.0,254,05,01,  Purba Koyarekhail,149,89,83,34,66,55,62.6,70.9,54.5,00000
79.0,87.0,28.0,279,01,01,  Goaskhati,153,65,80,28,73,37,70.2,74.1,66.4,00000
79.0,87.0,28.0,279,02,01,  Bhut Khali,156,30,89,12,67,18,83.9,88.1,78.8,00000
79.0,87.0,28.0,279,03,01,  Ganak Para,514,156,257,70,257,86,76.7,78.6,74.9,00000
79.0,87.0,28.0,279,04,01,  Bastala,213,113,102,46,111,67,65.3,68.9,62.4,00000
79.0,87.0,28.0,279,05,01,  Thalia,130,144,66,66,64,78,47.4,50.0,45.1,00000
79.0,87.0,28.0,279,06,01,  Katadahahari,231,194,98,103,133,91,54.4,48.8,59.4,00000
79.0,87.0,28.0,279,07,01,  Pashuribunia,34,43,17,21,17,22,44.2,44.7,43.6,00000
79.0,87.0,28.0,279,08,01,  Soilabunia,440,29,229,12,211,17,93.8,95.0,92.5,00000
79.0,87.0,28.0,994,01,01,  Daiharia,471,180,234,80,237,100,72.4,74.5,70.3,00000
79.0,87.0,28.0,994,02,01,  Takur Houla,260,64,131,28,129,36,80.2,82.4,78.2,00000
79.0,87.0,28.0,994,03,01,  Uribunia,244,156,130,58,114,98,61.0,69.1,53.8,00000
79.0,87.0,28.0,994,04,01,  Kanthalbari,149,114,75,51,74,63,56.7,59.5,54.0,00000
79.0,87.0,28.0,994,05,01,  Paschim Koyarekhali,154,37,82,10,72,27,80.6,89.1,72.7,00000
79.0,87.0,28.0,994,06,01,  Amtala,211,128,110,61,101,67,62.2,64.3,60.1,00000
79.0,87.0,28.0,994,07,01,  Beldanga,186,35,101,11,85,24,84.2,90.2,78.0,00000
79.0,87.0,38.0,206,01,01,  Chelabunia,156,67,82,27,74,40,70.0,75.2,64.9,00000
79.0,87.0,38.0,206,02,01,  Bishal,706,244,350,97,356,147,74.3,78.3,70.8,00000
79.0,87.0,38.0,206,03,01,  Gajia,156,32,81,11,75,21,83.0,88.0,78.1,00000
79.0,87.0,38.0,230,01,01,  Byaskati,605,355,309,152,296,203,63.0,67.0,59.3,00000
79.0,87.0,38.0,230,02,01,  Rajbari,219,188,93,94,126,94,53.8,49.7,57.3,00000
79.0,87.0,38.0,242,01,01,  Chandkati,557,340,265,149,292,191,62.1,64.0,60.5,00000
79.0,87.0,38.0,242,02,01,  Rudrapur,480,321,262,135,218,186,59.9,66.0,54.0,00000
79.0,87.0,38.0,837,01,01,  Raghatala,187,134,99,53,88,81,58.3,65.1,52.1,00000
79.0,87.0,38.0,837,02,01,  Talbari,101,55,45,27,56,28,64.7,62.5,66.7,00000
79.0,87.0,38.0,837,03,01,  Gabbari,114,102,60,48,54,54,52.8,55.6,50.0,00000
79.0,87.0,38.0,837,04,01,  Jamirtala,80,78,47,33,33,45,50.6,58.8,42.3,00000
79.0,87.0,38.0,837,05,01,  Batnatala,356,130,186,54,170,76,73.3,77.5,69.1,00000
79.0,87.0,38.0,837,06,01,  Rongakti,466,187,227,79,239,108,71.4,74.2,68.9,00000
79.0,87.0,47.0,315,01,01,  Ganapatikati,219,42,112,16,107,26,83.9,87.5,80.5,00000
79.0,87.0,47.0,315,02,01,  Soulapatikati,66,11,33,3,33,8,85.7,91.7,80.5,00000
79.0,87.0,47.0,412,01,01,  Jalabari,1243,399,667,160,576,239,75.7,80.7,70.7,00000
79.0,87.0,47.0,412,02,01,  Purba Jalabari,1824,585,930,257,894,328,75.7,78.3,73.2,00000
79.0,87.0,47.0,497,01,01,  Kamarkati,3506,1553,1703,784,1803,769,69.3,68.5,70.1,00000
79.0,87.0,95.0,788,01,01,  Rahutkati,623,151,296,76,327,75,80.5,79.6,81.3,00000
79.0,87.0,95.0,788,02,01,  Panaullapur,355,45,180,20,175,25,88.8,90.0,87.5,00000
79.0,87.0,95.0,946,01,01,  Sultanpur,245,86,130,38,115,48,74.0,77.4,70.6,00000
79.0,87.0,95.0,946,02,01,  Alankarkati,1350,386,611,186,739,200,77.8,76.7,78.7,00000
79.0,87.0,95.0,946,03,01,  Krishnakati,313,190,137,96,176,94,62.2,58.8,65.2,00000
79.0,90.0,15.0,034,01,01,  Purba Bali Para,588,431,280,195,308,236,57.7,58.9,56.6,00000
79.0,90.0,15.0,034,02,01,  Balipara Dighi,759,632,330,315,429,317,54.6,51.2,57.5,00000
79.0,90.0,15.0,034,03,01,  Uttar Bali Para,395,162,202,79,193,83,70.9,71.9,69.9,00000
79.0,90.0,15.0,034,04,01,  Madhya Bali Para,1079,674,697,329,382,345,61.6,67.9,52.5,00000
79.0,90.0,15.0,034,05,01,  Paschim Bali Para,1861,917,912,469,949,448,67.0,66.0,67.9,00000
79.0,90.0,15.0,102,01,01,  Uttar Chandipur,961,828,421,431,540,397,53.7,49.4,57.6,00000
79.0,90.0,15.0,102,02,01,  Dakshin Chandipur,677,777,309,412,368,365,46.6,42.9,50.2,00000
79.0,90.0,15.0,102,03,01,  Purba Char Balesher,958,1050,427,536,531,514,47.7,44.3,50.8,00000
79.0,90.0,15.0,102,04,01,  Paschim Char Balesher,598,486,261,235,337,251,55.2,52.6,57.3,00000
79.0,90.0,15.0,171,01,01,  Purba Kholpatua,769,396,333,206,436,190,66.0,61.8,69.6,00000
79.0,90.0,15.0,171,02,01,  Paschim Kholpatua,816,437,436,249,380,188,65.1,63.6,66.9,00000
79.0,90.0,15.0,651,01,01,  Uttar Kalaran,869,698,414,375,455,323,55.5,52.5,58.5,00000
79.0,90.0,15.0,651,02,01,  Dakshin Kalaran,742,532,327,251,415,281,58.2,56.6,59.6,00000
79.0,90.0,15.0,651,03,01,  Madhya Kalaran,1721,744,806,346,915,398,69.8,70.0,69.7,00000
79.0,90.0,43.0,051,01,01,  Baraikhali,290,275,128,142,162,133,51.3,47.4,54.9,00000
79.0,90.0,43.0,051,02,01,  Bathazor,478,251,214,125,264,126,65.6,63.1,67.7,00000
79.0,90.0,43.0,051,03,01,  Gather Horla,204,184,97,83,107,101,52.6,53.9,51.4,00000
79.0,90.0,43.0,051,04,01,  Lakshmidia,513,252,245,115,268,137,67.1,68.1,66.2,00000
79.0,90.0,43.0,051,05,01,  Nalbunia,1172,392,584,217,588,175,74.9,72.9,77.1,00000
79.0,90.0,43.0,137,01,01,  Char Gazipur,245,219,106,119,139,100,52.8,47.1,58.2,00000
79.0,90.0,43.0,137,02,01,  Char Lahuri,146,88,76,36,70,52,62.4,67.9,57.4,00000
79.0,90.0,43.0,994,01,01,  Umedpur,1014,885,487,455,527,430,53.4,51.7,55.1,00000
79.0,90.0,43.0,994,02,01,  Pererhat,711,293,359,158,352,135,70.8,69.4,72.3,00000
79.0,90.0,51.0,479,01,01,  Gabgachhia,537,174,253,85,284,89,75.5,74.9,76.1,00000
79.0,90.0,51.0,479,02,01,  Debipur,156,70,66,41,90,29,69.0,61.7,75.6,00000
79.0,90.0,51.0,616,01,01,  Uttar Kalaia,928,799,427,407,501,392,53.7,51.2,56.1,00000
79.0,90.0,51.0,616,02,01,  Dakshin Kalaia,1129,703,545,322,584,381,61.6,62.9,60.5,00000
79.0,90.0,51.0,753,01,01,  Uttar Pattashi,1263,505,619,253,644,252,71.4,71.0,71.9,00000
79.0,90.0,51.0,753,02,01,  Dakshin Pattashi,667,382,326,197,341,185,63.6,62.3,64.8,00000
9.0,18.0,14.0,186,01,03,  Uttar Bapta,1968,1533,933,684,1035,849,56.2,57.7,54.9,00000
9.0,18.0,14.0,186,02,03,  Madhya Bapta,1872,1536,904,691,968,845,54.9,56.7,53.4,00000
9.0,18.0,14.0,186,03,03,  Dakshin Bapta,2035,1055,1055,473,980,582,65.9,69.0,62.7,00000
9.0,18.0,14.0,186,04,03,  Sunderkhali,1028,973,542,464,486,509,51.4,53.9,48.8,00000
9.0,18.0,14.0,186,05,03,  Musakandi,921,1158,444,543,477,615,44.3,45.0,43.7,00000
9.0,18.0,14.0,186,06,03,  Chacra,1721,2600,891,1225,830,1375,39.8,42.1,37.6,00000
9.0,18.0,14.0,186,07,03,  Bapta Guchchhagram,231,560,119,271,112,289,29.2,30.5,27.9,00000
9.0,18.0,14.0,296,01,01,  Uttar Char Potka,494,624,227,301,267,323,44.2,43.0,45.3,00000
9.0,18.0,14.0,296,02,01,  Dakshin Char Pokta,527,767,251,382,276,385,40.7,39.7,41.8,00000
9.0,18.0,14.0,296,03,01,  Char Pokta Malarchara,170,281,77,124,93,157,37.7,38.3,37.2,00000
9.0,18.0,14.0,373,01,03,  Uttar Paschim Char Noabad,1402,1233,649,603,753,630,53.2,51.8,54.4,00000
9.0,18.0,14.0,373,02,03,  Dakshin Purba Char Noabad,462,450,259,227,203,223,50.7,53.3,47.7,00000
9.0,18.0,14.0,373,03,03,  Dakshinpaschim Char Noabad,545,764,278,393,267,371,41.6,41.4,41.8,00000
9.0,18.0,36.0,497,01,01,  Dhania,621,1283,277,658,344,625,32.6,29.6,35.5,00000
9.0,18.0,36.0,497,02,01,  Baliakandi,1023,1354,510,674,513,680,43.0,43.1,43.0,00000
9.0,18.0,36.0,497,03,01,  Chowakhali,586,658,288,325,298,333,47.1,47.0,47.2,00000
9.0,18.0,36.0,497,04,01,  Paschim Dhania,692,988,334,504,358,484,41.2,39.9,42.5,00000
9.0,18.0,36.0,497,05,01,  Purba Dhania,538,799,283,411,255,388,40.2,40.8,39.7,00000
9.0,18.0,36.0,526,01,01,  Guli,1117,1635,535,856,582,779,40.6,38.5,42.8,00000
9.0,18.0,36.0,526,02,01,  Ganga Karti,199,263,102,133,97,130,43.1,43.4,42.7,00000
9.0,18.0,36.0,526,03,01,  Bolgram Sura,42,106,21,51,21,55,28.4,29.2,27.6,00000
9.0,18.0,36.0,526,04,01,  Kala Sura,415,735,176,385,239,350,36.1,31.4,40.6,00000
9.0,18.0,51.0,086,01,01,  Char Ananda Part-1,539,801,262,408,277,393,40.2,39.1,41.3,00000
9.0,18.0,51.0,086,02,01,  Char Ananda Part-2,871,1902,418,999,453,903,31.4,29.5,33.4,00000
9.0,18.0,51.0,086,03,01,  Char Ananda Part-3,1057,2045,514,1039,543,1006,34.1,33.1,35.1,00000
9.0,18.0,55.0,440,01,01,  D.Char Pata,1583,3180,741,1526,842,1654,33.2,32.7,33.7,00000
9.0,18.0,55.0,440,02,01,  Uttar Char Pata,1316,2293,628,1115,688,1178,36.5,36.0,36.9,00000
9.0,18.0,55.0,918,01,01,  Purba Sadur Char,1746,2396,849,1162,897,1234,42.2,42.2,42.1,00000
9.0,18.0,55.0,918,02,01,  Paschim Sadur Char,466,575,189,258,277,317,44.8,42.3,46.6,00000
9.0,18.0,58.0,602,01,01,  Dakshin-Purba Kachia,541,878,278,443,263,435,38.1,38.6,37.7,00000
9.0,18.0,58.0,602,02,01,  Madhya Kachia,413,564,226,276,187,288,42.3,45.0,39.4,00000
9.0,18.0,73.0,641,01,01,  Uttar Kandarpapur,816,2614,389,1416,427,1198,23.8,21.6,26.3,00000
9.0,18.0,73.0,641,02,01,  Dakshin Kandarpapur,866,1657,395,877,471,780,34.3,31.1,37.6,00000
9.0,18.0,73.0,880,01,01,  Uttar Ramdaspur,1092,2006,496,1031,596,975,35.2,32.5,37.9,00000
9.0,18.0,73.0,880,02,01,  Dakshin Ramdaspur,1156,2684,535,1446,621,1238,30.1,27.0,33.4,00000
9.0,18.0,94.0,076,01,01,  Paschim Chandra Prasad,1926,2969,950,1561,976,1408,39.3,37.8,40.9,00000
9.0,18.0,94.0,076,02,01,  Purba Chandra Prasad,1663,2035,800,1076,863,959,45.0,42.6,47.4,00000
9.0,21.0,28.0,590,01,01,  Paschim Jaya,902,2195,399,1162,503,1033,29.1,25.6,32.7,00000
9.0,21.0,28.0,590,02,01,  Madhya Jaya,2631,2065,1178,1047,1453,1018,56.0,52.9,58.8,00000
9.0,21.0,28.0,590,03,01,  Purba Jaya,946,737,447,330,499,407,56.2,57.5,55.1,00000
9.0,21.0,57.0,668,01,03,  Dakshin Kutba,1744,811,935,359,809,452,68.3,72.3,64.2,00000
9.0,21.0,57.0,668,02,03,  Uttar Kutba,1602,839,837,367,765,472,65.6,69.5,61.8,00000
9.0,21.0,76.0,450,01,01,  Uttargram,191,735,89,325,102,410,20.6,21.5,19.9,00000
9.0,21.0,76.0,450,02,01,  Dakshingram,259,872,133,451,126,421,22.9,22.8,23.0,00000
9.0,21.0,76.0,450,03,01,  Lamchibill+Santosh+Nizhowa+Eco,675,1493,351,729,324,764,31.1,32.5,29.8,00000
9.0,25.0,13.0,855,01,01,  Uttar Shibar Char,2191,2340,1011,1162,1180,1178,48.4,46.5,50.0,00000
9.0,25.0,13.0,855,02,01,  Dakshin Shibar Char,1694,2452,802,1265,892,1187,40.9,38.8,42.9,00000
9.0,25.0,66.0,663,01,03,  Daskandi,324,378,162,173,162,205,46.2,48.4,44.1,00000
9.0,25.0,66.0,663,02,03,  Jinnaghar,1836,2267,953,1128,883,1139,44.7,45.8,43.7,00000
9.0,25.0,66.0,663,03,03,  Daulat Khan Kandi,412,405,195,206,217,199,50.4,48.6,52.2,00000
9.0,25.0,66.0,907,01,03,  Kutubganj,369,423,207,186,162,237,46.6,52.7,40.6,00000
9.0,25.0,66.0,907,02,03,  Uttarcharrmadras,3490,3215,1749,1623,1741,1592,52.1,51.9,52.2,00000
9.0,25.0,76.0,139,01,01,  Char Jamuna (1),2553,4701,1244,2234,1309,2467,35.2,35.8,34.7,00000
9.0,25.0,76.0,139,02,01,  Char Jamuna (2),1282,1920,659,959,623,961,40.0,40.7,39.3,00000
9.0,54.0,19.0,244,01,01,  Purba Char Bhuta,815,2092,374,915,441,1177,28.0,29.0,27.3,00000
9.0,54.0,19.0,244,02,01,  Madhya Char Bhuta,1280,1724,606,761,674,963,42.6,44.3,41.2,00000
9.0,54.0,19.0,244,03,01,  Paschim Char Bhuta,1222,1727,629,796,593,931,41.4,44.1,38.9,00000
9.0,54.0,19.0,551,01,01,  Purba Hariganj,642,1168,327,544,315,624,35.5,37.5,33.5,00000
9.0,54.0,19.0,551,02,01,  Paschim Hariganj,1468,1454,781,686,687,768,50.2,53.2,47.2,00000
9.0,54.0,19.0,551,03,01,  Uttar Hriganj,910,1585,432,757,478,828,36.5,36.3,36.6,00000
9.0,54.0,19.0,994,01,01,  Purba Taraganj,1105,2064,535,983,570,1081,34.9,35.2,34.5,00000
9.0,54.0,19.0,994,02,01,  Paschim Taraganj,918,1314,449,627,469,687,41.1,41.7,40.6,00000
9.0,54.0,28.0,459,01,01,  Chatla,1734,3145,847,1458,887,1687,35.5,36.7,34.5,00000
9.0,54.0,28.0,459,02,01,  Tagachia,551,1159,259,542,292,617,32.2,32.3,32.1,00000
9.0,54.0,28.0,489,01,01,  Purba Dhali Gaurnagar,762,1230,391,646,371,584,38.3,37.7,38.8,00000
9.0,54.0,28.0,489,02,01,  Paschim Dhali Gaurnagar,2542,3202,1293,1571,1249,1631,44.3,45.1,43.4,00000
9.0,54.0,28.0,612,01,01,  Kala Mabulla,417,902,213,468,204,434,31.6,31.3,32.0,00000
9.0,54.0,28.0,719,01,01,  Kumarkhali,491,616,231,289,260,327,44.4,44.4,44.3,00000
9.0,54.0,28.0,719,02,01,  Naobhangni,521,565,272,246,249,319,48.0,52.5,43.8,00000
9.0,54.0,38.0,505,01,01,  Uttar Farazganj,425,1138,188,556,237,582,27.2,25.3,28.9,00000
9.0,54.0,38.0,505,02,01,  Satani,704,1656,341,795,363,861,29.8,30.0,29.7,00000
9.0,54.0,38.0,505,03,01,  Dakshin Farazganj,700,1786,332,804,368,982,28.2,29.2,27.3,00000
9.0,54.0,38.0,505,04,01,  Gaymara,1185,2813,539,1348,646,1465,29.6,28.6,30.6,00000
9.0,54.0,38.0,688,01,01,  Uttar Kishoreganj,729,1114,343,531,386,583,39.6,39.2,39.8,00000
9.0,54.0,38.0,688,02,01,  Dakshin Kishoreganj,474,710,221,300,253,410,40.0,42.4,38.2,00000
9.0,54.0,38.0,765,01,01,  Purba Maheshkhali,758,981,362,465,396,516,43.6,43.8,43.4,00000
9.0,54.0,38.0,765,02,01,  Dakshin Maheshkhali,833,1181,382,593,451,588,41.4,39.2,43.4,00000
9.0,54.0,66.0,183,01,01,  Chandpur,496,1061,245,515,251,546,31.9,32.2,31.5,00000
9.0,54.0,66.0,183,02,01,  Howakona,120,504,59,253,61,251,19.2,18.9,19.6,00000
9.0,54.0,66.0,229,01,01,  Annada Prasad,1615,977,853,462,762,515,62.3,64.9,59.7,00000
9.0,54.0,66.0,229,02,01,  Dedrabaz,288,263,152,109,136,154,52.3,58.2,46.9,00000
9.0,54.0,66.0,367,01,01,  Lord Hardinje,2230,3133,1105,1587,1125,1546,41.6,41.0,42.1,00000
9.0,54.0,66.0,367,02,01,  Latur Char,253,526,132,248,121,278,32.5,34.7,30.3,00000
9.0,54.0,66.0,397,01,01,  Peari Mohan,623,862,332,443,291,419,42.0,42.8,41.0,00000
9.0,54.0,66.0,397,02,01,  Jangalia,653,781,340,387,313,394,45.5,46.8,44.3,00000
9.0,54.0,66.0,520,01,01,  Fatemabad,841,1287,384,682,457,605,39.5,36.0,43.0,00000
9.0,54.0,66.0,520,02,01,  Howchia,684,916,351,472,333,444,42.8,42.6,42.9,00000
9.0,54.0,66.0,979,01,01,  Saidabad,550,870,273,418,277,452,38.7,39.5,38.0,00000
9.0,54.0,66.0,979,02,01,  Hasania,456,421,241,189,215,232,52.0,56.0,48.1,00000
9.0,54.0,70.0,581,01,01,  Kachukhali,2635,5872,1319,2860,1316,3012,31.0,31.6,30.4,00000
9.0,54.0,70.0,581,02,01,  Char Kachuakhali,32,1326,26,668,6,658,2.4,3.7,0.9,00000
9.0,54.0,70.0,872,01,01,  Paschim Char Umed,2096,2091,1096,1024,1000,1067,50.1,51.7,48.4,00000
9.0,54.0,70.0,872,02,01,  Guchchhagram,23,67,9,37,14,30,25.6,19.6,31.8,00000
9.0,54.0,70.0,872,03,01,  Ray Pura Kandy,294,739,156,329,138,410,28.5,32.2,25.2,00000
9.0,54.0,70.0,872,04,01,  Illidhs Kandy,496,867,244,411,252,456,36.4,37.3,35.6,00000
9.0,54.0,76.0,918,01,01,  Dakshin Ramaganj,1946,1983,970,923,976,1060,49.5,51.2,47.9,00000
9.0,54.0,76.0,918,02,01,  Uttar Ramaganj,1474,2084,676,993,798,1091,41.4,40.5,42.2,00000
9.0,54.0,76.0,933,01,01,  Uttar Roychand,1117,1587,542,736,575,851,41.3,42.4,40.3,00000
9.0,54.0,76.0,933,02,01,  Dakshin Roychand,801,1152,407,568,394,584,41.0,41.7,40.3,00000
9.0,65.0,21.0,547,01,01,  Sobhanpur,292,1159,140,558,152,601,20.1,20.1,20.2,00000
9.0,65.0,21.0,547,02,01,  Saguriha,1035,2263,496,1113,539,1150,31.4,30.8,31.9,00000
9.0,65.0,21.0,895,01,01,  Uttar Rahmanpur,1024,2711,480,1343,544,1368,27.4,26.3,28.5,00000
9.0,65.0,21.0,895,02,01,  Koralia,496,960,222,511,274,449,34.1,30.3,37.9,00000
9.0,65.0,21.0,895,03,01,  Dakshin Rahmanpur,758,1525,395,750,363,775,33.2,34.5,31.9,00000
9.0,65.0,23.0,945,01,01,  U.Sonar Char,668,789,360,355,308,434,45.8,50.3,41.5,00000
9.0,65.0,23.0,945,02,01,  D.Sonar Char,408,905,224,459,184,446,31.1,32.8,29.2,00000
9.0,65.0,47.0,049,01,01,  Purba Andhirpar,316,630,177,318,139,312,33.4,35.8,30.8,00000
9.0,65.0,47.0,049,02,01,  Machua Khali,368,741,191,354,177,387,33.2,35.0,31.4,00000
9.0,65.0,47.0,049,03,01,  Paschim Andhirpar,335,491,195,252,140,239,40.6,43.6,36.9,00000
9.0,65.0,47.0,049,04,01,  Ram Nawaz Bazar,403,855,207,431,196,424,32.0,32.4,31.6,00000
9.0,65.0,47.0,746,01,01,  Purba Kulagazir Taluk,196,456,105,233,91,223,30.1,31.1,29.0,00000
9.0,65.0,47.0,746,02,01,  Paschim Kulagazir Taluk,200,493,100,260,100,233,28.9,27.8,30.0,00000
9.0,65.0,47.0,746,04,01,  Kowertak,397,674,204,356,193,318,37.1,36.4,37.8,00000
9.0,65.0,47.0,746,05,01,  Chita Kundu,470,858,234,411,236,447,35.4,36.3,34.6,00000
9.0,65.0,71.0,199,01,01,  Majidpur,662,1493,323,723,339,770,30.7,30.9,30.6,00000
9.0,65.0,71.0,199,02,01,  Badiuzzaman,197,316,102,156,95,160,38.4,39.5,37.3,00000
9.0,65.0,71.0,199,03,01,  Sonapur,863,1846,415,915,448,931,31.9,31.2,32.5,00000
9.0,65.0,71.0,199,04,01,  Samedpur,196,513,108,285,88,228,27.6,27.5,27.8,00000
9.0,65.0,71.0,199,05,01,  Alampur,211,792,109,420,102,372,21.0,20.6,21.5,00000
9.0,65.0,71.0,995,01,01,  Alipur,1095,2582,521,1236,574,1346,29.8,29.7,29.9,00000
9.0,65.0,71.0,995,02,01,  Sandwip,680,1034,331,549,349,485,39.7,37.6,41.8,00000
9.0,91.0,38.0,276,01,01,  Dakshin Chanchra,927,1670,490,846,437,824,35.7,36.7,34.7,00000
9.0,91.0,38.0,276,02,01,  Dakshin Paschim Chanchra,1249,1959,632,920,617,1039,38.9,40.7,37.3,00000
9.0,91.0,38.0,958,01,01,  Uttar Paschim Chanchra,832,1294,409,638,423,656,39.1,39.1,39.2,00000
9.0,91.0,38.0,958,02,01,  Uttar Purba Chanchra,541,1355,290,678,251,677,28.5,30.0,27.0,00000
9.0,91.0,57.0,036,01,01,  Matabarkandi,229,609,123,304,106,305,27.3,28.8,25.8,00000
9.0,91.0,57.0,036,02,01,  Uttar Kalsa,196,236,117,114,79,122,45.4,50.6,39.3,00000
9.0,91.0,57.0,036,03,01,  Dakshin Kalsa,189,141,110,63,79,78,57.3,63.6,50.3,00000
9.0,91.0,57.0,036,04,01,  Aralia,175,234,91,111,84,123,42.8,45.0,40.6,00000
9.0,91.0,57.0,036,05,01,  Patwarikandi,99,346,50,184,49,162,22.2,21.4,23.2,00000
9.0,91.0,57.0,036,06,01,  Badura,294,305,167,141,127,164,49.1,54.2,43.6,00000
9.0,91.0,57.0,036,07,01,  Daser Hat,155,91,84,45,71,46,63.0,65.1,60.7,00000
9.0,91.0,57.0,036,08,01,  Panchayetkandi,309,619,156,313,153,306,33.3,33.3,33.3,00000
9.0,91.0,57.0,036,09,01,  Datta Para,167,126,104,43,63,83,57.0,70.7,43.2,00000
9.0,91.0,57.0,036,10,01,  Dawari Bazar,185,44,110,13,75,31,80.8,89.4,70.8,00000
9.0,91.0,57.0,036,11,01,  Baraikandi,176,76,100,27,76,49,69.8,78.7,60.8,00000
9.0,91.0,57.0,165,01,01,  Baliakandi,369,677,178,355,191,322,35.3,33.4,37.2,00000
9.0,91.0,57.0,165,02,01,  Dalalkandi,217,500,122,272,95,228,30.3,31.0,29.4,00000
9.0,91.0,57.0,165,03,01,  Gosher Haola,554,698,296,338,258,360,44.2,46.7,41.7,00000
9.0,91.0,57.0,165,04,01,  Dewanpur,803,994,377,542,426,452,44.7,41.0,48.5,00000
9.0,91.0,57.0,165,05,01,  Mollahgram,259,290,127,136,132,154,47.2,48.3,46.2,00000
9.0,91.0,57.0,165,06,01,  Chandpur,520,471,258,244,262,227,52.5,51.4,53.6,00000
9.0,91.0,57.0,165,07,01,  Mistrykandi,308,181,157,84,151,97,63.0,65.1,60.9,00000
9.0,91.0,57.0,165,08,01,  Maharkandi,513,287,276,135,237,152,64.1,67.2,60.9,00000
9.0,91.0,57.0,165,09,01,  Panditkandi,231,245,129,122,102,123,48.5,51.4,45.3,00000
9.0,91.0,57.0,350,01,01,  Imam Para,142,377,62,204,80,173,27.4,23.3,31.6,00000
9.0,91.0,57.0,350,02,01,  Moulanakandi,114,469,60,237,54,232,19.6,20.2,18.9,00000
9.0,91.0,57.0,350,03,01,  Dalalkandi,396,1085,214,590,182,495,26.7,26.6,26.9,00000
9.0,91.0,57.0,350,04,01,  Hajikandi,92,407,46,224,46,183,18.4,17.0,20.1,00000
9.0,91.0,57.0,350,05,01,  Patarikandi,123,332,44,182,79,150,27.0,19.5,34.5,00000
9.0,91.0,57.0,350,06,01,  Dakshin Dari Chandpur,166,397,105,196,61,201,29.5,34.9,23.3,00000
9.0,91.0,57.0,350,07,01,  Gurinda Bazar,54,246,25,120,29,126,18.0,17.2,18.7,00000
9.0,91.0,57.0,350,08,01,  Paschim Dari Chandpur,130,557,82,278,48,279,18.9,22.8,14.7,00000
9.0,91.0,57.0,515,01,03,  Uttar Keamulla,517,735,284,379,233,356,41.3,42.8,39.6,00000
9.0,91.0,57.0,515,02,03,  Purba Keamulla,402,447,233,212,169,235,47.3,52.4,41.8,00000
9.0,91.0,57.0,515,03,03,  Howladarkandi,387,225,214,89,173,136,63.2,70.6,56.0,00000
9.0,91.0,57.0,515,04,03,  Shayestakandi,183,111,96,46,87,65,62.2,67.6,57.2,00000
9.0,91.0,57.0,515,05,03,  Dakshin Keamullah,130,195,92,98,38,97,40.0,48.4,28.1,00000
9.0,91.0,57.0,515,06,03,  Bhelagazi Howladarkandi,361,439,177,235,184,204,45.1,43.0,47.4,00000
9.0,91.0,57.0,515,07,03,  Kumarkandi,65,249,42,132,23,117,20.7,24.1,16.4,00000
9.0,91.0,57.0,515,08,03,  Mazumder Para,210,234,112,112,98,122,47.3,50.0,44.5,00000
9.0,91.0,57.0,515,09,03,  Panditkandi,339,648,171,329,168,319,34.3,34.2,34.5,00000
9.0,91.0,57.0,515,10,03,  Jabbar Howladarkandi,265,364,138,158,127,206,42.1,46.6,38.1,00000
9.0,91.0,57.0,847,03,03,  Bhuiyankandi,442,981,208,501,234,480,31.1,29.3,32.8,00000
9.0,91.0,57.0,847,04,03,  Talukgram,147,199,75,99,72,100,42.5,43.1,41.9,00000
9.0,91.0,57.0,847,05,03,  Ramprasad,62,224,30,116,32,108,21.7,20.5,22.9,00000
9.0,91.0,57.0,847,06,03,  Mohajankandi,317,581,178,285,139,296,35.3,38.4,32.0,00000
9.0,91.0,57.0,847,07,03,  Shashiganj Bazar,929,493,534,251,395,242,65.3,68.0,62.0,00000
9.0,91.0,57.0,847,08,03,  Howladarkandi,100,512,30,285,70,227,16.3,9.5,23.6,00000
9.0,91.0,57.0,847,09,03,  Patarikandi,452,335,262,147,190,188,57.4,64.1,50.3,00000
9.0,91.0,57.0,847,10,03,  Satbaria,441,701,234,356,207,345,38.6,39.7,37.5,00000
9.0,91.0,57.0,847,11,03,  Kazikandi,75,317,37,160,38,157,19.1,18.8,19.5,00000
9.0,91.0,57.0,847,12,03,  Paschim Daspara,342,309,177,148,165,161,52.5,54.5,50.6,00000
9.0,91.0,57.0,847,13,03,  Purba Daspara,481,201,261,96,220,105,70.5,73.1,67.7,00000
9.0,91.0,57.0,847,14,03,  Dakshin Shashiganj,441,314,235,147,206,167,58.4,61.5,55.2,00000
9.0,91.0,57.0,847,15,03,  Officer Para,368,65,213,30,155,35,85.0,87.7,81.6,00000
9.0,91.0,76.0,921,01,01,  Sreeshtidhar Guha,356,558,202,304,154,254,38.9,39.9,37.7,00000
9.0,91.0,76.0,921,02,01,  Char Telea,499,782,291,386,208,396,39.0,43.0,34.4,00000
4.0,9.0,13.0,147,01,01,  Chala Bhanga,999,763,526,358,473,405,56.7,59.5,53.9,00000
4.0,9.0,13.0,147,02,01,  Chhota Nilganj,667,657,328,304,339,353,50.4,51.9,49.0,00000
4.0,9.0,13.0,147,03,01,  Sarikhali,185,199,91,94,94,105,48.2,49.2,47.2,00000
4.0,9.0,13.0,147,04,01,  Bhayla Bunia,332,366,184,175,148,191,47.6,51.3,43.7,00000
4.0,9.0,13.0,147,05,01,  Maitha,218,243,105,109,113,134,47.3,49.1,45.7,00000
4.0,9.0,13.0,712,01,01,  Uttar Nachna Para,355,549,186,239,169,310,39.3,43.8,35.3,00000
4.0,9.0,13.0,712,02,01,  Dakshin Nachna Para,454,1282,230,589,224,693,26.2,28.1,24.4,00000
4.0,9.0,13.0,712,03,01,  Mahishdanga,618,605,309,299,309,306,50.5,50.8,50.2,00000
4.0,9.0,13.0,724,01,01,  Dakshin Nilganj,545,323,278,155,267,168,62.8,64.2,61.4,00000
4.0,9.0,13.0,724,02,01,  Sekandarkhali,776,563,378,272,398,291,58.0,58.2,57.8,00000
4.0,9.0,13.0,724,03,01,  Karaibunia,437,305,214,155,223,150,58.9,58.0,59.8,00000
4.0,9.0,13.0,994,01,01,  Uttar Tiakhali,1312,987,644,491,668,496,57.1,56.7,57.4,00000
4.0,9.0,13.0,994,02,01,  Balaibunia,559,320,280,158,279,162,63.6,63.9,63.3,00000
4.0,9.0,15.0,036,01,01,  Arpangashia,135,285,65,130,70,155,32.1,33.3,31.1,00000
4.0,9.0,15.0,036,02,01,  Uttar Ghopkhali,310,252,158,111,152,141,55.2,58.7,51.9,00000
4.0,9.0,15.0,036,03,01,  Kalibari Ghopkhali,360,365,197,175,163,190,49.7,53.0,46.2,00000
4.0,9.0,15.0,036,04,01,  Jugia,399,391,185,192,214,199,50.5,49.1,51.8,00000
4.0,9.0,15.0,036,05,01,  Bhainabunia,103,188,48,103,55,85,35.4,31.8,39.3,00000
4.0,9.0,15.0,442,01,01,  Ghopkhali,1056,536,532,227,524,309,66.3,70.1,62.9,00000
4.0,9.0,15.0,442,02,01,  Char Kogsoia,343,138,163,57,180,81,71.3,74.1,69.0,00000
4.0,9.0,15.0,442,03,01,  Balia Tali,1001,671,497,327,504,344,59.9,60.3,59.4,00000
4.0,9.0,15.0,442,04,01,  Purba Charak Gachhia,293,273,127,125,166,148,51.8,50.4,52.9,00000
4.0,9.0,15.0,442,05,01,  Dakshin Charak Gachhia,646,433,324,219,322,214,59.9,59.7,60.1,00000
4.0,9.0,15.0,921,01,01,  Tarikata,438,299,210,138,228,161,59.4,60.3,58.6,00000
4.0,9.0,15.0,921,02,01,  Patakata,542,424,283,176,259,248,56.1,61.7,51.1,00000
4.0,9.0,15.0,921,03,01,  Purba Arpangashia,265,259,118,114,147,145,50.6,50.9,50.3,00000
4.0,9.0,15.0,921,04,01,  Uttar Tarikata,525,668,273,315,252,353,44.0,46.4,41.7,00000
4.0,9.0,15.0,921,05,01,  Dakshin Tarikata,450,472,243,190,207,282,48.8,56.1,42.3,00000
4.0,9.0,23.0,049,01,01,  Atharagashia,867,1190,488,488,379,702,42.1,50.0,35.1,00000
4.0,9.0,23.0,049,02,01,  Godanga,219,494,142,227,77,267,30.7,38.5,22.4,00000
4.0,9.0,23.0,049,03,01,  Paschim Atharagashia,209,490,110,237,99,253,29.9,31.7,28.1,00000
4.0,9.0,23.0,049,04,01,  Darikata,73,271,38,100,35,171,21.2,27.5,17.0,00000
4.0,9.0,23.0,393,01,01,  Uttar Gazipur,617,988,332,475,285,513,38.4,41.1,35.7,00000
4.0,9.0,23.0,393,02,01,  Dakshin Gazipur,1184,624,625,283,559,341,65.5,68.8,62.1,00000
4.0,9.0,23.0,417,01,01,  Gerabunia,491,765,254,341,237,424,39.1,42.7,35.9,00000
4.0,9.0,23.0,417,02,01,  Algi,222,409,121,182,101,227,35.2,39.9,30.8,00000
4.0,9.0,23.0,884,01,01,  Sakharia,749,1144,381,492,368,652,39.6,43.6,36.1,00000
4.0,9.0,23.0,884,02,01,  Chowla,290,350,144,145,146,205,45.3,49.8,41.6,00000
4.0,9.0,23.0,884,03,01,  Dharma Narayan,277,372,144,161,133,211,42.7,47.2,38.7,00000
4.0,9.0,23.0,884,04,01,  Golbunia,471,343,250,147,221,196,57.9,63.0,53.0,00000
4.0,9.0,23.0,909,01,01,  Purba Sonakhali,614,952,329,427,285,525,39.2,43.5,35.2,00000
4.0,9.0,23.0,909,02,01,  Paschim Sonakhali,773,1195,381,540,392,655,39.3,41.4,37.4,00000
4.0,9.0,23.0,909,03,01,  Dakshin Sonakhali,723,815,366,361,357,454,47.0,50.3,44.0,00000
4.0,9.0,23.0,909,04,01,  Uttar Sonakhali,584,355,318,163,266,192,62.2,66.1,58.1,00000
4.0,9.0,39.0,085,01,01,  Taltali Para,304,212,161,97,143,115,58.9,62.4,55.4,00000
4.0,9.0,39.0,085,02,01,  Chatan Para,662,221,347,110,315,111,75.0,75.9,73.9,00000
4.0,9.0,39.0,085,03,01,  Taltali Bandar,1245,215,670,108,575,107,85.3,86.1,84.3,00000
4.0,9.0,39.0,085,04,01,  Mali Para,649,482,354,244,295,238,57.4,59.2,55.3,00000
4.0,9.0,39.0,085,05,01,  Chhota Bhaijora,537,526,273,255,264,271,50.5,51.7,49.3,00000
4.0,9.0,39.0,085,06,01,  Talukdar Para,385,138,198,52,187,86,73.6,79.2,68.5,00000
4.0,9.0,39.0,085,07,01,  Sadagar Para,1419,851,685,417,734,434,62.5,62.2,62.8,00000
4.0,9.0,39.0,085,08,01,  Char Para,434,385,201,208,233,177,53.0,49.1,56.8,00000
4.0,9.0,39.0,085,09,01,  Harinkhola,153,248,70,117,83,131,38.2,37.4,38.8,00000
4.0,9.0,39.0,085,10,01,  Dakshin Kazirkhal,323,310,175,134,148,176,51.0,56.6,45.7,00000
4.0,9.0,39.0,085,11,01,  Moma Para,109,168,51,78,58,90,39.4,39.5,39.2,00000
4.0,9.0,39.0,085,12,01,  Sikari Para,220,285,124,142,96,143,43.6,46.6,40.2,00000
4.0,9.0,39.0,085,13,01,  Buli Para,365,46,192,25,173,21,88.8,88.5,89.2,00000
4.0,9.0,39.0,085,14,01,  Karamja Para,120,324,67,154,53,170,27.0,30.3,23.8,00000
4.0,9.0,39.0,085,15,01,  Aga Thakur Para,205,132,114,57,91,75,60.8,66.7,54.8,00000
4.0,9.0,39.0,085,16,01,  Naobhanga,193,193,108,97,85,96,50.0,52.7,47.0,00000
4.0,9.0,39.0,085,17,01,  Uttar Kazirkhal,62,249,34,121,28,128,19.9,21.9,17.9,00000
4.0,9.0,39.0,085,18,01,  Naya Bhaijora,143,91,64,55,79,36,61.1,53.8,68.7,00000
4.0,9.0,39.0,085,19,01,  Natun Para,290,107,148,56,142,51,73.0,72.5,73.6,00000
4.0,9.0,39.0,085,20,01,  Bara Bhaijora,453,500,188,255,265,245,47.5,42.4,52.0,00000
4.0,9.0,39.0,085,21,01,  Momisha Para,151,97,74,47,77,50,60.9,61.2,60.6,00000
4.0,9.0,39.0,085,22,01,  Pajrabhanga,317,288,139,145,178,143,52.4,48.9,55.5,00000
4.0,9.0,39.0,085,23,01,  Naya Para,237,28,121,7,116,21,89.4,94.5,84.7,00000
4.0,9.0,39.0,085,24,01,  Tulatali,169,195,86,108,83,87,46.4,44.3,48.8,00000
4.0,9.0,39.0,085,25,01,  Manukha Para,39,38,22,16,17,22,50.6,57.9,43.6,00000
4.0,9.0,43.0,122,01,01,  Bethi Para,270,363,132,161,138,202,42.7,45.1,40.6,00000
4.0,9.0,43.0,122,02,01,  Jogir Tabak,513,472,266,246,247,226,52.1,52.0,52.2,00000
4.0,9.0,43.0,122,03,01,  Gandamara,352,544,190,247,162,297,39.3,43.5,35.3,00000
4.0,9.0,43.0,233,01,01,  Char Para,847,877,427,431,420,446,49.1,49.8,48.5,00000
4.0,9.0,43.0,233,02,01,  Thakur Para,470,130,237,62,233,68,78.3,79.3,77.4,00000
4.0,9.0,43.0,233,03,01,  Thong Para,643,623,304,300,339,323,50.8,50.3,51.2,00000
4.0,9.0,43.0,257,01,01,  Chhota Bagi,1089,652,538,305,551,347,62.6,63.8,61.4,00000
4.0,9.0,43.0,257,02,01,  Mowpara,589,582,314,281,275,301,50.3,52.8,47.7,00000
4.0,9.0,43.0,380,01,01,  Gabtali,1051,906,516,452,535,454,53.7,53.3,54.1,00000
4.0,9.0,43.0,380,02,01,  Sundaria,65,226,35,117,30,109,22.3,23.0,21.6,00000
4.0,9.0,47.0,196,01,01,  Chandra,1666,1899,821,875,845,1024,46.7,48.4,45.2,00000
4.0,9.0,47.0,196,02,01,  Chandra Chalitabunia,162,150,72,83,90,67,51.9,46.5,57.3,00000
4.0,9.0,47.0,208,01,01,  Kownia,270,536,133,240,137,296,33.5,35.7,31.6,00000
4.0,9.0,47.0,208,02,01,  Chalabhanga,306,321,154,155,152,166,48.8,49.8,47.8,00000
4.0,9.0,47.0,208,03,01,  Lodha,445,852,225,418,220,434,34.3,35.0,33.6,00000
4.0,9.0,47.0,208,04,01,  Chowra Chalitabunia,135,210,62,104,73,106,39.1,37.3,40.8,00000
4.0,9.0,47.0,208,05,01,  Chowra Kali Bari(Part),482,469,252,237,230,232,50.7,51.5,49.8,00000
4.0,9.0,47.0,429,01,01,  Ghotkhali,1430,1235,751,542,679,693,53.7,58.1,49.5,00000
4.0,9.0,47.0,429,02,01,  Baithaghata,338,506,175,234,163,272,40.0,42.8,37.5,00000
4.0,9.0,47.0,429,03,01,  Gilatala,268,236,119,123,149,113,53.2,49.2,56.9,00000
4.0,9.0,47.0,429,04,01,  Betmor,705,452,347,212,358,240,60.9,62.1,59.9,00000
4.0,9.0,63.0,454,01,01,  Gojkhali,1574,1563,751,673,823,890,50.2,52.7,48.0,00000
4.0,9.0,63.0,454,02,01,  Dalachara,1188,1606,589,714,599,892,42.5,45.2,40.2,00000
4.0,9.0,63.0,454,03,01,  Bazarkhali,320,284,173,119,147,165,53.0,59.2,47.1,00000
4.0,9.0,63.0,454,04,01,  Bainbunia,590,492,287,199,303,293,54.5,59.1,50.8,00000
4.0,9.0,63.0,454,05,01,  Deppur,149,126,80,64,69,62,54.2,55.6,52.7,00000
4.0,9.0,63.0,479,01,01,  Gulisakhali,1497,1986,759,917,738,1069,43.0,45.3,40.8,00000
4.0,9.0,63.0,479,02,01,  Haridrabaria,655,518,322,232,333,286,55.8,58.1,53.8,00000
4.0,9.0,63.0,626,01,01,  Khekuani,1580,699,774,288,806,411,69.3,72.9,66.2,00000
4.0,9.0,63.0,626,02,01,  Angulkata,1420,806,726,354,694,452,63.8,67.2,60.6,00000
4.0,9.0,71.0,773,01,01,  Paschim Chila,765,558,344,248,421,310,57.8,58.1,57.6,00000
4.0,9.0,71.0,773,02,01,  Madhya Paschim Chila,1096,710,555,314,541,396,60.7,63.9,57.7,00000
4.0,9.0,71.0,945,01,01,  Tepura,1048,681,563,279,485,402,60.6,66.9,54.7,00000
4.0,9.0,71.0,945,02,01,  Dakshin Tepura,994,972,482,480,512,492,50.6,50.1,51.0,00000
4.0,9.0,79.0,012,01,01,  Alirbandar,536,726,290,382,246,344,42.5,43.2,41.7,00000
4.0,9.0,79.0,012,02,01,  Uttar Jharakhali,682,587,317,279,365,308,53.7,53.2,54.2,00000
4.0,9.0,87.0,307,01,01,  Kalipur,787,510,389,198,398,312,60.7,66.3,56.1,00000
4.0,9.0,87.0,307,02,01,  Amragachhia,803,787,416,394,387,393,50.5,51.4,49.6,00000
4.0,9.0,87.0,601,01,01,  Paschim Keowabunia,854,657,410,241,444,416,56.5,63.0,51.6,00000
4.0,9.0,87.0,601,02,01,  Purba Keowabunia,366,392,197,140,169,252,48.3,58.5,40.1,00000
4.0,9.0,87.0,638,01,01,  Paschim Krishnanagar,613,886,312,399,301,487,40.9,43.9,38.2,00000
4.0,9.0,87.0,638,02,01,  Purba Krishnanagar,787,520,372,229,415,291,60.2,61.9,58.8,00000
4.0,9.0,87.0,663,01,01,  Paschim Kukua,657,741,319,341,338,400,47.0,48.3,45.8,00000
4.0,9.0,87.0,663,02,01,  Purba Kukua,904,1347,433,612,471,735,40.2,41.4,39.1,00000
4.0,9.0,87.0,872,01,01,  Paschim Roybala,285,258,139,111,146,147,52.5,55.6,49.8,00000
4.0,9.0,87.0,872,02,01,  Purba Roybala,146,256,72,114,74,142,36.3,38.7,34.3,00000
4.0,9.0,91.0,073,09,01,  Tanti Para,484,387,235,211,249,176,55.6,52.7,58.6,00000
4.0,9.0,91.0,073,10,01,  Namesha Para,277,142,139,82,138,60,66.1,62.9,69.7,00000
4.0,9.0,91.0,073,11,01,  Sobhan Para,236,180,105,101,131,79,56.7,51.0,62.4,00000
4.0,9.0,91.0,073,12,01,  Maha Para,72,108,38,50,34,58,40.0,43.2,37.0,00000
4.0,9.0,91.0,073,13,01,  Bathi Para,227,55,114,19,113,36,80.5,85.7,75.8,00000
4.0,9.0,91.0,073,14,01,  Chhota Akujan Para,71,66,29,33,42,33,51.8,46.8,56.0,00000
4.0,9.0,91.0,073,15,01,  Baraitali Para,264,270,134,132,130,138,49.4,50.4,48.5,00000
4.0,9.0,91.0,073,16,01,  Morati,557,154,279,77,278,77,78.3,78.4,78.3,00000
4.0,9.0,91.0,282,01,01,  Bara Ankujan Para,933,944,452,492,481,452,49.7,47.9,51.6,00000
4.0,9.0,91.0,282,02,01,  Tentulbaria,293,298,142,155,151,143,49.6,47.8,51.4,00000
4.0,9.0,91.0,282,03,01,  Joyalbhanga,133,375,70,190,63,185,26.2,26.9,25.4,00000
4.0,9.0,91.0,282,04,01,  Adapara,391,241,183,123,208,118,61.9,59.8,63.8,00000
4.0,9.0,91.0,282,05,01,  Nidraghora Para,572,836,270,429,302,407,40.6,38.6,42.6,00000
4.0,9.0,91.0,282,06,01,  Mani Para,298,268,137,147,161,121,52.7,48.2,57.1,00000
4.0,9.0,91.0,282,07,01,  Chamo Para,172,279,79,142,93,137,38.1,35.7,40.4,00000
4.0,9.0,91.0,282,08,01,  Nidrarghora Para,541,637,273,332,268,305,45.9,45.1,46.8,00000
4.0,9.0,94.0,098,01,01,  Bara Para,626,468,304,209,322,259,57.2,59.3,55.4,00000
4.0,9.0,94.0,098,02,01,  Gabbaria,718,460,371,207,347,253,61.0,64.2,57.8,00000
4.0,9.0,94.0,184,01,01,  Chandkhali,993,366,486,154,507,212,73.1,75.9,70.5,00000
4.0,9.0,94.0,184,02,01,  Kalarang,659,511,317,228,342,283,56.3,58.2,54.7,00000
4.0,9.0,94.0,184,03,01,  Hulatana,341,304,157,129,184,175,52.9,54.9,51.3,00000
4.0,9.0,94.0,184,04,01,  Hari Para,420,365,181,175,239,190,53.5,50.8,55.7,00000
4.0,9.0,94.0,737,01,01,  Pancha Koralia,698,581,372,256,326,325,54.6,59.2,50.1,00000
4.0,9.0,94.0,737,02,01,  Monshatali,449,470,219,235,230,235,48.9,48.2,49.5,00000
4.0,9.0,94.0,737,03,01,  Joyalbhanga,508,826,280,396,228,430,38.1,41.4,34.7,00000
4.0,9.0,95.0,540,01,01,  Kachupatra,731,500,380,211,351,289,59.4,64.3,54.8,00000
4.0,9.0,95.0,540,02,01,  Badurgachha,921,810,419,363,502,447,53.2,53.6,52.9,00000
4.0,9.0,95.0,896,01,01,  Sarikkhali,359,272,200,102,159,170,56.9,66.2,48.3,00000
4.0,9.0,95.0,896,02,01,  Nalbunia,635,588,324,278,311,310,51.9,53.8,50.1,00000
4.0,9.0,95.0,896,03,01,  Chowla Para,559,378,274,193,285,185,59.7,58.7,60.6,00000
4.0,9.0,95.0,896,04,01,  Anger Para,286,516,170,277,116,239,35.7,38.0,32.7,00000
4.0,9.0,96.0,073,01,01,  Kabiraj Para,716,515,342,243,374,272,58.2,58.5,57.9,00000
4.0,9.0,96.0,073,02,01,  Lowpara,344,506,187,250,157,256,40.5,42.8,38.0,00000
4.0,9.0,96.0,073,03,01,  Lalu Para,576,354,254,193,322,161,61.9,56.8,66.7,00000
4.0,9.0,96.0,073,04,01,  Bara Amkhola,573,564,256,275,317,289,50.4,48.2,52.3,00000
4.0,9.0,96.0,073,05,01,  Chhota Amkhola,287,523,148,271,139,252,35.4,35.3,35.5,00000
4.0,9.0,96.0,073,06,01,  Idupara,427,368,207,192,220,176,53.7,51.9,55.6,00000
4.0,9.0,96.0,073,07,01,  Sokina,595,342,306,167,289,175,63.5,64.7,62.3,00000
4.0,9.0,96.0,073,08,01,  Nidra Char,1119,581,590,287,529,294,65.8,67.3,64.3,00000
4.0,19.0,23.0,943,01,03,  Purba Shafipur,1490,882,715,441,775,441,62.8,61.9,63.7,00000
4.0,19.0,23.0,943,02,03,  Paschim Shafipur,2156,610,1098,271,1058,339,77.9,80.2,75.7,00000
4.0,19.0,47.0,331,01,01,  Chhanbunia,1074,807,540,401,534,406,57.1,57.4,56.8,00000
4.0,19.0,47.0,331,02,01,  Jafrakhali,469,487,251,228,218,259,49.1,52.4,45.7,00000
4.0,19.0,47.0,867,01,01,  Purba Chalitabunia,1908,1060,947,518,961,542,64.3,64.6,63.9,00000
4.0,19.0,47.0,867,02,01,  Kalikabari,285,79,157,33,128,46,78.3,82.6,73.6,00000
4.0,19.0,71.0,229,01,01,  Uttar Bhaijora,1125,394,558,175,567,219,74.1,76.1,72.1,00000
4.0,19.0,71.0,229,02,01,  Dakshin Bhaijora,1206,756,649,356,557,400,61.5,64.6,58.2,00000
4.0,19.0,71.0,408,01,01,  Uttar Dauatala,1736,430,909,196,827,234,80.1,82.3,77.9,00000
4.0,19.0,71.0,408,02,01,  Dakshin Dauatala,1030,606,530,280,500,326,63.0,65.4,60.5,00000
4.0,19.0,71.0,535,01,01,  Uttar Gudighata,1377,677,737,315,640,362,67.0,70.1,63.9,00000
4.0,19.0,71.0,535,02,01,  Dakshin Gudighata,459,388,235,214,224,174,54.2,52.3,56.3,00000
4.0,19.0,71.0,535,03,01,  Chala Bhanga,323,438,192,239,131,199,42.4,44.5,39.7,00000
4.0,19.0,71.0,535,04,01,  Dakshin Kakchira,493,299,266,141,227,158,62.2,65.4,59.0,00000
4.0,19.0,71.0,612,01,01,  Uttar Kakchira,1078,709,613,312,465,397,60.3,66.3,53.9,00000
4.0,19.0,71.0,612,02,01,  Dakshin Kakchira,1404,468,708,192,696,276,75.0,78.7,71.6,00000
4.0,19.0,95.0,484,01,01,  Golaghata,1299,1007,631,485,668,522,56.3,56.5,56.1,00000
4.0,19.0,95.0,484,02,01,  Dauatala,270,74,127,29,143,45,78.5,81.4,76.1,00000
4.0,28.0,17.0,356,01,01,  Gabtali,360,327,181,141,179,186,52.4,56.2,49.0,00000
4.0,28.0,17.0,356,02,01,  Pakurgachhia,1032,805,536,388,496,417,56.2,58.0,54.3,00000
4.0,28.0,17.0,356,03,01,  Purba Keorabunia,168,148,77,74,91,74,53.2,51.0,55.2,00000
4.0,28.0,17.0,488,01,01,  Uttar Itabaria,740,296,369,147,371,149,71.4,71.5,71.3,00000
4.0,28.0,17.0,488,02,01,  Badhu Thakurani,570,488,293,240,277,248,53.9,55.0,52.8,00000
4.0,28.0,17.0,488,03,01,  Lemua,866,1027,457,474,409,553,45.7,49.1,42.5,00000
4.0,28.0,17.0,488,04,01,  Kadamtala,433,682,209,335,224,347,38.8,38.4,39.2,00000
4.0,28.0,17.0,488,05,01,  Khejurtala,211,98,107,44,104,54,68.3,70.9,65.8,00000
4.0,28.0,17.0,882,01,01,  Porakata,436,542,220,258,216,284,44.6,46.0,43.2,00000
4.0,28.0,17.0,882,02,01,  Purba Keorabunia,741,749,399,350,342,399,49.7,53.3,46.2,00000
4.0,28.0,17.0,882,03,01,  Dakshin Jtbaria,782,562,410,261,372,301,58.2,61.1,55.3,00000
4.0,28.0,17.0,882,04,01,  Langalkata,266,70,133,26,133,44,79.2,83.6,75.1,00000
4.0,28.0,17.0,882,05,01,  Khajurtala,318,137,148,63,170,74,69.9,70.1,69.7,00000
4.0,28.0,19.0,075,01,01,  Uttar Badarkhali,1048,647,543,293,505,354,61.8,65.0,58.8,00000
4.0,28.0,19.0,075,02,01,  Dakshin Badarkhali,988,704,523,296,465,408,58.4,63.9,53.3,00000
4.0,28.0,19.0,131,01,01,  Purba Baoalkar,607,915,317,416,290,499,39.9,43.2,36.8,00000
4.0,28.0,19.0,131,02,01,  Paschim Baoalkar,520,908,244,446,276,462,36.4,35.4,37.4,00000
4.0,28.0,19.0,131,03,01,  Dema,633,667,341,292,292,375,48.7,53.9,43.8,00000
4.0,28.0,19.0,431,01,01,  Purba Gulishakhali,1039,678,492,332,547,346,60.5,59.7,61.3,00000
4.0,28.0,19.0,431,02,01,  Paschim Gulishakhali,313,360,158,166,155,194,46.5,48.8,44.4,00000
4.0,28.0,19.0,431,03,01,  Mager Char,213,107,121,48,92,59,66.6,71.6,60.9,00000
4.0,28.0,19.0,638,01,01,  Kumrakhali,2616,1660,1379,750,1237,910,61.2,64.8,57.6,00000
4.0,28.0,19.0,638,02,01,  Chalitatala,581,361,276,166,305,195,61.7,62.4,61.0,00000
4.0,28.0,19.0,976,01,01,  Uttar Tentulbaria,766,616,339,294,427,322,55.4,53.6,57.0,00000
4.0,28.0,19.0,976,02,01,  Dakshin Tentulbaria,911,544,443,252,468,292,62.6,63.7,61.6,00000
4.0,28.0,28.0,112,01,01,  Kalir Tabak,1129,763,541,381,588,382,59.7,58.7,60.6,00000
4.0,28.0,28.0,112,02,01,  Pajrabhanga,576,403,256,215,320,188,58.8,54.4,63.0,00000
4.0,28.0,28.0,112,03,01,  Khakbunia,159,217,73,112,86,105,42.3,39.5,45.0,00000
4.0,28.0,28.0,112,04,01,  Uttar Helibunia,355,273,174,143,181,130,56.5,54.9,58.2,00000
4.0,28.0,28.0,112,05,01,  Banshbunia,618,595,318,274,300,321,50.9,53.7,48.3,00000
4.0,28.0,28.0,469,01,01,  Patakata,524,241,241,116,283,125,68.5,67.5,69.4,00000
4.0,28.0,28.0,469,02,01,  Hewlibunia,459,449,241,193,218,256,50.6,55.5,46.0,00000
4.0,28.0,28.0,469,03,01,  Amtali,711,577,358,267,353,310,55.2,57.3,53.2,00000
4.0,28.0,28.0,469,04,01,  Paschim Hewlibunia,920,688,477,315,443,373,57.2,60.2,54.3,00000
4.0,28.0,28.0,600,01,01,  Korak,1301,976,674,459,627,517,57.1,59.5,54.8,00000
4.0,28.0,28.0,600,02,01,  Kalatala,296,337,136,160,160,177,46.8,45.9,47.5,00000
4.0,28.0,28.0,600,03,01,  Karitala,199,149,90,72,109,77,57.2,55.6,58.6,00000
4.0,28.0,28.0,600,04,01,  Dhula,1057,538,533,238,524,300,66.3,69.1,63.6,00000
4.0,28.0,28.0,600,05,01,  Uttar Helibunia,303,221,151,93,152,128,57.8,61.9,54.3,00000
4.0,28.0,28.0,600,06,01,  Paschim Helibunia,137,147,69,78,68,69,48.2,46.9,49.6,00000
4.0,28.0,28.0,901,01,01,  Potkakhali,573,388,300,186,273,202,59.6,61.7,57.5,00000
4.0,28.0,28.0,901,02,01,  Paschim Dhalua,780,174,400,86,380,88,81.8,82.3,81.2,00000
4.0,28.0,28.0,901,03,01,  Parbati,239,131,110,64,129,67,64.6,63.2,65.8,00000
4.0,28.0,38.0,168,01,01,  Bara Labangola,851,795,432,387,419,408,51.7,52.7,50.7,00000
4.0,28.0,38.0,168,02,01,  Manik Khali,297,346,144,173,153,173,46.2,45.4,46.9,00000
4.0,28.0,38.0,168,03,01,  Sonbunia,260,249,129,119,131,130,51.1,52.0,50.2,00000
4.0,28.0,38.0,168,04,01,  Maitha,849,870,411,422,438,448,49.4,49.3,49.4,00000
4.0,28.0,38.0,168,05,01,  Uttar Bara Labongola,686,771,338,384,348,387,47.1,46.8,47.3,00000
4.0,28.0,38.0,244,01,01,  Charak Gachhia,1116,1137,587,537,529,600,49.5,52.2,46.9,00000
4.0,28.0,38.0,244,02,01,  Keorabunia,1068,987,576,463,492,524,52.0,55.4,48.4,00000
4.0,28.0,38.0,244,03,01,  Sonakhali,841,620,424,309,417,311,57.6,57.8,57.3,00000
4.0,28.0,38.0,244,04,01,  Paschim Charak Gachhia,908,850,481,396,427,454,51.6,54.8,48.5,00000
4.0,28.0,38.0,713,01,01,  Napitkhali,311,228,158,111,153,117,57.7,58.7,56.7,00000
4.0,28.0,38.0,713,02,01,  Hazar Bigha,857,525,438,242,419,283,62.0,64.4,59.7,00000
4.0,28.0,38.0,713,03,01,  Paschim Burir Char,608,731,329,333,279,398,45.4,49.7,41.2,00000
4.0,28.0,38.0,938,01,01,  Sonatala,148,796,79,374,69,422,15.7,17.4,14.1,00000
4.0,28.0,38.0,938,02,01,  Royer Tabak,516,372,235,174,281,198,58.1,57.5,58.7,00000
4.0,28.0,47.0,262,01,01,  Roybhog (Part),999,498,441,213,558,285,66.7,67.4,66.2,00000
4.0,28.0,47.0,262,02,01,  Islampur Bandar Gachhia,423,460,194,230,229,230,47.9,45.8,49.9,00000
4.0,28.0,47.0,262,03,01,  Uttar Charak Gachhia,793,794,377,361,416,433,50.0,51.1,49.0,00000
4.0,28.0,47.0,262,04,01,  Kakurnia,379,459,214,213,165,246,45.2,50.1,40.1,00000
4.0,28.0,47.0,319,01,01,  Dalbhanga,363,343,170,159,193,184,51.4,51.7,51.2,00000
4.0,28.0,47.0,319,02,01,  Mollar Hora,560,429,276,209,284,220,56.6,56.9,56.3,00000
4.0,28.0,47.0,319,03,01,  Markhali,317,398,149,179,168,219,44.3,45.4,43.4,00000
4.0,28.0,47.0,319,04,01,  Paschim Fuldhalua,310,182,181,80,129,102,63.0,69.3,55.8,00000
4.0,28.0,47.0,319,05,01,  Kanthaltali,323,470,151,199,172,271,40.7,43.1,38.8,00000
4.0,28.0,47.0,319,06,01,  Kadamtala,363,418,166,181,197,237,46.5,47.8,45.4,00000
4.0,28.0,47.0,319,07,01,  Manikjar,184,56,89,28,95,28,76.7,76.1,77.2,00000
4.0,28.0,47.0,319,08,01,  Roybhog (Part),253,86,121,39,132,47,74.6,75.6,73.7,00000
4.0,28.0,47.0,319,09,01,  Lakurtala,181,219,83,100,98,119,45.3,45.4,45.2,00000
4.0,28.0,47.0,337,01,01,  Lemua,1063,393,496,176,567,217,73.0,73.8,72.3,00000
4.0,28.0,47.0,337,02,01,  Purba Fuldhalua,1221,829,595,367,626,462,59.6,61.9,57.5,00000
4.0,28.0,47.0,563,01,01,  Golbunia,253,213,110,114,143,99,54.3,49.1,59.1,00000
4.0,28.0,47.0,563,02,01,  Baraitala,232,170,99,86,133,84,57.7,53.5,61.3,00000
4.0,28.0,47.0,563,03,01,  Latabaria,248,229,118,114,130,115,52.0,50.9,53.1,00000
4.0,28.0,47.0,563,04,01,  Machkhali,27,32,10,19,17,13,45.8,34.5,56.7,00000
4.0,28.0,47.0,563,05,01,  Khajura,213,274,104,136,109,138,43.7,43.3,44.1,00000
4.0,28.0,47.0,563,06,01,  Uttar Fuldhalua,42,88,23,38,19,50,32.3,37.7,27.5,00000
4.0,28.0,47.0,563,07,01,  Uttar Dalbhanga,275,329,145,162,130,167,45.5,47.2,43.8,00000
4.0,28.0,47.0,563,08,01,  Potkakhali,1286,1157,674,547,612,610,52.6,55.2,50.1,00000
4.0,28.0,47.0,675,01,01,  Itabaria,252,28,125,7,127,21,90.0,94.7,85.8,00000
4.0,28.0,47.0,675,02,01,  Shapa,50,9,25,2,25,7,84.7,92.6,78.1,00000
4.0,28.0,47.0,675,03,01,  Nali,924,428,482,191,442,237,68.3,71.6,65.1,00000
4.0,28.0,47.0,675,04,01,  Shazimara,214,303,74,141,140,162,41.4,34.4,46.4,00000
4.0,28.0,47.0,675,05,01,  Dakshin Charak Gachhia,459,283,267,134,192,149,61.9,66.6,56.3,00000
4.0,28.0,57.0,225,01,01,  Purba Ghudighata,616,514,312,220,304,294,54.5,58.6,50.8,00000
4.0,28.0,57.0,225,02,01,  Saheber Haola,830,396,393,182,437,214,67.7,68.3,67.1,00000
4.0,28.0,57.0,225,03,01,  Road Para,600,362,321,161,279,201,62.4,66.6,58.1,00000
4.0,28.0,57.0,225,04,01,  Ferachora,280,95,136,54,144,41,74.7,71.6,77.8,00000
4.0,28.0,57.0,225,05,01,  Andar Manik,526,258,259,133,267,125,67.1,66.1,68.1,00000
4.0,28.0,57.0,225,06,01,  Burirkhal,323,243,178,100,145,143,57.1,64.0,50.3,00000
4.0,28.0,57.0,225,07,01,  Paschim Chudighata,297,180,145,86,152,94,62.3,62.8,61.8,00000
4.0,28.0,57.0,281,01,01,  Chhota Gaurichanna,439,378,219,184,220,194,53.7,54.3,53.1,00000
4.0,28.0,57.0,281,02,01,  Khar Mahal,401,232,212,102,189,130,63.3,67.5,59.2,00000
4.0,28.0,57.0,281,03,01,  Barghar,113,113,56,49,57,64,50.0,53.3,47.1,00000
4.0,28.0,57.0,281,04,01,  Rupnagar,311,451,162,192,149,259,40.8,45.8,36.5,00000
4.0,28.0,57.0,281,05,01,  Gayen Para,349,312,165,140,184,172,52.8,54.1,51.7,00000
4.0,28.0,57.0,281,06,01,  Galachipa,134,96,75,41,59,55,58.3,64.7,51.8,00000
4.0,28.0,57.0,281,07,01,  Mir Mahal,444,337,210,133,234,204,56.9,61.2,53.4,00000
4.0,28.0,66.0,150,01,01,  Mansatali,2723,1576,1481,740,1242,836,63.3,66.7,59.8,00000
4.0,28.0,66.0,150,02,01,  Bhutmara,388,351,200,165,188,186,52.5,54.8,50.3,00000
4.0,28.0,66.0,150,03,01,  Paschim Dhupati,935,468,453,229,482,239,66.6,66.4,66.9,00000
4.0,28.0,66.0,150,04,01,  Purba Dhupati,1025,518,507,239,518,279,66.4,68.0,65.0,00000
4.0,28.0,66.0,150,05,01,  Rotpara,504,218,264,97,240,121,69.8,73.1,66.5,00000
4.0,28.0,66.0,581,01,01,  Khajurtala,3473,2106,1762,974,1711,1132,62.3,64.4,60.2,00000
4.0,28.0,66.0,581,02,01,  Lakurtala,3156,1237,1615,563,1541,674,71.8,74.2,69.6,00000
4.0,28.0,66.0,581,03,01,  Betbunia,307,33,157,14,150,19,90.3,91.8,88.8,00000
4.0,28.0,66.0,844,01,01,  Bara Gaurichanna,1122,778,564,344,558,434,59.1,62.1,56.3,00000
4.0,28.0,66.0,844,02,01,  Kalai Mudafat,568,338,296,150,272,188,62.7,66.4,59.1,00000
4.0,28.0,66.0,844,03,01,  Baish Tabak,355,216,187,106,168,110,62.2,63.8,60.4,00000
4.0,28.0,66.0,844,04,01,  Chhota Badarkhali,396,288,200,117,196,171,57.9,63.1,53.4,00000
4.0,28.0,66.0,844,05,01,  Uttar Lakurtala,348,296,168,136,180,160,54.0,55.3,52.9,00000
4.0,28.0,76.0,450,01,01,  Angerpora,904,1026,443,477,461,549,46.8,48.2,45.6,00000
4.0,28.0,76.0,450,02,01,  Adabaria,296,254,152,115,144,139,53.8,56.9,50.9,00000
4.0,28.0,76.0,450,03,01,  Haridrabaria,765,607,357,297,408,310,55.8,54.6,56.8,00000
4.0,28.0,76.0,450,04,01,  Purba Angerpora,546,477,276,196,270,281,53.4,58.5,49.0,00000
4.0,28.0,76.0,544,01,01,  Latabaria,733,436,380,193,353,243,62.7,66.3,59.2,00000
4.0,28.0,76.0,544,02,01,  Keorabunia,803,549,393,266,410,283,59.4,59.6,59.2,00000
4.0,28.0,76.0,544,03,01,  Singrabunia,730,318,347,145,383,173,69.7,70.5,68.9,00000
4.0,28.0,76.0,544,04,01,  Dakshin Jakir Tabak,378,397,184,187,194,210,48.8,49.6,48.0,00000
4.0,28.0,76.0,544,05,01,  K.Latabaria,197,242,119,109,78,133,44.9,52.2,37.0,00000
4.0,28.0,76.0,994,01,01,  Purba Tulsibaria,642,420,328,175,314,245,60.5,65.2,56.2,00000
4.0,28.0,76.0,994,02,01,  Purba Ghatbaria,274,471,159,216,115,255,36.8,42.4,31.1,00000
4.0,28.0,76.0,994,03,01,  Jogir Tabak,440,333,220,152,220,181,56.9,59.1,54.9,00000
4.0,28.0,76.0,994,04,01,  Kotbaria,121,248,72,111,49,137,32.8,39.3,26.3,00000
4.0,28.0,76.0,994,05,01,  Paschim Tulsibaria,279,267,129,122,150,145,51.1,51.4,50.8,00000
4.0,28.0,76.0,994,06,01,  Paschim Ghatbaria,405,338,197,182,208,156,54.5,52.0,57.1,00000
4.0,28.0,85.0,093,01,01,  Bara Baliatali,362,227,176,103,186,124,61.5,63.1,60.0,00000
4.0,28.0,85.0,093,02,01,  Chhota Baliatali,575,489,281,240,294,249,54.0,53.9,54.1,00000
4.0,28.0,85.0,093,03,01,  Char Para,458,456,211,199,247,257,50.1,51.5,49.0,00000
4.0,28.0,85.0,657,01,01,  Maitha,697,419,326,180,371,239,62.5,64.4,60.8,00000
4.0,28.0,85.0,657,02,01,  Shasatala,146,190,73,93,73,97,43.5,44.0,42.9,00000
4.0,28.0,85.0,657,03,01,  Mansatali,194,213,95,93,99,120,47.7,50.5,45.2,00000
4.0,28.0,85.0,657,04,01,  Baski,333,340,158,168,175,172,49.5,48.5,50.4,00000
4.0,28.0,85.0,657,05,01,  Amtala,250,134,117,64,133,70,65.1,64.6,65.5,00000
4.0,28.0,85.0,657,06,01,  Lakurtala,383,221,175,96,208,125,63.4,64.6,62.5,00000
4.0,28.0,85.0,657,07,01,  Chaltatali,354,125,178,50,176,75,73.9,78.1,70.1,00000
4.0,28.0,85.0,732,01,01,  Char Maitha,241,306,118,147,123,159,44.1,44.5,43.6,00000
4.0,28.0,85.0,732,02,01,  Azizabad (Nimtali),139,163,67,71,72,92,46.0,48.6,43.9,00000
4.0,28.0,85.0,732,03,01,  Mothertali,249,162,120,82,129,80,60.6,59.4,61.7,00000
4.0,28.0,85.0,732,04,01,  Maitha,803,532,350,239,453,293,60.1,59.4,60.7,00000
4.0,28.0,85.0,732,05,01,  Chalitatali,333,166,173,77,160,89,66.7,69.2,64.3,00000
4.0,28.0,85.0,732,06,01,  Nimtali,258,207,119,98,139,109,55.5,54.8,56.0,00000
4.0,28.0,85.0,769,01,01,  Orbania,685,489,325,226,360,263,58.3,59.0,57.8,00000
4.0,28.0,85.0,769,02,01,  Charabhanga,259,221,123,107,136,114,54.0,53.5,54.4,00000
4.0,28.0,85.0,769,03,01,  Helibunia,145,100,68,52,77,48,59.2,56.7,61.6,00000
4.0,28.0,85.0,769,04,01,  Falisatali,272,235,135,126,137,109,53.6,51.7,55.7,00000
4.0,28.0,85.0,769,05,01,  Jhinaibaria,143,118,81,54,62,64,54.8,60.0,49.2,00000
4.0,28.0,85.0,769,06,01,  Amtali,178,78,102,32,76,46,69.5,76.1,62.3,00000
4.0,28.0,85.0,769,07,01,  Chalitatali,193,160,106,60,87,100,54.7,63.9,46.5,00000
4.0,28.0,85.0,769,08,01,  Jelkhana,677,439,305,215,372,224,60.7,58.7,62.4,00000
4.0,28.0,85.0,807,01,01,  Paler Baliatali,632,430,306,233,326,197,59.5,56.8,62.3,00000
4.0,28.0,85.0,807,02,01,  Patakata,769,817,350,408,419,409,48.5,46.2,50.6,00000
4.0,28.0,85.0,807,03,01,  Chonbunia,88,258,42,129,46,129,25.4,24.6,26.3,00000
4.0,28.0,85.0,919,01,01,  Rokshachandi,337,276,159,117,178,159,55.0,57.6,52.8,00000
4.0,28.0,85.0,919,02,01,  Shashatali,173,158,89,77,84,81,52.3,53.6,50.9,00000
4.0,28.0,85.0,919,03,01,  Latakata,195,459,101,213,94,246,29.8,32.2,27.6,00000
4.0,28.0,85.0,919,04,01,  Khantakata,184,116,86,46,98,70,61.3,65.2,58.3,00000
4.0,28.0,85.0,919,05,01,  Banai,132,236,64,98,68,138,35.9,39.5,33.0,00000
4.0,28.0,85.0,919,06,01,  Mansatali,634,211,309,96,325,115,75.0,76.3,73.9,00000
4.0,28.0,85.0,919,07,01,  Parirkhal,192,346,93,153,99,193,35.7,37.8,33.9,00000
4.0,28.0,85.0,957,01,01,  Taltali,588,516,269,259,319,257,53.3,50.9,55.4,00000
4.0,28.0,85.0,957,02,01,  Parirkhal,576,465,299,216,277,249,55.3,58.1,52.7,00000
4.0,28.0,85.0,957,03,01,  Amlakitala,299,252,131,115,168,137,54.3,53.3,55.1,00000
4.0,28.0,85.0,957,04,01,  Bainsamet,349,286,174,144,175,142,55.0,54.7,55.2,00000
4.0,28.0,95.0,375,01,01,  Shialia,343,175,168,88,175,87,66.2,65.6,66.8,00000
4.0,28.0,95.0,375,02,01,  Padma (Part-788),289,355,145,158,144,197,44.9,47.9,42.2,00000
4.0,28.0,95.0,394,01,01,  Gazi Mamud,1405,1120,649,576,756,544,55.6,53.0,58.2,00000
4.0,28.0,95.0,394,02,01,  Padma (Part-788),173,95,79,47,94,48,64.6,62.7,66.2,00000
4.0,28.0,95.0,619,01,01,  Gazi Mamud (Part-394-01),205,159,102,89,103,70,56.3,53.4,59.5,00000
4.0,28.0,95.0,619,02,01,  Padma (Part-788),499,365,248,181,251,184,57.8,57.8,57.7,00000
4.0,28.0,95.0,619,03,01,  Sonatala,612,716,261,378,351,338,46.1,40.8,50.9,00000
4.0,28.0,95.0,619,04,01,  Kumirmara,170,281,69,153,101,128,37.7,31.1,44.1,00000
4.0,28.0,95.0,694,01,01,  Naltona,542,486,275,232,267,254,52.7,54.2,51.2,00000
4.0,28.0,95.0,694,02,01,  Golbunia,490,412,221,210,269,202,54.3,51.3,57.1,00000
4.0,28.0,95.0,694,03,01,  Azgarkati,695,566,327,283,368,283,55.1,53.6,56.5,00000
4.0,28.0,95.0,750,01,01,  Garjanbunia,246,251,121,109,125,142,49.5,52.6,46.8,00000
4.0,28.0,95.0,750,02,01,  Nishanbaria,520,594,247,281,273,313,46.7,46.8,46.6,00000
4.0,28.0,95.0,750,03,01,  Amtali,126,165,55,82,71,83,43.3,40.1,46.1,00000
4.0,28.0,95.0,963,01,01,  Garjanbunia,632,424,301,194,331,230,59.8,60.8,59.0,00000
4.0,28.0,95.0,963,02,01,  Sialia,735,510,363,247,372,263,59.0,59.5,58.6,00000
4.0,28.0,95.0,963,03,01,  Padma,56,24,32,9,24,15,70.0,78.0,61.5,00000
4.0,47.0,11.0,151,01,03,  Purba Betagi,19,31,10,19,9,12,38.0,34.5,42.9,00000
4.0,47.0,11.0,151,02,03,  Dakshin Betagi,548,228,283,112,265,116,70.6,71.6,69.6,00000
4.0,47.0,11.0,151,03,03,  Uttar Betagi,212,125,118,56,94,69,62.9,67.8,57.7,00000
4.0,47.0,11.0,893,01,01,  Paschim Ranipur,382,372,190,163,192,209,50.7,53.8,47.9,00000
4.0,47.0,11.0,893,02,01,  Purba Ranipur,963,418,446,165,517,253,69.7,73.0,67.1,00000
4.0,47.0,23.0,185,01,01,  Bibichini,2737,1884,1351,834,1386,1050,59.2,61.8,56.9,00000
4.0,47.0,23.0,185,02,01,  Char Bibichini,329,132,147,61,182,71,71.4,70.7,71.9,00000
4.0,47.0,47.0,269,01,01,  Uttar Chhopkhali Char,609,283,305,131,304,152,68.3,70.0,66.7,00000
4.0,47.0,47.0,269,02,01,  Dakshin Chhopkhali,853,888,423,390,430,498,49.0,52.0,46.3,00000
4.0,47.0,47.0,387,01,01,  Purba Hosnabad,446,417,226,191,220,226,51.7,54.2,49.3,00000
4.0,47.0,47.0,387,02,01,  Paschim Hosnabad,776,953,422,430,354,523,44.9,49.5,40.4,00000
4.0,47.0,47.0,556,01,01,  Purba Hosnabad,1076,1039,524,456,552,583,50.9,53.5,48.6,00000
4.0,47.0,47.0,556,02,01,  Paschim Hosnabad,693,505,352,226,341,279,57.8,60.9,55.0,00000
4.0,47.0,47.0,843,01,01,  Paschimkandi,134,235,63,107,71,128,36.3,37.1,35.7,00000
4.0,47.0,47.0,843,02,01,  Purbakandi,405,357,183,165,222,192,53.1,52.6,53.6,00000
4.0,47.0,59.0,033,01,01,  Ayela Chandkhali,558,370,272,176,286,194,60.1,60.7,59.6,00000
4.0,47.0,59.0,033,02,01,  Dakshin Chandkhali,1143,495,582,232,561,263,69.8,71.5,68.1,00000
4.0,47.0,59.0,067,01,01,  Purba Bakultali,1006,656,483,290,523,366,60.5,62.5,58.8,00000
4.0,47.0,59.0,067,02,01,  Paschim Bakultali,787,610,385,273,402,337,56.3,58.5,54.4,00000
4.0,47.0,59.0,640,01,01,  Uttar Kalikabari,157,84,82,35,75,49,65.1,70.1,60.5,00000
4.0,47.0,59.0,640,02,01,  Chhota Kalikabari,375,342,187,150,188,192,52.3,55.5,49.5,00000
4.0,47.0,59.0,708,01,01,  Kazirabad,922,582,457,265,465,317,61.3,63.3,59.5,00000
4.0,47.0,59.0,708,02,01,  Madhya Kazirabad,517,816,267,386,250,430,38.8,40.9,36.8,00000
4.0,47.0,59.0,708,03,01,  Dakshin Kazirabad,974,809,495,366,479,443,54.6,57.5,52.0,00000
4.0,47.0,83.0,168,01,01,  Bhora,1283,889,638,365,645,524,59.1,63.6,55.2,00000
4.0,47.0,83.0,168,02,01,  Betmor,859,1193,432,532,427,661,41.9,44.8,39.2,00000
4.0,85.0,11.0,178,01,01,  Uttar Char Duanti,1467,1416,786,655,681,761,50.9,54.5,47.2,00000
4.0,85.0,11.0,178,02,01,  Dakshin Char Duanti,1359,1560,638,828,721,732,46.6,43.5,49.6,00000
4.0,85.0,11.0,433,01,01,  Uttar Hogla Pasha,769,435,398,194,371,241,63.9,67.2,60.6,00000
4.0,85.0,11.0,433,02,01,  Dakshin Hogla Pasha,797,592,373,302,424,290,57.4,55.3,59.4,00000
4.0,85.0,23.0,051,01,01,  Bain Chutki (Part),1147,742,554,329,593,413,60.7,62.7,58.9,00000
4.0,85.0,23.0,051,02,01,  Singrabunia,999,463,467,204,532,259,68.3,69.6,67.3,00000
4.0,85.0,23.0,484,01,01,  Kakchira,1218,506,693,280,525,226,70.6,71.2,69.9,00000
4.0,85.0,23.0,484,02,01,  Kalibari,481,305,243,152,238,153,61.2,61.5,60.9,00000
4.0,85.0,23.0,484,03,01,  Kakchira Binchootki,709,1011,363,495,346,516,41.2,42.3,40.1,00000
4.0,85.0,23.0,484,04,01,  Harirda,390,473,177,275,213,198,45.2,39.2,51.8,00000
4.0,85.0,23.0,484,05,01,  Majerchar,97,212,46,103,51,109,31.4,30.9,31.9,00000
4.0,85.0,23.0,918,01,01,  Rupdon,1291,818,634,367,657,451,61.2,63.3,59.3,00000
4.0,85.0,23.0,918,02,01,  Katakhali,567,404,282,206,285,198,58.4,57.8,59.0,00000
4.0,85.0,23.0,918,03,01,  Jhaliaghata,1779,807,846,355,933,452,68.8,70.4,67.4,00000
4.0,85.0,35.0,535,01,01,  Kupoon,1207,863,589,410,618,453,58.3,59.0,57.7,00000
4.0,85.0,35.0,535,02,01,  Kalipur,681,532,364,240,317,292,56.1,60.3,52.1,00000
4.0,85.0,35.0,535,03,01,  Amratala,646,188,307,92,339,96,77.5,76.9,77.9,00000
4.0,85.0,47.0,510,01,01,  Kalibari,1591,1143,743,548,848,595,58.2,57.6,58.8,00000
4.0,85.0,47.0,510,02,01,  Azizabad,594,315,291,139,303,176,65.3,67.7,63.3,00000
4.0,85.0,59.0,459,01,01,  Uttar Jhan Para,845,505,437,235,408,270,62.6,65.0,60.2,00000
4.0,85.0,59.0,459,02,01,  Purba Jhan Para,1421,620,676,316,745,304,69.6,68.1,71.0,00000
4.0,85.0,59.0,459,03,01,  Dakshin Jhan Para,887,545,428,252,459,293,61.9,62.9,61.0,00000
4.0,85.0,59.0,714,01,01,  Dakshin Manikkhali,532,241,292,109,240,132,68.8,72.8,64.5,00000
4.0,85.0,59.0,714,02,01,  Singrabunia,568,132,281,48,287,84,81.1,85.4,77.4,00000
4.0,85.0,59.0,714,03,01,  Uttar Manikkhali,1044,635,486,322,558,313,62.2,60.1,64.1,00000
4.0,85.0,59.0,765,01,01,  Bara Nachna Para,683,330,343,156,340,174,67.4,68.7,66.1,00000
4.0,85.0,59.0,765,02,01,  Chhota Nachna Para,563,272,281,128,282,144,67.4,68.7,66.2,00000
4.0,85.0,59.0,765,03,01,  Dakshinpurba Nachna Para,719,229,365,98,354,131,75.8,78.8,73.0,00000
4.0,85.0,71.0,025,01,01,  Purba Badurtala,1163,863,571,424,592,439,57.4,57.4,57.4,00000
4.0,85.0,71.0,025,02,01,  Paschim Badurtala,942,559,448,299,494,260,62.8,60.0,65.5,00000
4.0,85.0,83.0,153,01,01,  Betmor,889,553,428,259,461,294,61.7,62.3,61.1,00000
4.0,85.0,83.0,153,02,01,  Satakar,803,374,344,181,459,193,68.2,65.5,70.4,00000
4.0,85.0,83.0,663,01,01,  Lemua,1756,1356,820,675,936,681,56.4,54.8,57.9,00000
4.0,85.0,83.0,663,02,01,  Gulbunia,985,442,457,192,528,250,69.0,70.4,67.9,00000
4.0,85.0,83.0,688,01,01,  Madartali,1120,698,543,318,577,380,61.6,63.1,60.3,00000
4.0,85.0,83.0,688,02,01,  Jamirtala,390,318,182,144,208,174,55.1,55.8,54.5,00000
4.0,85.0,83.0,688,03,01,  Charakkhola,138,265,55,133,83,132,34.2,29.3,38.6,00000
4.0,85.0,83.0,688,04,01,  Karaitala,371,297,156,145,215,152,55.5,51.8,58.6,00000
52.0,2.0,11.0,114,01,01,  Shalmararpar,1599,2635,850,1241,749,1394,37.8,40.7,35.0,00000
52.0,2.0,11.0,114,02,01,  Bhelamari,1652,1636,931,773,721,863,50.2,54.6,45.5,00000
52.0,2.0,11.0,114,03,01,  Falimari,551,597,293,266,258,331,48.0,52.4,43.8,00000
52.0,2.0,11.0,114,04,01,  Bhatitari,335,576,179,257,156,319,36.8,41.1,32.8,00000
52.0,2.0,11.0,114,05,01,  Baksitari,419,489,233,222,186,267,46.1,51.2,41.1,00000
52.0,2.0,11.0,709,01,01,  Paschim Bhelabari,722,819,397,391,325,428,46.9,50.4,43.2,00000
52.0,2.0,11.0,709,02,01,  Namorirpar,939,641,515,266,424,375,59.4,65.9,53.1,00000
52.0,2.0,11.0,888,01,01,  Taluk Dulali,1571,2616,870,1178,701,1438,37.5,42.5,32.8,00000
52.0,2.0,11.0,888,02,01,  Mahishtali,621,939,352,421,269,518,39.8,45.5,34.2,00000
52.0,2.0,11.0,888,03,01,  Jharirjhar,399,422,231,180,168,242,48.6,56.2,41.0,00000
52.0,2.0,41.0,260,01,01,  Kalirhat Chattarpar,1023,1189,570,531,453,658,46.2,51.8,40.8,00000
52.0,2.0,41.0,260,02,01,  Bhitarkuti,534,675,290,300,244,375,44.2,49.2,39.4,00000
52.0,2.0,41.0,260,03,01,  Dawairkuti,351,413,193,180,158,233,45.9,51.7,40.4,00000
52.0,2.0,41.0,260,04,01,  Thagartari,152,243,82,120,70,123,38.5,40.6,36.3,00000
52.0,2.0,41.0,260,05,01,  Bhatiatari,205,500,110,235,95,265,29.1,31.9,26.4,00000
52.0,2.0,41.0,285,01,01,  Dakaduka,490,150,251,61,239,89,76.6,80.4,72.9,00000
52.0,2.0,41.0,285,02,01,  Shah Akatertari,481,356,246,160,235,196,57.5,60.6,54.5,00000
52.0,2.0,41.0,285,03,01,  Majatari,870,540,461,234,409,306,61.7,66.3,57.2,00000
52.0,2.0,41.0,285,04,01,  Dikrir Char,122,285,65,143,57,142,30.0,31.3,28.6,00000
52.0,2.0,41.0,285,05,01,  Kumartari,403,412,210,185,193,227,49.4,53.2,46.0,00000
52.0,2.0,41.0,285,06,01,  Janab Alitari,464,384,243,175,221,209,54.7,58.1,51.4,00000
52.0,2.0,41.0,309,01,01,  Namatari,143,235,65,115,78,120,37.8,36.1,39.4,00000
52.0,2.0,41.0,309,02,01,  Maja Para,1477,1049,743,482,734,567,58.5,60.7,56.4,00000
52.0,2.0,41.0,309,03,01,  Dakshintari,190,229,90,100,100,129,45.3,47.4,43.7,00000
52.0,2.0,41.0,309,04,01,  Chauratari,345,426,174,197,171,229,44.7,46.9,42.8,00000
52.0,2.0,41.0,309,05,01,  S.Haq Pramanikertari,889,749,461,361,428,388,54.3,56.1,52.5,00000
52.0,2.0,41.0,309,06,01,  Charaltari,414,415,232,176,182,239,49.9,56.9,43.2,00000
52.0,2.0,41.0,318,01,01,  Munshitari,247,110,133,39,114,71,69.2,77.3,61.6,00000
52.0,2.0,41.0,318,02,01,  Duhnamarpar,251,168,123,80,128,88,59.9,60.6,59.3,00000
52.0,2.0,41.0,318,03,01,  Guitari,172,166,87,78,85,88,50.9,52.7,49.1,00000
52.0,2.0,41.0,318,04,01,  Basintari,410,285,219,117,191,168,59.0,65.2,53.2,00000
52.0,2.0,41.0,318,05,01,  Baharditari,147,180,84,75,63,105,45.0,52.8,37.5,00000
52.0,2.0,41.0,318,06,01,  Mambertari,178,133,99,51,79,82,57.2,66.0,49.1,00000
52.0,2.0,41.0,318,07,01,  Bata Para,389,522,208,237,181,285,42.7,46.7,38.8,00000
52.0,2.0,41.0,994,01,01,  Kaimari,301,463,169,209,132,254,39.4,44.7,34.2,00000
52.0,2.0,41.0,994,02,01,  Shatiabarihat,1345,926,734,419,611,507,59.2,63.7,54.7,00000
52.0,2.0,41.0,994,03,01,  Chaurarpar,273,153,145,70,128,83,64.1,67.4,60.7,00000
52.0,2.0,41.0,994,04,01,  Posarartari,393,411,192,171,201,240,48.9,52.9,45.6,00000
52.0,2.0,41.0,994,05,01,  Karam Alitari,265,164,124,71,141,93,61.8,63.6,60.3,00000
52.0,2.0,71.0,065,01,01,  Sardar Para,515,442,259,189,256,253,53.8,57.8,50.3,00000
52.0,2.0,71.0,065,02,01,  Goal Tari,854,973,453,444,401,529,46.7,50.5,43.1,00000
52.0,2.0,71.0,065,03,01,  Mahiskhocha Hater,1338,2619,681,1193,657,1426,33.8,36.3,31.5,00000
52.0,2.0,71.0,228,01,01,  Balatari,152,200,89,89,63,111,43.2,50.0,36.2,00000
52.0,2.0,71.0,228,02,01,  Kutirpar,347,419,194,183,153,236,45.3,51.5,39.3,00000
52.0,2.0,71.0,228,03,01,  Shingimari,239,786,116,378,123,408,23.3,23.5,23.2,00000
52.0,2.0,71.0,228,04,01,  Rajabtari,827,1001,471,447,356,554,45.2,51.3,39.1,00000
52.0,2.0,71.0,228,05,01,  Brammuttar,726,596,394,257,332,339,54.9,60.5,49.5,00000
52.0,2.0,71.0,228,06,01,  Rasultari,207,173,102,77,105,96,54.5,57.0,52.2,00000
52.0,2.0,71.0,342,01,01,  Ismail Para,72,256,44,124,28,132,22.0,26.2,17.5,00000
52.0,2.0,71.0,342,02,01,  Gobardhan,298,956,163,434,135,522,23.8,27.3,20.5,00000
52.0,2.0,71.0,342,03,01,  Gurati Para,52,83,29,44,23,39,38.5,39.7,37.1,00000
52.0,2.0,71.0,342,04,01,  Uttarpara,235,737,127,334,108,403,24.2,27.5,21.1,00000
52.0,2.0,71.0,611,01,01,  Kachhumura,462,826,245,394,217,432,35.9,38.3,33.4,00000
52.0,2.0,71.0,611,02,01,  Kamar Para,339,490,186,227,153,263,40.9,45.0,36.8,00000
52.0,2.0,71.0,611,03,01,  Balatari,159,267,76,120,83,147,37.3,38.8,36.1,00000
52.0,2.0,71.0,611,04,01,  Rasultari,226,239,129,106,97,133,48.6,54.9,42.2,00000
52.0,2.0,71.0,611,05,01,  Khamar Para,401,503,238,232,163,271,44.4,50.6,37.6,00000
52.0,2.0,77.0,595,01,01,  Madanpur,2345,3000,1316,1417,1029,1583,43.9,48.2,39.4,00000
52.0,2.0,77.0,595,02,01,  Mollah Para,774,696,418,341,356,355,52.7,55.1,50.1,00000
52.0,33.0,74.0,884,01,01,  Thengjhara,1019,1494,501,731,518,763,40.5,40.7,40.4,00000
52.0,33.0,74.0,884,02,01,  Char Thengjhara,507,1015,272,505,235,510,33.3,35.0,31.5,00000
52.0,33.0,76.0,315,01,01,  Dakshin Dhubni,444,974,245,465,199,509,31.3,34.5,28.1,00000
52.0,33.0,76.0,315,02,01,  Dhubni,1540,2007,815,928,725,1079,43.4,46.8,40.2,00000
52.0,39.0,35.0,244,01,01,  Barantar,445,578,236,263,209,315,43.5,47.3,39.9,00000
52.0,39.0,35.0,244,02,01,  Pashuram Para,1129,1424,612,679,517,745,44.2,47.4,41.0,00000
52.0,39.0,35.0,244,03,01,  Dakshin Dalagram,1266,1259,659,583,607,676,50.1,53.1,47.3,00000
52.0,39.0,35.0,848,01,01,  Sreekhata,1775,2313,908,1053,867,1260,43.4,46.3,40.8,00000
52.0,39.0,35.0,848,02,01,  Khodar Para,457,782,245,378,212,404,36.9,39.3,34.4,00000
52.0,39.0,35.0,848,03,01,  Napit Para,458,516,249,219,209,297,47.0,53.2,41.3,00000
52.0,39.0,35.0,848,04,01,  Bhala Para,312,275,162,137,150,138,53.2,54.2,52.1,00000
52.0,39.0,35.0,905,01,01,  Putimari,293,390,139,175,154,215,42.9,44.3,41.7,00000
52.0,39.0,35.0,905,02,01,  Bhitarkuti,108,316,55,149,53,167,25.5,27.0,24.1,00000
52.0,39.0,35.0,978,01,01,  Patwartari,1033,1060,540,491,493,569,49.4,52.4,46.4,00000
52.0,39.0,35.0,978,02,01,  Jambari,987,872,519,418,468,454,53.1,55.4,50.8,00000
52.0,39.0,35.0,978,03,01,  Barantari,238,213,127,86,111,127,52.8,59.6,46.6,00000
52.0,39.0,35.0,978,04,01,  Chamnarpar,893,1072,470,502,423,570,45.4,48.4,42.6,00000
52.0,39.0,53.0,350,01,01,  Uttar Gopal Roy,873,1110,460,545,413,565,44.0,45.8,42.2,00000
52.0,39.0,53.0,350,02,01,  Madhya Gopal Roy,1511,934,776,418,735,516,61.8,65.0,58.8,00000
52.0,39.0,53.0,350,03,01,  Dakhin Gopal Roy,846,1016,447,482,399,534,45.4,48.1,42.8,00000
52.0,39.0,65.0,160,01,01,  Khamat Para,366,389,189,176,177,213,48.5,51.8,45.4,00000
52.0,39.0,65.0,160,02,01,  Gandarpar,441,366,224,166,217,200,54.6,57.4,52.0,00000
52.0,39.0,65.0,160,03,01,  Dalal Para,235,513,120,233,115,280,31.4,34.0,29.1,00000
52.0,39.0,65.0,160,04,01,  Baman Tari,217,287,113,127,104,160,43.1,47.1,39.4,00000
52.0,39.0,65.0,160,05,01,  Kalikapur,329,357,182,146,147,211,48.0,55.5,41.1,00000
52.0,39.0,65.0,399,01,01,  Kaitari,813,945,417,451,396,494,46.2,48.0,44.5,00000
52.0,39.0,65.0,399,02,01,  Chang Tari,393,627,220,292,173,335,38.5,43.0,34.1,00000
52.0,39.0,65.0,456,01,01,  Khalisha Madadi,170,229,92,103,78,126,42.6,47.2,38.2,00000
52.0,39.0,65.0,456,02,01,  Jhar Para,842,743,450,357,392,386,53.1,55.8,50.4,00000
52.0,39.0,65.0,774,01,01,  Baburdanga,562,589,285,262,277,327,48.8,52.1,45.9,00000
52.0,39.0,65.0,774,02,01,  Roy Barirdanga,1154,1493,581,687,573,806,43.6,45.8,41.6,00000
52.0,39.0,65.0,774,03,01,  Mangalerdanga,589,709,276,320,313,389,45.4,46.3,44.6,00000
52.0,39.0,65.0,774,04,01,  Jambari,236,506,124,251,112,255,31.8,33.1,30.5,00000
52.0,39.0,65.0,774,05,01,  Sardartari,834,873,444,402,390,471,48.9,52.5,45.3,00000
52.0,39.0,65.0,774,06,01,  Dola Para,335,213,175,94,160,119,61.1,65.1,57.3,00000
52.0,39.0,65.0,921,01,01,  Refeuji Para,438,495,222,218,216,277,46.9,50.5,43.8,00000
52.0,39.0,65.0,921,02,01,  Bhitarkuti,561,776,299,360,262,416,42.0,45.4,38.6,00000
52.0,39.0,65.0,921,03,01,  Nadibhangatari,336,497,164,215,172,282,40.3,43.3,37.9,00000
52.0,39.0,65.0,952,01,01,  Gaglarpar,539,874,286,427,253,447,38.1,40.1,36.1,00000
52.0,39.0,65.0,952,02,01,  Tapardanga,565,897,290,449,275,448,38.6,39.2,38.0,00000
52.0,39.0,65.0,952,03,01,  Rabirgour,790,1006,406,500,384,506,44.0,44.8,43.1,00000
52.0,39.0,65.0,952,04,01,  Gutirgour,806,616,419,289,387,327,56.7,59.2,54.2,00000
52.0,39.0,65.0,952,05,01,  Kagaji Para,636,889,331,430,305,459,41.7,43.5,39.9,00000
52.0,55.0,20.0,093,01,01,  Bara Basuria,331,953,166,456,165,497,25.8,26.7,24.9,00000
52.0,55.0,20.0,093,02,01,  Dakhin Basuria,222,527,138,239,84,288,29.6,36.6,22.6,00000
52.0,55.0,20.0,516,01,01,  Khedabagh,998,564,512,238,486,326,63.9,68.3,59.9,00000
52.0,55.0,20.0,516,02,01,  Fakir Para,340,309,181,144,159,165,52.4,55.7,49.1,00000
52.0,55.0,20.0,516,03,01,  Purba Khedabagh,363,250,184,113,179,137,59.2,62.0,56.6,00000
52.0,55.0,20.0,516,04,01,  Sardar Para,264,201,151,79,113,122,56.8,65.7,48.1,00000
52.0,55.0,20.0,549,01,01,  Kismat Bidyabagis,168,287,86,136,82,151,36.9,38.7,35.2,00000
52.0,55.0,20.0,549,02,01,  Pangular Para,445,270,231,111,214,159,62.2,67.5,57.4,00000
52.0,55.0,20.0,912,01,01,  Uttar Shibram,505,366,256,169,249,197,58.0,60.2,55.8,00000
52.0,55.0,20.0,912,02,01,  Shibram,303,458,159,224,144,234,39.8,41.5,38.1,00000
52.0,55.0,20.0,912,03,01,  Dhakin Shibram,674,744,349,371,325,373,47.5,48.5,46.6,00000
52.0,55.0,36.0,252,01,01,  Kurepar,493,709,279,347,214,362,41.0,44.6,37.2,00000
52.0,55.0,36.0,252,02,01,  Janerpar,449,465,248,209,201,256,49.1,54.3,44.0,00000
52.0,55.0,36.0,252,03,01,  Azaher Ullahtari,461,431,249,199,212,232,51.7,55.6,47.7,00000
52.0,55.0,36.0,302,01,01,  Khandakar Para,500,184,259,76,241,108,73.1,77.3,69.1,00000
52.0,55.0,36.0,302,02,01,  Fakirtari,576,365,300,167,276,198,61.2,64.2,58.2,00000
52.0,55.0,36.0,401,01,01,  Sahidartari,886,961,490,436,396,525,48.0,52.9,43.0,00000
52.0,55.0,36.0,401,02,01,  Kopar Dartari,272,603,163,273,109,330,31.1,37.4,24.8,00000
52.0,55.0,36.0,401,03,01,  Gafurertari,155,282,88,130,67,152,35.5,40.4,30.6,00000
52.0,55.0,36.0,401,04,01,  Exral Para,190,273,117,117,73,156,41.0,50.0,31.9,00000
52.0,55.0,36.0,560,01,01,  Kumartari,307,550,177,251,130,299,35.8,41.4,30.3,00000
52.0,55.0,36.0,560,02,01,  Shah Para,204,623,111,313,93,310,24.7,26.2,23.1,00000
52.0,55.0,36.0,577,01,01,  Dolabari,319,437,148,232,171,205,42.2,38.9,45.5,00000
52.0,55.0,36.0,577,02,01,  Ajittari,245,547,161,262,84,285,30.9,38.1,22.8,00000
52.0,55.0,36.0,577,03,01,  Madrasarak,303,407,152,192,151,215,42.7,44.2,41.3,00000
52.0,55.0,36.0,577,04,01,  Paikertari,180,219,95,93,85,126,45.1,50.5,40.3,00000
52.0,55.0,36.0,725,01,01,  Balatari,209,228,103,110,106,118,47.8,48.4,47.3,00000
52.0,55.0,36.0,725,02,01,  Malitari,129,253,73,120,56,133,33.8,37.8,29.6,00000
52.0,55.0,36.0,725,03,01,  Kani Para,297,595,146,292,151,303,33.3,33.3,33.3,00000
52.0,55.0,36.0,962,01,01,  Hagratari,298,553,160,245,138,308,35.0,39.5,30.9,00000
52.0,55.0,36.0,962,02,01,  Nadirpar,387,531,224,253,163,278,42.2,47.0,37.0,00000
52.0,55.0,36.0,962,03,01,  Khamartari,222,77,118,29,104,48,74.2,80.3,68.4,00000
52.0,55.0,36.0,962,04,01,  Barantar,158,305,95,144,63,161,34.1,39.7,28.1,00000
52.0,55.0,36.0,962,05,01,  Bamantari,340,549,185,258,155,291,38.2,41.8,34.8,00000
52.0,55.0,43.0,384,01,01,  Purba Harinchhara,232,1750,152,894,80,856,11.7,14.5,8.5,00000
52.0,55.0,43.0,384,02,01,  Paschim Harinchhara,557,3423,350,1750,207,1673,14.0,16.7,11.0,00000
52.0,55.0,43.0,434,01,01,  Bagdora,542,864,290,379,252,485,38.5,43.3,34.2,00000
52.0,55.0,43.0,434,02,01,  Baniatara,802,1500,424,713,378,787,34.8,37.3,32.4,00000
52.0,55.0,43.0,434,03,01,  Gudamerchoura (Ananda Bazar),658,1158,364,558,294,600,36.2,39.5,32.9,00000
52.0,55.0,43.0,434,04,01,  Kalamati,792,1620,417,784,375,836,32.8,34.7,31.0,00000
52.0,55.0,43.0,434,05,01,  Chongadara,496,1181,287,547,209,634,29.6,34.4,24.8,00000
52.0,55.0,43.0,544,01,01,  Shekh Para,651,967,357,407,294,560,40.2,46.7,34.4,00000
52.0,55.0,43.0,544,02,01,  Kamar Para,278,468,156,196,122,272,37.3,44.3,31.0,00000
52.0,55.0,43.0,544,03,01,  Chekna Para,318,910,177,444,141,466,25.9,28.5,23.2,00000
52.0,55.0,43.0,544,04,01,  Panati Para,323,539,183,245,140,294,37.5,42.8,32.3,00000
52.0,55.0,43.0,544,05,01,  Chaora Para,60,689,32,349,28,340,8.0,8.4,7.6,00000
52.0,55.0,43.0,544,06,01,  Purba Para,404,604,235,279,169,325,40.1,45.7,34.2,00000
52.0,55.0,51.0,071,01,01,  Banagram,861,1531,499,690,362,841,36.0,42.0,30.1,00000
52.0,55.0,51.0,071,02,01,  Dhekirchar,87,155,41,81,46,74,36.0,33.6,38.3,00000
52.0,55.0,51.0,071,03,01,  Shiberkuti,1174,1884,664,824,510,1060,38.4,44.6,32.5,00000
52.0,55.0,51.0,109,01,01,  Paschim Barua,759,214,413,76,346,138,78.0,84.5,71.5,00000
52.0,55.0,51.0,109,02,01,  Purba Barua,414,578,208,271,206,307,41.7,43.4,40.2,00000
52.0,55.0,51.0,511,01,01,  Khatamari,835,855,472,372,363,483,49.4,55.9,42.9,00000
52.0,55.0,51.0,511,02,01,  Char Khatamari,526,1211,272,588,254,623,30.3,31.6,29.0,00000
52.0,55.0,51.0,621,01,01,  Kulaghat,964,1078,537,474,427,604,47.2,53.1,41.4,00000
52.0,55.0,51.0,621,02,01,  Medurkuti,359,491,206,234,153,257,42.2,46.8,37.3,00000
52.0,55.0,51.0,621,03,01,  Kulaghat Char,219,908,141,442,78,466,19.4,24.2,14.3,00000
52.0,55.0,73.0,318,01,01,  Gobai,287,469,151,226,136,243,38.0,40.1,35.9,00000
52.0,55.0,73.0,318,02,01,  Kachurtary,129,288,68,148,61,140,30.9,31.5,30.3,00000
52.0,55.0,73.0,368,01,01,  Haribhanga,2141,1493,1234,695,907,798,58.9,64.0,53.2,00000
52.0,55.0,73.0,368,02,01,  Pachim Haribhanga,367,391,189,187,178,204,48.4,50.3,46.6,00000
52.0,55.0,73.0,368,03,01,  Dhakhin Haribhanga,156,382,97,174,59,208,29.0,35.8,22.1,00000
52.0,55.0,73.0,456,01,01,  Kashipur,337,543,182,276,155,267,38.3,39.7,36.7,00000
52.0,55.0,73.0,456,02,01,  Silakhana,205,153,108,78,97,75,57.3,58.1,56.4,00000
52.0,55.0,73.0,456,03,01,  Purba Kashipur,370,284,186,135,184,149,56.6,57.9,55.3,00000
52.0,55.0,73.0,456,04,01,  Dakhin Kashipur,176,316,107,154,69,162,35.8,41.0,29.9,00000
52.0,55.0,73.0,456,05,01,  Shahebpara,200,251,117,107,83,144,44.3,52.2,36.6,00000
52.0,55.0,73.0,566,01,01,  Kismat Dhadhagachh,678,865,355,417,323,448,43.9,46.0,41.9,00000
52.0,55.0,73.0,566,02,01,  Debdabi,297,521,157,252,140,269,36.3,38.4,34.2,00000
52.0,55.0,73.0,714,01,01,  Naodabas,579,742,302,370,277,372,43.8,44.9,42.7,00000
52.0,55.0,73.0,714,02,01,  Dhakhin Naodabas,284,410,151,179,133,231,40.9,45.8,36.5,00000
52.0,55.0,94.0,478,01,01,  Pramanik Para,41,419,25,221,16,198,8.9,10.2,7.5,00000
52.0,55.0,94.0,478,02,01,  Char Khalaighat,141,1219,87,622,54,597,10.4,12.3,8.3,00000
52.0,55.0,94.0,824,01,01,  Dola Para,142,377,82,171,60,206,27.4,32.4,22.6,00000
52.0,55.0,94.0,824,02,01,  Bala Para,271,207,168,70,103,137,56.7,70.6,42.9,00000
52.0,55.0,94.0,824,03,01,  Bhatitari,298,429,178,173,120,256,41.0,50.7,31.9,00000
52.0,55.0,94.0,824,04,01,  Patwaritari,139,194,73,86,66,108,41.7,45.9,37.9,00000
52.0,55.0,94.0,824,05,01,  Deben Baburtari,283,422,161,172,122,250,40.1,48.3,32.8,00000
52.0,55.0,94.0,824,06,01,  Maja Para,1053,1454,618,648,435,806,42.0,48.8,35.1,00000
52.0,55.0,94.0,824,07,01,  Chandimari,161,264,85,110,76,154,37.9,43.6,33.0,00000
52.0,55.0,94.0,951,01,01,  Sarkartari,284,593,167,274,117,319,32.4,37.9,26.8,00000
52.0,55.0,94.0,951,02,01,  Takhurtari,189,326,107,155,82,171,36.7,40.8,32.4,00000
52.0,70.0,13.0,530,01,01,  Hosenabad,1559,1826,799,900,760,926,46.1,47.0,45.1,00000
52.0,70.0,13.0,570,01,01,  Jamgram,3799,4060,1939,1955,1860,2105,48.3,49.8,46.9,00000
52.0,70.0,13.0,756,01,01,  Nabinagar (Baura),3282,3758,1718,1775,1564,1983,46.6,49.2,44.1,00000
52.0,70.0,13.0,756,02,01,  Shibram,1073,1756,534,881,539,875,37.9,37.7,38.1,00000
52.0,70.0,13.0,928,01,01,  Rasulpur,1267,1098,673,512,594,586,53.6,56.8,50.3,00000
52.0,70.0,15.0,053,01,01,  Bamandal,570,389,298,174,272,215,59.4,63.1,55.9,00000
52.0,70.0,15.0,119,01,01,  Burimari,2069,2112,1172,1003,897,1109,49.5,53.9,44.7,00000
52.0,70.0,15.0,285,01,01,  Dakshin Islampur,1578,1968,908,968,670,1000,44.5,48.4,40.1,00000
52.0,70.0,15.0,994,01,01,  Upharmara,4822,6745,2584,3257,2238,3488,41.7,44.2,39.1,00000
52.0,70.0,19.0,013,01,01,  Angarpota,727,1314,436,625,291,689,35.6,41.1,29.7,00000
52.0,70.0,19.0,424,01,01,  Dahagram,2052,3738,1119,1796,933,1942,35.4,38.4,32.5,00000
52.0,70.0,27.0,066,01,01,  Banglabari,615,574,317,306,298,268,51.7,50.9,52.7,00000
52.0,70.0,27.0,092,01,01,  Bhandardaha,1600,1899,863,936,737,963,45.7,48.0,43.4,00000
52.0,70.0,27.0,106,01,01,  Bhothatkhata,349,647,177,319,172,328,35.0,35.7,34.4,00000
52.0,70.0,27.0,477,01,01,  Dharakanta,271,164,153,70,118,94,62.3,68.6,55.7,00000
52.0,70.0,27.0,623,01,01,  Jote Santiram,213,135,115,67,98,68,61.2,63.2,59.0,00000
52.0,70.0,27.0,742,01,01,  Mohammadpur,1653,2621,881,1256,772,1365,38.7,41.2,36.1,00000
52.0,70.0,27.0,782,01,01,  Nazir Gumani,233,459,125,225,108,234,33.7,35.7,31.6,00000
52.0,70.0,27.0,795,01,01,  Pachabhandar,264,457,136,238,128,219,36.6,36.4,36.9,00000
52.0,70.0,27.0,822,01,01,  Paschim Jagatber,3390,4054,1808,1879,1582,2175,45.5,49.0,42.1,00000
52.0,70.0,27.0,849,01,01,  Purba Jagatber,1567,1868,824,909,743,959,45.6,47.5,43.7,00000
52.0,70.0,40.0,437,01,01,  Dhabalguri,2876,2073,1486,1011,1390,1062,58.1,59.5,56.7,00000
52.0,70.0,40.0,517,01,01,  Guru Para,294,547,163,258,131,289,35.0,38.7,31.2,00000
52.0,70.0,40.0,543,01,01,  Islamabad (Islamnagar),1521,1820,813,839,708,981,45.5,49.2,41.9,00000
52.0,70.0,40.0,596,01,01,  Jongra,2908,3108,1582,1502,1326,1606,48.3,51.3,45.2,00000
52.0,70.0,40.0,636,01,01,  Kharija Jongra,1035,1123,536,554,499,569,48.0,49.2,46.7,00000
52.0,70.0,40.0,676,01,01,  Kokoabari,146,117,73,56,73,61,55.5,56.6,54.5,00000
52.0,70.0,40.0,716,01,01,  Maminpur,1627,1802,867,872,760,930,47.4,49.9,45.0,00000
52.0,70.0,40.0,902,01,01,  Ramkanta,247,432,134,191,113,241,36.4,41.2,31.9,00000
52.0,70.0,54.0,689,01,01,  Kuchlibari,1968,3058,982,1538,986,1520,39.2,39.0,39.3,00000
52.0,70.0,54.0,809,01,01,  Panbari,2853,3869,1488,1893,1365,1976,42.4,44.0,40.9,00000
52.0,70.0,54.0,941,01,01,  Samserpur,798,1771,423,879,375,892,31.1,32.5,29.6,00000
52.0,70.0,67.0,079,01,01,  Bengkanda,1858,1703,969,844,889,859,52.2,53.4,50.9,00000
52.0,70.0,67.0,451,01,01,  Dhabalsati,1305,2032,678,1014,627,1018,39.1,40.1,38.1,00000
77.0,4.0,40.0,848,01,01,  Malgoba,212,178,120,68,92,110,54.4,63.8,45.5,00000
77.0,4.0,40.0,848,02,01,  Rajagaon,607,507,324,212,283,295,54.5,60.4,49.0,00000
77.0,4.0,81.0,962,01,01,  Uttar Taria,1372,1543,729,693,643,850,47.1,51.3,43.1,00000
77.0,4.0,81.0,962,02,01,  Dakshin Taria,677,708,327,322,350,386,48.9,50.4,47.6,00000
77.0,4.0,81.0,962,03,01,  Paschim Taria,490,490,248,218,242,272,50.0,53.2,47.1,00000
77.0,25.0,14.0,244,01,01,  Pradhan Para,555,637,293,317,262,320,46.6,48.0,45.0,00000
77.0,25.0,14.0,244,02,01,  Bhelartal (Goul Para),339,370,161,187,178,183,47.8,46.3,49.3,00000
77.0,25.0,14.0,250,01,01,  Malai Pukuri,281,201,139,101,142,100,58.3,57.9,58.7,00000
77.0,25.0,14.0,250,02,01,  Dhakrahat,113,276,52,150,61,126,29.0,25.7,32.6,00000
77.0,25.0,14.0,250,03,01,  Chowdhury Para,205,199,100,97,105,102,50.7,50.8,50.7,00000
77.0,25.0,14.0,250,04,01,  Benghari Margerddu,1715,1108,878,552,837,556,60.8,61.4,60.1,00000
77.0,25.0,14.0,943,01,01,  Jharjharia Para,704,671,388,322,316,349,51.2,54.6,47.5,00000
77.0,25.0,14.0,943,03,01,  Subha Boalmari,157,180,88,84,69,96,46.6,51.2,41.8,00000
77.0,25.0,21.0,306,01,01,  Prashadkhoa,149,193,83,93,66,100,43.6,47.2,39.8,00000
77.0,25.0,21.0,306,02,01,  Daksha Para,386,433,205,195,181,238,47.1,51.3,43.2,00000
77.0,25.0,21.0,397,01,01,  Danga Para,491,410,255,173,236,237,54.5,59.6,49.9,00000
77.0,25.0,21.0,397,02,01,  Sutar Para,166,235,103,115,63,120,41.4,47.2,34.4,00000
77.0,25.0,21.0,397,03,01,  Tita Para (Part),236,188,123,73,113,115,55.7,62.8,49.6,00000
77.0,25.0,21.0,397,04,01,  Sankai Para,327,347,168,155,159,192,48.5,52.0,45.3,00000
77.0,25.0,21.0,477,01,01,  Bhallai Para,214,36,110,16,104,20,85.6,87.3,83.9,00000
77.0,25.0,21.0,477,02,01,  Titu Para (Part),268,35,152,13,116,22,88.4,92.1,84.1,00000
77.0,25.0,21.0,540,01,01,  Kantamani,933,769,502,334,431,435,54.8,60.0,49.8,00000
77.0,25.0,21.0,540,02,01,  Basdanga,373,263,202,124,171,139,58.6,62.0,55.2,00000
77.0,25.0,21.0,670,01,01,  Banghari,210,151,104,79,106,72,58.2,56.8,59.6,00000
77.0,25.0,21.0,670,02,01,  Fakirpara (Purba),281,119,160,52,121,67,70.3,75.5,64.4,00000
77.0,25.0,29.0,267,01,01,  Munshi Para,864,1015,433,475,431,540,46.0,47.7,44.4,00000
77.0,25.0,29.0,267,02,01,  Bania Para,739,1232,385,603,354,629,37.5,39.0,36.0,00000
77.0,25.0,29.0,267,03,01,  Jorepakhuri,379,353,188,178,191,175,51.8,51.4,52.2,00000
77.0,25.0,29.0,574,01,01,  Kumar Para,716,597,394,286,322,311,54.5,57.9,50.9,00000
77.0,25.0,29.0,574,02,01,  Mathua Para,863,1450,469,670,394,780,37.3,41.2,33.6,00000
77.0,25.0,29.0,574,03,01,  Khalifapur,265,497,134,226,131,271,34.8,37.2,32.6,00000
77.0,25.0,29.0,574,04,01,  Balaramhat Sardar Para,640,613,337,281,303,332,51.1,54.5,47.7,00000
77.0,25.0,29.0,938,01,01,  Barogoria,290,413,149,202,141,211,41.3,42.5,40.1,00000
77.0,25.0,29.0,938,02,01,  Shikarpur Kazi Para,310,519,148,263,162,256,37.4,36.0,38.8,00000
77.0,25.0,29.0,938,03,01,  Shakharia Para,286,478,174,218,112,260,37.4,44.4,30.1,00000
77.0,25.0,29.0,938,04,01,  Sikerpur Prodhan Para,301,246,172,114,129,132,55.0,60.1,49.4,00000
77.0,25.0,51.0,062,01,01,  Cheakuti,178,154,88,69,90,85,53.6,56.1,51.4,00000
77.0,25.0,51.0,062,02,01,  Kismat Bahadurnaray,496,631,267,308,229,323,44.0,46.4,41.5,00000
77.0,25.0,51.0,079,01,01,  Langalgram,190,155,102,67,88,88,55.1,60.4,50.0,00000
77.0,25.0,51.0,079,02,01,  Uttar Langalgram,404,477,220,210,184,267,45.9,51.2,40.8,00000
77.0,25.0,51.0,426,01,01,  Chandanbari,410,262,219,113,191,149,61.0,66.0,56.2,00000
77.0,25.0,51.0,426,02,01,  Sarkar Para,246,143,125,68,121,75,63.2,64.8,61.7,00000
77.0,25.0,51.0,426,03,01,  Barua Para,550,268,299,97,251,171,67.2,75.5,59.5,00000
77.0,25.0,51.0,579,01,01,  Shalshiri,403,428,215,201,188,227,48.5,51.7,45.3,00000
77.0,25.0,51.0,579,02,01,  Makoari Para,135,207,73,93,62,114,39.5,44.0,35.2,00000
77.0,25.0,51.0,579,03,01,  Kamarpara,190,199,115,92,75,107,48.8,55.6,41.2,00000
77.0,25.0,51.0,613,01,01,  Bhera Para Neshikanta(,629,515,346,226,283,289,55.0,60.5,49.5,00000
77.0,25.0,51.0,613,02,01,  Sankedhar Para,250,276,133,126,117,150,47.5,51.4,43.8,00000
77.0,25.0,51.0,648,01,01,  Motapara Kismat B.Nary,250,362,145,170,105,192,40.8,46.0,35.4,00000
77.0,25.0,51.0,648,02,01,  Kismat Bahadurnarayani,138,330,84,163,54,167,29.5,34.0,24.4,00000
77.0,25.0,58.0,193,01,01,  Banagram,783,1108,421,521,362,587,41.4,44.7,38.1,00000
77.0,25.0,58.0,193,02,01,  Jhakua Para,461,505,228,253,233,252,47.7,47.4,48.0,00000
77.0,25.0,58.0,358,01,01,  Denakata,427,337,214,169,213,168,55.9,55.9,55.9,00000
77.0,25.0,58.0,358,02,01,  Paida Para,463,578,251,281,212,297,44.5,47.2,41.7,00000
77.0,25.0,58.0,358,03,01,  Kaliganj,348,371,184,174,164,197,48.4,51.4,45.4,00000
77.0,25.0,58.0,514,01,01,  Laharipar,581,509,274,255,307,254,53.3,51.8,54.7,00000
77.0,25.0,58.0,514,02,01,  Damarhat,444,386,217,179,227,207,53.5,54.8,52.3,00000
77.0,25.0,58.0,960,01,01,  Amtala Kazi Para,483,303,248,139,235,164,61.5,64.1,58.9,00000
77.0,25.0,58.0,960,02,01,  Utkura,725,1409,365,718,360,691,34.0,33.7,34.3,00000
77.0,25.0,80.0,631,01,01,  Kharija Marea,230,282,120,137,110,145,44.9,46.7,43.1,00000
77.0,25.0,80.0,631,02,01,  Gadi Para,150,195,90,85,60,110,43.5,51.4,35.3,00000
77.0,25.0,80.0,631,03,01,  Hari Pukuri,56,316,29,159,27,157,15.1,15.4,14.7,00000
77.0,25.0,80.0,631,04,01,  Pradhanpara,15,35,12,31,11,45,15.1,15.4,14.7,00000
77.0,25.0,80.0,710,01,01,  Fakir Para,176,322,89,161,87,161,35.3,35.6,35.1,00000
77.0,25.0,80.0,710,02,01,  Goal Para,517,279,280,123,237,156,64.9,69.5,60.3,00000
77.0,25.0,80.0,710,03,01,  Marea Colony,478,868,273,406,205,462,35.5,40.2,30.7,00000
77.0,25.0,80.0,710,04,01,  Janglipir,251,274,136,130,115,144,47.8,51.1,44.4,00000
77.0,25.0,80.0,716,01,01,  Majhialipara,344,494,182,242,162,252,41.1,42.9,39.1,00000
77.0,25.0,80.0,716,02,01,  Nutan Basti,422,684,209,324,213,360,38.2,39.2,37.2,00000
77.0,25.0,80.0,716,03,01,  Baman Para,729,617,397,289,332,328,54.2,57.9,50.3,00000
77.0,25.0,80.0,716,04,01,  Kamal Pukuri,224,213,123,98,101,115,51.3,55.7,46.8,00000
77.0,25.0,80.0,716,05,01,  Sardar Para,477,673,248,325,229,348,41.5,43.3,39.7,00000
77.0,25.0,80.0,716,06,01,  Danga Para,333,408,182,187,151,221,44.9,49.3,40.6,00000
77.0,25.0,80.0,716,07,01,  Sarkar Para,247,444,128,226,119,218,35.7,36.2,35.3,00000
77.0,25.0,80.0,750,01,01,  Bamanhat,370,284,206,124,164,160,56.6,62.4,50.6,00000
77.0,25.0,80.0,750,02,01,  Muslimpur,251,132,133,61,118,71,65.5,68.6,62.4,00000
77.0,25.0,80.0,858,01,01,  Sarkar Para,145,275,70,130,75,145,34.5,35.0,34.1,00000
77.0,25.0,80.0,858,02,01,  Boalmari,155,211,89,107,66,104,42.3,45.4,38.8,00000
77.0,25.0,80.0,869,01,01,  Rahmat Pur,466,316,266,136,200,180,59.6,66.2,52.6,00000
77.0,25.0,80.0,869,02,01,  Paik Para,249,163,138,67,111,96,60.4,67.3,53.6,00000
77.0,25.0,80.0,955,01,01,  Jogir Para,570,482,310,211,260,271,54.2,59.5,49.0,00000
77.0,25.0,80.0,955,02,01,  Nandapara,226,192,133,79,93,113,54.1,62.7,45.1,00000
77.0,25.0,80.0,955,03,01,  Kahar Para,120,282,69,134,51,148,29.9,34.0,25.6,00000
77.0,25.0,80.0,955,04,01,  Hari Pukury,181,204,94,90,87,114,47.0,51.1,43.3,00000
77.0,25.0,87.0,153,01,01,  Mashan Para,248,441,145,212,103,229,36.0,40.6,31.0,00000
77.0,25.0,87.0,153,02,01,  Pradhad Para,496,193,248,86,248,107,72.0,74.3,69.9,00000
77.0,25.0,87.0,153,03,01,  Panchpir,293,237,157,104,136,133,55.3,60.2,50.6,00000
77.0,25.0,87.0,153,04,01,  Kauni Khaua Para,408,727,214,353,194,374,35.9,37.7,34.2,00000
77.0,25.0,87.0,153,05,01,  Kali Bari,733,366,380,154,353,212,66.7,71.2,62.5,00000
77.0,25.0,87.0,153,06,01,  Chowdhury Para,215,174,112,83,103,91,55.3,57.4,53.1,00000
77.0,25.0,87.0,153,07,01,  Harinimai Para,278,390,150,191,128,199,41.6,44.0,39.1,00000
77.0,25.0,87.0,153,08,01,  Kaikuri Para,139,357,77,165,62,192,28.0,31.8,24.4,00000
77.0,25.0,87.0,153,09,01,  Bairati Sener Para,312,357,171,155,141,202,46.6,52.5,41.1,00000
77.0,25.0,87.0,164,01,01,  Amzani Para,707,389,373,172,334,217,64.5,68.4,60.6,00000
77.0,25.0,87.0,164,02,01,  Bakpur,596,649,329,297,267,352,47.9,52.6,43.1,00000
77.0,25.0,87.0,557,01,01,  Aousdanga,244,77,124,35,120,42,76.0,78.0,74.1,00000
77.0,25.0,87.0,557,02,01,  Pathan Para,1036,591,549,245,487,346,63.7,69.1,58.5,00000
77.0,25.0,87.0,557,03,01,  Kalitola,296,198,165,96,131,102,59.9,63.2,56.2,00000
77.0,25.0,94.0,744,01,01,  Sakoa Bazar,576,538,294,259,282,279,51.7,53.2,50.3,00000
77.0,25.0,94.0,744,02,01,  Board Office Pallipari,306,267,160,119,146,148,53.4,57.3,49.7,00000
77.0,25.0,94.0,744,03,01,  Bullipara,206,444,104,239,102,205,31.7,30.3,33.2,00000
77.0,25.0,94.0,818,01,01,  Naya Dighi,169,243,82,129,87,114,41.0,38.9,43.3,00000
77.0,25.0,94.0,818,02,01,  Gidal Para,119,327,63,161,56,166,26.7,28.1,25.2,00000
77.0,25.0,94.0,818,03,01,  Kherbari Sardar Para,302,395,159,191,143,204,43.3,45.4,41.2,00000
77.0,25.0,94.0,818,04,01,  Pandit Para,305,96,155,50,150,46,76.1,75.6,76.5,00000
77.0,25.0,94.0,886,01,01,  Karji Para,344,643,180,283,164,360,34.9,38.9,31.3,00000
77.0,25.0,94.0,886,02,01,  Majgram,209,77,107,38,102,39,73.1,73.8,72.3,00000
77.0,34.0,38.0,295,01,01,  Paralbari,725,436,399,187,326,249,62.4,68.1,56.7,00000
77.0,34.0,38.0,295,02,01,  Debidoba,779,934,444,440,335,494,45.5,50.2,40.4,00000
77.0,34.0,47.0,305,01,03,  Debiganj,3983,2410,2117,1075,1866,1335,62.3,66.3,58.3,00000
77.0,34.0,47.0,305,02,03,  Natun Bandar,2267,1771,1249,802,1018,969,56.1,60.9,51.2,00000
77.0,73.0,11.0,206,01,01,  Mahenabita,378,592,192,285,186,307,39.0,40.3,37.7,00000
77.0,73.0,11.0,206,02,01,  Naradab Para,377,369,215,172,162,197,50.5,55.6,45.1,00000
77.0,73.0,11.0,206,03,01,  Bara Kamat,250,437,120,218,130,219,36.4,35.5,37.2,00000
77.0,73.0,11.0,206,04,01,  Chhata Kamat,190,250,106,99,84,151,43.2,51.7,35.7,00000
77.0,73.0,11.0,206,05,01,  Senpara,379,161,195,70,184,91,70.2,73.6,66.9,00000
77.0,73.0,11.0,206,06,01,  Peshkar Para,122,98,65,42,57,56,55.5,60.7,50.4,00000
77.0,73.0,11.0,206,07,01,  Barua Para,112,165,57,78,55,87,40.4,42.2,38.7,00000
77.0,73.0,11.0,262,01,01,  Danga Para,327,348,172,167,155,181,48.4,50.7,46.1,00000
77.0,73.0,11.0,262,02,01,  Badina Jot,250,440,123,212,127,228,36.2,36.7,35.8,00000
77.0,73.0,11.0,262,03,01,  Boalimari,414,330,225,157,189,173,55.6,58.9,52.2,00000
77.0,73.0,11.0,262,04,01,  Chaythana Para,209,163,109,63,100,100,56.2,63.4,50.0,00000
77.0,73.0,11.0,262,05,01,  Tutapakuri,406,339,211,146,195,193,54.5,59.1,50.3,00000
77.0,73.0,11.0,262,06,01,  Goral Para,167,200,83,83,84,117,45.5,50.0,41.8,00000
77.0,73.0,11.0,262,07,01,  Bania Para,301,260,145,136,156,124,53.7,51.6,55.7,00000
77.0,73.0,11.0,262,08,01,  Jogdol,236,239,121,120,115,119,49.7,50.2,49.1,00000
77.0,73.0,11.0,281,01,01,  Amarkhana,182,427,105,213,77,214,29.9,33.0,26.5,00000
77.0,73.0,11.0,281,02,01,  Jamuribari,400,236,201,105,199,131,62.9,65.7,60.3,00000
77.0,73.0,11.0,281,03,01,  Uttar Talma,177,263,87,116,90,147,40.2,42.9,38.0,00000
77.0,73.0,11.0,281,04,01,  Hatra Para,108,134,54,60,54,74,44.6,47.4,42.2,00000
77.0,73.0,11.0,281,05,01,  Saker Para,191,213,104,95,87,118,47.3,52.3,42.4,00000
77.0,73.0,11.0,600,01,01,  Madhu Para,439,596,236,307,203,289,42.4,43.5,41.3,00000
77.0,73.0,11.0,600,02,01,  Baman Para,187,213,96,103,91,110,46.8,48.2,45.3,00000
77.0,73.0,11.0,600,03,01,  Kalajot,249,247,145,122,104,125,50.2,54.3,45.4,00000
77.0,73.0,11.0,600,04,01,  Thukuri Para,151,302,74,155,77,147,33.3,32.3,34.4,00000
77.0,73.0,11.0,600,05,01,  Madhuban,115,232,55,123,60,109,33.1,30.9,35.5,00000
77.0,73.0,11.0,976,01,01,  Sonarban,473,805,240,398,233,407,37.0,37.6,36.4,00000
77.0,73.0,11.0,976,02,01,  Jamadar Para,384,483,200,222,184,261,44.3,47.4,41.3,00000
77.0,73.0,11.0,976,03,01,  Khal Para,195,273,102,138,93,135,41.7,42.5,40.8,00000
77.0,73.0,11.0,976,04,01,  Bhadyabita,386,235,292,105,94,130,62.2,73.6,42.0,00000
77.0,73.0,11.0,976,05,01,  Pradhan Para,190,193,102,83,88,110,49.6,55.1,44.4,00000
77.0,73.0,11.0,976,06,01,  Purba Amarkhana,243,296,117,139,126,157,45.1,45.7,44.5,00000
77.0,73.0,11.0,976,07,01,  Sukdeb Para,225,258,112,123,113,135,46.6,47.7,45.6,00000
77.0,73.0,11.0,976,08,01,  Abalupara,157,177,82,80,75,97,47.0,50.6,43.6,00000
77.0,73.0,11.0,976,09,01,  Kamala Para,105,337,51,172,54,165,23.8,22.9,24.7,00000
77.0,73.0,23.0,075,01,01,  Kaku Para(Darbespara)P,171,105,101,49,70,56,62.0,67.3,55.6,00000
77.0,73.0,23.0,075,02,01,  Bania Para (Malirdanga,154,132,74,63,80,69,53.8,54.0,53.7,00000
77.0,73.0,23.0,112,01,01,  Bandarugram,777,1096,399,518,378,578,41.5,43.5,39.5,00000
77.0,73.0,23.0,112,02,01,  Baguladanga (Sardar Pa,445,436,240,187,205,249,50.5,56.2,45.2,00000
77.0,73.0,23.0,112,03,01,  Bania Para,130,109,67,48,63,61,54.4,58.3,50.8,00000
77.0,73.0,23.0,112,04,01,  Kaku Para (Part-1),242,267,136,123,106,144,47.5,52.5,42.4,00000
77.0,73.0,23.0,112,05,01,  Tashildar Para,677,563,350,254,327,309,54.6,57.9,51.4,00000
77.0,73.0,23.0,300,01,01,  Mahar Para,338,749,160,385,178,364,31.1,29.4,32.8,00000
77.0,73.0,23.0,300,02,01,  Purba Chak Lahat(Birpa,439,322,238,135,201,187,57.7,63.8,51.8,00000
77.0,73.0,23.0,300,03,01,  Chak Lahat,830,957,421,446,409,511,46.4,48.6,44.5,00000
77.0,73.0,23.0,957,01,01,  Ratanibari,727,631,389,284,338,347,53.5,57.8,49.3,00000
77.0,73.0,23.0,957,02,01,  Sing Road Dewani Para,211,228,97,108,114,120,48.1,47.3,48.7,00000
77.0,73.0,23.0,957,03,01,  Sing Road Damarkhana,499,329,257,151,242,178,60.3,63.0,57.6,00000
77.0,73.0,23.0,957,04,01,  Sing Road Kismat,514,255,267,111,247,144,66.8,70.6,63.2,00000
77.0,73.0,35.0,375,01,01,  Khal Para,1198,1519,623,733,575,786,44.1,45.9,42.2,00000
77.0,73.0,35.0,375,02,01,  Thakar Para,463,445,259,209,204,236,51.0,55.3,46.4,00000
77.0,73.0,35.0,413,01,01,  Dalua Para,540,542,282,250,258,292,49.9,53.0,46.9,00000
77.0,73.0,35.0,413,02,01,  Basunia Para,943,854,466,404,477,450,52.5,53.6,51.5,00000
77.0,73.0,35.0,619,01,01,  Panimach Pukuri,1859,1461,975,676,884,785,56.0,59.1,53.0,00000
77.0,73.0,35.0,619,02,01,  Bismani,626,703,323,336,303,367,47.1,49.0,45.2,00000
77.0,73.0,35.0,750,01,01,  Kahar Para,249,212,124,101,125,111,54.0,55.1,53.0,00000
77.0,73.0,35.0,750,02,01,  Tali Para,600,828,298,401,302,427,42.0,42.6,41.4,00000
77.0,73.0,35.0,901,01,01,  Madhai Para,371,306,205,122,166,184,54.8,62.7,47.4,00000
77.0,73.0,35.0,901,02,01,  Toka Para,594,547,339,228,255,319,52.1,59.8,44.4,00000
77.0,73.0,36.0,102,01,01,  Khanpukuri,881,631,453,297,428,334,58.3,60.4,56.2,00000
77.0,73.0,36.0,102,02,01,  Shikarpur,1265,816,651,354,614,462,60.8,64.8,57.1,00000
77.0,73.0,36.0,363,01,01,  Mirgarh Purba Para,952,448,492,185,460,263,68.0,72.7,63.6,00000
77.0,73.0,36.0,363,02,01,  Mali Para,482,422,271,189,211,233,53.3,58.9,47.5,00000
77.0,73.0,36.0,363,03,01,  Jatan Pukuri,1722,859,907,391,815,468,66.7,69.9,63.5,00000
77.0,73.0,36.0,369,01,01,  Ghatiar Para,1278,1167,664,564,614,603,52.3,54.1,50.5,00000
77.0,73.0,36.0,369,02,01,  Darua Para,92,190,42,80,50,110,32.6,34.4,31.3,00000
77.0,73.0,36.0,369,03,01,  Burirban,752,457,427,186,325,271,62.2,69.7,54.5,00000
77.0,73.0,36.0,505,01,01,  Benghari,788,600,421,281,367,319,56.8,60.0,53.5,00000
77.0,73.0,36.0,505,02,01,  Langalgaon,830,340,455,151,375,189,70.9,75.1,66.5,00000
77.0,73.0,36.0,983,01,01,  Latua Para,1338,1314,678,616,660,698,50.5,52.4,48.6,00000
77.0,73.0,36.0,983,02,01,  Amarkhana,658,975,405,468,253,507,40.3,46.4,33.3,00000
77.0,73.0,43.0,682,01,01,  Sipai Para,1131,624,623,267,508,357,64.4,70.0,58.7,00000
77.0,73.0,43.0,682,02,01,  Galeha Kantamani,1147,588,633,262,514,326,66.1,70.7,61.2,00000
77.0,73.0,43.0,835,01,01,  Chanda Para,1019,795,547,356,472,439,56.2,60.6,51.8,00000
77.0,73.0,43.0,835,02,01,  Pradhan Para,334,689,178,359,156,330,32.6,33.1,32.1,00000
77.0,73.0,43.0,835,03,01,  Bajra Para,641,730,345,343,296,387,46.8,50.1,43.3,00000
77.0,73.0,43.0,977,01,01,  That Para,804,608,423,277,381,331,56.9,60.4,53.5,00000
77.0,73.0,43.0,977,02,01,  Goal Para,860,1015,465,463,395,552,45.9,50.1,41.7,00000
77.0,73.0,47.0,337,01,01,  Purba Khapara Bandi Pa,406,550,201,261,205,289,42.5,43.5,41.5,00000
77.0,73.0,47.0,337,02,01,  Damu Para,354,469,180,233,174,236,43.0,43.6,42.4,00000
77.0,73.0,47.0,337,03,01,  Basunia Para,453,637,214,316,239,321,41.6,40.4,42.7,00000
77.0,73.0,47.0,337,04,01,  Danga Para,334,536,164,253,170,283,38.4,39.3,37.5,00000
77.0,73.0,47.0,394,01,01,  Danga Para,468,736,264,333,204,403,38.9,44.2,33.6,00000
77.0,73.0,47.0,394,02,01,  Dangi Pukuri,805,896,426,418,379,478,47.3,50.5,44.2,00000
77.0,73.0,47.0,394,03,01,  Bara Bari Para,758,714,395,333,363,381,51.5,54.3,48.8,00000
77.0,73.0,47.0,694,01,01,  Goal Para,533,373,277,174,256,199,58.8,61.4,56.3,00000
77.0,73.0,47.0,694,02,01,  Hari Basa Para,807,1469,411,700,396,769,35.5,37.0,34.0,00000
77.0,73.0,47.0,694,03,01,  Khapara Damu Para,120,254,62,112,58,142,32.1,35.6,29.0,00000
77.0,73.0,47.0,713,01,01,  Ambari Para,810,851,423,380,387,471,48.8,52.7,45.1,00000
77.0,73.0,47.0,713,02,01,  Mohan Bagan Para,913,902,482,424,431,478,50.3,53.2,47.4,00000
77.0,73.0,47.0,807,01,01,  Halua Para,1006,1384,521,696,485,688,42.1,42.8,41.3,00000
77.0,73.0,47.0,807,02,01,  Dalal Para,487,615,260,292,227,323,44.2,47.1,41.3,00000
77.0,73.0,47.0,807,03,01,  Nalaganga Para,449,602,234,303,215,299,42.7,43.6,41.8,00000
77.0,73.0,59.0,150,01,01,  Boalimarigram,351,339,188,160,163,179,50.9,54.0,47.7,00000
77.0,73.0,59.0,150,02,01,  Ghatabar,878,751,427,352,451,399,53.9,54.8,53.1,00000
77.0,73.0,59.0,244,01,01,  Chash Para,687,590,356,274,331,316,53.8,56.5,51.2,00000
77.0,73.0,59.0,244,02,01,  Fulpara (GolahaDafada,659,489,358,226,301,263,57.4,61.3,53.4,00000
77.0,73.0,59.0,244,03,01,  Nalkura(KatabariJangn,729,596,383,301,346,295,55.0,56.0,54.0,00000
77.0,73.0,59.0,469,01,01,  Kuchiamor,707,895,388,426,319,469,44.1,47.7,40.5,00000
77.0,73.0,59.0,469,02,01,  Shipahi Para,521,469,267,231,254,238,52.6,53.6,51.6,00000
77.0,73.0,59.0,469,03,01,  Laskar Para,201,195,100,98,101,97,50.8,50.5,51.0,00000
77.0,73.0,59.0,469,04,01,  Sarkar Para,229,378,119,198,110,180,37.7,37.5,37.9,00000
77.0,73.0,59.0,469,05,01,  Goal Para,445,452,226,227,219,225,49.6,49.9,49.3,00000
77.0,73.0,59.0,469,06,01,  Tunirhat (Bairagi Para,655,410,353,186,302,224,61.5,65.5,57.4,00000
77.0,73.0,65.0,437,01,01,  Dhani Para,249,312,135,160,114,152,44.4,45.8,42.9,00000
77.0,73.0,65.0,437,02,01,  Azadpur,609,660,353,303,256,357,48.0,53.8,41.8,00000
77.0,73.0,65.0,437,03,01,  Pradhan Para,1229,857,684,406,545,451,58.9,62.8,54.7,00000
77.0,73.0,71.0,319,01,01,  Goal Para,155,188,82,90,73,98,45.2,47.7,42.7,00000
77.0,73.0,71.0,319,02,01,  Jhambita,143,291,71,150,72,141,32.9,32.1,33.8,00000
77.0,73.0,71.0,319,03,01,  Buri Para (Bushi Bita),682,716,364,323,318,393,48.8,53.0,44.7,00000
77.0,73.0,71.0,319,04,01,  Sannasi Para,203,268,99,136,104,132,43.1,42.1,44.1,00000
77.0,73.0,71.0,319,05,01,  Moulvi Para (Part),205,255,104,132,101,123,44.6,44.1,45.1,00000
77.0,73.0,71.0,506,01,01,  Dabardanga(Pradhan & S,525,846,271,410,254,436,38.3,39.8,36.8,00000
77.0,73.0,71.0,506,02,01,  Kazi Para,398,422,210,190,188,232,48.5,52.5,44.8,00000
77.0,73.0,71.0,506,03,01,  Darikamari,100,77,57,36,43,41,56.5,61.3,51.2,00000
77.0,73.0,71.0,506,04,01,  Surivita (Part),138,101,82,47,56,54,57.7,63.6,50.9,00000
77.0,73.0,71.0,732,01,01,  Boleya Para,764,1003,389,501,375,502,43.2,43.7,42.8,00000
77.0,73.0,71.0,732,02,01,  Sing Para (Purba Pasch,834,513,515,276,319,237,61.9,65.1,57.4,00000
77.0,73.0,71.0,732,03,01,  Molani Boda Para,1354,1513,716,722,638,791,47.2,49.8,44.6,00000
77.0,73.0,71.0,788,01,01,  Dudumari,756,635,411,276,345,359,54.3,59.8,49.0,00000
77.0,73.0,71.0,788,02,01,  Fakir Para,268,81,149,39,119,42,76.8,79.3,73.9,00000
77.0,73.0,71.0,788,03,01,  Mohan Para,304,529,163,263,141,266,36.5,38.3,34.6,00000
77.0,73.0,71.0,788,04,01,  Danga Para,201,144,107,67,94,77,58.3,61.5,55.0,00000
77.0,73.0,71.0,788,05,01,  Jhakuakali,320,332,164,166,156,166,49.1,49.7,48.4,00000
77.0,73.0,71.0,788,06,01,  Daria Para,352,235,185,101,167,134,60.0,64.7,55.5,00000
77.0,73.0,71.0,788,07,01,  Gofa Para,490,540,266,262,224,278,47.6,50.4,44.6,00000
77.0,73.0,71.0,788,08,01,  Sitagram(Surivita & Ke,607,662,303,323,304,339,47.8,48.4,47.3,00000
77.0,73.0,71.0,899,01,01,  Basunia Para (Kayei Pa,367,456,173,220,194,236,44.6,44.0,45.1,00000
77.0,73.0,71.0,899,02,01,  Panihaga,236,126,114,56,122,70,65.2,67.1,63.5,00000
77.0,73.0,71.0,899,03,01,  Jagdal (Sardar Para),1414,1138,716,571,698,567,55.4,55.6,55.2,00000
77.0,73.0,83.0,563,01,01,  Khasmahal,640,465,351,231,289,234,57.9,60.3,55.3,00000
77.0,73.0,83.0,563,02,01,  Haroa Para,204,425,122,199,82,226,32.4,38.0,26.6,00000
77.0,73.0,83.0,563,03,01,  Bangu Para,339,391,186,187,153,204,46.4,49.9,42.9,00000
77.0,73.0,83.0,563,04,01,  Satarang Para,285,280,146,133,139,147,50.4,52.3,48.6,00000
77.0,73.0,83.0,638,01,01,  Majhi Para,207,336,117,156,90,180,38.1,42.9,33.3,00000
77.0,73.0,83.0,638,02,01,  Kakpara,540,984,275,476,265,508,35.4,36.6,34.3,00000
77.0,73.0,83.0,638,03,01,  Baluki Para,48,410,26,196,22,214,10.5,11.7,9.3,00000
77.0,73.0,83.0,638,04,01,  Baksigaz,307,629,164,306,143,323,32.8,34.9,30.7,00000
77.0,73.0,83.0,638,05,01,  Jote Shouda,401,552,208,285,193,267,42.1,42.2,42.0,00000
77.0,73.0,83.0,844,01,01,  Pakilaga,545,693,284,332,261,361,44.0,46.1,42.0,00000
77.0,73.0,83.0,844,02,01,  Palku Jote,230,277,128,113,102,164,45.4,53.1,38.3,00000
77.0,73.0,83.0,844,03,01,  Jitkilura,222,218,130,92,92,126,50.5,58.6,42.2,00000
77.0,73.0,83.0,844,04,01,  Goaljar,485,537,250,258,235,279,47.5,49.2,45.7,00000
77.0,73.0,83.0,863,01,01,  Pradhan Para,397,444,209,218,188,226,47.2,48.9,45.4,00000
77.0,73.0,83.0,863,02,01,  Khal Para,424,347,239,163,185,184,55.0,59.5,50.1,00000
77.0,73.0,83.0,863,03,01,  Nunia Para,370,587,181,304,189,283,38.7,37.3,40.0,00000
77.0,73.0,83.0,882,01,01,  Purba Sahebi Jote,96,196,48,110,48,86,32.9,30.4,35.8,00000
77.0,73.0,83.0,882,02,01,  Paschim Sahebi Jote,137,115,83,41,54,74,54.4,66.9,42.2,00000
77.0,73.0,83.0,882,03,01,  Dabanagar,304,637,151,307,153,330,32.3,33.0,31.7,00000
77.0,73.0,83.0,882,04,01,  Nachara Para,155,358,91,159,64,199,30.2,36.4,24.3,00000
77.0,73.0,83.0,882,05,01,  Chak Karmari,330,562,183,267,147,295,37.0,40.7,33.3,00000
77.0,73.0,83.0,882,06,01,  Jabariduar (Part),58,66,31,30,27,36,46.8,50.8,42.9,00000
77.0,73.0,83.0,882,07,01,  Danga Para,470,770,255,397,215,373,37.9,39.1,36.6,00000
77.0,73.0,83.0,919,01,01,  Roypara,238,189,119,86,119,103,55.7,58.0,53.6,00000
77.0,73.0,83.0,919,02,01,  Sitlihasna,360,508,215,241,145,267,41.5,47.1,35.2,00000
77.0,73.0,83.0,919,03,01,  Bandi Para,102,231,61,114,41,117,30.6,34.9,25.9,00000
77.0,73.0,83.0,919,04,01,  Pati Para,202,181,108,87,94,94,52.7,55.4,50.0,00000
77.0,73.0,83.0,919,05,01,  Bira Jote,241,344,131,173,110,171,41.2,43.1,39.1,00000
77.0,73.0,83.0,919,06,01,  Fakir Para,217,361,116,170,101,191,37.5,40.6,34.6,00000
77.0,73.0,83.0,919,07,01,  Kahar Para,161,197,88,87,73,110,45.0,50.3,39.9,00000
77.0,73.0,83.0,919,08,01,  Jote Hosna,190,167,114,74,76,93,53.2,60.6,45.0,00000
77.0,73.0,83.0,919,09,01,  Laipara,133,248,68,123,65,125,34.9,35.6,34.2,00000
77.0,73.0,83.0,919,10,01,  Tabaniduar,290,373,159,189,131,184,43.7,45.7,41.6,00000
77.0,90.0,13.0,090,01,01,  Banglabandha,602,497,342,251,260,246,54.8,57.7,51.4,00000
77.0,90.0,13.0,090,02,01,  Jharua Para,376,342,196,183,180,159,52.4,51.7,53.1,00000
77.0,90.0,13.0,090,03,01,  Jaigir Jote,384,420,204,245,180,175,47.8,45.4,50.7,00000
77.0,90.0,13.0,090,04,01,  Paglidangi,152,131,94,68,58,63,53.7,58.0,47.9,00000
77.0,90.0,13.0,090,05,01,  Gatia Para,65,139,34,60,31,79,31.9,36.2,28.2,00000
77.0,90.0,13.0,090,06,01,  Pabnabasti,22,62,14,27,8,35,26.2,34.1,18.6,00000
77.0,90.0,13.0,090,07,01,  Sardar Para,103,144,53,74,50,70,41.7,41.7,41.7,00000
77.0,90.0,13.0,090,08,01,  Nidigachh,97,35,52,13,45,22,73.5,80.0,67.2,00000
77.0,90.0,13.0,090,09,01,  Baingachh,146,139,71,78,75,61,51.2,47.7,55.1,00000
77.0,90.0,13.0,090,10,01,  Bhougri Bhita,55,58,29,30,26,28,48.7,49.2,48.1,00000
77.0,90.0,13.0,512,01,01,  Uttar Kashimgachh,229,273,118,137,111,136,45.6,46.3,44.9,00000
77.0,90.0,13.0,512,02,01,  Dakshin Kashimgachh,361,355,203,158,158,197,50.4,56.2,44.5,00000
77.0,90.0,13.0,512,04,01,  Jamadargachh,246,305,127,158,119,147,44.6,44.6,44.7,00000
77.0,90.0,13.0,512,05,01,  Goulgachh,143,203,81,98,62,105,41.3,45.3,37.1,00000
77.0,90.0,13.0,512,06,01,  Pathan Para,269,217,141,104,128,113,55.3,57.6,53.1,00000
77.0,90.0,13.0,512,07,01,  Halasu Jote,419,470,225,228,194,242,47.1,49.7,44.5,00000
77.0,90.0,13.0,512,08,01,  Narayan Jote,143,99,79,39,64,60,59.1,66.9,51.6,00000
77.0,90.0,13.0,512,09,01,  Pedibita,57,102,28,46,29,56,35.8,37.8,34.1,00000
77.0,90.0,13.0,512,10,01,  Futkibari,578,796,303,379,275,417,42.1,44.4,39.7,00000
77.0,90.0,13.0,904,01,01,  Chaturagachh,178,195,100,84,78,111,47.7,54.3,41.3,00000
77.0,90.0,13.0,904,02,01,  Haji Para,49,111,28,51,21,60,30.6,35.4,25.9,00000
77.0,90.0,13.0,904,03,01,  Daijan,209,274,101,141,108,133,43.3,41.7,44.8,00000
77.0,90.0,13.0,904,04,01,  Digalgaon,295,179,161,74,134,105,62.2,68.5,56.1,00000
77.0,90.0,13.0,904,05,01,  Ukil Jot,116,79,65,39,51,40,59.5,62.5,56.0,00000
77.0,90.0,13.0,904,06,01,  Sipai Para,296,296,166,146,130,150,50.0,53.2,46.4,00000
77.0,90.0,13.0,904,07,01,  Haea Jote,297,346,161,175,136,171,46.2,47.9,44.3,00000
77.0,90.0,13.0,904,08,01,  Sannashi Para,137,209,77,103,60,106,39.6,42.8,36.1,00000
77.0,90.0,27.0,120,01,01,  Kritan Para,55,60,33,28,22,32,47.8,54.1,40.7,00000
77.0,90.0,27.0,120,02,01,  Bangi Para,80,94,45,48,35,46,46.0,48.4,43.2,00000
77.0,90.0,27.0,120,03,01,  Santinagar,57,86,32,45,25,41,39.9,41.6,37.9,00000
77.0,90.0,27.0,120,04,01,  Mulkhagachh,274,329,142,160,132,169,45.4,47.0,43.9,00000
77.0,90.0,27.0,120,05,01,  Bhadreshwar,69,86,40,39,29,47,44.5,50.6,38.2,00000
77.0,90.0,27.0,120,06,01,  Sipai Para,132,94,79,38,53,56,58.4,67.5,48.6,00000
77.0,90.0,27.0,120,07,01,  Bramatul,131,152,74,72,57,80,46.3,50.7,41.6,00000
77.0,90.0,27.0,150,01,01,  Ganagachh,377,365,214,170,163,195,50.8,55.7,45.5,00000
77.0,90.0,27.0,150,02,01,  Kaurgachh,436,372,243,162,193,210,54.0,60.0,47.9,00000
77.0,90.0,27.0,150,03,01,  Gulabdigachh,369,312,207,134,162,178,54.2,60.7,47.6,00000
77.0,90.0,27.0,150,04,01,  Bhojanpur,813,489,451,213,362,276,62.4,67.9,56.7,00000
77.0,90.0,27.0,150,05,01,  Niwa Para,128,124,63,61,65,63,50.8,50.8,50.8,00000
77.0,90.0,27.0,150,06,01,  Valu Para,133,105,70,55,63,50,55.9,56.0,55.8,00000
77.0,90.0,27.0,693,01,01,  Bhuti Pukuri,302,477,153,252,149,225,38.8,37.8,39.8,00000
77.0,90.0,27.0,693,02,01,  Khal Para,35,84,20,40,15,44,29.4,33.3,25.4,00000
77.0,90.0,27.0,693,03,01,  Bagulahaji,285,386,161,185,124,201,42.5,46.5,38.2,00000
77.0,90.0,27.0,693,04,01,  Pradhangachh,309,406,166,186,143,220,43.2,47.2,39.4,00000
77.0,90.0,27.0,693,05,01,  Khuniagachh,49,79,27,33,22,46,38.3,45.0,32.4,00000
77.0,90.0,27.0,693,06,01,  Kuranugachh,202,277,110,127,92,150,42.2,46.4,38.0,00000
77.0,90.0,27.0,693,07,01,  Sarifgacha,143,228,77,118,66,110,38.5,39.5,37.5,00000
77.0,90.0,27.0,783,01,01,  Sardar Para,127,119,80,48,47,71,51.6,62.5,39.8,00000
77.0,90.0,27.0,783,02,01,  Danga Para,370,388,209,188,161,200,48.8,52.6,44.6,00000
77.0,90.0,27.0,783,03,01,  Fakir Para,72,172,37,90,35,82,29.5,29.1,29.9,00000
77.0,90.0,27.0,783,04,01,  Bania Para,102,96,53,50,49,46,51.5,51.5,51.6,00000
77.0,90.0,27.0,783,05,01,  Bamma Para,328,546,173,279,155,267,37.5,38.3,36.7,00000
77.0,90.0,27.0,783,06,01,  Maligachh,250,309,134,148,116,161,44.7,47.5,41.9,00000
77.0,90.0,27.0,783,07,01,  Chandiagachh,192,164,104,76,88,88,53.9,57.8,50.0,00000
77.0,90.0,27.0,783,08,01,  Bairagigachh,125,276,68,140,57,136,31.2,32.7,29.5,00000
77.0,90.0,27.0,783,09,01,  Daktar Para,82,90,48,42,34,48,47.7,53.3,41.5,00000
77.0,90.0,27.0,783,10,01,  Gitalgachh,241,352,131,164,110,188,40.6,44.4,36.9,00000
77.0,90.0,27.0,783,11,01,  Puhatugachh,90,158,38,85,52,73,36.3,30.9,41.6,00000
77.0,90.0,27.0,783,12,01,  Demagachh,84,64,51,24,33,40,56.8,68.0,45.2,00000
77.0,90.0,40.0,030,01,01,  Shibchandi,325,360,189,194,136,166,47.4,49.3,45.0,00000
77.0,90.0,40.0,030,02,01,  Joygobinda Joat,295,427,156,212,139,215,40.9,42.4,39.3,00000
77.0,90.0,40.0,030,03,01,  Nandagachh,215,359,103,179,112,180,37.5,36.5,38.4,00000
77.0,90.0,40.0,030,04,01,  Sita Para,111,235,69,116,42,119,32.1,37.3,26.1,00000
77.0,90.0,40.0,030,05,01,  Sipai Para,27,184,12,90,15,94,12.8,11.8,13.8,00000
77.0,90.0,40.0,030,06,01,  Hangadoba,278,275,154,127,124,148,50.3,54.8,45.6,00000
77.0,90.0,40.0,030,07,01,  Danga Para,70,206,27,99,43,107,25.4,21.4,28.7,00000
77.0,90.0,40.0,030,08,01,  Amzdoani,230,239,115,106,115,133,49.0,52.0,46.4,00000
77.0,90.0,40.0,030,09,01,  Mandal Para,39,39,20,19,19,20,50.0,51.3,48.7,00000
77.0,90.0,40.0,030,10,01,  Kanpara,97,119,53,57,44,62,44.9,48.2,41.5,00000
77.0,90.0,40.0,030,11,01,  Khata Para,279,272,145,126,134,146,50.6,53.5,47.9,00000
77.0,90.0,40.0,180,01,01,  Dhansuka,65,139,36,61,29,78,31.9,37.1,27.1,00000
77.0,90.0,40.0,180,02,01,  Nijbari,686,834,380,390,306,444,45.1,49.4,40.8,00000
77.0,90.0,40.0,180,03,01,  Dafadar Para,98,165,59,74,39,91,37.3,44.4,30.0,00000
77.0,90.0,40.0,180,04,01,  Satmera,178,140,104,64,74,76,56.0,61.9,49.3,00000
77.0,90.0,40.0,180,05,01,  Hawajdat,98,72,48,35,50,37,57.6,57.8,57.5,00000
77.0,90.0,40.0,180,06,01,  Satramgachh,95,52,54,16,41,36,64.6,77.1,53.2,00000
77.0,90.0,40.0,180,07,01,  Nagurmari,325,185,183,82,142,103,63.7,69.1,58.0,00000
77.0,90.0,40.0,180,08,01,  Setali Para,80,89,41,44,39,45,47.3,48.2,46.4,00000
77.0,90.0,40.0,180,09,01,  Usha Para,131,191,79,96,52,95,40.7,45.1,35.4,00000
77.0,90.0,40.0,180,10,01,  Badiagachh,115,112,66,48,49,64,50.7,57.9,43.4,00000
77.0,90.0,40.0,180,11,01,  Hurbari,115,128,60,64,55,64,47.3,48.4,46.2,00000
77.0,90.0,40.0,180,12,01,  Lathibgachh,181,214,95,92,86,122,45.8,50.8,41.3,00000
77.0,90.0,40.0,180,13,01,  Balubari,75,68,44,31,31,37,52.4,58.7,45.6,00000
77.0,90.0,40.0,211,01,01,  Dalua Gerdda,198,302,108,138,90,164,39.6,43.9,35.4,00000
77.0,90.0,40.0,211,02,01,  Fatua Para,71,94,31,50,40,44,43.0,38.3,47.6,00000
77.0,90.0,40.0,211,03,01,  Jangalbari,38,133,16,69,22,64,22.2,18.8,25.6,00000
77.0,90.0,40.0,391,01,01,  Kaliamani,91,178,49,84,42,94,33.8,36.8,30.9,00000
77.0,90.0,40.0,391,02,01,  Jhalingigachh,125,284,74,137,51,147,30.6,35.1,25.8,00000
77.0,90.0,40.0,391,03,01,  Jhalingoach Guchagram,35,152,20,76,15,76,18.7,20.8,16.5,00000
77.0,90.0,40.0,422,01,01,  Patharghata,91,221,53,110,38,111,29.2,32.5,25.5,00000
77.0,90.0,40.0,422,02,01,  Atharkhi,124,298,60,155,64,143,29.4,27.9,30.9,00000
77.0,90.0,40.0,422,03,01,  Khatiagachh,172,85,88,42,84,43,66.9,67.7,66.1,00000
77.0,90.0,40.0,422,04,01,  Atmagachh,117,178,69,86,48,92,39.7,44.5,34.3,00000
77.0,90.0,40.0,422,05,01,  Shantigachh,88,57,48,25,40,32,60.7,65.8,55.6,00000
77.0,90.0,40.0,422,06,01,  Brahmatal,122,118,65,53,57,65,50.8,55.1,46.7,00000
77.0,90.0,40.0,422,07,01,  Surigachh,154,175,94,84,60,91,46.8,52.8,39.7,00000
77.0,90.0,40.0,422,08,01,  Majram,258,185,127,88,131,97,58.2,59.1,57.5,00000
77.0,90.0,40.0,603,01,01,  Mainaguri,337,319,190,152,147,167,51.4,55.6,46.8,00000
77.0,90.0,40.0,603,02,01,  Gani Para,198,128,107,57,91,71,60.7,65.2,56.2,00000
77.0,90.0,40.0,603,03,01,  Gachhbari,74,62,31,33,43,29,54.4,48.4,59.7,00000
77.0,90.0,40.0,603,04,01,  Kamat Para,241,362,119,183,122,179,40.0,39.4,40.5,00000
77.0,90.0,40.0,603,05,01,  Thena Para,22,26,14,13,8,13,45.8,51.9,38.1,00000
77.0,90.0,40.0,874,01,01,  Dutu Para,178,146,93,66,85,80,54.9,58.5,51.5,00000
77.0,90.0,40.0,874,02,01,  Sekhgachh,138,124,72,62,66,62,52.7,53.7,51.6,00000
77.0,90.0,40.0,874,03,01,  Bania Para,115,89,67,41,48,48,56.4,62.0,50.0,00000
77.0,90.0,40.0,874,04,01,  Nayabari,3,2,2,1,1,1,60.0,66.7,50.0,00000
77.0,90.0,40.0,874,05,01,  Butujdat,87,123,44,60,43,63,41.4,42.3,40.6,00000
77.0,90.0,40.0,874,06,01,  Pathan Para,103,152,63,70,40,82,40.4,47.4,32.8,00000
77.0,90.0,40.0,874,07,01,  Banglachandi,262,231,154,111,108,120,53.1,58.1,47.4,00000
77.0,90.0,40.0,874,08,01,  Sarkar Para,122,128,69,54,53,74,48.8,56.1,41.7,00000
77.0,90.0,40.0,874,09,01,  Manikdoba,182,423,96,233,86,190,30.1,29.2,31.2,00000
77.0,90.0,40.0,874,10,01,  Mandal Para,12,21,5,8,7,13,36.4,38.5,35.0,00000
77.0,90.0,40.0,874,11,01,  Tutua Para,54,126,31,63,23,63,30.0,33.0,26.7,00000
77.0,90.0,40.0,874,12,01,  Hatu Para,180,127,109,52,71,75,58.6,67.7,48.6,00000
77.0,90.0,40.0,874,13,01,  Kamat Para,66,69,28,36,38,33,48.9,43.8,53.5,00000
77.0,90.0,40.0,874,14,01,  Khatiagachh,43,14,21,9,22,5,75.4,70.0,81.5,00000
77.0,90.0,40.0,874,15,01,  Jharbari,169,138,95,61,74,77,55.0,60.9,49.0,00000
77.0,90.0,54.0,271,01,01,  Buraburi,579,658,323,282,256,376,46.8,53.4,40.5,00000
77.0,90.0,54.0,271,02,01,  Mandal Para-1,291,362,189,190,102,172,44.6,49.9,37.2,00000
77.0,90.0,54.0,271,03,01,  Mandal Para-2,310,387,171,184,139,203,44.5,48.2,40.6,00000
77.0,90.0,54.0,361,01,01,  Pradhan Balabari,32,25,23,13,9,12,56.1,63.9,42.9,00000
77.0,90.0,54.0,361,02,01,  Balabari,79,129,40,71,39,58,38.0,36.0,40.2,00000
77.0,90.0,54.0,361,03,01,  Lalgachh,67,143,33,80,34,63,31.9,29.2,35.1,00000
77.0,90.0,54.0,361,04,01,  Hara Dighi,340,351,171,161,169,190,49.2,51.5,47.1,00000
77.0,90.0,54.0,361,05,01,  Kazi Para,141,109,87,48,54,61,56.4,64.4,47.0,00000
77.0,90.0,54.0,452,01,01,  Naya Para,176,100,101,33,75,67,63.8,75.4,52.8,00000
77.0,90.0,54.0,452,02,01,  Garagachh,169,194,88,95,81,99,46.6,48.1,45.0,00000
77.0,90.0,54.0,452,03,01,  Chowdhury Para,189,170,102,69,87,101,52.6,59.6,46.3,00000
77.0,90.0,54.0,452,04,01,  Bhuyalgachh,103,158,54,79,49,79,39.5,40.6,38.3,00000
77.0,90.0,54.0,452,05,01,  Kata Para,257,314,145,141,112,173,45.0,50.7,39.3,00000
77.0,90.0,54.0,452,06,01,  Narayangachh,311,328,159,153,152,175,48.7,51.0,46.5,00000
77.0,90.0,54.0,452,07,01,  Kaldas Para,255,276,113,135,142,141,48.0,45.6,50.2,00000
77.0,90.0,54.0,844,01,01,  Sarkar Para,294,421,150,208,144,213,41.1,41.9,40.3,00000
77.0,90.0,54.0,844,02,01,  Bhandibhita,117,103,67,48,50,55,53.2,58.3,47.6,00000
77.0,90.0,54.0,844,03,01,  Nawabari,53,143,26,76,27,67,27.0,25.5,28.7,00000
77.0,90.0,54.0,844,04,01,  Rajugachh,135,133,80,59,55,74,50.4,57.6,42.6,00000
77.0,90.0,54.0,844,05,01,  Shelakuti,142,201,84,86,58,115,41.4,49.4,33.5,00000
77.0,90.0,54.0,844,06,01,  Sardargachh Balabari,114,187,54,77,60,110,37.9,41.2,35.3,00000
77.0,90.0,54.0,844,07,01,  Charakdangi,231,240,130,110,101,130,49.0,54.2,43.7,00000
77.0,90.0,54.0,844,08,01,  Namagachh,53,135,31,66,22,69,28.2,32.0,24.2,00000
77.0,90.0,67.0,060,01,01,  Balabari,305,222,178,97,127,125,57.9,64.7,50.4,00000
77.0,90.0,67.0,060,02,01,  Basanta Joat,98,95,52,50,46,45,50.8,51.0,50.5,00000
77.0,90.0,67.0,060,03,01,  Haguragachh,80,108,36,57,44,51,42.6,38.7,46.3,00000
77.0,90.0,67.0,060,04,01,  Barbisua,194,210,94,95,100,115,48.0,49.7,46.5,00000
77.0,90.0,67.0,060,05,01,  Balabari Gucho Gram,49,174,24,89,25,85,22.0,21.2,22.7,00000
77.0,90.0,67.0,241,01,01,  Sopagachh,219,278,114,133,105,145,44.1,46.2,42.0,00000
77.0,90.0,67.0,241,02,01,  Mohigachh,232,160,124,73,108,87,59.2,62.9,55.4,00000
77.0,90.0,67.0,241,03,01,  Boalmari,585,820,311,378,274,442,41.6,45.1,38.3,00000
77.0,90.0,67.0,241,04,01,  Pathni Para,199,240,101,113,98,127,45.3,47.2,43.6,00000
77.0,90.0,67.0,241,05,01,  Chowdharygachh,200,149,98,67,102,82,57.3,59.4,55.4,00000
77.0,90.0,67.0,241,06,01,  Maynagari,315,364,158,176,157,188,46.4,47.3,45.5,00000
77.0,90.0,67.0,542,01,01,  Namagachh,215,237,109,116,106,121,47.6,48.4,46.7,00000
77.0,90.0,67.0,542,02,01,  Daluagachh,178,197,83,103,95,94,47.5,44.6,50.3,00000
77.0,90.0,67.0,542,03,01,  Mandal Para,253,185,141,82,112,103,57.8,63.2,52.1,00000
77.0,90.0,67.0,542,04,01,  Pramanik Para,109,135,65,61,44,74,44.7,51.6,37.3,00000
77.0,90.0,67.0,542,05,01,  Pran Joat,103,84,59,40,44,44,55.1,59.6,50.0,00000
77.0,90.0,67.0,542,06,01,  Khirkidangi,135,99,61,51,74,48,57.7,54.5,60.7,00000
77.0,90.0,67.0,542,07,01,  Chhota Daluagachh,178,239,103,118,75,121,42.7,46.6,38.3,00000
77.0,90.0,67.0,542,08,01,  Kumartun,223,144,106,63,117,81,60.8,62.7,59.1,00000
77.0,90.0,67.0,542,09,01,  Kalandigachh,196,199,97,98,99,101,49.6,49.7,49.5,00000
77.0,90.0,67.0,542,10,01,  Taiyagachh,98,196,54,96,44,100,33.3,36.0,30.6,00000
77.0,90.0,67.0,542,11,01,  Fakir Para,118,185,70,91,48,94,38.9,43.5,33.8,00000
77.0,90.0,67.0,572,01,01,  Guabari,175,285,104,131,71,154,38.0,44.3,31.6,00000
77.0,90.0,67.0,572,02,01,  Dadhegachh,196,171,99,83,97,88,53.4,54.4,52.4,00000
77.0,90.0,67.0,572,03,01,  Lohakanchi,228,104,122,47,106,57,68.7,72.2,65.0,00000
77.0,90.0,67.0,572,04,01,  Danagachh,261,122,149,50,112,72,68.1,74.9,60.9,00000
77.0,90.0,67.0,572,05,01,  Jamariguri,101,85,54,42,47,43,54.3,56.3,52.2,00000
77.0,90.0,67.0,572,06,01,  Kazigachh,216,317,108,157,108,160,40.5,40.8,40.3,00000
77.0,90.0,67.0,633,01,01,  Daragachh,210,149,106,76,104,73,58.5,58.2,58.8,00000
77.0,90.0,67.0,633,02,01,  Majhi Para,579,526,300,233,279,293,52.4,56.3,48.8,00000
77.0,90.0,67.0,633,03,01,  Narangachh,197,308,96,148,101,160,39.0,39.3,38.7,00000
77.0,90.0,67.0,633,04,01,  Dahuk Guchchhagram,123,134,61,63,62,71,47.9,49.2,46.6,00000
77.0,90.0,67.0,633,05,01,  Khutagachh,342,215,171,112,171,103,61.4,60.4,62.4,00000
77.0,90.0,67.0,633,06,01,  Padiagachh,236,153,109,78,127,75,60.7,58.3,62.9,00000
77.0,90.0,67.0,753,01,01,  Salbahan,551,406,287,194,264,212,57.6,59.7,55.5,00000
77.0,90.0,67.0,753,02,01,  Dariagachh,346,262,181,123,165,139,56.9,59.5,54.3,00000
77.0,90.0,67.0,753,03,01,  Gobragachh,106,93,59,43,47,50,53.3,57.8,48.5,00000
77.0,90.0,67.0,753,04,01,  Sarkar Para,69,80,34,41,35,39,46.3,45.3,47.3,00000
77.0,90.0,67.0,753,05,01,  Bhalkugachh,160,180,79,86,81,94,47.1,47.9,46.3,00000
77.0,90.0,67.0,753,06,01,  Paramanik Para,263,407,138,210,125,197,39.3,39.7,38.8,00000
77.0,90.0,81.0,301,01,01,  Darjee Para,562,1042,269,519,293,523,35.0,34.1,35.9,00000
77.0,90.0,81.0,301,02,01,  Kankata,87,103,43,52,44,51,45.8,45.3,46.3,00000
77.0,90.0,81.0,301,03,01,  Premcharan Jote,62,79,30,39,32,40,44.0,43.5,44.4,00000
77.0,90.0,81.0,301,04,01,  Sreeman Jote,156,288,84,144,72,144,35.1,36.8,33.3,00000
77.0,90.0,81.0,301,05,01,  Sarial Jote,314,416,158,212,156,204,43.0,42.7,43.3,00000
77.0,90.0,81.0,331,01,01,  Baburam Jote,132,226,59,119,73,107,36.9,33.1,40.6,00000
77.0,90.0,81.0,331,02,01,  Panihaga,157,272,82,140,75,132,36.6,36.9,36.2,00000
77.0,90.0,81.0,331,03,01,  Chandamari,69,72,29,36,40,36,48.9,44.6,52.6,00000
77.0,90.0,81.0,331,04,01,  Gariagachh,213,406,106,193,107,213,34.4,35.5,33.4,00000
77.0,90.0,81.0,331,05,01,  Khal Para,251,152,141,62,110,90,62.3,69.5,55.0,00000
77.0,90.0,81.0,331,06,01,  Mulukchand Gosh,66,233,28,121,38,112,22.1,18.8,25.3,00000
77.0,90.0,81.0,331,07,01,  Berali Jote,150,373,65,192,85,181,28.7,25.3,32.0,00000
77.0,90.0,81.0,331,08,01,  Bursagachh,61,67,35,34,26,33,47.7,50.7,44.1,00000
77.0,90.0,81.0,331,09,01,  Compani Jote,104,228,58,119,46,109,31.3,32.8,29.7,00000
77.0,90.0,81.0,663,01,01,  Mathafata,515,419,249,202,266,217,55.1,55.2,55.1,00000
77.0,90.0,81.0,663,02,01,  Aziznagar,941,546,508,247,433,299,63.3,67.3,59.2,00000
77.0,90.0,81.0,663,03,01,  Danga Para,323,391,159,178,164,213,45.2,47.2,43.5,00000
77.0,90.0,81.0,814,01,01,  Mahalal Jote,86,86,51,42,35,44,50.0,54.8,44.3,00000
77.0,90.0,81.0,814,02,01,  Sardar Para,186,176,97,79,89,97,51.4,55.1,47.8,00000
77.0,90.0,81.0,814,03,01,  Kalaram Jote,123,94,69,48,54,46,56.7,59.0,54.0,00000
77.0,90.0,81.0,814,04,01,  Burimatki,71,130,32,68,39,62,35.3,32.0,38.6,00000
77.0,90.0,81.0,814,05,01,  Hapi Jote,52,37,26,12,26,25,58.4,68.4,51.0,00000
77.0,90.0,81.0,814,06,01,  Sarkar Para,121,96,67,44,54,52,55.8,60.4,50.9,00000
77.0,90.0,81.0,814,07,01,  Badurbari,150,134,76,67,74,67,52.8,53.1,52.5,00000
77.0,90.0,81.0,814,08,01,  Ranchandi,204,333,86,166,118,167,38.0,34.1,41.4,00000
77.0,90.0,81.0,814,09,01,  Guabari,231,575,118,285,113,290,28.7,29.3,28.0,00000
77.0,90.0,81.0,934,01,03,  Tetulia,1022,640,520,288,502,352,61.5,64.4,58.8,00000
77.0,90.0,81.0,934,02,03,  Sahab Jote,548,279,300,132,248,147,66.3,69.4,62.8,00000
77.0,90.0,81.0,934,03,03,  Bargharia,123,161,62,79,61,82,43.3,44.0,42.7,00000
77.0,90.0,81.0,934,04,03,  Khuniabeta,269,62,147,26,122,36,81.3,85.0,77.2,00000
77.0,90.0,81.0,934,05,03,  Krishnakanda Jote,103,79,54,37,49,42,56.6,59.3,53.8,00000
77.0,90.0,81.0,934,06,03,  Tali Para,152,66,77,25,75,41,69.7,75.5,64.7,00000
77.0,90.0,81.0,934,07,03,  Colony Para,580,216,294,108,286,108,72.9,73.1,72.6,00000
77.0,90.0,81.0,934,08,03,  Magura,247,206,136,100,111,106,54.5,57.6,51.2,00000
77.0,90.0,94.0,482,01,01,  Thunthunia,225,247,119,109,106,138,47.7,52.2,43.4,00000
77.0,90.0,94.0,482,02,01,  Dhamnagach,275,201,154,91,121,110,57.8,62.9,52.4,00000
77.0,90.0,94.0,482,03,01,  Pithakhua,247,232,134,117,113,115,51.6,53.4,49.6,00000
77.0,90.0,94.0,482,04,01,  Islampur,158,244,82,121,76,123,39.3,40.4,38.2,00000
77.0,90.0,94.0,482,05,01,  Babuani Jote,266,237,142,123,124,114,52.9,53.6,52.1,00000
77.0,90.0,94.0,482,06,01,  Dargahsing,127,321,61,155,66,166,28.3,28.2,28.4,00000
77.0,90.0,94.0,482,07,01,  Khaikhat Para,294,374,152,190,142,184,44.0,44.4,43.6,00000
77.0,90.0,94.0,482,08,01,  Dam Gach,141,224,82,101,59,123,38.6,44.8,32.4,00000
77.0,90.0,94.0,723,01,01,  Najiragachh,189,217,84,113,105,104,46.6,42.6,50.2,00000
77.0,90.0,94.0,723,02,01,  Pradhan Para,222,253,118,127,104,126,46.7,48.2,45.2,00000
77.0,90.0,94.0,723,03,01,  Raushanpur,634,539,340,258,294,281,54.0,56.9,51.1,00000
77.0,90.0,94.0,723,04,01,  Islambagh,295,334,145,166,150,168,46.9,46.6,47.2,00000
77.0,90.0,94.0,723,05,01,  Guabari,281,216,132,104,149,112,56.5,55.9,57.1,00000
77.0,90.0,94.0,964,01,01,  Hakimpur,404,577,218,269,186,308,41.2,44.8,37.7,00000
77.0,90.0,94.0,964,02,01,  Mondol Para,344,246,187,110,157,136,58.3,63.0,53.6,00000
77.0,90.0,94.0,964,03,01,  Sarkar Para,79,60,42,24,37,36,56.8,63.6,50.7,00000
77.0,90.0,94.0,964,04,01,  Daulat Para,169,325,89,154,80,171,34.2,36.6,31.9,00000
77.0,90.0,94.0,964,05,01,  Bhaktidangi,16,43,7,24,9,19,27.1,22.6,32.1,00000
77.0,90.0,94.0,964,06,01,  Tirnai,129,200,62,105,67,95,39.2,37.1,41.4,00000
77.0,90.0,94.0,964,07,01,  Fakir Para,162,177,82,77,80,100,47.8,51.6,44.4,00000
77.0,90.0,94.0,964,08,01,  Danga Para,140,152,73,75,67,77,47.9,49.3,46.5,00000
77.0,90.0,94.0,964,09,01,  Alarbari,78,150,36,79,42,71,34.2,31.3,37.2,00000
77.0,90.0,94.0,964,10,01,  Dagarbari,396,514,217,224,179,290,43.5,49.2,38.2,00000
77.0,90.0,94.0,994,01,01,  Baksi Para,170,193,90,96,80,97,46.8,48.4,45.2,00000
77.0,90.0,94.0,994,02,01,  Jogigachh,482,681,241,336,241,345,41.4,41.8,41.1,00000
77.0,90.0,94.0,994,03,01,  Sonakandar,105,123,54,62,51,61,46.1,46.6,45.5,00000
77.0,90.0,94.0,994,04,01,  Talukbari,57,56,32,25,25,31,50.4,56.1,44.6,00000
77.0,90.0,94.0,994,05,01,  Bhola Jote,43,39,21,23,22,16,52.4,47.7,57.9,00000
77.0,90.0,94.0,994,06,01,  Shankar Para,136,197,71,90,65,107,40.8,44.1,37.8,00000
77.0,90.0,94.0,994,07,01,  Munigachh,148,122,82,50,66,72,54.8,62.1,47.8,00000
77.0,90.0,94.0,994,08,01,  Chuthutiagachh,213,183,130,88,83,95,53.8,59.6,46.6,00000
77.0,90.0,94.0,994,09,01,  Brahmatal,225,366,115,170,110,196,38.1,40.4,35.9,00000
85.0,3.0,18.0,153,01,01,  Asraf Uddiner Para,98,297,52,159,46,138,24.8,24.6,25.0,00000
85.0,3.0,18.0,153,02,01,  Abdur Rahimer Para,71,189,36,94,35,95,27.3,27.7,26.9,00000
85.0,3.0,18.0,153,03,01,  Danga Para,96,87,48,38,48,49,52.5,55.8,49.5,00000
85.0,3.0,18.0,153,04,01,  Koch Para,82,169,39,80,43,89,32.7,32.8,32.6,00000
85.0,3.0,18.0,153,05,01,  Bairagi Para,76,52,44,25,32,27,59.4,63.8,54.2,00000
85.0,3.0,18.0,153,06,01,  Sarkar Para,194,584,111,281,83,303,24.9,28.3,21.5,00000
85.0,3.0,18.0,153,07,01,  Sekar Para,68,325,39,160,29,165,17.3,19.6,14.9,00000
85.0,3.0,18.0,210,01,01,  Chowdhury Para,150,197,69,99,81,98,43.2,41.1,45.3,00000
85.0,3.0,18.0,210,02,01,  Teli Para,85,133,35,64,50,69,39.0,35.4,42.0,00000
85.0,3.0,18.0,210,03,01,  Pramanik Para,176,134,97,50,79,84,56.8,66.0,48.5,00000
85.0,3.0,18.0,210,04,01,  Dhar Para,60,242,29,123,31,119,19.9,19.1,20.7,00000
85.0,3.0,18.0,210,05,01,  Sardar Para,19,110,11,51,8,59,14.7,17.7,11.9,00000
85.0,3.0,18.0,210,06,01,  Chand Para,227,292,115,155,112,137,43.7,42.6,45.0,00000
85.0,3.0,18.0,210,07,01,  Kazi Para,227,182,117,86,110,96,55.5,57.6,53.4,00000
85.0,3.0,18.0,210,08,01,  Munshi Para,57,159,32,73,25,86,26.4,30.5,22.5,00000
85.0,3.0,18.0,210,09,01,  Dewan Para,228,303,121,137,107,166,42.9,46.9,39.2,00000
85.0,3.0,18.0,210,10,01,  Dafadar Para,70,59,35,27,35,32,54.3,56.5,52.2,00000
85.0,3.0,18.0,210,11,01,  Purbapara,140,205,76,91,64,114,40.6,45.5,36.0,00000
85.0,3.0,18.0,210,12,01,  Majh Para,174,384,87,193,87,191,31.2,31.1,31.3,00000
85.0,3.0,18.0,210,13,01,  Jola Para,183,137,91,70,92,67,57.2,56.5,57.9,00000
85.0,3.0,18.0,210,14,01,  Hari Para,22,70,12,29,10,41,23.9,29.3,19.6,00000
85.0,3.0,18.0,239,01,01,  Purbapara,133,250,74,120,59,130,34.7,38.1,31.2,00000
85.0,3.0,18.0,239,02,01,  Dalua,315,157,169,75,146,82,66.7,69.3,64.0,00000
85.0,3.0,18.0,487,01,01,  Baragharia,135,224,69,107,66,117,37.6,39.2,36.1,00000
85.0,3.0,18.0,487,02,01,  Sona Para,108,60,60,25,48,35,64.3,70.6,57.8,00000
85.0,3.0,18.0,487,03,01,  Guna Para,83,210,50,100,33,110,28.3,33.3,23.1,00000
85.0,3.0,18.0,487,04,01,  Mandal Para,269,106,141,57,128,49,71.7,71.2,72.3,00000
85.0,3.0,18.0,487,05,01,  Moyan Para,134,223,66,114,68,109,37.5,36.7,38.4,00000
85.0,3.0,18.0,487,06,01,  Bania Para,412,211,213,94,199,117,66.1,69.4,63.0,00000
85.0,3.0,18.0,487,07,01,  Gachua Para,44,38,22,17,22,21,53.7,56.4,51.2,00000
85.0,3.0,18.0,487,08,01,  Saha Para,155,109,80,50,75,59,58.7,61.5,56.0,00000
85.0,3.0,18.0,487,09,01,  Thatari Para,156,187,91,87,65,100,45.5,51.1,39.4,00000
85.0,3.0,18.0,487,10,01,  Jumma Para,114,93,61,41,53,52,55.1,59.8,50.5,00000
85.0,3.0,18.0,487,11,01,  Paschimpara,125,227,62,106,63,121,35.5,36.9,34.2,00000
85.0,3.0,25.0,353,01,01,  Gopalpur,871,1473,441,738,430,735,37.2,37.4,36.9,00000
85.0,3.0,25.0,353,02,01,  Uttar Gopalpur,876,1578,452,745,424,833,35.7,37.8,33.7,00000
85.0,3.0,31.0,363,01,01,  Station Para,276,130,128,52,148,78,68.0,71.1,65.5,00000
85.0,3.0,31.0,363,02,01,  Palpara,99,288,55,139,44,149,25.6,28.4,22.8,00000
85.0,3.0,31.0,363,03,01,  Ananda Para,68,68,36,34,32,34,50.0,51.4,48.5,00000
85.0,3.0,31.0,363,04,01,  Baroi Para,52,48,23,25,29,23,52.0,47.9,55.8,00000
85.0,3.0,31.0,363,05,01,  Acharuddin Para,113,216,60,113,53,103,34.3,34.7,34.0,00000
85.0,3.0,31.0,363,06,01,  Holli Para,174,225,93,104,81,121,43.6,47.2,40.1,00000
85.0,3.0,31.0,363,07,01,  Masna Para,134,215,66,108,68,107,38.4,37.9,38.9,00000
85.0,3.0,31.0,363,08,01,  Akhand Para,197,259,100,133,97,126,43.2,42.9,43.5,00000
85.0,3.0,31.0,363,09,01,  Ayarmari,334,286,189,130,145,156,53.9,59.2,48.2,00000
85.0,3.0,31.0,363,10,01,  Baragharia,183,231,102,115,81,116,44.2,47.0,41.1,00000
85.0,3.0,31.0,363,11,01,  Madhyapara,113,303,52,157,61,146,27.2,24.9,29.5,00000
85.0,3.0,31.0,363,12,01,  Paschimpara,169,580,73,299,96,281,22.6,19.6,25.5,00000
85.0,3.0,31.0,363,13,01,  Naya Para,137,594,71,281,66,313,18.7,20.2,17.4,00000
85.0,3.0,31.0,363,14,01,  Uttarpara,305,679,158,321,147,358,31.0,33.0,29.1,00000
85.0,3.0,31.0,363,15,01,  Thatari Para,200,257,104,126,96,131,43.8,45.2,42.3,00000
85.0,3.0,31.0,363,16,01,  Dakshinpara,275,523,146,237,129,286,34.5,38.1,31.1,00000
85.0,3.0,31.0,363,17,01,  Achar Para,120,139,65,67,55,72,46.3,49.2,43.3,00000
85.0,3.0,75.0,832,01,01,  Bairagi Para,402,330,224,143,178,187,54.9,61.0,48.8,00000
85.0,3.0,75.0,832,02,01,  Dhantala,324,351,177,177,147,174,48.0,50.0,45.8,00000
85.0,3.0,75.0,832,03,01,  Nowhakhali Para,326,473,160,218,166,255,40.8,42.3,39.4,00000
85.0,3.0,75.0,832,04,01,  Kaljani,81,305,47,148,34,157,21.0,24.1,17.8,00000
85.0,3.0,75.0,832,05,01,  Uttar Dala Para,202,218,114,109,88,109,48.1,51.1,44.7,00000
85.0,3.0,75.0,832,06,01,  Dala Para,106,266,59,136,47,130,28.5,30.3,26.6,00000
85.0,3.0,75.0,832,07,01,  Sonali Para,333,483,178,249,155,234,40.8,41.7,39.8,00000
85.0,3.0,75.0,832,08,01,  Kashiganj,615,873,344,442,271,431,41.3,43.8,38.6,00000
85.0,3.0,75.0,832,09,01,  Mothkhola,383,391,214,180,169,211,49.5,54.3,44.5,00000
85.0,3.0,75.0,832,10,01,  Bogura Para,173,688,88,350,85,338,20.1,20.1,20.1,00000
85.0,3.0,75.0,832,11,01,  Dakshin Dala Para,507,312,256,136,251,176,61.9,65.3,58.8,00000
85.0,27.0,19.0,136,01,01,  Purba Barabil,3128,3506,1635,1621,1493,1885,47.2,50.2,44.2,00000
85.0,27.0,19.0,136,02,01,  Paschim Barabil,1216,1255,649,595,567,660,49.2,52.2,46.2,00000
85.0,27.0,19.0,994,01,01,  Uttar Pana Pukur,999,1309,504,664,495,645,43.3,43.2,43.4,00000
85.0,27.0,19.0,994,02,01,  Uttar Pana Pukur Giri,1428,1840,760,882,668,958,43.7,46.3,41.1,00000
85.0,27.0,21.0,027,01,01,  Dashani Aldadpur,227,588,132,269,95,319,27.9,32.9,22.9,00000
85.0,27.0,21.0,027,02,01,  Jot Aldadpur,335,449,185,198,150,251,42.7,48.3,37.4,00000
85.0,27.0,21.0,027,03,01,  Chhayani Aldadpur,409,600,238,271,171,329,40.5,46.8,34.2,00000
85.0,27.0,21.0,149,01,01,  Madhya Betgari,856,1546,476,714,380,832,35.6,40.0,31.4,00000
85.0,27.0,21.0,149,02,01,  Dakshin Betgari,1369,1225,760,604,609,621,52.8,55.7,49.5,00000
85.0,27.0,21.0,517,01,01,  Purba Khaprikhal,352,529,174,240,178,289,40.0,42.0,38.1,00000
85.0,27.0,21.0,517,02,01,  Paschim Khaprikhal,613,1447,378,727,235,720,29.8,34.2,24.6,00000
85.0,27.0,21.0,804,01,01,  Peruladaha Baniapara,390,359,202,159,188,200,52.1,56.0,48.5,00000
85.0,27.0,21.0,804,02,01,  Sarkar Para,229,390,112,192,117,198,37.0,36.8,37.1,00000
85.0,27.0,52.0,422,01,01,  Fakirtari And Thakurta,197,143,102,70,95,73,57.9,59.3,56.5,00000
85.0,27.0,52.0,422,02,01,  Kachutari,128,121,59,61,69,60,51.4,49.2,53.5,00000
85.0,27.0,52.0,422,03,01,  Chowratari,122,160,59,76,63,84,43.3,43.7,42.9,00000
85.0,27.0,52.0,422,04,01,  Nonitari,232,312,106,150,126,162,42.6,41.4,43.8,00000
85.0,27.0,52.0,613,01,01,  Shalbari,613,1298,338,605,275,693,32.1,35.8,28.4,00000
85.0,27.0,52.0,613,02,01,  Bhinna Jagat,114,443,60,223,54,220,20.5,21.2,19.7,00000
85.0,27.0,52.0,613,03,01,  Sarkar Tari,330,508,181,235,149,273,39.4,43.5,35.3,00000
85.0,27.0,52.0,613,04,01,  Shalya Sha Para,696,714,374,331,322,383,49.4,53.0,45.7,00000
85.0,27.0,52.0,817,01,01,  Thakur Para And Tati T,203,543,114,250,89,293,27.2,31.3,23.3,00000
85.0,27.0,52.0,817,02,01,  Uttarpara,283,604,139,299,144,305,31.9,31.7,32.1,00000
85.0,27.0,52.0,817,03,01,  Paschimpara,300,229,167,97,133,132,56.7,63.3,50.2,00000
85.0,27.0,52.0,817,04,01,  Patan Tari,385,301,212,120,173,181,56.1,63.9,48.9,00000
85.0,27.0,52.0,817,05,01,  Birabaari And Upartala,170,293,92,140,78,153,36.7,39.7,33.8,00000
85.0,27.0,52.0,967,01,01,  Narair Dargah,876,878,462,425,414,453,49.9,52.1,47.8,00000
85.0,27.0,52.0,967,02,01,  Dalalertari,1236,1104,708,512,528,592,52.8,58.0,47.1,00000
85.0,27.0,52.0,967,03,01,  Sardarpara,390,286,201,132,189,154,57.7,60.4,55.1,00000
85.0,27.0,52.0,967,04,01,  Mollahtari,939,796,473,386,466,410,54.1,55.1,53.2,00000
85.0,27.0,73.0,449,01,01,  Purba Ichli,459,1009,259,503,200,506,31.3,34.0,28.3,00000
85.0,27.0,73.0,449,02,01,  Paschim Ichli,659,1101,370,539,289,562,37.4,40.7,34.0,00000
85.0,27.0,73.0,626,01,01,  Dakshin Mahipur,1345,878,719,373,626,505,60.5,65.8,55.3,00000
85.0,27.0,73.0,626,02,01,  Purba Mahipur,1084,840,564,393,520,447,56.3,58.9,53.8,00000
85.0,27.0,73.0,626,03,01,  Paschim Mahipur,1016,713,510,305,506,408,58.8,62.6,55.4,00000
85.0,27.0,84.0,109,01,01,  Khamar Kumartari,557,849,303,393,254,456,39.6,43.5,35.8,00000
85.0,27.0,84.0,109,02,01,  Khalifar Bazar,223,505,117,227,106,278,30.6,34.0,27.6,00000
85.0,27.0,84.0,122,01,01,  Jamchora,226,152,122,70,104,82,59.8,63.5,55.9,00000
85.0,27.0,84.0,122,02,01,  Kagji Para,239,235,127,108,112,127,50.4,54.0,46.9,00000
85.0,27.0,84.0,122,03,01,  Hindu Para,335,390,175,190,160,200,46.2,47.9,44.4,00000
85.0,27.0,84.0,272,01,01,  Telitari,207,262,103,129,104,133,44.1,44.4,43.9,00000
85.0,27.0,84.0,272,02,01,  Guati Para,161,277,88,139,73,138,36.8,38.8,34.6,00000
85.0,27.0,84.0,272,03,01,  Naya Tari,211,544,102,264,109,280,27.9,27.9,28.0,00000
85.0,27.0,84.0,272,04,01,  Panga,257,449,131,222,126,227,36.4,37.1,35.7,00000
85.0,27.0,84.0,504,01,01,  Kamdeb,268,629,157,314,111,315,29.9,33.3,26.1,00000
85.0,27.0,84.0,504,02,01,  Sekh Para,393,389,207,181,186,208,50.3,53.4,47.2,00000
85.0,27.0,84.0,722,01,01,  Uttar Maubhasa,347,361,190,156,157,205,49.0,54.9,43.4,00000
85.0,27.0,84.0,722,02,01,  Dakshin Maubhasa,625,1141,343,565,282,576,35.4,37.8,32.9,00000
85.0,27.0,84.0,722,03,01,  Baldi Pukur,324,416,171,172,153,244,43.8,49.9,38.5,00000
85.0,27.0,84.0,722,04,01,  Munshitari,284,362,150,168,134,194,44.0,47.2,40.9,00000
85.0,27.0,84.0,722,05,01,  Bamonertari,145,565,80,280,65,285,20.4,22.2,18.6,00000
85.0,27.0,84.0,722,06,01,  Lakhrajtari,268,358,135,165,133,193,42.8,45.0,40.8,00000
85.0,27.0,84.0,722,07,01,  Bangaljhar,229,487,125,223,104,264,32.0,35.9,28.3,00000
85.0,42.0,23.0,646,01,01,  Char Nazirdaha,600,1880,342,943,258,937,24.2,26.6,21.6,00000
85.0,42.0,23.0,646,02,01,  Danga Nazir Dha,641,1203,343,561,298,642,34.8,37.9,31.7,00000
85.0,42.0,23.0,646,03,01,  Chak Ropani,835,1238,448,611,387,627,40.3,42.3,38.2,00000
85.0,42.0,23.0,646,04,01,  Basunia Para,1120,2356,587,1086,533,1270,32.2,35.1,29.6,00000
85.0,42.0,23.0,646,05,01,  Nazirdaha (Chit),253,1107,144,560,109,547,18.6,20.5,16.6,00000
85.0,42.0,67.0,820,01,01,  Bir Sabdi,1320,1626,697,748,623,878,44.8,48.2,41.5,00000
85.0,42.0,67.0,820,02,01,  Char Sabdi,407,1059,221,484,186,575,27.8,31.3,24.4,00000
85.0,49.0,17.0,013,01,01,  Fakirtari,265,324,123,173,142,151,45.0,41.6,48.5,00000
85.0,49.0,17.0,013,02,01,  Jharuatari,404,461,218,236,186,225,46.7,48.0,45.3,00000
85.0,49.0,17.0,106,01,01,  Mandal Para,230,262,99,139,131,123,46.7,41.6,51.6,00000
85.0,49.0,17.0,106,02,01,  Uttar Baikunthapur,555,710,261,361,294,349,43.9,42.0,45.7,00000
85.0,49.0,17.0,106,03,01,  Panati Para,106,187,62,97,44,90,36.2,39.0,32.8,00000
85.0,49.0,17.0,247,01,01,  Dangirpar,478,580,253,287,225,293,45.2,46.9,43.4,00000
85.0,49.0,17.0,247,02,01,  Madhya Para,843,715,401,339,442,376,54.1,54.2,54.0,00000
85.0,49.0,17.0,247,03,01,  Matia Para,190,153,100,64,90,89,55.4,61.0,50.3,00000
85.0,49.0,17.0,247,04,01,  Baman Para,361,409,182,201,179,208,46.9,47.5,46.3,00000
85.0,49.0,17.0,247,05,01,  Shit Chandanpat,170,222,89,128,81,94,43.4,41.0,46.3,00000
85.0,49.0,17.0,420,01,01,  Purbapara,433,558,213,284,220,274,43.7,42.9,44.5,00000
85.0,49.0,17.0,420,02,01,  Dakshinpara,299,168,132,80,167,88,64.0,62.3,65.5,00000
85.0,49.0,17.0,460,01,01,  Zola Para,371,501,172,265,199,236,42.5,39.4,45.7,00000
85.0,49.0,17.0,460,02,01,  Ishwarpur,349,434,180,204,169,230,44.6,46.9,42.4,00000
85.0,49.0,17.0,460,03,01,  Nuni Pukur,1046,1250,498,634,548,616,45.6,44.0,47.1,00000
85.0,49.0,17.0,460,04,01,  Kholahati,553,724,256,374,297,350,43.3,40.6,45.9,00000
85.0,49.0,17.0,460,05,01,  Naya Para,258,286,126,156,132,130,47.4,44.7,50.4,00000
85.0,49.0,17.0,467,01,01,  Deonda Para,459,525,241,278,218,247,46.6,46.4,46.9,00000
85.0,49.0,17.0,467,02,01,  Hindu Para,200,114,119,58,81,56,63.7,67.2,59.1,00000
85.0,49.0,17.0,480,01,01,  Bhabanipur,176,185,78,91,98,94,48.8,46.2,51.0,00000
85.0,49.0,17.0,480,02,01,  Jalkaria,537,481,264,246,273,235,52.8,51.8,53.7,00000
85.0,49.0,17.0,874,01,01,  Dactar Para,366,487,197,229,169,258,42.9,46.2,39.6,00000
85.0,49.0,17.0,874,02,01,  Kalar Khamar,429,918,228,466,201,452,31.8,32.9,30.8,00000
85.0,49.0,17.0,874,03,01,  Kashipur,552,353,285,159,267,194,61.0,64.2,57.9,00000
85.0,49.0,17.0,874,04,01,  Chatta Para,527,664,286,349,241,315,44.2,45.0,43.3,00000
85.0,49.0,17.0,928,01,01,  Balatari,343,464,188,215,155,249,42.5,46.7,38.4,00000
85.0,49.0,17.0,928,02,01,  Kona Para,264,198,128,99,136,99,57.1,56.4,57.9,00000
85.0,49.0,17.0,928,03,01,  Sreerampur,303,401,140,215,163,186,43.0,39.4,46.7,00000
85.0,49.0,17.0,934,01,01,  Saha Para,386,398,194,195,192,203,49.2,49.9,48.6,00000
85.0,49.0,17.0,934,02,01,  Khailla Para,507,563,250,289,257,274,47.4,46.4,48.4,00000
85.0,49.0,17.0,934,03,01,  College Para,421,305,225,147,196,158,58.0,60.5,55.4,00000
85.0,49.0,17.0,934,04,01,  Bania Para,208,156,106,61,102,95,57.1,63.5,51.8,00000
85.0,49.0,17.0,934,05,01,  Putimari,720,770,343,379,377,391,48.3,47.5,49.1,00000
85.0,49.0,17.0,981,01,01,  Paschimpara,198,191,109,84,89,107,50.9,56.5,45.4,00000
85.0,49.0,17.0,981,02,01,  Purbapara,122,160,71,79,51,81,43.3,47.3,38.6,00000
85.0,49.0,19.0,721,01,01,  Purba Nazir Digar,724,505,368,244,356,261,58.9,60.1,57.7,00000
85.0,49.0,19.0,721,02,01,  Paschim Nazir Digar,1266,1125,612,600,654,525,52.9,50.5,55.5,00000
85.0,49.0,23.0,053,01,01,  Hazra Para,159,268,82,120,77,148,37.2,40.6,34.2,00000
85.0,49.0,23.0,053,02,01,  Thakur Para (Nather Para),339,235,188,96,151,139,59.1,66.2,52.1,00000
85.0,49.0,23.0,333,01,01,  Bala Para,167,194,81,95,86,99,46.3,46.0,46.5,00000
85.0,49.0,23.0,333,02,01,  Purba Fakiran,552,722,288,350,264,372,43.3,45.1,41.5,00000
85.0,49.0,23.0,333,03,01,  Kerani Para,410,357,209,157,201,200,53.5,57.1,50.1,00000
85.0,49.0,23.0,360,01,01,  Tot Para,245,307,131,138,114,169,44.4,48.7,40.3,00000
85.0,49.0,23.0,360,02,01,  Darabi Para (Dabri Para),210,317,106,162,104,155,39.8,39.6,40.2,00000
85.0,49.0,23.0,360,03,01,  Madhyapara,218,240,114,102,104,138,47.6,52.8,43.0,00000
85.0,49.0,23.0,360,04,01,  Bazar Para,551,543,277,239,274,304,50.4,53.7,47.4,00000
85.0,49.0,23.0,380,01,01,  Uttar Gokulpur (1),2001,1560,1055,754,946,806,56.2,58.3,54.0,00000
85.0,49.0,23.0,380,02,01,  Dakshin Gokulpur (2),1567,981,843,452,724,529,61.5,65.1,57.8,00000
85.0,49.0,23.0,414,01,01,  Uttar Haridebpur,711,979,347,482,364,497,42.1,41.9,42.3,00000
85.0,49.0,23.0,414,02,01,  Dakshin Haridebpur,1103,1771,538,879,565,892,38.4,38.0,38.8,00000
85.0,49.0,23.0,414,03,01,  Majhi Para,163,330,82,164,81,166,33.1,33.3,32.8,00000
85.0,49.0,23.0,414,04,01,  Kamar Para,112,175,42,89,70,86,39.0,32.1,44.9,00000
85.0,49.0,23.0,634,01,01,  Teli Para,300,435,162,223,138,212,40.8,42.1,39.4,00000
85.0,49.0,23.0,634,02,01,  Baksi Para,934,915,481,446,453,469,50.5,51.9,49.1,00000
85.0,49.0,23.0,634,03,01,  Bairagi Para,728,568,383,277,345,291,56.2,58.0,54.2,00000
85.0,49.0,23.0,687,01,01,  Jola Para,319,493,173,243,146,250,39.3,41.6,36.9,00000
85.0,49.0,23.0,687,02,01,  Patbari (Mandal Para),934,1298,506,613,428,685,41.8,45.2,38.5,00000
85.0,49.0,23.0,868,01,01,  Bania Para,583,932,289,491,294,441,38.5,37.1,40.0,00000
85.0,49.0,23.0,868,02,01,  Pirpara,168,228,84,107,84,121,42.4,44.0,41.0,00000
85.0,49.0,23.0,868,03,01,  Dakshinpara,141,297,49,148,92,149,32.2,24.9,38.2,00000
85.0,49.0,23.0,868,04,01,  Purbapara,618,721,335,345,283,376,46.2,49.3,42.9,00000
85.0,49.0,23.0,868,05,01,  Dalal Para,411,432,207,220,204,212,48.8,48.5,49.0,00000
85.0,49.0,23.0,868,06,01,  Derhalia,133,243,65,129,68,114,35.4,33.5,37.4,00000
85.0,49.0,31.0,280,01,01,  Laskar Para,381,639,215,333,166,306,37.4,39.2,35.2,00000
85.0,49.0,31.0,280,02,01,  Moktar Para,747,664,405,299,342,365,52.9,57.5,48.4,00000
85.0,49.0,31.0,280,03,01,  Dargar Para,143,286,79,136,64,150,33.3,36.7,29.9,00000
85.0,49.0,31.0,280,04,01,  Boramosgid+Hat Para,430,296,229,135,201,161,59.2,62.9,55.5,00000
85.0,49.0,31.0,280,05,01,  Master Para,89,174,45,83,44,91,33.8,35.2,32.6,00000
85.0,49.0,31.0,280,08,01,  Bara Masjid Hat,203,203,109,87,94,116,50.0,55.6,44.8,00000
85.0,49.0,31.0,280,09,01,  Sardar Para,239,300,128,136,111,164,44.3,48.5,40.4,00000
85.0,49.0,31.0,280,10,01,  Palpara,158,335,81,162,77,173,32.0,33.3,30.8,00000
85.0,49.0,31.0,280,11,01,  Kotali Para,149,242,86,108,63,134,38.1,44.3,32.0,00000
85.0,49.0,31.0,280,12,01,  Bania Para,553,936,280,458,273,478,37.1,37.9,36.4,00000
85.0,49.0,31.0,494,01,01,  Khaliler Para,173,210,87,104,86,106,45.2,45.5,44.8,00000
85.0,49.0,31.0,494,02,01,  Maler Para,98,216,37,109,61,107,31.2,25.3,36.3,00000
85.0,49.0,31.0,494,03,01,  Khorir Para,96,234,53,107,43,127,29.1,33.1,25.3,00000
85.0,49.0,31.0,494,04,01,  Mohammader Para,220,531,118,263,102,268,29.3,31.0,27.6,00000
85.0,49.0,31.0,494,05,01,  Pacham Para,197,202,111,89,86,113,49.4,55.5,43.2,00000
85.0,49.0,31.0,560,01,01,  Chowdhury Para,298,215,167,86,131,129,58.1,66.0,50.4,00000
85.0,49.0,31.0,560,02,01,  Kari Para,128,295,69,137,59,158,30.3,33.5,27.2,00000
85.0,49.0,31.0,560,03,01,  Nasir Uddin Para,157,209,87,104,70,105,42.9,45.5,40.0,00000
85.0,49.0,31.0,560,04,01,  Kadamtali,113,233,59,119,54,114,32.7,33.1,32.1,00000
85.0,49.0,31.0,560,05,01,  Sardar Para,230,563,111,279,119,284,29.0,28.5,29.5,00000
85.0,49.0,31.0,560,06,01,  Kalir Para,384,387,189,186,195,201,49.8,50.4,49.2,00000
85.0,49.0,31.0,614,01,01,  Jumma Para,255,720,140,349,115,371,26.2,28.6,23.7,00000
85.0,49.0,31.0,614,02,01,  Darji Para,309,557,169,275,140,282,35.7,38.1,33.2,00000
85.0,49.0,31.0,614,03,01,  Bala Para,275,587,155,292,120,295,31.9,34.7,28.9,00000
85.0,49.0,31.0,614,04,01,  Purba Jumma Para,357,646,174,320,183,326,35.6,35.2,36.0,00000
85.0,49.0,31.0,614,05,01,  Uttarpara,145,295,84,137,61,158,33.0,38.0,27.9,00000
85.0,49.0,31.0,641,01,01,  Barabari,157,224,85,98,72,126,41.2,46.4,36.4,00000
85.0,49.0,31.0,641,02,01,  Pashari Para,328,435,168,216,160,219,43.0,43.8,42.2,00000
85.0,49.0,31.0,641,03,01,  Haji Para,101,275,48,137,53,138,26.9,25.9,27.7,00000
85.0,49.0,31.0,994,01,01,  Bara Mutukpur,665,744,342,384,323,360,47.2,47.1,47.3,00000
85.0,49.0,31.0,994,02,01,  Chhota Mutukpur,550,403,287,183,263,220,57.7,61.1,54.5,00000
85.0,49.0,31.0,994,03,01,  Haji Para (Mahatab Par,118,368,59,182,59,186,24.3,24.5,24.1,00000
85.0,49.0,31.0,994,04,01,  Chilmari Para,264,340,155,160,109,180,43.7,49.2,37.7,00000
85.0,49.0,31.0,994,05,01,  Pochar Para+Ashan Para,61,238,39,120,22,118,20.4,24.5,15.7,00000
85.0,49.0,31.0,994,06,01,  Chowdhury Para,206,231,110,113,96,118,47.1,49.3,44.9,00000
85.0,49.0,31.0,994,07,01,  Miah Ullar Para,219,72,107,38,112,34,75.3,73.8,76.7,00000
85.0,49.0,31.0,994,08,01,  Ahsan Para,4,72,3,36,1,36,5.3,7.7,2.7,00000
85.0,49.0,31.0,994,09,01,  Naya Para (Hindu Para),181,87,90,43,91,44,67.5,67.7,67.4,00000
85.0,49.0,31.0,994,10,01,  Chankuti And Sarkar Pa,305,1204,169,587,136,617,20.2,22.4,18.1,00000
85.0,49.0,47.0,120,01,01,  Ghaterpar,538,218,279,91,259,127,71.2,75.4,67.1,00000
85.0,49.0,47.0,120,02,01,  Pascim Para,756,409,415,170,341,239,64.9,70.9,58.8,00000
85.0,49.0,47.0,120,03,01,  Darogarbari,694,475,355,206,339,269,59.4,63.3,55.8,00000
85.0,49.0,47.0,120,04,01,  Masua Para,248,470,125,234,123,236,34.5,34.8,34.3,00000
85.0,49.0,47.0,186,01,01,  Dalalitari,383,274,209,127,174,147,58.3,62.2,54.2,00000
85.0,49.0,47.0,186,02,01,  Purba Binnatari,550,268,269,141,281,127,67.2,65.6,68.9,00000
85.0,49.0,47.0,186,03,01,  Dakshin Binnatari,487,320,265,152,222,168,60.3,63.5,56.9,00000
85.0,49.0,47.0,186,04,01,  Binnatari Hindu Para,422,237,215,103,207,134,64.0,67.6,60.7,00000
85.0,49.0,47.0,186,05,01,  Mirpara,201,124,103,66,98,58,61.8,60.9,62.8,00000
85.0,49.0,47.0,186,06,01,  Madha Para,493,277,252,136,241,141,64.0,64.9,63.1,00000
85.0,49.0,47.0,474,01,01,  Purba Jagadishpur,208,220,134,123,74,97,48.6,52.1,43.3,00000
85.0,49.0,47.0,474,02,01,  Khorder Tari,613,799,304,387,309,412,43.4,44.0,42.9,00000
85.0,49.0,47.0,474,03,01,  Hindu Para,521,635,276,298,245,337,45.1,48.1,42.1,00000
85.0,49.0,47.0,474,04,01,  Chowdhury Para,625,583,330,269,295,314,51.7,55.1,48.4,00000
85.0,49.0,47.0,527,01,01,  Dakshin Kamdebpur,600,1037,342,457,258,580,36.7,42.8,30.8,00000
85.0,49.0,47.0,527,02,01,  Uttar Kamdebpur,407,451,208,239,199,212,47.4,46.5,48.4,00000
85.0,49.0,47.0,808,01,01,  Bagicha,549,459,302,216,247,243,54.5,58.3,50.4,00000
85.0,49.0,47.0,808,02,01,  Najirhat,404,427,213,186,191,241,48.6,53.4,44.2,00000
85.0,49.0,47.0,808,03,01,  Paschim Radhakrishnapu,542,256,276,115,266,141,67.9,70.6,65.4,00000
85.0,49.0,47.0,808,04,01,  Baksitari,490,318,253,144,237,174,60.6,63.7,57.7,00000
85.0,49.0,63.0,180,01,01,  Uttarpara,312,555,144,295,168,260,36.0,32.8,39.3,00000
85.0,49.0,63.0,180,02,01,  Dakshinpara,423,651,203,331,220,320,39.4,38.0,40.7,00000
85.0,49.0,63.0,273,01,01,  Sing Para,235,218,125,103,110,115,51.9,54.8,48.9,00000
85.0,49.0,63.0,273,02,01,  Munshi Para,275,453,128,220,147,233,37.8,36.8,38.7,00000
85.0,49.0,63.0,327,01,01,  Majhi Para,98,422,45,214,53,208,18.8,17.4,20.3,00000
85.0,49.0,63.0,327,02,01,  Maroltari,258,308,133,157,125,151,45.6,45.9,45.3,00000
85.0,49.0,63.0,340,01,01,  Bhatia Para,195,197,99,82,96,115,49.7,54.7,45.5,00000
85.0,49.0,63.0,340,02,01,  Munshi Para,183,204,97,98,86,106,47.3,49.7,44.8,00000
85.0,49.0,63.0,340,03,01,  Bagurai Para,271,257,142,120,129,137,51.3,54.2,48.5,00000
85.0,49.0,63.0,340,04,01,  Hindu Para,557,569,294,271,263,298,49.5,52.0,46.9,00000
85.0,49.0,63.0,340,05,01,  Fatehpur,792,1229,402,630,390,599,39.2,39.0,39.4,00000
85.0,49.0,63.0,347,01,01,  Paschimpara,442,688,205,360,237,328,39.1,36.3,41.9,00000
85.0,49.0,63.0,347,02,01,  Charani Para,191,187,91,103,100,84,50.5,46.9,54.3,00000
85.0,49.0,63.0,487,01,01,  Dhaperhat,640,379,320,181,320,198,62.8,63.9,61.8,00000
85.0,49.0,63.0,487,02,01,  Hazrat Para,118,171,50,86,68,85,40.8,36.8,44.4,00000
85.0,49.0,63.0,487,03,01,  Ghuria Khal,184,205,102,100,82,105,47.3,50.5,43.9,00000
85.0,49.0,63.0,487,04,01,  Majhi Para,176,170,102,73,74,97,50.9,58.3,43.3,00000
85.0,49.0,63.0,487,05,01,  Panbari,391,403,187,211,204,192,49.2,47.0,51.5,00000
85.0,49.0,63.0,487,06,01,  Gouati Para,528,807,262,407,266,400,39.6,39.2,39.9,00000
85.0,49.0,63.0,507,01,01,  Purbapara,434,960,192,502,242,458,31.1,27.7,34.6,00000
85.0,49.0,63.0,507,02,01,  Paschimpara,940,1767,471,886,469,881,34.7,34.7,34.7,00000
85.0,49.0,63.0,507,03,01,  Bania Para,682,619,338,327,344,292,52.4,50.8,54.1,00000
85.0,49.0,63.0,507,04,01,  Thatari Para,135,261,66,148,69,113,34.1,30.8,37.9,00000
85.0,49.0,63.0,621,01,01,  Uttar And Dakshinpara,171,186,93,79,78,107,47.9,54.1,42.2,00000
85.0,49.0,63.0,621,02,01,  Paschimpara,407,442,207,210,200,232,47.9,49.6,46.3,00000
85.0,49.0,63.0,747,01,01,  Bakshi Para,363,241,181,85,182,156,60.1,68.0,53.8,00000
85.0,49.0,63.0,747,02,01,  Rauhair Para,121,157,59,84,62,73,43.5,41.3,45.9,00000
85.0,49.0,63.0,747,03,01,  Karani Para & Hazi Para,661,1157,305,613,356,544,36.4,33.2,39.6,00000
85.0,49.0,63.0,747,04,01,  Dakshinpara,237,287,106,139,131,148,45.2,43.3,47.0,00000
85.0,49.0,63.0,747,05,01,  Dola Para,172,322,89,163,83,159,34.8,35.3,34.3,00000
85.0,49.0,63.0,747,06,01,  Miah Para,295,210,155,98,140,112,58.4,61.3,55.6,00000
85.0,49.0,63.0,747,07,01,  Balua Para,439,574,201,309,238,265,43.3,39.4,47.3,00000
85.0,49.0,63.0,747,08,01,  Madhyapara,420,562,211,284,209,278,42.8,42.6,42.9,00000
85.0,49.0,63.0,841,01,01,  Moulvi Para,199,166,104,90,95,76,54.5,53.6,55.6,00000
85.0,49.0,63.0,841,02,01,  Mandal Para,234,266,108,142,126,124,46.8,43.2,50.4,00000
85.0,49.0,63.0,841,03,01,  Dalal Para,207,212,97,119,110,93,49.4,44.9,54.2,00000
85.0,49.0,63.0,841,04,01,  Dakshinpara,319,664,158,314,161,350,32.5,33.5,31.5,00000
85.0,49.0,63.0,881,01,01,  Katabari & Mali Para,991,825,514,397,477,428,54.6,56.4,52.7,00000
85.0,49.0,63.0,881,02,01,  Joyram,222,320,99,166,123,154,41.0,37.4,44.4,00000
85.0,49.0,63.0,881,03,01,  Dabrirpar,176,234,92,106,84,128,42.9,46.5,39.6,00000
85.0,49.0,63.0,881,04,01,  Baman Para,144,252,78,128,66,124,36.4,37.9,34.7,00000
85.0,49.0,63.0,881,05,01,  Noakhali Para & Kagoji,168,270,75,138,93,132,38.4,35.2,41.3,00000
85.0,49.0,63.0,881,06,01,  Bara Bhita,167,234,75,112,92,122,41.6,40.1,43.0,00000
85.0,49.0,63.0,921,01,01,  Bhorat,194,199,96,115,98,84,49.4,45.5,53.8,00000
85.0,49.0,63.0,921,02,01,  Dararpar,164,167,76,92,88,75,49.5,45.2,54.0,00000
85.0,49.0,63.0,921,03,01,  Napit Para,119,229,58,122,61,107,34.2,32.2,36.3,00000
85.0,49.0,63.0,921,04,01,  Madhyapara,301,400,156,212,145,188,42.9,42.4,43.5,00000
85.0,49.0,71.0,313,01,01,  Nekartari,494,597,246,277,248,320,45.3,47.0,43.7,00000
85.0,49.0,71.0,313,02,01,  Madhyapara,818,677,439,340,379,337,54.7,56.4,52.9,00000
85.0,49.0,71.0,313,03,01,  Patan Para,917,695,469,358,448,337,56.9,56.7,57.1,00000
85.0,49.0,71.0,313,04,01,  Kamar Para,526,335,265,165,261,170,61.1,61.6,60.6,00000
85.0,49.0,71.0,313,05,01,  Bania Para,544,362,269,165,275,197,60.0,62.0,58.3,00000
85.0,49.0,71.0,313,06,01,  Paiker Tari,369,249,200,116,169,133,59.7,63.3,56.0,00000
85.0,49.0,71.0,313,07,01,  Dangir Para,882,575,457,296,425,279,60.5,60.7,60.4,00000
85.0,49.0,71.0,681,01,01,  Munshi Para,232,165,111,82,121,83,58.4,57.5,59.3,00000
85.0,49.0,71.0,681,02,01,  Madhyapara,472,360,244,183,228,177,56.7,57.1,56.3,00000
85.0,49.0,71.0,681,03,01,  Paschimpara,227,215,106,113,121,102,51.4,48.4,54.3,00000
85.0,49.0,71.0,681,04,01,  Shingimari,168,222,84,114,84,108,43.1,42.4,43.8,00000
85.0,49.0,71.0,681,05,01,  Chowli Para,360,101,185,42,175,59,78.1,81.5,74.8,00000
85.0,49.0,71.0,681,06,01,  Uttarpara,311,349,160,177,151,172,47.1,47.5,46.7,00000
85.0,49.0,71.0,787,01,01,  Dangir Para,857,401,462,170,395,231,68.1,73.1,63.1,00000
85.0,49.0,71.0,787,02,01,  Sarkar Para,847,539,410,255,437,284,61.1,61.7,60.6,00000
85.0,49.0,71.0,787,03,01,  Faria Para,1337,1204,656,597,681,607,52.6,52.4,52.9,00000
85.0,49.0,71.0,787,04,01,  Jogi Para,1476,788,717,387,759,401,65.2,64.9,65.4,00000
85.0,49.0,71.0,787,05,01,  Bepari Para,809,345,404,170,405,175,70.1,70.4,69.8,00000
85.0,49.0,79.0,086,01,01,  Munshi Para,303,396,141,208,162,188,43.3,40.4,46.3,00000
85.0,49.0,79.0,086,02,01,  Tali Para,295,182,164,80,131,102,61.8,67.2,56.2,00000
85.0,49.0,79.0,086,03,01,  Saha Para,515,357,267,152,248,205,59.1,63.7,54.7,00000
85.0,49.0,79.0,086,04,01,  Madhyapara,319,160,170,72,149,88,66.6,70.2,62.9,00000
85.0,49.0,79.0,086,05,01,  Jola Para,201,154,103,81,98,73,56.6,56.0,57.3,00000
85.0,49.0,79.0,086,06,01,  Thatari Para,296,154,160,72,136,82,65.8,69.0,62.4,00000
85.0,49.0,79.0,086,07,01,  Hindu Para,243,185,134,74,109,111,56.8,64.4,49.5,00000
85.0,49.0,79.0,454,01,01,  Bogurai Para,445,431,225,202,220,229,50.8,52.7,49.0,00000
85.0,49.0,79.0,454,02,01,  Hindu Para,141,322,74,166,67,156,30.5,30.8,30.0,00000
85.0,49.0,79.0,661,01,01,  Purba Mandira,405,279,221,123,184,156,59.2,64.2,54.1,00000
85.0,49.0,79.0,661,02,01,  Paschim Mandira,358,153,187,70,171,83,70.1,72.8,67.3,00000
85.0,49.0,79.0,661,03,01,  Madhya Mandira,421,386,211,185,210,201,52.2,53.3,51.1,00000
85.0,49.0,79.0,661,04,01,  Uttar Mandira,262,127,128,60,134,67,67.4,68.1,66.7,00000
85.0,49.0,79.0,661,05,01,  Dakshin Mandira,230,136,114,54,116,82,62.8,67.9,58.6,00000
85.0,49.0,79.0,694,01,01,  Baniatari,139,108,75,51,64,57,56.3,59.5,52.9,00000
85.0,49.0,79.0,694,02,01,  Bola Para,270,330,137,153,133,177,45.0,47.2,42.9,00000
85.0,49.0,79.0,694,03,01,  Madhyapara,521,267,253,112,268,155,66.1,69.3,63.4,00000
85.0,49.0,79.0,694,04,01,  Kona Para(Madorasha Para),378,230,191,109,187,121,62.2,63.7,60.7,00000
85.0,49.0,79.0,694,05,01,  Bedoa Para(Sundar Para),121,194,60,101,61,93,38.4,37.3,39.6,00000
85.0,49.0,79.0,694,06,01,  Nayatari,204,224,92,117,112,107,47.7,44.0,51.1,00000
85.0,49.0,79.0,694,07,01,  Pathantari,143,145,68,72,75,73,49.7,48.6,50.7,00000
85.0,49.0,79.0,954,01,01,  Milan Para (Masjid Par,988,476,535,213,453,263,67.5,71.5,63.3,00000
85.0,49.0,79.0,954,02,01,  Baro Aulia,1149,701,573,350,576,351,62.1,62.1,62.1,00000
85.0,49.0,79.0,954,03,01,  Sardar Para,349,133,183,61,166,72,72.4,75.0,69.7,00000
85.0,49.0,79.0,954,04,01,  Lakshman Para,662,406,350,195,312,211,62.0,64.2,59.7,00000
85.0,49.0,79.0,954,06,01,  Baman Para,408,214,198,87,210,127,65.6,69.5,62.3,00000
85.0,49.0,79.0,954,07,01,  Kabiraj Para,247,118,123,49,124,69,67.7,71.5,64.2,00000
85.0,49.0,79.0,954,08,01,  Dola Para,716,254,393,127,323,127,73.8,75.6,71.8,00000
85.0,49.0,79.0,961,01,01,  Basunia Para,215,208,109,105,106,103,50.8,50.9,50.7,00000
85.0,49.0,79.0,961,02,01,  Bhatia Para,199,166,102,79,97,87,54.5,56.4,52.7,00000
85.0,49.0,94.0,006,01,01,  Madhya Abhirampur,712,644,377,309,335,335,52.5,55.0,50.0,00000
85.0,49.0,94.0,006,02,01,  Purba Abhiram,1254,940,677,434,577,506,57.2,60.9,53.3,00000
85.0,49.0,94.0,006,03,01,  Paschim Abhiram,2013,1385,1082,644,931,741,59.2,62.7,55.7,00000
85.0,49.0,94.0,540,01,01,  Kellaband Purbapara,825,398,442,171,383,227,67.5,72.1,62.8,00000
85.0,49.0,94.0,540,02,01,  Kuti Para,682,492,351,228,331,264,58.1,60.6,55.6,00000
85.0,49.0,94.0,540,03,01,  Kellaband Paschimpara,317,91,153,40,164,51,77.7,79.3,76.3,00000
85.0,58.0,17.0,978,01,01,  Ucha Balua,525,799,263,379,262,420,39.7,41.0,38.4,00000
85.0,58.0,17.0,978,02,01,  Sibpur,1,4,1,1,0,3,20.0,50.0,0.0,00000
85.0,58.0,21.0,083,01,01,  Paschim Barabala,824,1077,470,465,354,612,43.3,50.3,36.6,00000
85.0,58.0,21.0,083,02,01,  Purba Barabala,607,1525,354,718,253,807,28.5,33.0,23.9,00000
85.0,58.0,54.0,363,01,01,  Paschimpara,2307,3937,1260,1851,1047,2086,36.9,40.5,33.4,00000
85.0,58.0,54.0,363,02,01,  Madhyapara,1982,2804,1040,1306,942,1498,41.4,44.3,38.6,00000
85.0,58.0,54.0,363,03,01,  Purbapara,603,1653,326,782,277,871,26.7,29.4,24.1,00000
85.0,58.0,94.0,067,01,01,  Baldi Pukur,1636,2025,862,951,774,1074,44.7,47.5,41.9,00000
85.0,58.0,94.0,067,02,01,  Naya Para,234,411,136,172,98,239,36.3,44.2,29.1,00000
85.0,58.0,94.0,235,01,01,  Daulat Nurpur,859,533,435,276,424,257,61.7,61.2,62.3,00000
85.0,58.0,94.0,235,02,01,  Mirar Bala Para,362,289,173,137,189,152,55.6,55.8,55.4,00000
85.0,76.0,16.0,064,01,01,  Bansh Pukuria Madhyapa,577,591,305,287,272,304,49.4,51.5,47.2,00000
85.0,76.0,16.0,064,02,01,  Shal Para,305,361,165,169,140,192,45.8,49.4,42.2,00000
85.0,76.0,16.0,067,01,01,  Sholagharia,305,526,143,266,162,260,36.7,35.0,38.4,00000
85.0,76.0,16.0,067,02,01,  Maktagari,138,399,85,166,53,233,25.7,33.9,18.5,00000
85.0,76.0,16.0,067,03,01,  Dhakir Para,30,55,15,24,15,31,35.3,38.5,32.6,00000
85.0,76.0,16.0,067,04,01,  Madhyapara,241,327,127,157,114,170,42.4,44.7,40.1,00000
85.0,76.0,16.0,067,05,01,  Dikhirkona,94,285,60,137,34,148,24.8,30.5,18.7,00000
85.0,76.0,16.0,067,06,01,  Fatehpur,202,225,105,110,97,115,47.3,48.8,45.8,00000
85.0,76.0,16.0,920,01,01,  Uttarpara,151,201,81,89,70,112,42.9,47.6,38.5,00000
85.0,76.0,16.0,920,02,01,  Dakshinpara,231,205,130,99,101,106,53.0,56.8,48.8,00000
85.0,76.0,88.0,407,01,01,  Ghoshpur,464,930,227,444,237,486,33.3,33.8,32.8,00000
85.0,76.0,88.0,407,02,01,  Krishnapur,34,34,16,16,18,18,50.0,50.0,50.0,00000
85.0,76.0,88.0,407,03,01,  Rampur,47,68,25,31,22,37,40.9,44.6,37.3,00000
85.0,76.0,88.0,445,01,01,  Hariram Sahapur,410,759,214,349,196,410,35.1,38.0,32.3,00000
85.0,76.0,88.0,445,02,01,  Rajarpur,249,195,121,81,128,114,56.1,59.9,52.9,00000
85.0,76.0,88.0,613,01,01,  Kholahati,514,596,286,258,228,338,46.3,52.6,40.3,00000
85.0,76.0,88.0,613,02,01,  Jatimanpur,208,231,105,115,103,116,47.4,47.7,47.0,00000
85.0,76.0,88.0,755,01,01,  Paharpur,681,1092,366,530,315,562,38.4,40.8,35.9,00000
85.0,76.0,88.0,755,02,01,  Gopalpur,107,251,52,116,55,135,29.9,31.0,28.9,00000
85.0,76.0,95.0,177,01,01,  Bhita Para,127,153,69,74,58,79,45.4,48.3,42.3,00000
85.0,76.0,95.0,177,02,01,  Char Para,65,176,36,84,29,92,27.0,30.0,24.0,00000
85.0,76.0,95.0,177,03,01,  Bichna,281,254,138,123,143,131,52.5,52.9,52.2,00000
85.0,76.0,95.0,245,01,01,  Chhatua,379,362,196,176,183,186,51.1,52.7,49.6,00000
85.0,76.0,95.0,245,02,01,  Bhagabanpur,183,208,90,106,93,102,46.8,45.9,47.7,00000
85.0,76.0,95.0,274,01,01,  Roykuri Para,61,66,31,34,30,32,48.0,47.7,48.4,00000
85.0,76.0,95.0,274,02,01,  Durgapur,84,47,51,23,33,24,64.1,68.9,57.9,00000
85.0,76.0,95.0,374,01,01,  Shanu Para,140,68,69,35,71,33,67.3,66.3,68.3,00000
85.0,76.0,95.0,374,02,01,  Khamar Para,86,103,42,53,44,50,45.5,44.2,46.8,00000
85.0,76.0,95.0,374,03,01,  Purbapara,301,89,154,41,147,48,77.2,79.0,75.4,00000
85.0,76.0,95.0,374,04,01,  Gandharbapur,181,99,88,45,93,54,64.6,66.2,63.3,00000
85.0,76.0,95.0,419,01,01,  Kani Para,35,34,15,18,20,16,50.7,45.5,55.6,00000
85.0,76.0,95.0,419,02,01,  Madhyapara,296,415,149,229,147,186,41.6,39.4,44.1,00000
85.0,76.0,95.0,419,03,01,  Mandal Para,126,159,69,75,57,84,44.2,47.9,40.4,00000
85.0,76.0,95.0,419,04,01,  Gachhua Para,123,103,54,48,69,55,54.4,52.9,55.6,00000
85.0,76.0,95.0,436,01,01,  Kananchagari,179,140,88,72,91,68,56.1,55.0,57.2,00000
85.0,76.0,95.0,436,02,01,  Haranathpur,434,397,220,185,214,212,52.2,54.3,50.2,00000
85.0,76.0,95.0,662,01,01,  Madhabpur,321,277,166,133,155,144,53.7,55.5,51.8,00000
85.0,76.0,95.0,662,02,01,  Mamrus Para,147,179,80,80,67,99,45.1,50.0,40.4,00000
85.0,76.0,95.0,788,01,01,  Boalmari,105,274,50,128,55,146,27.7,28.1,27.4,00000
85.0,76.0,95.0,788,02,01,  Mari Para,86,275,53,141,33,134,23.8,27.3,19.8,00000
85.0,76.0,95.0,975,01,01,  Gausa Para,344,188,169,100,175,88,64.7,62.8,66.5,00000
85.0,76.0,95.0,975,02,01,  Kaila Para,175,78,95,29,80,49,69.2,76.6,62.0,00000
85.0,76.0,95.0,975,03,01,  Fakir Para,222,61,113,29,109,32,78.4,79.6,77.3,00000
85.0,92.0,63.0,621,01,01,  Purba Kismat Menanagar,2058,2501,1082,1206,976,1295,45.1,47.3,43.0,00000
85.0,92.0,63.0,621,02,01,  Paschim Kismat Menanag,2436,3323,1303,1578,1133,1745,42.3,45.2,39.4,00000
49.0,6.0,13.0,042,01,01,  Khamar Andhari Jhar Koti,545,1065,285,494,260,571,33.9,36.6,31.3,00000
49.0,6.0,13.0,042,02,01,  Khamar Andhari Bari,1677,1967,894,915,783,1052,46.0,49.4,42.7,00000
49.0,6.0,13.0,042,03,01,  Khamar Andhari Jhar,1202,1464,637,639,565,825,45.1,49.9,40.6,00000
49.0,6.0,13.0,126,01,01,  Bir Baruitari,761,1061,421,476,340,585,41.8,46.9,36.8,00000
49.0,6.0,13.0,126,02,01,  Char Baruitari,600,1332,319,605,281,727,31.1,34.5,27.9,00000
49.0,6.0,13.0,378,01,01,  Bir Dhaurar Kuthi,976,1163,512,525,464,638,45.6,49.4,42.1,00000
49.0,6.0,13.0,378,02,01,  Char Dhaurar Kuthi,763,2077,410,923,353,1154,26.9,30.8,23.4,00000
49.0,6.0,19.0,056,01,01,  Uttarpara Angaria,200,248,94,119,106,129,44.6,44.1,45.1,00000
49.0,6.0,19.0,056,02,01,  Dakshinpara,657,690,357,325,300,365,48.8,52.3,45.1,00000
49.0,6.0,19.0,084,01,03,  Jhukia,748,842,397,393,351,449,47.0,50.3,43.9,00000
49.0,6.0,19.0,084,02,03,  Sonatali,1177,1338,662,619,515,719,46.8,51.7,41.7,00000
49.0,6.0,19.0,084,03,03,  Bagbhandar,1901,1756,1028,816,873,940,52.0,55.7,48.2,00000
49.0,6.0,19.0,168,01,01,  Dakshin Paschim Bhothat,498,990,300,479,198,511,33.5,38.5,27.9,00000
49.0,6.0,19.0,168,02,01,  Purba Bhothat,603,863,340,398,263,465,41.1,46.1,36.1,00000
49.0,6.0,19.0,168,03,01,  Madhya Bhothat,296,1176,159,602,137,574,20.1,20.9,19.3,00000
49.0,6.0,19.0,364,01,03,  Dakshin Dewaner Khamar,805,729,424,330,381,399,52.5,56.2,48.8,00000
49.0,6.0,19.0,364,02,03,  Paschim Dewaner Khamar,2418,1172,1372,502,1046,670,67.4,73.2,61.0,00000
49.0,6.0,19.0,364,03,03,  Uttar Dewaner  Khamar,2134,1319,1133,594,1001,725,61.8,65.6,58.0,00000
49.0,6.0,19.0,364,04,03,  Purba Dewaner  Khamar,969,439,501,192,468,247,68.8,72.3,65.5,00000
49.0,6.0,19.0,490,01,03,  Bashni Para,596,545,321,248,275,297,52.2,56.4,48.1,00000
49.0,6.0,19.0,490,02,03,  Bepari Para,665,884,362,392,303,492,42.9,48.0,38.1,00000
49.0,6.0,19.0,490,03,03,  Dakshin Kamat Angaria,2991,1962,1561,895,1430,1067,60.4,63.6,57.3,00000
49.0,6.0,19.0,658,01,01,  Dakshin Manik Kazi,422,765,244,344,178,421,35.6,41.5,29.7,00000
49.0,6.0,19.0,658,02,01,  Uttar Manik Kazi,378,461,203,196,175,265,45.1,50.9,39.8,00000
49.0,6.0,19.0,672,01,01,  Char Naleya,312,1135,176,572,136,563,21.6,23.5,19.5,00000
49.0,6.0,19.0,672,02,01,  Kayem Naleya,572,716,308,326,264,390,44.4,48.6,40.4,00000
49.0,6.0,28.0,224,01,01,  Sardarturi,239,563,123,250,116,313,29.8,33.0,27.0,00000
49.0,6.0,28.0,224,02,01,  Khalisakuri,707,917,356,402,351,515,43.5,47.0,40.5,00000
49.0,6.0,28.0,294,01,01,  Angalari Kuti,412,1348,226,603,186,745,23.4,27.3,20.0,00000
49.0,6.0,28.0,294,02,01,  Islambad,318,465,150,199,168,266,40.6,43.0,38.7,00000
49.0,6.0,28.0,294,03,01,  Dakshin Baladia,374,692,213,285,161,407,35.1,42.8,28.3,00000
49.0,6.0,28.0,294,04,01,  Komartari,124,327,66,152,58,175,27.5,30.3,24.9,00000
49.0,6.0,28.0,518,01,01,  Khamar Para,611,1167,316,480,295,687,34.4,39.7,30.0,00000
49.0,6.0,28.0,518,02,01,  Khan Para,193,135,111,58,82,77,58.8,65.7,51.6,00000
49.0,6.0,28.0,518,03,01,  Bramhatar,162,166,87,77,75,89,49.4,53.0,45.7,00000
49.0,6.0,28.0,518,04,01,  Sarkar Para,380,370,194,138,186,232,50.7,58.4,44.5,00000
49.0,6.0,28.0,518,05,01,  Bepari Para,249,417,130,189,119,228,37.4,40.8,34.3,00000
49.0,6.0,28.0,644,01,01,  Marakhana,253,520,128,208,125,312,32.7,38.1,28.6,00000
49.0,6.0,28.0,644,02,01,  Mangalarkuti,355,356,194,146,161,210,49.9,57.1,43.4,00000
49.0,6.0,28.0,644,03,01,  Nayar Chhara,149,274,76,122,73,152,35.2,38.4,32.4,00000
49.0,6.0,28.0,714,01,01,  Harimanerpar,52,182,22,74,30,108,22.2,22.9,21.7,00000
49.0,6.0,28.0,714,02,01,  Chatim,203,682,96,301,107,381,22.9,24.2,21.9,00000
49.0,6.0,28.0,714,03,01,  Porabhita,196,319,103,142,93,177,38.1,42.0,34.4,00000
49.0,6.0,28.0,714,04,01,  Parshuramerkuti,231,171,128,79,103,92,57.5,61.8,52.8,00000
49.0,6.0,28.0,882,01,01,  Char Satipuri,724,1492,380,713,344,779,32.7,34.8,30.6,00000
49.0,6.0,28.0,882,02,01,  Satipuri,317,680,165,306,152,374,31.8,35.0,28.9,00000
49.0,6.0,28.0,924,01,01,  Balabari,195,406,103,165,92,241,32.4,38.4,27.6,00000
49.0,6.0,28.0,924,02,01,  Khochabari,125,164,68,79,57,85,43.3,46.3,40.1,00000
49.0,6.0,28.0,924,03,01,  Char Baldia,258,408,148,181,110,227,38.7,45.0,32.6,00000
49.0,6.0,28.0,924,04,01,  Baldia,155,412,66,194,89,218,27.3,25.4,29.0,00000
49.0,6.0,28.0,924,05,01,  Uttar Baldia,274,380,156,169,118,211,41.9,48.0,35.9,00000
49.0,6.0,28.0,924,06,01,  Shahi Bazar,115,248,54,115,61,133,31.7,32.0,31.4,00000
49.0,6.0,38.0,098,01,01,  Dhakaia Para,314,676,163,303,151,373,31.7,35.0,28.8,00000
49.0,6.0,38.0,098,02,01,  Charaya Para,644,821,349,376,295,445,44.0,48.1,39.9,00000
49.0,6.0,38.0,098,03,01,  Gaybari,369,727,211,324,158,403,33.7,39.4,28.2,00000
49.0,6.0,38.0,154,01,01,  Uttar Bharater Chhara,582,1244,328,525,254,719,31.9,38.5,26.1,00000
49.0,6.0,38.0,154,02,01,  Dakshin Bharater Chhara,826,1766,441,823,385,943,31.9,34.9,29.0,00000
49.0,6.0,38.0,154,03,01,  Madnya Bharater Chhara,364,922,194,425,170,497,28.3,31.3,25.5,00000
49.0,6.0,38.0,196,01,01,  Fakir Para,355,748,171,381,184,367,32.2,31.0,33.4,00000
49.0,6.0,38.0,196,02,01,  Paschimpara,99,669,51,309,48,360,12.9,14.2,11.8,00000
49.0,6.0,38.0,196,03,01,  Assam Para,222,549,112,259,110,290,28.8,30.2,27.5,00000
49.0,6.0,38.0,420,01,01,  Uttar Ganarkuthi,173,477,80,221,93,256,26.6,26.6,26.6,00000
49.0,6.0,38.0,420,02,01,  Paschim Ganarkuthi,132,190,61,90,71,100,41.0,40.4,41.5,00000
49.0,6.0,38.0,420,03,01,  Purba Ganarkuthi,226,329,109,152,117,177,40.7,41.8,39.8,00000
49.0,6.0,38.0,420,04,01,  Madhya Ganarkuthi,209,502,109,228,100,274,29.4,32.3,26.7,00000
49.0,6.0,38.0,420,05,01,  Kani Para Ganarkuthi,32,279,18,121,14,158,10.3,12.9,8.1,00000
49.0,6.0,38.0,616,01,01,  Uttar Mahiganj,278,984,152,481,126,503,22.0,24.0,20.0,00000
49.0,6.0,38.0,616,02,01,  Dakshin Mahiganj,3,320,2,153,1,167,0.9,1.3,0.6,00000
49.0,6.0,38.0,616,03,01,  Madhya Mahiganj,229,489,124,216,105,273,31.9,36.5,27.8,00000
49.0,6.0,47.0,182,01,01,  Bahalkuri,400,459,199,230,201,229,46.6,46.4,46.7,00000
49.0,6.0,47.0,182,02,01,  Beparitari,607,881,347,380,260,501,40.8,47.7,34.2,00000
49.0,6.0,47.0,182,03,01,  Charuatari,417,760,222,343,195,417,35.4,39.3,31.9,00000
49.0,6.0,47.0,182,04,01,  Baniatari,441,767,242,349,199,418,36.5,40.9,32.3,00000
49.0,6.0,47.0,210,01,01,  Musullitari,77,276,44,133,33,143,21.8,24.9,18.8,00000
49.0,6.0,47.0,210,02,01,  Char Bhurungamari Madhyapara,542,865,293,377,249,488,38.5,43.7,33.8,00000
49.0,6.0,47.0,210,03,01,  Hocharbala,297,468,170,209,127,259,38.8,44.9,32.9,00000
49.0,6.0,47.0,210,04,01,  Sishib Bari,155,505,81,243,74,262,23.5,25.0,22.0,00000
49.0,6.0,47.0,462,01,01,  Islampur Pashimpara,169,550,81,263,88,287,23.5,23.5,23.5,00000
49.0,6.0,47.0,462,02,01,  Chatra Para,112,346,65,162,47,184,24.5,28.6,20.3,00000
49.0,6.0,47.0,462,03,01,  Islampur Purbapara,236,699,111,343,125,356,25.2,24.4,26.0,00000
49.0,6.0,47.0,462,04,01,  Darga Para,215,230,104,114,111,116,48.3,47.7,48.9,00000
49.0,6.0,66.0,252,01,01,  Uttarpara,445,661,214,288,231,373,40.2,42.6,38.2,00000
49.0,6.0,66.0,252,02,01,  Madhyapara,220,171,118,88,102,83,56.3,57.3,55.1,00000
49.0,6.0,66.0,252,03,01,  Charar Purbapar,550,615,295,269,255,346,47.2,52.3,42.4,00000
49.0,6.0,66.0,252,04,01,  Dakshinpara,297,609,164,272,133,337,32.8,37.6,28.3,00000
49.0,6.0,66.0,406,01,01,  Araiarkoti,545,686,276,313,269,373,44.3,46.9,41.9,00000
49.0,6.0,66.0,406,02,01,  Gachhidanga,1445,2253,786,1072,659,1181,39.1,42.3,35.8,00000
49.0,6.0,66.0,700,01,01,  Pateshwari Para,340,1098,172,524,168,574,23.6,24.7,22.6,00000
49.0,6.0,66.0,700,02,01,  Chatra Para,900,1323,479,630,421,693,40.5,43.2,37.8,00000
49.0,6.0,66.0,700,03,01,  Jula Para,536,1185,286,531,250,654,31.1,35.0,27.7,00000
49.0,6.0,85.0,322,01,01,  Dakshin Dhaldanga Bir,1741,2029,916,914,825,1115,46.2,50.1,42.5,00000
49.0,6.0,85.0,322,02,01,  Dakshin Dhaldanga Char,347,642,174,299,173,343,35.1,36.8,33.5,00000
49.0,6.0,85.0,966,01,01,  Purba Uttar Dhaldanga,386,999,208,487,178,512,27.9,29.9,25.8,00000
49.0,6.0,85.0,966,02,01,  Paschim Uttar Dhaldanga,513,1439,269,674,244,765,26.3,28.5,24.2,00000
49.0,6.0,85.0,994,01,01,  Uttar Tilai Bir,940,1963,492,883,448,1080,32.4,35.8,29.3,00000
49.0,6.0,85.0,994,02,01,  Uttar Tilai Char,368,797,213,365,155,432,31.6,36.9,26.4,00000
49.0,6.0,95.0,350,01,01,  Bhotegati,351,427,155,188,196,239,45.1,45.2,45.1,00000
49.0,6.0,95.0,350,02,01,  Uttarpara,488,1035,260,455,228,580,32.0,36.4,28.2,00000
49.0,6.0,95.0,350,03,01,  Purbapara,286,547,164,241,122,306,34.3,40.5,28.5,00000
49.0,6.0,95.0,350,04,01,  Madhyapara,45,351,26,173,19,178,11.4,13.1,9.6,00000
49.0,6.0,95.0,350,05,01,  Nalea,108,222,54,109,54,113,32.7,33.1,32.3,00000
49.0,6.0,95.0,350,06,01,  Naya Para,75,298,40,142,35,156,20.1,22.0,18.3,00000
49.0,8.0,19.0,087,01,01,  Shiberdangi,699,1198,346,529,353,669,36.8,39.5,34.5,00000
49.0,8.0,19.0,087,02,01,  Shiberdangi Naya Para,153,409,92,169,61,240,27.2,35.2,20.3,00000
49.0,8.0,19.0,087,03,01,  Baliamari Naya Para,263,490,124,227,139,263,34.9,35.3,34.6,00000
49.0,8.0,19.0,087,04,01,  Pachim Para,165,242,107,110,58,132,40.5,49.3,30.5,00000
49.0,8.0,19.0,087,05,01,  Bazar Para,239,243,127,107,112,136,49.6,54.3,45.2,00000
49.0,8.0,19.0,087,06,01,  Adarsa Gram,57,237,35,112,22,125,19.4,23.8,15.0,00000
49.0,8.0,19.0,087,07,01,  Purba Bepari Para,100,320,46,164,54,156,23.8,21.9,25.7,00000
49.0,8.0,19.0,087,08,01,  Paschim Bepari Para,93,437,57,212,36,225,17.5,21.2,13.8,00000
49.0,8.0,19.0,087,09,01,  Sandar Para,20,141,14,61,6,80,12.4,18.7,7.0,00000
49.0,8.0,19.0,087,10,01,  Mandal Para,152,337,79,154,73,183,31.1,33.9,28.5,00000
49.0,8.0,19.0,175,01,03,  Uttar Maricha Kandi,366,602,175,276,191,326,37.8,38.8,36.9,00000
49.0,8.0,19.0,175,02,03,  Madhya Maricha Kandi,109,244,61,111,48,133,30.9,35.5,26.5,00000
49.0,8.0,19.0,175,03,03,  Dakshin Maricha Kandi,151,242,75,95,76,147,38.4,44.1,34.1,00000
49.0,8.0,19.0,175,04,03,  Tangalia Para,700,1198,369,553,331,645,36.9,40.0,33.9,00000
49.0,8.0,19.0,175,05,03,  Member Para,276,416,151,172,125,244,39.9,46.7,33.9,00000
49.0,8.0,19.0,175,06,03,  Sabujbag,515,252,296,106,219,146,67.1,73.6,60.0,00000
49.0,8.0,19.0,175,07,03,  Jahir Mandal Para,115,341,63,154,52,187,25.2,29.0,21.8,00000
49.0,8.0,19.0,175,08,03,  Kachari Para,815,706,452,326,363,380,53.6,58.1,48.9,00000
49.0,8.0,19.0,175,09,03,  Dakshin Borai Dangi,261,312,132,145,129,167,45.5,47.7,43.6,00000
49.0,8.0,19.0,175,10,03,  Uttar Borai Dangi,237,311,129,131,108,180,43.2,49.6,37.5,00000
49.0,8.0,19.0,175,11,03,  Madrasa Para,152,204,66,96,86,108,42.7,40.7,44.3,00000
49.0,8.0,19.0,175,12,03,  Char Rajibpur Mandal Para,204,388,111,168,93,220,34.5,39.8,29.7,00000
49.0,8.0,19.0,175,13,03,  Karagar Para,274,442,153,214,121,228,38.3,41.7,34.7,00000
49.0,8.0,19.0,175,14,03,  Yad Ali Sarkar Para,262,226,137,113,125,113,53.7,54.8,52.5,00000
49.0,8.0,19.0,175,15,03,  Sadek Dewani Para,138,389,71,180,67,209,26.2,28.3,24.3,00000
49.0,8.0,19.0,175,16,03,  Bhuiyan Para,164,236,98,111,66,125,41.0,46.9,34.6,00000
49.0,8.0,19.0,175,17,03,  Collegepara,242,198,128,80,114,118,55.0,61.5,49.1,00000
49.0,8.0,19.0,175,18,03,  Kechomary,233,504,112,243,121,261,31.6,31.5,31.7,00000
49.0,8.0,19.0,468,01,01,  Kachni Para,88,199,54,82,34,117,30.7,39.7,22.5,00000
49.0,8.0,19.0,468,02,01,  Jalchira Para,333,530,173,237,160,293,38.6,42.2,35.3,00000
49.0,8.0,19.0,468,03,01,  Mia Para,383,475,188,228,195,247,44.6,45.2,44.1,00000
49.0,8.0,19.0,468,04,01,  Baul Para,139,204,77,96,62,108,40.5,44.5,36.5,00000
49.0,8.0,19.0,468,05,01,  Dhublia Para,187,521,100,228,87,293,26.4,30.5,22.9,00000
49.0,8.0,19.0,468,06,01,  Karaidangi,171,271,80,120,91,151,38.7,40.0,37.6,00000
49.0,8.0,19.0,468,07,01,  Lamba Para,221,303,115,141,106,162,42.2,44.9,39.6,00000
49.0,8.0,19.0,468,08,01,  Garaimari,130,300,64,127,66,173,30.2,33.5,27.6,00000
49.0,8.0,19.0,468,09,01,  Dhula Uri,316,889,166,418,150,471,26.2,28.4,24.2,00000
49.0,8.0,19.0,468,10,01,  Nama Para,435,788,229,394,206,394,35.6,36.8,34.3,00000
49.0,8.0,19.0,790,02,01,  Munshi Para,143,242,72,108,71,134,37.1,40.0,34.6,00000
49.0,8.0,19.0,790,04,01,  Asgar Dewani Para,130,263,76,117,54,146,33.1,39.4,27.0,00000
49.0,8.0,19.0,790,05,01,  Karati Para,514,811,286,361,228,450,38.8,44.2,33.6,00000
49.0,8.0,19.0,790,06,01,  Madaner Char,50,293,27,129,23,164,14.6,17.3,12.3,00000
49.0,8.0,57.0,204,01,01,  Uttar Char Sajai,388,805,190,377,198,428,32.5,33.5,31.6,00000
49.0,8.0,57.0,204,02,01,  Madhya Char Sajai,109,281,45,114,64,167,27.9,28.3,27.7,00000
49.0,8.0,57.0,204,03,01,  Purba Char Sajai,153,292,67,145,86,147,34.4,31.6,36.9,00000
49.0,8.0,57.0,585,01,01,  Uttar Kodailkati,367,895,184,402,183,493,29.1,31.4,27.1,00000
49.0,8.0,57.0,585,02,01,  Haji Para,29,52,14,25,15,27,35.8,35.9,35.7,00000
49.0,8.0,57.0,585,03,01,  Joddar Para,31,18,18,10,13,8,63.3,64.3,61.9,00000
49.0,8.0,57.0,585,04,01,  Terosi Para,70,264,30,107,40,157,21.0,21.9,20.3,00000
49.0,8.0,57.0,585,05,01,  Paikantari Para,64,65,28,28,36,37,49.6,50.0,49.3,00000
49.0,8.0,57.0,585,06,01,  Ballab Para,201,202,93,90,108,112,49.9,50.8,49.1,00000
49.0,8.0,57.0,585,07,01,  Janab Dewani Para,8,30,3,12,5,18,21.1,20.0,21.7,00000
49.0,8.0,57.0,585,08,01,  Mohammad Member Para,153,358,68,171,85,187,29.9,28.5,31.3,00000
49.0,8.0,57.0,585,09,01,  Ansar Dealar Para,118,304,56,150,62,154,28.0,27.2,28.7,00000
49.0,8.0,57.0,585,10,01,  Sairuddin Dewani Para,163,298,82,135,81,163,35.4,37.8,33.2,00000
49.0,8.0,57.0,819,01,01,  Uttar Sajai,842,1143,442,509,400,634,42.4,46.5,38.7,00000
49.0,8.0,57.0,819,02,01,  Madhya Char Sajai,155,219,68,107,87,112,41.4,38.9,43.7,00000
49.0,8.0,57.0,819,03,01,  Purba Sajai,409,603,204,246,205,357,40.4,45.3,36.5,00000
49.0,8.0,57.0,819,04,01,  Madhya Sajai,271,393,148,174,123,219,40.8,46.0,36.0,00000
49.0,8.0,57.0,819,05,01,  Dakshin Sajai,637,689,341,308,296,381,48.0,52.5,43.7,00000
49.0,8.0,57.0,819,06,01,  Master Para,119,300,62,140,57,160,28.4,30.7,26.3,00000
49.0,8.0,76.0,117,01,01,  Uttar Baraber,241,943,116,453,125,490,20.4,20.4,20.3,00000
49.0,8.0,76.0,117,02,01,  Madhya Baraber,68,297,39,147,29,150,18.6,21.0,16.2,00000
49.0,8.0,76.0,117,03,01,  Baraber Master Para,250,341,124,161,126,180,42.3,43.5,41.2,00000
49.0,8.0,76.0,117,04,01,  Baraber Sarkar Para,175,608,92,282,83,326,22.3,24.6,20.3,00000
49.0,8.0,76.0,263,02,01,  Dhakaiya Para,116,185,59,80,57,105,38.5,42.4,35.2,00000
49.0,8.0,76.0,702,01,01,  Naya Char  Uttar Para,149,255,72,107,77,148,36.9,40.2,34.2,00000
49.0,8.0,76.0,702,02,01,  Naya Char Goal Para,394,555,186,240,208,315,41.5,43.7,39.8,00000
49.0,8.0,76.0,702,03,01,  Naya Char Fakir Para,333,502,173,235,160,267,39.9,42.4,37.5,00000
49.0,8.0,76.0,702,04,01,  Naya Char Joani Para,170,172,95,67,75,105,49.7,58.6,41.7,00000
49.0,8.0,76.0,702,05,01,  Naya Char Pathdhoa Para,421,624,194,306,227,318,40.3,38.8,41.7,00000
49.0,8.0,76.0,702,06,01,  Naya Char Tinthopa Para,304,425,138,207,166,218,41.7,40.0,43.2,00000
49.0,8.0,76.0,702,07,01,  Naya Char Sylhet Para,204,494,73,222,131,272,29.2,24.7,32.5,00000
49.0,8.0,76.0,702,08,01,  Naya Char Kalki Para,192,497,104,205,88,292,27.9,33.7,23.2,00000
49.0,8.0,76.0,702,09,01,  Naya Char Madan Para,332,348,167,162,165,186,48.8,50.8,47.0,00000
49.0,8.0,76.0,702,10,01,  Naya Char Ajmir Para,199,318,107,149,92,169,38.5,41.8,35.2,00000
49.0,8.0,76.0,702,11,01,  Naya Char Votang Para,96,298,51,135,45,163,24.4,27.4,21.6,00000
49.0,8.0,76.0,702,12,01,  Naya Char Bazar Para,136,119,66,49,70,70,53.3,57.4,50.0,00000
49.0,8.0,76.0,702,13,01,  Naya Char Master Para,169,217,80,94,89,123,43.8,46.0,42.0,00000
49.0,8.0,76.0,702,14,01,  Naya Char Munshi Para,115,160,55,69,60,91,41.8,44.4,39.7,00000
49.0,8.0,76.0,702,15,01,  Naya Char Sankarpur Para,461,642,254,278,207,364,41.8,47.7,36.3,00000
49.0,8.0,76.0,702,16,01,  Naya Char Madhya  Para,267,245,133,114,134,131,52.1,53.8,50.6,00000
49.0,8.0,76.0,702,17,01,  Naya Char Dakshin Para,225,176,119,85,106,91,56.1,58.3,53.8,00000
49.0,8.0,76.0,702,18,01,  Naya Char Mollah Para,115,211,56,97,59,114,35.3,36.6,34.1,00000
49.0,8.0,76.0,702,19,01,  Naya Char Coal Para,69,139,37,60,32,79,33.2,38.1,28.8,00000
49.0,8.0,76.0,702,20,01,  Naya Char Jiga Para,84,196,47,77,37,119,30.0,37.9,23.7,00000
49.0,9.0,11.0,212,01,01,  Goaler Char,203,774,110,339,93,435,20.8,24.5,17.6,00000
49.0,9.0,11.0,212,02,01,  Char Mudafat Kalikapur,312,1061,157,493,155,568,22.7,24.2,21.4,00000
49.0,9.0,23.0,185,01,01,  Moniruddin Sarkargram,155,321,98,136,57,185,32.6,41.9,23.6,00000
49.0,9.0,23.0,185,02,01,  Techaruddin Membergram,86,195,54,104,32,91,30.6,34.2,26.0,00000
49.0,9.0,23.0,185,03,01,  Samadergram,46,230,33,110,13,120,16.7,23.1,9.8,00000
49.0,9.0,23.0,411,01,01,  Ibrahimergram,91,186,35,98,56,88,32.9,26.3,38.9,00000
49.0,9.0,23.0,411,02,01,  Jharali Membergram,33,305,21,143,12,162,9.8,12.8,6.9,00000
49.0,9.0,23.0,636,01,01,  Abdul Nazirergram,64,129,32,60,32,69,33.2,34.8,31.7,00000
49.0,9.0,23.0,636,02,01,  Mansurergram,123,98,69,41,54,57,55.7,62.7,48.6,00000
49.0,9.0,23.0,636,03,01,  Abdur Raufergram,61,150,34,65,27,85,28.9,34.3,24.1,00000
49.0,9.0,23.0,636,04,01,  Mohashiner Gram,88,119,45,57,43,62,42.5,44.1,41.0,00000
49.0,9.0,23.0,888,01,01,  Tamizuddiner Gram,73,162,35,92,38,70,31.1,27.6,35.2,00000
49.0,9.0,23.0,888,02,01,  Sekandarergram,105,118,46,57,59,61,47.1,44.7,49.2,00000
49.0,9.0,23.0,888,03,01,  Jmaluddiner Gram,177,146,91,66,86,80,54.8,58.0,51.8,00000
49.0,9.0,59.0,490,01,03,  Pachim Kharkharia,527,666,255,296,272,370,44.2,46.3,42.4,00000
49.0,9.0,59.0,490,02,03,  Jakua Para,139,409,75,203,64,206,25.4,27.0,23.7,00000
49.0,9.0,59.0,490,03,03,  Dalali Para,192,344,86,138,106,206,35.8,38.4,34.0,00000
49.0,9.0,59.0,490,04,03,  Teli Para,123,454,64,187,59,267,21.3,25.5,18.1,00000
49.0,9.0,59.0,490,05,03,  Kurshar Para,100,163,51,66,49,97,38.0,43.6,33.6,00000
49.0,9.0,59.0,490,07,03,  Bharatgram,289,423,162,170,127,253,40.6,48.8,33.4,00000
49.0,9.0,59.0,490,08,03,  Mandal Para,539,373,253,152,286,221,59.1,62.5,56.4,00000
49.0,9.0,59.0,490,09,03,  Jargachh Natun Bazar,368,368,176,157,192,211,50.0,52.9,47.6,00000
49.0,9.0,59.0,490,10,03,  Jargachh Bazar Poratan,275,309,133,131,142,178,47.1,50.4,44.4,00000
49.0,9.0,59.0,490,12,03,  Basantirgram,128,393,70,193,58,200,24.6,26.6,22.5,00000
49.0,9.0,59.0,490,14,03,  Satghari Para,164,393,77,170,87,223,29.4,31.2,28.1,00000
49.0,9.0,59.0,676,01,03,  Balar Bhita,415,437,197,184,218,253,48.7,51.7,46.3,00000
49.0,9.0,59.0,676,02,03,  Sarkarer Para,1281,1281,663,547,618,734,50.0,54.8,45.7,00000
49.0,9.0,59.0,676,03,03,  Purba Mudafat Thana,306,619,145,274,161,345,33.1,34.6,31.8,00000
49.0,9.0,59.0,795,01,03,  Hesar Beparirgram,110,245,53,115,57,130,31.0,31.5,30.5,00000
49.0,9.0,59.0,795,02,03,  Gafulbeparirgram,173,248,73,103,100,145,41.1,41.5,40.8,00000
49.0,9.0,59.0,795,03,03,  Master Para,326,563,162,256,164,307,36.7,38.8,34.8,00000
49.0,9.0,59.0,795,04,03,  Rahaman Hajir Para,448,650,235,312,213,338,40.8,43.0,38.7,00000
49.0,9.0,59.0,795,05,03,  Fakir Para,375,500,182,215,193,285,42.9,45.8,40.4,00000
49.0,9.0,59.0,795,06,03,  Manir Beparirgram,203,210,108,111,95,99,49.2,49.3,49.0,00000
49.0,9.0,59.0,795,07,03,  Hasen Hajirgram,214,321,118,149,96,172,40.0,44.2,35.8,00000
49.0,9.0,59.0,795,08,03,  Lengo Beparirgram,134,265,64,126,70,139,33.6,33.7,33.5,00000
49.0,9.0,59.0,795,09,03,  Majhi Para,74,188,46,88,28,100,28.2,34.3,21.9,00000
49.0,9.0,59.0,862,01,03,  Bepari Para,84,228,48,101,36,127,26.9,32.2,22.1,00000
49.0,9.0,59.0,862,02,03,  Borhan Sarkarergram,588,616,311,245,277,371,48.8,55.9,42.7,00000
49.0,9.0,59.0,862,03,03,  Munju Miar Gram,109,165,56,70,53,95,39.8,44.4,35.8,00000
49.0,9.0,59.0,862,04,03,  Mistree Para,421,727,208,315,213,412,36.7,39.8,34.1,00000
49.0,9.0,59.0,862,05,03,  Ramna Bazar,199,229,109,91,90,138,46.5,54.5,39.5,00000
49.0,9.0,59.0,862,06,03,  Panati Para,315,438,159,191,156,247,41.8,45.4,38.7,00000
49.0,9.0,59.0,862,07,03,  Rail Station Para,107,250,65,116,42,134,30.0,35.9,23.9,00000
49.0,9.0,59.0,862,08,03,  Sonari Para,251,192,137,83,114,109,56.7,62.3,51.1,00000
49.0,9.0,59.0,862,09,03,  Anowarergram,196,181,103,87,93,94,52.0,54.2,49.7,00000
49.0,9.0,59.0,862,10,03,  Gurati Para,255,306,130,146,125,160,45.5,47.1,43.9,00000
49.0,9.0,59.0,862,11,03,  Natun Bepari Para,210,631,94,283,116,348,25.0,24.9,25.0,00000
49.0,9.0,59.0,862,12,03,  Liner Mathagram,130,154,67,73,63,81,45.8,47.9,43.8,00000
49.0,9.0,71.0,305,01,01,  Wapda Bad,746,904,377,395,369,509,45.2,48.8,42.0,00000
49.0,9.0,71.0,305,02,01,  Bara Bhitar Char,66,328,34,167,32,161,16.8,16.9,16.6,00000
49.0,9.0,71.0,305,03,01,  Sutar Marir Char,118,200,62,93,56,107,37.1,40.0,34.4,00000
49.0,9.0,71.0,729,01,01,  Purba Nrisinh Bhanj,396,354,195,149,201,205,52.8,56.7,49.5,00000
49.0,9.0,71.0,729,02,01,  Burugerpar,354,322,175,127,179,195,52.4,57.9,47.9,00000
49.0,9.0,71.0,782,01,01,  Sonari Para,503,545,255,217,248,328,48.0,54.0,43.1,00000
49.0,9.0,71.0,782,02,01,  Sarkar Para,84,275,44,117,40,158,23.4,27.3,20.2,00000
49.0,9.0,71.0,782,03,01,  Johitari,290,703,149,279,141,424,29.2,34.8,25.0,00000
49.0,9.0,71.0,782,04,01,  Kutirgram,400,419,193,166,207,253,48.8,53.8,45.0,00000
49.0,9.0,71.0,782,05,01,  Charua Para,436,581,228,226,208,355,42.9,50.2,36.9,00000
49.0,9.0,71.0,782,07,01,  Majartari,447,1290,239,579,208,711,25.7,29.2,22.6,00000
49.0,9.0,71.0,782,08,01,  Fakirhat,120,216,54,97,66,119,35.7,35.8,35.7,00000
49.0,9.0,71.0,782,09,01,  Tentulkandi,72,315,44,155,28,160,18.6,22.1,14.9,00000
49.0,9.0,71.0,782,10,01,  Nayabas,101,327,58,155,43,172,23.6,27.2,20.0,00000
49.0,9.0,71.0,875,01,01,  Raniganj Bazar,393,419,208,185,185,234,48.4,52.9,44.2,00000
49.0,9.0,71.0,875,02,01,  Sakari Para,206,183,107,72,99,111,53.0,59.8,47.1,00000
49.0,9.0,71.0,875,03,01,  Napit Para,112,267,63,113,49,154,29.6,35.8,24.1,00000
49.0,9.0,71.0,875,04,01,  Kaiar Para,371,579,183,276,188,303,39.1,39.9,38.3,00000
49.0,9.0,71.0,875,05,01,  Darar Para,307,301,156,117,151,184,50.5,57.1,45.1,00000
49.0,9.0,71.0,875,06,01,  Purba Bhatia Para,261,151,139,68,122,83,63.3,67.1,59.5,00000
49.0,9.0,71.0,875,07,01,  Saraktari,123,241,55,116,68,125,33.8,32.2,35.2,00000
49.0,9.0,71.0,875,08,01,  Natun Raniganj,295,425,136,156,159,269,41.0,46.6,37.1,00000
49.0,9.0,71.0,875,09,01,  Panchgram,137,229,69,97,68,132,37.4,41.6,34.0,00000
49.0,9.0,71.0,875,10,01,  Paschim Bhatia Para,185,154,101,62,84,92,54.6,62.0,47.7,00000
49.0,9.0,71.0,875,11,01,  Maynar Khamar,260,324,137,136,123,188,44.5,50.2,39.5,00000
49.0,9.0,83.0,583,01,01,  Kismat Banu Khamargram,254,414,123,188,131,226,38.0,39.5,36.7,00000
49.0,9.0,83.0,583,02,01,  Sonari Para,161,244,79,129,82,115,39.8,38.0,41.6,00000
49.0,9.0,83.0,583,03,01,  Sarafuddinergram,208,142,107,64,101,78,59.4,62.6,56.4,00000
49.0,9.0,83.0,583,04,01,  Keramatuddinergram,324,295,174,130,150,165,52.3,57.2,47.6,00000
49.0,9.0,83.0,583,05,01,  Nalarpar,459,266,236,100,223,166,63.3,70.2,57.3,00000
49.0,9.0,83.0,583,06,01,  Haji Para,383,252,188,122,195,130,60.3,60.6,60.0,00000
49.0,9.0,83.0,583,07,01,  Abul Moulvirgram,367,409,185,191,182,218,47.3,49.2,45.5,00000
49.0,9.0,83.0,596,01,01,  Radhaballabh,270,234,153,107,117,127,53.6,58.8,48.0,00000
49.0,9.0,83.0,596,02,01,  Kismat Radhaballabh,86,309,42,137,44,172,21.8,23.5,20.4,00000
49.0,9.0,83.0,596,03,01,  Sardar Para Doctorgram,315,568,167,272,148,296,35.7,38.0,33.3,00000
49.0,9.0,83.0,835,01,01,  Hatithana,416,353,220,158,196,195,54.1,58.2,50.1,00000
49.0,9.0,83.0,835,02,01,  Baharer Bhita,584,565,285,246,299,319,50.8,53.7,48.4,00000
49.0,9.0,83.0,849,01,01,  Putimari Kajaldanga,347,387,167,159,180,228,47.3,51.2,44.1,00000
49.0,9.0,83.0,849,02,01,  Adhikarirgram,284,209,152,85,132,124,57.6,64.1,51.6,00000
49.0,9.0,83.0,849,03,01,  Fakir Bhitagram,218,174,124,77,94,97,55.6,61.7,49.2,00000
49.0,9.0,83.0,849,04,01,  Jehardi Telirgram,349,466,190,198,159,268,42.8,49.0,37.2,00000
49.0,9.0,83.0,968,01,03,  Bara Kushturi,542,285,264,122,278,163,65.5,68.4,63.0,00000
49.0,9.0,83.0,968,02,03,  Chhota Kushturi,1179,920,609,431,570,489,56.2,58.6,53.8,00000
49.0,9.0,83.0,968,03,03,  Bhola Chairmangram,425,374,223,171,202,203,53.2,56.6,49.9,00000
49.0,9.0,83.0,968,04,03,  Balabari Rail Station Para,464,659,236,326,228,333,41.3,42.0,40.6,00000
49.0,9.0,83.0,968,05,03,  Mandal Para,858,365,440,150,418,215,70.2,74.6,66.0,00000
49.0,9.0,83.0,968,06,03,  Bazar Majhi Para,622,549,317,252,305,297,53.1,55.7,50.7,00000
49.0,9.0,83.0,968,07,03,  Thana Hat Bazar,895,694,454,360,441,334,56.3,55.8,56.9,00000
49.0,9.0,83.0,968,08,03,  Chinna Mukul,153,217,76,103,77,114,41.4,42.5,40.3,00000
49.0,9.0,83.0,968,09,03,  Shamshergram,309,266,186,133,123,133,53.7,58.3,48.0,00000
49.0,9.0,83.0,968,10,03,  Thana Hat Hospital Para,410,79,215,34,195,45,83.8,86.3,81.3,00000
49.0,9.0,83.0,968,11,03,  Demnarpar,269,326,130,151,139,175,45.2,46.3,44.3,00000
49.0,9.0,83.0,968,12,03,  Rajar Bhita,189,248,87,108,102,140,43.2,44.6,42.1,00000
49.0,9.0,83.0,968,13,03,  Baharer Bhita,326,423,155,205,171,218,43.5,43.1,44.0,00000
49.0,9.0,83.0,968,14,03,  Panchu Miargram,191,277,97,132,94,145,40.8,42.4,39.3,00000
49.0,9.0,83.0,968,15,03,  Teli Para,214,269,116,126,98,143,44.3,47.9,40.7,00000
49.0,9.0,83.0,968,16,03,  Khalil Membarergram,422,752,218,359,204,393,35.9,37.8,34.2,00000
49.0,18.0,13.0,139,01,01,  Dulabari,452,353,238,142,214,211,56.1,62.6,50.4,00000
49.0,18.0,13.0,139,02,01,  Sanar Khamar,302,281,171,123,131,158,51.8,58.2,45.3,00000
49.0,18.0,13.0,139,03,01,  Madhya Bara Bhita,625,639,311,276,314,363,49.4,53.0,46.4,00000
49.0,18.0,13.0,139,04,01,  Hitarkuti,405,425,217,178,188,247,48.8,54.9,43.2,00000
49.0,18.0,13.0,139,05,01,  Bamastari,447,300,242,125,205,175,59.8,65.9,53.9,00000
49.0,18.0,13.0,139,06,01,  Char Bara Bhita,105,289,55,142,50,147,26.6,27.9,25.4,00000
49.0,18.0,13.0,159,01,01,  Char Baralai,972,1169,533,497,439,672,45.4,51.7,39.5,00000
49.0,18.0,13.0,159,02,01,  Balatari,356,289,181,129,175,160,55.2,58.4,52.2,00000
49.0,18.0,13.0,159,03,01,  Bhitarkuti,524,466,276,187,248,279,52.9,59.6,47.1,00000
49.0,18.0,13.0,159,04,01,  Dalaltari,171,144,90,66,81,78,54.3,57.7,50.9,00000
49.0,18.0,13.0,159,05,01,  Kazitari,382,288,215,132,167,156,57.0,62.0,51.7,00000
49.0,18.0,13.0,159,06,01,  Fakirtari,349,288,183,120,166,168,54.8,60.4,49.7,00000
49.0,18.0,13.0,159,07,01,  Sardartari,445,314,237,141,208,173,58.6,62.7,54.6,00000
49.0,18.0,13.0,159,08,01,  Kayatari,273,341,141,146,132,195,44.5,49.1,40.4,00000
49.0,18.0,13.0,298,01,01,  Pudertari,364,321,180,139,184,182,53.1,56.4,50.3,00000
49.0,18.0,13.0,298,02,01,  Tulitari,290,174,155,77,135,97,62.5,66.8,58.2,00000
49.0,18.0,13.0,298,03,01,  Tapar Bazar,331,460,180,200,151,260,41.8,47.4,36.7,00000
49.0,18.0,13.0,636,01,01,  Sekh Para,510,443,274,188,236,255,53.5,59.3,48.1,00000
49.0,18.0,13.0,636,02,01,  Maittertari,394,197,217,67,177,130,66.7,76.4,57.7,00000
49.0,18.0,13.0,636,03,01,  Maguatari,561,595,295,252,266,343,48.5,53.9,43.7,00000
49.0,18.0,13.0,636,04,01,  Basuniatari,254,245,144,105,110,140,50.9,57.8,44.0,00000
49.0,18.0,13.0,636,05,01,  Zaklatari,161,87,86,37,75,50,64.9,69.9,60.0,00000
49.0,18.0,13.0,716,01,01,  Baratghar Kuti,85,211,44,102,41,109,28.7,30.1,27.3,00000
49.0,18.0,13.0,716,02,01,  Panchaiter Char,157,472,84,231,73,241,25.0,26.7,23.2,00000
49.0,18.0,13.0,716,03,01,  Mahish Khocha,439,820,238,380,201,440,34.9,38.5,31.4,00000
49.0,18.0,13.0,756,01,01,  Satakuti,393,744,208,315,185,429,34.6,39.8,30.1,00000
49.0,18.0,13.0,756,02,01,  Bagha Khawar Char,281,466,147,199,134,267,37.6,42.5,33.4,00000
49.0,18.0,13.0,756,03,01,  Paikan Tari,303,377,150,156,153,221,44.6,49.0,40.9,00000
49.0,18.0,13.0,756,04,01,  Ambholarpar,368,655,188,296,180,359,36.0,38.8,33.4,00000
49.0,18.0,13.0,756,05,01,  Shibar Bazar,153,157,81,65,72,92,49.4,55.5,43.9,00000
49.0,18.0,27.0,171,01,01,  Beparitari,369,228,211,98,158,130,61.8,68.3,54.9,00000
49.0,18.0,27.0,171,02,01,  Khamartari,178,337,113,154,65,183,34.6,42.3,26.2,00000
49.0,18.0,27.0,171,03,01,  Majhitari,229,290,126,127,103,163,44.1,49.8,38.7,00000
49.0,18.0,27.0,171,04,01,  Chararpar,168,114,94,50,74,64,59.6,65.3,53.6,00000
49.0,18.0,27.0,171,05,01,  Basuniatari,150,212,85,103,65,109,41.4,45.2,37.4,00000
49.0,18.0,27.0,171,06,01,  Talukdartari,242,140,134,48,108,92,63.4,73.6,54.0,00000
49.0,18.0,27.0,218,01,01,  Majhitari,163,242,86,108,77,134,40.2,44.3,36.5,00000
49.0,18.0,27.0,218,02,01,  Paltari,259,375,148,182,111,193,40.9,44.8,36.5,00000
49.0,18.0,27.0,218,03,01,  Bhatiatari,157,243,75,107,82,136,39.3,41.2,37.6,00000
49.0,18.0,27.0,218,04,01,  Fakirtari,373,325,218,120,155,205,53.4,64.5,43.1,00000
49.0,18.0,27.0,477,01,01,  Sardartari,274,521,151,242,123,279,34.5,38.4,30.6,00000
49.0,18.0,27.0,477,02,01,  Balatari,262,681,142,314,120,367,27.8,31.1,24.6,00000
49.0,18.0,27.0,477,03,01,  Pramanik,207,467,110,218,97,249,30.7,33.5,28.0,00000
49.0,18.0,27.0,597,01,01,  Uttar Nagarajpur,667,446,375,169,292,277,59.9,68.9,51.3,00000
49.0,18.0,27.0,597,02,01,  Balatari,385,394,228,165,157,229,49.4,58.0,40.7,00000
49.0,18.0,27.0,597,03,01,  Kutibari,402,333,210,130,192,203,54.7,61.8,48.6,00000
49.0,18.0,27.0,597,04,01,  Kamartari,432,636,244,284,188,352,40.4,46.2,34.8,00000
49.0,18.0,27.0,776,01,01,  Porarkuti,686,487,401,208,285,279,58.5,65.8,50.5,00000
49.0,18.0,27.0,776,02,01,  Sarkartari,430,427,245,179,185,248,50.2,57.8,42.7,00000
49.0,18.0,27.0,776,03,01,  Atharbari,745,595,411,239,334,356,55.6,63.2,48.4,00000
49.0,18.0,27.0,776,04,01,  Charuatari,185,331,115,154,70,177,35.9,42.8,28.3,00000
49.0,18.0,27.0,776,05,01,  Dulabari,672,736,375,325,297,411,47.7,53.6,41.9,00000
49.0,18.0,27.0,776,06,01,  Sitrabaitari,526,509,293,217,233,292,50.8,57.5,44.4,00000
49.0,18.0,27.0,835,01,01,  Sardartari,387,508,231,262,156,246,43.2,46.9,38.8,00000
49.0,18.0,27.0,835,02,01,  Beparitari,469,667,275,279,194,388,41.3,49.6,33.3,00000
49.0,18.0,40.0,238,01,03,  Chandrakhana,3648,3902,1980,1748,1668,2154,48.3,53.1,43.6,00000
49.0,18.0,40.0,238,02,03,  Kumartari,127,275,74,124,53,151,31.6,37.4,26.0,00000
49.0,18.0,40.0,238,03,03,  Balatari,1029,992,538,433,491,559,50.9,55.4,46.8,00000
49.0,18.0,40.0,238,04,03,  Aktari,150,226,88,105,62,121,39.9,45.6,33.9,00000
49.0,18.0,40.0,238,05,03,  Maslerpar,275,267,137,115,138,152,50.7,54.4,47.6,00000
49.0,18.0,40.0,238,06,03,  Chandrakhana (Chitmahal),85,126,45,58,40,68,40.3,43.7,37.0,00000
49.0,18.0,40.0,577,01,01,  Kuthi Chandrakhana,1634,2332,877,1036,757,1296,41.2,45.8,36.9,00000
49.0,18.0,40.0,577,02,01,  Majhitari,137,468,75,227,62,241,22.6,24.8,20.5,00000
49.0,18.0,40.0,577,03,01,  Nakarjan,42,78,23,35,19,43,35.0,39.7,30.6,00000
49.0,18.0,54.0,019,01,01,  Bhellirtal,141,393,78,193,63,200,26.4,28.8,24.0,00000
49.0,18.0,54.0,019,02,01,  Mandaltari,357,444,196,177,161,267,44.6,52.5,37.6,00000
49.0,18.0,54.0,019,03,01,  Khamartari,239,421,131,193,108,228,36.2,40.4,32.1,00000
49.0,18.0,54.0,019,04,01,  Berakuti,259,447,152,208,107,239,36.7,42.2,30.9,00000
49.0,18.0,54.0,019,05,01,  Materpar,151,495,94,237,57,258,23.4,28.4,18.1,00000
49.0,18.0,54.0,019,06,01,  Pachimanantapur,537,798,283,342,254,456,40.2,45.3,35.8,00000
49.0,18.0,54.0,019,07,01,  Jhakuatari,382,377,210,163,172,214,50.3,56.3,44.6,00000
49.0,18.0,54.0,019,08,01,  Bhakur Bhita,344,321,182,123,162,198,51.7,59.7,45.0,00000
49.0,18.0,54.0,019,09,01,  Ghugurhat,183,163,96,73,87,90,52.9,56.8,49.2,00000
49.0,18.0,54.0,019,10,01,  Nazirhat,467,594,254,266,213,328,44.0,48.8,39.4,00000
49.0,18.0,54.0,019,11,01,  Lilarkhas,321,404,164,175,157,229,44.3,48.4,40.7,00000
49.0,18.0,54.0,079,01,01,  Bharaliatari,117,165,71,87,46,78,41.5,44.9,37.1,00000
49.0,18.0,54.0,079,02,01,  Gangerhat,497,241,269,99,228,142,67.3,73.1,61.6,00000
49.0,18.0,54.0,079,03,01,  Kalamdertari,371,315,204,124,167,191,54.1,62.2,46.6,00000
49.0,18.0,54.0,079,04,01,  Kaliatari,102,92,58,44,44,48,52.6,56.9,47.8,00000
49.0,18.0,54.0,079,05,01,  Senpara,86,66,49,26,37,40,56.6,65.3,48.1,00000
49.0,18.0,54.0,079,06,01,  Balatari,137,212,71,107,66,105,39.3,39.9,38.6,00000
49.0,18.0,54.0,079,07,01,  Beparitari,184,145,90,61,94,84,55.9,59.6,52.8,00000
49.0,18.0,54.0,079,08,01,  Khashda,126,171,70,82,56,89,42.4,46.1,38.6,00000
49.0,18.0,54.0,079,09,01,  Thataritari,144,216,83,102,61,114,40.0,44.9,34.9,00000
49.0,18.0,54.0,079,10,01,  Sardartari,262,134,132,58,130,76,66.2,69.5,63.1,00000
49.0,18.0,54.0,079,11,01,  Bhaturiarpar,277,313,147,153,130,160,46.9,49.0,44.8,00000
49.0,18.0,54.0,079,12,01,  Chhararpar,204,142,112,62,92,80,59.0,64.4,53.5,00000
49.0,18.0,54.0,079,13,01,  Bamner Bazar,243,172,130,83,113,89,58.6,61.0,55.9,00000
49.0,18.0,54.0,258,01,01,  Zolatari,176,294,105,125,71,169,37.4,45.7,29.6,00000
49.0,18.0,54.0,258,02,01,  Kashiabari,197,269,107,113,90,156,42.3,48.6,36.6,00000
49.0,18.0,54.0,258,03,01,  Khan Para,131,214,74,99,57,115,38.0,42.8,33.1,00000
49.0,18.0,54.0,258,04,01,  Paiktari,175,196,90,80,85,116,47.2,52.9,42.3,00000
49.0,18.0,54.0,258,05,01,  Khamar Para,242,237,120,99,122,138,50.5,54.8,46.9,00000
49.0,18.0,54.0,258,06,01,  Hajitari,156,176,82,72,74,104,47.0,53.2,41.6,00000
49.0,18.0,54.0,258,07,01,  Sarkartari,312,436,181,190,131,246,41.7,48.8,34.7,00000
49.0,18.0,54.0,258,08,01,  Masanerpat,398,813,207,393,191,420,32.9,34.5,31.3,00000
49.0,18.0,54.0,437,01,01,  Berakuti,164,210,70,101,94,109,43.9,40.9,46.3,00000
49.0,18.0,54.0,437,02,01,  Zolatari,365,345,205,152,160,193,51.4,57.4,45.3,00000
49.0,18.0,54.0,437,03,01,  Telitari,167,219,88,104,79,115,43.3,45.8,40.7,00000
49.0,18.0,54.0,437,04,01,  Ghaguatari,260,435,144,194,116,241,37.4,42.6,32.5,00000
49.0,18.0,54.0,437,05,01,  Bhatiatari,117,287,74,126,43,161,29.0,37.0,21.1,00000
49.0,18.0,54.0,437,06,01,  Khan Para,190,323,100,151,90,172,37.0,39.8,34.4,00000
49.0,18.0,54.0,437,07,01,  Fakirtari,186,257,114,113,72,144,42.0,50.2,33.3,00000
49.0,18.0,54.0,437,08,01,  Bestadeb,407,721,228,331,179,390,36.1,40.8,31.5,00000
49.0,18.0,54.0,437,09,01,  Jangirtari,384,369,225,151,159,218,51.0,59.8,42.2,00000
49.0,18.0,54.0,437,10,01,  Refujeetari,175,209,102,98,73,111,45.6,51.0,39.7,00000
49.0,18.0,54.0,935,01,01,  Goaltari,549,444,317,207,232,237,55.3,60.5,49.5,00000
49.0,18.0,54.0,935,02,01,  Kutibari,125,154,61,68,64,86,44.8,47.3,42.7,00000
49.0,18.0,54.0,935,03,01,  Majhipara,149,159,79,72,70,87,48.4,52.3,44.6,00000
49.0,18.0,54.0,935,04,01,  Bhaturiarpar,159,227,81,105,78,122,41.2,43.5,39.0,00000
49.0,18.0,54.0,935,05,01,  Mandaltari,49,314,29,142,20,172,13.5,17.0,10.4,00000
49.0,18.0,67.0,119,01,01,  Purba Balatari,473,434,249,195,224,239,52.1,56.1,48.4,00000
49.0,18.0,67.0,119,02,01,  Madhya Balatari,152,198,70,89,82,109,43.4,44.0,42.9,00000
49.0,18.0,67.0,119,03,01,  Kanchiar Kuthi,226,401,113,181,113,220,36.0,38.4,33.9,00000
49.0,18.0,67.0,278,01,01,  Pramaniktari,118,219,64,94,54,125,35.0,40.5,30.2,00000
49.0,18.0,67.0,278,02,01,  Gazer Kuthi,358,393,208,154,150,239,47.7,57.5,38.6,00000
49.0,18.0,67.0,318,01,01,  Baghmara,549,1067,331,498,218,569,34.0,39.9,27.7,00000
49.0,18.0,67.0,318,02,01,  Kalir Char,372,1898,222,885,150,1013,16.4,20.1,12.9,00000
49.0,18.0,67.0,318,03,01,  Kerkerar Char,40,409,25,193,15,216,8.9,11.5,6.5,00000
49.0,18.0,67.0,557,01,01,  Uttar Kurusa Furusa,539,602,300,235,239,367,47.2,56.1,39.4,00000
49.0,18.0,67.0,557,02,01,  Chowrabari,330,285,188,109,142,176,53.7,63.3,44.7,00000
49.0,18.0,67.0,557,03,01,  Baritari,270,165,146,61,124,104,62.1,70.5,54.4,00000
49.0,18.0,67.0,557,04,01,  Zaigir,341,282,168,127,173,155,54.7,56.9,52.7,00000
49.0,18.0,67.0,736,01,01,  Kanda Para,92,331,59,137,33,194,21.7,30.1,14.5,00000
49.0,18.0,67.0,736,02,01,  Dakshin Phulmati,495,772,268,342,227,430,39.1,43.9,34.6,00000
49.0,18.0,67.0,736,03,01,  Uttar Phulmati,652,722,319,319,333,403,47.5,50.0,45.2,00000
49.0,18.0,67.0,736,04,01,  Purba Phulmati,365,285,191,114,174,171,56.2,62.6,50.4,00000
49.0,18.0,67.0,736,05,01,  Jogitari,276,435,139,181,137,254,38.8,43.4,35.0,00000
49.0,18.0,81.0,358,01,01,  Char Jot Indranarayan,477,1243,268,589,209,654,27.7,31.3,24.2,00000
49.0,18.0,81.0,358,02,01,  Santararpar,174,204,90,88,84,116,46.0,50.6,42.0,00000
49.0,18.0,81.0,895,01,01,  Uttar Sonai Kazi,97,280,48,119,49,161,25.7,28.7,23.3,00000
49.0,18.0,81.0,895,02,01,  Haldangarpar,109,128,50,57,59,71,46.0,46.7,45.4,00000
49.0,18.0,81.0,895,03,01,  Rowsantari,152,469,84,219,68,250,24.5,27.7,21.4,00000
49.0,18.0,81.0,895,04,01,  Dakshin Sonai Kazi,338,614,178,271,160,343,35.5,39.6,31.8,00000
49.0,18.0,81.0,895,05,01,  Kazigaontari,90,325,49,160,41,165,21.7,23.4,19.9,00000
49.0,18.0,81.0,995,01,01,  Paschim Taluk Shimulbari,92,208,50,88,42,120,30.7,36.2,25.9,00000
49.0,18.0,81.0,995,02,01,  Miah Para,815,884,434,369,381,515,48.0,54.0,42.5,00000
49.0,18.0,81.0,995,03,01,  Sardartari,466,345,236,149,230,196,57.5,61.3,54.0,00000
49.0,18.0,81.0,995,04,01,  Zaklatari,143,157,75,68,68,89,47.7,52.4,43.3,00000
49.0,18.0,81.0,995,05,01,  Hindutari,297,420,149,181,148,239,41.4,45.2,38.2,00000
49.0,18.0,81.0,995,06,01,  Balditari,260,119,142,46,118,73,68.6,75.5,61.8,00000
49.0,18.0,81.0,995,07,01,  Baniatari,216,135,117,60,99,75,61.5,66.1,56.9,00000
49.0,18.0,81.0,995,08,01,  Bhuiyar Kuthi,291,450,144,183,147,267,39.3,44.0,35.5,00000
49.0,18.0,81.0,995,09,01,  Nandir Kuthi,527,628,306,269,221,359,45.6,53.2,38.1,00000
49.0,18.0,81.0,995,10,01,  Fakir Para,672,598,354,255,318,343,52.9,58.1,48.1,00000
49.0,52.0,17.0,140,01,01,  Chila Para,445,525,219,239,226,286,45.9,47.8,44.1,00000
49.0,52.0,17.0,140,02,01,  Pathan Para,125,288,63,139,62,149,30.3,31.2,29.4,00000
49.0,52.0,17.0,140,03,01,  Puragram,299,252,164,108,135,144,54.3,60.3,48.4,00000
49.0,52.0,17.0,204,01,01,  Kawla Para,245,258,132,113,113,145,48.7,53.9,43.8,00000
49.0,52.0,17.0,204,02,01,  Bashania Para,408,297,223,128,185,169,57.9,63.5,52.3,00000
49.0,52.0,17.0,280,01,01,  Uttar Dhananjoy,488,262,257,107,231,155,65.1,70.6,59.8,00000
49.0,52.0,17.0,280,02,01,  Dakshin Dhananjoy,534,668,280,310,254,358,44.4,47.5,41.5,00000
49.0,52.0,17.0,484,01,03,  Railway Colony,1491,623,779,271,712,352,70.5,74.2,66.9,00000
49.0,52.0,17.0,484,02,03,  Wapda Colony,802,252,441,113,361,139,76.1,79.6,72.2,00000
49.0,52.0,17.0,510,01,01,  Nagdaha Para,500,201,251,94,249,107,71.3,72.8,69.9,00000
49.0,52.0,17.0,510,02,01,  Bhogaram,555,314,286,133,269,181,63.9,68.3,59.8,00000
49.0,52.0,17.0,510,03,01,  Dairgram,187,208,96,89,91,119,47.3,51.9,43.3,00000
49.0,52.0,17.0,510,04,01,  Dhulaura,227,319,120,143,107,176,41.6,45.6,37.8,00000
49.0,52.0,17.0,510,05,01,  Jogirbhita,213,149,111,66,102,83,58.8,62.7,55.1,00000
49.0,52.0,17.0,510,06,01,  Jukri Para,293,248,145,111,148,137,54.2,56.6,51.9,00000
49.0,52.0,19.0,191,01,01,  Gaurar Khamar,315,634,141,305,174,329,33.2,31.6,34.6,00000
49.0,52.0,19.0,191,02,01,  Kanthir Khamar,228,426,127,192,101,234,34.9,39.8,30.1,00000
49.0,52.0,19.0,191,03,01,  Dalal Para,279,326,142,147,137,179,46.1,49.1,43.4,00000
49.0,52.0,19.0,191,04,01,  Kazi Para,188,195,101,78,87,117,49.1,56.4,42.6,00000
49.0,52.0,19.0,191,05,01,  Maydipur,133,254,73,106,60,148,34.4,40.8,28.8,00000
49.0,52.0,19.0,191,06,01,  Kashi Char,351,772,178,339,173,433,31.3,34.4,28.5,00000
49.0,52.0,19.0,191,07,01,  Bhogdanga,556,729,304,351,252,378,43.3,46.4,40.0,00000
49.0,52.0,19.0,216,01,01,  Char Baraibari Namagram,291,851,154,385,137,466,25.5,28.6,22.7,00000
49.0,52.0,19.0,216,02,01,  Char Baraibari Upargram,381,442,199,195,182,247,46.3,50.5,42.4,00000
49.0,52.0,19.0,216,03,01,  Char Nanda Dalal,174,661,108,309,66,352,20.8,25.9,15.8,00000
49.0,52.0,19.0,637,01,01,  Madhabram,1185,2183,629,1008,556,1175,35.2,38.4,32.1,00000
49.0,52.0,19.0,637,02,01,  Kazi Char,291,557,160,233,131,324,34.3,40.7,28.8,00000
49.0,52.0,19.0,650,01,01,  Kaim Baraibari,230,504,117,244,113,260,31.3,32.4,30.3,00000
49.0,52.0,19.0,650,02,01,  Umarer Bhita,279,479,143,221,136,258,36.8,39.3,34.5,00000
49.0,52.0,19.0,650,03,01,  Kanuramer Bhita,104,152,52,68,52,84,40.6,43.3,38.2,00000
49.0,52.0,19.0,650,04,01,  Satbhangamur,171,468,84,200,87,268,26.8,29.6,24.5,00000
49.0,52.0,19.0,650,05,01,  Bengar Bhita,111,261,51,126,60,135,29.8,28.8,30.8,00000
49.0,52.0,19.0,650,06,01,  Barapak,137,189,80,81,57,108,42.0,49.7,34.5,00000
49.0,52.0,19.0,650,07,01,  Bhagir Bhita,139,279,70,128,69,151,33.3,35.4,31.4,00000
49.0,52.0,19.0,650,08,01,  Banchar Bhita,264,406,150,178,114,228,39.4,45.7,33.3,00000
49.0,52.0,19.0,650,09,01,  Maudipur,508,875,265,415,243,460,36.7,39.0,34.6,00000
49.0,52.0,19.0,650,10,01,  Nanda Dulalar Bhita,322,1088,177,537,145,551,22.8,24.8,20.8,00000
49.0,52.0,19.0,650,11,01,  Dauanar Khamar,119,262,72,122,47,140,31.2,37.1,25.1,00000
49.0,52.0,19.0,650,12,01,  Bishweshwar Khamar,203,205,113,97,90,108,49.8,53.8,45.5,00000
49.0,52.0,19.0,650,13,01,  Lakhir Khamar,213,405,122,197,91,208,34.5,38.2,30.4,00000
49.0,52.0,19.0,650,14,01,  Choyter Khamar,201,156,111,65,90,91,56.3,63.1,49.7,00000
49.0,52.0,19.0,650,15,01,  Kumarpur,511,624,282,269,229,355,45.0,51.2,39.2,00000
49.0,52.0,19.0,650,16,01,  Hudurdoba,163,188,88,81,75,107,46.4,52.1,41.2,00000
49.0,52.0,19.0,650,17,01,  Bonar Bhita,173,430,97,185,76,245,28.7,34.4,23.7,00000
49.0,52.0,19.0,752,01,01,  Koykuri,192,334,88,146,104,188,36.5,37.6,35.6,00000
49.0,52.0,19.0,752,02,01,  Bara Bhita,83,178,46,76,37,102,31.8,37.7,26.6,00000
49.0,52.0,19.0,752,03,01,  Dighal Hailla,48,234,30,126,18,108,17.0,19.2,14.3,00000
49.0,52.0,19.0,752,04,01,  Goailbari,215,165,114,71,101,94,56.6,61.6,51.8,00000
49.0,52.0,19.0,752,05,01,  Jatra Juma,215,156,106,74,109,82,58.0,58.9,57.1,00000
49.0,52.0,19.0,752,06,01,  Titer Bhita,78,137,39,56,39,81,36.3,41.1,32.5,00000
49.0,52.0,19.0,752,07,01,  Nagar Khamar,302,417,170,189,132,228,42.0,47.4,36.7,00000
49.0,52.0,19.0,752,08,01,  Dhadhar Kuti,89,289,39,126,50,163,23.5,23.6,23.5,00000
49.0,52.0,19.0,752,09,01,  Gopalhalar Khamar,379,640,206,309,173,331,37.2,40.0,34.3,00000
49.0,52.0,19.0,752,10,01,  Tangnar Bhita,118,260,64,105,54,155,31.2,37.9,25.8,00000
49.0,52.0,19.0,752,11,01,  Bidasir Bhita,229,259,110,100,119,159,46.9,52.4,42.8,00000
49.0,52.0,19.0,752,12,01,  Basur Bhita,274,685,136,315,138,370,28.6,30.2,27.2,00000
49.0,52.0,19.0,752,13,01,  Shibuttar,345,661,167,328,178,333,34.3,33.7,34.8,00000
49.0,52.0,19.0,752,14,01,  Paramali,435,627,233,269,202,358,41.0,46.4,36.1,00000
49.0,52.0,19.0,752,15,01,  Bramayur,177,213,99,102,78,111,45.4,49.3,41.3,00000
49.0,52.0,19.0,752,16,01,  Hudurdoba,167,185,83,87,84,98,47.4,48.8,46.2,00000
49.0,52.0,19.0,994,01,01,  Shibuttar Moylar Bhita,367,349,206,156,161,193,51.3,56.9,45.5,00000
49.0,52.0,19.0,994,02,01,  Kanibari,334,275,166,121,168,154,54.8,57.8,52.2,00000
49.0,52.0,19.0,994,03,01,  Japur Bhita,276,395,130,170,146,225,41.1,43.3,39.4,00000
49.0,52.0,19.0,994,04,01,  Kuranir Bhita,135,292,69,136,66,156,31.6,33.7,29.7,00000
49.0,52.0,19.0,994,05,01,  Sukan Dighi,191,185,99,69,92,116,50.8,58.9,44.2,00000
49.0,52.0,19.0,994,06,01,  Dungdungirhat,328,472,179,200,149,272,41.0,47.2,35.4,00000
49.0,52.0,19.0,994,07,01,  Daktar Para,206,195,123,77,83,118,51.4,61.5,41.3,00000
49.0,52.0,19.0,994,08,01,  Panchgandi,125,190,65,72,60,118,39.7,47.4,33.7,00000
49.0,52.0,19.0,994,09,01,  Jogi Para,159,171,80,74,79,97,48.2,51.9,44.9,00000
49.0,52.0,19.0,994,10,01,  Batuakhana,227,260,114,116,113,144,46.6,49.6,44.0,00000
49.0,52.0,19.0,994,11,01,  Faraji Para,202,149,103,65,99,84,57.5,61.3,54.1,00000
49.0,52.0,19.0,994,12,01,  Sardar Para,223,243,122,108,101,135,47.9,53.0,42.8,00000
49.0,52.0,19.0,994,13,01,  Jakua Para,113,218,58,99,55,119,34.1,36.9,31.6,00000
49.0,52.0,28.0,331,01,01,  Kamar Hailla,245,527,141,244,104,283,31.7,36.6,26.9,00000
49.0,52.0,28.0,331,02,01,  Sakhari Para,174,323,95,138,79,185,35.0,40.8,29.9,00000
49.0,52.0,28.0,331,03,01,  Duba Chhari,224,221,117,95,107,126,50.3,55.2,45.9,00000
49.0,52.0,28.0,331,04,01,  Ghogadaha,222,256,136,118,86,138,46.4,53.5,38.4,00000
49.0,52.0,28.0,331,05,01,  Shantir Bhita,211,192,113,68,98,124,52.4,62.4,44.1,00000
49.0,52.0,28.0,331,06,01,  Kharuarpar,90,240,40,118,50,122,27.3,25.3,29.1,00000
49.0,52.0,28.0,331,07,01,  Kajaldaha,480,725,262,340,218,385,39.8,43.5,36.2,00000
49.0,52.0,28.0,331,08,01,  Katlamari,145,160,86,78,59,82,47.5,52.4,41.8,00000
49.0,52.0,28.0,548,01,01,  Dakshin Chandar Khamar,155,173,82,80,73,93,47.3,50.6,44.0,00000
49.0,52.0,28.0,548,02,01,  Sardar Para,232,190,121,82,111,108,55.0,59.6,50.7,00000
49.0,52.0,28.0,548,03,01,  Mara Tari,202,255,110,115,92,140,44.2,48.9,39.7,00000
49.0,52.0,28.0,548,04,01,  Charua Para,181,207,98,93,83,114,46.6,51.3,42.1,00000
49.0,52.0,28.0,548,05,01,  Kablar Bhita,195,205,90,104,105,101,48.8,46.4,51.0,00000
49.0,52.0,28.0,548,06,01,  Kachi Char,92,193,56,89,36,104,32.3,38.6,25.7,00000
49.0,52.0,28.0,816,01,01,  Gopalar Khamar,210,250,115,114,95,136,45.7,50.2,41.1,00000
49.0,52.0,28.0,816,02,01,  Dobariar Bhita,273,423,143,164,130,259,39.2,46.6,33.4,00000
49.0,52.0,28.0,816,03,01,  Gunar Bhita,245,222,133,107,112,115,52.5,55.4,49.3,00000
49.0,52.0,28.0,816,04,01,  Sonalirkuti,259,337,147,154,112,183,43.5,48.8,38.0,00000
49.0,52.0,28.0,816,05,01,  Hajirkuti,131,262,71,119,60,143,33.3,37.4,29.6,00000
49.0,52.0,28.0,816,06,01,  Ghogadaha,165,160,92,73,73,87,50.8,55.8,45.6,00000
49.0,52.0,28.0,816,07,01,  Sardar Para,242,128,130,51,112,77,65.4,71.8,59.3,00000
49.0,52.0,28.0,816,08,01,  Kanchi Char,63,180,33,79,30,101,25.9,29.5,22.9,00000
49.0,52.0,28.0,816,09,01,  Dakshin Chandar Khamar,144,152,82,67,62,85,48.6,55.0,42.2,00000
49.0,52.0,28.0,816,10,01,  Shatibari,213,212,108,87,105,125,50.1,55.4,45.7,00000
49.0,52.0,28.0,816,11,01,  Jumarkuti,177,338,94,129,83,209,34.4,42.2,28.4,00000
49.0,52.0,28.0,816,12,01,  Nagar Khamar,118,174,69,73,49,101,40.4,48.6,32.7,00000
49.0,52.0,28.0,816,13,01,  Choyter Khamar,328,594,172,272,156,322,35.6,38.7,32.6,00000
49.0,52.0,28.0,816,15,01,  Uttar Chandar Khamar,178,124,101,50,77,74,58.9,66.9,51.0,00000
49.0,52.0,28.0,816,16,01,  Mara Tari,239,197,125,89,114,108,54.8,58.4,51.4,00000
49.0,52.0,28.0,816,17,01,  Kumar Para,148,134,81,65,67,69,52.5,55.5,49.3,00000
49.0,52.0,28.0,816,18,01,  Lakshmir Khamar,139,297,82,130,57,167,31.9,38.7,25.4,00000
49.0,52.0,28.0,816,19,01,  Bhelar Bhita,228,204,120,82,108,122,52.8,59.4,47.0,00000
49.0,52.0,28.0,816,20,01,  Gaglarpar,137,281,77,124,60,157,32.8,38.3,27.6,00000
49.0,52.0,28.0,841,01,01,  Khamar Krishnaram,174,239,91,122,83,117,42.1,42.7,41.5,00000
49.0,52.0,28.0,841,02,01,  Girairpar,18,39,8,15,10,24,31.6,34.8,29.4,00000
49.0,52.0,28.0,841,03,01,  Danabanga,28,68,15,28,13,40,29.2,34.9,24.5,00000
49.0,52.0,28.0,841,04,01,  Voysarkuti,182,176,93,75,89,101,50.8,55.4,46.8,00000
49.0,52.0,28.0,841,05,01,  Brahmauttar,169,562,90,247,79,315,23.1,26.7,20.1,00000
49.0,52.0,28.0,841,06,01,  Rasulpur,53,292,33,108,20,184,15.4,23.4,9.8,00000
49.0,52.0,28.0,841,07,01,  Char Rasulpur,89,259,52,134,37,125,25.6,28.0,22.8,00000
49.0,52.0,28.0,841,08,01,  Duba Char,205,230,114,99,91,131,47.1,53.5,41.0,00000
49.0,52.0,28.0,854,01,01,  Raulia,141,504,77,222,64,282,21.9,25.8,18.5,00000
49.0,52.0,28.0,854,02,01,  Kumargati,57,343,25,166,32,177,14.3,13.1,15.3,00000
49.0,52.0,28.0,854,03,01,  Pathariar Bhita,71,140,40,61,31,79,33.6,39.6,28.2,00000
49.0,52.0,28.0,854,04,01,  Dubariar Bhita,166,278,85,115,81,163,37.4,42.5,33.2,00000
49.0,52.0,28.0,943,01,01,  Sobhandaha,459,662,268,294,191,368,40.9,47.7,34.2,00000
49.0,52.0,28.0,943,02,01,  Kanchi Char,609,1861,338,813,271,1048,24.7,29.4,20.5,00000
49.0,52.0,38.0,178,01,01,  Sarkar Para,374,517,179,247,195,270,42.0,42.0,41.9,00000
49.0,52.0,38.0,178,02,01,  Jola Para,148,162,75,75,73,87,47.7,50.0,45.6,00000
49.0,52.0,38.0,178,03,01,  Hindu Para,356,203,209,69,147,134,63.7,75.2,52.3,00000
49.0,52.0,38.0,178,04,01,  Pangatari,286,352,145,169,141,183,44.8,46.2,43.5,00000
49.0,52.0,38.0,178,05,01,  Bhatihal,251,392,128,210,123,182,39.0,37.9,40.3,00000
49.0,52.0,38.0,178,06,01,  Kamar Para,101,208,53,109,48,99,32.7,32.7,32.7,00000
49.0,52.0,38.0,357,01,01,  Dakshin Holokhana,124,483,74,227,50,256,20.4,24.6,16.3,00000
49.0,52.0,38.0,357,02,01,  Uttar Holokhana,273,935,145,460,128,475,22.6,24.0,21.2,00000
49.0,52.0,38.0,357,03,01,  Purba Holokhana,139,422,79,210,60,212,24.8,27.3,22.1,00000
49.0,52.0,38.0,612,01,01,  Lakshmikanta,328,855,189,419,139,436,27.7,31.1,24.2,00000
49.0,52.0,38.0,612,02,01,  Char Lakshmikanta,305,644,161,301,144,343,32.1,34.8,29.6,00000
49.0,52.0,38.0,625,01,01,  Balakura,154,226,87,105,67,121,40.5,45.3,35.6,00000
49.0,52.0,38.0,625,02,01,  Madajal Para,326,416,162,208,164,208,43.9,43.8,44.1,00000
49.0,52.0,38.0,625,03,01,  Mandal Para,190,232,95,123,95,109,45.0,43.6,46.6,00000
49.0,52.0,38.0,625,04,01,  Kazi Para,184,191,99,95,85,96,49.1,51.0,47.0,00000
49.0,52.0,38.0,956,01,01,  Char Subharkuthi,618,1501,307,747,311,754,29.2,29.1,29.2,00000
49.0,52.0,38.0,956,02,01,  Upar Subharkuthi,790,1060,423,483,367,577,42.7,46.7,38.9,00000
49.0,52.0,47.0,089,01,01,  Majhi Alir Char,165,457,81,225,84,232,26.5,26.5,26.6,00000
49.0,52.0,47.0,089,02,01,  Goalpurir Char,92,437,47,204,45,233,17.4,18.7,16.2,00000
49.0,52.0,47.0,089,03,01,  Kheralga,112,538,55,263,57,275,17.2,17.3,17.2,00000
49.0,52.0,47.0,153,01,01,  Dakshin Bhagabatipur,48,202,21,94,27,108,19.2,18.3,20.0,00000
49.0,52.0,47.0,153,02,01,  Uttar Bhagabatipur,217,807,112,361,105,446,21.2,23.7,19.1,00000
49.0,52.0,47.0,318,01,01,  Garuhara,644,1595,322,674,322,921,28.8,32.3,25.9,00000
49.0,52.0,47.0,318,02,01,  Char Ghanashyampur,47,474,30,242,17,232,9.0,11.0,6.8,00000
49.0,52.0,47.0,318,03,01,  Khana Para,384,531,214,224,170,307,42.0,48.9,35.6,00000
49.0,52.0,47.0,318,04,01,  Nawa Para,287,331,157,143,130,188,46.4,52.3,40.9,00000
49.0,52.0,47.0,318,05,01,  Dhallar Para,445,724,245,332,200,392,38.1,42.5,33.8,00000
49.0,52.0,47.0,318,06,01,  Bhashir Bhita,390,409,227,177,163,232,48.8,56.2,41.3,00000
49.0,52.0,47.0,420,01,01,  Char Jatrapur,237,1486,128,709,109,777,13.8,15.3,12.3,00000
49.0,52.0,47.0,420,02,01,  Nowani Para,156,206,98,92,58,114,43.1,51.6,33.7,00000
49.0,52.0,47.0,420,03,01,  Sarkar Para,128,260,90,119,38,141,33.0,43.1,21.2,00000
49.0,52.0,47.0,420,04,01,  Farazi Para,58,240,32,111,26,129,19.5,22.4,16.8,00000
49.0,52.0,47.0,497,01,01,  Kalir Agla,89,305,46,136,43,169,22.6,25.3,20.3,00000
49.0,52.0,47.0,497,02,01,  Musulli Para,149,373,88,181,61,192,28.5,32.7,24.1,00000
49.0,52.0,47.0,497,03,01,  Dakshin Kalir Agla,79,277,49,131,30,146,22.2,27.2,17.0,00000
49.0,52.0,47.0,778,01,01,  Dakshin Junker Char,105,286,53,129,52,157,26.9,29.1,24.9,00000
49.0,52.0,47.0,778,02,01,  Uttar Junker Char,48,257,25,123,23,134,15.7,16.9,14.6,00000
49.0,52.0,47.0,778,03,01,  Ralakata Chak,76,128,36,59,40,69,37.3,37.9,36.7,00000
49.0,52.0,47.0,829,01,01,  Junker Char,78,147,43,66,35,81,34.7,39.4,30.2,00000
49.0,52.0,47.0,829,02,01,  Chira Khaya Char,25,69,20,37,5,32,26.6,35.1,13.5,00000
49.0,52.0,47.0,829,03,01,  Debarikhola,125,448,68,219,57,229,21.8,23.7,19.9,00000
49.0,52.0,47.0,829,04,01,  Poesti Junker Char,54,139,26,59,28,80,28.0,30.6,25.9,00000
49.0,52.0,57.0,306,01,01,  Dawpara,322,107,173,34,149,73,75.1,83.6,67.1,00000
49.0,52.0,57.0,306,02,01,  Buridubar Para,224,181,119,90,105,91,55.3,56.9,53.6,00000
49.0,52.0,57.0,306,03,01,  Tuffar Bazar,131,178,66,83,65,95,42.4,44.3,40.6,00000
49.0,52.0,57.0,446,01,01,  Badu Para,111,227,58,122,53,105,32.8,32.2,33.5,00000
49.0,52.0,57.0,446,02,01,  Jakua Para,60,221,35,112,25,109,21.4,23.8,18.7,00000
49.0,52.0,57.0,446,03,01,  Sarkar Para,390,284,215,135,175,149,57.9,61.4,54.0,00000
49.0,52.0,57.0,446,04,01,  Junkutari,54,239,32,126,22,113,18.4,20.3,16.3,00000
49.0,52.0,57.0,446,05,01,  Nadirpar,177,186,90,80,87,106,48.8,52.9,45.1,00000
49.0,52.0,57.0,523,01,01,  Hindu Para,147,94,87,36,60,58,61.0,70.7,50.8,00000
49.0,52.0,57.0,523,02,01,  Daktartari,118,122,63,59,55,63,49.2,51.6,46.6,00000
49.0,52.0,57.0,535,01,01,  Pathantari,64,64,37,28,27,36,50.0,56.9,42.9,00000
49.0,52.0,57.0,535,02,01,  Jogi Para,26,99,13,52,13,47,20.8,20.0,21.7,00000
49.0,52.0,57.0,535,03,01,  Farmantari,191,159,106,76,85,83,54.6,58.2,50.6,00000
49.0,52.0,57.0,535,04,01,  Balatari,186,99,118,54,68,45,65.3,68.6,60.2,00000
49.0,52.0,57.0,535,05,01,  Sardar Para,83,166,43,88,40,78,33.3,32.8,33.9,00000
49.0,52.0,57.0,535,06,01,  Bepari Para,327,305,173,138,154,167,51.7,55.6,48.0,00000
49.0,52.0,57.0,663,01,01,  Bhanur Bhita,352,326,195,143,157,183,51.9,57.7,46.2,00000
49.0,52.0,57.0,663,02,01,  Bashabari,176,233,95,99,81,134,43.0,49.0,37.7,00000
49.0,52.0,57.0,663,03,01,  Palpara,26,29,20,11,6,18,47.3,64.5,25.0,00000
49.0,52.0,57.0,790,01,01,  Nayak Para,234,122,123,59,111,63,65.7,67.6,63.8,00000
49.0,52.0,57.0,790,02,01,  Dasarhat,374,384,204,177,170,207,49.3,53.5,45.1,00000
49.0,52.0,57.0,803,01,01,  Kendra,179,163,102,86,77,77,52.3,54.3,50.0,00000
49.0,52.0,57.0,803,02,01,  Karji Para,173,163,107,60,66,103,51.5,64.1,39.1,00000
49.0,52.0,57.0,803,03,01,  Behara Para,43,42,26,19,17,23,50.6,57.8,42.5,00000
49.0,52.0,57.0,803,04,01,  Tagraihati,141,191,75,87,66,104,42.5,46.3,38.8,00000
49.0,52.0,57.0,803,05,01,  Pathan Para,97,197,51,90,46,107,33.0,36.2,30.1,00000
49.0,52.0,57.0,803,06,01,  Chiragram,127,164,63,69,64,95,43.6,47.7,40.3,00000
49.0,52.0,57.0,803,07,01,  Nafar Dargah,148,195,81,87,67,108,43.1,48.2,38.3,00000
49.0,52.0,57.0,803,08,01,  Bairagi Para,243,158,141,64,102,94,60.6,68.8,52.0,00000
49.0,52.0,57.0,803,09,01,  Bepari Para,508,405,253,176,255,229,55.6,59.0,52.7,00000
49.0,52.0,57.0,867,01,01,  Majhi Para,403,504,222,225,181,279,44.4,49.7,39.3,00000
49.0,52.0,57.0,867,02,01,  Kamar Para,382,461,217,305,165,156,45.3,41.6,51.4,00000
49.0,52.0,57.0,918,01,01,  Kumar Para,194,227,97,97,97,130,46.1,50.0,42.7,00000
49.0,52.0,57.0,918,02,01,  Pramaniktari,601,597,321,264,280,333,50.2,54.9,45.7,00000
49.0,52.0,57.0,918,03,01,  Patni Para,83,201,35,97,48,104,29.2,26.5,31.6,00000
49.0,52.0,57.0,918,04,01,  Muchi Para,129,181,72,84,57,97,41.6,46.2,37.0,00000
49.0,52.0,57.0,918,05,01,  Saha Para,173,245,90,112,83,133,41.4,44.6,38.4,00000
49.0,52.0,57.0,918,06,01,  Bhabaneshwar,511,339,266,161,245,178,60.1,62.3,57.9,00000
49.0,52.0,57.0,918,07,01,  Alotari,275,118,141,47,134,71,70.0,75.0,65.4,00000
49.0,52.0,57.0,918,08,01,  Khamar Para,320,297,172,131,148,166,51.9,56.8,47.1,00000
49.0,52.0,57.0,918,09,01,  Goalar Bhita,148,183,79,84,69,99,44.7,48.5,41.1,00000
49.0,52.0,57.0,918,10,01,  Ragati Para,233,310,128,144,105,166,42.9,47.1,38.7,00000
49.0,52.0,57.0,918,11,01,  Fakir Para,622,631,345,298,277,333,49.6,53.7,45.4,00000
49.0,52.0,57.0,918,12,01,  Karji Para,178,239,92,113,86,126,42.7,44.9,40.6,00000
49.0,52.0,57.0,918,13,01,  Patbhata,135,193,70,93,65,100,41.2,42.9,39.4,00000
49.0,52.0,57.0,918,14,01,  Ghopatari,188,161,105,75,83,86,53.9,58.3,49.1,00000
49.0,52.0,57.0,918,15,01,  Munshi Para,97,90,53,42,44,48,51.9,55.8,47.8,00000
49.0,52.0,57.0,969,01,01,  Khularpar,274,214,156,85,118,129,56.1,64.7,47.8,00000
49.0,52.0,57.0,969,02,01,  Kuya Para,287,133,167,49,120,84,68.3,77.3,58.8,00000
49.0,52.0,57.0,969,03,01,  Khan Para,370,392,207,178,163,214,48.6,53.8,43.2,00000
49.0,52.0,57.0,969,04,01,  Ghosh Para,255,167,137,73,118,94,60.4,65.2,55.7,00000
49.0,52.0,76.0,229,01,01,  Majagram,319,339,185,143,134,196,48.5,56.4,40.6,00000
49.0,52.0,76.0,229,02,01,  Khamar,318,317,173,134,145,183,50.1,56.4,44.2,00000
49.0,52.0,76.0,229,03,01,  Char Sitai Jhar,863,2056,447,886,416,1170,29.6,33.5,26.2,00000
49.0,52.0,76.0,229,04,01,  Bepari Para,420,596,223,256,197,340,41.3,46.6,36.7,00000
49.0,52.0,85.0,025,01,01,  Uttar Noabash,405,661,231,308,174,353,38.0,42.9,33.0,00000
49.0,52.0,85.0,025,02,01,  Dakshin Noabash,404,829,231,372,173,457,32.8,38.3,27.5,00000
49.0,52.0,85.0,025,03,01,  Char Noabash,408,641,193,308,215,333,38.9,38.5,39.2,00000
49.0,52.0,85.0,038,01,01,  Arazi Kadamtala,614,850,295,363,319,487,41.9,44.8,39.6,00000
49.0,52.0,85.0,038,02,01,  Garuhara,265,598,161,283,104,315,30.7,36.3,24.8,00000
49.0,52.0,85.0,038,03,01,  Elabadir Char,13,240,9,95,4,145,5.1,8.7,2.7,00000
49.0,52.0,85.0,227,01,01,  Uttar Sitaijhar,461,1336,272,583,189,753,25.7,31.8,20.1,00000
49.0,52.0,85.0,227,02,01,  Dakshin Sitaijhar,604,1144,333,498,271,646,34.6,40.1,29.6,00000
49.0,52.0,85.0,267,01,01,  Noyani,576,576,311,255,265,321,50.0,54.9,45.2,00000
49.0,52.0,85.0,267,02,01,  Nama Char,402,787,216,338,186,449,33.8,39.0,29.3,00000
49.0,52.0,85.0,267,03,01,  Jakua Para,882,1460,440,591,442,869,37.7,42.7,33.7,00000
49.0,52.0,85.0,267,04,01,  Jola Para,525,926,292,406,233,520,36.2,41.8,30.9,00000
49.0,52.0,85.0,267,05,01,  Mandal Para,442,328,236,118,206,210,57.4,66.7,49.5,00000
49.0,52.0,85.0,267,06,01,  Majhi Para,89,292,52,133,37,159,23.4,28.1,18.9,00000
49.0,52.0,85.0,267,07,01,  Garial Para,217,138,117,46,100,92,61.1,71.8,52.1,00000
49.0,52.0,85.0,344,01,01,  Gobindapur (Kaim),300,680,147,282,153,398,30.6,34.3,27.8,00000
49.0,52.0,85.0,344,02,01,  Char Gobindapur,529,1556,273,696,256,860,25.4,28.2,22.9,00000
49.0,52.0,85.0,459,01,01,  Kadamtala,718,1554,399,618,319,936,31.6,39.2,25.4,00000
49.0,52.0,85.0,459,02,01,  Char Kadamtola,52,232,31,106,21,126,18.3,22.6,14.3,00000
49.0,61.0,11.0,163,01,01,  Alongajani,220,644,118,279,102,365,25.5,29.7,21.8,00000
49.0,61.0,11.0,163,02,01,  Dewanjagi,343,1005,170,467,173,538,25.4,26.7,24.3,00000
49.0,61.0,11.0,365,01,01,  Tapur Char,512,915,252,406,260,509,35.9,38.3,33.8,00000
49.0,61.0,11.0,365,02,01,  Brahmuttar,842,1110,487,477,355,633,43.1,50.5,35.9,00000
49.0,61.0,11.0,365,03,01,  Char Dhariarpar,243,560,146,258,97,302,30.3,36.1,24.3,00000
49.0,61.0,11.0,365,04,01,  Dhariarpar,642,1133,357,475,285,658,36.2,42.9,30.2,00000
49.0,61.0,11.0,365,05,01,  Sen Para,421,731,243,320,178,411,36.5,43.2,30.2,00000
49.0,61.0,11.0,365,06,01,  Kumar Para,370,495,204,219,166,276,42.8,48.2,37.6,00000
49.0,61.0,11.0,365,07,01,  Mollah Para,211,476,107,202,104,274,30.7,34.6,27.5,00000
49.0,61.0,11.0,591,01,01,  Darar Bhita,205,451,104,178,101,273,31.3,36.9,27.0,00000
49.0,61.0,11.0,591,02,01,  Krishnapur Char,437,1100,247,475,190,625,28.4,34.2,23.3,00000
49.0,61.0,11.0,591,03,01,  Raghur Bhita,245,775,120,338,125,437,24.0,26.2,22.2,00000
49.0,61.0,11.0,667,01,01,  Char Madarganj,177,536,102,229,75,307,24.8,30.8,19.6,00000
49.0,61.0,11.0,667,02,01,  Madarganj Bazar,455,742,245,277,210,465,38.0,46.9,31.1,00000
49.0,61.0,11.0,667,03,01,  Fakir Para,478,638,253,256,225,382,42.8,49.7,37.1,00000
49.0,61.0,12.0,125,01,01,  Bowalerdara,122,171,56,79,66,92,41.6,41.5,41.8,00000
49.0,61.0,12.0,125,02,01,  Pateshwari,173,259,101,123,72,136,40.0,45.1,34.6,00000
49.0,61.0,12.0,125,03,01,  Mominganj,174,245,93,124,81,121,41.5,42.9,40.1,00000
49.0,61.0,12.0,125,04,01,  Charuatari,266,61,136,26,130,35,81.3,84.0,78.8,00000
49.0,61.0,12.0,125,06,01,  Phulmari,76,167,32,92,44,75,31.3,25.8,37.0,00000
49.0,61.0,12.0,125,07,01,  Namahaila,128,145,76,58,52,87,46.9,56.7,37.4,00000
49.0,61.0,12.0,125,08,01,  Dhanitari,353,552,181,259,172,293,39.0,41.1,37.0,00000
49.0,61.0,12.0,125,09,01,  Antairpar,219,225,117,112,102,113,49.3,51.1,47.4,00000
49.0,61.0,12.0,125,10,01,  Kuti Bamandanga,297,515,129,254,168,261,36.6,33.7,39.2,00000
49.0,61.0,12.0,125,11,01,  Sardar Bhita,171,208,91,104,80,104,45.1,46.7,43.5,00000
49.0,61.0,12.0,125,12,01,  Panatitari,196,365,98,171,98,194,34.9,36.4,33.6,00000
49.0,61.0,12.0,125,13,01,  Shean Para,215,117,124,40,91,77,64.8,75.6,54.2,00000
49.0,61.0,12.0,125,14,01,  Galadigli,139,110,78,49,61,61,55.8,61.4,50.0,00000
49.0,61.0,12.0,125,15,01,  Baramani,432,351,206,169,226,182,55.2,54.9,55.4,00000
49.0,61.0,12.0,264,01,01,  Char Luchhni Uttar,90,359,50,174,40,185,20.0,22.3,17.8,00000
49.0,61.0,12.0,264,02,01,  Dakhin Char Luchhni,207,533,117,226,90,307,28.0,34.1,22.7,00000
49.0,61.0,12.0,642,01,01,  Kutir Char,74,518,43,253,31,265,12.5,14.5,10.5,00000
49.0,61.0,12.0,642,02,01,  Dakhin Kait Char,66,402,33,191,33,211,14.1,14.7,13.5,00000
49.0,61.0,12.0,654,01,01,  Luchhni,306,932,152,451,154,481,24.7,25.2,24.3,00000
49.0,61.0,12.0,654,02,01,  Uttar Luchhni,140,621,87,290,53,331,18.4,23.1,13.8,00000
49.0,61.0,12.0,654,03,01,  Pachim  Luchhni,62,613,42,296,20,317,9.2,12.4,5.9,00000
49.0,61.0,12.0,680,01,01,  Maliani,186,393,98,168,88,225,32.1,36.8,28.1,00000
49.0,61.0,12.0,680,02,01,  Char Muria,66,210,37,96,29,114,23.9,27.8,20.3,00000
49.0,61.0,12.0,957,01,01,  Teliani,733,708,369,321,364,387,50.9,53.5,48.5,00000
49.0,61.0,12.0,957,02,01,  Teliani Kuti,454,634,222,280,232,354,41.7,44.2,39.6,00000
49.0,61.0,18.0,088,01,01,  Kumriarpar,134,202,77,96,57,106,39.9,44.5,35.0,00000
49.0,61.0,18.0,088,02,01,  Khelar Bhita,546,728,276,338,270,390,42.9,45.0,40.9,00000
49.0,61.0,18.0,088,03,01,  Chilmari,419,376,222,162,197,214,52.7,57.8,47.9,00000
49.0,61.0,18.0,088,04,01,  Faraskura,502,629,251,283,251,346,44.4,47.0,42.0,00000
49.0,61.0,18.0,088,05,01,  Mawamari,717,623,391,269,326,354,53.5,59.2,47.9,00000
49.0,61.0,18.0,088,06,01,  Khamar Nakula,439,710,226,331,213,379,38.2,40.6,36.0,00000
49.0,61.0,18.0,088,07,01,  Berubari,243,181,113,75,130,106,57.3,60.1,55.1,00000
49.0,61.0,18.0,088,08,01,  Satana,233,246,114,110,119,136,48.6,50.9,46.7,00000
49.0,61.0,18.0,088,09,01,  Mirar Bhita,148,343,74,160,74,183,30.1,31.6,28.8,00000
49.0,61.0,18.0,088,10,01,  Bamnar Bhita,96,330,55,156,41,174,22.5,26.1,19.1,00000
49.0,61.0,18.0,239,01,01,  Char Berubari,119,693,66,320,53,373,14.7,17.1,12.4,00000
49.0,61.0,18.0,239,02,01,  Sengram,62,238,32,109,30,129,20.7,22.7,18.9,00000
49.0,61.0,18.0,239,03,01,  Sarkar Para,222,581,129,279,93,302,27.6,31.6,23.5,00000
49.0,61.0,18.0,239,04,01,  Haji Para,184,626,100,261,84,365,22.7,27.7,18.7,00000
49.0,61.0,18.0,239,05,01,  Wapda Para,110,353,64,163,46,190,23.8,28.2,19.5,00000
49.0,61.0,18.0,239,06,01,  Mandal Para,256,717,144,332,112,385,26.3,30.3,22.5,00000
49.0,61.0,18.0,982,01,01,  Char Rahmanerkuti,246,1017,124,423,122,594,19.5,22.7,17.0,00000
49.0,61.0,18.0,982,02,01,  Baliarkuti,151,500,68,232,83,268,23.2,22.7,23.6,00000
49.0,61.0,18.0,982,03,01,  Salmara,694,1084,344,480,350,604,39.0,41.7,36.7,00000
49.0,61.0,18.0,982,04,01,  Gachpari,491,700,236,321,255,379,41.2,42.4,40.2,00000
49.0,61.0,18.0,982,05,01,  Char Tupamari,299,641,152,303,147,338,31.8,33.4,30.3,00000
49.0,61.0,25.0,176,01,01,  Digdarirpar,156,239,79,114,77,125,39.5,40.9,38.1,00000
49.0,61.0,25.0,176,02,01,  Hatibanda,84,70,46,33,38,37,54.5,58.2,50.7,00000
49.0,61.0,25.0,176,03,01,  Kumar Para,63,235,40,106,23,129,21.1,27.4,15.1,00000
49.0,61.0,25.0,176,04,01,  Bhitarband Bazar,383,158,200,59,183,99,70.8,77.2,64.9,00000
49.0,61.0,25.0,176,05,01,  Nagar Para,79,294,42,141,37,153,21.2,23.0,19.5,00000
49.0,61.0,25.0,176,06,01,  Jokamari,101,105,49,45,52,60,49.0,52.1,46.4,00000
49.0,61.0,25.0,176,07,01,  Doali Para,384,355,200,170,184,185,52.0,54.1,49.9,00000
49.0,61.0,25.0,176,08,01,  Bara Banar Bhita,66,105,29,42,37,63,38.6,40.8,37.0,00000
49.0,61.0,25.0,176,09,01,  Sikdarkura,184,334,109,148,75,186,35.5,42.4,28.7,00000
49.0,61.0,25.0,176,10,01,  Nawa Para,111,230,62,108,49,122,32.6,36.5,28.7,00000
49.0,61.0,25.0,176,11,01,  Dabertal,149,283,75,133,74,150,34.5,36.1,33.0,00000
49.0,61.0,25.0,176,12,01,  Majhi Para,104,145,55,76,49,69,41.8,42.0,41.5,00000
49.0,61.0,25.0,188,01,01,  Bhangamor,428,527,228,231,200,296,44.8,49.7,40.3,00000
49.0,61.0,25.0,188,02,01,  Bhitarkuti,307,415,162,171,145,244,42.5,48.6,37.3,00000
49.0,61.0,25.0,188,03,01,  Nawdabosh,112,213,68,96,44,117,34.5,41.5,27.3,00000
49.0,61.0,25.0,188,04,01,  Baman Para,194,187,99,82,95,105,50.9,54.7,47.5,00000
49.0,61.0,25.0,214,01,01,  Chandipur,184,184,91,74,93,110,50.0,55.2,45.8,00000
49.0,61.0,25.0,214,02,01,  Batuakhana,200,225,117,94,83,131,47.1,55.5,38.8,00000
49.0,61.0,25.0,214,03,01,  Baman Para,105,96,58,43,47,53,52.2,57.4,47.0,00000
49.0,61.0,25.0,214,04,01,  Monnearpar,172,289,72,129,100,160,37.3,35.8,38.5,00000
49.0,61.0,25.0,214,05,01,  Bandi Tari,278,329,142,151,136,178,45.8,48.5,43.3,00000
49.0,61.0,25.0,214,06,01,  Shatkurapar,245,180,128,65,117,115,57.6,66.3,50.4,00000
49.0,61.0,25.0,214,07,01,  Koach Para,332,401,172,186,160,215,45.3,48.0,42.7,00000
49.0,61.0,25.0,214,08,01,  Kamar Para,176,173,96,78,80,95,50.4,55.2,45.7,00000
49.0,61.0,25.0,214,09,01,  Debuttar,228,394,122,167,106,227,36.7,42.2,31.8,00000
49.0,61.0,25.0,321,01,01,  Pondith Para,280,491,142,215,138,276,36.3,39.8,33.3,00000
49.0,61.0,25.0,321,02,01,  Senpara,182,310,94,150,88,160,37.0,38.5,35.5,00000
49.0,61.0,25.0,321,03,01,  Hatibandha,166,209,93,109,73,100,44.3,46.0,42.2,00000
49.0,61.0,25.0,321,04,01,  Takimari,134,237,77,103,57,134,36.1,42.8,29.8,00000
49.0,61.0,25.0,403,01,01,  Bhati Digdari,88,167,32,88,56,79,34.5,26.7,41.5,00000
49.0,61.0,25.0,403,02,01,  Charua Para,175,467,89,234,86,233,27.3,27.6,27.0,00000
49.0,61.0,25.0,403,03,01,  Nawa Para,265,173,137,82,128,91,60.5,62.6,58.4,00000
49.0,61.0,25.0,403,04,01,  Uddamari,184,199,105,72,79,127,48.0,59.3,38.3,00000
49.0,61.0,25.0,403,05,01,  Khansamar Bhita,40,255,17,115,23,140,13.6,12.9,14.1,00000
49.0,61.0,25.0,403,06,01,  Mandaler Bhita,72,259,44,116,28,143,21.8,27.5,16.4,00000
49.0,61.0,25.0,403,07,01,  Bania Para,95,242,43,104,52,138,28.2,29.3,27.4,00000
49.0,61.0,25.0,403,08,01,  Jakuabari,217,275,113,128,104,147,44.1,46.9,41.4,00000
49.0,61.0,25.0,403,09,01,  Koach Para,95,214,53,90,42,124,30.7,37.1,25.3,00000
49.0,61.0,25.0,491,01,01,  Kumar Para,178,312,102,151,76,161,36.3,40.3,32.1,00000
49.0,61.0,25.0,491,02,01,  Zola Para,124,106,68,48,56,58,53.9,58.6,49.1,00000
49.0,61.0,25.0,705,01,01,  Jagannather Khamar,444,563,214,247,230,316,44.1,46.4,42.1,00000
49.0,61.0,25.0,705,02,01,  Kachuarpar,134,206,69,95,65,111,39.4,42.1,36.9,00000
49.0,61.0,25.0,705,03,01,  Bamuner Bhita,40,133,26,68,14,65,23.1,27.7,17.7,00000
49.0,61.0,25.0,705,04,01,  Madhaikhal,159,148,85,55,74,93,51.8,60.7,44.3,00000
49.0,61.0,31.0,466,01,01,  Kabiraj Para,231,167,127,71,104,96,58.0,64.1,52.0,00000
49.0,61.0,31.0,466,02,01,  Chintar Khamar,195,191,121,73,74,118,50.5,62.4,38.5,00000
49.0,61.0,31.0,466,03,01,  Chorarpar,255,359,136,155,119,204,41.5,46.7,36.8,00000
49.0,61.0,31.0,466,04,01,  Jola Para,95,139,56,71,39,68,40.6,44.1,36.4,00000
49.0,61.0,31.0,466,05,01,  Kharubhanch,246,527,145,250,101,277,31.8,36.7,26.7,00000
49.0,61.0,31.0,466,06,01,  Dakshin Nawda Para,137,285,79,121,58,164,32.5,39.5,26.1,00000
49.0,61.0,31.0,466,07,01,  Dakshin Chhorarpar,139,180,65,79,74,101,43.6,45.1,42.3,00000
49.0,61.0,31.0,466,08,01,  Chintar Char,244,348,121,161,123,187,41.2,42.9,39.7,00000
49.0,61.0,31.0,466,09,01,  Kamaria Para,135,165,69,71,66,94,45.0,49.3,41.3,00000
49.0,61.0,31.0,466,10,01,  Nawda Para,156,134,77,66,79,68,53.8,53.8,53.7,00000
49.0,61.0,31.0,466,11,01,  Nawa Para,109,195,59,89,50,106,35.9,39.9,32.1,00000
49.0,61.0,31.0,478,01,01,  Bhitar Bandha,40,62,24,29,16,33,39.2,45.3,32.7,00000
49.0,61.0,31.0,478,02,01,  Dhumkuwarpar,120,234,70,107,50,127,33.9,39.5,28.2,00000
49.0,61.0,31.0,478,03,01,  Dobarpar,47,216,28,100,19,116,17.9,21.9,14.1,00000
49.0,61.0,31.0,478,04,01,  Sen Para,100,29,55,10,45,19,77.5,84.6,70.3,00000
49.0,61.0,31.0,478,05,01,  Burir Chharar Para,114,174,65,79,49,95,39.6,45.1,34.0,00000
49.0,61.0,31.0,478,06,01,  Chotalerpar,219,471,134,224,85,247,31.7,37.4,25.6,00000
49.0,61.0,31.0,478,07,01,  Bolairpath,252,401,129,176,123,225,38.6,42.3,35.3,00000
49.0,61.0,31.0,478,08,01,  Kheuni Para(Beparitari),85,238,43,113,42,125,26.3,27.6,25.1,00000
49.0,61.0,31.0,478,09,01,  Khotri Para,53,46,35,19,18,27,53.5,64.8,40.0,00000
49.0,61.0,31.0,478,10,01,  Kachuar Bhita,171,174,103,88,68,86,49.6,53.9,44.2,00000
49.0,61.0,31.0,478,11,01,  Burirdara,196,187,100,87,96,100,51.2,53.5,49.0,00000
49.0,61.0,31.0,478,12,01,  Talipara,57,184,38,80,19,104,23.7,32.2,15.4,00000
49.0,61.0,31.0,478,13,01,  Narir Dolarpar,233,439,124,191,109,248,34.7,39.4,30.5,00000
49.0,61.0,31.0,478,14,01,  Maniarhat,188,521,114,245,74,276,26.5,31.8,21.1,00000
49.0,61.0,31.0,478,15,01,  Talanafa,180,307,106,134,74,173,37.0,44.2,30.0,00000
49.0,61.0,31.0,478,16,01,  Panchat Para,76,191,46,85,30,106,28.5,35.1,22.1,00000
49.0,61.0,31.0,478,17,01,  Kanibari,96,173,47,71,49,102,35.7,39.8,32.5,00000
49.0,61.0,31.0,478,18,01,  Charuatari(Mondalpara),103,303,53,152,50,151,25.4,25.9,24.9,00000
49.0,61.0,31.0,478,19,01,  Munshi Para,168,163,88,68,80,95,50.8,56.4,45.7,00000
49.0,61.0,31.0,478,20,01,  Hawserhat,159,253,83,113,76,140,38.6,42.3,35.2,00000
49.0,61.0,31.0,932,01,01,  Kuti Bari,235,524,136,244,99,280,31.0,35.8,26.1,00000
49.0,61.0,31.0,932,02,01,  Sutibari,697,812,384,365,313,447,46.2,51.3,41.2,00000
49.0,61.0,31.0,932,03,01,  Bhenditari,335,976,183,439,152,537,25.6,29.4,22.1,00000
49.0,61.0,31.0,932,04,01,  Bania Para,167,357,88,156,79,201,31.9,36.1,28.2,00000
49.0,61.0,31.0,932,05,01,  Singarbita Khatripara,297,721,156,345,141,376,29.2,31.1,27.3,00000
49.0,61.0,31.0,932,06,01,  Jola Para,169,425,85,214,84,211,28.5,28.4,28.5,00000
49.0,61.0,31.0,932,07,01,  Goshai Bari,200,288,109,127,91,161,41.0,46.2,36.1,00000
49.0,61.0,37.0,352,01,01,  Uttar Dhanirampur,277,474,140,173,137,301,36.9,44.7,31.3,00000
49.0,61.0,37.0,352,02,01,  Dakshin Dhanirampur,229,608,124,263,105,345,27.4,32.0,23.3,00000
49.0,61.0,37.0,352,03,01,  Sholmari,231,891,121,352,110,539,20.6,25.6,16.9,00000
49.0,61.0,37.0,503,01,01,  Beparitari,563,931,293,349,270,582,37.7,45.6,31.7,00000
49.0,61.0,37.0,503,02,01,  Paikertari,146,485,77,194,69,291,23.1,28.4,19.2,00000
49.0,61.0,37.0,503,03,01,  Kaiyar Char,85,316,57,138,28,178,21.2,29.2,13.6,00000
49.0,61.0,37.0,503,04,01,  Jalir Char,72,224,40,112,32,112,24.3,26.3,22.2,00000
49.0,61.0,37.0,503,05,01,  Dakshin Indragar,259,623,138,272,121,351,29.4,33.7,25.6,00000
49.0,61.0,37.0,503,06,01,  Tunker Char,20,288,15,142,5,146,6.5,9.6,3.3,00000
49.0,61.0,37.0,528,01,01,  Uttarkata,127,462,70,210,57,252,21.6,25.0,18.4,00000
49.0,61.0,37.0,528,02,01,  Jinjira Balar Char,179,386,99,158,80,228,31.7,38.5,26.0,00000
49.0,61.0,37.0,528,03,01,  Noada Para,126,174,73,70,53,104,42.0,51.0,33.8,00000
49.0,61.0,37.0,528,04,01,  Pradhanitari,244,311,133,135,111,176,44.0,49.6,38.7,00000
49.0,61.0,37.0,528,05,01,  Bara Chorarpar,261,402,154,178,107,224,39.4,46.4,32.3,00000
49.0,61.0,37.0,528,06,01,  Chhota Chorarpar,105,524,50,237,55,287,16.7,17.4,16.1,00000
49.0,61.0,37.0,528,07,01,  Bala Para,270,702,149,300,121,402,27.8,33.2,23.1,00000
49.0,61.0,37.0,528,08,01,  Musallitari,108,599,68,254,40,345,15.3,21.1,10.4,00000
49.0,61.0,37.0,528,09,01,  Khamar,90,262,58,91,32,171,25.6,38.9,15.8,00000
49.0,61.0,37.0,528,10,01,  Bhoter Hailla,337,682,185,248,152,434,33.1,42.7,25.9,00000
49.0,61.0,37.0,528,11,01,  Bara Sarkartari,131,580,79,237,52,343,18.4,25.0,13.2,00000
49.0,61.0,37.0,528,12,01,  Chhota Sarkartari,243,749,149,294,94,455,24.5,33.6,17.1,00000
49.0,61.0,37.0,528,13,01,  Kamartari,101,308,58,110,43,198,24.7,34.5,17.8,00000
49.0,61.0,37.0,528,14,01,  Natokerhat,149,236,79,109,70,127,38.7,42.0,35.5,00000
49.0,61.0,37.0,528,15,01,  Budurdola,92,262,50,107,42,155,26.0,31.8,21.3,00000
49.0,61.0,44.0,629,01,01,  Kalikamarer Bhita,189,834,106,389,83,445,18.5,21.4,15.7,00000
49.0,61.0,44.0,629,02,01,  Bepari Para,145,329,89,152,56,177,30.6,36.9,24.0,00000
49.0,61.0,44.0,629,03,01,  Akanda Para,99,234,55,116,44,118,29.7,32.2,27.2,00000
49.0,61.0,44.0,629,04,01,  Beguni Para,160,420,87,192,73,228,27.6,31.2,24.3,00000
49.0,61.0,44.0,629,05,01,  Kapali Para,217,634,137,296,80,338,25.5,31.6,19.1,00000
49.0,61.0,44.0,629,06,01,  Kabiraj Para,134,290,75,154,59,136,31.6,32.8,30.3,00000
49.0,61.0,44.0,629,07,01,  Paitali Para,86,215,51,99,35,116,28.6,34.0,23.2,00000
49.0,61.0,44.0,629,08,01,  Kathgirai,51,518,30,251,21,267,9.0,10.7,7.3,00000
49.0,61.0,44.0,692,01,01,  Shibnather Bos,840,1409,410,559,430,850,37.3,42.3,33.6,00000
49.0,61.0,44.0,692,02,01,  Phandar Bhita,172,399,94,155,78,244,30.1,37.8,24.2,00000
49.0,61.0,44.0,692,03,01,  Chat Bangaler Bhita,97,267,54,122,43,145,26.6,30.7,22.9,00000
49.0,61.0,44.0,692,04,01,  Poddarer Bhita,110,179,64,70,46,109,38.1,47.8,29.7,00000
49.0,61.0,44.0,692,05,01,  Monneyarpar,261,907,142,401,119,506,22.3,26.2,19.0,00000
49.0,61.0,44.0,692,06,01,  Gordararpar,116,149,63,67,53,82,43.8,48.5,39.3,00000
49.0,61.0,44.0,894,01,01,  Madaikhal,213,462,119,197,94,265,31.6,37.7,26.2,00000
49.0,61.0,44.0,894,02,01,  Digalhalla,168,202,87,90,81,112,45.4,49.2,42.0,00000
49.0,61.0,44.0,894,03,01,  Korani Para,148,260,79,127,69,133,36.3,38.3,34.2,00000
49.0,61.0,44.0,894,04,01,  Kaliganj,302,222,162,87,140,135,57.6,65.1,50.9,00000
49.0,61.0,44.0,894,05,01,  Dhanir Bhita,95,311,48,123,47,188,23.4,28.1,20.0,00000
49.0,61.0,44.0,894,06,01,  Jokri Para,124,208,57,90,67,118,37.3,38.8,36.2,00000
49.0,61.0,44.0,894,07,01,  Salmara,505,717,247,290,258,427,41.3,46.0,37.7,00000
49.0,61.0,44.0,894,09,01,  Kumriarpar,448,622,224,251,224,371,41.9,47.2,37.6,00000
49.0,61.0,44.0,894,10,01,  Bhabananderkuti,406,442,221,176,185,266,47.9,55.7,41.0,00000
49.0,61.0,44.0,894,11,01,  Satani,86,259,54,130,32,129,24.9,29.3,19.9,00000
49.0,61.0,50.0,075,01,01,  Taria,438,688,251,310,187,378,38.9,44.7,33.1,00000
49.0,61.0,50.0,075,02,01,  Naldoba,302,631,178,293,124,338,32.4,37.8,26.8,00000
49.0,61.0,50.0,075,03,01,  Subalpara,198,148,101,67,97,81,57.2,60.1,54.5,00000
49.0,61.0,50.0,201,01,01,  Purba Bishnupur,959,1851,507,920,452,931,34.1,35.5,32.7,00000
49.0,61.0,50.0,201,02,01,  Paschim Bishnupur,467,2092,285,1012,182,1080,18.2,22.0,14.4,00000
49.0,61.0,50.0,327,01,01,  Balabari,531,1248,303,607,228,641,29.8,33.3,26.2,00000
49.0,61.0,50.0,327,02,01,  Beparitari,429,1067,263,507,166,560,28.7,34.2,22.9,00000
49.0,61.0,50.0,541,01,01,  Sobharkuti,506,1505,305,706,201,799,25.2,30.2,20.1,00000
49.0,61.0,50.0,541,02,01,  Shiberhat,785,1377,465,657,320,720,36.3,41.4,30.8,00000
49.0,61.0,50.0,541,03,01,  Kochakata,376,899,195,409,181,490,29.5,32.3,27.0,00000
49.0,61.0,50.0,541,04,01,  Khamar,541,1218,328,576,213,642,30.8,36.3,24.9,00000
49.0,61.0,50.0,969,01,01,  Kayem Teparkuti,1007,2324,562,1112,445,1212,30.2,33.6,26.9,00000
49.0,61.0,50.0,969,02,01,  Char Teparkuti,742,2146,451,1047,291,1099,25.7,30.1,20.9,00000
49.0,61.0,63.0,277,01,01,  Chauddaghari,234,927,140,463,94,464,20.2,23.2,16.8,00000
49.0,61.0,63.0,277,02,01,  Elahir Char,108,316,54,159,54,157,25.5,25.4,25.6,00000
49.0,61.0,63.0,289,01,01,  Dakshin Dhakdahar,104,504,57,241,47,263,17.1,19.1,15.2,00000
49.0,61.0,63.0,289,02,01,  Bagmara,375,424,232,186,143,238,46.9,55.5,37.5,00000
49.0,61.0,63.0,415,01,01,  Dumurdaha,456,1393,257,626,199,767,24.7,29.1,20.6,00000
49.0,61.0,63.0,415,02,01,  Mirkamari,372,662,189,301,183,361,36.0,38.6,33.6,00000
49.0,61.0,63.0,516,01,01,  Jhaukuti,293,687,156,326,137,361,29.9,32.4,27.5,00000
49.0,61.0,63.0,516,02,01,  Sirajul Sarkar Para,64,424,45,201,19,223,13.1,18.3,7.9,00000
49.0,61.0,63.0,604,01,01,  Kulamua Kalar Char,502,1483,288,702,214,781,25.3,29.1,21.5,00000
49.0,61.0,63.0,604,02,01,  Bhera Mara,109,785,63,409,46,376,12.2,13.3,10.9,00000
49.0,61.0,63.0,617,01,01,  Kulamua Majhiali,146,939,85,443,61,496,13.5,16.1,11.0,00000
49.0,61.0,63.0,617,02,01,  Bapari Para,158,460,94,227,64,233,25.6,29.3,21.5,00000
49.0,61.0,63.0,730,01,01,  Narayanpur,432,1585,228,758,204,827,21.4,23.1,19.8,00000
49.0,61.0,63.0,730,02,01,  Molla Para,301,625,164,298,137,327,32.5,35.5,29.5,00000
49.0,61.0,63.0,730,03,01,  Purba Narayanpur,146,501,90,246,56,255,22.6,26.8,18.0,00000
49.0,61.0,63.0,780,01,01,  Pakhiura,91,407,55,207,36,200,18.3,21.0,15.3,00000
49.0,61.0,63.0,780,02,01,  Airmari,80,387,62,194,18,193,17.1,24.2,8.5,00000
49.0,61.0,63.0,780,03,01,  Dakhin Pakhiora,161,345,84,161,77,184,31.8,34.3,29.5,00000
49.0,61.0,63.0,994,01,01,  Uttar Dhakdahar,92,604,63,297,29,307,13.2,17.5,8.6,00000
49.0,61.0,63.0,994,02,01,  Munshi Para,260,402,154,199,106,203,39.3,43.6,34.3,00000
49.0,61.0,69.0,440,01,01,  New Gobardhan Kuti,140,205,67,86,73,119,40.6,43.8,38.0,00000
49.0,61.0,69.0,440,02,01,  Purba Gobardhankuti,377,706,195,308,182,398,34.8,38.8,31.4,00000
49.0,61.0,69.0,440,03,01,  Chaker Kuti,705,353,383,144,322,209,66.6,72.7,60.6,00000
49.0,61.0,69.0,440,04,01,  Paschim Gobardhankuti,274,308,149,141,125,167,47.1,51.4,42.8,00000
49.0,61.0,69.0,440,05,01,  Burir Chara,455,455,239,209,216,246,50.0,53.3,46.8,00000
49.0,61.0,69.0,440,06,01,  Singjhar,484,608,258,288,226,320,44.3,47.3,41.4,00000
49.0,61.0,69.0,440,07,01,  Magur Mura,190,471,103,217,87,254,28.7,32.2,25.5,00000
49.0,61.0,69.0,743,01,01,  Satkurarpar,981,851,511,396,470,455,53.5,56.3,50.8,00000
49.0,61.0,69.0,743,02,01,  Panthabari,494,325,258,144,236,181,60.3,64.2,56.6,00000
49.0,61.0,69.0,743,03,01,  Baldi Tari,399,305,195,135,204,170,56.7,59.1,54.5,00000
49.0,61.0,69.0,743,04,01,  Newashi,778,817,430,373,348,444,48.8,53.5,43.9,00000
49.0,61.0,69.0,743,05,01,  Gharzia Tari,163,183,90,80,73,103,47.1,52.9,41.5,00000
49.0,61.0,69.0,743,06,01,  Muktarkuti(Bangdula),600,511,323,225,277,286,54.0,58.9,49.2,00000
49.0,61.0,69.0,743,07,01,  Kangaltari,421,440,215,198,206,242,48.9,52.1,46.0,00000
49.0,61.0,69.0,994,01,01,  Badyatari,452,734,238,343,214,391,38.1,41.0,35.4,00000
49.0,61.0,69.0,994,02,01,  Uzan Tari,391,632,197,291,194,341,38.2,40.4,36.3,00000
49.0,61.0,69.0,994,03,01,  Boad Ghar Para,375,464,195,220,180,244,44.7,47.0,42.5,00000
49.0,61.0,69.0,994,04,01,  Dholar Para,243,355,122,151,121,204,40.6,44.7,37.2,00000
49.0,61.0,69.0,994,05,01,  Kashir Dara,301,395,161,171,140,224,43.2,48.5,38.5,00000
49.0,61.0,69.0,994,06,01,  Chaker Tari,475,673,239,310,236,363,41.4,43.5,39.4,00000
49.0,61.0,69.0,994,07,01,  Girar Par,455,442,235,202,220,240,50.7,53.8,47.8,00000
49.0,61.0,75.0,554,01,01,  Shaheb Gang,149,240,79,91,70,149,38.3,46.5,32.0,00000
49.0,61.0,75.0,554,02,01,  Kalikapu,245,1107,146,507,99,600,18.1,22.4,14.2,00000
49.0,61.0,75.0,579,01,01,  Kapna,228,429,122,180,106,249,34.7,40.4,29.9,00000
49.0,61.0,75.0,579,02,01,  Char Kapna,536,1016,284,480,252,536,34.5,37.2,32.0,00000
49.0,61.0,75.0,768,01,01,  Noonkhawa,225,750,99,348,126,402,23.1,22.1,23.9,00000
49.0,61.0,75.0,768,02,01,  Baparir Char,170,611,110,258,60,353,21.8,29.9,14.5,00000
49.0,61.0,75.0,831,01,01,  Bowalmari,324,907,193,420,131,487,26.3,31.5,21.2,00000
49.0,61.0,75.0,831,02,01,  Kanchanerpar,421,909,247,393,174,516,31.7,38.6,25.2,00000
49.0,61.0,75.0,831,03,01,  Banglar Bhita,113,420,54,214,59,206,21.2,20.1,22.3,00000
49.0,61.0,75.0,831,04,01,  Char Pattali,223,797,113,369,110,428,21.9,23.4,20.4,00000
49.0,61.0,82.0,138,01,01,  Barabari,653,1010,332,476,321,534,39.3,41.1,37.5,00000
49.0,61.0,82.0,138,02,01,  Mollar Bhita,321,676,162,319,159,357,32.2,33.7,30.8,00000
49.0,61.0,82.0,314,01,01,  Damalgram,515,1214,269,578,246,636,29.8,31.8,27.9,00000
49.0,61.0,82.0,314,02,01,  Ratanpur,757,1054,401,477,356,577,41.8,45.7,38.2,00000
49.0,61.0,82.0,314,03,01,  Gatir Khamar,383,489,191,209,192,280,43.9,47.8,40.7,00000
49.0,61.0,82.0,314,04,01,  Char Damalgram,281,812,159,370,122,442,25.7,30.1,21.6,00000
49.0,61.0,82.0,881,01,01,  Paschim Raiganj,732,680,385,290,347,390,51.8,57.0,47.1,00000
49.0,61.0,82.0,881,02,01,  Royganj,754,607,386,257,368,350,55.4,60.0,51.3,00000
49.0,61.0,82.0,881,03,01,  Hatir Bhita,628,478,326,208,302,270,56.8,61.0,52.8,00000
49.0,61.0,82.0,881,04,01,  Sonair Khamar,504,981,256,468,248,513,33.9,35.4,32.6,00000
49.0,61.0,82.0,881,05,01,  Rangaliar Bos,1025,1387,556,616,469,771,42.5,47.4,37.8,00000
49.0,61.0,82.0,919,01,01,  Purba Sapkhawa,897,891,431,404,466,487,50.2,51.6,48.9,00000
49.0,61.0,82.0,919,02,01,  Paschim Sapkhawa,701,1015,390,450,311,565,40.9,46.4,35.5,00000
49.0,61.0,88.0,025,01,01,  Mandalerkuti,371,394,190,174,181,220,48.5,52.2,45.1,00000
49.0,61.0,88.0,025,02,01,  Kolabarir Chara,355,535,180,239,175,296,39.9,43.0,37.2,00000
49.0,61.0,88.0,025,03,01,  Sarkartari,294,363,164,173,130,190,44.7,48.7,40.6,00000
49.0,61.0,88.0,025,04,01,  Noyanir Bhita,124,163,67,71,57,92,43.2,48.6,38.3,00000
49.0,61.0,88.0,025,05,01,  Khurardara,224,252,112,116,112,136,47.1,49.1,45.2,00000
49.0,61.0,88.0,025,06,01,  Turungerkuti,137,184,82,87,55,97,42.7,48.5,36.2,00000
49.0,61.0,88.0,025,07,01,  Beparitari,206,205,109,91,97,114,50.1,54.5,46.0,00000
49.0,61.0,88.0,025,08,01,  Singriarpar,127,261,60,111,67,150,32.7,35.1,30.9,00000
49.0,61.0,88.0,025,09,01,  Hajitari,127,268,73,117,54,151,32.2,38.4,26.3,00000
49.0,61.0,88.0,025,10,01,  Baniatari,195,230,114,105,81,125,45.9,52.1,39.3,00000
49.0,61.0,88.0,037,01,01,  Madarerkuti,145,282,80,127,65,155,34.0,38.6,29.5,00000
49.0,61.0,88.0,037,02,01,  Narirbhita,237,373,121,165,116,208,38.9,42.3,35.8,00000
49.0,61.0,88.0,037,03,01,  Beparitari,175,241,83,102,92,139,42.1,44.9,39.8,00000
49.0,61.0,88.0,037,04,01,  Dhonirdara,128,265,77,126,51,139,32.6,37.9,26.8,00000
49.0,61.0,88.0,037,05,01,  Kamperhat,241,184,135,72,106,112,56.7,65.2,48.6,00000
49.0,61.0,88.0,037,06,01,  Jolarghat,95,241,42,112,53,129,28.3,27.3,29.1,00000
49.0,61.0,88.0,037,07,01,  Khoirarkuti,46,139,27,60,19,79,24.9,31.0,19.4,00000
49.0,61.0,88.0,037,08,01,  Bhomarerkuti,34,110,18,55,16,55,23.6,24.7,22.5,00000
49.0,61.0,88.0,037,09,01,  Daktarerkuti,52,140,19,74,33,66,27.1,20.4,33.3,00000
49.0,61.0,88.0,037,10,01,  Jalirkuti,240,162,125,62,115,100,59.7,66.8,53.5,00000
49.0,61.0,88.0,037,11,01,  Jhakuatari,222,183,118,85,104,98,54.8,58.1,51.5,00000
49.0,61.0,88.0,037,12,01,  Sipaitari,121,296,54,145,67,151,29.0,27.1,30.7,00000
49.0,61.0,88.0,302,01,01,  Shialkanda,397,604,203,270,194,334,39.7,42.9,36.7,00000
49.0,61.0,88.0,302,02,01,  Dhonirpar,311,637,169,310,142,327,32.8,35.3,30.3,00000
49.0,61.0,88.0,302,03,01,  Banar Bhita,368,391,191,185,177,206,48.5,50.8,46.2,00000
49.0,61.0,88.0,302,04,01,  Colonytari,385,364,208,158,177,206,51.4,56.8,46.2,00000
49.0,61.0,88.0,302,05,01,  Sarkartari,393,473,214,202,179,271,45.4,51.4,39.8,00000
49.0,61.0,88.0,302,06,01,  Indaratari,269,442,155,211,114,231,37.8,42.3,33.0,00000
49.0,61.0,88.0,302,07,01,  Beparitari,183,335,104,151,79,184,35.3,40.8,30.0,00000
49.0,61.0,88.0,302,08,01,  Majhitari,257,238,126,121,131,117,51.9,51.0,52.8,00000
49.0,61.0,88.0,302,09,01,  Purba Nakharganj,193,232,91,108,102,124,45.4,45.7,45.1,00000
49.0,61.0,88.0,818,01,01,  Mistrytari,194,165,104,66,90,99,54.0,61.2,47.6,00000
49.0,61.0,88.0,818,02,01,  Sindir Bhita,117,166,62,77,55,89,41.3,44.6,38.2,00000
49.0,61.0,88.0,818,03,01,  Nakheraj,263,330,136,158,127,172,44.4,46.3,42.5,00000
49.0,61.0,88.0,818,04,01,  Bharailtari,77,209,33,99,44,110,26.9,25.0,28.6,00000
49.0,61.0,88.0,818,05,01,  Dewanitari,119,125,67,51,52,74,48.8,56.8,41.3,00000
49.0,61.0,88.0,818,06,01,  Panchayet Tari,114,108,58,47,56,61,51.4,55.2,47.9,00000
49.0,61.0,88.0,818,07,01,  Jhakuratari,164,258,97,125,67,133,38.9,43.7,33.5,00000
49.0,61.0,88.0,818,08,01,  Kuerpar,171,234,94,99,77,135,42.2,48.7,36.3,00000
49.0,61.0,88.0,818,09,01,  Jolatari,230,439,121,212,109,227,34.4,36.3,32.4,00000
49.0,61.0,88.0,818,10,01,  Nawar Bhita,95,167,48,76,47,91,36.3,38.7,34.1,00000
49.0,61.0,88.0,818,11,01,  Prasaderkuti,129,184,81,74,48,110,41.2,52.3,30.4,00000
49.0,61.0,88.0,818,12,01,  Bansher Bhita,120,235,55,121,65,114,33.8,31.3,36.3,00000
49.0,61.0,88.0,818,13,01,  Goaltari,94,186,52,92,42,94,33.6,36.1,30.9,00000
49.0,61.0,88.0,818,14,01,  Kazitari,200,81,104,28,96,53,71.2,78.8,64.4,00000
49.0,61.0,88.0,818,15,01,  Sahatari,148,213,65,109,83,104,41.0,37.4,44.4,00000
49.0,61.0,88.0,818,16,01,  Chanderhat,211,148,114,70,97,78,58.8,62.0,55.4,00000
49.0,61.0,88.0,869,01,01,  Purba Ramakhana,1175,1354,662,582,513,772,46.5,53.2,39.9,00000
49.0,61.0,88.0,869,02,01,  Madararkuti,524,522,277,225,247,297,50.1,55.2,45.4,00000
49.0,61.0,94.0,340,01,01,  Hari Bholarkuti,174,188,92,82,82,106,48.1,52.9,43.6,00000
49.0,61.0,94.0,340,02,01,  Bakkucha,308,414,172,185,136,229,42.7,48.2,37.3,00000
49.0,61.0,94.0,340,03,01,  Hailla,361,525,196,239,165,286,40.7,45.1,36.6,00000
49.0,61.0,94.0,340,04,01,  Binnabari,535,569,302,252,233,317,48.5,54.5,42.4,00000
49.0,61.0,94.0,340,05,01,  Dhonigagla Bazar,582,523,315,253,267,270,52.7,55.5,49.7,00000
49.0,61.0,94.0,340,06,01,  Moragagla,833,595,438,283,395,312,58.3,60.7,55.9,00000
49.0,61.0,94.0,340,07,01,  Heerarkuti,493,551,283,244,210,307,47.2,53.7,40.6,00000
49.0,61.0,94.0,340,08,01,  Baniatari,289,397,156,179,133,218,42.1,46.6,37.9,00000
49.0,61.0,94.0,340,09,01,  Chilakhana Bazar,321,386,166,173,155,213,45.4,49.0,42.1,00000
49.0,61.0,94.0,453,01,01,  Uttamkhana,673,752,368,331,305,421,47.2,52.6,42.0,00000
49.0,61.0,94.0,453,02,01,  Dangarpar,197,244,110,111,87,133,44.7,49.8,39.5,00000
49.0,61.0,94.0,453,03,01,  Sarkartari,482,365,246,161,236,204,56.9,60.4,53.6,00000
49.0,61.0,94.0,453,04,01,  Nawatari,587,808,326,346,261,462,42.1,48.5,36.1,00000
49.0,61.0,94.0,453,05,01,  Salmaripar,738,779,392,373,346,406,48.6,51.2,46.0,00000
49.0,61.0,94.0,453,06,01,  Jagatjhalli,176,184,100,82,76,102,48.9,54.9,42.7,00000
49.0,61.0,94.0,717,01,01,  Naodangakuti,1290,1599,694,723,596,876,44.7,49.0,40.5,00000
49.0,61.0,94.0,717,02,01,  Dargarkuti,323,477,204,201,119,276,40.4,50.4,30.1,00000
49.0,61.0,94.0,717,03,01,  Kutibari,353,510,188,227,165,283,40.9,45.3,36.8,00000
49.0,61.0,94.0,755,01,01,  Nilur Khamar,1354,1652,728,752,626,900,45.0,49.2,41.0,00000
49.0,61.0,94.0,755,02,01,  Kaitari,665,735,346,339,319,396,47.5,50.5,44.6,00000
49.0,61.0,94.0,906,01,01,  Neparpuchi,768,608,417,268,351,340,55.8,60.9,50.8,00000
49.0,61.0,94.0,906,02,01,  Santoshpur,1169,981,597,421,572,560,54.4,58.6,50.5,00000
49.0,61.0,94.0,906,03,01,  Kanthalbari,269,373,144,176,125,197,41.9,45.0,38.8,00000
49.0,61.0,94.0,906,04,01,  Singrirpar,137,258,74,115,63,143,34.7,39.2,30.6,00000
49.0,77.0,10.0,132,01,01,  Chhota Chatura,221,185,101,85,120,100,54.4,54.3,54.5,00000
49.0,77.0,10.0,132,02,01,  Bara Chatura,894,786,487,346,407,440,53.2,58.5,48.1,00000
49.0,77.0,10.0,583,01,01,  Purba Manashwar,311,285,177,126,134,159,52.2,58.4,45.7,00000
49.0,77.0,10.0,583,02,01,  Paschim Manashwar,121,105,66,38,55,67,53.5,63.5,45.1,00000
49.0,77.0,10.0,590,01,01,  Durlabhkuti,672,818,366,396,306,422,45.1,48.0,42.0,00000
49.0,77.0,10.0,590,02,01,  Paikar Para,172,362,95,167,77,195,32.2,36.3,28.3,00000
49.0,77.0,10.0,590,03,01,  Tongarkuti,72,176,38,80,34,96,29.0,32.2,26.2,00000
49.0,77.0,10.0,590,04,01,  Banerkuti,124,143,60,70,64,73,46.4,46.2,46.7,00000
49.0,77.0,10.0,893,01,01,  Barai Para,165,155,83,67,82,88,51.6,55.3,48.2,00000
49.0,77.0,10.0,893,02,01,  Khowar Para,121,195,67,84,54,111,38.3,44.4,32.7,00000
49.0,77.0,10.0,893,03,01,  Bagicha,142,127,69,52,73,75,52.8,57.0,49.3,00000
49.0,77.0,10.0,893,04,01,  Basunia Para,409,396,201,163,208,233,50.8,55.2,47.2,00000
49.0,77.0,10.0,893,05,01,  Kani Para,224,195,112,88,112,107,53.5,56.0,51.1,00000
49.0,77.0,21.0,046,01,01,  Haribasar,304,230,163,96,141,134,56.9,62.9,51.3,00000
49.0,77.0,21.0,046,02,01,  Thatmari,619,333,332,127,287,206,65.0,72.3,58.2,00000
49.0,77.0,21.0,108,01,03,  Das Para,312,490,165,227,147,263,38.9,42.1,35.9,00000
49.0,77.0,21.0,108,02,03,  Mandal Para,584,589,298,267,286,322,49.8,52.7,47.0,00000
49.0,77.0,21.0,108,03,03,  Jola Para,445,167,225,72,220,95,72.7,75.8,69.8,00000
49.0,77.0,21.0,108,04,03,  Bepari Para,397,147,209,59,188,88,73.0,78.0,68.1,00000
49.0,77.0,21.0,373,01,01,  Achingachh,535,571,300,252,235,319,48.4,54.3,42.4,00000
49.0,77.0,21.0,373,02,01,  Atarmala,212,311,102,139,110,172,40.5,42.3,39.0,00000
49.0,77.0,21.0,373,03,01,  Pathan Para,399,437,204,190,195,247,47.7,51.8,44.1,00000
49.0,77.0,21.0,497,01,03,  Agtari,977,650,544,283,433,367,60.0,65.8,54.1,00000
49.0,77.0,21.0,497,02,03,  Patwari Para,130,264,68,125,62,139,33.0,35.2,30.8,00000
49.0,77.0,21.0,839,01,01,  Nilarkuti,276,363,135,162,141,201,43.2,45.5,41.2,00000
49.0,77.0,21.0,839,02,01,  Uttarpara,252,384,124,165,128,219,39.6,42.9,36.9,00000
49.0,77.0,21.0,839,03,01,  Boaltari,217,481,122,228,95,253,31.1,34.9,27.3,00000
49.0,77.0,21.0,839,04,01,  Balatari,231,475,109,227,122,248,32.7,32.4,33.0,00000
49.0,77.0,21.0,839,05,01,  Chatgram,419,475,229,206,190,269,46.9,52.6,41.4,00000
49.0,77.0,21.0,925,01,01,  Kuti,195,191,129,83,66,108,50.5,60.8,37.9,00000
49.0,77.0,21.0,925,02,01,  Badarjal,618,532,349,231,269,301,53.7,60.2,47.2,00000
49.0,77.0,31.0,186,01,01,  Nawa Para,175,91,88,43,87,48,65.8,67.2,64.4,00000
49.0,77.0,31.0,186,02,01,  Ghosh Para,588,564,306,255,282,309,51.0,54.5,47.7,00000
49.0,77.0,31.0,186,03,01,  Chhinaihat,511,456,277,179,234,277,52.8,60.7,45.8,00000
49.0,77.0,31.0,621,01,01,  Bangal Para,335,352,181,162,154,190,48.8,52.8,44.8,00000
49.0,77.0,31.0,621,02,01,  Paitatari,200,134,100,48,100,86,59.9,67.6,53.8,00000
49.0,77.0,31.0,621,03,01,  Bishail,269,382,138,184,131,198,41.3,42.9,39.8,00000
49.0,77.0,31.0,621,04,01,  Jharkhola,463,675,248,319,215,356,40.7,43.7,37.7,00000
49.0,77.0,31.0,621,05,01,  Khil Para,409,292,220,140,189,152,58.3,61.1,55.4,00000
49.0,77.0,31.0,621,06,01,  Dew Para,211,200,118,87,93,113,51.3,57.6,45.1,00000
49.0,77.0,42.0,077,01,01,  Koteshwar,245,82,133,30,112,52,74.9,81.6,68.3,00000
49.0,77.0,42.0,077,02,01,  Kachu Khawatari,313,267,176,119,137,148,54.0,59.7,48.1,00000
49.0,77.0,42.0,147,01,01,  Dola Para,354,209,174,74,180,135,62.9,70.2,57.1,00000
49.0,77.0,42.0,147,02,01,  Kasaitari,134,129,65,57,69,72,51.0,53.3,48.9,00000
49.0,77.0,42.0,303,01,01,  Char Gatiasam,789,874,425,412,364,462,47.4,50.8,44.1,00000
49.0,77.0,42.0,303,02,01,  Namabharat,684,902,368,439,316,463,43.1,45.6,40.6,00000
49.0,77.0,42.0,303,03,01,  Hajitari,336,452,166,199,170,253,42.6,45.5,40.2,00000
49.0,77.0,42.0,427,01,01,  Nadda Para,168,126,87,54,81,72,57.1,61.7,52.9,00000
49.0,77.0,42.0,427,02,01,  Jogi Para,591,395,323,147,268,248,59.9,68.7,51.9,00000
49.0,77.0,42.0,474,01,01,  Kawabuba,147,174,78,77,69,97,45.8,50.3,41.6,00000
49.0,77.0,42.0,474,02,01,  Dewda Para,211,160,118,67,93,93,56.9,63.8,50.0,00000
49.0,77.0,42.0,481,01,01,  Kamar Para,154,153,78,67,76,86,50.2,53.8,46.9,00000
49.0,77.0,42.0,481,02,01,  Khamar,140,161,83,70,57,91,46.5,54.2,38.5,00000
49.0,77.0,42.0,481,03,01,  Bara Dargah,329,199,175,78,154,121,62.3,69.2,56.0,00000
49.0,77.0,42.0,481,04,01,  Gharialdanga,448,526,268,234,180,292,46.0,53.4,38.1,00000
49.0,77.0,42.0,481,05,01,  Medini,472,460,260,196,212,264,50.6,57.0,44.5,00000
49.0,77.0,42.0,481,06,01,  Noakhali Para,385,356,209,157,176,199,52.0,57.1,46.9,00000
49.0,77.0,42.0,481,07,01,  Char Khitab Khan,301,286,172,136,129,150,51.3,55.8,46.2,00000
49.0,77.0,42.0,481,08,01,  Burihat,155,150,90,67,65,83,50.8,57.3,43.9,00000
49.0,77.0,42.0,481,09,01,  Sardar Para,469,456,239,197,230,259,50.7,54.8,47.0,00000
49.0,77.0,42.0,481,10,01,  Miah Para,359,315,180,139,179,176,53.3,56.4,50.4,00000
49.0,77.0,42.0,629,01,01,  Singardabri,535,516,280,232,255,284,50.9,54.7,47.3,00000
49.0,77.0,42.0,629,02,01,  Napit Para,245,132,127,43,118,89,65.0,74.7,57.0,00000
49.0,77.0,42.0,645,01,01,  Khan Para,264,54,136,23,128,31,83.0,85.5,80.5,00000
49.0,77.0,42.0,645,02,01,  Majh Para,364,385,197,183,167,202,48.6,51.8,45.3,00000
49.0,77.0,42.0,707,01,01,  Bhatia Para,142,161,82,79,60,82,46.9,50.9,42.3,00000
49.0,77.0,42.0,707,02,01,  Barai Para,202,176,117,74,85,102,53.4,61.3,45.5,00000
49.0,77.0,42.0,707,03,01,  Nakhendarpar,434,463,235,199,199,264,48.4,54.1,43.0,00000
49.0,77.0,42.0,707,04,01,  Damchhara,570,247,316,103,254,144,69.8,75.4,63.8,00000
49.0,77.0,42.0,707,05,01,  Station Para,506,438,275,197,231,241,53.6,58.3,48.9,00000
49.0,77.0,52.0,551,01,01,  Kuti Para,362,347,200,144,162,203,51.1,58.1,44.4,00000
49.0,77.0,52.0,551,02,01,  Bara Gilarpar,498,449,259,183,239,266,52.6,58.6,47.3,00000
49.0,77.0,52.0,559,01,01,  Baksi Para,137,132,78,44,59,88,50.9,63.9,40.1,00000
49.0,77.0,52.0,559,02,01,  Baidhya Para,240,255,120,98,120,157,48.5,55.0,43.3,00000
49.0,77.0,52.0,559,03,01,  Pataripara,345,222,149,99,196,123,60.8,60.1,61.4,00000
49.0,77.0,52.0,575,01,01,  Gidal Para,372,220,195,81,177,139,62.8,70.7,56.0,00000
49.0,77.0,52.0,575,02,01,  Basunia Para,422,284,214,132,208,152,59.8,61.8,57.8,00000
49.0,77.0,52.0,598,01,01,  Miah Para,360,193,178,85,182,108,65.1,67.7,62.8,00000
49.0,77.0,52.0,598,02,01,  Jakua Para,303,240,144,118,159,122,55.8,55.0,56.6,00000
49.0,77.0,52.0,754,01,01,  Jarijar,467,466,241,200,226,266,50.1,54.6,45.9,00000
49.0,77.0,52.0,754,02,01,  Batubari,361,234,196,90,165,144,60.7,68.5,53.4,00000
49.0,77.0,52.0,792,01,01,  Tali Para,96,166,57,69,39,97,36.6,45.2,28.7,00000
49.0,77.0,52.0,792,02,01,  Mandal Para,444,808,232,367,212,441,35.5,38.7,32.5,00000
49.0,77.0,52.0,816,01,01,  Khamar,160,137,82,58,78,79,53.9,58.6,49.7,00000
49.0,77.0,52.0,816,02,01,  Ranjiteshwar,358,354,185,161,173,193,50.3,53.5,47.3,00000
49.0,77.0,52.0,847,01,01,  Barantate,195,127,99,58,96,69,60.6,63.1,58.2,00000
49.0,77.0,52.0,847,02,01,  Dang Ghat,231,216,122,84,109,132,51.7,59.2,45.2,00000
49.0,77.0,52.0,847,03,01,  Sekh Para,231,344,108,147,123,197,40.2,42.4,38.4,00000
49.0,77.0,52.0,847,04,01,  Pathan Para,383,291,201,128,182,163,56.8,61.1,52.8,00000
49.0,77.0,52.0,886,01,01,  Nauthoualauthoua,386,399,212,149,174,250,49.2,58.7,41.0,00000
49.0,77.0,52.0,886,02,01,  Auliadarga,369,397,175,172,194,225,48.2,50.4,46.3,00000
49.0,77.0,52.0,886,03,01,  Manabari,449,319,228,128,221,191,58.5,64.0,53.6,00000
49.0,77.0,52.0,886,04,01,  Shaib Para,438,660,229,297,209,363,39.9,43.5,36.5,00000
49.0,77.0,52.0,886,05,01,  Sararpar,510,369,249,139,261,230,58.0,64.2,53.2,00000
49.0,77.0,84.0,054,01,01,  Uttar Balakandi,1510,1354,745,594,765,760,52.7,55.6,50.2,00000
49.0,77.0,84.0,054,02,01,  Dakshin Balakandi,1283,1165,692,526,591,639,52.4,56.8,48.0,00000
49.0,77.0,84.0,233,01,01,  Futani Para,320,302,171,128,149,174,51.4,57.2,46.1,00000
49.0,77.0,84.0,233,02,01,  Selhati (Talua Para),200,149,109,65,91,84,57.3,62.6,52.0,00000
49.0,77.0,84.0,310,01,01,  Ghumaru Bhimsitla,630,507,328,201,302,306,55.4,62.0,49.7,00000
49.0,77.0,84.0,310,02,01,  Jogi Para (Movpara),408,379,190,156,218,223,51.8,54.9,49.4,00000
49.0,77.0,84.0,310,03,01,  Bhadra Para,535,307,273,115,262,192,63.5,70.4,57.7,00000
49.0,77.0,84.0,544,01,01,  Uttar Makar,152,157,70,66,82,91,49.2,51.5,47.4,00000
49.0,77.0,84.0,544,02,01,  Dakshin Makar,126,137,60,56,66,81,47.9,51.7,44.9,00000
49.0,77.0,84.0,963,01,01,  Taluk Subal,221,131,104,52,117,79,62.8,66.7,59.7,00000
49.0,77.0,84.0,963,02,01,  Uttar Taluk Subal,558,549,243,230,315,319,50.4,51.4,49.7,00000
49.0,77.0,84.0,979,01,01,  Khan Para,458,312,242,129,216,183,59.5,65.2,54.1,00000
49.0,77.0,84.0,979,02,01,  Omar Majid,322,415,161,172,161,243,43.7,48.3,39.9,00000
49.0,79.0,11.0,052,01,01,  Fulkar Char,55,338,34,163,21,175,14.0,17.3,10.7,00000
49.0,79.0,11.0,052,02,01,  Mashaler Char,74,351,46,164,28,187,17.4,21.9,13.0,00000
49.0,79.0,11.0,052,03,01,  Khas Para & Baguar Char,109,796,58,399,51,397,12.0,12.7,11.4,00000
49.0,79.0,11.0,052,04,01,  Miar Char,350,807,204,406,146,401,30.3,33.4,26.7,00000
49.0,79.0,11.0,052,05,01,  Wahednagar,151,316,100,129,51,187,32.3,43.7,21.4,00000
49.0,79.0,11.0,052,06,01,  Pakhiura,429,1230,239,564,190,666,25.9,29.8,22.2,00000
49.0,79.0,11.0,052,07,01,  Uttar Char Khadaimari,241,752,141,369,100,383,24.3,27.6,20.7,00000
49.0,79.0,11.0,052,08,01,  Purba Char Khadaimari,283,549,133,263,150,286,34.0,33.6,34.4,00000
49.0,79.0,11.0,052,09,01,  Paschim Char Khadaimari,81,326,42,149,39,177,19.9,22.0,18.1,00000
49.0,79.0,11.0,052,10,01,  Dakshin Khadaimari,258,664,144,290,114,374,28.0,33.2,23.4,00000
49.0,79.0,11.0,052,11,01,  Purba Char Sailmari,401,479,234,202,167,277,45.6,53.7,37.6,00000
49.0,79.0,11.0,157,01,01,  Jantirkanda,305,1193,170,571,135,622,20.4,22.9,17.8,00000
49.0,79.0,11.0,157,02,01,  Bandaber,560,1084,290,475,270,609,34.1,37.9,30.7,00000
49.0,79.0,11.0,157,03,01,  Char Bandaber,582,1630,321,744,261,886,26.3,30.1,22.8,00000
49.0,79.0,11.0,157,04,01,  Purba Baghmara,93,427,56,213,37,214,17.9,20.8,14.7,00000
49.0,79.0,11.0,157,05,01,  Paschim Baghmara,85,309,47,143,38,166,21.6,24.7,18.6,00000
49.0,79.0,11.0,157,06,01,  Char Baghmara (Kutirchar),356,1246,189,556,167,690,22.2,25.4,19.5,00000
49.0,79.0,11.0,157,07,01,  Dakshin Khanjanmara,406,665,225,294,181,371,37.9,43.4,32.8,00000
49.0,79.0,11.0,314,01,01,  Char Saulmari,335,461,188,201,147,260,42.1,48.3,36.1,00000
49.0,79.0,11.0,314,02,01,  Daikhaya,158,305,70,154,88,151,34.1,31.3,36.8,00000
49.0,79.0,11.0,314,03,01,  Sonapur,259,731,159,343,100,388,26.2,31.7,20.5,00000
49.0,79.0,11.0,314,04,01,  Char Gandaragla,271,536,132,265,139,271,33.6,33.2,33.9,00000
49.0,79.0,11.0,314,05,01,  Sukharbati,257,1293,135,603,122,690,16.6,18.3,15.0,00000
49.0,79.0,11.0,314,06,01,  Ghughumari,361,895,197,426,164,469,28.7,31.6,25.9,00000
49.0,79.0,11.0,628,01,01,  Purba Khanjanmara,748,1179,394,505,354,674,38.8,43.8,34.4,00000
49.0,79.0,11.0,628,02,01,  Bhaguar Char,555,1758,311,806,244,952,24.0,27.8,20.4,00000
49.0,79.0,11.0,628,03,01,  Dakshin Bhitkamari,450,824,238,400,212,424,35.3,37.3,33.3,00000
49.0,79.0,11.0,628,04,01,  Junkir Char,99,394,58,185,41,209,20.1,23.9,16.4,00000
49.0,79.0,11.0,628,05,01,  Paschim Khanjanmara,239,595,116,296,123,299,28.7,28.2,29.1,00000
49.0,79.0,11.0,628,06,01,  Tiltali,121,220,78,105,43,115,35.5,42.6,27.2,00000
49.0,79.0,11.0,811,01,01,  Pakheura,228,634,131,290,97,344,26.5,31.1,22.0,00000
49.0,79.0,11.0,811,02,01,  Baitkamari,449,1068,237,504,212,564,29.6,32.0,27.3,00000
49.0,79.0,11.0,811,03,01,  Nalbari,115,285,72,135,43,150,28.8,34.8,22.3,00000
49.0,79.0,11.0,811,04,01,  Dakshin Tapur Char,494,643,249,287,245,356,43.4,46.5,40.8,00000
49.0,79.0,11.0,811,05,01,  Madhya Tapur Char,218,678,102,322,116,356,24.3,24.1,24.6,00000
49.0,79.0,11.0,811,06,01,  Uttar Tapur Char,155,335,94,145,61,190,31.6,39.3,24.3,00000
49.0,79.0,11.0,811,07,01,  Tapur Char Bazar,293,558,171,244,122,314,34.4,41.2,28.0,00000
49.0,79.0,11.0,811,08,01,  Purar Char,387,1057,203,465,184,592,26.8,30.4,23.7,00000
49.0,79.0,11.0,811,09,01,  Madhya Char,151,216,78,101,73,115,41.1,43.6,38.8,00000
49.0,79.0,11.0,811,10,01,  Tangari Para,339,457,181,214,158,243,42.6,45.8,39.4,00000
49.0,79.0,11.0,811,11,01,  Badurtila,122,118,62,54,60,64,50.8,53.4,48.4,00000
49.0,79.0,23.0,366,01,01,  Dantbhanga,338,673,191,294,147,379,33.4,39.4,27.9,00000
49.0,79.0,23.0,366,02,01,  Chat Karaibari,72,206,37,96,35,110,25.9,27.8,24.1,00000
49.0,79.0,23.0,366,03,01,  Uttar Ujan Jhagrar Char,86,76,48,26,38,50,53.1,64.9,43.2,00000
49.0,79.0,23.0,366,04,01,  Harindhara,461,668,245,284,216,384,40.8,46.3,36.0,00000
49.0,79.0,23.0,366,05,01,  Dharmapur,132,358,66,152,66,206,26.9,30.3,24.3,00000
49.0,79.0,23.0,497,01,01,  Ujan Jhagrar Char,533,727,280,325,253,402,42.3,46.3,38.6,00000
49.0,79.0,23.0,497,02,01,  Takani Jhagrar Char,504,865,295,369,209,496,36.8,44.4,29.6,00000
49.0,79.0,23.0,497,03,01,  Gotligram,339,618,181,285,158,333,35.4,38.8,32.2,00000
49.0,79.0,23.0,497,04,01,  Bongsher Char,119,140,67,66,52,74,45.9,50.4,41.3,00000
49.0,79.0,23.0,497,05,01,  Jhagrar Char,780,1096,436,490,344,606,41.6,47.1,36.2,00000
49.0,79.0,23.0,497,06,01,  Dakshin Harindhara,262,383,141,175,121,208,40.6,44.6,36.8,00000
49.0,79.0,23.0,497,07,01,  Dakshin Dharmapur,149,215,68,87,81,128,40.9,43.9,38.8,00000
49.0,79.0,23.0,497,08,01,  Kowar Char,379,637,221,281,158,356,37.3,44.0,30.7,00000
49.0,79.0,23.0,576,01,01,  Goita Para,58,187,30,84,28,103,23.7,26.3,21.4,00000
49.0,79.0,23.0,576,02,01,  Khetar Char,111,214,67,111,44,103,34.2,37.6,29.9,00000
49.0,79.0,23.0,576,03,01,  Uttar Kauniar Char,153,314,76,140,77,174,32.8,35.2,30.7,00000
49.0,79.0,23.0,576,04,01,  Chat Karaibari,220,366,114,144,106,222,37.5,44.2,32.3,00000
49.0,79.0,23.0,576,05,01,  Kauniar Char,198,329,113,169,85,160,37.6,40.1,34.7,00000
49.0,79.0,23.0,576,06,01,  Parer Char,151,389,80,177,71,212,28.0,31.1,25.1,00000
49.0,79.0,23.0,576,07,01,  Uttar Datbhanga,157,224,91,97,66,127,41.2,48.4,34.2,00000
49.0,79.0,23.0,576,08,01,  Chhota Kauniar Char,190,247,109,104,81,143,43.5,51.2,36.2,00000
49.0,79.0,23.0,576,09,01,  Ambari,212,528,119,249,93,279,28.6,32.3,25.0,00000
49.0,79.0,23.0,602,01,01,  Char Italokanda,373,1284,220,577,153,707,22.5,27.6,17.8,00000
49.0,79.0,23.0,602,02,01,  Santirchar (Kazaikat Psc.Para),234,458,126,212,108,246,33.8,37.3,30.5,00000
49.0,79.0,23.0,602,03,01,  Kazaikata,229,503,123,207,106,296,31.3,37.3,26.4,00000
49.0,79.0,23.0,602,04,01,  Char Kazaikata,180,253,100,104,80,149,41.6,49.0,34.9,00000
49.0,79.0,23.0,602,05,01,  Madhyapara Kazaikata,259,417,139,155,120,262,38.3,47.3,31.4,00000
49.0,79.0,23.0,602,06,01,  Uttarpara Kazaikata,279,864,150,385,129,479,24.4,28.0,21.2,00000
49.0,79.0,23.0,602,07,01,  Dicree Char,165,547,84,245,81,302,23.2,25.5,21.1,00000
49.0,79.0,23.0,602,08,01,  Dakshinpara Kazaikata,59,340,35,136,24,204,14.8,20.5,10.5,00000
49.0,79.0,23.0,602,09,01,  Italokanda,312,758,165,340,147,418,29.2,32.7,26.0,00000
49.0,79.0,23.0,602,10,01,  Shantir Char,258,508,131,242,127,266,33.7,35.1,32.3,00000
49.0,79.0,23.0,602,11,01,  Bheramara,58,308,38,153,20,155,15.8,19.9,11.4,00000
49.0,79.0,23.0,759,01,01,  Kharani Para,383,286,221,119,162,167,57.2,65.0,49.2,00000
49.0,79.0,23.0,759,02,01,  Fulkar Char,252,267,143,133,109,134,48.6,51.8,44.9,00000
49.0,79.0,23.0,759,03,01,  Char Dant Tala,207,357,96,169,111,188,36.7,36.2,37.1,00000
49.0,79.0,23.0,759,04,01,  Miar Char,258,495,148,220,110,275,34.3,40.2,28.6,00000
49.0,79.0,23.0,994,01,01,  Bariakandi,156,287,86,131,70,156,35.2,39.6,31.0,00000
49.0,79.0,23.0,994,02,01,  Chhota Dant Tala,333,448,192,185,141,263,42.6,50.9,34.9,00000
49.0,79.0,23.0,994,03,01,  Dant Tala,164,228,93,93,71,135,41.8,50.0,34.5,00000
49.0,79.0,23.0,994,04,01,  Balurgram,362,421,199,194,163,227,46.2,50.6,41.8,00000
49.0,79.0,23.0,994,05,01,  Tapur Char,758,1225,405,559,353,666,38.2,42.0,34.6,00000
49.0,79.0,23.0,994,06,01,  Dakshin Tapur Char,390,652,213,296,177,356,37.4,41.8,33.2,00000
49.0,79.0,35.0,392,01,01,  Dhanar Char Natungram,382,1239,208,597,174,642,23.6,25.8,21.3,00000
49.0,79.0,35.0,392,02,01,  Hatkholagram,160,444,74,199,86,245,26.5,27.1,26.0,00000
49.0,79.0,35.0,392,03,01,  Charergram,335,859,160,397,175,462,28.1,28.7,27.5,00000
49.0,79.0,35.0,392,04,01,  Dhanar Char Paschimpara,216,463,101,213,115,250,31.8,32.2,31.5,00000
49.0,79.0,35.0,392,05,01,  Dhanar Char Sarkar Para,134,155,71,60,63,95,46.4,54.2,39.9,00000
49.0,79.0,35.0,392,06,01,  Dhanar Char Tangra Para,210,352,113,152,97,200,37.4,42.6,32.7,00000
49.0,79.0,35.0,392,07,01,  Dhanar Char Purbapara,89,314,56,148,33,166,22.1,27.5,16.6,00000
49.0,79.0,35.0,392,08,01,  Dhanar Char Madhya Para,340,333,171,153,169,180,50.5,52.8,48.4,00000
49.0,79.0,35.0,445,01,01,  Jadur Char Natungram(Tintali),523,978,267,482,256,496,34.8,35.6,34.0,00000
49.0,79.0,35.0,445,02,01,  Tinghari Para,55,170,24,84,31,86,24.4,22.2,26.5,00000
49.0,79.0,35.0,445,03,01,  Chaktabari,529,719,293,327,236,392,42.4,47.3,37.6,00000
49.0,79.0,35.0,445,04,01,  Kartimari,310,522,161,230,149,292,37.3,41.2,33.8,00000
49.0,79.0,35.0,445,05,01,  Golabari,437,391,216,199,221,192,52.8,52.0,53.5,00000
49.0,79.0,35.0,445,06,01,  Sreefalgati,216,170,108,72,108,98,56.0,60.0,52.4,00000
49.0,79.0,35.0,445,07,01,  Jadur Char Purbapara,280,468,148,209,132,259,37.4,41.5,33.8,00000
49.0,79.0,35.0,445,08,01,  Puran Jadur Char,134,262,78,121,56,141,33.8,39.2,28.4,00000
49.0,79.0,35.0,445,09,01,  Kartimari Bazar,375,294,184,150,191,144,56.1,55.1,57.0,00000
49.0,79.0,35.0,445,10,01,  Kashiabari,498,910,254,422,244,488,35.4,37.6,33.3,00000
49.0,79.0,35.0,445,11,01,  Lalkura,411,1069,211,499,200,570,27.8,29.7,26.0,00000
49.0,79.0,35.0,445,12,01,  Baim Mari (Baisha),209,590,110,282,99,308,26.2,28.1,24.3,00000
49.0,79.0,35.0,654,01,01,  Khewar Char,97,467,49,204,48,263,17.2,19.4,15.4,00000
49.0,79.0,35.0,654,02,01,  Dublabari,152,172,69,86,83,86,46.9,44.5,49.1,00000
49.0,79.0,35.0,654,03,01,  Bokbandha Nama Para,131,373,75,146,56,227,26.0,33.9,19.8,00000
49.0,79.0,35.0,706,01,01,  Komarbhangi Sarkar Para,121,321,63,143,58,178,27.4,30.6,24.6,00000
49.0,79.0,35.0,706,02,01,  Komarbhangi Uttarpara,136,548,67,240,69,308,19.9,21.8,18.3,00000
49.0,79.0,35.0,706,03,01,  Komarbhangi Paschimpara,234,435,130,197,104,238,35.0,39.8,30.4,00000
49.0,79.0,35.0,706,04,01,  Komarbhangi,146,692,88,319,58,373,17.4,21.6,13.5,00000
49.0,79.0,35.0,706,05,01,  Komarbhangi Naya Para,381,431,195,218,186,213,46.9,47.2,46.6,00000
49.0,79.0,35.0,706,06,01,  Shebaridangi,329,391,162,170,167,221,45.7,48.8,43.0,00000
49.0,79.0,35.0,706,07,01,  Komarbhangi Bheta Para,207,590,111,265,96,325,26.0,29.5,22.8,00000
49.0,79.0,35.0,706,08,01,  Komarbhangi Tangra Para,104,210,49,93,55,117,33.1,34.5,32.0,00000
49.0,79.0,35.0,785,01,01,  Bakbanda Bepari Para,406,747,223,286,183,461,35.2,43.8,28.4,00000
49.0,79.0,35.0,785,02,01,  Bekribill,207,707,104,345,103,362,22.6,23.2,22.2,00000
49.0,79.0,35.0,785,03,01,  Khewar Char,446,767,227,343,219,424,36.8,39.8,34.1,00000
49.0,79.0,35.0,785,04,01,  Algar Char,270,735,151,322,119,413,26.9,31.9,22.4,00000
49.0,79.0,35.0,785,05,01,  Lathi Yaldanga,50,231,28,106,22,125,17.8,20.9,15.0,00000
49.0,79.0,71.0,340,01,01,  Islamari,584,782,293,306,291,476,42.8,48.9,37.9,00000
49.0,79.0,71.0,340,02,01,  Khan Para,230,288,106,124,124,164,44.4,46.1,43.1,00000
49.0,79.0,71.0,340,03,01,  Chhota Madartilla,51,177,30,64,21,113,22.4,31.9,15.7,00000
49.0,79.0,71.0,340,04,01,  Goalgram,353,966,198,419,155,547,26.8,32.1,22.1,00000
49.0,79.0,71.0,340,05,01,  Chaktabari,279,594,149,279,130,315,32.0,34.8,29.2,00000
49.0,79.0,71.0,340,06,01,  Kanda Para,269,629,153,300,116,329,30.0,33.8,26.1,00000
49.0,79.0,71.0,340,07,01,  Mirza Para Balair Para,322,767,171,369,151,398,29.6,31.7,27.5,00000
49.0,79.0,71.0,340,08,01,  Chak Tamari Baliamari,116,321,64,146,52,175,26.5,30.5,22.9,00000
49.0,79.0,71.0,340,09,01,  Boraikandi,83,167,42,90,41,77,33.2,31.8,34.7,00000
49.0,79.0,71.0,340,10,01,  Dhandani Para,295,414,155,188,140,226,41.6,45.2,38.3,00000
49.0,79.0,71.0,340,11,01,  Bara Madhartila,210,550,96,254,114,296,27.6,27.4,27.8,00000
49.0,79.0,71.0,340,12,01,  Konasi Para,255,461,141,189,114,272,35.6,42.7,29.5,00000
49.0,79.0,71.0,340,13,01,  Chuliar Char Kutub Sarkargram,80,154,47,62,33,92,34.2,43.1,26.4,00000
49.0,79.0,71.0,340,14,01,  Jahar Dewanirgram,116,157,61,61,55,96,42.5,50.0,36.4,00000
49.0,79.0,71.0,340,15,01,  Karaikandi,162,459,79,203,83,256,26.1,28.0,24.5,00000
49.0,79.0,71.0,549,01,01,  Puran Chuliar Char,326,733,150,288,176,445,30.8,34.2,28.3,00000
49.0,79.0,71.0,549,02,01,  Bawirgram,387,1017,202,487,185,530,27.6,29.3,25.9,00000
49.0,79.0,71.0,549,03,01,  Baraibari,199,678,114,298,85,380,22.7,27.7,18.3,00000
49.0,79.0,71.0,549,04,01,  Jhawbari,55,335,33,165,22,170,14.1,16.7,11.5,00000
49.0,79.0,71.0,549,05,01,  Dublabari,288,553,161,234,127,319,34.2,40.8,28.5,00000
49.0,79.0,71.0,549,06,01,  Kalabari,242,428,138,188,104,240,36.1,42.3,30.2,00000
49.0,79.0,71.0,549,07,01,  Dakshin Barabanda,520,1198,251,540,269,658,30.3,31.7,29.0,00000
49.0,79.0,71.0,837,01,03,  Raumarigram,1615,773,896,357,719,416,67.6,71.5,63.3,00000
49.0,79.0,71.0,837,02,03,  Mandal Para,343,271,176,115,167,156,55.9,60.5,51.7,00000
49.0,79.0,71.0,837,03,03,  Majhi Para,94,344,55,173,39,171,21.5,24.1,18.6,00000
49.0,79.0,71.0,837,04,03,  Raumari Uttarpara,150,403,88,184,62,219,27.1,32.4,22.1,00000
49.0,79.0,71.0,837,05,03,  Natun Para,900,1059,472,504,428,555,45.9,48.4,43.5,00000
49.0,79.0,71.0,837,06,03,  Suter Para,235,326,113,137,122,189,41.9,45.2,39.2,00000
49.0,79.0,71.0,837,07,03,  Ishakuri Chaker Dianirgram,151,486,75,238,76,248,23.7,24.0,23.5,00000
49.0,79.0,71.0,837,08,03,  Ishakuri Zabbar Dianirgram,272,451,151,198,121,253,37.6,43.3,32.4,00000
49.0,79.0,71.0,837,09,03,  Mirza Para Inshab Dianir Para,207,254,119,115,88,139,44.9,50.9,38.8,00000
49.0,79.0,71.0,837,10,03,  Raumari Bazar,915,338,529,164,386,174,73.0,76.3,68.9,00000
49.0,79.0,71.0,837,11,03,  Sobuj Para,264,52,144,19,120,33,83.5,88.3,78.4,00000
49.0,79.0,71.0,837,12,03,  Ishakuri Rahmat Dianirgram,145,346,80,159,65,187,29.5,33.5,25.8,00000
49.0,79.0,71.0,837,13,03,  College Para,1014,350,543,148,471,202,74.3,78.6,70.0,00000
49.0,79.0,71.0,864,01,03,  Khatiamari,232,464,126,220,106,244,33.3,36.4,30.3,00000
49.0,79.0,71.0,864,02,03,  Ratanpur,207,383,108,177,99,206,35.1,37.9,32.5,00000
49.0,79.0,71.0,864,03,03,  Bamnar Char,248,610,132,284,116,326,28.9,31.7,26.2,00000
49.0,79.0,71.0,864,04,03,  Chander Char,78,170,47,82,31,88,31.5,36.4,26.1,00000
49.0,79.0,71.0,864,05,03,  Natun Bandar,426,630,193,249,233,381,40.3,43.7,37.9,00000
49.0,79.0,71.0,864,06,03,  Char Natun Bandar,173,391,87,162,86,229,30.7,34.9,27.3,00000
49.0,79.0,71.0,864,07,03,  Char Fulbari,124,610,68,272,56,338,16.9,20.0,14.2,00000
49.0,79.0,71.0,864,08,03,  Bar Bandar,185,411,97,171,88,240,31.0,36.2,26.8,00000
49.0,79.0,71.0,864,09,03,  Char Bamnar Char,417,1259,229,544,188,715,24.9,29.6,20.8,00000
49.0,79.0,71.0,864,10,03,  Dakshin Fulbari,290,701,169,327,121,374,29.3,34.1,24.4,00000
49.0,79.0,71.0,864,11,03,  Fulbari,121,176,62,69,59,107,40.7,47.3,35.5,00000
49.0,79.0,71.0,864,12,03,  Ishakuri Pubar Para,401,773,212,363,189,410,34.2,36.9,31.6,00000
49.0,79.0,71.0,864,13,03,  Nurpur,80,177,51,75,29,102,31.1,40.5,22.1,00000
49.0,79.0,83.0,209,01,01,  Bausmari,357,488,173,227,184,261,42.2,43.3,41.3,00000
49.0,79.0,83.0,209,02,01,  Chatlakanda,347,576,167,271,180,305,37.6,38.1,37.1,00000
49.0,79.0,83.0,235,01,01,  Char Boailmari,612,1356,332,649,280,707,31.1,33.8,28.4,00000
49.0,79.0,83.0,235,02,01,  Dangua Para,525,732,289,322,236,410,41.8,47.3,36.5,00000
49.0,79.0,83.0,235,03,01,  Sangta Para,725,844,381,349,344,495,46.2,52.2,41.0,00000
49.0,79.0,83.0,235,04,01,  Majhi Para,73,183,43,82,30,101,28.5,34.4,22.9,00000
49.0,79.0,83.0,235,05,01,  Bathergram,563,966,276,420,287,546,36.8,39.7,34.5,00000
49.0,79.0,83.0,235,06,01,  Baraikandi,541,778,279,389,262,389,41.0,41.8,40.2,00000
49.0,79.0,83.0,235,07,01,  Purar Char,267,330,148,151,119,179,44.7,49.5,39.9,00000
49.0,79.0,83.0,235,08,01,  Dakshin Boailmari,375,725,209,331,166,394,34.1,38.7,29.6,00000
49.0,79.0,83.0,235,09,01,  Baoilmari,561,476,337,229,224,247,54.1,59.5,47.6,00000
49.0,79.0,83.0,235,10,01,  Ukrakanda,191,242,90,100,101,142,44.1,47.4,41.6,00000
49.0,79.0,83.0,942,01,01,  Charargram,97,351,56,162,41,189,21.7,25.7,17.8,00000
49.0,79.0,83.0,942,02,01,  Gayata Para(North),346,530,183,237,163,293,39.5,43.6,35.7,00000
49.0,79.0,83.0,942,03,01,  Gayata Para(Est),407,210,222,87,185,123,66.0,71.8,60.1,00000
49.0,79.0,83.0,942,04,01,  Saulmari,335,531,157,249,178,282,38.7,38.7,38.7,00000
49.0,79.0,83.0,942,05,01,  Natun Saulmari,313,457,149,213,164,244,40.6,41.2,40.2,00000
49.0,79.0,83.0,942,06,01,  Nawbari,148,209,68,95,80,114,41.5,41.7,41.2,00000
49.0,79.0,83.0,942,07,01,  Sutirpar,122,270,62,139,60,131,31.1,30.8,31.4,00000
49.0,79.0,83.0,942,08,01,  Kalmar Char,268,311,156,131,112,180,46.3,54.4,38.4,00000
49.0,79.0,83.0,942,09,01,  Fakir Para,280,444,120,201,160,243,38.7,37.4,39.7,00000
49.0,79.0,83.0,942,10,01,  Hapati Para,266,455,137,190,129,265,36.9,41.9,32.7,00000
49.0,79.0,83.0,942,11,01,  Bahular Char,310,821,172,391,138,430,27.4,30.6,24.3,00000
49.0,79.0,83.0,968,01,01,  Taluar Char,309,754,165,372,144,382,29.1,30.7,27.4,00000
49.0,79.0,83.0,968,02,01,  Jhunkir Char,354,330,191,148,163,182,51.8,56.3,47.2,00000
49.0,94.0,14.0,015,01,01,  Akel Mamud,367,1318,201,640,166,678,21.8,23.9,19.7,00000
49.0,94.0,14.0,015,02,01,  Kaligonj,241,647,147,313,94,334,27.1,32.0,22.0,00000
49.0,94.0,14.0,015,03,01,  Khudirkuti,139,455,82,231,57,224,23.4,26.2,20.3,00000
49.0,94.0,14.0,065,01,01,  Baladoba,333,1492,183,757,150,735,18.2,19.5,16.9,00000
49.0,94.0,14.0,065,02,01,  Bagalerkuti,220,595,110,278,110,317,27.0,28.4,25.8,00000
49.0,94.0,14.0,105,01,01,  Begumganj,735,1711,437,815,298,896,30.0,34.9,25.0,00000
49.0,94.0,14.0,105,02,01,  Majhi Para,414,1374,246,697,168,677,23.2,26.1,19.9,00000
49.0,94.0,14.0,105,03,01,  Islampur,378,1418,224,661,154,757,21.0,25.3,16.9,00000
49.0,94.0,14.0,880,01,01,  Sekh Palanu,35,455,26,216,9,239,7.1,10.7,3.6,00000
49.0,94.0,14.0,880,02,01,  Aftabganj,39,239,23,99,16,140,14.0,18.9,10.3,00000
49.0,94.0,16.0,060,01,01,  Purba Bazra,1276,879,627,374,649,505,59.2,62.6,56.2,00000
49.0,94.0,16.0,060,02,01,  Madhya Bazra,1247,1203,612,524,635,679,50.9,53.9,48.3,00000
49.0,94.0,16.0,060,03,01,  Paschim Bazra,625,594,312,266,313,328,51.3,54.0,48.8,00000
49.0,94.0,16.0,130,01,01,  Uttar Birahim,336,327,175,159,161,168,50.7,52.4,48.9,00000
49.0,94.0,16.0,130,02,01,  Dakshin Birahim,489,860,251,402,238,458,36.2,38.4,34.2,00000
49.0,94.0,22.0,040,01,01,  Purba Atharpaika,730,1099,407,513,323,586,39.9,44.2,35.5,00000
49.0,94.0,22.0,040,02,01,  Paschim Atharpaika,1473,1420,754,651,719,769,50.9,53.7,48.3,00000
49.0,94.0,22.0,140,01,01,  Hindu Para,328,191,182,66,146,125,63.2,73.4,53.9,00000
49.0,94.0,22.0,140,02,01,  Muslim Para,262,647,158,315,104,332,28.8,33.4,23.9,00000
49.0,94.0,22.0,145,01,01,  Fakir Para,283,452,173,209,110,243,38.5,45.3,31.2,00000
49.0,94.0,22.0,145,02,01,  Kurarpar,199,319,117,152,82,167,38.4,43.5,32.9,00000
49.0,94.0,22.0,145,03,01,  Hindu Para,289,589,152,311,137,278,32.9,32.8,33.0,00000
49.0,94.0,22.0,145,04,01,  Jakua Para,443,751,235,354,208,397,37.1,39.9,34.4,00000
49.0,94.0,22.0,215,01,01,  Purba Dalan,70,229,38,103,32,126,23.4,27.0,20.3,00000
49.0,94.0,22.0,215,02,01,  Paschim Dalan,754,844,417,371,337,473,47.2,52.9,41.6,00000
49.0,94.0,22.0,265,01,01,  Hindu Para,263,912,128,447,135,465,22.4,22.3,22.5,00000
49.0,94.0,22.0,265,02,01,  Miah Para,677,932,371,432,306,500,42.1,46.2,38.0,00000
49.0,94.0,22.0,265,03,01,  Sarkar Para,155,229,83,95,72,134,40.4,46.6,35.0,00000
49.0,94.0,22.0,265,04,01,  Panchgram,445,1182,236,555,209,627,27.4,29.8,25.0,00000
49.0,94.0,22.0,265,05,01,  Fakir Para,48,192,28,89,20,103,20.0,23.9,16.3,00000
49.0,94.0,22.0,425,01,01,  Muslim Para,192,179,103,90,89,89,51.8,53.4,50.0,00000
49.0,94.0,22.0,425,02,01,  Musulli Para,269,513,148,254,121,259,34.4,36.8,31.8,00000
49.0,94.0,22.0,775,01,01,  Fakir Para,337,95,184,38,153,57,78.0,82.9,72.9,00000
49.0,94.0,22.0,775,02,01,  Mollah Para,628,471,344,193,284,278,57.1,64.1,50.5,00000
49.0,94.0,22.0,840,01,01,  Hindu Para,191,177,101,82,90,95,51.9,55.2,48.6,00000
49.0,94.0,22.0,840,02,01,  Paschimpara,649,522,332,216,317,306,55.4,60.6,50.9,00000
49.0,94.0,22.0,875,01,01,  Paschim Satbhita,981,1336,534,606,447,730,42.3,46.8,38.0,00000
49.0,94.0,22.0,875,02,01,  Purba Satbhita,236,591,117,267,119,324,28.5,30.5,26.9,00000
49.0,94.0,33.0,205,01,01,  Tapurkuti,221,73,99,30,122,43,75.2,76.7,73.9,00000
49.0,94.0,33.0,205,02,01,  Patilapur,565,340,268,129,297,211,62.4,67.5,58.5,00000
49.0,94.0,33.0,205,03,01,  Ghatial Para,404,322,195,147,209,175,55.6,57.0,54.4,00000
49.0,94.0,33.0,205,04,01,  Khamar Magura,785,244,399,91,386,153,76.3,81.4,71.6,00000
49.0,94.0,33.0,205,05,01,  Ganak Para,278,247,137,93,141,154,53.0,59.6,47.8,00000
49.0,94.0,33.0,205,06,01,  Balar Char,382,53,158,24,224,29,87.8,86.8,88.5,00000
49.0,94.0,33.0,430,02,01,  Basunia Para,216,192,112,74,104,118,52.9,60.2,46.8,00000
49.0,94.0,33.0,430,03,01,  Sardar Para,157,78,78,29,79,49,66.8,72.9,61.7,00000
49.0,94.0,33.0,430,04,01,  Chapara Para,694,1156,341,510,353,646,37.5,40.1,35.3,00000
49.0,94.0,33.0,430,05,01,  Hindu Para,307,200,159,83,148,117,60.6,65.7,55.8,00000
49.0,94.0,33.0,430,06,01,  Kadamtala,252,113,119,40,133,73,69.0,74.8,64.6,00000
49.0,94.0,33.0,430,07,01,  Munsi Para,163,78,74,30,89,48,67.6,71.2,65.0,00000
49.0,94.0,33.0,455,01,01,  Bala Para,177,168,89,70,88,98,51.3,56.0,47.3,00000
49.0,94.0,33.0,455,02,01,  Chat Kazi Para,203,145,108,55,95,90,58.3,66.3,51.4,00000
49.0,94.0,33.0,455,03,01,  Munshi Para,264,110,125,46,139,64,70.6,73.1,68.5,00000
49.0,94.0,33.0,455,04,01,  Soner Para,165,162,80,71,85,91,50.5,53.0,48.3,00000
49.0,94.0,33.0,560,01,01,  Paschim Mahadeb,517,507,251,211,266,296,50.5,54.3,47.3,00000
49.0,94.0,33.0,560,02,01,  Purba Mahadeb,369,240,185,96,184,144,60.6,65.8,56.1,00000
49.0,94.0,33.0,995,01,01,  Chatlarpar,331,333,158,144,173,189,49.8,52.3,47.8,00000
49.0,94.0,33.0,995,02,01,  Chhota Sardar Para,161,65,80,20,81,45,71.2,80.0,64.3,00000
49.0,94.0,33.0,995,03,01,  Sardar Para,176,128,91,43,85,85,57.9,67.9,50.0,00000
49.0,94.0,33.0,995,04,01,  Saheber Kuti,456,425,227,180,229,245,51.8,55.8,48.3,00000
49.0,94.0,33.0,995,05,01,  Baman Para,194,171,90,69,104,102,53.2,56.6,50.5,00000
49.0,94.0,33.0,995,06,01,  Mia Para,363,187,175,84,188,103,66.0,67.6,64.6,00000
49.0,94.0,33.0,995,07,01,  Kuti Para,531,291,264,113,267,178,64.6,70.0,60.0,00000
49.0,94.0,33.0,995,08,01,  Dokla Para,150,189,86,79,64,110,44.2,52.1,36.8,00000
49.0,94.0,33.0,995,09,01,  Kartuar Para,209,186,129,75,80,111,52.9,63.2,41.9,00000
49.0,94.0,33.0,995,10,01,  Hossen Para,260,187,142,77,118,110,58.2,64.8,51.8,00000
49.0,94.0,33.0,995,11,01,  Khamar Para,188,189,109,78,79,111,49.9,58.3,41.6,00000
49.0,94.0,33.0,995,12,01,  Khan Para,153,106,71,41,82,65,59.1,63.4,55.8,00000
49.0,94.0,39.0,045,01,01,  Uttar Bagchir Khamar,517,314,264,112,253,202,62.2,70.2,55.6,00000
49.0,94.0,39.0,045,02,01,  Dakshin Bagchir Khamar,264,250,134,99,130,151,51.4,57.5,46.3,00000
49.0,94.0,39.0,125,01,01,  Uttar Bijoyram Tabakpur,426,502,204,218,222,284,45.9,48.3,43.9,00000
49.0,94.0,39.0,125,02,01,  Dakshin Bijoyram Tabakpur,353,526,185,248,168,278,40.2,42.7,37.7,00000
49.0,94.0,39.0,135,01,01,  Uttar Bishnu Ballabh,238,441,115,187,123,254,35.1,38.1,32.6,00000
49.0,94.0,39.0,135,02,01,  Madhya Bishnu Ballabh,349,325,177,130,172,195,51.8,57.7,46.9,00000
49.0,94.0,39.0,135,03,01,  Dakshin Bishnu Ballabh,767,603,385,248,382,355,56.0,60.8,51.8,00000
49.0,94.0,39.0,225,01,01,  Purba Dari Char,246,247,125,109,121,138,49.9,53.4,46.7,00000
49.0,94.0,39.0,225,02,01,  Madhya Dari Char,397,202,195,70,202,132,66.3,73.6,60.5,00000
49.0,94.0,39.0,225,03,01,  Paschim Dari Char,340,658,167,292,173,366,34.1,36.4,32.1,00000
49.0,94.0,39.0,230,01,01,  Paik Para,663,498,336,217,327,281,57.1,60.8,53.8,00000
49.0,94.0,39.0,230,02,01,  Palpara,235,163,134,60,101,103,59.0,69.1,49.5,00000
49.0,94.0,39.0,230,04,01,  Baraibari,379,269,197,111,182,158,58.5,64.0,53.5,00000
49.0,94.0,39.0,230,05,01,  Surir Darar Para,600,562,306,256,294,306,51.6,54.4,49.0,00000
49.0,94.0,39.0,230,06,01,  Indararpar,310,119,158,41,152,78,72.3,79.4,66.1,00000
49.0,94.0,39.0,230,08,01,  Kurarpar,601,149,291,63,310,86,80.1,82.2,78.3,00000
49.0,94.0,39.0,230,09,01,  Zadu Poddar,440,123,208,44,232,79,78.2,82.5,74.6,00000
49.0,94.0,39.0,435,01,01,  Uttar Kasiagari Haripur,503,471,272,194,231,277,51.6,58.4,45.5,00000
49.0,94.0,39.0,435,02,01,  Dakshin Kasiagari Haripur,308,410,170,181,138,229,42.9,48.4,37.6,00000
49.0,94.0,39.0,645,01,01,  Purba Naora,573,550,299,248,274,302,51.0,54.7,47.6,00000
49.0,94.0,39.0,645,02,01,  Paschim Naora,345,406,187,162,158,244,45.9,53.6,39.3,00000
49.0,94.0,50.0,250,01,01,  Kamar Para,430,566,222,266,208,300,43.2,45.5,40.9,00000
49.0,94.0,50.0,250,02,01,  Dhalali Para,201,189,108,86,93,103,51.5,55.7,47.4,00000
49.0,94.0,50.0,250,03,01,  Durgapur,460,420,249,195,211,225,52.3,56.1,48.4,00000
49.0,94.0,50.0,250,04,01,  Valurkhamar,443,452,228,206,215,246,49.5,52.5,46.6,00000
49.0,94.0,50.0,250,05,01,  Batia Para,522,466,264,201,258,265,52.8,56.8,49.3,00000
49.0,94.0,50.0,250,06,01,  Bangsigram,239,271,116,114,123,157,46.9,50.4,43.9,00000
49.0,94.0,50.0,305,01,01,  Hararkhamar,393,425,193,180,200,245,48.0,51.7,44.9,00000
49.0,94.0,50.0,305,02,01,  Ambari,93,108,44,49,49,59,46.3,47.3,45.4,00000
49.0,94.0,50.0,305,03,01,  Chit Gopinathpur,255,315,106,128,149,187,44.7,45.3,44.3,00000
49.0,94.0,50.0,310,01,01,  Ganjaibari,115,236,65,99,50,137,32.8,39.6,26.7,00000
49.0,94.0,50.0,310,02,01,  Sarkar Para,239,200,123,105,116,95,54.4,53.9,55.0,00000
49.0,94.0,50.0,310,03,01,  Radunighat,443,357,231,170,212,187,55.4,57.6,53.1,00000
49.0,94.0,50.0,310,04,01,  Nalkata,446,535,240,230,206,305,45.5,51.1,40.3,00000
49.0,94.0,50.0,310,05,01,  Panchpir,598,596,305,270,293,326,50.1,53.0,47.3,00000
49.0,94.0,50.0,310,06,01,  Shyampur,266,356,129,173,137,183,42.8,42.7,42.8,00000
49.0,94.0,50.0,310,07,01,  Miaji Para,269,154,137,67,132,87,63.6,67.2,60.3,00000
49.0,94.0,50.0,310,08,01,  Mandal Para,464,512,233,209,231,303,47.5,52.7,43.3,00000
49.0,94.0,50.0,310,09,01,  Baman Para,138,173,69,78,69,95,44.4,46.9,42.1,00000
49.0,94.0,50.0,310,10,01,  Baksi Gram,252,192,139,71,113,121,56.8,66.2,48.3,00000
49.0,94.0,50.0,310,11,01,  Sararpar,447,600,257,270,190,330,42.7,48.8,36.5,00000
49.0,94.0,50.0,315,01,01,  Kalyan,167,348,80,161,87,187,32.4,33.2,31.8,00000
49.0,94.0,50.0,315,02,01,  Bangar Bhita,139,240,79,112,60,128,36.7,41.4,31.9,00000
49.0,94.0,50.0,315,03,01,  Haji Para,280,278,153,129,127,149,50.2,54.3,46.0,00000
49.0,94.0,50.0,315,04,01,  Mia Para,189,67,93,28,96,39,73.8,76.9,71.1,00000
49.0,94.0,50.0,315,05,01,  Nurashwar,160,220,84,96,76,124,42.1,46.7,38.0,00000
49.0,94.0,50.0,315,06,01,  Jola Para,246,467,122,199,124,268,34.5,38.0,31.6,00000
49.0,94.0,50.0,315,07,01,  Damurarpar,122,244,61,106,61,138,33.3,36.5,30.7,00000
49.0,94.0,50.0,315,08,01,  Paikari Bhita,290,678,136,268,154,410,30.0,33.7,27.3,00000
49.0,94.0,50.0,315,09,01,  Jakua Para,122,232,64,90,58,142,34.5,41.6,29.0,00000
49.0,94.0,50.0,315,10,01,  Gombari,301,703,165,346,136,357,30.0,32.3,27.6,00000
49.0,94.0,50.0,375,01,01,  Dalimarpar,222,181,117,80,105,101,55.1,59.4,51.0,00000
49.0,94.0,50.0,375,02,01,  Roypara,282,226,146,81,136,145,55.5,64.3,48.4,00000
49.0,94.0,50.0,375,03,01,  Kamar Para,218,276,116,105,102,171,44.1,52.5,37.4,00000
49.0,94.0,50.0,375,04,01,  Paik Para,206,353,116,148,90,205,36.9,43.9,30.5,00000
49.0,94.0,50.0,375,05,01,  Pasri Para,142,219,69,89,73,130,39.3,43.7,36.0,00000
49.0,94.0,50.0,375,06,01,  Bepari Para,322,318,168,133,154,185,50.3,55.8,45.4,00000
49.0,94.0,50.0,375,07,01,  Fakir Para,210,168,100,75,110,93,55.6,57.1,54.2,00000
49.0,94.0,50.0,375,08,01,  Jalla-Am,307,408,171,181,136,227,42.9,48.6,37.5,00000
49.0,94.0,50.0,375,09,01,  Jakua Para,64,81,31,35,33,46,44.1,47.0,41.8,00000
49.0,94.0,50.0,375,10,01,  Bashbari,231,221,126,86,105,135,51.1,59.4,43.8,00000
49.0,94.0,50.0,375,11,01,  Brahmatat,190,214,115,94,75,120,47.0,55.0,38.5,00000
49.0,94.0,50.0,375,12,01,  Baksigram,187,276,79,108,108,168,40.4,42.2,39.1,00000
49.0,94.0,50.0,375,13,01,  Sarkar Para,179,123,90,42,89,81,59.3,68.2,52.4,00000
49.0,94.0,50.0,420,01,01,  Purba Kamal Khamar,804,1129,370,524,434,605,41.6,41.4,41.8,00000
49.0,94.0,50.0,420,02,01,  Janjagir,774,750,380,324,394,426,50.8,54.0,48.0,00000
49.0,94.0,55.0,325,01,01,  Dalali Para,573,316,293,125,280,191,64.5,70.1,59.4,00000
49.0,94.0,55.0,325,02,01,  Gunaigachh,872,636,445,278,427,358,57.8,61.5,54.4,00000
49.0,94.0,61.0,020,01,01,  Mazipara,282,587,144,255,138,332,32.5,36.1,29.4,00000
49.0,94.0,61.0,020,02,01,  Gaburjan,73,371,43,163,30,208,16.4,20.9,12.6,00000
49.0,94.0,61.0,020,03,01,  Anantapur,946,1513,532,695,414,818,38.5,43.4,33.6,00000
49.0,94.0,61.0,020,04,01,  Hindu Para,251,308,131,123,120,185,44.9,51.6,39.3,00000
49.0,94.0,61.0,020,05,01,  Kalatipara,334,695,178,298,156,397,32.5,37.4,28.2,00000
49.0,94.0,61.0,020,06,01,  Chirakhoya,641,893,366,383,275,510,41.8,48.9,35.0,00000
49.0,94.0,61.0,340,01,01,  Hatiagram,93,247,41,107,52,140,27.4,27.7,27.1,00000
49.0,94.0,61.0,340,02,01,  Naya Dara,97,274,47,128,50,146,26.1,26.9,25.5,00000
49.0,94.0,61.0,340,03,01,  Kamar Tari,148,192,64,77,84,115,43.5,45.4,42.2,00000
49.0,94.0,61.0,345,01,01,  Beparigram,562,894,308,390,254,504,38.6,44.1,33.5,00000
49.0,94.0,61.0,345,02,01,  Bakshi Para,328,791,182,323,146,468,29.3,36.0,23.8,00000
49.0,94.0,61.0,345,03,01,  Balar Char,231,660,144,283,87,377,25.9,33.7,18.8,00000
49.0,94.0,61.0,345,04,01,  Sonar Para,578,914,288,384,290,530,38.7,42.9,35.4,00000
49.0,94.0,61.0,345,05,01,  Jola Para,335,403,159,166,176,237,45.4,48.9,42.6,00000
49.0,94.0,61.0,355,01,01,  Dudkumarpar,443,291,197,124,246,167,60.4,61.4,59.6,00000
49.0,94.0,61.0,355,02,01,  Sarkar Para,321,424,164,191,157,233,43.1,46.2,40.3,00000
49.0,94.0,61.0,355,03,01,  Hijli,812,910,416,417,396,493,47.2,49.9,44.5,00000
49.0,94.0,61.0,360,01,01,  Dighal Hillah,421,381,221,139,200,242,52.5,61.4,45.2,00000
49.0,94.0,61.0,360,02,01,  Hijli Goppara,802,1446,446,692,356,754,35.7,39.2,32.1,00000
49.0,94.0,61.0,360,03,01,  Thutirpar,423,553,213,230,210,323,43.3,48.1,39.4,00000
49.0,94.0,72.0,025,01,01,  Uttar Apuarkhata,623,726,330,316,293,410,46.2,51.1,41.7,00000
49.0,94.0,72.0,025,02,01,  Paschim Apuarkhata,145,165,75,69,70,96,46.8,52.1,42.2,00000
49.0,94.0,72.0,025,03,01,  Pathan Para,181,132,100,42,81,90,57.8,70.4,47.4,00000
49.0,94.0,72.0,025,04,01,  Nuta Para,120,285,73,126,47,159,29.6,36.7,22.8,00000
49.0,94.0,72.0,025,05,01,  Hindu Para,836,562,455,223,381,339,59.8,67.1,52.9,00000
49.0,94.0,72.0,025,06,01,  Satghariapar,74,244,33,105,41,139,23.3,23.9,22.8,00000
49.0,94.0,72.0,025,07,01,  Sattur Bhita,438,413,222,179,216,234,51.5,55.4,48.0,00000
49.0,94.0,72.0,025,08,01,  Mandal Para,199,232,97,107,102,125,46.2,47.5,44.9,00000
49.0,94.0,72.0,025,09,01,  Audiarpar,342,299,185,143,157,156,53.4,56.4,50.2,00000
49.0,94.0,72.0,670,01,01,  Bhannatri,458,657,234,272,224,385,41.1,46.2,36.8,00000
49.0,94.0,72.0,670,02,01,  Rambadra Para,529,743,249,339,280,404,41.6,42.3,40.9,00000
49.0,94.0,72.0,670,03,01,  Parul,154,301,72,131,82,170,33.8,35.5,32.5,00000
49.0,94.0,72.0,670,04,01,  Bairagi Para,136,219,63,102,73,117,38.3,38.2,38.4,00000
49.0,94.0,72.0,670,05,01,  Bamnarpar,636,632,334,286,302,346,50.2,53.9,46.6,00000
49.0,94.0,72.0,670,06,01,  Dakshin Pandul,236,219,128,89,108,130,51.9,59.0,45.4,00000
49.0,94.0,72.0,670,07,01,  Uttar Pandul,288,227,138,106,150,121,55.9,56.6,55.4,00000
49.0,94.0,72.0,670,08,01,  Haji Para,433,841,238,403,195,438,34.0,37.1,30.8,00000
49.0,94.0,72.0,670,09,01,  Kagzi Para,207,347,112,152,95,195,37.4,42.4,32.8,00000
49.0,94.0,72.0,670,10,01,  Satgharia Para,215,302,111,133,104,169,41.6,45.5,38.1,00000
49.0,94.0,72.0,670,11,01,  Kumar Para,238,307,116,129,122,178,43.7,47.3,40.7,00000
49.0,94.0,72.0,965,01,01,  Uttar Tanuram,251,429,131,174,120,255,36.9,43.0,32.0,00000
49.0,94.0,72.0,965,02,01,  Dakshin Tanuram,542,696,301,311,241,385,43.8,49.2,38.5,00000
49.0,94.0,75.0,168,01,01,  Mandaler Char,20,372,13,184,7,188,5.1,6.6,3.6,00000
49.0,94.0,75.0,168,02,01,  Parar Char,153,620,93,327,60,293,19.8,22.1,17.0,00000
49.0,94.0,75.0,200,01,01,  Daikhawa,287,1087,173,512,114,575,20.9,25.3,16.5,00000
49.0,94.0,75.0,200,02,01,  Airmari,43,377,21,172,22,205,10.2,10.9,9.7,00000
49.0,94.0,75.0,285,01,01,  Gendar Alga,111,661,76,314,35,347,14.4,19.5,9.2,00000
49.0,94.0,75.0,285,02,01,  Mandal Para,307,390,160,182,147,208,44.0,46.8,41.4,00000
49.0,94.0,75.0,285,03,01,  Guchchhagram,126,268,79,128,47,140,32.0,38.2,25.1,00000
49.0,94.0,75.0,625,01,01,  Mekurer Alga,102,711,62,351,40,360,12.5,15.0,10.0,00000
49.0,94.0,75.0,625,02,01,  Nazirarchar,140,257,76,124,64,133,35.3,38.0,32.5,00000
49.0,94.0,75.0,625,03,01,  Char Mekurer Alga,91,268,55,129,36,139,25.3,29.9,20.6,00000
49.0,94.0,75.0,635,01,01,  Uttar Namajer Char,481,910,277,410,204,500,34.6,40.3,29.0,00000
49.0,94.0,75.0,635,02,01,  Dakshin Namajer Char,709,1857,396,863,313,994,27.6,31.5,23.9,00000
49.0,94.0,75.0,855,01,01,  Saheber Alga,233,627,139,293,94,334,27.1,32.2,22.0,00000
49.0,94.0,75.0,855,02,01,  Char Saheber Alga,68,414,47,191,21,223,14.1,19.7,8.6,00000
49.0,94.0,75.0,855,03,01,  Katlamari,92,357,61,151,31,206,20.5,28.8,13.1,00000
49.0,94.0,78.0,075,01,01,  Khan Para,251,180,134,75,117,105,58.2,64.1,52.7,00000
49.0,94.0,78.0,075,02,01,  Bairagi Para,254,115,128,49,126,66,68.8,72.3,65.6,00000
49.0,94.0,78.0,075,03,01,  Jola Para,165,64,82,28,83,36,72.1,74.5,69.7,00000
49.0,94.0,78.0,075,04,01,  Miaji Para,152,168,74,80,78,88,47.5,48.1,47.0,00000
49.0,94.0,78.0,075,05,01,  Bala Para,240,219,108,100,132,119,52.3,51.9,52.6,00000
49.0,94.0,78.0,075,06,01,  Nayagram,74,165,37,71,37,94,31.0,34.3,28.2,00000
49.0,94.0,78.0,075,07,01,  Sarkar Para,158,165,72,76,86,89,48.9,48.6,49.1,00000
49.0,94.0,78.0,075,08,01,  Haji Para,144,85,82,31,62,54,62.9,72.6,53.4,00000
49.0,94.0,78.0,075,09,01,  Baldi Para,187,125,86,49,101,76,59.9,63.7,57.1,00000
49.0,94.0,78.0,075,10,01,  Farazi Para,151,156,81,59,70,97,49.2,57.9,41.9,00000
49.0,94.0,78.0,075,11,01,  Akand Para,321,219,156,106,165,113,59.4,59.5,59.4,00000
49.0,94.0,78.0,075,12,01,  Darar Para,308,206,167,90,141,116,59.9,65.0,54.9,00000
49.0,94.0,78.0,075,13,01,  Sonary Para,213,178,116,69,97,109,54.5,62.7,47.1,00000
49.0,94.0,78.0,095,01,01,  Rajarghat,265,314,127,118,138,196,45.8,51.8,41.3,00000
49.0,94.0,78.0,095,02,01,  Tamakuri Para,181,309,102,130,79,179,36.9,44.0,30.6,00000
49.0,94.0,78.0,095,03,01,  Sekh Para,188,388,100,164,88,224,32.6,37.9,28.2,00000
49.0,94.0,78.0,095,04,01,  Aggram,90,189,49,78,41,111,32.3,38.6,27.0,00000
49.0,94.0,78.0,405,01,01,  Uttar Para,393,236,215,93,178,143,62.5,69.8,55.5,00000
49.0,94.0,78.0,405,02,01,  Dakshin Para,192,189,98,76,94,113,50.4,56.3,45.4,00000
49.0,94.0,78.0,485,01,01,  Teli Para,300,478,157,232,143,246,38.6,40.4,36.8,00000
49.0,94.0,78.0,485,02,01,  Paik Para,101,211,62,91,39,120,32.4,40.5,24.5,00000
49.0,94.0,78.0,485,03,01,  Majhi Para,282,377,151,165,131,212,42.8,47.8,38.2,00000
49.0,94.0,78.0,485,04,01,  Charua Para,158,191,86,89,72,102,45.3,49.1,41.4,00000
49.0,94.0,78.0,520,01,01,  Barui Para,297,141,154,61,143,80,67.8,71.6,64.1,00000
49.0,94.0,78.0,520,02,01,  Mollah Para,117,97,57,38,60,59,54.7,60.0,50.4,00000
49.0,94.0,78.0,520,03,01,  Chowkidar Para,137,169,71,72,66,97,44.8,49.7,40.5,00000
49.0,94.0,78.0,850,01,01,  Chuniarpar,482,293,253,139,229,154,62.2,64.5,59.8,00000
49.0,94.0,78.0,850,02,01,  Sarkar Para,453,683,255,304,198,379,39.9,45.6,34.3,00000
49.0,94.0,78.0,850,03,01,  Miraji Para,169,117,100,52,69,65,59.1,65.8,51.5,00000
49.0,94.0,78.0,850,04,01,  Fakir Para,167,105,88,43,79,62,61.4,67.2,56.0,00000
49.0,94.0,78.0,850,05,01,  Chachiarpar,301,262,160,122,141,140,53.5,56.7,50.2,00000
49.0,94.0,78.0,850,06,01,  Uchchhatari,128,256,69,134,59,122,33.3,34.0,32.6,00000
49.0,94.0,78.0,850,07,01,  Teli Para,384,314,196,112,188,202,55.0,63.6,48.2,00000
49.0,94.0,78.0,850,08,01,  Daoband,337,415,183,177,154,238,44.8,50.8,39.3,00000
49.0,94.0,78.0,850,09,01,  Akirpar,113,177,60,80,53,97,39.0,42.9,35.3,00000
49.0,94.0,78.0,850,10,01,  Manushmara,467,541,254,248,213,293,46.3,50.6,42.1,00000
49.0,94.0,78.0,850,11,01,  Charua Para,204,137,108,62,96,75,59.8,63.5,56.1,00000
49.0,94.0,78.0,850,12,01,  Mandal Para,158,117,80,51,78,66,57.5,61.1,54.2,00000
49.0,94.0,78.0,900,01,01,  Poglarpar,89,78,44,30,45,48,53.3,59.5,48.4,00000
49.0,94.0,78.0,900,02,01,  Nayagram,99,103,53,51,46,52,49.0,51.0,46.9,00000
49.0,94.0,78.0,900,03,01,  Kabiraj Para,150,203,72,82,78,121,42.5,46.8,39.2,00000
49.0,94.0,78.0,925,01,01,  Zaharia Para,250,371,134,175,116,196,40.3,43.4,37.2,00000
49.0,94.0,78.0,925,02,01,  Ruhirpar,194,175,95,71,99,104,52.6,57.2,48.8,00000
49.0,94.0,78.0,925,03,01,  Sardar Para,281,289,142,123,139,166,49.3,53.6,45.6,00000
49.0,94.0,78.0,925,04,01,  Mandal Para,161,458,88,223,73,235,26.0,28.3,23.7,00000
49.0,94.0,78.0,925,05,01,  Aggpara,113,272,57,129,56,143,29.4,30.6,28.1,00000
49.0,94.0,78.0,925,06,01,  Mistri Para,181,140,93,63,88,77,56.4,59.6,53.3,00000
49.0,94.0,78.0,925,07,01,  Tapashi Para,184,166,111,70,73,96,52.6,61.3,43.2,00000
49.0,94.0,78.0,925,08,01,  Baman Para,303,409,150,188,153,221,42.6,44.4,40.9,00000
49.0,94.0,78.0,925,09,01,  Miah Para,159,256,87,125,72,131,38.3,41.0,35.5,00000
49.0,94.0,78.0,925,10,01,  Kabiraj Para,223,287,121,125,102,162,43.7,49.2,38.6,00000
49.0,94.0,78.0,980,01,01,  Kari Para,566,421,299,179,267,242,57.3,62.6,52.5,00000
49.0,94.0,78.0,980,02,01,  Miaji Para,231,335,128,156,103,179,40.8,45.1,36.5,00000
49.0,94.0,78.0,980,03,01,  Tentultala,396,195,213,81,183,114,67.0,72.4,61.6,00000
49.0,94.0,78.0,980,04,01,  Gigir Para,202,206,102,84,100,122,49.5,54.8,45.0,00000
49.0,94.0,78.0,980,05,01,  Charaikati,35,70,17,28,18,42,33.3,37.8,30.0,00000
49.0,94.0,78.0,980,06,01,  Akerpar,99,237,46,112,53,125,29.5,29.1,29.8,00000
49.0,94.0,78.0,980,07,01,  Kuti,87,112,43,49,44,63,43.7,46.7,41.1,00000
49.0,94.0,78.0,980,08,01,  Majhi Para,69,102,37,45,32,57,40.4,45.1,36.0,00000
49.0,94.0,78.0,980,09,01,  Bangsi Para,125,182,68,79,57,103,40.7,46.3,35.6,00000
49.0,94.0,78.0,980,10,01,  Zamirbari,275,205,126,94,149,111,57.3,57.3,57.3,00000
49.0,94.0,78.0,980,11,01,  Sarairpar,316,477,160,226,156,251,39.8,41.5,38.3,00000
49.0,94.0,78.0,980,12,01,  Zamer Dargah,457,682,240,308,217,374,40.1,43.8,36.7,00000
49.0,94.0,83.0,220,01,01,  Uttar Dari Kishorepur,626,750,306,316,320,434,45.5,49.2,42.4,00000
49.0,94.0,83.0,220,02,01,  Dakshin Dari Kishorepur,482,608,218,255,264,353,44.2,46.1,42.8,00000
49.0,94.0,83.0,220,03,01,  Sekher Khamar,179,108,88,42,91,66,62.4,67.7,58.0,00000
49.0,94.0,83.0,320,01,01,  Uttar Goraipiar,1183,622,587,251,596,371,65.5,70.0,61.6,00000
49.0,94.0,83.0,320,02,01,  Dakshin Goraipiar,184,502,91,212,93,290,26.8,30.0,24.3,00000
49.0,94.0,83.0,320,03,01,  Gorai Piar Char Pachim,155,314,99,142,56,172,33.0,41.1,24.6,00000
49.0,94.0,83.0,335,01,01,  Bepari Para,332,298,170,131,162,167,52.7,56.5,49.2,00000
49.0,94.0,83.0,335,02,01,  Sarkar Para,234,171,115,79,119,92,57.8,59.3,56.4,00000
49.0,94.0,83.0,335,03,01,  Majhi Para,147,168,83,76,64,92,46.7,52.2,41.0,00000
49.0,94.0,83.0,365,01,01,  Fakir Para,526,457,266,178,260,279,53.5,59.9,48.2,00000
49.0,94.0,83.0,365,02,01,  Chairman Para,390,274,207,105,183,169,58.7,66.3,52.0,00000
49.0,94.0,83.0,365,03,01,  Kumar Para,253,205,124,80,129,125,55.2,60.8,50.8,00000
49.0,94.0,83.0,365,04,01,  Khamar Para,390,307,192,117,198,190,56.0,62.1,51.0,00000
49.0,94.0,83.0,365,05,01,  Bakshi Para,164,277,83,126,81,151,37.2,39.7,34.9,00000
49.0,94.0,83.0,365,06,01,  Borat Para,307,137,158,49,149,88,69.1,76.3,62.9,00000
49.0,94.0,83.0,365,07,01,  Dalal Para,232,193,119,74,113,119,54.6,61.7,48.7,00000
49.0,94.0,83.0,365,08,01,  Patwari Para,241,105,110,35,131,70,69.7,75.9,65.2,00000
49.0,94.0,83.0,525,01,01,  Kumar Para,201,140,112,52,89,88,58.9,68.3,50.3,00000
49.0,94.0,83.0,525,02,01,  Basunia Para,327,111,161,41,166,70,74.7,79.7,70.3,00000
49.0,94.0,83.0,525,03,01,  Teli Para,149,154,67,61,82,93,49.2,52.3,46.9,00000
49.0,94.0,83.0,525,04,01,  Bangali Para,364,235,177,105,187,130,60.8,62.8,59.0,00000
49.0,94.0,83.0,525,05,01,  Patilapuri,340,318,141,143,199,175,51.7,49.6,53.2,00000
49.0,94.0,83.0,525,06,01,  Bari Para,260,152,132,61,128,91,63.1,68.4,58.4,00000
49.0,94.0,83.0,525,07,01,  Baksi Para,270,122,146,50,124,72,68.9,74.5,63.3,00000
49.0,94.0,83.0,525,08,01,  Noygharia,200,132,103,64,97,68,60.2,61.7,58.8,00000
49.0,94.0,83.0,525,09,01,  Moulvi Para,198,215,100,88,98,127,47.9,53.2,43.6,00000
49.0,94.0,83.0,800,01,01,  Purba Ramprasad,584,225,314,101,270,124,72.2,75.7,68.5,00000
49.0,94.0,83.0,800,02,01,  Madrasa Area,316,235,162,94,154,141,57.4,63.3,52.2,00000
32.0,21.0,11.0,273,01,01,  Dakatiar Char,473,1571,240,743,233,828,23.1,24.4,22.0,00000
32.0,21.0,11.0,273,02,01,  Ghatua,66,78,31,36,35,42,45.8,46.3,45.5,00000
32.0,21.0,35.0,572,01,01,  Kalur Para,13,255,9,122,4,133,4.9,6.9,2.9,00000
32.0,21.0,35.0,572,02,01,  Sekh Para,63,714,45,361,18,353,8.1,11.1,4.9,00000
32.0,21.0,47.0,335,01,03,  Baushi Para,2053,2342,1140,1064,913,1278,46.7,51.7,41.7,00000
32.0,21.0,47.0,335,02,03,  Gazaria,279,780,154,370,125,410,26.3,29.4,23.4,00000
32.0,21.0,47.0,621,01,01,  Paschim Katlamari,1114,1576,574,681,540,895,41.4,45.7,37.6,00000
32.0,21.0,47.0,621,02,01,  Purba Katlamari,947,1683,527,790,420,893,36.0,40.0,32.0,00000
32.0,21.0,71.0,136,01,01,  Dakshin Burail,973,1766,521,846,452,920,35.5,38.1,32.9,00000
32.0,21.0,71.0,136,02,01,  Uttar Burail,761,1054,404,479,357,575,41.9,45.8,38.3,00000
32.0,21.0,71.0,236,01,01,  Purba Chhalua,625,1008,347,460,278,548,38.3,43.0,33.7,00000
32.0,21.0,71.0,236,02,01,  Paschim Chhalua,814,1233,424,573,390,660,39.8,42.5,37.1,00000
32.0,21.0,71.0,609,01,01,  Uttar Kathur,1020,1579,524,686,496,893,39.2,43.3,35.7,00000
32.0,21.0,71.0,609,02,01,  Dakshin Kathur,642,737,350,316,292,421,46.6,52.6,41.0,00000
32.0,21.0,71.0,970,01,01,  Purba Udakhali,1067,1672,552,766,515,906,39.0,41.9,36.2,00000
32.0,21.0,71.0,970,02,01,  Paschim Udakhali,1097,1415,595,605,502,810,43.7,49.6,38.3,00000
32.0,24.0,36.0,219,01,01,  Konar Para,218,652,99,310,119,342,25.1,24.2,25.8,00000
32.0,24.0,36.0,219,02,01,  Sonakura,420,850,221,392,199,458,33.1,36.1,30.3,00000
32.0,24.0,36.0,219,03,01,  Moktar Para,235,202,117,84,118,118,53.8,58.2,50.0,00000
32.0,24.0,36.0,219,04,01,  Charergram,307,132,142,62,165,70,69.9,69.6,70.2,00000
32.0,24.0,36.0,219,05,01,  Master Para,171,223,86,99,85,124,43.4,46.5,40.7,00000
32.0,24.0,36.0,219,06,01,  Taltala,385,404,197,198,188,206,48.8,49.9,47.7,00000
32.0,24.0,36.0,219,07,01,  Madhyapara,150,270,83,131,67,139,35.7,38.8,32.5,00000
32.0,24.0,36.0,219,08,01,  Dakshin Ghagoa,115,279,59,124,56,155,29.2,32.2,26.5,00000
32.0,24.0,36.0,980,01,01,  Khatihara,539,647,288,307,251,340,45.4,48.4,42.5,00000
32.0,24.0,36.0,980,02,01,  Ganglardoba,239,475,127,196,112,279,33.5,39.3,28.6,00000
32.0,24.0,36.0,980,03,01,  Hatia Para,386,724,193,331,193,393,34.8,36.8,32.9,00000
32.0,24.0,36.0,980,04,01,  Sulagari,541,1096,276,481,265,615,33.0,36.5,30.1,00000
32.0,24.0,36.0,980,05,01,  Nutangari,640,1100,354,508,286,592,36.8,41.1,32.6,00000
32.0,24.0,36.0,980,06,01,  Tangamara,332,519,188,224,144,295,39.0,45.6,32.8,00000
32.0,24.0,36.0,980,07,01,  Palpara,469,812,234,370,235,442,36.6,38.7,34.7,00000
32.0,24.0,36.0,980,08,01,  Uttar Ghagoa,268,499,152,229,116,270,34.9,39.9,30.1,00000
32.0,30.0,10.0,005,01,01,  Fatehpur,138,417,77,209,61,208,24.9,26.9,22.7,00000
32.0,30.0,10.0,005,02,01,  Akhira Para,235,428,126,192,109,236,35.4,39.6,31.6,00000
32.0,30.0,10.0,005,03,01,  Shikshar,62,236,28,113,34,123,20.8,19.9,21.7,00000
32.0,30.0,10.0,050,01,01,  Purbapara,155,263,80,121,75,142,37.1,39.8,34.6,00000
32.0,30.0,10.0,050,02,01,  Mandal Para,125,267,67,124,58,143,31.9,35.1,28.9,00000
32.0,30.0,10.0,050,03,01,  Naya Para,90,250,47,124,43,126,26.5,27.5,25.4,00000
32.0,30.0,10.0,050,04,01,  Daspara,169,184,93,87,76,97,47.9,51.7,43.9,00000
32.0,30.0,10.0,050,05,01,  Haji Para,79,294,47,136,32,158,21.2,25.7,16.8,00000
32.0,30.0,10.0,050,06,01,  Bhotala Para,116,111,69,54,47,57,51.1,56.1,45.2,00000
32.0,30.0,10.0,050,07,01,  Char Para,246,347,131,157,115,190,41.5,45.5,37.7,00000
32.0,30.0,10.0,050,08,01,  Dargah Para,160,230,90,106,70,124,41.0,45.9,36.1,00000
32.0,30.0,10.0,050,09,01,  Nama Para,127,228,62,105,65,123,35.8,37.1,34.6,00000
32.0,30.0,10.0,050,10,01,  Miha Para,349,609,197,268,152,341,36.4,42.4,30.8,00000
32.0,30.0,10.0,050,11,01,  Fakir Para,104,248,50,122,54,126,29.5,29.1,30.0,00000
32.0,30.0,10.0,183,01,01,  Birahimpur,129,175,75,78,54,97,42.4,49.0,35.8,00000
32.0,30.0,10.0,183,02,01,  Chak Birahimpur,116,212,65,97,51,115,35.4,40.1,30.7,00000
32.0,30.0,10.0,192,01,01,  Paschimpara,49,231,24,119,25,112,17.5,16.8,18.2,00000
32.0,30.0,10.0,192,02,01,  Mona Para,105,265,53,127,52,138,28.4,29.4,27.4,00000
32.0,30.0,10.0,192,03,01,  Motor Para,177,247,89,119,88,128,41.7,42.8,40.7,00000
32.0,30.0,10.0,192,04,01,  Balu Para,196,252,101,126,95,126,43.8,44.5,43.0,00000
32.0,30.0,10.0,497,01,01,  Sapgachhi,162,220,85,104,77,116,42.4,45.0,39.9,00000
32.0,30.0,10.0,497,02,01,  Kalikapur,210,429,117,196,93,233,32.9,37.4,28.5,00000
32.0,30.0,10.0,648,01,01,  Uttarpara,194,217,106,101,88,116,47.2,51.2,43.1,00000
32.0,30.0,10.0,648,02,01,  Kamar Para,160,232,82,108,78,124,40.8,43.2,38.6,00000
32.0,30.0,10.0,648,03,01,  Sabbari,167,233,92,105,75,128,41.8,46.7,36.9,00000
32.0,30.0,10.0,648,04,01,  Chhota Maria,196,487,109,235,87,252,28.7,31.7,25.7,00000
32.0,30.0,10.0,684,01,01,  Naldanga Gobindapur,219,627,124,294,95,333,25.9,29.7,22.2,00000
32.0,30.0,10.0,684,02,01,  Naldanga,149,221,78,95,71,126,40.3,45.1,36.0,00000
32.0,30.0,10.0,799,01,01,  Rahala,189,181,104,86,85,95,51.1,54.7,47.2,00000
32.0,30.0,10.0,799,02,01,  Bil Rahala,74,230,36,106,38,124,24.3,25.4,23.5,00000
32.0,30.0,10.0,870,01,01,  Satana,157,239,83,107,74,132,39.6,43.7,35.9,00000
32.0,30.0,10.0,870,02,01,  Dalal Para,109,216,50,102,59,114,33.5,32.9,34.1,00000
32.0,30.0,10.0,870,03,01,  Ghosh Para,123,134,55,62,68,72,47.9,47.0,48.6,00000
32.0,30.0,10.0,870,04,01,  Balo Para,199,442,97,212,102,230,31.0,31.4,30.7,00000
32.0,30.0,11.0,447,01,01,  Hatiadaha,82,217,45,95,37,122,27.4,32.1,23.3,00000
32.0,30.0,27.0,127,01,01,  Barna Chandra Sekhar,529,683,266,324,263,359,43.6,45.1,42.3,00000
32.0,30.0,27.0,127,02,01,  Dingalkandi,153,179,74,81,79,98,46.1,47.7,44.6,00000
32.0,30.0,27.0,127,03,01,  Moghaltali,286,326,148,154,138,172,46.7,49.0,44.5,00000
32.0,30.0,27.0,651,01,01,  Masta Kanipara,123,304,61,150,62,154,28.8,28.9,28.7,00000
32.0,30.0,27.0,651,02,01,  Dakshinpara,160,242,92,127,68,115,39.8,42.0,37.2,00000
32.0,30.0,27.0,651,03,01,  Fakir Para,11,18,5,9,6,9,37.9,35.7,40.0,00000
32.0,30.0,27.0,651,04,01,  Nama Para,172,191,84,88,88,103,47.4,48.8,46.1,00000
32.0,30.0,27.0,651,05,01,  Ucha Masta,177,340,85,178,92,162,34.2,32.3,36.2,00000
32.0,30.0,27.0,651,06,01,  Sarkar Para,170,231,86,105,84,126,42.4,45.0,40.0,00000
32.0,30.0,27.0,651,07,01,  Sola Para,152,200,79,85,73,115,43.2,48.2,38.8,00000
32.0,30.0,27.0,651,08,01,  Patoni Para,78,215,43,123,35,92,26.6,25.9,27.6,00000
32.0,30.0,27.0,651,09,01,  Uttar Masta,184,325,80,157,104,168,36.1,33.8,38.2,00000
32.0,30.0,39.0,032,01,01,  Uttar Askur,236,282,118,134,118,148,45.6,46.8,44.4,00000
32.0,30.0,39.0,032,02,01,  Dakshin Askur,224,576,107,299,117,277,28.0,26.4,29.7,00000
32.0,30.0,39.0,151,01,01,  Khaten Para,60,244,38,115,22,129,19.7,24.8,14.6,00000
32.0,30.0,39.0,151,02,01,  Betra Para,260,686,142,323,118,363,27.5,30.5,24.5,00000
32.0,30.0,39.0,201,01,01,  Palpara,942,1750,518,850,424,900,35.0,37.9,32.0,00000
32.0,30.0,39.0,201,02,01,  Kholoni,1226,1413,635,660,591,753,46.5,49.0,44.0,00000
32.0,30.0,39.0,201,03,01,  Balamari,405,764,201,363,204,401,34.6,35.6,33.7,00000
32.0,30.0,39.0,201,04,01,  Adampur,159,93,77,38,82,55,63.1,67.0,59.9,00000
32.0,30.0,39.0,384,01,01,  Nama Para,128,210,65,106,63,104,37.9,38.0,37.7,00000
32.0,30.0,39.0,384,02,01,  Katalbari,129,188,64,88,65,100,40.7,42.1,39.4,00000
32.0,30.0,39.0,515,01,01,  1 No Para,484,358,239,178,245,180,57.5,57.3,57.6,00000
32.0,30.0,39.0,515,02,01,  2 No Para,349,391,170,196,179,195,47.2,46.4,47.9,00000
32.0,30.0,39.0,515,03,01,  5 No Para,143,209,73,106,70,103,40.6,40.8,40.5,00000
32.0,30.0,39.0,515,04,01,  Malekabad,271,246,149,117,122,129,52.4,56.0,48.6,00000
32.0,30.0,39.0,515,05,01,  Bogura Para,317,452,158,224,159,228,41.2,41.4,41.1,00000
32.0,30.0,39.0,515,06,01,  Bayro Para,111,234,55,110,56,124,32.2,33.3,31.1,00000
32.0,30.0,39.0,515,07,01,  Helali Para,83,290,41,145,42,145,22.3,22.0,22.5,00000
32.0,30.0,39.0,515,08,01,  Zagui Para,380,461,195,238,185,223,45.2,45.0,45.3,00000
32.0,30.0,39.0,515,09,01,  Kotra Para,128,236,79,111,49,125,35.2,41.6,28.2,00000
32.0,30.0,39.0,515,10,01,  Nasirabad,602,457,298,215,304,242,56.8,58.1,55.7,00000
32.0,30.0,39.0,515,11,01,  Hamidpur,529,876,290,425,239,451,37.7,40.6,34.6,00000
32.0,30.0,39.0,518,01,01,  Kanthalbari,245,328,132,159,113,169,42.8,45.4,40.1,00000
32.0,30.0,39.0,518,02,01,  Bera,110,138,69,58,41,80,44.4,54.3,33.9,00000
32.0,30.0,50.0,740,01,01,  Bara Panthamari,275,254,134,119,141,135,52.0,53.0,51.1,00000
32.0,30.0,50.0,740,02,01,  Chhota Panthamari,154,293,77,147,77,146,34.5,34.4,34.5,00000
32.0,30.0,61.0,879,01,01,  Sihipur,438,711,235,304,203,407,38.1,43.6,33.3,00000
32.0,30.0,61.0,879,02,01,  Barai Para,160,388,94,172,66,216,29.2,35.3,23.4,00000
32.0,82.0,51.0,161,01,01,  Sarkar Para,456,667,213,314,243,353,40.6,40.4,40.8,00000
32.0,82.0,51.0,161,02,01,  Mollah Para,148,153,71,76,77,77,49.2,48.3,50.0,00000
32.0,82.0,51.0,161,03,01,  Uttarpara,110,368,56,172,54,196,23.0,24.6,21.6,00000
32.0,82.0,51.0,275,01,01,  Pali Lakshmipur,182,220,93,103,89,117,45.3,47.4,43.2,00000
32.0,82.0,51.0,275,02,01,  Khathal Lakshmipur,378,560,205,264,173,296,40.3,43.7,36.9,00000
32.0,82.0,51.0,377,01,01,  Baghjana,259,455,132,216,127,239,36.3,37.9,34.7,00000
32.0,82.0,51.0,377,02,01,  Cherenga,408,754,212,358,196,396,35.1,37.2,33.1,00000
32.0,82.0,51.0,377,03,01,  Kismat Ambari,185,237,98,118,87,119,43.8,45.4,42.2,00000
32.0,82.0,51.0,491,01,01,  Jogibari,269,566,136,269,133,297,32.2,33.6,30.9,00000
32.0,82.0,51.0,491,02,01,  Kuti Para,93,180,48,74,45,106,34.1,39.3,29.8,00000
32.0,82.0,51.0,737,01,01,  Mazompur,380,316,199,147,181,169,54.6,57.5,51.7,00000
32.0,82.0,51.0,737,02,01,  Kuli Para,92,171,46,90,46,81,35.0,33.8,36.2,00000
32.0,82.0,77.0,419,01,01,  Uttar Hatbamni,1098,1791,564,822,534,969,38.0,40.7,35.5,00000
32.0,82.0,77.0,419,02,01,  Madhyam Hatbamni,778,768,408,343,370,425,50.3,54.3,46.5,00000
32.0,82.0,77.0,419,03,01,  Dakshin Hatbamni,784,927,401,399,383,528,45.8,50.1,42.0,00000
32.0,82.0,77.0,527,01,01,  Purba Kesalidanga,1083,1068,568,468,515,600,50.3,54.8,46.2,00000
32.0,82.0,77.0,527,02,01,  Paschim Kesalidanga,693,1327,356,604,337,723,34.3,37.1,31.8,00000
32.0,82.0,77.0,533,01,01,  Khamar Bagchi,61,326,30,148,31,178,15.8,16.9,14.8,00000
32.0,82.0,77.0,533,02,01,  Khamar Bagchi (Part),99,137,48,69,51,68,41.9,41.0,42.9,00000
32.0,88.0,28.0,765,01,01,  Pabantair,1119,2545,641,1167,478,1378,30.5,35.5,25.8,00000
32.0,88.0,28.0,765,02,01,  Khamar Pabantair,538,1366,291,628,247,738,28.3,31.7,25.1,00000
32.0,88.0,66.0,561,01,01,  Kaichara,888,1007,490,447,398,560,46.9,52.3,41.5,00000
32.0,88.0,66.0,561,02,01,  Monglay Para,771,666,396,290,375,376,53.7,57.7,49.9,00000
32.0,88.0,66.0,561,03,01,  Char Para,39,450,24,219,15,231,8.0,9.9,6.1,00000
32.0,88.0,66.0,816,01,01,  Pakurtala,411,976,227,471,184,505,29.6,32.5,26.7,00000
32.0,88.0,66.0,816,02,01,  Panchpur,308,1077,198,495,110,582,22.2,28.6,15.9,00000
32.0,88.0,66.0,816,03,01,  Phalia,677,1244,355,560,322,684,35.2,38.8,32.0,00000
32.0,88.0,76.0,340,01,01,  Dakshinpara,1076,1074,559,463,517,611,50.0,54.7,45.8,00000
32.0,88.0,76.0,340,02,01,  Kumargari,506,690,257,305,249,385,42.3,45.7,39.3,00000
32.0,88.0,76.0,340,03,01,  Mazider Bhita,705,908,359,386,346,522,43.7,48.2,39.9,00000
32.0,88.0,76.0,340,04,01,  Shil Para,318,373,170,178,148,195,46.0,48.9,43.1,00000
32.0,88.0,76.0,340,05,01,  Kotal Para,340,320,198,129,142,191,51.5,60.6,42.6,00000
32.0,88.0,76.0,340,06,01,  Madhyapara,385,395,198,167,187,228,49.4,54.2,45.1,00000
32.0,88.0,76.0,340,07,01,  Jordoba,533,743,256,299,277,444,41.8,46.1,38.4,00000
32.0,88.0,76.0,969,01,01,  Miabari Mahish Lathi,1000,921,521,419,479,502,52.1,55.4,48.8,00000
32.0,88.0,76.0,969,02,01,  Bharat Mandal Para No-1,342,366,165,155,177,211,48.3,51.6,45.6,00000
32.0,88.0,76.0,969,03,01,  Bharat Mandal Para No-2,393,349,183,150,210,199,53.0,55.0,51.3,00000
32.0,88.0,76.0,969,04,01,  Kani Para,654,553,338,222,316,331,54.2,60.4,48.8,00000
32.0,88.0,76.0,969,05,01,  Char Para,556,483,280,184,276,299,53.5,60.3,48.0,00000
32.0,88.0,76.0,969,06,01,  Sattakore,336,320,163,125,173,195,51.2,56.6,47.0,00000
32.0,88.0,76.0,969,07,01,  Ullah Para,701,642,340,274,361,368,52.2,55.4,49.5,00000
32.0,88.0,76.0,969,08,01,  Mukti Para,778,737,392,326,386,411,51.4,54.6,48.4,00000
32.0,91.0,12.0,099,01,01,  Purba Belka,1065,2690,566,1216,499,1474,28.4,31.8,25.3,00000
32.0,91.0,12.0,099,02,01,  Madhya Belka,1472,2740,771,1274,701,1466,34.9,37.7,32.3,00000
32.0,91.0,12.0,099,03,01,  Paschim Belka,1141,2118,578,1001,563,1117,35.0,36.6,33.5,00000
32.0,91.0,18.0,198,01,01,  Paschim Chandipur,1867,1884,1010,849,857,1035,49.8,54.3,45.3,00000
32.0,91.0,18.0,198,02,01,  Purba Chandipur,1983,2661,1088,1224,895,1437,42.7,47.1,38.4,00000
32.0,91.0,18.0,850,01,01,  Uttar Sicha,1319,2600,703,1215,616,1385,33.7,36.7,30.8,00000
32.0,91.0,18.0,850,02,01,  Dakshin Sicha,2060,4314,1127,2069,933,2245,32.3,35.3,29.4,00000
32.0,91.0,18.0,850,03,01,  Nutan Sicha,104,426,54,195,50,231,19.6,21.7,17.8,00000
32.0,91.0,18.0,949,01,01,  Paschim Bochagari,371,696,211,321,160,375,34.8,39.7,29.9,00000
32.0,91.0,18.0,949,02,01,  Kamarer Bhita,555,1571,305,756,250,815,26.1,28.7,23.5,00000
32.0,91.0,18.0,949,03,01,  Purba Bochagari,1562,2474,853,1107,709,1367,38.7,43.5,34.2,00000
32.0,91.0,18.0,949,04,01,  Uzan Bochagari,163,165,89,76,74,89,49.7,53.9,45.4,00000
32.0,91.0,25.0,262,01,01,  Sonalayer Para,408,331,211,152,197,179,55.2,58.1,52.4,00000
32.0,91.0,25.0,262,02,01,  Bamanir Para,609,1518,335,686,274,832,28.6,32.8,24.8,00000
32.0,91.0,25.0,262,03,01,  Kakeytori,601,955,331,397,270,558,38.6,45.5,32.6,00000
32.0,91.0,25.0,262,04,01,  Dapachila,957,1406,504,602,453,804,40.5,45.6,36.0,00000
32.0,91.0,25.0,262,05,01,  Chhayani,644,674,347,293,297,381,48.9,54.2,43.8,00000
32.0,91.0,25.0,262,06,01,  Baganerghat,242,935,139,443,103,492,20.6,23.9,17.3,00000
32.0,91.0,25.0,488,01,01,  Purba Khamar,492,1051,255,468,237,583,31.9,35.3,28.9,00000
32.0,91.0,25.0,488,02,01,  Paschim Khamar,558,1297,301,608,257,689,30.1,33.1,27.2,00000
32.0,91.0,25.0,714,01,01,  Takimari,440,300,220,113,220,187,59.5,66.1,54.1,00000
32.0,91.0,25.0,714,02,01,  Duramari,376,324,195,129,181,195,53.7,60.2,48.1,00000
32.0,91.0,25.0,714,03,01,  Kustari,798,1010,415,463,383,547,44.1,47.3,41.2,00000
32.0,91.0,25.0,714,04,01,  Khan Para,917,1154,478,493,439,661,44.3,49.2,39.9,00000
32.0,91.0,25.0,714,05,01,  Haudar Bhita,253,480,131,220,122,260,34.5,37.3,31.9,00000
32.0,91.0,25.0,750,01,01,  Katalerghat,345,576,188,271,157,305,37.5,41.0,34.0,00000
32.0,91.0,25.0,750,02,01,  Chartari,1003,1987,515,899,488,1088,33.5,36.4,31.0,00000
32.0,91.0,25.0,750,03,01,  Maulvi Para,542,690,261,347,281,343,44.0,42.9,45.0,00000
32.0,91.0,25.0,985,01,01,  Dupnitari,719,1393,401,630,318,763,34.0,38.9,29.4,00000
32.0,91.0,25.0,985,02,01,  Majhi Para,339,933,178,450,161,483,26.7,28.3,25.0,00000
32.0,91.0,25.0,985,03,01,  Uttar Maruadaha,801,1991,424,890,377,1101,28.7,32.3,25.5,00000
32.0,91.0,37.0,768,01,01,  Dakshin Rajibpur,885,1152,447,512,438,640,43.4,46.6,40.6,00000
32.0,91.0,37.0,768,02,01,  Uttar Rajibpur,851,2037,459,916,392,1121,29.5,33.4,25.9,00000
32.0,91.0,37.0,768,03,01,  Paschim Rajibpur,668,781,350,358,318,423,46.1,49.4,42.9,00000
32.0,91.0,44.0,217,01,01,  Char Choritabari,502,1331,258,619,244,712,27.4,29.4,25.5,00000
32.0,91.0,44.0,217,02,01,  Kani Choritabari,716,1929,382,917,334,1012,27.1,29.4,24.8,00000
32.0,91.0,56.0,551,01,01,  Purba Lalchamar,141,756,78,380,63,376,15.7,17.0,14.4,00000
32.0,91.0,56.0,551,02,01,  Paschim Lalchamar,668,2027,330,990,338,1037,24.8,25.0,24.6,00000
32.0,91.0,63.0,081,01,01,  Fakir Para,404,623,216,279,188,344,39.3,43.6,35.3,00000
32.0,91.0,63.0,081,02,01,  Bhatia Para,246,456,132,202,114,254,35.0,39.5,31.0,00000
32.0,91.0,63.0,081,03,01,  Digtari,391,707,200,309,191,398,35.6,39.3,32.4,00000
32.0,91.0,63.0,081,04,01,  Kamargari,220,376,115,181,105,195,36.9,38.9,35.0,00000
32.0,91.0,63.0,081,05,01,  Dakshintari,135,256,66,118,69,138,34.5,35.9,33.3,00000
32.0,91.0,63.0,117,01,01,  Majhi Para,42,207,26,104,16,103,16.9,20.0,13.4,00000
32.0,91.0,63.0,117,02,01,  Kamar Para,223,342,112,153,111,189,39.5,42.3,37.0,00000
32.0,91.0,63.0,461,01,01,  Kasadaha Fakir Para,300,514,155,241,145,273,36.9,39.1,34.7,00000
32.0,91.0,63.0,461,02,01,  Miha Para,141,245,68,112,73,133,36.5,37.8,35.4,00000
32.0,91.0,63.0,461,03,01,  Madha Para,311,360,150,158,161,202,46.3,48.7,44.4,00000
32.0,91.0,63.0,461,04,01,  Kamar Para,289,558,141,256,148,302,34.1,35.5,32.9,00000
32.0,91.0,63.0,470,01,01,  Gourangertari,67,245,34,115,33,130,21.5,22.8,20.2,00000
32.0,91.0,63.0,470,02,01,  Hasrar Bhita,98,289,45,144,53,145,25.3,23.8,26.8,00000
32.0,91.0,63.0,470,03,01,  Bamnirpar,149,256,71,132,78,124,36.8,35.0,38.6,00000
32.0,91.0,63.0,470,04,01,  Sarkargaram,335,539,170,239,165,300,38.3,41.6,35.5,00000
32.0,91.0,63.0,470,05,01,  Kurerpar,439,722,233,320,206,402,37.8,42.1,33.9,00000
32.0,91.0,63.0,651,01,01,  Pakertari,195,540,108,256,87,284,26.5,29.7,23.5,00000
32.0,91.0,63.0,651,02,01,  Banakhar Bhita,242,187,135,82,107,105,56.4,62.2,50.5,00000
32.0,91.0,63.0,651,03,01,  Gaber Bhita,103,249,58,121,45,128,29.3,32.4,26.0,00000
32.0,91.0,63.0,651,04,01,  Kurartari,211,486,116,242,95,244,30.3,32.4,28.0,00000
32.0,91.0,63.0,651,05,01,  Naya Para,282,455,139,226,143,229,38.3,38.1,38.4,00000
32.0,91.0,63.0,795,01,01,  Saha Para,200,488,112,225,88,263,29.1,33.2,25.1,00000
32.0,91.0,63.0,795,02,01,  Kuti Para,134,426,69,200,65,226,23.9,25.7,22.3,00000
32.0,91.0,63.0,795,03,01,  Beparipara,300,334,140,153,160,181,47.3,47.8,46.9,00000
32.0,91.0,63.0,795,04,01,  Behara Para,264,462,119,196,145,266,36.4,37.8,35.3,00000
32.0,91.0,63.0,795,05,01,  Majhi Para,516,1235,278,567,238,668,29.5,32.9,26.3,00000
32.0,91.0,63.0,795,06,01,  Sikarmari Para,357,957,173,463,184,494,27.2,27.2,27.1,00000
32.0,91.0,63.0,868,01,01,  Handardoba,245,520,130,240,115,280,32.0,35.1,29.1,00000
32.0,91.0,63.0,868,02,01,  Kussha Para,466,543,240,242,226,301,46.2,49.8,42.9,00000
32.0,91.0,63.0,868,03,01,  Purbo Para,223,322,113,156,110,166,40.9,42.0,39.9,00000
32.0,91.0,69.0,479,01,01,  Charerkuti,362,489,202,227,160,262,42.5,47.1,37.9,00000
32.0,91.0,69.0,479,02,01,  Manaj Paschimpar,241,338,132,138,109,200,41.6,48.9,35.3,00000
32.0,91.0,69.0,479,03,01,  Pastari/Kathaler Ghat,306,419,157,178,149,241,42.2,46.9,38.2,00000
32.0,91.0,69.0,479,04,01,  Majumdar Para,235,449,124,222,111,227,34.4,35.8,32.8,00000
32.0,91.0,69.0,479,05,01,  Hindu Para,115,228,62,103,53,125,33.5,37.6,29.8,00000
32.0,91.0,69.0,479,06,01,  Khamar Dvmnipramanik Para,387,356,203,158,184,198,52.1,56.2,48.2,00000
32.0,91.0,69.0,687,01,01,  Akandapara,301,330,161,148,140,182,47.7,52.1,43.5,00000
32.0,91.0,69.0,687,02,01,  Mollah Para,363,610,190,269,173,341,37.3,41.4,33.7,00000
32.0,91.0,69.0,687,03,01,  Majhi Para,39,282,21,138,18,144,12.1,13.2,11.1,00000
32.0,91.0,69.0,687,04,01,  Dandhani Para,264,409,127,190,137,219,39.2,40.1,38.5,00000
32.0,91.0,69.0,687,05,01,  Teli Para,339,294,166,121,173,173,53.6,57.8,50.0,00000
32.0,91.0,69.0,687,06,01,  Hajir Gram/Master Para,524,984,276,455,248,529,34.7,37.8,31.9,00000
32.0,91.0,69.0,687,07,01,  Kuti Para,248,751,125,349,123,402,24.8,26.4,23.4,00000
32.0,91.0,69.0,687,08,01,  Bepari Para,376,352,199,158,177,194,51.6,55.7,47.7,00000
32.0,91.0,69.0,687,09,01,  Sarker Para,202,180,100,83,102,97,52.9,54.6,51.3,00000
32.0,91.0,69.0,705,01,01,  Khatia Galai,753,689,368,283,385,406,52.2,56.5,48.7,00000
32.0,91.0,69.0,705,02,01,  Kuti Para,205,117,112,43,93,74,63.7,72.3,55.7,00000
32.0,91.0,69.0,705,03,01,  Paschimpara,803,1176,428,524,375,652,40.6,45.0,36.5,00000
32.0,91.0,69.0,705,04,01,  Mahishbandi,343,553,181,234,162,319,38.3,43.6,33.7,00000
32.0,91.0,69.0,705,05,01,  Bindabari,401,591,223,273,178,318,40.4,45.0,35.9,00000
32.0,91.0,69.0,705,06,01,  Bhatia Para,603,943,330,403,273,540,39.0,45.0,33.6,00000
32.0,91.0,69.0,814,01,01,  Jhagrar Char,785,576,427,253,358,323,57.7,62.8,52.6,00000
32.0,91.0,69.0,814,02,01,  Ruherbata,473,435,252,177,221,258,52.1,58.7,46.1,00000
32.0,91.0,69.0,814,03,01,  Shashi Babur Para,135,220,63,101,72,119,38.0,38.4,37.7,00000
32.0,91.0,69.0,814,04,01,  Akanda Para,608,600,333,273,275,327,50.3,55.0,45.7,00000
32.0,91.0,69.0,814,05,01,  Baganchali,135,212,75,102,60,110,38.9,42.4,35.3,00000
32.0,91.0,69.0,814,06,01,  Nururtari,745,469,403,202,342,267,61.4,66.6,56.2,00000
32.0,91.0,69.0,814,07,01,  Kaliar Chhira,533,779,296,354,237,425,40.6,45.5,35.8,00000
32.0,91.0,69.0,814,08,01,  Master Para,219,143,109,61,110,82,60.5,64.1,57.3,00000
32.0,91.0,69.0,814,09,01,  Fakir Para,353,357,189,151,164,206,49.7,55.6,44.3,00000
32.0,91.0,69.0,814,10,01,  Napit Para,323,318,180,138,143,180,50.4,56.6,44.3,00000
32.0,91.0,69.0,814,11,01,  Khudiram Para,449,506,269,221,180,285,47.0,54.9,38.7,00000
32.0,91.0,75.0,018,01,01,  Paschim Bachh Hati,1209,1468,671,670,538,798,45.2,50.0,40.3,00000
32.0,91.0,75.0,018,02,01,  Purba Bachh Hati,1386,1664,760,691,626,973,45.4,52.4,39.1,00000
32.0,91.0,75.0,904,01,01,  Uttar Rambhadra,1514,1453,821,647,693,806,51.0,55.9,46.2,00000
32.0,91.0,75.0,904,02,01,  Dakshin Rambhadra,1011,1683,520,788,491,895,37.5,39.8,35.4,00000
32.0,91.0,75.0,922,01,01,  Uttar Sahabaj,1119,2174,584,1051,535,1123,34.0,35.7,32.3,00000
32.0,91.0,75.0,922,02,01,  Madhya Sahabaj,709,1421,377,656,332,765,33.3,36.5,30.3,00000
32.0,91.0,75.0,922,03,01,  Dakshin Sahabaj,1081,1578,550,706,531,872,40.7,43.8,37.8,00000
73.0,45.0,43.0,326,01,01,  Garagram,2567,2851,1380,1330,1187,1521,47.4,50.9,43.8,00000
73.0,45.0,43.0,326,02,01,  Khamar Garagram,1756,1860,956,852,800,1008,48.6,52.9,44.2,00000
73.0,45.0,51.0,824,01,01,  Uttar Rajib,1199,2000,667,911,532,1089,37.5,42.3,32.8,00000
73.0,45.0,51.0,824,02,01,  Madhya Rajib,736,1804,392,870,344,934,29.0,31.1,26.9,00000
73.0,45.0,51.0,824,03,01,  Dakshin Rajib,875,1610,433,754,442,856,35.2,36.5,34.1,00000
73.0,64.0,50.0,646,01,01,  Uttar Kunda Pukur,561,630,306,247,255,383,47.1,55.3,40.0,00000
73.0,64.0,50.0,646,02,01,  Dakshin Kunda Pukur,812,1027,404,499,408,528,44.2,44.7,43.6,00000
73.0,64.0,75.0,805,01,01,  Purba Ramnagar,890,1171,485,536,405,635,43.2,47.5,38.9,00000
73.0,64.0,75.0,805,02,01,  Paschim Ramnagar,1573,2194,902,991,671,1203,41.8,47.6,35.8,00000
73.0,64.0,75.0,805,03,01,  Dakshin Ramnagar,398,586,213,285,185,301,40.4,42.8,38.1,00000
94.0,51.0,27.0,955,01,01,  Tantihat,163,309,88,148,75,161,34.5,37.3,31.8,00000
94.0,51.0,27.0,955,02,01,  Chandipur,19,27,8,14,11,13,41.3,36.4,45.8,00000
94.0,94.0,26.0,605,01,01,  Kismat Keshurbari,1600,1127,859,502,741,625,58.7,63.1,54.2,00000
94.0,94.0,26.0,605,02,01,  Keshurbari,758,840,460,346,298,494,47.4,57.1,37.6,00000
94.0,94.0,52.0,805,01,03,  Madhyam Parpugi,1100,1271,594,607,506,664,46.4,49.5,43.2,00000
94.0,94.0,52.0,805,02,03,  Purba Parpugi,1449,952,771,422,678,530,60.3,64.6,56.1,00000
94.0,94.0,52.0,805,03,03,  Dakshinpurba Parpugi,1320,1087,714,471,606,616,54.8,60.3,49.6,00000
94.0,94.0,63.0,779,01,01,  Purba Nargun,2276,1650,1191,754,1085,896,58.0,61.2,54.8,00000
94.0,94.0,63.0,779,02,01,  Paschim Nargun,769,640,408,310,361,330,54.6,56.8,52.2,00000
27.0,10.0,35.0,133,01,01,  Bijul,479,311,292,141,187,170,60.6,67.4,52.4,00000
27.0,10.0,35.0,133,02,01,  Magura Para,363,654,168,326,195,328,35.7,34.0,37.3,00000
27.0,10.0,35.0,133,03,01,  Kanchigari,457,515,258,234,199,281,47.0,52.4,41.5,00000
27.0,10.0,35.0,133,04,01,  Jangal,343,358,178,169,165,189,48.9,51.3,46.6,00000
27.0,10.0,35.0,133,05,01,  Bamnahar,216,247,115,130,101,117,46.7,46.9,46.3,00000
27.0,10.0,35.0,168,01,01,  Domabaga,88,121,44,56,44,65,42.1,44.0,40.4,00000
27.0,10.0,35.0,168,02,01,  Naliar Para,166,290,81,145,85,145,36.4,35.8,37.0,00000
27.0,10.0,35.0,366,01,01,  Deor,794,894,423,412,371,482,47.0,50.7,43.5,00000
27.0,10.0,35.0,366,02,01,  Belkhur,691,353,377,148,314,205,66.2,71.8,60.5,00000
27.0,10.0,35.0,366,03,01,  Soulahar,328,211,181,95,147,116,60.9,65.6,55.9,00000
27.0,10.0,35.0,529,01,01,  Kanazgari,125,22,68,9,57,13,85.0,88.3,81.4,00000
27.0,10.0,35.0,529,02,01,  Kuchiamuri,256,386,137,184,119,202,39.9,42.7,37.1,00000
27.0,10.0,59.0,343,01,01,  Uttar Daudpur,812,956,420,470,392,486,45.9,47.2,44.6,00000
27.0,10.0,59.0,343,02,01,  Dakshin Daudpur,937,799,527,375,410,424,54.0,58.4,49.2,00000
27.0,10.0,59.0,558,01,01,  Uttar Katla,354,417,183,192,171,225,45.9,48.8,43.2,00000
27.0,10.0,59.0,558,02,01,  Dakshin Katla,909,855,479,410,430,445,51.5,53.9,49.1,00000
27.0,10.0,71.0,261,01,01,  Charaibhita,202,225,125,116,77,109,47.3,51.9,41.4,00000
27.0,10.0,71.0,261,02,01,  Khoshalpur,117,229,62,117,55,112,33.8,34.6,32.9,00000
27.0,10.0,71.0,261,03,01,  Khanpur,367,343,185,159,182,184,51.7,53.8,49.7,00000
27.0,10.0,71.0,331,01,01,  Barakona,325,382,184,178,141,204,46.0,50.8,40.9,00000
27.0,10.0,71.0,331,02,01,  Poragram,248,363,130,182,118,181,40.6,41.7,39.5,00000
27.0,10.0,71.0,331,03,01,  Changmari,187,294,95,148,92,146,38.9,39.1,38.7,00000
27.0,10.0,71.0,331,04,01,  Dakshin Sahabazpur,373,609,184,308,189,301,38.0,37.4,38.6,00000
27.0,10.0,71.0,389,01,01,  Dhanjuri Kalisahar,536,120,297,37,239,83,81.7,88.9,74.2,00000
27.0,10.0,71.0,389,02,01,  Netasan,165,304,101,138,64,166,35.2,42.3,27.8,00000
27.0,10.0,71.0,389,03,01,  Dighalchand,234,269,125,107,109,162,46.5,53.9,40.2,00000
27.0,10.0,71.0,389,04,01,  Ratanpur Kalisahar,315,248,172,114,143,134,56.0,60.1,51.6,00000
27.0,10.0,71.0,389,05,01,  Pran Nathpur,153,433,69,219,84,214,26.1,24.0,28.2,00000
27.0,10.0,71.0,389,06,01,  Ratanpur,551,442,297,203,254,239,55.5,59.4,51.5,00000
27.0,10.0,71.0,389,07,01,  Dhakan Dah,166,127,84,52,82,75,56.7,61.8,52.2,00000
27.0,10.0,71.0,634,01,01,  Kursakhali,306,387,149,200,157,187,44.2,42.7,45.6,00000
27.0,10.0,71.0,634,02,01,  Buchki,180,177,98,88,82,89,50.4,52.7,48.0,00000
27.0,10.0,71.0,820,01,01,  Prayagpur,168,166,85,83,83,83,50.3,50.6,50.0,00000
27.0,10.0,71.0,820,02,01,  Natkumari Sonajuri,482,427,252,212,230,215,53.0,54.3,51.7,00000
27.0,10.0,71.0,820,03,01,  Patnichand,134,340,65,181,69,159,28.3,26.4,30.3,00000
27.0,10.0,71.0,820,04,01,  Uttar Ratanpur,315,428,185,209,130,219,42.4,47.0,37.2,00000
27.0,10.0,83.0,762,01,03,  Pali Prayagpur,494,368,271,164,223,204,57.3,62.3,52.2,00000
27.0,10.0,83.0,762,02,03,  Khayar Para,194,187,100,81,94,106,50.9,55.2,47.0,00000
27.0,12.0,94.0,681,01,01,  Makari (Part),103,233,49,122,54,111,30.7,28.7,32.7,00000
27.0,12.0,94.0,681,02,01,  Kamarpur(Part),781,1117,425,527,356,590,41.1,44.6,37.6,00000
27.0,21.0,67.0,842,01,01,  Ruhigaon,672,499,375,200,297,299,57.4,65.2,49.8,00000
27.0,21.0,67.0,842,02,01,  Chhota Sultanpur,948,716,489,325,459,391,57.0,60.1,54.0,00000
27.0,21.0,67.0,842,03,01,  Mourialla,975,726,528,312,447,414,57.3,62.9,51.9,00000
27.0,38.0,25.0,811,01,01,  Rangamati,1336,799,666,390,670,409,62.6,63.1,62.1,00000
27.0,38.0,25.0,811,02,01,  Rangamati B.D.R Cantonment,293,14,216,11,77,3,95.4,95.2,96.3,00000
27.0,43.0,57.0,216,01,01,  Bshainathpur,596,324,330,138,266,186,64.8,70.5,58.8,00000
27.0,43.0,57.0,216,02,01,  Dampara,235,245,120,117,115,128,49.0,50.6,47.3,00000
27.0,47.0,13.0,024,01,01,  Alihat,223,238,118,119,105,119,48.4,49.8,46.9,00000
27.0,47.0,13.0,024,02,01,  Kashiadanga,179,273,91,146,88,127,39.6,38.4,40.9,00000
27.0,47.0,13.0,024,03,01,  Arji Para,114,275,64,139,50,136,29.3,31.5,26.9,00000
27.0,47.0,13.0,090,01,01,  Baona,250,186,139,79,111,107,57.3,63.8,50.9,00000
27.0,47.0,13.0,090,02,01,  Maheshpur,175,226,99,103,76,123,43.6,49.0,38.2,00000
27.0,47.0,13.0,090,03,01,  Chakchaka,260,317,145,135,115,182,45.1,51.8,38.7,00000
27.0,47.0,13.0,090,04,01,  Chakerpara,183,210,96,108,87,102,46.6,47.1,46.0,00000
27.0,47.0,40.0,049,01,01,  Bagdor,294,212,163,97,131,115,58.1,62.7,53.3,00000
27.0,47.0,40.0,049,02,01,  Khatiachara,123,136,66,64,57,72,47.5,50.8,44.2,00000
27.0,47.0,40.0,049,03,01,  Mokhuria,116,123,56,51,60,72,48.5,52.3,45.5,00000
27.0,47.0,40.0,106,01,01,  Bara Chenggram,205,105,112,44,93,61,66.1,71.8,60.4,00000
27.0,47.0,40.0,106,02,01,  Naonapara,215,234,113,110,102,124,47.9,50.7,45.1,00000
27.0,47.0,40.0,197,01,01,  Daskhin Boaldar,632,539,324,248,308,291,54.0,56.6,51.4,00000
27.0,47.0,40.0,197,02,01,  Uttar Boaldar,458,691,245,319,213,372,39.9,43.4,36.4,00000
27.0,47.0,40.0,197,03,01,  Sorangagari,396,495,192,229,204,266,44.4,45.6,43.4,00000
27.0,47.0,40.0,550,01,01,  Kandarpapur,156,290,79,133,77,157,35.0,37.3,32.9,00000
27.0,47.0,40.0,550,02,01,  Kristapur,99,146,62,72,37,74,40.4,46.3,33.3,00000
27.0,47.0,40.0,912,01,01,  Naya Para,568,674,289,323,279,351,45.7,47.2,44.3,00000
27.0,47.0,40.0,912,02,01,  Roybhag,161,148,80,71,81,77,52.1,53.0,51.3,00000
27.0,47.0,81.0,411,01,01,  Satkuri,875,502,481,200,394,302,63.5,70.6,56.6,00000
27.0,47.0,81.0,411,02,01,  Mangala Para,288,234,164,111,124,123,55.2,59.6,50.2,00000
27.0,47.0,81.0,411,03,01,  Mahalipara,241,88,119,34,122,54,73.3,77.8,69.3,00000
27.0,47.0,81.0,419,01,01,  Ghasuria,264,316,141,161,123,155,45.5,46.7,44.2,00000
27.0,47.0,81.0,419,02,01,  Nandipur,165,229,84,114,81,115,41.9,42.4,41.3,00000
27.0,47.0,81.0,419,03,01,  Roybagh,146,182,77,85,69,97,44.5,47.5,41.6,00000
27.0,47.0,81.0,435,01,01,  Gobindapur,171,105,99,43,72,62,62.0,69.7,53.7,00000
27.0,47.0,81.0,435,02,01,  Lachara,532,334,300,136,232,198,61.4,68.8,54.0,00000
27.0,47.0,81.0,435,03,01,  Debkhanda,360,213,188,103,172,110,62.8,64.6,61.0,00000
27.0,47.0,81.0,435,04,01,  Ghonashapur,336,378,182,178,154,200,47.1,50.6,43.5,00000
27.0,47.0,81.0,435,05,01,  Shal Pukuria,214,150,118,59,96,91,58.8,66.7,51.3,00000
27.0,47.0,81.0,435,06,01,  Chak Birban,112,82,61,40,51,42,57.7,60.4,54.8,00000
27.0,47.0,81.0,435,07,01,  Harekrishnapur,415,405,215,171,200,234,50.6,55.7,46.1,00000
27.0,47.0,81.0,583,01,01,  Khatta,412,324,220,137,192,187,56.0,61.6,50.7,00000
27.0,47.0,81.0,583,02,01,  Delu Para,108,103,65,50,43,53,51.2,56.5,44.8,00000
27.0,47.0,81.0,583,03,01,  Paush Gara,714,690,375,330,339,360,50.9,53.2,48.5,00000
27.0,47.0,81.0,583,04,01,  Danga Para,881,777,449,368,432,409,53.1,55.0,51.4,00000
27.0,47.0,81.0,649,01,01,  Madhab Para,782,690,400,324,382,366,53.1,55.2,51.1,00000
27.0,47.0,81.0,649,02,01,  Chakbhabani,218,142,115,75,103,67,60.6,60.5,60.6,00000
27.0,47.0,81.0,649,03,01,  Balupara,147,149,75,62,72,87,49.7,54.7,45.3,00000
27.0,64.0,25.0,059,01,01,  Barail,2715,2361,1502,1154,1213,1207,53.5,56.6,50.1,00000
27.0,64.0,25.0,059,02,01,  Per Baril,70,243,37,117,33,126,22.4,24.0,20.8,00000
27.0,64.0,25.0,962,01,01,  Uttar Gobindapur,1090,1253,658,607,432,646,46.5,52.0,40.1,00000
27.0,64.0,25.0,962,02,01,  Per Uffar Gobinto Pur,51,316,19,158,32,158,13.9,10.7,16.8,00000
27.0,69.0,13.0,139,01,01,  Bhaduria,863,1041,460,499,403,542,45.3,48.0,42.6,00000
27.0,69.0,13.0,139,02,01,  Bhaduria Bazar,494,386,242,184,252,202,56.1,56.8,55.5,00000
27.0,69.0,13.0,139,03,01,  Latidam,148,121,78,45,70,76,55.0,63.4,47.9,00000
27.0,69.0,13.0,731,01,01,  Kajal Dighi,96,182,60,81,36,101,34.5,42.6,26.3,00000
27.0,69.0,13.0,731,02,01,  Nirsa,102,117,52,48,50,69,46.6,52.0,42.0,00000
27.0,69.0,13.0,751,01,01,  Pakuria,115,275,55,127,60,148,29.5,30.2,28.8,00000
27.0,69.0,13.0,751,02,01,  Halaijana,159,377,82,184,77,193,29.7,30.8,28.5,00000
27.0,69.0,13.0,886,01,01,  Salti Muradpur,777,1254,420,616,357,638,38.3,40.5,35.9,00000
27.0,69.0,13.0,886,02,01,  Putihar,212,266,115,131,97,135,44.4,46.7,41.8,00000
27.0,69.0,13.0,886,03,01,  Jurgari,89,122,52,60,37,62,42.2,46.4,37.4,00000
27.0,69.0,25.0,294,01,01,  Palpara,484,270,247,123,237,147,64.2,66.8,61.7,00000
27.0,69.0,25.0,294,02,01,  Haluaghat,406,207,203,103,203,104,66.2,66.3,66.1,00000
27.0,69.0,25.0,325,01,01,  Purba Dharanji,159,148,83,67,76,81,51.8,55.3,48.4,00000
27.0,69.0,25.0,325,02,01,  Paschim Dharanji,248,337,123,168,125,169,42.4,42.3,42.5,00000
27.0,69.0,25.0,421,01,01,  Harirampur,247,234,132,100,115,134,51.4,56.9,46.2,00000
27.0,69.0,25.0,421,02,01,  Guchca Gram,55,260,18,126,37,134,17.5,12.5,21.6,00000
27.0,69.0,25.0,437,01,01,  Purbapara,639,1003,325,478,314,525,38.9,40.5,37.4,00000
27.0,69.0,25.0,437,02,01,  Heyatpur,226,252,112,139,114,113,47.3,44.6,50.2,00000
27.0,69.0,25.0,437,03,01,  Chinir Chhara,170,309,82,154,88,155,35.5,34.7,36.2,00000
27.0,69.0,25.0,437,04,01,  Saotal Para,23,60,15,27,8,33,27.7,35.7,19.5,00000
27.0,69.0,25.0,437,05,01,  Paschimpara,397,501,206,245,191,256,44.2,45.7,42.7,00000
27.0,69.0,25.0,576,01,01,  Khayergani(Khirkini),91,220,50,114,41,106,29.3,30.5,27.9,00000
27.0,69.0,25.0,576,02,01,  Refuzi Para,305,471,153,243,152,228,39.3,38.6,40.0,00000
27.0,69.0,25.0,576,03,01,  Daspara,295,411,142,208,153,203,41.8,40.6,43.0,00000
27.0,69.0,25.0,615,01,01,  Mosalman Para,308,492,163,236,145,256,38.5,40.9,36.2,00000
27.0,69.0,25.0,615,02,01,  Panchgachhi,30,27,15,14,15,13,52.6,51.7,53.6,00000
27.0,69.0,25.0,627,01,01,  Bazar,306,57,168,22,138,35,84.3,88.4,79.8,00000
27.0,69.0,25.0,627,02,01,  Laugari,377,245,202,121,175,124,60.6,62.5,58.5,00000
27.0,69.0,25.0,650,01,01,  Paschim Para,96,137,51,66,45,71,41.2,43.6,38.8,00000
27.0,69.0,25.0,650,02,01,  Maldaha,299,336,155,159,144,177,47.1,49.4,44.9,00000
27.0,69.0,25.0,650,03,01,  Saotal Para,24,44,13,18,11,26,35.3,41.9,29.7,00000
27.0,69.0,25.0,828,01,01,  Bagchi Para,85,167,43,79,42,88,33.7,35.2,32.3,00000
27.0,69.0,25.0,828,02,01,  Madhyapara,131,245,65,133,66,112,34.8,32.8,37.1,00000
27.0,69.0,25.0,828,03,01,  Mondal Para,91,348,48,173,43,175,20.7,21.7,19.7,00000
27.0,69.0,25.0,828,04,01,  Malur Para,68,239,43,116,25,123,22.1,27.0,16.9,00000
27.0,69.0,25.0,929,01,01,  Hindu Para,61,60,38,31,23,29,50.4,55.1,44.2,00000
27.0,69.0,25.0,929,02,01,  Balua Para,136,222,82,97,54,125,38.0,45.8,30.2,00000
27.0,69.0,25.0,929,03,01,  Panchgachhi,115,136,72,63,43,73,45.8,53.3,37.1,00000
27.0,69.0,25.0,929,04,01,  Fakir Para,58,45,35,16,23,29,56.3,68.6,44.2,00000
27.0,69.0,25.0,929,05,01,  Kadira Para,88,148,49,65,39,83,37.3,43.0,32.0,00000
27.0,69.0,25.0,929,06,01,  Bhita Para,50,280,25,138,25,142,15.2,15.3,15.0,00000
27.0,69.0,25.0,983,01,01,  Muradpur,287,666,137,341,150,325,30.1,28.7,31.6,00000
27.0,69.0,25.0,983,02,01,  Purbapara,144,313,66,163,78,150,31.5,28.8,34.2,00000
27.0,69.0,25.0,983,03,01,  Dakshinpara,127,227,57,118,70,109,35.9,32.6,39.1,00000
27.0,69.0,25.0,983,04,01,  Paschim Para,104,179,44,94,60,85,36.7,31.9,41.4,00000
27.0,69.0,43.0,360,01,01,  Hazar Soula,50,71,31,32,19,39,41.3,49.2,32.8,00000
27.0,69.0,43.0,360,02,01,  Daduria,103,119,61,54,42,65,46.4,53.0,39.3,00000
27.0,69.0,43.0,360,03,01,  Fatehpur Marash,394,420,194,212,200,208,48.4,47.8,49.0,00000
27.0,69.0,43.0,464,01,03,  Jiga Kanthal,253,316,116,158,137,158,44.5,42.3,46.4,00000
27.0,69.0,43.0,464,02,03,  Nababganj,1196,352,555,161,641,191,77.3,77.5,77.0,00000
27.0,69.0,43.0,464,03,03,  Touskota,150,87,80,39,70,48,63.3,67.2,59.3,00000
27.0,69.0,43.0,654,01,01,  Mali Para-1(Uttar Para),214,281,95,139,119,142,43.2,40.6,45.6,00000
27.0,69.0,43.0,654,02,01,  Mali Para-2,94,234,49,110,45,124,28.7,30.8,26.6,00000
27.0,69.0,43.0,654,03,01,  Dadanpur,95,192,58,90,37,102,33.1,39.2,26.6,00000
27.0,69.0,43.0,785,01,01,  Naobhanga,354,258,173,122,181,136,57.8,58.6,57.1,00000
27.0,69.0,43.0,785,02,01,  Naya Para,270,139,140,67,130,72,66.0,67.6,64.4,00000
27.0,69.0,43.0,994,01,01,  Uttar Shyampur,258,186,134,86,124,100,58.1,60.9,55.4,00000
27.0,69.0,43.0,994,02,01,  Naya Para,75,175,54,69,21,106,30.0,43.9,16.5,00000
27.0,69.0,51.0,877,01,01,  Salgharia,363,605,198,295,165,310,37.5,40.2,34.7,00000
27.0,69.0,51.0,877,02,01,  Chila Para,332,64,159,27,173,37,83.8,85.5,82.4,00000
27.0,69.0,51.0,987,01,01,  Uttar Sahabazpur,653,922,318,439,335,483,41.5,42.0,41.0,00000
27.0,69.0,51.0,987,02,01,  Tepukuria,910,769,449,382,461,387,54.2,54.0,54.4,00000
27.0,69.0,51.0,987,03,01,  Amerdanga,295,439,146,225,149,214,40.2,39.4,41.0,00000
27.0,69.0,69.0,135,01,01,  Jat Bhabanipur,338,572,179,287,159,285,37.1,38.4,35.8,00000
27.0,69.0,69.0,135,02,01,  Mal Bhabanipur,453,906,247,431,206,475,33.3,36.4,30.2,00000
27.0,69.0,77.0,038,01,01,  Azampur,785,1023,434,481,351,542,43.4,47.4,39.3,00000
27.0,69.0,77.0,038,02,01,  Patua Para,45,100,29,42,16,58,31.0,40.8,21.6,00000
27.0,69.0,77.0,038,03,01,  Rameshwarpur,32,82,21,35,11,47,28.1,37.5,19.0,00000
27.0,69.0,77.0,290,01,01,  Balua,137,125,74,63,63,62,52.3,54.0,50.4,00000
27.0,69.0,77.0,290,02,01,  Daria,144,152,81,65,63,87,48.6,55.5,42.0,00000
27.0,69.0,77.0,290,03,01,  Daskhin Para,88,156,47,73,41,83,36.1,39.2,33.1,00000
27.0,69.0,77.0,398,01,01,  Paschimpara,176,264,88,133,88,131,40.0,39.8,40.2,00000
27.0,69.0,77.0,398,02,01,  Tale Para,141,225,67,96,74,129,38.5,41.1,36.5,00000
27.0,69.0,77.0,414,01,01,  Namakatan,685,831,319,389,366,442,45.2,45.1,45.3,00000
27.0,69.0,77.0,414,02,01,  Harinathpur (Rajbari),317,526,145,249,172,277,37.6,36.8,38.3,00000
27.0,69.0,77.0,429,01,01,  Maharajpur,33,110,21,52,12,58,23.1,28.8,17.1,00000
27.0,69.0,77.0,429,02,01,  Hathbhangi,126,206,65,102,61,104,38.0,38.9,37.0,00000
27.0,69.0,77.0,487,01,01,  Kabuli Para,137,290,69,144,68,146,32.1,32.4,31.8,00000
27.0,69.0,77.0,487,02,01,  Hindu Para,138,105,77,45,61,60,56.8,63.1,50.4,00000
27.0,69.0,77.0,538,01,01,  Karaibari,148,388,71,187,77,201,27.6,27.5,27.7,00000
27.0,69.0,77.0,538,02,01,  Majhi Para,132,216,70,105,62,111,37.9,40.0,35.8,00000
27.0,69.0,77.0,638,01,01,  Purbapara,124,266,63,135,61,131,31.8,31.8,31.8,00000
27.0,69.0,77.0,638,02,01,  Paschimpara,201,389,110,192,91,197,34.1,36.4,31.6,00000
27.0,69.0,77.0,662,01,01,  Daha Para,168,170,93,79,75,91,49.7,54.1,45.2,00000
27.0,69.0,77.0,662,02,01,  Maulvi Para,122,104,66,46,56,58,54.0,58.9,49.1,00000
27.0,69.0,77.0,662,03,01,  Ambagan,113,513,51,275,62,238,18.1,15.6,20.7,00000
27.0,69.0,77.0,662,04,01,  Mahmud Pur,85,223,46,110,39,113,27.6,29.5,25.7,00000
27.0,69.0,77.0,696,01,01,  Saiadpur,172,266,82,129,90,137,39.3,38.9,39.6,00000
27.0,69.0,77.0,696,02,01,  Mirzapur,588,632,327,290,261,342,48.2,53.0,43.3,00000
27.0,69.0,77.0,700,01,01,  Uttar Mogar Para,258,466,136,244,122,222,35.6,35.8,35.5,00000
27.0,69.0,77.0,700,02,01,  Nama Para,55,96,32,45,23,51,36.4,41.6,31.1,00000
27.0,69.0,77.0,704,01,01,  Naleya,210,772,96,404,114,368,21.4,19.2,23.7,00000
27.0,69.0,77.0,704,02,01,  Aklaspur,77,137,37,75,40,62,36.0,33.0,39.2,00000
27.0,69.0,77.0,956,01,01,  Patna Para,83,93,47,52,36,41,47.2,47.5,46.8,00000
27.0,69.0,77.0,956,02,01,  Denot Para,69,193,31,105,38,88,26.3,22.8,30.2,00000
27.0,69.0,77.0,956,03,01,  Bishnapur,81,187,41,97,40,90,30.2,29.7,30.8,00000
27.0,69.0,86.0,030,01,01,  Sonakani,222,307,141,155,81,152,42.0,47.6,34.8,00000
27.0,69.0,86.0,030,02,01,  Shakopara,220,301,107,151,113,150,42.2,41.5,43.0,00000
27.0,69.0,86.0,030,03,01,  Nayapara,356,475,190,206,166,269,42.8,48.0,38.2,00000
27.0,69.0,86.0,030,04,01,  Sharaipara,414,428,210,194,204,234,49.2,52.0,46.6,00000
27.0,69.0,86.0,030,05,01,  Chandipur,93,227,46,117,47,110,29.1,28.2,29.9,00000
27.0,69.0,86.0,689,01,01,  Matihara,1031,686,540,295,491,391,60.0,64.7,55.7,00000
27.0,69.0,86.0,689,02,01,  Parandighi,207,175,115,78,92,97,54.2,59.6,48.7,00000
27.0,69.0,86.0,902,01,01,  Shernagar,271,482,163,231,108,251,36.0,41.4,30.1,00000
27.0,69.0,86.0,902,02,01,  Tongi,148,154,90,61,58,93,49.0,59.6,38.4,00000
27.0,69.0,94.0,882,01,01,  Shalkhuria,649,859,345,371,304,488,43.0,48.2,38.4,00000
27.0,69.0,94.0,882,02,01,  Baniyhatpur,119,133,66,61,53,72,47.2,52.0,42.4,00000
27.0,69.0,94.0,936,01,01,  Sutar Para,200,132,110,51,90,81,60.2,68.3,52.6,00000
27.0,69.0,94.0,936,02,01,  Kasegari,238,232,132,114,106,118,50.6,53.7,47.3,00000
27.0,77.0,25.0,641,01,01,  Dakshin Marnai,626,381,322,192,304,189,62.2,62.6,61.7,00000
27.0,77.0,25.0,641,02,01,  Uttar Marnai,1492,1042,761,508,731,534,58.9,60.0,57.8,00000
27.0,77.0,25.0,907,01,01,  Purba Sherpur,450,375,225,174,225,201,54.5,56.4,52.8,00000
27.0,77.0,25.0,907,02,01,  Paschim Sherpur,1910,968,959,455,951,513,66.4,67.8,65.0,00000
27.0,77.0,34.0,054,01,01,  Baidyanathpur,472,556,236,262,236,294,45.9,47.4,44.5,00000
27.0,77.0,34.0,054,02,01,  Gigagari,331,236,179,107,152,129,58.4,62.6,54.1,00000
27.0,77.0,34.0,201,01,01,  Uttar Chauhati,356,345,168,168,188,177,50.8,50.0,51.5,00000
27.0,77.0,34.0,201,02,01,  Dakshin Chauhati,537,282,303,128,234,154,65.6,70.3,60.3,00000
27.0,77.0,34.0,271,01,01,  Sithi Daldalia,210,172,104,86,106,86,55.0,54.7,55.2,00000
27.0,77.0,34.0,271,02,01,  Daldalia,342,159,174,72,168,87,68.3,70.7,65.9,00000
27.0,77.0,34.0,505,01,01,  Bala Para,83,300,42,147,41,153,21.7,22.2,21.1,00000
27.0,77.0,34.0,505,02,01,  Mollah Para,297,79,152,38,145,41,79.0,80.0,78.0,00000
27.0,77.0,34.0,505,03,01,  Thakur Para,298,329,155,166,143,163,47.5,48.3,46.7,00000
27.0,77.0,34.0,505,04,01,  Bhatia Para,78,326,38,171,40,155,19.3,18.2,20.5,00000
27.0,77.0,34.0,505,05,01,  Kortoa Para,101,162,49,77,52,85,38.4,38.9,38.0,00000
27.0,77.0,34.0,505,06,01,  Pukur Para,152,342,76,175,76,167,30.8,30.3,31.3,00000
27.0,77.0,34.0,505,07,01,  Sardar Para,878,1104,461,564,417,540,44.3,45.0,43.6,00000
27.0,77.0,34.0,755,01,01,  Danga Para,214,237,119,107,95,130,47.5,52.7,42.2,00000
27.0,77.0,34.0,755,02,01,  Mollah Para,186,230,92,94,94,136,44.7,49.5,40.9,00000
27.0,77.0,34.0,755,03,01,  Dighaltari,244,304,131,133,113,171,44.5,49.6,39.8,00000
27.0,77.0,34.0,755,04,01,  Darji Para,213,261,113,119,100,142,44.9,48.7,41.3,00000
27.0,77.0,34.0,793,01,01,  Ghughumari,272,141,145,51,127,90,65.9,74.0,58.5,00000
27.0,77.0,34.0,793,02,01,  Purbapara,344,538,168,268,176,270,39.0,38.5,39.5,00000
27.0,77.0,34.0,793,03,01,  Balerdanga,88,164,41,74,47,90,34.9,35.7,34.3,00000
27.0,77.0,34.0,793,04,01,  Choor Dang,250,444,117,218,133,226,36.0,34.9,37.0,00000
27.0,77.0,34.0,793,05,01,  Refujee Para,135,266,64,125,71,141,33.7,33.9,33.5,00000
27.0,77.0,34.0,793,06,01,  Gumma Para,110,285,56,134,54,151,27.8,29.5,26.3,00000
27.0,77.0,34.0,793,07,01,  Natirdanga,100,173,42,86,58,87,36.6,32.8,40.0,00000
27.0,77.0,34.0,799,01,01,  Purba Sultanpur,270,159,152,71,118,88,62.9,68.2,57.3,00000
27.0,77.0,34.0,799,02,01,  Karatoya Para,142,177,93,88,49,89,44.5,51.4,35.5,00000
27.0,77.0,43.0,250,01,01,  Dakshin Harirampur,1283,2606,676,1266,607,1340,33.0,34.8,31.2,00000
27.0,77.0,43.0,250,02,01,  Gucchhagram,55,255,37,122,18,133,17.7,23.3,11.9,00000
27.0,77.0,77.0,038,01,01,  Atrai,454,362,231,174,223,188,55.6,57.0,54.3,00000
27.0,77.0,77.0,038,02,01,  Madhya Atrai,404,414,210,195,194,219,49.4,51.9,47.0,00000
27.0,77.0,77.0,038,03,01,  Dakshin Atrai,377,574,196,277,181,297,39.6,41.4,37.9,00000
27.0,77.0,77.0,146,01,01,  Chak Musha,457,237,237,91,220,146,65.9,72.3,60.1,00000
27.0,77.0,77.0,146,02,01,  Hindu Para,484,308,242,151,242,157,61.1,61.6,60.7,00000
27.0,77.0,77.0,146,03,01,  Hadir Para,381,117,204,47,177,70,76.5,81.3,71.7,00000
27.0,77.0,77.0,146,04,01,  Pramanik Para,392,54,202,30,190,24,87.9,87.1,88.8,00000
27.0,77.0,77.0,146,05,01,  Koyal Para,246,133,132,68,114,65,64.9,66.0,63.7,00000
27.0,77.0,77.0,288,01,01,  Dargah Para,647,810,331,359,316,451,44.4,48.0,41.2,00000
27.0,77.0,77.0,288,02,01,  Chanda Para,224,235,124,113,100,122,48.8,52.3,45.0,00000
27.0,77.0,77.0,288,03,01,  Nedu Sahar Para,173,247,92,130,81,117,41.2,41.4,40.9,00000
27.0,77.0,77.0,288,04,01,  Kazi Para,306,269,157,123,149,146,53.2,56.1,50.5,00000
27.0,77.0,77.0,288,05,01,  Chhota Kalai Gate,181,219,94,116,87,103,45.3,44.8,45.8,00000
27.0,77.0,77.0,288,06,01,  Bara Kalai Gate,207,221,119,106,88,115,48.4,52.9,43.3,00000
27.0,77.0,77.0,288,07,01,  Niada Para,480,342,261,153,219,189,58.4,63.0,53.7,00000
27.0,77.0,77.0,288,08,01,  Mandal Para,611,488,326,238,285,250,55.6,57.8,53.3,00000
27.0,77.0,77.0,315,01,01,  Uttar Dhopakhal,5716,2449,2912,1104,2804,1345,70.0,72.5,67.6,00000
27.0,77.0,77.0,315,02,01,  Dakshin Dhopakhal,426,484,228,228,198,256,46.8,50.0,43.6,00000
27.0,77.0,77.0,315,03,01,  Sahid Mahabub Army Cantonmen,2447,115,2050,45,397,70,95.5,97.9,85.0,00000
27.0,77.0,77.0,478,01,01,  Uttar Kalikapur,957,1117,509,532,448,585,46.1,48.9,43.4,00000
27.0,77.0,77.0,478,02,01,  Dakshin Kalikapur,1040,1459,512,695,528,764,41.6,42.4,40.9,00000
27.0,77.0,86.0,130,01,01,  Bashu Para,1633,1094,875,479,758,615,59.9,64.6,55.2,00000
27.0,77.0,86.0,130,02,01,  Batgachh,438,297,233,142,205,155,59.6,62.1,56.9,00000
27.0,77.0,86.0,130,03,01,  Badia Para,106,199,48,96,58,103,34.8,33.3,36.0,00000
27.0,77.0,86.0,130,04,01,  Mirpara,291,118,143,53,148,65,71.1,73.0,69.5,00000
27.0,77.0,86.0,130,05,01,  Bara Britta Para,352,309,180,152,172,157,53.3,54.2,52.3,00000
27.0,77.0,86.0,130,06,01,  Chhota Britta Para,210,110,109,46,101,64,65.6,70.3,61.2,00000
27.0,77.0,86.0,146,01,01,  Chhygharia,243,289,136,134,107,155,45.7,50.4,40.8,00000
27.0,77.0,86.0,146,02,01,  Ghona Para,153,85,83,32,70,53,64.3,72.2,56.9,00000
27.0,77.0,86.0,511,01,01,  Sundari Para,257,292,134,134,123,158,46.8,50.0,43.8,00000
27.0,77.0,86.0,511,02,01,  Dangapara,462,144,229,51,233,93,76.2,81.8,71.5,00000
27.0,77.0,86.0,511,03,01,  Dakshin Mondal Para,249,126,133,54,116,72,66.4,71.1,61.7,00000
27.0,77.0,86.0,717,01,01,  Sarkar Para,989,590,527,268,462,322,62.6,66.3,58.9,00000
27.0,77.0,86.0,717,02,01,  Telipatti,757,148,401,62,356,86,83.6,86.6,80.5,00000
27.0,77.0,86.0,821,01,01,  Paik Para,242,149,127,84,115,65,61.9,60.2,63.9,00000
27.0,77.0,86.0,821,02,01,  Paramanik Para,456,402,252,179,204,223,53.1,58.5,47.8,00000
27.0,77.0,86.0,821,03,01,  Danga Para-1,195,104,103,44,92,60,65.2,70.1,60.5,00000
27.0,77.0,86.0,821,04,01,  Purba Kumar Para,240,168,134,80,106,88,58.8,62.6,54.6,00000
27.0,77.0,86.0,821,05,01,  Madhyapara,123,243,58,108,65,135,33.6,34.9,32.5,00000
27.0,77.0,86.0,821,06,01,  Sardar Para,80,195,38,103,42,92,29.1,27.0,31.3,00000
27.0,77.0,86.0,821,07,01,  Danga Para-2,91,117,50,55,41,62,43.8,47.6,39.8,00000
27.0,77.0,86.0,821,08,01,  Ghat Para,72,50,33,25,39,25,59.0,56.9,60.9,00000
27.0,77.0,86.0,821,09,01,  Pandit Para,155,84,96,39,59,45,64.9,71.1,56.7,00000
27.0,77.0,86.0,821,10,01,  Bania Para,83,29,50,10,33,19,74.1,83.3,63.5,00000
27.0,77.0,86.0,821,11,01,  Naya Para,279,370,135,174,144,196,43.0,43.7,42.4,00000
27.0,77.0,86.0,821,12,01,  Gararpar,288,315,153,141,135,174,47.8,52.0,43.7,00000
27.0,77.0,86.0,821,13,01,  Chayanpara,231,337,113,153,118,184,40.7,42.5,39.1,00000
27.0,77.0,86.0,821,14,01,  Fakir Para,273,217,137,98,136,119,55.7,58.3,53.3,00000
27.0,77.0,86.0,821,15,01,  Dola Para,315,299,176,131,139,168,51.3,57.3,45.3,00000
27.0,77.0,86.0,821,16,01,  Teli Para,146,254,72,114,74,140,36.5,38.7,34.6,00000
27.0,77.0,86.0,821,17,01,  Simlia Para,445,204,210,84,235,120,68.6,71.4,66.2,00000
27.0,77.0,86.0,821,19,01,  Biswas Para,40,35,22,13,18,22,53.3,62.9,45.0,00000
27.0,77.0,86.0,853,01,03,  Rampur Taltala,538,231,267,101,271,130,70.0,72.6,67.6,00000
27.0,77.0,86.0,853,02,03,  Babu Para,200,111,115,45,85,66,64.3,71.9,56.3,00000
27.0,77.0,86.0,853,03,03,  Machhua Para,79,139,32,69,47,70,36.2,31.7,40.2,00000
27.0,77.0,86.0,853,04,03,  Darikhamar,811,683,442,349,369,334,54.3,55.9,52.5,00000
27.0,77.0,86.0,853,05,03,  Purba Hugli Para,731,674,389,324,342,350,52.0,54.6,49.4,00000
27.0,77.0,86.0,853,06,03,  Paschim Huglipara,922,388,491,164,431,224,70.4,75.0,65.8,00000
27.0,77.0,86.0,853,07,03,  Chaindair Danga,148,65,81,26,67,39,69.5,75.7,63.2,00000
27.0,77.0,86.0,853,08,03,  Mandal Para,564,278,307,131,257,147,67.0,70.1,63.6,00000
27.0,77.0,86.0,853,09,03,  Rampur,1360,1272,735,583,625,689,51.7,55.8,47.6,00000
27.0,77.0,86.0,929,01,01,  Dhudar Para,240,198,126,86,114,112,54.8,59.4,50.4,00000
27.0,77.0,86.0,929,02,01,  Khen Para,95,52,54,25,41,27,64.6,68.4,60.3,00000
27.0,77.0,86.0,929,03,01,  Kazi Para,1190,280,617,112,573,168,81.0,84.6,77.3,00000
27.0,77.0,86.0,929,04,01,  Lakshmanpur,860,417,443,183,417,234,67.3,70.8,64.1,00000
27.0,77.0,86.0,929,05,01,  Badia Para,80,62,38,28,42,34,56.3,57.6,55.3,00000
27.0,77.0,86.0,929,06,01,  Takia Para,578,373,295,169,283,204,60.8,63.6,58.1,00000
10.0,6.0,13.0,685,01,01,  Muradpur,204,190,109,83,95,107,51.8,56.8,47.0,00000
10.0,6.0,13.0,685,02,01,  Haludghar,203,265,101,123,102,142,43.4,45.1,41.8,00000
10.0,6.0,27.0,017,01,01,  Arail,369,686,202,316,167,370,35.0,39.0,31.1,00000
10.0,6.0,27.0,017,02,01,  Bhella,707,714,391,325,316,389,49.8,54.6,44.8,00000
10.0,6.0,27.0,035,01,01,  Amtair,99,217,56,93,43,124,31.3,37.6,25.7,00000
10.0,6.0,27.0,035,02,01,  Damorkuri,84,91,53,38,31,53,48.0,58.2,36.9,00000
10.0,6.0,27.0,035,03,01,  Bantair,387,378,202,168,185,210,50.6,54.6,46.8,00000
10.0,6.0,27.0,079,01,01,  Baria Barta,442,637,268,284,174,353,41.0,48.6,33.0,00000
10.0,6.0,27.0,079,02,01,  Chhota Barta,86,200,27,100,59,100,30.1,21.3,37.1,00000
10.0,6.0,27.0,115,01,01,  Uttarpara,575,604,309,273,266,331,48.8,53.1,44.6,00000
10.0,6.0,27.0,115,02,01,  Paschimpara,476,353,245,158,231,195,57.4,60.8,54.2,00000
10.0,6.0,27.0,115,03,01,  Bapihar,174,178,89,78,85,100,49.4,53.3,45.9,00000
10.0,6.0,27.0,115,04,01,  Lakshmikul,346,313,180,141,166,172,52.5,56.1,49.1,00000
10.0,6.0,27.0,115,05,01,  Kumar Para,124,220,67,101,57,119,36.0,39.9,32.4,00000
10.0,6.0,27.0,337,01,01,  Bejar,450,239,232,99,218,140,65.3,70.1,60.9,00000
10.0,6.0,27.0,337,02,01,  Bhathali,161,146,87,72,74,74,52.4,54.7,50.0,00000
10.0,6.0,27.0,337,03,01,  Garohali,128,91,78,41,50,50,58.4,65.5,50.0,00000
10.0,6.0,27.0,408,01,01,  Chhota Jhakhar,233,538,130,260,103,278,30.2,33.3,27.0,00000
10.0,6.0,27.0,408,02,01,  Bara Jhakhar,357,269,174,130,183,139,57.0,57.2,56.8,00000
10.0,6.0,27.0,408,03,01,  Champapur,771,608,391,283,380,325,55.9,58.0,53.9,00000
10.0,6.0,27.0,408,04,01,  Kanchanpur,1055,451,577,200,478,251,70.1,74.3,65.6,00000
10.0,6.0,27.0,408,05,01,  Haospur,339,403,179,192,160,211,45.7,48.2,43.1,00000
10.0,6.0,27.0,408,06,01,  Mataapur,283,176,141,82,142,94,61.7,63.2,60.2,00000
10.0,6.0,27.0,408,07,01,  Bahadurpur,187,325,97,152,90,173,36.5,39.0,34.2,00000
10.0,6.0,27.0,408,08,01,  Mandir Pukur,174,147,93,71,81,76,54.2,56.7,51.6,00000
10.0,6.0,27.0,408,09,01,  Kamar Pukur,165,147,97,75,68,72,52.9,56.4,48.6,00000
10.0,6.0,40.0,044,01,01,  Bara Akhira+Guchha Gram,1175,971,601,480,574,491,54.8,55.6,53.9,00000
10.0,6.0,40.0,044,02,01,  Belgachhi,295,115,148,47,147,68,72.0,75.9,68.4,00000
10.0,6.0,40.0,062,01,01,  Bara Dighi,338,169,162,77,176,92,66.7,67.8,65.7,00000
10.0,6.0,40.0,062,02,01,  Tikri,175,133,80,65,95,68,56.8,55.2,58.3,00000
10.0,6.0,40.0,062,03,01,  Palashi,114,118,53,60,61,58,49.1,46.9,51.3,00000
10.0,6.0,40.0,168,01,01,  Chhatiangram,1044,638,551,295,493,343,62.1,65.1,59.0,00000
10.0,6.0,40.0,168,02,01,  Ghoradah,87,63,42,31,45,32,58.0,57.5,58.4,00000
10.0,6.0,40.0,168,03,01,  Hardam,69,69,36,28,33,41,50.0,56.3,44.6,00000
10.0,6.0,40.0,168,04,01,  Durgapur,469,506,228,232,241,274,48.1,49.6,46.8,00000
10.0,6.0,40.0,168,05,01,  Antahar,667,700,332,325,335,375,48.8,50.5,47.2,00000
10.0,6.0,40.0,168,06,01,  Baghbari,502,327,247,144,255,183,60.6,63.2,58.2,00000
10.0,6.0,40.0,168,07,01,  Kalabaria (Belgachhipara),126,67,63,29,63,38,65.3,68.5,62.4,00000
10.0,6.0,40.0,168,08,01,  Dhulatoir,186,182,102,85,84,97,50.5,54.5,46.4,00000
10.0,6.0,40.0,168,09,01,  Ambaria,86,92,53,35,33,57,48.3,60.2,36.7,00000
10.0,6.0,40.0,168,10,01,  Yusubpur,97,335,52,163,45,172,22.5,24.2,20.7,00000
10.0,6.0,40.0,168,11,01,  Kallagari,489,391,243,183,246,208,55.6,57.0,54.2,00000
10.0,6.0,40.0,168,12,01,  Nemai Dighi,747,360,378,158,369,202,67.5,70.5,64.6,00000
10.0,6.0,40.0,390,01,01,  Indail,427,291,224,151,203,140,59.5,59.7,59.2,00000
10.0,6.0,40.0,390,02,01,  Chak Sabaj,99,116,56,62,43,54,46.0,47.5,44.3,00000
10.0,6.0,40.0,444,01,01,  Kaikuri,332,322,158,161,174,161,50.8,49.5,51.9,00000
10.0,6.0,40.0,444,02,01,  Kalaikuri,589,568,287,260,302,308,50.9,52.5,49.5,00000
10.0,6.0,40.0,444,03,01,  Pahlowan Para,561,71,285,28,276,43,88.8,91.1,86.5,00000
10.0,6.0,40.0,444,04,01,  Amuwil,213,110,118,46,95,64,65.9,72.0,59.7,00000
10.0,6.0,40.0,444,05,01,  Chak Sonar,144,198,77,92,67,106,42.1,45.6,38.7,00000
10.0,6.0,40.0,444,06,01,  Kumarbhog,243,192,120,94,123,98,55.9,56.1,55.7,00000
10.0,6.0,40.0,568,01,01,  Kumarpur,790,622,399,300,391,322,55.9,57.1,54.8,00000
10.0,6.0,40.0,568,02,01,  Kashimalkuri,486,198,243,96,243,102,71.1,71.7,70.4,00000
10.0,6.0,40.0,604,01,01,  Lakshmikul,209,219,116,94,93,125,48.8,55.2,42.7,00000
10.0,6.0,40.0,604,02,01,  Lakshmankuri,172,109,95,44,77,65,61.2,68.3,54.2,00000
10.0,6.0,40.0,826,01,01,  Salgaon,1238,788,607,365,631,423,61.1,62.4,59.9,00000
10.0,6.0,40.0,826,02,01,  Kasaigari,159,116,74,58,85,58,57.8,56.1,59.4,00000
10.0,6.0,54.0,399,01,01,  Charu Para,223,151,121,66,102,85,59.6,64.7,54.5,00000
10.0,6.0,54.0,399,02,01,  Panda Para,176,111,107,44,69,67,61.3,70.9,50.7,00000
10.0,6.0,54.0,577,01,01,  Kundagram,2131,1572,1083,728,1048,844,57.5,59.8,55.4,00000
10.0,6.0,54.0,577,02,01,  Baniagari,132,137,75,60,57,77,49.1,55.6,42.5,00000
10.0,6.0,54.0,577,03,01,  Tentulia,165,130,95,58,70,72,55.9,62.1,49.3,00000
10.0,6.0,54.0,577,04,01,  Harbhanga,170,202,76,91,94,111,45.7,45.5,45.9,00000
10.0,6.0,54.0,577,05,01,  Harinmara,407,433,201,170,206,263,48.5,54.2,43.9,00000
10.0,6.0,54.0,577,06,01,  Bagicha Para,212,622,98,276,114,346,25.4,26.2,24.8,00000
10.0,6.0,54.0,577,07,01,  Bhebra Para,41,54,27,21,14,33,43.2,56.3,29.8,00000
10.0,6.0,54.0,586,01,01,  Kusabari,438,516,247,224,191,292,45.9,52.4,39.5,00000
10.0,6.0,54.0,586,02,01,  Gazaria,28,66,13,30,15,36,29.8,30.2,29.4,00000
10.0,6.0,54.0,710,01,01,  Nimakuri,233,181,127,73,106,108,56.3,63.5,49.5,00000
10.0,6.0,54.0,710,02,01,  Mot Pukuria,293,510,136,235,157,275,36.5,36.7,36.3,00000
10.0,6.0,54.0,977,01,01,  Joydebpur,184,218,87,110,97,108,45.8,44.2,47.3,00000
10.0,6.0,54.0,977,02,01,  Tilach Chhayani Para,319,154,178,67,141,87,67.4,72.7,61.8,00000
10.0,6.0,54.0,977,03,01,  Gadhghat,430,217,216,92,214,125,66.5,70.1,63.1,00000
10.0,6.0,54.0,977,04,01,  Sitahar,191,160,100,69,91,91,54.4,59.2,50.0,00000
10.0,6.0,54.0,977,05,01,  Sonar Para,329,166,189,64,140,102,66.5,74.7,57.9,00000
10.0,6.0,54.0,977,06,01,  Kandar Para,208,157,106,60,102,97,57.0,63.9,51.3,00000
10.0,6.0,54.0,977,07,01,  Dakshinpara,205,146,108,60,97,86,58.4,64.3,53.0,00000
10.0,6.0,54.0,977,08,01,  Pitahar,179,147,96,59,83,88,54.9,61.9,48.5,00000
10.0,6.0,67.0,053,01,01,  Bara Baria,262,168,138,76,124,92,60.9,64.5,57.4,00000
10.0,6.0,67.0,053,02,01,  Haludghar,318,241,158,95,160,146,56.9,62.5,52.3,00000
10.0,6.0,67.0,275,01,01,  Dattabaria,178,222,86,106,92,116,44.5,44.8,44.2,00000
10.0,6.0,67.0,275,02,01,  Samsamkuri,208,135,110,57,98,78,60.6,65.9,55.7,00000
10.0,6.0,67.0,346,01,01,  Ghoradaha,256,202,135,85,121,117,55.9,61.4,50.8,00000
10.0,6.0,67.0,346,02,01,  Deodhar,92,111,54,47,38,64,45.3,53.5,37.3,00000
10.0,6.0,67.0,346,03,01,  Chamail,44,29,26,11,18,18,60.3,70.3,50.0,00000
10.0,6.0,67.0,550,01,01,  Khariakandi,304,166,153,71,151,95,64.7,68.3,61.4,00000
10.0,6.0,67.0,550,02,01,  Sitlai,358,191,192,79,166,112,65.2,70.8,59.7,00000
10.0,6.0,67.0,621,01,01,  Latifpur,417,515,202,246,215,269,44.7,45.1,44.4,00000
10.0,6.0,67.0,621,02,01,  Dhantala,268,367,146,181,122,186,42.2,44.6,39.6,00000
10.0,6.0,67.0,692,01,01,  Murail,773,561,411,269,362,292,57.9,60.4,55.4,00000
10.0,6.0,67.0,692,02,01,  Uttar Murail,103,138,61,62,42,76,42.7,49.6,35.6,00000
10.0,6.0,67.0,692,03,01,  Kamargari,130,184,78,82,52,102,41.4,48.8,33.8,00000
10.0,6.0,67.0,692,04,01,  Kola Dighi,180,82,104,38,76,44,68.7,73.2,63.3,00000
10.0,6.0,67.0,701,01,01,  Nasratpur Bazar,452,278,242,132,210,146,61.9,64.7,59.0,00000
10.0,6.0,67.0,701,02,01,  Nasratpur,645,377,333,178,312,199,63.1,65.2,61.1,00000
10.0,6.0,67.0,701,03,01,  Thal Para,174,141,91,61,83,80,55.2,59.9,50.9,00000
10.0,6.0,67.0,835,01,01,  Sanail,1407,1325,736,591,671,734,51.5,55.5,47.8,00000
10.0,6.0,67.0,835,02,01,  Basudeb Para,118,65,63,25,55,40,64.5,71.6,57.9,00000
10.0,6.0,67.0,852,01,01,  Sankoa,69,168,35,80,34,88,29.1,30.4,27.9,00000
10.0,6.0,67.0,852,02,01,  Arjungari,164,334,103,157,61,177,32.9,39.6,25.6,00000
10.0,6.0,67.0,852,03,01,  Banshbaria,42,87,24,39,18,48,32.6,38.1,27.3,00000
10.0,6.0,81.0,177,01,01,  Purba Chhatni,562,831,302,389,260,442,40.3,43.7,37.0,00000
10.0,6.0,81.0,177,02,01,  Paschim Chhatni,1230,1229,662,559,568,670,50.0,54.2,45.9,00000
10.0,6.0,81.0,177,03,01,  Paik Para,68,90,33,47,35,43,43.0,41.3,44.9,00000
10.0,6.0,81.0,177,04,01,  Kella Para,238,422,134,175,104,247,36.1,43.4,29.6,00000
10.0,6.0,81.0,177,05,01,  Danga Para,259,211,137,96,122,115,55.1,58.8,51.5,00000
10.0,6.0,81.0,257,01,01,  Dariapur,179,445,105,200,74,245,28.7,34.4,23.2,00000
10.0,6.0,81.0,257,02,01,  Chakjan,179,301,91,130,88,171,37.3,41.2,34.0,00000
10.0,6.0,81.0,293,01,01,  Dhekra,692,519,373,227,319,292,57.1,62.2,52.2,00000
10.0,6.0,81.0,293,02,01,  Panla,167,214,91,97,76,117,43.8,48.4,39.4,00000
10.0,6.0,81.0,994,01,01,  Uthrail,1162,937,606,426,556,511,55.4,58.7,52.1,00000
10.0,6.0,81.0,994,02,01,  Jahanabaz,380,280,213,132,167,148,57.6,61.7,53.0,00000
10.0,20.0,23.0,037,01,01,  Gholagari,1430,588,777,234,653,354,70.9,76.9,64.8,00000
10.0,20.0,23.0,037,02,01,  Kadamtali,339,210,186,92,153,118,61.7,66.9,56.5,00000
10.0,20.0,23.0,068,01,01,  Ambaria,364,54,191,27,173,27,87.1,87.6,86.5,00000
10.0,20.0,23.0,068,02,01,  Ban Dighi,1868,1126,987,511,881,615,62.4,65.9,58.9,00000
10.0,20.0,23.0,068,03,01,  Echabpur,1560,483,800,223,760,260,76.4,78.2,74.5,00000
10.0,20.0,23.0,068,04,01,  Hapunia,445,220,247,94,198,126,66.9,72.4,61.1,00000
10.0,20.0,23.0,385,01,01,  Erulia,2359,1020,1246,476,1113,544,69.8,72.4,67.2,00000
10.0,20.0,23.0,385,02,01,  Palibari,493,154,270,67,223,87,76.2,80.1,71.9,00000
10.0,20.0,23.0,385,03,01,  Arazi Palibari,574,451,300,233,274,218,56.0,56.3,55.7,00000
10.0,20.0,23.0,385,04,01,  Raghunathpur,610,245,322,119,288,126,71.3,73.0,69.6,00000
10.0,20.0,23.0,385,05,01,  Nilail,211,305,125,145,86,160,40.9,46.3,35.0,00000
10.0,20.0,23.0,938,01,01,  Shikarpur,1922,647,1006,282,916,365,74.8,78.1,71.5,00000
10.0,20.0,23.0,938,02,01,  Purba Shikarpur,912,643,501,336,411,307,58.6,59.9,57.2,00000
10.0,20.0,25.0,382,01,01,  Chak Durgapur,301,178,138,80,163,98,62.8,63.3,62.5,00000
10.0,20.0,25.0,382,02,01,  Belgari,334,270,162,144,172,126,55.3,52.9,57.7,00000
10.0,20.0,25.0,529,01,01,  Kanar,729,283,379,134,350,149,72.0,73.9,70.1,00000
10.0,20.0,25.0,529,02,01,  Dhawa Changoir,326,95,169,42,157,53,77.4,80.1,74.8,00000
10.0,20.0,60.0,438,01,01,  Hukmapur,300,347,172,151,128,196,46.4,53.3,39.5,00000
10.0,20.0,60.0,438,02,01,  Sadhona Para,356,427,207,181,149,246,45.5,53.4,37.7,00000
10.0,20.0,60.0,699,01,01,  Bhandari Para,866,1008,452,456,414,552,46.2,49.8,42.9,00000
10.0,20.0,60.0,699,02,01,  Panna Para,387,449,205,207,182,242,46.3,49.8,42.9,00000
10.0,20.0,60.0,699,03,01,  Thakur Para,422,342,221,161,201,181,55.2,57.9,52.6,00000
10.0,20.0,60.0,699,04,01,  Sardar Para,378,220,202,109,176,111,63.2,65.0,61.3,00000
10.0,20.0,60.0,699,05,01,  Majid Para,354,824,184,388,170,436,30.1,32.2,28.1,00000
10.0,20.0,60.0,699,06,01,  Saha Para,272,429,142,207,130,222,38.8,40.7,36.9,00000
10.0,20.0,60.0,699,07,01,  Chak Rampur,220,304,131,159,89,145,42.0,45.2,38.0,00000
10.0,20.0,60.0,699,08,01,  Bagar Para,634,917,308,442,326,475,40.9,41.1,40.7,00000
10.0,20.0,60.0,699,09,01,  Nath Para,431,538,235,253,196,285,44.5,48.2,40.7,00000
10.0,20.0,60.0,979,01,01,  Bara Tengra,735,958,414,467,321,491,43.4,47.0,39.5,00000
10.0,20.0,60.0,979,02,01,  Chhota Tengra,330,382,198,189,132,193,46.3,51.2,40.6,00000
10.0,20.0,64.0,087,01,01,  Chandpur,1493,812,835,392,658,420,64.8,68.1,61.0,00000
10.0,20.0,64.0,087,02,01,  Barpur Madhya Para,2346,838,1278,358,1068,480,73.7,78.1,69.0,00000
10.0,20.0,64.0,087,03,01,  Noada Para,385,57,208,28,177,29,87.1,88.1,85.9,00000
10.0,20.0,82.0,064,01,01,  Banamali Para,318,155,168,64,150,91,67.2,72.4,62.2,00000
10.0,20.0,82.0,064,02,01,  Bharui Para,579,538,290,276,289,262,51.8,51.2,52.5,00000
10.0,20.0,82.0,064,03,01,  Jangali Para,917,716,469,364,448,352,56.2,56.3,56.0,00000
10.0,20.0,82.0,064,04,01,  Gopalbari,890,1328,462,696,428,632,40.1,39.9,40.4,00000
10.0,20.0,86.0,976,01,01,  Purbapara,364,463,190,220,174,243,44.0,46.3,41.7,00000
10.0,20.0,86.0,976,02,01,  Paschimpara,372,363,185,186,187,177,50.6,49.9,51.4,00000
10.0,20.0,86.0,976,03,01,  Dakshinpara,923,658,491,309,432,349,58.4,61.4,55.3,00000
10.0,20.0,86.0,976,04,01,  Chak Telihara,88,84,43,39,45,45,51.2,52.4,50.0,00000
10.0,20.0,86.0,976,05,01,  Balu Para,188,249,103,131,85,118,43.0,44.0,41.9,00000
10.0,27.0,15.0,153,01,01,  Bhandarbari,80,196,42,91,38,105,29.0,31.6,26.6,00000
10.0,27.0,15.0,153,02,01,  Bhutbari,413,989,205,452,208,537,29.5,31.2,27.9,00000
10.0,27.0,15.0,153,03,01,  Raghunathpur,218,356,113,159,105,197,38.0,41.5,34.8,00000
10.0,27.0,15.0,153,04,01,  Gopalnagar,116,236,57,111,59,125,33.0,33.9,32.1,00000
10.0,27.0,15.0,306,01,01,  Radhanagar,48,85,21,40,27,45,36.1,34.4,37.5,00000
10.0,27.0,15.0,306,02,01,  Bothuarvita,16,62,7,32,9,30,20.5,17.9,23.1,00000
10.0,27.0,15.0,306,03,01,  Boishakhj,238,111,119,56,119,55,68.2,68.0,68.4,00000
10.0,27.0,15.0,820,01,01,  Ramkrishnapur,381,539,186,239,195,300,41.4,43.8,39.4,00000
10.0,27.0,15.0,820,02,01,  Marichtala,425,708,215,285,210,423,37.5,43.0,33.2,00000
10.0,27.0,15.0,820,03,01,  Narayanpur,310,549,153,267,157,282,36.1,36.4,35.8,00000
10.0,27.0,15.0,820,04,01,  Madhabdanga,424,674,215,289,209,385,38.6,42.7,35.2,00000
10.0,27.0,15.0,907,01,01,  Sariakandi,135,463,66,193,69,270,22.6,25.5,20.4,00000
10.0,27.0,15.0,907,02,01,  Pukharia,351,591,176,243,175,348,37.3,42.0,33.5,00000
10.0,27.0,19.0,164,01,01,  Bhubanganti,385,892,186,442,199,450,30.1,29.6,30.7,00000
10.0,27.0,19.0,164,02,01,  Kumariadanga,159,173,86,81,73,92,47.9,51.5,44.2,00000
10.0,27.0,19.0,174,01,01,  Chan Diar,376,795,175,384,201,411,32.1,31.3,32.8,00000
10.0,27.0,19.0,174,02,01,  Konagati,57,132,29,66,28,66,30.2,30.5,29.8,00000
10.0,27.0,19.0,174,03,01,  Naya Chandiar,39,187,20,87,19,100,17.3,18.7,16.0,00000
10.0,27.0,19.0,218,01,01,  Bishnupur,287,461,134,216,153,245,38.4,38.3,38.4,00000
10.0,27.0,19.0,218,02,01,  Nasratpur,471,721,233,335,238,386,39.5,41.0,38.1,00000
10.0,27.0,19.0,218,03,01,  Khudapir Hatai,99,242,50,118,49,124,29.0,29.8,28.3,00000
10.0,27.0,19.0,299,01,01,  Bishwaharigachha,844,1299,436,604,408,695,39.4,41.9,37.0,00000
10.0,27.0,19.0,299,02,01,  Faringhata,116,672,63,330,53,342,14.7,16.0,13.4,00000
10.0,27.0,19.0,317,01,01,  Chaukibari,545,1631,310,801,235,830,25.0,27.9,22.1,00000
10.0,27.0,19.0,317,02,01,  Dingalkandi,475,1187,260,545,215,642,28.6,32.3,25.1,00000
10.0,27.0,19.0,317,03,01,  Thewkandi,253,712,127,344,126,368,26.2,27.0,25.5,00000
10.0,27.0,19.0,317,04,01,  Batikabari,315,611,166,290,149,321,34.0,36.4,31.7,00000
10.0,27.0,19.0,754,01,01,  Panchthupi,861,1271,437,593,424,678,40.4,42.4,38.5,00000
10.0,27.0,19.0,754,02,01,  Shambari,70,241,43,124,27,117,22.5,25.7,18.8,00000
10.0,27.0,19.0,754,03,01,  Ala Bishwanath,9,32,3,16,6,16,22.0,15.8,27.3,00000
10.0,27.0,19.0,754,04,01,  Ala Kokil,2,42,2,20,0,22,4.5,9.1,0.0,00000
10.0,27.0,19.0,754,05,01,  Soroa,119,831,51,414,68,417,12.5,11.0,14.0,00000
10.0,27.0,19.0,754,06,01,  Mairkeykhali,38,255,23,133,15,122,13.0,14.7,10.9,00000
10.0,27.0,19.0,841,01,01,  Rudrabaria,296,752,172,347,124,405,28.2,33.1,23.4,00000
10.0,27.0,19.0,841,02,01,  Kaigati,195,329,95,174,100,155,37.2,35.3,39.2,00000
10.0,27.0,19.0,841,03,01,  Kashto Sagara,111,136,68,64,43,72,44.9,51.5,37.4,00000
10.0,27.0,19.0,885,01,01,  Sakdaha,506,668,248,308,258,360,43.1,44.6,41.7,00000
10.0,27.0,19.0,885,02,01,  Penchibari,523,1218,309,531,214,687,30.0,36.8,23.8,00000
10.0,27.0,28.0,338,01,01,  Chikasi,635,1106,312,499,323,607,36.5,38.5,34.7,00000
10.0,27.0,28.0,338,02,01,  Sultanhata,220,574,119,247,101,327,27.7,32.5,23.6,00000
10.0,27.0,28.0,338,03,01,  Chhota Chikasi,335,659,173,317,162,342,33.7,35.3,32.1,00000
10.0,27.0,28.0,338,04,01,  Mohanpur,497,1087,280,522,217,565,31.4,34.9,27.7,00000
10.0,27.0,28.0,338,05,01,  Char Chikasi,708,1179,374,530,334,649,37.5,41.4,34.0,00000
10.0,27.0,28.0,765,01,01,  Par Lakshmipur,236,873,131,404,105,469,21.3,24.5,18.3,00000
10.0,27.0,28.0,765,02,01,  Khatiamari,94,115,56,55,38,60,45.0,50.5,38.8,00000
10.0,27.0,28.0,765,03,01,  Boria,451,925,260,431,191,494,32.8,37.6,27.9,00000
10.0,27.0,28.0,765,04,01,  Joursimal,988,2113,542,948,446,1165,31.9,36.4,27.7,00000
10.0,27.0,28.0,765,05,01,  Bhalu Katala,161,453,83,201,78,252,26.2,29.2,23.6,00000
10.0,27.0,28.0,765,06,01,  Jeani,830,1352,456,600,374,752,38.0,43.2,33.2,00000
10.0,27.0,28.0,765,07,01,  Chapra,1211,1647,592,764,619,883,42.4,43.7,41.2,00000
10.0,27.0,28.0,765,08,01,  Gaulat Taire,225,412,111,175,114,237,35.3,38.8,32.5,00000
10.0,27.0,38.0,131,01,01,  Belkuchi,1182,2320,603,1125,579,1195,33.8,34.9,32.6,00000
10.0,27.0,38.0,131,02,01,  Matikora,955,903,485,417,470,486,51.4,53.8,49.2,00000
10.0,27.0,38.0,131,03,01,  Ullah Para,755,843,390,369,365,474,47.2,51.4,43.5,00000
10.0,27.0,38.0,131,04,01,  Char Para,159,276,73,140,86,136,36.6,34.3,38.7,00000
10.0,27.0,38.0,262,01,01,  Chala Para,1631,2593,844,1226,787,1367,38.6,40.8,36.5,00000
10.0,27.0,38.0,262,02,01,  Mate Para,644,842,332,394,312,448,43.3,45.7,41.1,00000
10.0,27.0,38.0,393,01,03,  Chander Para,181,661,100,320,81,341,21.5,23.8,19.2,00000
10.0,27.0,38.0,393,02,03,  Malo Para,218,363,135,171,83,192,37.5,44.1,30.2,00000
10.0,27.0,38.0,393,03,03,  Par Dhunat,761,1197,418,550,343,647,38.9,43.2,34.6,00000
10.0,27.0,38.0,393,04,03,  Ratani Para,154,380,90,202,64,178,28.8,30.8,26.4,00000
10.0,27.0,38.0,393,05,03,  Pakurihata,716,1815,397,855,319,960,28.3,31.7,24.9,00000
10.0,27.0,38.0,393,06,03,  Kutibari,320,444,174,201,146,243,41.9,46.4,37.5,00000
10.0,27.0,47.0,185,01,01,  Bil Chapri,537,537,262,239,275,298,50.0,52.3,48.0,00000
10.0,27.0,47.0,185,02,01,  Dakraghat,531,1116,291,545,240,571,32.2,34.8,29.6,00000
10.0,27.0,47.0,404,01,01,  Hasapotal,225,499,120,226,105,273,31.1,34.7,27.8,00000
10.0,27.0,47.0,404,02,01,  Rangamati,454,663,230,297,224,366,40.6,43.6,38.0,00000
10.0,27.0,47.0,404,03,01,  Kumarkhali,330,509,182,217,148,292,39.3,45.6,33.6,00000
10.0,27.0,47.0,404,04,01,  Dider Para,656,1010,339,458,317,552,39.4,42.5,36.5,00000
10.0,27.0,47.0,404,05,01,  Soilmari,745,1288,389,640,356,648,36.6,37.8,35.5,00000
10.0,27.0,47.0,404,06,01,  Elangi,233,440,151,217,82,223,34.6,41.0,26.9,00000
10.0,27.0,47.0,404,07,01,  Elangi Pacshim Para,242,464,132,206,110,258,34.3,39.1,29.9,00000
10.0,27.0,47.0,404,08,01,  Chhota Elangi,412,450,219,210,193,240,47.8,51.0,44.6,00000
10.0,27.0,47.0,404,09,01,  Khoksahata,332,628,184,313,148,315,34.6,37.0,32.0,00000
10.0,27.0,47.0,404,10,01,  Naldunga,542,1052,300,491,242,561,34.0,37.9,30.1,00000
10.0,27.0,47.0,404,11,01,  Fakir Para,599,959,314,455,285,504,38.4,40.8,36.1,00000
10.0,27.0,47.0,404,12,01,  Tarakandi,714,1445,387,692,327,753,33.1,35.9,30.3,00000
10.0,27.0,47.0,404,13,01,  Chalarvita,111,262,59,113,52,149,29.8,34.3,25.9,00000
10.0,27.0,57.0,076,01,01,  Baniaganti,725,1421,372,679,353,742,33.8,35.4,32.2,00000
10.0,27.0,57.0,076,02,01,  Bashpata,454,737,231,348,223,389,38.1,39.9,36.4,00000
10.0,27.0,57.0,076,03,01,  Mahisura,383,620,201,267,182,353,38.2,42.9,34.0,00000
10.0,27.0,57.0,240,01,01,  Chak Dakatia,370,707,182,352,188,355,34.4,34.1,34.6,00000
10.0,27.0,57.0,240,02,01,  Razarampur,172,307,79,155,93,152,35.9,33.8,38.0,00000
10.0,27.0,57.0,240,03,01,  Voadha Bara Mongasa,134,314,63,152,71,162,29.9,29.3,30.5,00000
10.0,27.0,57.0,240,04,01,  Diger Bodergathi,74,89,37,42,37,47,45.4,46.8,44.0,00000
10.0,27.0,57.0,251,01,01,  Chak Meherdi,233,731,124,328,109,403,24.2,27.4,21.3,00000
10.0,27.0,57.0,251,02,01,  Satpakhia,129,336,74,163,55,173,27.7,31.2,24.1,00000
10.0,27.0,57.0,437,01,01,  Gopalnagar,721,1862,363,893,358,969,27.9,28.9,27.0,00000
10.0,27.0,57.0,437,02,01,  Dawaria,268,399,151,167,117,232,40.2,47.5,33.5,00000
10.0,27.0,57.0,437,03,01,  Bolarbari,192,339,99,160,93,179,36.2,38.2,34.2,00000
10.0,27.0,57.0,437,04,01,  Khatiamari,223,605,127,295,96,310,26.9,30.1,23.6,00000
10.0,27.0,57.0,437,05,01,  Char Gopalnagar,75,232,40,111,35,121,24.4,26.5,22.4,00000
10.0,27.0,57.0,437,06,01,  Biser Dear,380,649,193,311,187,338,36.9,38.3,35.6,00000
10.0,27.0,57.0,437,07,01,  Sat Tikuri,632,1242,326,559,306,683,33.7,36.8,30.9,00000
10.0,27.0,57.0,437,08,01,  Dighari Char,162,223,87,102,75,121,42.1,46.0,38.3,00000
10.0,27.0,57.0,623,01,01,  Konaganti,222,506,101,234,121,272,30.5,30.1,30.8,00000
10.0,27.0,57.0,623,02,01,  Ariamohan,83,195,45,85,38,110,29.9,34.6,25.7,00000
10.0,27.0,57.0,863,01,01,  Sholiabari,511,845,279,413,232,432,37.7,40.3,34.9,00000
10.0,27.0,57.0,863,02,01,  Ramnarayanpur,114,327,56,151,58,176,25.9,27.1,24.8,00000
10.0,27.0,57.0,863,03,01,  Kuratala,58,32,32,13,26,19,64.4,71.1,57.8,00000
10.0,27.0,66.0,349,01,01,  Chithulia,880,1181,428,520,452,661,42.7,45.1,40.6,00000
10.0,27.0,66.0,349,02,01,  Mabuakhali,291,459,135,198,156,261,38.8,40.5,37.4,00000
10.0,27.0,66.0,448,01,01,  Gosainbari,1000,955,486,413,514,542,51.2,54.1,48.7,00000
10.0,27.0,66.0,448,02,01,  Purba Guadahari,760,2140,388,1011,372,1129,26.2,27.7,24.8,00000
10.0,27.0,66.0,448,03,01,  Paschim Guadahari,810,1750,428,819,382,931,31.6,34.3,29.1,00000
10.0,27.0,66.0,612,01,01,  Khoksabari,468,718,243,319,225,399,39.5,43.2,36.1,00000
10.0,27.0,66.0,612,02,01,  Manik Potal,366,752,177,325,189,427,32.7,35.3,30.7,00000
10.0,27.0,66.0,721,01,01,  Natabari,762,1775,424,817,338,958,30.0,34.2,26.1,00000
10.0,27.0,66.0,721,02,01,  Par Natabari,464,1361,251,642,213,719,25.4,28.1,22.9,00000
10.0,27.0,66.0,721,03,01,  Bakcha Para,283,681,157,325,126,356,29.4,32.6,26.1,00000
10.0,27.0,76.0,021,01,01,  Anarpur,405,768,192,351,213,417,34.5,35.4,33.8,00000
10.0,27.0,76.0,021,02,01,  Kachugari,265,968,129,457,136,511,21.5,22.0,21.0,00000
10.0,27.0,76.0,021,03,01,  Gaugra Para,147,507,85,226,62,281,22.5,27.3,18.1,00000
10.0,27.0,76.0,021,04,01,  Moderbhita,123,148,70,60,53,88,45.4,53.8,37.6,00000
10.0,27.0,76.0,502,01,01,  Kodala Para,282,465,159,213,123,252,37.8,42.7,32.8,00000
10.0,27.0,76.0,502,02,01,  Ishwarghat,674,1228,345,580,329,648,35.4,37.3,33.7,00000
10.0,27.0,76.0,557,01,01,  Kadai,356,1113,163,522,193,591,24.2,23.8,24.6,00000
10.0,27.0,76.0,557,02,01,  Kandunia,35,312,25,141,10,171,10.1,15.1,5.5,00000
10.0,27.0,76.0,579,01,01,  Haskhali,265,410,143,193,122,217,39.3,42.6,36.0,00000
10.0,27.0,76.0,579,02,01,  Uttar Kantanagar,442,858,244,401,198,457,34.0,37.8,30.2,00000
10.0,27.0,76.0,579,03,01,  Dakshin Kantanagar,73,307,31,159,42,148,19.2,16.3,22.1,00000
10.0,27.0,76.0,579,04,01,  Purba Kantanagar,97,279,46,132,51,147,25.8,25.8,25.8,00000
10.0,27.0,76.0,579,05,01,  Char Para,132,289,71,141,61,148,31.4,33.5,29.2,00000
10.0,27.0,76.0,579,06,01,  Darakata,118,184,72,76,46,108,39.1,48.6,29.9,00000
10.0,27.0,76.0,579,07,01,  Paschim Kantangar,161,165,88,82,73,83,49.4,51.8,46.8,00000
10.0,27.0,76.0,579,08,01,  Hautnagar,333,818,182,358,151,460,28.9,33.7,24.7,00000
10.0,27.0,76.0,579,09,01,  Kantanagar,415,290,208,137,207,153,58.9,60.3,57.5,00000
10.0,27.0,76.0,579,10,01,  Ramnagar,545,932,294,421,251,511,36.9,41.1,32.9,00000
10.0,27.0,76.0,645,01,01,  Kaler Para,702,783,368,365,334,418,47.3,50.2,44.4,00000
10.0,27.0,76.0,645,02,01,  Niktipota,389,1126,207,514,182,612,25.7,28.7,22.9,00000
10.0,27.0,76.0,645,03,01,  Dulauri,219,445,116,198,103,247,33.0,36.9,29.4,00000
10.0,27.0,76.0,645,04,01,  Arkatia,421,1196,233,544,188,652,26.0,30.0,22.4,00000
10.0,27.0,76.0,645,05,01,  Sultanhata,240,552,132,251,108,301,30.3,34.5,26.4,00000
10.0,27.0,85.0,010,01,01,  Aloa,457,772,255,345,202,427,37.2,42.5,32.1,00000
10.0,27.0,85.0,010,02,01,  Goyalbhagh,150,414,83,192,67,222,26.6,30.2,23.2,00000
10.0,27.0,85.0,010,03,01,  Narayanpur,93,109,53,50,40,59,46.0,51.5,40.4,00000
10.0,27.0,85.0,010,04,01,  Mathurapur,138,104,72,49,66,55,57.0,59.5,54.5,00000
10.0,27.0,85.0,284,01,01,  Char Khaduli,226,155,120,60,106,95,59.3,66.7,52.7,00000
10.0,27.0,85.0,284,02,01,  Bhadailhata,54,59,27,31,27,28,47.8,46.6,49.1,00000
10.0,27.0,85.0,328,01,01,  Chhatiani,523,941,273,464,250,477,35.7,37.0,34.4,00000
10.0,27.0,85.0,328,02,01,  Rampura,362,322,170,160,192,162,52.9,51.5,54.2,00000
10.0,27.0,85.0,328,03,01,  Ullar Chapor,147,178,71,82,76,96,45.2,46.4,44.2,00000
10.0,27.0,85.0,382,01,01,  Dheruahati,290,768,155,374,135,394,27.4,29.3,25.5,00000
10.0,27.0,85.0,382,02,01,  Haripur,82,153,46,74,36,79,34.9,38.3,31.3,00000
10.0,27.0,85.0,492,01,01,  Hossainpur,169,194,87,85,82,109,46.6,50.6,42.9,00000
10.0,27.0,85.0,492,02,01,  Jabari Para,54,128,29,61,25,67,29.7,32.2,27.2,00000
10.0,27.0,85.0,492,03,01,  Ujalsingh,56,110,34,51,22,59,33.7,40.0,27.2,00000
10.0,27.0,85.0,524,01,01,  Jolaganti,486,881,269,431,217,450,35.6,38.4,32.5,00000
10.0,27.0,85.0,524,02,01,  Char Jolaganti,239,466,119,223,120,243,33.9,34.8,33.1,00000
10.0,27.0,85.0,590,01,01,  Kasihata,488,790,240,372,248,418,38.2,39.2,37.2,00000
10.0,27.0,85.0,590,02,01,  Chak Ulipur,125,355,58,168,67,187,26.0,25.7,26.4,00000
10.0,27.0,85.0,601,01,01,  Khaduli Singh,952,1104,524,511,428,593,46.3,50.6,41.9,00000
10.0,27.0,85.0,601,02,01,  Gopalpur Khaduli,452,595,238,269,214,326,43.2,46.9,39.6,00000
10.0,27.0,85.0,951,01,01,  Shimulkandi,309,840,163,407,146,433,26.9,28.6,25.2,00000
10.0,27.0,85.0,951,02,01,  Kanuganti,68,72,40,29,28,43,48.6,58.0,39.4,00000
10.0,27.0,95.0,371,01,01,  Dhamachama,1026,1823,520,853,506,970,36.0,37.9,34.3,00000
10.0,27.0,95.0,371,02,01,  Satbakey,362,1010,202,449,160,561,26.4,31.0,22.2,00000
10.0,27.0,95.0,699,01,01,  Nandiar Para,720,1366,363,661,357,705,34.5,35.4,33.6,00000
10.0,27.0,95.0,699,02,01,  Faridpur,581,1115,298,521,283,594,34.3,36.4,32.3,00000
10.0,27.0,95.0,798,01,01,  Pirapat,331,689,164,310,167,379,32.5,34.6,30.6,00000
10.0,27.0,95.0,798,02,01,  Joysing,366,921,209,443,157,478,28.4,32.1,24.7,00000
10.0,27.0,95.0,929,01,01,  Shiali,428,778,214,365,214,413,35.5,37.0,34.1,00000
10.0,27.0,95.0,929,02,01,  Sonahata,175,504,102,237,73,267,25.8,30.1,21.5,00000
10.0,27.0,95.0,929,03,01,  Niktipota,158,302,85,144,73,158,34.3,37.1,31.6,00000
10.0,33.0,13.0,060,01,01,  Dighir Para,158,409,85,176,73,233,27.9,32.6,23.9,00000
10.0,33.0,13.0,060,02,01,  Khiyar Para,170,240,106,97,64,143,41.5,52.2,30.9,00000
10.0,33.0,13.0,060,03,01,  Khunihara,153,263,75,124,78,139,36.8,37.7,35.9,00000
10.0,33.0,13.0,060,04,01,  Kayagari,117,244,63,112,54,132,32.4,36.0,29.0,00000
10.0,33.0,13.0,060,05,01,  Nagar Para,290,186,155,79,135,107,60.9,66.2,55.8,00000
10.0,33.0,13.0,060,06,01,  Saha Para,129,174,63,81,66,93,42.6,43.8,41.5,00000
10.0,33.0,13.0,060,07,01,  Parthiot,145,223,80,110,65,113,39.4,42.1,36.5,00000
10.0,33.0,13.0,060,08,01,  Poradah,289,278,159,135,130,143,51.0,54.1,47.6,00000
10.0,33.0,13.0,060,09,01,  Belhali,444,552,248,243,196,309,44.6,50.5,38.8,00000
10.0,33.0,13.0,346,01,01,  Sanulla,52,165,33,70,19,95,24.0,32.0,16.7,00000
10.0,33.0,13.0,346,02,01,  Dobla Para,116,214,60,94,56,120,35.2,39.0,31.8,00000
10.0,33.0,13.0,493,01,01,  Kathahali,427,919,221,440,206,479,31.7,33.4,30.1,00000
10.0,33.0,13.0,493,02,01,  Chak Sohaga,84,76,44,33,40,43,52.5,57.1,48.2,00000
10.0,33.0,13.0,795,01,01,  Pora Para,256,591,149,290,107,301,30.2,33.9,26.2,00000
10.0,33.0,13.0,795,02,01,  Bakadah,98,118,50,54,48,64,45.4,48.1,42.9,00000
10.0,33.0,13.0,994,01,01,  Uttar Sajapur,507,412,275,171,232,241,55.2,61.7,49.0,00000
10.0,33.0,13.0,994,02,01,  Haringari,195,87,111,40,84,47,69.1,73.5,64.1,00000
10.0,33.0,27.0,008,01,01,  Paschim Alohali,324,490,171,221,153,269,39.8,43.6,36.3,00000
10.0,33.0,27.0,008,02,01,  Purba Alohali,283,286,148,129,135,157,49.7,53.4,46.2,00000
10.0,33.0,27.0,008,03,01,  Bhelur Chak,108,32,47,18,61,14,77.1,72.3,81.3,00000
10.0,33.0,27.0,008,04,01,  Morcha Para,100,98,49,45,51,53,50.5,52.1,49.0,00000
10.0,33.0,27.0,008,05,01,  Alohali Madhya Para,257,270,140,129,117,141,48.8,52.0,45.3,00000
10.0,33.0,27.0,285,01,01,  Dakahar,354,378,188,170,166,208,48.4,52.5,44.4,00000
10.0,33.0,27.0,285,02,01,  Belbhuja,184,113,91,52,93,61,62.0,63.6,60.4,00000
10.0,33.0,27.0,320,01,01,  Dhap,512,775,276,367,236,408,39.8,42.9,36.6,00000
10.0,33.0,27.0,320,02,01,  Nimaikola,146,223,86,96,60,127,39.6,47.3,32.1,00000
10.0,33.0,27.0,320,03,01,  Jogipotha,94,176,46,93,48,83,34.8,33.1,36.6,00000
10.0,33.0,27.0,406,01,01,  Tarafdar Para,154,87,84,37,70,50,63.9,69.4,58.3,00000
10.0,33.0,27.0,406,02,01,  Khan Para,276,192,157,90,119,102,59.0,63.6,53.8,00000
10.0,33.0,27.0,406,03,01,  Khanbari,126,326,62,152,64,174,27.9,29.0,26.9,00000
10.0,33.0,27.0,406,04,01,  Kushbahar,234,216,133,85,101,131,52.0,61.0,43.5,00000
10.0,33.0,27.0,406,05,01,  Barabaria,53,121,29,60,24,61,30.5,32.6,28.2,00000
10.0,33.0,27.0,475,01,01,  Kamargaon,571,529,303,237,268,292,51.9,56.1,47.9,00000
10.0,33.0,27.0,475,02,01,  Katagari,186,118,94,53,92,65,61.2,63.9,58.6,00000
10.0,33.0,27.0,475,03,01,  Baharampur,63,86,32,37,31,49,42.3,46.4,38.8,00000
10.0,33.0,27.0,622,01,01,  Masinda,130,120,60,59,70,61,52.0,50.4,53.4,00000
10.0,33.0,27.0,622,02,01,  Sukhanagari,407,344,206,164,201,180,54.2,55.7,52.8,00000
10.0,33.0,27.0,648,01,01,  Matihas,227,253,128,114,99,139,47.3,52.9,41.6,00000
10.0,33.0,27.0,648,02,01,  Kankai,203,137,104,62,99,75,59.7,62.7,56.9,00000
10.0,33.0,27.0,977,01,01,  Tentulia,162,236,95,106,67,130,40.7,47.3,34.0,00000
10.0,33.0,27.0,977,02,01,  Karamgi,170,492,99,254,71,238,25.7,28.0,23.0,00000
10.0,33.0,27.0,977,03,01,  Sonar Para,124,86,72,37,52,49,59.0,66.1,51.5,00000
10.0,33.0,40.0,025,01,01,  Amsatta,851,657,462,270,389,387,56.4,63.1,50.1,00000
10.0,33.0,40.0,025,02,01,  Panch Khupi,319,105,177,41,142,64,75.2,81.2,68.9,00000
10.0,33.0,40.0,025,03,01,  Dharsan,498,379,241,174,257,205,56.8,58.1,55.6,00000
10.0,33.0,40.0,043,01,01,  Uttar Asunja,484,384,286,138,198,246,55.8,67.5,44.6,00000
10.0,33.0,40.0,043,02,01,  Dakshin Asunja,238,210,127,86,111,124,53.1,59.6,47.2,00000
10.0,33.0,40.0,103,01,01,  Phutaniganj,94,202,56,85,38,117,31.8,39.7,24.5,00000
10.0,33.0,40.0,103,02,01,  Bania Dighi,280,264,138,120,142,144,51.5,53.5,49.7,00000
10.0,33.0,40.0,217,01,01,  Chandani,198,145,94,57,104,88,57.7,62.3,54.2,00000
10.0,33.0,40.0,217,02,01,  Palla,237,183,126,80,111,103,56.4,61.2,51.9,00000
10.0,33.0,40.0,536,01,01,  Khamargari,325,306,167,140,158,166,51.5,54.4,48.8,00000
10.0,33.0,40.0,536,02,01,  Berach,169,40,93,14,76,26,80.9,86.9,74.5,00000
10.0,33.0,40.0,536,03,01,  Nihali,189,243,112,97,77,146,43.8,53.6,34.5,00000
10.0,33.0,40.0,536,04,01,  Uttarpaschim Khihali,561,748,306,329,255,419,42.9,48.2,37.8,00000
10.0,33.0,40.0,536,05,01,  Chak Para,248,302,125,141,123,161,45.1,47.0,43.3,00000
10.0,33.0,40.0,536,06,01,  Madhyapara,241,129,113,56,128,73,65.1,66.9,63.7,00000
10.0,33.0,40.0,536,07,01,  Dakshinpara,297,197,150,92,147,105,60.1,62.0,58.3,00000
10.0,33.0,40.0,536,08,01,  Koch Pukuria,263,118,122,49,141,69,69.0,71.3,67.1,00000
10.0,33.0,40.0,536,09,01,  Bontentulia,305,255,159,103,146,152,54.5,60.7,49.0,00000
10.0,33.0,40.0,596,01,01,  Majinda,492,578,260,258,232,320,46.0,50.2,42.0,00000
10.0,33.0,40.0,596,02,01,  Seola,130,133,67,57,63,76,49.4,54.0,45.3,00000
10.0,33.0,40.0,640,01,01,  Uttar Mathurapur,561,320,276,138,285,182,63.7,66.7,61.0,00000
10.0,33.0,40.0,640,02,01,  Dakshin Mathurapur,594,281,289,117,305,164,67.9,71.2,65.0,00000
10.0,33.0,40.0,657,01,01,  Maukuri,368,428,181,196,187,232,46.2,48.0,44.6,00000
10.0,33.0,40.0,657,02,01,  Altafnagar,267,183,124,71,143,112,59.3,63.6,56.1,00000
10.0,33.0,54.0,017,01,01,  Amjhupi,284,266,143,128,141,138,51.6,52.8,50.5,00000
10.0,33.0,54.0,017,02,01,  Baraikuri,73,43,35,16,38,27,62.9,68.6,58.5,00000
10.0,33.0,54.0,034,01,01,  Arjungari,265,331,134,147,131,184,44.5,47.7,41.6,00000
10.0,33.0,54.0,034,02,01,  Suhali,70,45,35,17,35,28,60.9,67.3,55.6,00000
10.0,33.0,54.0,034,03,01,  Khurda Para,94,55,48,23,46,32,63.1,67.6,59.0,00000
10.0,33.0,54.0,129,01,01,  Belhatta,304,221,156,87,148,134,57.9,64.2,52.5,00000
10.0,33.0,54.0,129,02,01,  Singa,323,217,180,81,143,136,59.8,69.0,51.3,00000
10.0,33.0,54.0,129,03,01,  Kazigari,60,88,30,38,30,50,40.5,44.1,37.5,00000
10.0,33.0,54.0,181,01,01,  Bhatanda,315,273,176,120,139,153,53.6,59.5,47.6,00000
10.0,33.0,54.0,181,02,01,  Dochia,131,112,63,55,68,57,53.9,53.4,54.4,00000
10.0,33.0,54.0,259,01,01,  Chhota Beragaon,191,117,90,50,101,67,62.0,64.3,60.1,00000
10.0,33.0,54.0,259,02,01,  Dashara,119,54,66,16,53,38,68.8,80.5,58.2,00000
10.0,33.0,54.0,415,01,01,  Jajira,455,804,219,382,236,422,36.1,36.4,35.9,00000
10.0,33.0,54.0,415,02,01,  Danga Para,165,103,86,41,79,62,61.6,67.7,56.0,00000
10.0,33.0,54.0,415,03,01,  Karamji,172,118,90,45,82,73,59.3,66.7,52.9,00000
10.0,33.0,54.0,501,01,01,  Keut,159,118,97,44,62,74,57.4,68.8,45.6,00000
10.0,33.0,54.0,501,02,01,  Sana Para,65,42,35,16,30,26,60.7,68.6,53.6,00000
10.0,33.0,54.0,501,03,01,  Nandar Para,71,100,43,42,28,58,41.5,50.6,32.6,00000
10.0,33.0,54.0,709,01,01,  Bara Nilahali,403,440,227,187,176,253,47.8,54.8,41.0,00000
10.0,33.0,54.0,709,02,01,  Koigari,139,86,75,31,64,55,61.8,70.8,53.8,00000
10.0,33.0,54.0,744,01,01,  Panchusha,292,441,142,200,150,241,39.8,41.5,38.4,00000
10.0,33.0,54.0,744,02,01,  Satni,127,133,64,57,63,76,48.8,52.9,45.3,00000
10.0,33.0,54.0,761,01,01,  Paogachha,526,523,275,240,251,283,50.1,53.4,47.0,00000
10.0,33.0,54.0,761,02,01,  Khoksa Para,139,114,87,40,52,74,54.9,68.5,41.3,00000
10.0,33.0,54.0,770,01,01,  Paota,577,474,306,184,271,290,54.9,62.4,48.3,00000
10.0,33.0,54.0,770,02,01,  Damkuri,144,77,85,21,59,56,65.2,80.2,51.3,00000
10.0,33.0,54.0,813,01,01,  Pukurgachha,286,378,152,163,134,215,43.1,48.3,38.4,00000
10.0,33.0,54.0,813,02,01,  Pora Para,116,162,64,74,52,88,41.7,46.4,37.1,00000
10.0,33.0,54.0,899,01,01,  Singra,357,287,187,122,170,165,55.4,60.5,50.7,00000
10.0,33.0,54.0,899,02,01,  Batahar,164,241,81,114,83,127,40.5,41.5,39.5,00000
10.0,33.0,54.0,986,01,01,  Unahat,260,358,144,166,116,192,42.1,46.5,37.7,00000
10.0,33.0,54.0,986,02,01,  Chak Manohar,150,185,70,91,80,94,44.8,43.5,46.0,00000
10.0,33.0,67.0,112,01,01,  Gari Belgharia,254,202,137,83,117,119,55.7,62.3,49.6,00000
10.0,33.0,67.0,112,02,01,  Sana Belgharia,179,108,96,48,83,60,62.4,66.7,58.0,00000
10.0,33.0,67.0,112,03,01,  Rasulpur,220,206,115,97,105,109,51.6,54.2,49.1,00000
10.0,33.0,67.0,112,04,01,  Chak Shola,234,128,113,62,121,66,64.6,64.6,64.7,00000
10.0,33.0,67.0,112,05,01,  Chak Gopal,40,11,23,2,17,9,78.4,92.0,65.4,00000
10.0,33.0,67.0,363,01,01,  Dubra,294,461,150,210,144,251,38.9,41.7,36.5,00000
10.0,33.0,67.0,363,02,01,  Muktagachha,349,251,170,108,179,143,58.2,61.2,55.6,00000
10.0,33.0,67.0,363,03,01,  Talora Railway Station,162,149,86,62,76,87,52.1,58.1,46.6,00000
10.0,33.0,67.0,467,01,01,  Kail,1106,954,558,433,548,521,53.7,56.3,51.3,00000
10.0,33.0,67.0,467,02,01,  Bara Chapra,177,114,92,53,85,61,60.8,63.4,58.2,00000
10.0,33.0,67.0,467,03,01,  Baluka Para,275,156,147,68,128,88,63.8,68.4,59.3,00000
10.0,33.0,67.0,467,04,01,  Dogachhi,369,120,171,45,198,75,75.5,79.2,72.5,00000
10.0,33.0,67.0,467,05,01,  Poraghata,103,72,63,32,40,40,58.9,66.3,50.0,00000
10.0,33.0,67.0,527,01,01,  Khanpur,973,834,491,377,482,457,53.8,56.6,51.3,00000
10.0,33.0,67.0,527,02,01,  Kunchigari,127,229,69,99,58,130,35.7,41.1,30.9,00000
10.0,33.0,67.0,527,03,01,  Chak Madhab,151,56,75,21,76,35,72.9,78.1,68.5,00000
10.0,33.0,67.0,666,01,01,  Megha,275,307,151,134,124,173,47.3,53.0,41.8,00000
10.0,33.0,67.0,666,02,01,  Saranjabari,312,139,182,51,130,88,69.2,78.1,59.6,00000
10.0,33.0,67.0,830,01,01,  Sabla,888,988,476,460,412,528,47.3,50.9,43.8,00000
10.0,33.0,67.0,830,02,01,  Talora Bandar,794,233,481,113,313,120,77.3,81.0,72.3,00000
10.0,33.0,67.0,830,03,01,  Banshpata,575,142,168,56,407,86,80.2,75.0,82.6,00000
10.0,33.0,67.0,830,04,01,  Dakshin Sabla,149,87,96,42,53,45,63.1,69.6,54.1,00000
10.0,33.0,67.0,951,01,01,  Talora,1424,1177,713,547,711,630,54.7,56.6,53.0,00000
10.0,33.0,67.0,951,02,01,  Nalgharia,374,461,189,222,185,239,44.8,46.0,43.6,00000
10.0,33.0,67.0,951,03,01,  Naoda Para,290,215,161,91,129,124,57.4,63.9,51.0,00000
10.0,33.0,67.0,951,04,01,  Fepra,98,121,61,48,37,73,44.7,56.0,33.6,00000
10.0,33.0,67.0,951,05,01,  Solla Para,23,136,13,72,10,64,14.5,15.3,13.5,00000
10.0,33.0,67.0,951,06,01,  Lafa Para,546,373,293,170,253,203,59.4,63.3,55.5,00000
10.0,33.0,67.0,951,07,01,  Goyabanda,247,91,139,43,108,48,73.1,76.4,69.2,00000
10.0,33.0,67.0,951,08,01,  Poli Para,309,649,162,313,147,336,32.3,34.1,30.4,00000
10.0,33.0,67.0,951,09,01,  Bhelur Chak,154,148,89,72,65,76,51.0,55.3,46.1,00000
10.0,33.0,81.0,069,01,01,  Bagpal,336,375,184,163,152,212,47.3,53.0,41.8,00000
10.0,33.0,81.0,069,02,01,  Kali Pukur,102,107,53,47,49,60,48.8,53.0,45.0,00000
10.0,33.0,81.0,069,03,01,  Baluka Para,51,76,30,31,21,45,40.2,49.2,31.8,00000
10.0,33.0,81.0,086,01,01,  Bara Dighi,190,148,102,70,88,78,56.2,59.3,53.0,00000
10.0,33.0,81.0,086,02,01,  Madaimuri,157,272,86,132,71,140,36.6,39.4,33.6,00000
10.0,33.0,81.0,095,01,01,  Barahi,407,636,250,270,157,366,39.0,48.1,30.0,00000
10.0,33.0,81.0,095,02,01,  Chenchuria,128,186,74,86,54,100,40.8,46.3,35.1,00000
10.0,33.0,81.0,095,03,01,  Yanla,128,113,68,52,60,61,53.1,56.7,49.6,00000
10.0,33.0,81.0,268,01,01,  Chhota Nilahali,127,212,71,86,56,126,37.5,45.2,30.8,00000
10.0,33.0,81.0,268,02,01,  Barahi,138,215,73,96,65,119,39.1,43.2,35.3,00000
10.0,33.0,81.0,268,03,01,  Pora Para,86,143,44,56,42,87,37.6,44.0,32.6,00000
10.0,33.0,81.0,268,04,01,  Bhebra,105,239,54,113,51,126,30.5,32.3,28.8,00000
10.0,33.0,81.0,397,01,01,  Herenza,663,695,352,310,311,385,48.8,53.2,44.7,00000
10.0,33.0,81.0,397,02,01,  Parla,78,320,41,154,37,166,19.6,21.0,18.2,00000
10.0,33.0,81.0,423,01,01,  Jalanga,429,450,244,188,185,262,48.8,56.5,41.4,00000
10.0,33.0,81.0,423,02,01,  Kalaikuri,111,191,52,85,59,106,36.8,38.0,35.8,00000
10.0,33.0,81.0,441,01,01,  Kasiakuri,146,175,80,69,66,106,45.5,53.7,38.4,00000
10.0,33.0,81.0,441,02,01,  Shaharkuri,210,244,105,109,105,135,46.3,49.1,43.8,00000
10.0,33.0,81.0,449,01,01,  Zianagar,503,247,263,104,240,143,67.1,71.7,62.7,00000
10.0,33.0,81.0,449,02,01,  Chak Para,199,146,101,70,98,76,57.7,59.1,56.3,00000
10.0,33.0,81.0,449,03,01,  Khidir Para,648,535,338,252,310,283,54.8,57.3,52.3,00000
10.0,33.0,81.0,449,04,01,  Miah Para,396,354,196,143,200,211,52.8,57.8,48.7,00000
10.0,33.0,81.0,449,05,01,  Dighir Para,116,142,59,67,57,75,45.0,46.8,43.2,00000
10.0,33.0,81.0,449,06,01,  Jhalgharia,105,209,54,90,51,119,33.4,37.5,30.0,00000
10.0,33.0,81.0,449,07,01,  Sohagi Para,199,241,107,99,92,142,45.2,51.9,39.3,00000
10.0,40.0,11.0,063,01,01,  Balia Dighi,1056,1637,567,768,489,869,39.2,42.5,36.0,00000
10.0,40.0,11.0,063,02,01,  Kolakapa,798,1492,448,725,350,767,34.8,38.2,31.3,00000
10.0,40.0,11.0,063,03,01,  Dari Para,344,613,186,288,158,325,35.9,39.2,32.7,00000
10.0,40.0,11.0,063,04,01,  Malandanga,1372,1910,740,905,632,1005,41.8,45.0,38.6,00000
10.0,40.0,11.0,063,05,01,  Sonamua,418,554,223,249,195,305,43.0,47.2,39.0,00000
10.0,40.0,11.0,063,06,01,  Kutamahin,468,572,242,284,226,288,45.0,46.0,44.0,00000
10.0,40.0,11.0,442,01,01,  Kalaihata,2479,3447,1288,1621,1191,1826,41.8,44.3,39.5,00000
10.0,40.0,11.0,442,02,01,  Tollatola,1370,1703,730,814,640,889,44.6,47.3,41.9,00000
10.0,40.0,17.0,523,01,01,  Purba Krishna Chandrapur,616,1082,328,518,288,564,36.3,38.8,33.8,00000
10.0,40.0,17.0,523,02,01,  Paschim Krishna Chandrapur,886,1156,499,531,387,625,43.4,48.4,38.2,00000
10.0,40.0,17.0,954,01,01,  Uttar Ujgram,932,1059,487,506,445,553,46.8,49.0,44.6,00000
10.0,40.0,17.0,954,02,01,  Dakshin Ujgram,1037,1421,558,643,479,778,42.2,46.5,38.1,00000
10.0,40.0,27.0,103,01,01,  Beguni,1383,1382,673,651,710,731,50.0,50.8,49.3,00000
10.0,40.0,27.0,103,02,01,  Bhuligari,910,733,463,346,447,387,55.4,57.2,53.6,00000
10.0,40.0,27.0,103,03,01,  Kaludanga,382,412,176,202,206,210,48.1,46.6,49.5,00000
10.0,40.0,27.0,281,01,01,  Katinia (Dakshinpara),196,165,92,57,104,108,54.3,61.7,49.1,00000
10.0,40.0,27.0,281,02,01,  Durgahata,767,1332,369,633,398,699,36.5,36.8,36.3,00000
10.0,40.0,27.0,281,03,01,  Lalkha Para,378,697,214,318,164,379,35.2,40.2,30.2,00000
10.0,40.0,27.0,281,04,01,  Solartair,256,534,134,239,122,295,32.4,35.9,29.3,00000
10.0,40.0,27.0,281,05,01,  Dargahtali,94,263,47,120,47,143,26.3,28.1,24.7,00000
10.0,40.0,27.0,281,06,01,  Pakurtali,100,161,56,72,44,89,38.3,43.8,33.1,00000
10.0,40.0,27.0,281,07,01,  Matianchhara,134,256,74,119,60,137,34.4,38.3,30.5,00000
10.0,40.0,27.0,281,08,01,  Baithabhanga,1459,1427,743,615,716,812,50.6,54.7,46.9,00000
10.0,40.0,27.0,281,09,01,  Thakurber,103,137,59,54,44,83,42.9,52.2,34.6,00000
10.0,40.0,27.0,281,10,01,  Garerbari,787,985,433,428,354,557,44.4,50.3,38.9,00000
10.0,40.0,27.0,281,11,01,  Ghosh Para,210,288,108,138,102,150,42.2,43.9,40.5,00000
10.0,40.0,27.0,281,12,01,  Uttar Kaitinia,286,394,162,182,124,212,42.1,47.1,36.9,00000
10.0,40.0,27.0,281,13,01,  Majhi Para,129,273,70,125,59,148,32.1,35.9,28.5,00000
10.0,40.0,27.0,379,01,01,  Uttar Hatibandha,623,542,319,258,304,284,53.5,55.3,51.7,00000
10.0,40.0,27.0,379,02,01,  Dakshin Hatibandha,988,981,529,434,459,547,50.2,54.9,45.6,00000
10.0,40.0,27.0,379,03,01,  Thakur Para,92,261,47,124,45,137,26.1,27.5,24.7,00000
10.0,40.0,27.0,379,04,01,  Ghosh Para,95,214,51,107,44,107,30.7,32.3,29.1,00000
10.0,40.0,27.0,730,01,01,  Panir Para,589,885,307,416,282,469,40.0,42.5,37.5,00000
10.0,40.0,27.0,730,02,01,  Naya Para,62,197,34,99,28,98,23.9,25.6,22.2,00000
10.0,40.0,27.0,730,03,01,  Panch Kaunia,372,496,176,255,196,241,42.9,40.8,44.9,00000
10.0,40.0,27.0,897,01,01,  Sildabari,1082,1012,559,472,523,540,51.7,54.2,49.2,00000
10.0,40.0,27.0,897,02,01,  Betuarkandi,294,447,140,209,154,238,39.7,40.1,39.3,00000
10.0,40.0,33.0,960,01,01,  Uttarpara,724,868,336,446,388,422,45.5,43.0,47.9,00000
10.0,40.0,33.0,960,02,01,  Dakshinpara,846,593,400,306,446,287,58.8,56.7,60.8,00000
10.0,40.0,47.0,109,01,01,  Bererghon,93,145,59,64,34,81,39.1,48.0,29.6,00000
10.0,40.0,47.0,109,02,01,  Badpara,192,273,107,131,85,142,41.3,45.0,37.4,00000
10.0,40.0,47.0,431,01,01,  Khurda Kagail,382,294,200,140,182,154,56.5,58.8,54.2,00000
10.0,40.0,47.0,431,02,01,  Dashkandi,197,386,94,189,103,197,33.8,33.2,34.3,00000
10.0,40.0,47.0,431,03,01,  Chandipur,68,7,36,1,32,6,90.7,97.3,84.2,00000
10.0,40.0,47.0,431,04,01,  Bujruk Kagail,257,326,157,144,100,182,44.1,52.2,35.5,00000
10.0,40.0,47.0,431,05,01,  Pirpara,232,396,134,193,98,203,36.9,41.0,32.6,00000
10.0,40.0,47.0,431,06,01,  Beltala,489,579,265,275,224,304,45.8,49.1,42.4,00000
10.0,40.0,47.0,431,07,01,  Chak Rampur,148,123,89,61,59,62,54.6,59.3,48.8,00000
10.0,40.0,47.0,431,08,01,  Chak Kagail,215,238,105,130,110,108,47.5,44.7,50.5,00000
10.0,40.0,47.0,431,09,01,  Chak Tita,169,258,88,133,81,125,39.6,39.8,39.3,00000
10.0,40.0,47.0,431,10,01,  Chak Jamirabaria,35,60,18,33,17,27,36.8,35.3,38.6,00000
10.0,40.0,47.0,431,11,01,  Dari Para,243,360,127,176,116,184,40.3,41.9,38.7,00000
10.0,40.0,47.0,431,12,01,  Telkupi,532,477,283,230,249,247,52.7,55.2,50.2,00000
10.0,40.0,47.0,431,13,01,  Ekbaria,143,234,80,114,63,120,37.9,41.2,34.4,00000
10.0,40.0,47.0,431,14,01,  Hijla,448,571,231,265,217,306,44.0,46.6,41.5,00000
10.0,40.0,54.0,580,01,01,  Paschim Mahishaban,1573,2098,821,1043,752,1055,42.8,44.0,41.6,00000
10.0,40.0,54.0,580,02,01,  Purba Mahishaban,2205,2395,1174,1159,1031,1236,47.9,50.3,45.5,00000
10.0,40.0,54.0,609,01,01,  Uttar Maria,1579,1545,834,726,745,819,50.5,53.5,47.6,00000
10.0,40.0,54.0,609,02,01,  Dakshin Maria,888,804,486,405,402,399,52.5,54.5,50.2,00000
10.0,40.0,54.0,822,01,01,  Ranir Para,965,1325,514,644,451,681,42.1,44.4,39.8,00000
10.0,40.0,54.0,822,02,01,  Par Ranir Para,907,1588,437,793,470,795,36.4,35.5,37.2,00000
10.0,40.0,54.0,908,01,01,  Dari Sonakania,268,285,162,131,106,154,48.5,55.3,40.8,00000
10.0,40.0,54.0,908,02,01,  Sonakania,752,1137,385,566,367,571,39.8,40.5,39.1,00000
10.0,40.0,61.0,362,01,01,  Hamidpur (Part),1092,437,533,192,559,245,71.4,73.5,69.5,00000
10.0,40.0,61.0,362,02,01,  Doar Para,944,1120,480,556,464,564,45.7,46.3,45.1,00000
10.0,40.0,61.0,782,01,01,  Pratham Archhed,794,819,441,380,353,439,49.2,53.7,44.6,00000
10.0,40.0,61.0,782,02,01,  Madhyamar Cheo,493,638,248,304,245,334,43.6,44.9,42.3,00000
10.0,40.0,61.0,782,03,01,  Sonapur,339,232,179,100,160,132,59.4,64.2,54.8,00000
10.0,40.0,67.0,391,01,01,  Chhota Itali,632,912,294,452,338,460,40.9,39.4,42.4,00000
10.0,40.0,67.0,391,02,01,  Bara Itali,367,713,186,348,181,365,34.0,34.8,33.2,00000
10.0,40.0,67.0,672,01,01,  Nasipur,1021,1433,540,726,481,707,41.6,42.7,40.5,00000
10.0,40.0,67.0,672,02,01,  Nijgram,1030,1369,523,670,507,699,42.9,43.8,42.0,00000
10.0,40.0,67.0,672,03,01,  Horar Dighi,1049,1399,520,679,529,720,42.9,43.4,42.4,00000
10.0,40.0,67.0,672,04,01,  Kolarbari,791,1228,378,625,413,603,39.2,37.7,40.6,00000
10.0,40.0,67.0,672,05,01,  Majhbari,978,954,482,482,496,472,50.6,50.0,51.2,00000
10.0,40.0,67.0,672,06,01,  Baghbari,1406,1935,693,897,713,1038,42.1,43.6,40.7,00000
10.0,40.0,67.0,672,07,01,  Beltali,94,263,49,129,45,134,26.3,27.5,25.1,00000
10.0,40.0,74.0,028,01,01,  Akanda Para,478,408,282,156,196,252,54.0,64.4,43.8,00000
10.0,40.0,74.0,028,02,01,  Naya Para,126,134,62,63,64,71,48.5,49.6,47.4,00000
10.0,40.0,74.0,132,01,01,  Buruj,1451,1283,680,593,771,690,53.1,53.4,52.8,00000
10.0,40.0,74.0,132,02,01,  Shalukgari,617,585,293,254,324,331,51.3,53.6,49.5,00000
10.0,40.0,74.0,149,01,01,  Chak Doar,420,461,232,202,188,259,47.7,53.5,42.1,00000
10.0,40.0,74.0,149,02,01,  Sanar Pukur,116,260,69,132,47,128,30.9,34.3,26.9,00000
10.0,40.0,74.0,241,01,01,  Dhananjoy,810,1015,421,502,389,513,44.4,45.6,43.1,00000
10.0,40.0,74.0,241,02,01,  Nischintapur,258,272,145,117,113,155,48.7,55.3,42.2,00000
10.0,40.0,74.0,241,03,01,  Tarapakhi,168,220,88,108,80,112,43.3,44.9,41.7,00000
10.0,40.0,74.0,241,04,01,  Sonapur,180,221,83,108,97,113,44.9,43.5,46.2,00000
10.0,40.0,74.0,241,05,01,  Kaludanga,697,627,361,285,336,342,52.6,55.9,49.6,00000
10.0,40.0,74.0,241,06,01,  Bil Sharalia,147,170,82,71,65,99,46.4,53.6,39.6,00000
10.0,40.0,74.0,276,01,01,  Doar,68,226,37,111,31,115,23.1,25.0,21.2,00000
10.0,40.0,74.0,276,02,01,  Khira Para,114,215,49,102,65,113,34.7,32.5,36.5,00000
10.0,40.0,74.0,276,03,01,  Mahish Batan,241,215,140,85,101,130,52.9,62.2,43.7,00000
10.0,40.0,74.0,276,04,01,  Kashihata,129,44,74,16,55,28,74.6,82.2,66.3,00000
10.0,40.0,74.0,276,05,01,  Chamur Para,604,402,345,159,259,243,60.0,68.5,51.6,00000
10.0,40.0,74.0,276,06,01,  Kashaber Para,338,584,198,270,140,314,36.7,42.3,30.8,00000
10.0,40.0,74.0,276,07,01,  Trimohani,187,237,95,102,92,135,44.1,48.2,40.5,00000
10.0,40.0,74.0,276,08,01,  Amtala Para,190,311,111,137,79,174,37.9,44.8,31.2,00000
10.0,40.0,74.0,276,09,01,  Dehi Doar,323,391,186,177,137,214,45.2,51.2,39.0,00000
10.0,40.0,74.0,408,01,01,  Putiarghon,198,113,110,39,88,74,63.7,73.8,54.3,00000
10.0,40.0,74.0,408,02,01,  Jathaldia,1055,688,500,301,555,387,60.5,62.4,58.9,00000
10.0,40.0,74.0,425,01,01,  Dari Para,151,165,84,74,67,91,47.8,53.2,42.4,00000
10.0,40.0,74.0,425,02,01,  Tair Para(Bokshipara Khan,354,569,179,289,175,280,38.4,38.2,38.5,00000
10.0,40.0,74.0,425,03,01,  Kalyanpur (Patarpara),128,62,76,35,52,27,67.4,68.5,65.8,00000
10.0,40.0,74.0,425,04,01,  Kadamtali,864,1018,444,495,420,523,45.9,47.3,44.5,00000
10.0,40.0,74.0,678,01,01,  Nepaltali,905,1034,465,470,440,564,46.7,49.7,43.8,00000
10.0,40.0,74.0,678,02,01,  Dakshin Saratali Para,320,261,155,128,165,133,55.1,54.8,55.4,00000
10.0,40.0,74.0,678,03,01,  Ishwarpur,343,278,163,123,180,155,55.2,57.0,53.7,00000
10.0,40.0,74.0,678,04,01,  Sat Tikri,259,234,130,108,129,126,52.5,54.6,50.6,00000
10.0,40.0,74.0,678,05,01,  Shahbazpur,204,163,104,67,100,96,55.6,60.8,51.0,00000
10.0,40.0,74.0,678,06,01,  Latimarghon,273,257,129,126,144,131,51.5,50.6,52.4,00000
10.0,40.0,74.0,684,01,01,  Nij Kakra,424,420,225,178,199,242,50.2,55.8,45.1,00000
10.0,40.0,74.0,684,02,01,  Dalir Char,527,491,271,218,256,273,51.8,55.4,48.4,00000
10.0,40.0,74.0,684,03,01,  Uttar Saratali,227,411,117,190,110,221,35.6,38.1,33.2,00000
10.0,40.0,74.0,684,04,01,  Kajla Para,403,288,201,126,202,162,58.3,61.5,55.5,00000
10.0,40.0,74.0,736,01,01,  Par Kakra,545,678,307,305,238,373,44.6,50.2,39.0,00000
10.0,40.0,74.0,736,02,01,  Maynatala,402,310,201,144,201,166,56.5,58.3,54.8,00000
10.0,40.0,81.0,805,01,01,  Uttarpara,743,1147,360,572,383,575,39.3,38.6,40.0,00000
10.0,40.0,81.0,805,02,01,  Tejpara,1248,1339,627,625,621,714,48.2,50.1,46.5,00000
10.0,40.0,81.0,805,03,01,  Majh Para,796,1252,384,597,412,655,38.9,39.1,38.6,00000
10.0,40.0,81.0,805,04,01,  Nisu Para,726,962,350,446,376,516,43.0,44.0,42.2,00000
10.0,40.0,81.0,805,05,01,  Suba Para,592,1169,312,569,280,600,33.6,35.4,31.8,00000
10.0,40.0,81.0,839,01,01,  Sagatia,621,755,329,341,292,414,45.1,49.1,41.4,00000
10.0,40.0,81.0,839,02,01,  Ghon Sagatia,334,637,167,319,167,318,34.4,34.4,34.4,00000
10.0,40.0,81.0,839,03,01,  Hapania Sagatia,325,471,153,227,172,244,40.8,40.3,41.3,00000
10.0,40.0,88.0,322,01,01,  Gazaria,569,344,290,147,279,197,62.3,66.4,58.6,00000
10.0,40.0,88.0,322,02,01,  Laskari Para,439,633,235,310,204,323,41.0,43.1,38.7,00000
10.0,40.0,88.0,402,01,01,  Jamirbaria,739,1222,424,546,315,676,37.7,43.7,31.8,00000
10.0,40.0,88.0,402,02,01,  Hatkhola Para,99,230,65,116,34,114,30.1,35.9,23.0,00000
10.0,40.0,88.0,402,03,01,  Fakir Para,25,244,14,119,11,125,9.3,10.5,8.1,00000
10.0,40.0,88.0,402,04,01,  Karim Para,325,393,189,179,136,214,45.3,51.4,38.9,00000
10.0,40.0,88.0,511,01,01,  Natur Para,369,449,202,210,167,239,45.1,49.0,41.1,00000
10.0,40.0,88.0,511,02,01,  Kurir Para,131,178,80,82,51,96,42.4,49.4,34.7,00000
10.0,40.0,88.0,511,03,01,  Sukhan Pukur Bandar,269,90,152,44,117,46,74.9,77.6,71.8,00000
10.0,40.0,88.0,615,01,01,  Trimohani,198,109,92,51,106,58,64.5,64.3,64.6,00000
10.0,40.0,88.0,615,02,01,  Masundi,236,356,112,161,124,195,39.9,41.0,38.9,00000
10.0,40.0,88.0,615,03,01,  Keshaber Para,175,223,100,99,75,124,44.0,50.3,37.7,00000
10.0,40.0,88.0,615,04,01,  Pather Para,106,214,57,111,49,103,33.1,33.9,32.2,00000
10.0,40.0,88.0,615,05,01,  Saha Para,430,610,235,288,195,322,41.3,44.9,37.7,00000
10.0,40.0,88.0,615,06,01,  Nayapara,196,369,111,180,85,189,34.7,38.1,31.0,00000
10.0,40.0,88.0,856,01,01,  Chhaygharia,210,430,123,194,87,236,32.8,38.8,26.9,00000
10.0,40.0,88.0,856,02,01,  Bhangabari,193,168,94,73,99,95,53.5,56.3,51.0,00000
10.0,40.0,88.0,856,03,01,  Atapara,223,350,126,158,97,192,38.9,44.4,33.6,00000
10.0,40.0,88.0,856,04,01,  Sardhankuthi,466,446,250,207,216,239,51.1,54.7,47.5,00000
10.0,40.0,88.0,856,05,01,  Par Sardhankuthi,135,133,65,62,70,71,50.4,51.2,49.6,00000
10.0,40.0,88.0,920,01,01,  Sonarai,899,1388,467,699,432,689,39.3,40.1,38.5,00000
10.0,40.0,88.0,920,02,01,  Muchikhali,272,557,147,277,125,280,32.8,34.7,30.9,00000
10.0,54.0,13.0,101,01,01,  Bania Dighi,97,128,46,55,51,73,43.1,45.5,41.1,00000
10.0,54.0,13.0,101,02,01,  Junigari,109,146,47,68,62,78,42.7,40.9,44.3,00000
10.0,54.0,13.0,215,01,01,  Bir Kedar,584,602,311,264,273,338,49.2,54.1,44.7,00000
10.0,54.0,13.0,215,02,01,  Mirpara,260,175,145,71,115,104,59.8,67.1,52.5,00000
10.0,54.0,13.0,215,03,01,  Khar Chak,181,189,88,78,93,111,48.9,53.0,45.6,00000
10.0,54.0,13.0,215,04,01,  Kumar Para,117,160,60,71,57,89,42.2,45.8,39.0,00000
10.0,54.0,13.0,215,05,01,  Chak Baruna,50,115,23,55,27,60,30.3,29.5,31.0,00000
10.0,54.0,13.0,215,06,01,  Miah Para,64,58,36,30,28,28,52.5,54.5,50.0,00000
10.0,54.0,13.0,215,07,01,  Hazi Para,38,42,20,20,18,22,47.5,50.0,45.0,00000
10.0,54.0,13.0,215,08,01,  Fakir Para,209,318,101,158,108,160,39.7,39.0,40.3,00000
10.0,54.0,13.0,215,09,01,  Chak Mamudpur,200,148,98,82,102,66,57.5,54.4,60.7,00000
10.0,54.0,13.0,215,10,01,  Jangal Para,183,275,99,125,84,150,40.0,44.2,35.9,00000
10.0,54.0,13.0,215,11,01,  Sadar Para,168,178,81,87,87,91,48.6,48.2,48.9,00000
10.0,54.0,13.0,215,12,01,  Athalia,205,125,106,61,99,64,62.1,63.5,60.7,00000
10.0,54.0,13.0,215,13,01,  Jinnah Para,198,175,109,75,89,100,53.1,59.2,47.1,00000
10.0,54.0,13.0,215,14,01,  Naya Para,398,416,207,201,191,215,48.9,50.7,47.0,00000
10.0,54.0,13.0,215,15,01,  Jokar Para,590,418,281,207,309,211,58.5,57.6,59.4,00000
10.0,54.0,13.0,215,16,01,  Chhota Kasimala,160,176,95,89,65,87,47.6,51.6,42.8,00000
10.0,54.0,13.0,215,17,01,  Bagho Para,53,338,24,178,29,160,13.6,11.9,15.3,00000
10.0,54.0,13.0,557,01,01,  Kazir Para,547,671,287,324,260,347,44.9,47.0,42.8,00000
10.0,54.0,13.0,557,02,01,  Satuar Para,203,178,109,82,94,96,53.3,57.1,49.5,00000
10.0,54.0,13.0,671,01,01,  Mahish Bathan,166,44,78,25,88,19,79.0,75.7,82.2,00000
10.0,54.0,13.0,671,02,01,  Guliar Para,397,173,207,69,190,104,69.6,75.0,64.6,00000
10.0,54.0,13.0,701,01,01,  Malibari,210,168,114,78,96,90,55.6,59.4,51.6,00000
10.0,54.0,13.0,701,02,01,  Jaga Para,51,22,30,7,21,15,69.9,81.1,58.3,00000
10.0,54.0,13.0,713,01,01,  Mallikpur,131,198,70,97,61,101,39.8,41.9,37.7,00000
10.0,54.0,13.0,713,02,01,  Jhenai,420,280,231,124,189,156,60.0,65.1,54.8,00000
10.0,54.0,19.0,059,01,01,  Atasi,312,332,152,140,160,192,48.4,52.1,45.5,00000
10.0,54.0,19.0,059,02,01,  Tekunti,183,83,92,32,91,51,68.8,74.2,64.1,00000
10.0,54.0,19.0,263,01,01,  Chakdaha,393,204,199,86,194,118,65.8,69.8,62.2,00000
10.0,54.0,19.0,263,02,01,  Goal Para,44,36,25,18,19,18,55.0,58.1,51.4,00000
10.0,54.0,19.0,341,01,01,  Dhanpuja,280,191,136,97,144,94,59.4,58.4,60.5,00000
10.0,54.0,19.0,341,02,01,  Pagoil,490,268,228,82,262,186,64.6,73.5,58.5,00000
10.0,54.0,19.0,353,01,01,  Bara Dhekra,307,93,167,27,140,66,76.8,86.1,68.0,00000
10.0,54.0,19.0,353,02,01,  Chhota Dhekra,92,111,61,38,31,73,45.3,61.6,29.8,00000
10.0,54.0,19.0,377,01,01,  Durgapur,965,881,476,444,489,437,52.3,51.7,52.8,00000
10.0,54.0,19.0,377,02,01,  Purushottampur,292,386,152,185,140,201,43.1,45.1,41.1,00000
10.0,54.0,19.0,377,03,01,  Chak Jagatpur,253,122,131,62,122,60,67.5,67.9,67.0,00000
10.0,54.0,19.0,377,04,01,  Singar Para,295,336,146,166,149,170,46.8,46.8,46.7,00000
10.0,54.0,19.0,425,01,01,  Haripur,22,102,12,54,10,48,17.7,18.2,17.2,00000
10.0,54.0,19.0,425,02,01,  Sitlai,109,126,64,50,45,76,46.4,56.1,37.2,00000
10.0,54.0,19.0,863,01,01,  Protappur,455,345,235,164,220,181,56.9,58.9,54.9,00000
10.0,54.0,19.0,863,02,01,  Karigar Para,322,212,165,94,157,118,60.3,63.7,57.1,00000
10.0,54.0,19.0,863,03,01,  Bamuja,450,291,240,129,210,162,60.7,65.0,56.5,00000
10.0,54.0,19.0,863,04,01,  Thal Para,232,114,127,45,105,69,67.1,73.8,60.3,00000
10.0,54.0,19.0,863,05,01,  Arobari,270,307,154,143,116,164,46.8,51.9,41.4,00000
10.0,54.0,19.0,863,06,01,  Fakir Para,195,125,98,59,97,66,60.9,62.4,59.5,00000
10.0,54.0,19.0,863,07,01,  Singra Para,527,214,285,90,242,124,71.1,76.0,66.1,00000
10.0,54.0,19.0,863,08,01,  Chandpur,307,199,167,95,140,104,60.7,63.7,57.4,00000
10.0,54.0,19.0,863,09,01,  Nawda Para,313,131,159,59,154,72,70.5,72.9,68.1,00000
10.0,54.0,19.0,863,10,01,  Puiangari,124,75,61,30,63,45,62.3,67.0,58.3,00000
10.0,54.0,28.0,011,01,01,  Achilahar,168,54,87,22,81,32,75.7,79.8,71.7,00000
10.0,54.0,28.0,011,02,01,  Naya Para,84,56,45,25,39,31,60.0,64.3,55.7,00000
10.0,54.0,28.0,095,01,01,  Bandaikhara,731,691,391,342,340,349,51.4,53.3,49.3,00000
10.0,54.0,28.0,095,02,01,  Ratnagari,201,131,112,56,89,75,60.5,66.7,54.3,00000
10.0,54.0,28.0,095,03,01,  Goal Para,216,79,123,38,93,41,73.2,76.4,69.4,00000
10.0,54.0,28.0,449,01,01,  Jamgaon,300,538,148,263,152,275,35.8,36.0,35.6,00000
10.0,54.0,28.0,449,02,01,  Boal Chapar,503,275,268,122,235,153,64.7,68.7,60.6,00000
10.0,54.0,28.0,449,03,01,  Dakshin Jamgram,327,374,149,189,178,185,46.6,44.1,49.0,00000
10.0,54.0,28.0,449,04,01,  Satar Para,79,143,29,74,50,69,35.6,28.2,42.0,00000
10.0,54.0,28.0,449,05,01,  Dalkatra,16,48,7,24,9,24,25.0,22.6,27.3,00000
10.0,54.0,28.0,527,01,01,  Karanja Para,251,376,131,179,120,197,40.0,42.3,37.9,00000
10.0,54.0,28.0,527,02,01,  Kasimala,113,176,49,71,64,105,39.1,40.8,37.9,00000
10.0,54.0,28.0,527,03,01,  Telis Para,175,86,90,45,85,41,67.0,66.7,67.5,00000
10.0,54.0,28.0,527,04,01,  Matia Pukur,48,61,18,31,30,30,44.0,36.7,50.0,00000
10.0,54.0,28.0,587,01,01,  Khurasatti,320,287,151,134,169,153,52.7,53.0,52.5,00000
10.0,54.0,28.0,587,02,01,  Goal Para,45,24,23,8,22,16,65.2,74.2,57.9,00000
10.0,54.0,28.0,587,03,01,  Cheng Garia,64,128,43,63,21,65,33.3,40.6,24.4,00000
10.0,54.0,28.0,593,01,01,  Krishnapur,127,117,76,53,51,64,52.0,58.9,44.3,00000
10.0,54.0,28.0,593,02,01,  Sonar Para,246,329,122,168,124,161,42.8,42.1,43.5,00000
10.0,54.0,28.0,593,03,01,  Lohar Para,143,185,58,86,85,99,43.6,40.3,46.2,00000
10.0,54.0,28.0,593,04,01,  Mirpara,40,62,22,29,18,33,39.2,43.1,35.3,00000
10.0,54.0,28.0,911,01,01,  Santa,648,666,348,318,300,348,49.3,52.3,46.3,00000
10.0,54.0,28.0,911,02,01,  Sidal,532,667,285,323,247,344,44.4,46.9,41.8,00000
10.0,54.0,28.0,935,01,01,  Siala Bhabanipur,215,165,116,68,99,97,56.6,63.0,50.5,00000
10.0,54.0,28.0,935,02,01,  Amra Para,58,75,33,35,25,40,43.6,48.5,38.5,00000
10.0,54.0,28.0,935,03,01,  Kali Para,36,33,24,13,12,20,52.2,64.9,37.5,00000
10.0,54.0,38.0,575,01,01,  Khajlal,798,654,427,276,371,378,55.0,60.7,49.5,00000
10.0,54.0,38.0,575,02,01,  Paik Para,237,108,122,50,115,58,68.7,70.9,66.5,00000
10.0,54.0,38.0,665,01,01,  Maheshpur,827,445,427,197,400,248,65.0,68.4,61.7,00000
10.0,54.0,38.0,665,02,01,  Maharabani,314,238,167,94,147,144,56.9,64.0,50.5,00000
10.0,54.0,38.0,815,01,01,  Pan Dighi,167,136,87,63,80,73,55.1,58.0,52.3,00000
10.0,54.0,38.0,815,02,01,  Tal Dighi,118,103,62,45,56,58,53.4,57.9,49.1,00000
10.0,54.0,47.0,155,01,01,  Chhota Bhadahar,453,408,241,180,212,228,52.6,57.2,48.2,00000
10.0,54.0,47.0,155,02,01,  Bara Bhadahar,473,475,244,229,229,246,49.9,51.6,48.2,00000
10.0,54.0,47.0,155,03,01,  Naya Para,145,327,82,162,63,165,30.7,33.6,27.6,00000
10.0,54.0,47.0,299,01,01,  Dihi Damgara,295,257,166,111,129,146,53.4,59.9,46.9,00000
10.0,54.0,47.0,299,02,01,  Sukhangari,78,262,39,129,39,133,22.9,23.2,22.7,00000
10.0,54.0,47.0,299,03,01,  Kaura,232,252,133,108,99,144,47.9,55.2,40.7,00000
10.0,54.0,47.0,485,01,01,  Ghon Para,389,295,202,135,187,160,56.9,59.9,53.9,00000
10.0,54.0,47.0,485,02,01,  Mirpara,214,186,116,82,98,104,53.5,58.6,48.5,00000
10.0,54.0,47.0,485,03,01,  Dakshin Hindu Para,85,150,45,74,40,76,36.2,37.8,34.5,00000
10.0,54.0,47.0,485,04,01,  Paik Para,172,230,83,116,89,114,42.8,41.7,43.8,00000
10.0,54.0,47.0,485,05,01,  Thot Para,327,248,178,113,149,135,56.9,61.2,52.5,00000
10.0,54.0,47.0,485,06,01,  Kumar Para,391,247,209,107,182,140,61.3,66.1,56.5,00000
10.0,54.0,47.0,485,07,01,  Dewan Pukur,141,98,88,34,53,64,59.0,72.1,45.3,00000
10.0,54.0,47.0,485,08,01,  Khamar Para,299,240,154,106,145,134,55.5,59.2,52.0,00000
10.0,54.0,47.0,485,09,01,  Talpukur,156,112,99,43,57,69,58.2,69.7,45.2,00000
10.0,54.0,47.0,485,10,01,  Nata Para,377,443,199,206,178,237,46.0,49.1,42.9,00000
10.0,54.0,47.0,485,11,01,  Majh Para,316,76,165,31,151,45,80.6,84.2,77.0,00000
10.0,54.0,47.0,485,12,01,  Nowda Para,255,335,122,163,133,172,43.2,42.8,43.6,00000
10.0,54.0,47.0,485,13,01,  Uttar Kunni Para,126,163,68,77,58,86,43.6,46.9,40.3,00000
10.0,54.0,47.0,485,14,01,  Dakshin Kunni Para,756,783,397,354,359,429,49.1,52.9,45.6,00000
10.0,54.0,47.0,803,01,01,  Uttarpara,331,403,182,185,149,218,45.1,49.6,40.6,00000
10.0,54.0,47.0,803,02,01,  Dakshinpara,450,303,218,131,232,172,59.8,62.5,57.4,00000
10.0,54.0,47.0,839,01,01,  Papra Para,389,496,223,229,166,267,44.0,49.3,38.3,00000
10.0,54.0,47.0,839,02,01,  Fakir Para,202,376,105,173,97,203,34.9,37.8,32.3,00000
10.0,54.0,47.0,839,03,01,  Hindu Para,261,219,153,90,108,129,54.4,63.0,45.6,00000
10.0,54.0,47.0,839,04,01,  Dakshinpara,528,425,272,198,256,227,55.4,57.9,53.0,00000
10.0,54.0,47.0,839,05,01,  Chak Para,336,342,175,158,161,184,49.6,52.6,46.7,00000
10.0,54.0,47.0,839,06,01,  Janjar Para,110,232,47,126,63,106,32.2,27.2,37.3,00000
10.0,54.0,57.0,023,01,01,  Aghor,726,800,386,393,340,407,47.6,49.6,45.5,00000
10.0,54.0,57.0,023,02,01,  Shahargari,227,201,122,84,105,117,53.0,59.2,47.3,00000
10.0,54.0,57.0,023,03,01,  Palla Para,273,252,143,116,130,136,52.0,55.2,48.9,00000
10.0,54.0,57.0,419,01,01,  Gurbisa,511,727,271,328,240,399,41.3,45.2,37.6,00000
10.0,54.0,57.0,419,02,01,  Kaigari,229,227,121,110,108,117,50.2,52.4,48.0,00000
10.0,54.0,57.0,719,01,01,  Matihas,379,274,200,121,179,153,58.0,62.3,53.9,00000
10.0,54.0,57.0,719,02,01,  Indukhur,413,261,227,112,186,149,61.3,67.0,55.5,00000
10.0,54.0,57.0,827,01,01,  Paphara,288,356,147,155,141,201,44.7,48.7,41.2,00000
10.0,54.0,57.0,827,02,01,  Sinduail,216,340,104,167,112,173,38.8,38.4,39.3,00000
10.0,54.0,57.0,893,01,01,  Sabanpur,421,638,209,314,212,324,39.8,40.0,39.6,00000
10.0,54.0,57.0,893,02,01,  Hatur Para,678,474,376,185,302,289,58.9,67.0,51.1,00000
10.0,54.0,66.0,089,01,01,  Bakhara,298,268,146,140,152,128,52.7,51.0,54.3,00000
10.0,54.0,66.0,089,02,01,  Chak Bakhara,163,129,84,68,79,61,55.8,55.3,56.4,00000
10.0,54.0,66.0,113,01,01,  Durbagari,191,359,105,181,86,178,34.7,36.7,32.6,00000
10.0,54.0,66.0,113,02,01,  Bara Mahar,542,558,274,289,268,269,49.3,48.7,49.9,00000
10.0,54.0,66.0,311,01,01,  Dehar,218,266,117,128,101,138,45.0,47.8,42.3,00000
10.0,54.0,66.0,311,02,01,  Palason,152,130,80,55,72,75,53.9,59.3,49.0,00000
10.0,54.0,66.0,437,01,01,  Isabpur,422,346,214,160,208,186,54.9,57.2,52.8,00000
10.0,54.0,66.0,437,02,01,  Pugail,417,287,220,138,197,149,59.2,61.5,56.9,00000
10.0,54.0,66.0,959,01,01,  Sitlai,368,387,187,188,181,199,48.7,49.9,47.6,00000
10.0,54.0,66.0,959,02,01,  Dalgara,173,151,89,64,84,87,53.4,58.2,49.1,00000
10.0,54.0,76.0,209,01,01,  Binodi,353,337,195,158,158,179,51.2,55.2,46.9,00000
10.0,54.0,76.0,209,02,01,  Chak Binodi,145,83,76,34,69,49,63.6,69.1,58.5,00000
10.0,54.0,76.0,359,01,01,  Dodai,129,190,60,99,69,91,40.4,37.7,43.1,00000
10.0,54.0,76.0,359,02,01,  Pinchukhur,178,218,104,101,74,117,44.9,50.7,38.7,00000
10.0,54.0,76.0,611,01,01,  Lahara Para,440,175,224,72,216,103,71.5,75.7,67.7,00000
10.0,54.0,76.0,611,02,01,  Ulkhar,392,232,211,95,181,137,62.8,69.0,56.9,00000
10.0,54.0,76.0,635,01,01,  Lohajal,828,531,447,241,381,290,60.9,65.0,56.8,00000
10.0,54.0,76.0,635,02,01,  Borail,323,137,176,58,147,79,70.2,75.2,65.0,00000
10.0,54.0,76.0,647,01,01,  Madhab Banka,141,263,76,133,65,130,34.9,36.4,33.3,00000
10.0,54.0,76.0,647,02,01,  Hatgari,132,107,64,53,68,54,55.2,54.7,55.7,00000
10.0,54.0,76.0,749,01,01,  Narahatta,1492,1138,793,584,699,554,56.7,57.6,55.8,00000
10.0,54.0,76.0,749,02,01,  Tentulia Para,169,106,79,46,90,60,61.5,63.2,60.0,00000
10.0,54.0,76.0,779,01,01,  Nischintapur,457,176,223,76,234,100,72.2,74.6,70.1,00000
10.0,54.0,76.0,779,02,01,  Chandani,191,122,103,57,88,65,61.0,64.4,57.5,00000
10.0,54.0,76.0,887,01,01,  Rautgari,68,124,33,62,35,62,35.4,34.7,36.1,00000
10.0,54.0,76.0,887,02,01,  Rustam Chapor,245,111,134,52,111,59,68.8,72.0,65.3,00000
10.0,54.0,76.0,887,03,01,  Chak Sudam,102,176,46,90,56,86,36.7,33.8,39.4,00000
10.0,54.0,85.0,203,01,01,  Pali Bhugail,816,1226,449,560,367,666,40.0,44.5,35.5,00000
10.0,54.0,85.0,203,02,01,  Khear Bhugail,457,621,241,288,216,333,42.4,45.6,39.3,00000
10.0,67.0,10.0,211,01,01,  Bisha,392,864,213,399,179,465,31.2,34.8,27.8,00000
10.0,67.0,10.0,211,02,01,  Tentulagari,90,180,55,80,35,100,33.3,40.7,25.9,00000
10.0,67.0,10.0,355,01,01,  Damrul,650,327,328,150,322,177,66.5,68.6,64.5,00000
10.0,67.0,10.0,355,02,01,  Goalgari,44,58,23,25,21,33,43.1,47.9,38.9,00000
10.0,67.0,10.0,673,01,01,  Malancha,36,97,18,45,18,52,27.1,28.6,25.7,00000
10.0,67.0,10.0,673,02,01,  Pantagari,58,47,30,20,28,27,55.2,60.0,50.9,00000
10.0,67.0,10.0,872,01,01,  Roypur,419,664,233,295,186,369,38.7,44.1,33.5,00000
10.0,67.0,10.0,872,02,01,  Betgari,43,223,21,107,22,116,16.2,16.4,15.9,00000
10.0,67.0,21.0,165,01,01,  Bhag Bazar-1,155,243,89,113,66,130,38.9,44.1,33.7,00000
10.0,67.0,21.0,165,02,01,  Bhag Bazar-2,209,170,112,79,97,91,55.1,58.6,51.6,00000
10.0,67.0,21.0,237,01,01,  Brikanchi,546,642,284,283,262,359,46.0,50.1,42.2,00000
10.0,67.0,21.0,237,02,01,  Chhota Kanchi,388,346,221,156,167,190,52.9,58.6,46.8,00000
10.0,67.0,21.0,317,01,01,  Chau Dighi-1,236,204,140,95,96,109,53.6,59.6,46.8,00000
10.0,67.0,21.0,317,02,01,  Chau Dighi-2,189,259,104,125,85,134,42.2,45.4,38.8,00000
10.0,67.0,21.0,618,01,01,  Sasinagar,387,447,213,200,174,247,46.4,51.6,41.3,00000
10.0,67.0,21.0,618,02,01,  Bara Kosas,131,228,73,109,58,119,36.5,40.1,32.8,00000
10.0,67.0,21.0,618,03,01,  Chhota Kosas,95,103,57,51,38,52,48.0,52.8,42.2,00000
10.0,67.0,21.0,698,01,01,  Matihas,967,765,535,331,432,434,55.8,61.8,49.9,00000
10.0,67.0,21.0,698,02,01,  Padma Pukur,222,180,117,82,105,98,55.2,58.8,51.7,00000
10.0,67.0,21.0,698,03,01,  Pana Pukur,162,217,83,103,79,114,42.7,44.6,40.9,00000
10.0,67.0,21.0,724,01,01,  Nagarkandi,369,68,201,28,168,40,84.4,87.8,80.8,00000
10.0,67.0,21.0,724,02,01,  Par Nagarkandi,125,287,77,145,48,142,30.3,34.7,25.3,00000
10.0,67.0,21.0,724,03,01,  Chatragari,73,59,44,29,29,30,55.3,60.3,49.2,00000
10.0,67.0,21.0,728,01,01,  Nagra,189,252,96,107,93,145,42.9,47.3,39.1,00000
10.0,67.0,21.0,728,02,01,  Thalta Para,110,60,66,22,44,38,64.7,75.0,53.7,00000
10.0,67.0,21.0,880,01,01,  Rustampur,475,413,276,184,199,229,53.5,60.0,46.5,00000
10.0,67.0,21.0,880,02,01,  Kaliagari,43,92,16,45,27,47,31.9,26.2,36.5,00000
10.0,67.0,31.0,249,01,01,  Chak Deola,104,159,65,64,39,95,39.5,50.4,29.1,00000
10.0,67.0,31.0,249,02,01,  Ratan Dighi,151,80,88,29,63,51,65.4,75.2,55.3,00000
10.0,67.0,31.0,313,01,01,  Chapila Para,145,425,86,206,59,219,25.4,29.5,21.2,00000
10.0,67.0,31.0,313,02,01,  Khidra Poly,163,223,86,116,77,107,42.2,42.6,41.8,00000
10.0,67.0,31.0,368,01,01,  Dasgram,541,768,294,355,247,413,41.3,45.3,37.4,00000
10.0,67.0,31.0,368,02,01,  Saluka Para,147,245,86,106,61,139,37.5,44.8,30.5,00000
10.0,67.0,31.0,465,01,01,  Gunbari,135,160,67,76,68,84,45.8,46.9,44.7,00000
10.0,67.0,31.0,465,02,01,  Char Sankarpur,219,128,123,60,96,68,63.1,67.2,58.5,00000
10.0,67.0,31.0,495,01,01,  Khandakar Para,184,268,102,116,82,152,40.7,46.8,35.0,00000
10.0,67.0,31.0,495,02,01,  Hushiar Para,206,86,110,40,96,46,70.5,73.3,67.6,00000
10.0,67.0,31.0,495,03,01,  Gandabpur,190,171,103,80,87,91,52.6,56.3,48.9,00000
10.0,67.0,31.0,495,04,01,  Beani Para,117,172,65,84,52,88,40.5,43.6,37.1,00000
10.0,67.0,31.0,495,05,01,  Purba Hazarki Para,577,740,322,335,255,405,43.8,49.0,38.6,00000
10.0,67.0,31.0,770,01,01,  Nundaha,249,85,129,38,120,47,74.6,77.2,71.9,00000
10.0,67.0,31.0,770,02,01,  Pania Dighi,88,104,45,50,43,54,45.8,47.4,44.3,00000
10.0,67.0,31.0,825,01,01,  Peng,121,201,70,84,51,117,37.6,45.5,30.4,00000
10.0,67.0,31.0,825,02,01,  Daspara,179,206,102,95,77,111,46.5,51.8,41.0,00000
10.0,67.0,31.0,825,03,01,  Dakshinpara Peng,351,591,212,263,139,328,37.3,44.6,29.8,00000
10.0,67.0,31.0,876,01,01,  Ridhail,517,498,279,213,238,285,50.9,56.7,45.5,00000
10.0,67.0,31.0,876,02,01,  Kaigari,258,207,165,79,93,128,55.5,67.6,42.1,00000
10.0,67.0,73.0,381,01,01,  Bara Derahar,318,365,173,145,145,220,46.6,54.4,39.7,00000
10.0,67.0,73.0,381,02,01,  Hat Pukuria,121,64,56,20,65,44,65.4,73.7,59.6,00000
10.0,67.0,84.0,029,01,01,  Palpara,207,200,107,93,100,107,50.9,53.5,48.3,00000
10.0,67.0,84.0,029,02,01,  Sekh Para,267,147,138,72,129,75,64.5,65.7,63.2,00000
10.0,67.0,84.0,453,01,01,  Gopalpur,557,719,315,323,242,396,43.7,49.4,37.9,00000
10.0,67.0,84.0,453,02,01,  Apusagari,195,104,104,42,91,62,65.2,71.2,59.5,00000
10.0,67.0,84.0,461,01,01,  Krishnapur,240,511,112,265,128,246,32.0,29.7,34.2,00000
10.0,67.0,84.0,461,02,01,  Gulia,120,321,71,148,49,173,27.2,32.4,22.1,00000
10.0,67.0,84.0,804,01,01,  Sardar Para,148,253,75,107,73,146,36.9,41.2,33.3,00000
10.0,67.0,84.0,804,02,01,  Hindu Para,115,231,73,105,42,126,33.2,41.0,25.0,00000
10.0,67.0,84.0,804,03,01,  Saha Para,116,289,62,132,54,157,28.6,32.0,25.6,00000
10.0,67.0,84.0,804,04,01,  Chak Para,102,218,40,103,62,115,31.9,28.0,35.0,00000
10.0,67.0,84.0,804,05,01,  Parghata,154,300,91,170,63,130,33.9,34.9,32.6,00000
10.0,67.0,84.0,804,06,01,  Ghona Para,86,255,37,126,49,129,25.2,22.7,27.5,00000
10.0,81.0,12.0,401,01,01,  Dhara Barsha,309,1594,206,777,103,817,16.2,21.0,11.2,00000
10.0,81.0,12.0,401,02,01,  Pachim Dhara Barsha,392,1712,240,837,152,875,18.6,22.3,14.8,00000
10.0,81.0,12.0,886,01,01,  Shankarpur,401,1350,253,651,148,699,22.9,28.0,17.5,00000
10.0,81.0,12.0,886,02,01,  U.Shankrpur,312,972,207,464,105,508,24.3,30.8,17.1,00000
10.0,81.0,25.0,165,01,01,  Uttar Ghughumari,942,1502,486,639,456,863,38.5,43.2,34.6,00000
10.0,81.0,25.0,165,02,01,  Dakshin Ghughumari,914,1936,477,897,437,1039,32.1,34.7,29.6,00000
10.0,81.0,25.0,165,03,01,  Char Chandan Baisha,1434,1944,749,857,685,1087,42.5,46.6,38.7,00000
10.0,81.0,31.0,408,01,01,  Char Domkandi,290,613,149,273,141,340,32.1,35.3,29.3,00000
10.0,81.0,31.0,408,02,01,  Domkandi,335,562,180,254,155,308,37.3,41.5,33.5,00000
10.0,81.0,31.0,408,03,01,  Dhapara,330,549,174,244,156,305,37.5,41.6,33.8,00000
10.0,81.0,31.0,408,04,01,  Sonatala,395,533,208,214,187,319,42.6,49.3,37.0,00000
10.0,81.0,31.0,408,05,01,  Faringa Para,75,219,45,102,30,117,25.5,30.6,20.4,00000
10.0,81.0,31.0,803,01,01,  Fulbari,2602,2907,1362,1372,1240,1535,47.2,49.8,44.7,00000
10.0,81.0,31.0,803,02,01,  Dargahtali,135,148,59,73,76,75,47.7,44.7,50.3,00000
10.0,81.0,31.0,803,03,01,  Majbari,635,756,322,326,313,430,45.7,49.7,42.1,00000
10.0,81.0,31.0,803,04,01,  Harina,779,1061,404,504,375,557,42.3,44.5,40.2,00000
10.0,81.0,31.0,803,05,01,  Baluatair,327,262,161,120,166,142,55.5,57.3,53.9,00000
10.0,81.0,31.0,803,06,01,  Amtali,553,720,288,354,265,366,43.4,44.9,42.0,00000
10.0,81.0,31.0,803,07,01,  Ramnagar,921,961,478,422,443,539,48.9,53.1,45.1,00000
10.0,81.0,31.0,803,08,01,  Char Ramnagar,270,501,148,237,122,264,35.0,38.4,31.6,00000
10.0,81.0,31.0,803,09,01,  Katakhali,957,1161,525,537,432,624,45.2,49.4,40.9,00000
10.0,81.0,31.0,803,10,01,  Chakibari,697,749,351,338,346,411,48.2,50.9,45.7,00000
10.0,81.0,31.0,803,11,01,  Goalbatan,242,329,118,154,124,175,42.4,43.4,41.5,00000
10.0,81.0,31.0,803,12,01,  Ramchandrapur,890,927,457,422,433,505,49.0,52.0,46.2,00000
10.0,81.0,31.0,803,13,01,  Bhita Para,362,264,182,120,180,144,57.8,60.3,55.6,00000
10.0,81.0,31.0,803,14,01,  Komra Dange Para,141,122,77,49,64,73,53.6,61.1,46.7,00000
10.0,81.0,31.0,803,15,01,  Nayapara,281,393,144,184,137,209,41.7,43.9,39.6,00000
10.0,81.0,37.0,076,01,01,  Char Barurbari,145,247,65,120,80,127,37.0,35.1,38.6,00000
10.0,81.0,37.0,076,02,01,  Nij Barurbari,367,300,186,127,181,173,55.0,59.4,51.1,00000
10.0,81.0,37.0,459,01,01,  Hat Sherpur,548,965,288,446,260,519,36.2,39.2,33.4,00000
10.0,81.0,37.0,459,02,01,  Naya Para,228,268,123,128,105,140,46.0,49.0,42.9,00000
10.0,81.0,37.0,459,03,01,  Karanja Para,190,346,117,165,73,181,35.4,41.5,28.7,00000
10.0,81.0,37.0,459,04,01,  Dhega Para,170,191,86,95,84,96,47.1,47.5,46.7,00000
10.0,81.0,37.0,561,01,01,  Khord Balali,1206,1275,643,553,563,722,48.6,53.8,43.8,00000
10.0,81.0,37.0,561,02,01,  Bhara Mara,71,116,39,52,32,64,38.0,42.9,33.3,00000
10.0,81.0,37.0,593,01,01,  Khapir Para,110,147,61,62,49,85,42.8,49.6,36.6,00000
10.0,81.0,37.0,593,02,01,  Dhar Bandho,76,182,46,78,30,104,29.5,37.1,22.4,00000
10.0,81.0,37.0,943,01,01,  Tajur Para,205,226,107,105,98,121,47.6,50.5,44.7,00000
10.0,81.0,37.0,943,02,01,  Char Tajur Para,57,109,30,51,27,58,34.3,37.0,31.8,00000
10.0,81.0,44.0,121,01,01,  Bibir Para,455,1043,256,466,199,577,30.4,35.5,25.6,00000
10.0,81.0,44.0,121,02,01,  Satbhita,296,617,141,268,155,349,32.4,34.5,30.8,00000
10.0,81.0,44.0,121,03,01,  Bagu Para,90,236,47,111,43,125,27.6,29.7,25.6,00000
10.0,81.0,44.0,516,01,01,  Kamalpur,841,1072,467,500,374,572,44.0,48.3,39.5,00000
10.0,81.0,44.0,516,02,01,  Ishamara,307,742,158,340,149,402,29.3,31.7,27.0,00000
10.0,81.0,44.0,516,03,01,  Ghedakhali,185,376,96,170,89,206,33.0,36.1,30.2,00000
10.0,81.0,44.0,574,01,01,  Kashahar,339,510,194,227,145,283,39.9,46.1,33.9,00000
10.0,81.0,44.0,574,02,01,  Kashiahata,245,322,125,137,120,185,43.2,47.7,39.3,00000
10.0,81.0,44.0,574,03,01,  Char Para,105,200,61,85,44,115,34.4,41.8,27.7,00000
10.0,81.0,44.0,574,04,01,  Nayapara,104,128,62,54,42,74,44.8,53.4,36.2,00000
10.0,81.0,44.0,771,01,01,  Pakurtali,567,1531,296,717,271,814,27.0,29.2,25.0,00000
10.0,81.0,44.0,771,02,01,  Dari Para,651,1347,349,642,302,705,32.6,35.2,30.0,00000
10.0,81.0,44.0,841,01,01,  Rauhadaha,663,912,337,419,326,493,42.1,44.6,39.8,00000
10.0,81.0,44.0,841,02,01,  Karitala,297,475,165,209,132,266,38.5,44.1,33.2,00000
10.0,81.0,44.0,841,03,01,  Haurakali,462,844,236,385,226,459,35.4,38.0,33.0,00000
10.0,81.0,44.0,841,04,01,  Fakir Para,178,304,105,120,73,184,36.9,46.7,28.4,00000
10.0,81.0,55.0,491,01,01,  Kazla,400,468,227,210,173,258,46.1,51.9,40.1,00000
10.0,81.0,55.0,491,02,01,  Mayurer Char,31,112,23,56,8,56,21.7,29.1,12.5,00000
10.0,81.0,55.0,491,03,01,  Baytona,30,110,19,56,11,54,21.4,25.3,16.9,00000
10.0,81.0,56.0,235,01,01,  Char Kumar Para,710,658,393,290,317,368,51.9,57.5,46.3,00000
10.0,81.0,56.0,235,02,01,  Madhaya Char Kumar Para,93,167,54,82,39,85,35.8,39.7,31.5,00000
10.0,81.0,56.0,235,03,01,  Uttar Charpara,140,167,74,73,66,94,45.6,50.3,41.3,00000
10.0,81.0,56.0,235,04,01,  Dakshin Char Kumar Para,207,74,114,27,93,47,73.7,80.9,66.4,00000
10.0,81.0,56.0,235,05,01,  Ulladanga,967,652,557,276,410,376,59.7,66.9,52.2,00000
10.0,81.0,56.0,235,06,01,  Mathura Para Bazar,226,85,121,38,105,47,72.7,76.1,69.1,00000
10.0,81.0,56.0,293,01,01,  Chhanpacha,981,2049,555,1019,426,1030,32.4,35.3,29.3,00000
10.0,81.0,56.0,293,02,01,  Paschim Chhanpacha,198,836,118,412,80,424,19.1,22.3,15.9,00000
10.0,81.0,63.0,369,01,01,  Debdanga,1107,1410,588,598,519,812,44.0,49.6,39.0,00000
10.0,81.0,63.0,369,02,01,  Machir Para,826,760,408,323,418,437,52.1,55.8,48.9,00000
10.0,81.0,63.0,369,03,01,  Par Debdanga,397,505,202,240,195,265,44.0,45.7,42.4,00000
10.0,81.0,63.0,605,01,01,  Bara Kutubpur,1587,2180,858,978,729,1202,42.1,46.7,37.8,00000
10.0,81.0,63.0,605,02,01,  Chhota Kutubpur,475,570,241,261,234,309,45.5,48.0,43.1,00000
10.0,81.0,63.0,605,03,01,  Sholartari,1157,1994,615,890,542,1104,36.7,40.9,32.9,00000
10.0,81.0,63.0,605,04,01,  Kajla,321,1205,193,567,128,638,21.0,25.4,16.7,00000
10.0,81.0,63.0,605,05,01,  Nij Karnibari,828,935,456,417,372,518,47.0,52.2,41.8,00000
10.0,81.0,63.0,605,06,01,  Dhalirkandi,772,721,391,293,381,428,51.7,57.2,47.1,00000
10.0,81.0,63.0,605,07,01,  Boyrakandi,484,484,263,198,221,286,50.0,57.0,43.6,00000
10.0,81.0,75.0,548,01,01,  Bheramara,119,155,60,70,59,85,43.4,46.2,41.0,00000
10.0,81.0,75.0,548,02,01,  Budarbhita,96,126,46,65,50,61,43.2,41.4,45.0,00000
10.0,81.0,75.0,548,03,01,  Uttar Deber Para,617,629,315,273,302,356,49.5,53.6,45.9,00000
10.0,81.0,75.0,548,04,01,  Dakshin Deber Para,246,272,125,118,121,154,47.5,51.4,44.0,00000
10.0,81.0,75.0,548,05,01,  Ganak Para,349,185,173,74,176,111,65.4,70.0,61.3,00000
10.0,81.0,75.0,548,06,01,  Tiuor Para,282,314,132,138,150,176,47.3,48.9,46.0,00000
10.0,81.0,75.0,548,07,01,  Gas Bari,144,165,89,60,55,105,46.6,59.7,34.4,00000
10.0,81.0,75.0,707,01,01,  Kuptala,1575,1750,855,791,720,959,47.4,51.9,42.9,00000
10.0,81.0,75.0,707,02,01,  Fakir Para,446,615,244,278,202,337,42.0,46.7,37.5,00000
10.0,81.0,75.0,707,03,01,  Char Harina,481,930,283,426,198,504,34.1,39.9,28.2,00000
10.0,81.0,75.0,707,04,01,  Narchi,1009,1213,530,546,479,667,45.4,49.3,41.8,00000
10.0,81.0,75.0,707,05,01,  Nayurgachha,292,517,134,243,158,274,36.1,35.5,36.6,00000
10.0,81.0,75.0,707,06,01,  Banshgari,182,147,79,66,103,81,55.3,54.5,56.0,00000
10.0,81.0,75.0,707,07,01,  Godagari,345,434,168,184,177,250,44.3,47.7,41.5,00000
10.0,81.0,75.0,707,08,01,  Char Godagari,441,755,244,323,197,432,36.9,43.0,31.3,00000
10.0,81.0,88.0,318,01,01,  Dighalkandi,1001,1896,537,885,464,1011,34.6,37.8,31.5,00000
10.0,81.0,88.0,318,02,01,  Nabadri,266,312,152,129,114,183,46.0,54.1,38.4,00000
10.0,81.0,88.0,318,03,01,  Dhantala,101,189,52,86,49,103,34.8,37.7,32.2,00000
10.0,81.0,88.0,331,01,01,  Dakshin Gosaibari,340,498,167,233,173,265,40.6,41.8,39.5,00000
10.0,81.0,88.0,331,02,01,  Char Gosaibari,79,281,35,150,44,131,21.9,18.9,25.1,00000
10.0,81.0,88.0,784,01,01,  Par Titparal,1327,1369,696,604,631,765,49.2,53.5,45.2,00000
10.0,81.0,88.0,784,02,01,  Chandina Noapara,296,696,148,321,148,375,29.8,31.6,28.3,00000
10.0,85.0,16.0,389,01,01,  Fulkot,1444,1422,739,689,705,733,50.4,51.8,49.0,00000
10.0,85.0,16.0,389,02,01,  Khurda Fulkot,258,1000,118,501,140,499,20.5,19.1,21.9,00000
10.0,85.0,16.0,696,01,01,  Gobindapur,663,848,346,414,317,434,43.9,45.5,42.2,00000
10.0,85.0,16.0,696,02,01,  Lakshmipur,115,285,67,125,48,160,28.8,34.9,23.1,00000
10.0,85.0,16.0,696,03,01,  Jadabpur,199,171,98,97,101,74,53.8,50.3,57.7,00000
10.0,85.0,16.0,696,04,01,  Amrool,724,482,372,219,352,263,60.0,62.9,57.2,00000
10.0,85.0,16.0,696,05,01,  Rampur,478,303,243,155,235,148,61.2,61.1,61.4,00000
10.0,85.0,16.0,696,06,01,  Radhanagar,383,490,200,241,183,249,43.9,45.4,42.4,00000
10.0,85.0,16.0,696,07,01,  Baranagar,709,548,358,261,351,287,56.4,57.8,55.0,00000
10.0,85.0,16.0,696,08,01,  Rajarampur,491,603,249,284,242,319,44.9,46.7,43.1,00000
10.0,85.0,16.0,696,09,01,  Poly Palash,381,415,186,214,195,201,47.9,46.5,49.2,00000
10.0,85.0,16.0,779,01,01,  Paranbari,447,263,230,122,217,141,63.0,65.3,60.6,00000
10.0,85.0,16.0,779,02,01,  Jhalo Para,146,64,75,32,71,32,69.5,70.1,68.9,00000
10.0,85.0,17.0,022,01,01,  Aria,370,343,215,172,155,171,51.9,55.6,47.5,00000
10.0,85.0,17.0,022,02,01,  Katabaria,2396,1286,1210,622,1186,664,65.1,66.0,64.1,00000
10.0,85.0,17.0,052,01,01,  Bamunia,1643,1257,852,600,791,657,56.7,58.7,54.6,00000
10.0,85.0,17.0,052,02,01,  Chandbaria,208,228,103,117,105,111,47.7,46.8,48.6,00000
10.0,85.0,17.0,052,03,01,  Talpukuria,148,197,75,100,73,97,42.9,42.9,42.9,00000
10.0,85.0,17.0,578,01,01,  Khodaband Bala,324,231,171,105,153,126,58.4,62.0,54.8,00000
10.0,85.0,17.0,578,02,01,  Takuragari,422,106,209,41,213,65,79.9,83.6,76.6,00000
10.0,85.0,18.0,476,01,01,  Jora,2329,1670,1227,791,1102,879,58.2,60.8,55.6,00000
10.0,85.0,18.0,476,02,01,  Mathail Chapra,521,382,276,174,245,208,57.7,61.3,54.1,00000
10.0,85.0,18.0,476,03,01,  Chak Madhai,83,85,45,34,38,51,49.4,57.0,42.7,00000
10.0,85.0,19.0,151,01,01,  Birkulla,585,755,316,363,269,392,43.7,46.5,40.7,00000
10.0,85.0,19.0,151,02,01,  Kouchadah,510,826,258,393,252,433,38.2,39.6,36.8,00000
10.0,85.0,19.0,162,01,01,  Brikushtia,1528,809,795,405,733,404,65.4,66.3,64.5,00000
10.0,85.0,19.0,162,02,01,  Khudra Kushtia,357,284,174,137,183,147,55.7,55.9,55.5,00000
10.0,85.0,30.0,007,01,01,  Agra,409,745,204,345,205,400,35.4,37.2,33.9,00000
10.0,85.0,30.0,007,02,01,  Panchgharia,36,143,21,65,15,78,20.1,24.4,16.1,00000
10.0,85.0,30.0,075,01,01,  Banshkuta,130,151,73,70,57,81,46.3,51.0,41.3,00000
10.0,85.0,30.0,075,02,01,  Sabgari,189,141,95,66,94,75,57.3,59.0,55.6,00000
10.0,85.0,30.0,075,03,01,  Natun Para,112,170,58,83,54,87,39.7,41.1,38.3,00000
10.0,85.0,30.0,102,01,01,  Purbapara,106,99,60,43,46,56,51.7,58.3,45.1,00000
10.0,85.0,30.0,102,02,01,  Paschimpara,195,182,97,90,98,92,51.7,51.9,51.6,00000
10.0,85.0,30.0,272,01,01,  Chhalna,278,538,152,252,126,286,34.1,37.6,30.6,00000
10.0,85.0,30.0,272,02,01,  Jorgari,108,230,51,113,57,117,32.0,31.1,32.8,00000
10.0,85.0,30.0,412,01,01,  Gohail,403,224,214,91,189,133,64.3,70.2,58.7,00000
10.0,85.0,30.0,412,02,01,  Teli Para,58,20,30,10,28,10,74.4,75.0,73.7,00000
10.0,85.0,30.0,412,03,01,  Sona Para,138,332,88,159,50,173,29.4,35.6,22.4,00000
10.0,85.0,30.0,559,01,01,  Paschimpara,116,183,62,89,54,94,38.8,41.1,36.5,00000
10.0,85.0,30.0,559,02,01,  Hindu Para,105,342,64,148,41,194,23.5,30.2,17.4,00000
10.0,85.0,30.0,559,03,01,  Sardar Para,68,128,36,59,32,69,34.7,37.9,31.7,00000
10.0,85.0,30.0,559,04,01,  Rajbari,192,424,99,207,93,217,31.2,32.4,30.0,00000
10.0,85.0,30.0,559,05,01,  Purbapara,272,437,142,234,130,203,38.4,37.8,39.0,00000
10.0,85.0,30.0,559,06,01,  Chacho Para,208,127,113,50,95,77,62.1,69.3,55.2,00000
10.0,85.0,30.0,559,07,01,  Ollain Par,54,145,27,71,27,74,27.1,27.6,26.7,00000
10.0,85.0,30.0,559,08,01,  Sabgari,24,80,11,36,13,44,23.1,23.4,22.8,00000
10.0,85.0,30.0,571,01,01,  Khanda Khetra,145,122,75,54,70,68,54.3,58.1,50.7,00000
10.0,85.0,30.0,571,02,01,  Kehonai Para,11,108,9,51,2,57,9.2,15.0,3.4,00000
10.0,85.0,30.0,749,01,01,  Chachahar Para,91,80,52,33,39,47,53.2,61.2,45.3,00000
10.0,85.0,30.0,749,02,01,  Bara Para,831,541,407,248,424,293,60.6,62.1,59.1,00000
10.0,85.0,30.0,749,03,01,  Chhota Para,184,195,107,93,77,102,48.5,53.5,43.0,00000
10.0,85.0,30.0,749,04,01,  Bhadai Para,78,146,46,67,32,79,34.8,40.7,28.8,00000
10.0,85.0,30.0,749,05,01,  Gogachhi Para,200,169,117,87,83,82,54.2,57.4,50.3,00000
10.0,85.0,30.0,836,01,01,  Madhyapara,128,304,61,141,67,163,29.6,30.2,29.1,00000
10.0,85.0,30.0,836,02,01,  Dakshinpara,289,266,144,121,145,145,52.1,54.3,50.0,00000
10.0,85.0,30.0,847,01,01,  Rupihar,431,245,210,97,221,148,63.8,68.4,59.9,00000
10.0,85.0,30.0,847,02,01,  Hindu Para,70,66,48,24,22,42,51.5,66.7,34.4,00000
10.0,85.0,30.0,847,03,01,  Kachahar,214,237,121,105,93,132,47.5,53.5,41.3,00000
10.0,85.0,30.0,858,01,01,  Sadhra,173,427,96,194,77,233,28.8,33.1,24.8,00000
10.0,85.0,30.0,858,02,01,  Sori Para,147,180,73,83,74,97,45.0,46.8,43.3,00000
10.0,85.0,30.0,968,01,01,  Sati Para,206,295,105,140,101,155,41.1,42.9,39.5,00000
10.0,85.0,30.0,968,02,01,  Akand Para,87,263,42,126,45,137,24.9,25.0,24.7,00000
10.0,85.0,30.0,968,03,01,  Fakir Para,344,405,177,168,167,237,45.9,51.3,41.3,00000
10.0,85.0,51.0,911,01,01,  Sherkole,628,728,323,361,305,367,46.3,47.2,45.4,00000
10.0,85.0,51.0,911,02,01,  Mali Para,639,607,362,292,277,315,51.3,55.4,46.8,00000
10.0,85.0,51.0,911,03,01,  Chak Momin,161,187,90,94,71,93,46.3,48.9,43.3,00000
10.0,85.0,51.0,911,04,01,  Kumurabari,37,12,22,9,15,3,75.5,71.0,83.3,00000
10.0,88.0,17.0,022,01,01,  Aminpur,361,791,198,362,163,429,31.3,35.4,27.5,00000
10.0,88.0,17.0,022,02,01,  Natun Colony,91,277,55,124,36,153,24.7,30.7,19.0,00000
10.0,88.0,17.0,022,03,01,  Puran Colony,165,300,86,131,79,169,35.5,39.6,31.9,00000
10.0,88.0,17.0,035,01,01,  Asgram,358,541,211,240,147,301,39.8,46.8,32.8,00000
10.0,88.0,17.0,035,02,01,  Dhepuwa,208,230,118,92,90,138,47.5,56.2,39.5,00000
10.0,88.0,17.0,102,01,01,  Belghari,80,228,48,110,32,118,26.0,30.4,21.3,00000
10.0,88.0,17.0,102,02,01,  Belghari Colony,106,368,69,183,37,185,22.4,27.4,16.7,00000
10.0,88.0,17.0,133,01,01,  Bhabanipur,459,484,263,225,196,259,48.7,53.9,43.1,00000
10.0,88.0,17.0,133,02,01,  Afradgari,29,72,15,32,14,40,28.7,31.9,25.9,00000
10.0,88.0,17.0,133,03,01,  Mendi Para,72,125,35,58,37,67,36.5,37.6,35.6,00000
10.0,88.0,17.0,133,04,01,  Gobindpur,48,115,23,50,25,65,29.4,31.5,27.8,00000
10.0,88.0,17.0,133,05,01,  Jamnagar,119,375,66,175,53,200,24.1,27.4,20.9,00000
10.0,88.0,17.0,199,01,01,  Bishwa,512,537,288,238,224,299,48.8,54.8,42.8,00000
10.0,88.0,17.0,199,02,01,  Joynagar,23,148,17,68,6,80,13.5,20.0,7.0,00000
10.0,88.0,17.0,257,01,01,  Chhanka,1164,1254,597,542,567,712,48.1,52.4,44.3,00000
10.0,88.0,17.0,257,02,01,  Italy,183,573,110,262,73,311,24.2,29.6,19.0,00000
10.0,88.0,17.0,595,01,01,  Kumarghat,10,12,7,5,3,7,45.5,58.3,30.0,00000
10.0,88.0,17.0,595,02,01,  Sahapur,46,71,23,32,23,39,39.3,41.8,37.1,00000
10.0,88.0,19.0,119,01,01,  Bishalpur,542,461,298,191,244,270,54.0,60.9,47.5,00000
10.0,88.0,19.0,119,02,01,  Nagar Para,177,203,108,77,69,126,46.6,58.4,35.4,00000
10.0,88.0,19.0,119,03,01,  Colony Para,61,119,32,56,29,63,33.9,36.4,31.5,00000
10.0,88.0,19.0,119,04,01,  Phaguragari,72,98,42,38,30,60,42.4,52.5,33.3,00000
10.0,88.0,19.0,137,01,01,  Bhadaikuri,118,322,78,143,40,179,26.8,35.3,18.3,00000
10.0,88.0,19.0,137,02,01,  Char Kuta,12,184,10,83,2,101,6.1,10.8,1.9,00000
10.0,88.0,19.0,306,01,01,  Dayalsara,179,253,105,111,74,142,41.4,48.6,34.3,00000
10.0,88.0,19.0,306,02,01,  Bara Pukuria,234,209,134,96,100,113,52.8,58.3,46.9,00000
10.0,88.0,19.0,364,01,01,  Gholgharia,58,170,35,76,23,94,25.4,31.5,19.7,00000
10.0,88.0,19.0,364,02,01,  Mukundapur,74,218,40,99,34,119,25.3,28.8,22.2,00000
10.0,88.0,19.0,461,01,01,  Kachua Para,243,208,148,69,95,139,53.9,68.2,40.6,00000
10.0,88.0,19.0,461,02,01,  Ronihali,122,199,75,81,47,118,38.0,48.1,28.5,00000
10.0,88.0,19.0,581,01,01,  Koitkul,287,191,163,69,124,122,60.0,70.3,50.4,00000
10.0,88.0,19.0,581,02,01,  Bisur Para,60,121,30,56,30,65,33.1,34.9,31.6,00000
10.0,88.0,19.0,608,01,01,  Laishimul,56,169,29,87,27,82,24.9,25.0,24.8,00000
10.0,88.0,19.0,608,02,01,  Naiyar Para,75,100,43,45,32,55,42.9,48.9,36.8,00000
10.0,88.0,19.0,741,01,01,  Panisara,63,183,32,79,31,104,25.6,28.8,23.0,00000
10.0,88.0,19.0,741,02,01,  Naya Panisara,134,352,80,162,54,190,27.6,33.1,22.1,00000
10.0,88.0,19.0,741,03,01,  Panisara Hindupara,145,328,97,143,48,185,30.7,40.4,20.6,00000
10.0,88.0,19.0,821,01,01,  Sahanagar,152,221,90,104,62,117,40.8,46.4,34.6,00000
10.0,88.0,19.0,821,02,01,  Manik Chapor,232,365,134,166,98,199,38.9,44.7,33.0,00000
10.0,88.0,19.0,879,01,01,  Simla,408,438,236,180,172,258,48.2,56.7,40.0,00000
10.0,88.0,19.0,879,02,01,  Satbaria,113,296,69,134,44,162,27.6,34.0,21.4,00000
10.0,88.0,19.0,888,01,01,  Sirajnagar,348,456,221,183,127,273,43.3,54.7,31.8,00000
10.0,88.0,19.0,888,02,01,  Hasagari,109,190,74,77,35,113,36.5,49.0,23.6,00000
10.0,88.0,19.0,888,03,01,  Naila Para,149,279,97,117,52,162,34.8,45.3,24.3,00000
10.0,88.0,19.0,959,01,01,  Tentulia,273,389,165,169,108,220,41.2,49.4,32.9,00000
10.0,88.0,19.0,959,02,01,  Tentulia Hindu Para,44,123,30,55,14,68,26.3,35.3,17.1,00000
10.0,88.0,19.0,986,01,01,  Udgoan,309,462,192,193,117,269,40.1,49.9,30.3,00000
10.0,88.0,19.0,986,02,01,  Ambaria,140,181,78,79,62,102,43.6,49.7,37.8,00000
10.0,88.0,28.0,071,01,01,  Bangra,411,698,203,324,208,374,37.1,38.5,35.7,00000
10.0,88.0,28.0,071,02,01,  Dari Bangra,118,190,64,96,54,94,38.3,40.0,36.5,00000
10.0,88.0,28.0,342,01,03,  Garidaha,1384,951,741,419,643,532,59.3,63.9,54.7,00000
10.0,88.0,28.0,342,02,03,  Garidaha (Rural Academy),441,142,226,60,215,82,75.6,79.0,72.4,00000
10.0,88.0,28.0,342,03,03,  Dari Para,538,82,264,27,274,55,86.8,90.7,83.3,00000
10.0,88.0,28.0,408,01,01,  Colony,872,1162,449,548,423,614,42.9,45.0,40.8,00000
10.0,88.0,28.0,408,02,01,  Hapania,745,807,379,380,366,427,48.0,49.9,46.2,00000
10.0,88.0,28.0,648,01,01,  Mahipur,1567,1548,853,715,714,833,50.3,54.4,46.2,00000
10.0,88.0,28.0,648,02,01,  Mahipur Colony,1055,995,539,451,516,544,51.5,54.4,48.7,00000
10.0,88.0,28.0,719,01,01,  Fulbari,841,1587,443,772,398,815,34.6,36.5,32.8,00000
10.0,88.0,28.0,719,02,01,  Joynagar,472,1110,271,542,201,568,29.8,33.3,26.1,00000
10.0,88.0,28.0,786,01,01,  Ranabir Bala,596,792,301,385,295,407,42.9,43.9,42.0,00000
10.0,88.0,28.0,786,02,01,  Husnabad,14,469,6,233,8,236,2.9,2.5,3.3,00000
10.0,88.0,28.0,790,01,01,  Raninagar,288,459,164,222,124,237,38.6,42.5,34.3,00000
10.0,88.0,28.0,790,02,01,  Chak Pathalia,502,694,284,319,218,375,42.0,47.1,36.8,00000
10.0,88.0,38.0,550,01,01,  Khamarkandi,1443,2323,736,1120,707,1203,38.3,39.7,37.0,00000
10.0,88.0,38.0,550,02,01,  Magurar Tair,508,855,251,412,257,443,37.3,37.9,36.7,00000
10.0,88.0,38.0,550,03,01,  Jajar,535,1548,309,717,226,831,25.7,30.1,21.4,00000
10.0,88.0,38.0,906,01,01,  Subhagachha,749,1013,399,487,350,526,42.5,45.0,40.0,00000
10.0,88.0,38.0,906,02,01,  Bererbari,79,441,42,217,37,224,15.2,16.2,14.2,00000
10.0,88.0,38.0,906,03,01,  Bhataria,68,271,35,133,33,138,20.1,20.8,19.3,00000
10.0,88.0,38.0,906,04,01,  Boalmari,74,166,39,88,35,78,30.8,30.7,31.0,00000
10.0,88.0,38.0,906,05,01,  Noldingi,88,147,40,68,48,79,37.4,37.0,37.8,00000
10.0,88.0,38.0,906,06,01,  Bil Nothar,195,583,130,263,65,320,25.1,33.1,16.9,00000
10.0,88.0,47.0,159,01,01,  Bhandar Kaphura,198,226,104,96,94,130,46.7,52.0,42.0,00000
10.0,88.0,47.0,159,02,01,  Bhabanibati,134,308,77,144,57,164,30.3,34.8,25.8,00000
10.0,88.0,47.0,395,01,01,  Gopalpur,806,1069,460,486,346,583,43.0,48.6,37.2,00000
10.0,88.0,47.0,395,02,01,  Salpha,767,1794,406,891,361,903,29.9,31.3,28.6,00000
10.0,88.0,47.0,395,03,01,  Gajaria,529,846,296,378,233,468,38.5,43.9,33.2,00000
10.0,88.0,47.0,395,04,01,  Baritali,391,871,222,404,169,467,31.0,35.5,26.6,00000
10.0,88.0,47.0,395,05,01,  Subli,145,474,97,233,48,241,23.4,29.4,16.6,00000
10.0,88.0,47.0,395,06,01,  Panta Para,20,168,14,87,6,81,10.6,13.9,6.9,00000
10.0,88.0,47.0,395,07,01,  Safaljani,65,66,37,36,28,30,49.6,50.7,48.3,00000
10.0,88.0,47.0,395,08,01,  Chandpur,112,183,73,74,39,109,38.0,49.7,26.4,00000
10.0,88.0,47.0,395,09,01,  Talpukuria,178,334,91,154,87,180,34.8,37.1,32.6,00000
10.0,88.0,47.0,541,01,01,  Khaga,451,659,271,277,180,382,40.6,49.5,32.0,00000
10.0,88.0,47.0,541,02,01,  Nahar Khaga,171,236,105,100,66,136,42.0,51.2,32.7,00000
10.0,88.0,47.0,555,01,01,  Chak Khanpur,459,744,265,356,194,388,38.2,42.7,33.3,00000
10.0,88.0,47.0,555,02,01,  Purbapara,412,424,224,180,188,244,49.3,55.4,43.5,00000
10.0,88.0,47.0,555,03,01,  Paschimpara,803,1243,428,588,375,655,39.2,42.1,36.4,00000
10.0,88.0,47.0,555,04,01,  Daha Para,210,411,96,208,114,203,33.8,31.6,36.0,00000
10.0,88.0,47.0,555,05,01,  Dashsika Para,189,423,101,197,88,226,30.9,33.9,28.0,00000
10.0,88.0,47.0,555,06,01,  Sallya Para,169,657,92,298,77,359,20.5,23.6,17.7,00000
10.0,88.0,47.0,555,07,01,  Boyalkandi,185,510,104,227,81,283,26.6,31.4,22.3,00000
10.0,88.0,47.0,555,08,01,  Nalbaria,319,742,180,327,139,415,30.1,35.5,25.1,00000
10.0,88.0,57.0,048,01,01,  Bagra Bast,548,1107,292,519,256,588,33.1,36.0,30.3,00000
10.0,88.0,57.0,048,02,01,  Bagra Colony,897,1287,461,598,436,689,41.1,43.5,38.8,00000
10.0,88.0,57.0,048,03,01,  Bagra Hatath Para,655,621,370,255,285,366,51.3,59.2,43.8,00000
10.0,88.0,57.0,439,01,01,  Uttar Jamur,137,145,86,65,51,80,48.6,57.0,38.9,00000
10.0,88.0,57.0,439,02,01,  Dakshin Jamur,215,331,118,154,97,177,39.4,43.4,35.4,00000
10.0,88.0,57.0,439,03,01,  Madhya Jamur,91,198,50,92,41,106,31.5,35.2,27.9,00000
10.0,88.0,57.0,439,04,01,  Nama Jamur,284,300,147,137,137,163,48.6,51.8,45.7,00000
10.0,88.0,57.0,612,01,01,  Senpara,116,202,63,100,53,102,36.5,38.7,34.2,00000
10.0,88.0,57.0,612,02,01,  Chetonbari,84,97,35,48,49,49,46.4,42.2,50.0,00000
10.0,88.0,57.0,612,03,01,  Lakshmikul,166,396,100,185,66,211,29.5,35.1,23.8,00000
10.0,88.0,66.0,008,01,01,  Aira,222,512,135,221,87,291,30.2,37.9,23.0,00000
10.0,88.0,66.0,008,02,01,  Satian,21,129,15,59,6,70,14.0,20.3,7.9,00000
10.0,88.0,66.0,031,01,01,  Arangsail,183,528,108,240,75,288,25.7,31.0,20.7,00000
10.0,88.0,66.0,031,02,01,  Chak Arangsail,73,352,43,161,30,191,17.2,21.1,13.6,00000
10.0,88.0,66.0,195,01,01,  Birgaon,115,245,64,115,51,130,31.9,35.8,28.2,00000
10.0,88.0,66.0,195,02,01,  Chakandi,28,65,19,27,9,38,30.1,41.3,19.1,00000
10.0,88.0,66.0,346,01,01,  Shelborso,31,40,15,15,16,25,43.7,50.0,39.0,00000
10.0,88.0,66.0,346,02,01,  Gharta,53,46,29,20,24,26,53.5,59.2,48.0,00000
10.0,88.0,66.0,630,01,01,  Madanpur,550,747,283,318,267,429,42.4,47.1,38.4,00000
10.0,88.0,66.0,630,02,01,  Chak Madanpur,465,276,255,133,210,143,62.8,65.7,59.5,00000
10.0,88.0,66.0,679,01,01,  Mirzapur,1234,1817,664,871,570,946,40.4,43.3,37.6,00000
10.0,88.0,66.0,679,02,01,  Kunighat,133,143,75,70,58,73,48.2,51.7,44.3,00000
10.0,88.0,66.0,946,01,01,  Talta,270,472,155,205,115,267,36.4,43.1,30.1,00000
10.0,88.0,66.0,946,02,01,  Kholabari,20,44,15,21,5,23,31.3,41.7,17.9,00000
10.0,88.0,77.0,213,01,01,  Chak Mukunda,133,439,60,215,73,224,23.3,21.8,24.6,00000
10.0,88.0,77.0,213,02,01,  Chak Dueli,135,262,80,123,55,139,34.0,39.4,28.4,00000
10.0,88.0,77.0,297,01,01,  Dari Mukunda,176,446,85,211,91,235,28.3,28.7,27.9,00000
10.0,88.0,77.0,297,02,01,  Hatigara,101,274,59,128,42,146,26.9,31.6,22.3,00000
10.0,88.0,77.0,359,01,01,  Gholagari,172,533,107,250,65,283,24.4,30.0,18.7,00000
10.0,88.0,77.0,359,02,01,  Gholagari Colony,82,396,35,201,47,195,17.2,14.8,19.4,00000
10.0,88.0,77.0,466,01,01,  Kadi Mukunda,48,189,31,87,17,102,20.3,26.3,14.3,00000
10.0,88.0,77.0,466,02,01,  Baghmara,127,254,80,109,47,145,33.3,42.3,24.5,00000
10.0,88.0,77.0,564,01,01,  Khondakartala,3499,2461,1850,1170,1649,1291,58.7,61.3,56.1,00000
10.0,88.0,77.0,564,02,01,  Fultala,1191,1293,665,587,526,706,47.9,53.1,42.7,00000
10.0,88.0,77.0,852,01,03,  Serua,2392,2595,1303,1201,1089,1394,48.0,52.0,43.9,00000
10.0,88.0,77.0,852,02,03,  Dharam Mokam,1204,1770,648,819,556,951,40.5,44.2,36.9,00000
10.0,88.0,77.0,852,03,03,  Hamchyapur,1775,782,960,345,815,437,69.4,73.6,65.1,00000
10.0,88.0,77.0,852,04,03,  Andikumra,380,780,204,357,176,423,32.8,36.4,29.4,00000
10.0,88.0,77.0,852,05,03,  Rahmatpur,657,767,348,365,309,402,46.1,48.8,43.5,00000
10.0,88.0,77.0,852,06,03,  Garer Bari,699,795,389,345,310,450,46.8,53.0,40.8,00000
10.0,88.0,85.0,124,01,01,  Purbapara,387,332,199,146,188,186,53.8,57.7,50.3,00000
10.0,88.0,85.0,124,02,01,  Paschimpara,392,814,227,379,165,435,32.5,37.5,27.5,00000
10.0,88.0,85.0,315,01,01,  Uttarpara,247,395,123,182,124,213,38.5,40.3,36.8,00000
10.0,88.0,85.0,315,02,01,  Dakshinpara,624,643,336,286,288,357,49.3,54.0,44.7,00000
10.0,88.0,85.0,350,01,01,  Ghasuria,170,241,90,114,80,127,41.4,44.1,38.6,00000
10.0,88.0,85.0,350,02,01,  Nalua,493,468,276,231,217,237,51.3,54.4,47.8,00000
10.0,88.0,85.0,799,01,01,  Sadar Hasara,214,559,128,268,86,291,27.7,32.3,22.8,00000
10.0,88.0,85.0,799,02,01,  Kadim Hasara,98,170,62,76,36,94,36.6,44.9,27.7,00000
10.0,88.0,95.0,097,01,01,  Belgachhi,337,607,174,293,163,314,35.7,37.3,34.2,00000
10.0,88.0,95.0,097,02,01,  Char Belgachhi,39,96,22,46,17,50,28.9,32.4,25.4,00000
10.0,88.0,95.0,177,01,01,  Bil Joysagar,246,377,139,170,107,207,39.5,45.0,34.1,00000
10.0,88.0,95.0,177,02,01,  Horinath Pur,56,64,26,27,30,37,46.7,49.1,44.8,00000
10.0,88.0,95.0,202,01,01,  Chak Dhali,266,465,129,215,137,250,36.4,37.5,35.4,00000
10.0,88.0,95.0,202,02,01,  Chak Bhewa,60,80,33,40,27,40,42.9,45.2,40.3,00000
10.0,88.0,95.0,217,01,01,  Chak Nasi,112,221,58,102,54,119,33.6,36.3,31.2,00000
10.0,88.0,95.0,217,02,01,  Chak Pahari,195,524,98,242,97,282,27.1,28.8,25.6,00000
10.0,88.0,95.0,458,01,01,  Jaina Aladi,225,366,116,166,109,200,38.1,41.1,35.3,00000
10.0,88.0,95.0,458,02,01,  Chak Ghenai,150,150,81,67,69,83,50.0,54.7,45.4,00000
10.0,88.0,95.0,460,01,01,  Joyna Juan,434,530,225,263,209,267,45.0,46.1,43.9,00000
10.0,88.0,95.0,460,02,01,  Joynagar,167,235,90,108,77,127,41.5,45.5,37.7,00000
10.0,88.0,95.0,497,01,01,  Kallyani,384,362,212,156,172,206,51.5,57.6,45.5,00000
10.0,88.0,95.0,497,02,01,  Char Kallyani,179,466,107,229,72,237,27.8,31.8,23.3,00000
10.0,88.0,95.0,497,03,01,  Chak Kallyani,143,123,74,57,69,66,53.8,56.5,51.1,00000
10.0,88.0,95.0,715,01,01,  Omar Para,105,152,60,64,45,88,40.9,48.4,33.8,00000
10.0,88.0,95.0,715,02,01,  Matchkandi,58,272,27,125,31,147,17.6,17.8,17.4,00000
10.0,88.0,95.0,755,01,01,  Phuljor,103,150,51,67,52,83,40.7,43.2,38.5,00000
10.0,88.0,95.0,755,02,01,  Hasan Phuljor,71,156,45,73,26,83,31.3,38.1,23.9,00000
10.0,88.0,95.0,755,03,01,  Satani Phuljor,93,254,40,118,53,136,26.8,25.3,28.0,00000
10.0,88.0,95.0,910,01,01,  Sughat,275,364,130,162,145,202,43.0,44.5,41.8,00000
10.0,88.0,95.0,910,02,01,  Sharik Sughat,216,419,104,190,112,229,34.0,35.4,32.8,00000
10.0,88.0,95.0,919,01,01,  Sutrapur,218,352,117,166,101,186,38.2,41.3,35.2,00000
10.0,88.0,95.0,919,02,01,  Akheri Para,50,183,23,84,27,99,21.5,21.5,21.4,00000
10.0,88.0,95.0,919,03,01,  Baniagati,93,159,56,71,37,88,36.9,44.1,29.6,00000
10.0,94.0,11.0,056,01,01,  Hindu Para,264,222,137,89,127,133,54.3,60.6,48.8,00000
10.0,94.0,11.0,056,02,01,  Paschimpara,512,291,289,115,223,176,63.8,71.5,55.9,00000
10.0,94.0,11.0,060,01,01,  Uttar Atmul,1172,1349,646,608,526,741,46.5,51.5,41.5,00000
10.0,94.0,11.0,060,02,01,  Dakshin Atmul,751,648,421,287,330,361,53.7,59.5,47.8,00000
10.0,94.0,11.0,117,01,01,  Uttarpara,145,277,95,128,50,149,34.4,42.6,25.1,00000
10.0,94.0,11.0,117,02,01,  Dakshinpara,660,950,383,422,277,528,41.0,47.6,34.4,00000
10.0,94.0,11.0,617,01,01,  Uttarpara,635,1319,378,606,257,713,32.5,38.4,26.5,00000
10.0,94.0,11.0,617,02,01,  Dakshinpara,636,1006,365,473,271,533,38.7,43.6,33.7,00000
10.0,94.0,15.0,178,01,01,  Bhasu Bihar,167,603,92,305,75,298,21.7,23.2,20.1,00000
10.0,94.0,15.0,178,02,01,  Chand Para,254,539,134,260,120,279,32.0,34.0,30.1,00000
10.0,94.0,15.0,186,01,01,  Bihar,1299,1524,696,710,603,814,46.0,49.5,42.6,00000
10.0,94.0,15.0,186,02,01,  Fakir Para,835,1602,451,784,384,818,34.3,36.5,31.9,00000
10.0,94.0,15.0,345,01,01,  Dhamahar,740,906,421,436,319,470,45.0,49.1,40.4,00000
10.0,94.0,15.0,345,02,01,  Singargari,76,301,44,146,32,155,20.2,23.2,17.1,00000
10.0,94.0,23.0,190,01,01,  Bilhamla,1224,1518,646,724,578,794,44.6,47.2,42.1,00000
10.0,94.0,23.0,190,02,01,  Sonapura,44,56,26,25,18,31,44.0,51.0,36.7,00000
10.0,94.0,23.0,316,01,01,  Dakshin Belai,471,502,267,229,204,273,48.4,53.8,42.8,00000
10.0,94.0,23.0,316,02,01,  Tetulgara,116,55,71,23,45,32,67.8,75.5,58.4,00000
10.0,94.0,23.0,771,01,01,  Nischintapur,342,549,185,277,157,272,38.4,40.0,36.6,00000
10.0,94.0,23.0,771,02,01,  Paligatha,156,304,84,146,72,158,33.9,36.5,31.3,00000
10.0,94.0,23.0,771,03,01,  Machil,24,200,14,101,10,99,10.7,12.2,9.2,00000
10.0,94.0,23.0,978,01,01,  Triloch,520,435,288,201,232,234,54.5,58.9,49.8,00000
10.0,94.0,23.0,978,02,01,  Kharkona,293,114,164,46,129,68,72.0,78.1,65.5,00000
10.0,94.0,31.0,020,01,01,  Alampur,169,111,95,41,74,70,60.4,69.9,51.4,00000
10.0,94.0,31.0,020,02,01,  Paschimpara,166,146,87,60,79,86,53.2,59.2,47.9,00000
10.0,94.0,31.0,166,01,01,  Paschimpara,626,674,322,332,304,342,48.2,49.2,47.1,00000
10.0,94.0,31.0,166,02,01,  Madhyapara,363,354,191,164,172,190,50.6,53.8,47.5,00000
10.0,94.0,31.0,166,03,01,  Akhanda Para,661,514,345,250,316,264,56.3,58.0,54.5,00000
10.0,94.0,31.0,198,01,01,  Purba Bishnopur,233,274,127,127,106,147,46.0,50.0,41.9,00000
10.0,94.0,31.0,198,02,01,  Paschim Bishnopur,202,301,102,138,100,163,40.2,42.5,38.0,00000
10.0,94.0,31.0,203,01,01,  Purbapara,248,284,116,142,132,142,46.6,45.0,48.2,00000
10.0,94.0,31.0,203,02,01,  Paschimpara,181,359,88,168,93,191,33.5,34.4,32.7,00000
10.0,94.0,31.0,341,01,01,  Chak Deuli,356,261,184,120,172,141,57.7,60.5,55.0,00000
10.0,94.0,31.0,341,02,01,  Kandu Para,178,312,102,140,76,172,36.3,42.1,30.6,00000
10.0,94.0,31.0,341,03,01,  Bilpara,257,276,147,127,110,149,48.2,53.6,42.5,00000
10.0,94.0,31.0,341,04,01,  Karikar Para,177,212,91,90,86,122,45.5,50.3,41.3,00000
10.0,94.0,31.0,341,05,01,  Sarkar Para,255,245,132,109,123,136,51.0,54.8,47.5,00000
10.0,94.0,31.0,381,01,01,  Hindu Para,187,347,112,154,75,193,35.0,42.1,28.0,00000
10.0,94.0,31.0,381,02,01,  Muslim Para,174,150,87,68,87,82,53.7,56.1,51.5,00000
10.0,94.0,31.0,596,01,01,  Dakshinpara,88,284,53,158,35,126,23.7,25.1,21.7,00000
10.0,94.0,31.0,596,02,01,  Madhupur,555,474,307,226,248,248,53.9,57.6,50.0,00000
10.0,94.0,31.0,706,01,01,  Uttarpara,582,8,278,4,304,4,98.6,98.6,98.7,00000
10.0,94.0,31.0,706,02,01,  Dakshinpara,283,335,144,162,139,173,45.8,47.1,44.6,00000
10.0,94.0,31.0,775,01,01,  Purbapara,374,131,195,48,179,83,74.1,80.2,68.3,00000
10.0,94.0,31.0,775,02,01,  Paschimpara,310,111,168,40,142,71,73.6,80.8,66.7,00000
10.0,94.0,31.0,848,01,01,  Gopalpur,397,269,212,117,185,152,59.6,64.4,54.9,00000
10.0,94.0,31.0,848,02,01,  Goankuri,364,272,188,126,176,146,57.2,59.9,54.7,00000
10.0,94.0,31.0,848,03,01,  Hindu Para,221,95,116,34,105,61,69.9,77.3,63.3,00000
10.0,94.0,31.0,848,04,01,  Chengerata,544,419,287,199,257,220,56.5,59.1,53.9,00000
10.0,94.0,31.0,848,05,01,  Hazi Para,494,86,247,39,247,47,85.2,86.4,84.0,00000
10.0,94.0,31.0,848,06,01,  Purbapara,371,454,193,216,178,238,45.0,47.2,42.8,00000
10.0,94.0,31.0,954,01,01,  Purbapara,264,411,147,193,117,218,39.1,43.2,34.9,00000
10.0,94.0,31.0,954,02,01,  Paschimpara,453,659,239,325,214,334,40.7,42.4,39.1,00000
10.0,94.0,39.0,044,01,01,  Apson,475,495,288,221,187,274,49.0,56.6,40.6,00000
10.0,94.0,39.0,044,02,01,  Chatian Para,294,220,161,111,133,109,57.2,59.2,55.0,00000
10.0,94.0,39.0,064,01,01,  Kalki,170,187,103,76,67,111,47.6,57.5,37.6,00000
10.0,94.0,39.0,064,02,01,  Taltala,128,187,75,76,53,111,40.6,49.7,32.3,00000
10.0,94.0,39.0,276,01,01,  Challish Chhatra,307,451,179,206,128,245,40.5,46.5,34.3,00000
10.0,94.0,39.0,276,02,01,  Ghngar Para,115,233,61,96,54,137,33.0,38.9,28.3,00000
10.0,94.0,39.0,296,01,01,  Chinal,183,63,106,25,77,38,74.4,80.9,67.0,00000
10.0,94.0,39.0,296,02,01,  Kamarkhur,113,240,61,115,52,125,32.0,34.7,29.4,00000
10.0,94.0,39.0,410,01,01,  Gariar Para,291,492,154,223,137,269,37.2,40.8,33.7,00000
10.0,94.0,39.0,410,02,01,  Paik Para,105,227,58,109,47,118,31.6,34.7,28.5,00000
10.0,94.0,39.0,434,01,01,  Gopinathpur,642,1403,370,671,272,732,31.4,35.5,27.1,00000
10.0,94.0,39.0,434,02,01,  Chak Gopinathpur,122,315,66,159,56,156,27.9,29.3,26.4,00000
10.0,94.0,39.0,540,01,01,  Karunda,139,145,71,67,68,78,48.9,51.4,46.6,00000
10.0,94.0,39.0,540,02,01,  Budkhur,81,28,50,11,31,17,74.3,82.0,64.6,00000
10.0,94.0,39.0,540,03,01,  Adgola,91,17,47,5,44,12,84.3,90.4,78.6,00000
10.0,94.0,39.0,576,01,01,  Khamta,219,246,133,107,86,139,47.1,55.4,38.2,00000
10.0,94.0,39.0,576,02,01,  Bishnupur,155,227,86,107,69,120,40.6,44.6,36.5,00000
10.0,94.0,39.0,576,03,01,  Singar Para,239,362,128,172,111,190,39.8,42.7,36.9,00000
10.0,94.0,39.0,588,01,01,  Kichak,115,108,63,51,52,57,51.6,55.3,47.7,00000
10.0,94.0,39.0,588,02,01,  Mallik Para,162,197,109,114,53,83,45.1,48.9,39.0,00000
10.0,94.0,39.0,588,03,01,  Palihar,354,369,187,137,167,232,49.0,57.7,41.9,00000
10.0,94.0,39.0,653,01,01,  Mahish Hatta,326,451,181,213,145,238,42.0,45.9,37.9,00000
10.0,94.0,39.0,653,02,01,  Bhakun Dahar,185,135,109,60,76,75,57.8,64.5,50.3,00000
10.0,94.0,39.0,653,03,01,  Chak Bhakun Dahar,94,199,59,95,35,104,32.1,38.3,25.2,00000
10.0,94.0,39.0,653,04,01,  Aushgram,110,15,56,8,54,7,88.0,87.5,88.5,00000
10.0,94.0,39.0,783,01,01,  Palihar,256,336,134,152,122,184,43.2,46.9,39.9,00000
10.0,94.0,39.0,783,02,01,  Dhopakhur,153,206,78,102,75,104,42.6,43.3,41.9,00000
10.0,94.0,39.0,783,03,01,  Kekarpar,101,134,65,51,36,83,43.0,56.0,30.3,00000
10.0,94.0,39.0,824,01,01,  Ber Patair,368,501,211,216,157,285,42.3,49.4,35.5,00000
10.0,94.0,39.0,824,02,01,  Bengdha,221,383,135,187,86,196,36.6,41.9,30.5,00000
10.0,94.0,39.0,824,03,01,  Par Patair,111,181,63,76,48,105,38.0,45.3,31.4,00000
10.0,94.0,39.0,824,04,01,  Bahadurpur,295,596,162,280,133,316,33.1,36.7,29.6,00000
10.0,94.0,39.0,824,05,01,  Dhulajara,190,402,105,192,85,210,32.1,35.4,28.8,00000
10.0,94.0,39.0,824,06,01,  Tal Pukura,240,225,138,101,102,124,51.6,57.7,45.1,00000
10.0,94.0,39.0,824,07,01,  Sonar Para,152,378,93,167,59,211,28.7,35.8,21.9,00000
10.0,94.0,39.0,893,01,01,  Saldaha,128,499,66,232,62,267,20.4,22.1,18.8,00000
10.0,94.0,39.0,893,02,01,  Batta,99,194,56,94,43,100,33.8,37.3,30.1,00000
10.0,94.0,39.0,893,03,01,  Khan Para,219,377,120,170,99,207,36.7,41.4,32.4,00000
10.0,94.0,39.0,893,04,01,  Hajipur,160,267,89,116,71,151,37.5,43.4,32.0,00000
10.0,94.0,39.0,986,01,01,  Belai,426,822,228,377,198,445,34.1,37.7,30.8,00000
10.0,94.0,39.0,986,02,01,  Bhita,140,224,77,99,63,125,38.5,43.8,33.5,00000
10.0,94.0,39.0,986,03,01,  Bambu Para,65,41,37,19,28,22,61.3,66.1,56.0,00000
10.0,94.0,39.0,986,04,01,  Balarampur,190,187,105,92,85,95,50.4,53.3,47.2,00000
10.0,94.0,39.0,986,05,01,  Jhalkhur,117,164,70,84,47,80,41.6,45.5,37.0,00000
10.0,94.0,47.0,077,01,01,  Jamalpur,141,174,71,83,70,91,44.8,46.1,43.5,00000
10.0,94.0,47.0,077,02,01,  Paik Para,45,152,23,72,22,80,22.8,24.2,21.6,00000
10.0,94.0,47.0,077,03,01,  Bawlatala,160,361,87,158,73,203,30.7,35.5,26.4,00000
10.0,94.0,47.0,085,01,01,  Bagalpur,294,469,134,219,160,250,38.5,38.0,39.0,00000
10.0,94.0,47.0,085,02,01,  Balu Para,137,247,68,121,69,126,35.7,36.0,35.4,00000
10.0,94.0,47.0,101,01,01,  Barailgang Para,87,107,48,53,39,54,44.8,47.5,41.9,00000
10.0,94.0,47.0,101,02,01,  Akanda Para,33,62,18,26,15,36,34.7,40.9,29.4,00000
10.0,94.0,47.0,101,03,01,  Delwarer Para,16,62,7,30,9,32,20.5,18.9,22.0,00000
10.0,94.0,47.0,101,04,01,  Sahadater Para,179,235,94,116,85,119,43.2,44.8,41.7,00000
10.0,94.0,47.0,101,05,01,  Madhyapara,131,162,75,72,56,90,44.7,51.0,38.4,00000
10.0,94.0,47.0,101,06,01,  Dakshinpara,78,183,36,88,42,95,29.9,29.0,30.7,00000
10.0,94.0,47.0,101,07,01,  Rabia Munshir Para,1,37,0,18,1,19,2.6,0.0,5.0,00000
10.0,94.0,47.0,101,08,01,  Soleman Master Para,129,183,60,85,69,98,41.3,41.4,41.3,00000
10.0,94.0,47.0,101,09,01,  Mandal Para,122,119,71,46,51,73,50.6,60.7,41.1,00000
10.0,94.0,47.0,101,10,01,  Purbapara,75,316,38,153,37,163,19.2,19.9,18.5,00000
10.0,94.0,47.0,101,11,01,  Kandu Para,123,147,71,63,52,84,45.6,53.0,38.2,00000
10.0,94.0,47.0,101,12,01,  Panatia,127,252,67,115,60,137,33.5,36.8,30.5,00000
10.0,94.0,47.0,207,01,01,  Hindu Para,100,135,50,71,50,64,42.6,41.3,43.9,00000
10.0,94.0,47.0,207,02,01,  Mushar Chak,17,41,11,20,6,21,29.3,35.5,22.2,00000
10.0,94.0,47.0,207,03,01,  Madhya Char Para,228,168,124,77,104,91,57.6,61.7,53.3,00000
10.0,94.0,47.0,207,04,01,  Dakshinpara,138,154,60,70,78,84,47.3,46.2,48.1,00000
10.0,94.0,47.0,211,01,01,  Chak Bagalpur,145,180,73,81,72,99,44.6,47.4,42.1,00000
10.0,94.0,47.0,211,02,01,  Mutuk,75,118,39,57,36,61,38.9,40.6,37.1,00000
10.0,94.0,47.0,247,01,01,  Mandal Para,116,188,65,86,51,102,38.2,43.0,33.3,00000
10.0,94.0,47.0,247,02,01,  Hindu Para,39,40,21,16,18,24,49.4,56.8,42.9,00000
10.0,94.0,47.0,247,03,01,  Bawlatala,57,124,26,60,31,64,31.5,30.2,32.6,00000
10.0,94.0,47.0,247,04,01,  Haludbari,93,186,52,95,41,91,33.3,35.4,31.1,00000
10.0,94.0,47.0,247,05,01,  Purbapara,10,20,5,11,5,9,33.3,31.3,35.7,00000
10.0,94.0,47.0,365,01,01,  Dakshinpara,34,70,17,35,17,35,32.7,32.7,32.7,00000
10.0,94.0,47.0,365,02,01,  Uttarpara,161,178,87,91,74,87,47.5,48.9,46.0,00000
10.0,94.0,47.0,365,03,01,  Purbapara,22,64,8,30,14,34,25.6,21.1,29.2,00000
10.0,94.0,47.0,365,04,01,  Paschimpara,50,117,25,56,25,61,29.9,30.9,29.1,00000
10.0,94.0,47.0,385,01,01,  Matuk Daridaha,29,86,12,43,17,43,25.2,21.8,28.3,00000
10.0,94.0,47.0,385,02,01,  Gachu Para,239,287,118,126,121,161,45.4,48.4,42.9,00000
10.0,94.0,47.0,385,03,01,  Chhota Gachupara,110,105,56,46,54,59,51.2,54.9,47.8,00000
10.0,94.0,47.0,385,04,01,  Kalaihatta,61,153,25,76,36,77,28.5,24.8,31.9,00000
10.0,94.0,47.0,385,05,01,  Daridaha Bazar,280,130,159,66,121,64,68.3,70.7,65.4,00000
10.0,94.0,47.0,426,01,01,  Gokarna,124,182,65,84,59,98,40.5,43.6,37.6,00000
10.0,94.0,47.0,426,02,01,  Chandari,116,271,61,131,55,140,30.0,31.8,28.2,00000
10.0,94.0,47.0,426,03,01,  Nagarjan,121,234,64,117,57,117,34.1,35.4,32.8,00000
10.0,94.0,47.0,523,01,01,  Khamar Para,74,69,37,30,37,39,51.7,55.2,48.7,00000
10.0,94.0,47.0,523,02,01,  Chak Kalugari,121,221,58,109,63,112,35.4,34.7,36.0,00000
10.0,94.0,47.0,523,03,01,  Kalugari Uttarpara,124,219,73,96,51,123,36.2,43.2,29.3,00000
10.0,94.0,47.0,523,04,01,  Dakshinpara,141,239,72,108,69,131,37.1,40.0,34.5,00000
10.0,94.0,47.0,584,01,01,  Mandal Para,55,89,35,44,20,45,38.2,44.3,30.8,00000
10.0,94.0,47.0,584,02,01,  Purbapara,141,255,66,125,75,130,35.6,34.6,36.6,00000
10.0,94.0,47.0,584,03,01,  Jangal,163,123,81,47,82,76,57.0,63.3,51.9,00000
10.0,94.0,47.0,645,01,01,  Balu Pathar,34,91,14,47,20,44,27.2,23.0,31.3,00000
10.0,94.0,47.0,645,02,01,  Karim Para,41,123,24,57,17,66,25.0,29.6,20.5,00000
10.0,94.0,47.0,645,03,01,  Sarkar Para,136,81,70,36,66,45,62.7,66.0,59.5,00000
10.0,94.0,47.0,645,04,01,  Talukdar Para,209,169,110,77,99,92,55.3,58.8,51.8,00000
10.0,94.0,47.0,645,05,01,  Khan Para,8,77,6,38,2,39,9.4,13.6,4.9,00000
10.0,94.0,47.0,645,06,01,  Mahabat Hazi Para,45,85,24,40,21,45,34.6,37.5,31.8,00000
10.0,94.0,47.0,645,07,01,  Porali Para,34,51,18,25,16,26,40.0,41.9,38.1,00000
10.0,94.0,47.0,657,01,01,  Sardar Para,91,182,40,87,51,95,33.3,31.5,34.9,00000
10.0,94.0,47.0,657,02,01,  Kalaihati,249,144,120,69,129,75,63.4,63.5,63.2,00000
10.0,94.0,47.0,657,03,01,  Majumdar Para,24,7,12,3,12,4,77.4,80.0,75.0,00000
10.0,94.0,47.0,657,04,01,  Jhau Para,108,220,52,110,56,110,32.9,32.1,33.7,00000
10.0,94.0,47.0,657,05,01,  Uttarpara,110,95,53,43,57,52,53.7,55.2,52.3,00000
10.0,94.0,47.0,657,06,01,  Dakshinpara,146,334,75,150,71,184,30.4,33.3,27.8,00000
10.0,94.0,47.0,657,07,01,  Gasua Para,244,346,136,150,108,196,41.4,47.6,35.5,00000
10.0,94.0,47.0,690,01,01,  Mostafapur,28,81,15,41,13,40,25.7,26.8,24.5,00000
10.0,94.0,47.0,690,02,01,  Akanda Para,118,239,60,110,58,129,33.1,35.3,31.0,00000
10.0,94.0,47.0,690,03,01,  Paschimpara,150,213,73,93,77,120,41.3,44.0,39.1,00000
10.0,94.0,47.0,690,04,01,  Sarkar Para,63,147,31,65,32,82,30.0,32.3,28.1,00000
10.0,94.0,47.0,710,01,01,  Purbapara,136,221,64,109,72,112,38.1,37.0,39.1,00000
10.0,94.0,47.0,710,02,01,  Hindu Para,33,71,11,34,22,37,31.7,24.4,37.3,00000
10.0,94.0,47.0,731,01,01,  Purbapara,122,103,58,49,64,54,54.2,54.2,54.2,00000
10.0,94.0,47.0,731,02,01,  Madhyapara,178,102,93,47,85,55,63.6,66.4,60.7,00000
10.0,94.0,47.0,731,03,01,  Paschimpara,188,137,103,66,85,71,57.8,60.9,54.5,00000
10.0,94.0,47.0,763,01,01,  Niamatpur,156,296,74,127,82,169,34.5,36.8,32.7,00000
10.0,94.0,47.0,763,02,01,  Par Niamatpur,369,471,189,205,180,266,43.9,48.0,40.4,00000
10.0,94.0,47.0,800,01,01,  Badi Beparir Para,84,101,47,44,37,57,45.4,51.6,39.4,00000
10.0,94.0,47.0,800,02,01,  Majhi Para,74,126,39,57,35,69,37.0,40.6,33.7,00000
10.0,94.0,47.0,800,03,01,  Meser Doctor Para,116,176,43,91,73,85,39.7,32.1,46.2,00000
10.0,94.0,47.0,800,04,01,  Akbar Mondaler Para,130,136,64,58,66,78,48.9,52.5,45.8,00000
10.0,94.0,47.0,800,05,01,  Ghosh Para,7,42,4,22,3,20,14.3,15.4,13.0,00000
10.0,94.0,47.0,800,06,01,  Naya Para,76,292,32,137,44,155,20.7,18.9,22.1,00000
10.0,94.0,47.0,800,07,01,  Aina Para,74,169,38,81,36,88,30.5,31.9,29.0,00000
10.0,94.0,47.0,925,01,01,  Dakshinpara,75,449,35,211,40,238,14.3,14.2,14.4,00000
10.0,94.0,47.0,925,02,01,  Akanda Para,71,34,37,13,34,21,67.6,74.0,61.8,00000
10.0,94.0,47.0,925,03,01,  Khan Para,48,9,21,3,27,6,84.2,87.5,81.8,00000
10.0,94.0,47.0,925,04,01,  Porabari,67,265,27,141,40,124,20.2,16.1,24.4,00000
10.0,94.0,47.0,925,05,01,  Sardar Para,61,56,36,24,25,32,52.1,60.0,43.9,00000
10.0,94.0,47.0,925,06,01,  Sonar Para,59,35,30,17,29,18,62.8,63.8,61.7,00000
10.0,94.0,47.0,990,01,01,  Naya Para,106,459,56,222,50,237,18.8,20.1,17.4,00000
10.0,94.0,47.0,990,02,01,  Barugari,98,146,55,71,43,75,40.2,43.7,36.4,00000
10.0,94.0,47.0,990,03,01,  Porabari,108,227,61,113,47,114,32.2,35.1,29.2,00000
10.0,94.0,55.0,194,01,01,  Binna Chapar,428,349,232,158,196,191,55.1,59.5,50.6,00000
10.0,94.0,55.0,194,02,01,  Kaiuni,140,222,84,112,56,110,38.7,42.9,33.7,00000
10.0,94.0,55.0,239,02,01,  Naidobi,320,176,176,87,144,89,64.5,66.9,61.8,00000
10.0,94.0,55.0,284,01,01,  Chatua,1170,1113,665,485,505,628,51.2,57.8,44.6,00000
10.0,94.0,55.0,284,02,01,  Surail,170,237,102,107,68,130,41.8,48.8,34.3,00000
10.0,94.0,55.0,284,03,01,  Taltala,54,28,33,11,21,17,65.9,75.0,55.3,00000
10.0,94.0,55.0,284,04,01,  Salukgari,124,46,66,21,58,25,72.9,75.9,69.9,00000
10.0,94.0,55.0,328,01,01,  Damgara,1098,1395,648,615,450,780,44.0,51.3,36.6,00000
10.0,94.0,55.0,328,02,01,  Gamra,263,265,159,143,104,122,49.8,52.6,46.0,00000
10.0,94.0,55.0,560,01,01,  Kelunja,257,332,128,159,129,173,43.6,44.6,42.7,00000
10.0,94.0,55.0,560,02,01,  Manglahar,111,221,54,111,57,110,33.4,32.7,34.1,00000
10.0,94.0,63.0,016,01,01,  Alak Diar,124,247,67,132,57,115,33.4,33.7,33.1,00000
10.0,94.0,63.0,016,02,01,  Par Krishnapur,144,326,77,181,67,145,30.6,29.8,31.6,00000
10.0,94.0,63.0,227,01,01,  Gopinpur,110,175,53,79,57,96,38.6,40.2,37.3,00000
10.0,94.0,63.0,227,02,01,  Ramchandrapur,222,69,124,21,98,48,76.3,85.5,67.1,00000
10.0,94.0,63.0,231,01,01,  Satana,556,891,302,422,254,469,38.4,41.7,35.1,00000
10.0,94.0,63.0,231,02,01,  Bepari Para,327,261,176,114,151,147,55.6,60.7,50.7,00000
10.0,94.0,63.0,231,03,01,  Sarkar Para,302,221,166,90,136,131,57.7,64.8,50.9,00000
10.0,94.0,63.0,231,04,01,  Chak Alma,541,445,273,203,268,242,54.9,57.4,52.5,00000
10.0,94.0,63.0,454,01,01,  Jabaripur,429,823,234,425,195,398,34.3,35.5,32.9,00000
10.0,94.0,63.0,454,02,01,  Kholar Para,282,581,141,264,141,317,32.7,34.8,30.8,00000
10.0,94.0,63.0,454,03,01,  Bara Haripur,314,504,180,243,134,261,38.4,42.6,33.9,00000
10.0,94.0,63.0,454,04,01,  Chalanakati,244,285,133,135,111,150,46.1,49.6,42.5,00000
10.0,94.0,63.0,454,05,01,  Chhota Haripur,134,209,69,109,65,100,39.1,38.8,39.4,00000
10.0,94.0,63.0,625,01,01,  Lakshmipur,271,356,150,165,121,191,43.2,47.6,38.8,00000
10.0,94.0,63.0,625,02,01,  Mokamtala,867,306,483,139,384,167,73.9,77.7,69.7,00000
10.0,94.0,63.0,670,01,01,  Majh Para,283,279,147,133,136,146,50.4,52.5,48.2,00000
10.0,94.0,63.0,670,02,01,  Phultala,112,136,62,62,50,74,45.2,50.0,40.3,00000
10.0,94.0,63.0,905,01,01,  Radhakrishnapur,113,368,62,184,51,184,23.5,25.2,21.7,00000
10.0,94.0,63.0,905,02,01,  Sankarpur,1516,1303,854,620,662,683,53.8,57.9,49.2,00000
10.0,94.0,63.0,905,03,01,  Mokamtala,383,129,218,44,165,85,74.8,83.2,66.0,00000
10.0,94.0,71.0,105,01,01,  Chak Kusha,132,163,76,76,56,87,44.7,50.0,39.2,00000
10.0,94.0,71.0,105,02,01,  Dehara Para,329,517,177,232,152,285,38.9,43.3,34.8,00000
10.0,94.0,71.0,828,01,01,  Kamlihara,322,251,203,96,119,155,56.2,67.9,43.4,00000
10.0,94.0,71.0,828,02,01,  Chak Pukuria,99,68,61,27,38,41,59.3,69.3,48.1,00000
10.0,94.0,71.0,828,03,01,  Debchundi,272,329,150,144,122,185,45.3,51.0,39.7,00000
10.0,94.0,71.0,828,04,01,  Laoghat Pirab,844,790,451,335,393,455,51.7,57.4,46.3,00000
10.0,94.0,79.0,008,01,01,  Achlai,346,645,193,313,153,332,34.9,38.1,31.5,00000
10.0,94.0,79.0,008,02,01,  Tepagari,736,1847,388,891,348,956,28.5,30.3,26.7,00000
10.0,94.0,79.0,536,01,01,  Karatkola,565,487,302,225,263,262,53.7,57.3,50.1,00000
10.0,94.0,79.0,536,02,01,  Baula Para,230,457,131,222,99,235,33.5,37.1,29.6,00000
10.0,94.0,79.0,649,01,01,  Mahasthangar,1153,2329,615,1190,538,1139,33.1,34.1,32.1,00000
10.0,94.0,79.0,649,02,01,  Mahastan,951,1098,495,501,456,597,46.4,49.7,43.3,00000
10.0,94.0,87.0,004,01,01,  Abhirampur,1063,359,551,158,512,201,74.8,77.7,71.8,00000
10.0,94.0,87.0,004,02,01,  Chak Kutub,365,476,193,203,172,273,43.4,48.7,38.7,00000
10.0,94.0,87.0,097,01,01,  Baikunthapur,180,239,86,107,94,132,43.0,44.6,41.6,00000
10.0,94.0,87.0,097,02,01,  Gokulpur,391,370,193,169,198,201,51.4,53.3,49.6,00000
10.0,94.0,87.0,304,01,01,  Uttar Daha Para,281,311,153,140,128,171,47.5,52.2,42.8,00000
10.0,94.0,87.0,304,02,01,  Dakshin Daha Para,1194,988,651,445,543,543,54.7,59.4,50.0,00000
10.0,94.0,87.0,605,01,01,  Kuki Kalidas,700,412,346,204,354,208,62.9,62.9,63.0,00000
10.0,94.0,87.0,605,02,01,  Daudpur,133,153,54,75,79,78,46.5,41.9,50.3,00000
10.0,94.0,87.0,609,01,01,  Kukibazit,159,342,91,163,68,179,31.7,35.8,27.5,00000
10.0,94.0,87.0,609,02,01,  Mamdatair,232,149,112,68,120,81,60.9,62.2,59.7,00000
10.0,94.0,87.0,836,01,01,  Uttar Saidpur,398,298,208,141,190,157,57.2,59.6,54.8,00000
10.0,94.0,87.0,836,02,01,  Dakshin Saidpur,732,512,414,227,318,285,58.8,64.6,52.7,00000
10.0,94.0,94.0,012,01,01,  Ranirpukur,217,219,120,89,97,130,49.8,57.4,42.7,00000
10.0,94.0,94.0,012,02,01,  Purbapara,289,503,154,245,135,258,36.5,38.6,34.4,00000
10.0,94.0,94.0,012,03,01,  Naya Para,177,314,102,147,75,167,36.0,41.0,31.0,00000
10.0,94.0,94.0,012,04,01,  Arulia Para,186,206,108,88,78,118,47.4,55.1,39.8,00000
10.0,94.0,94.0,012,05,01,  Ghagar Para,249,592,123,296,126,296,29.6,29.4,29.9,00000
10.0,94.0,94.0,353,01,01,  Porali,99,309,54,145,45,164,24.3,27.1,21.5,00000
10.0,94.0,94.0,353,02,01,  Milkipur,308,456,164,231,144,225,40.3,41.5,39.0,00000
10.0,94.0,94.0,353,03,01,  Paglapar,143,255,69,120,74,135,35.9,36.5,35.4,00000
10.0,94.0,94.0,353,04,01,  Mathura Para,308,782,160,357,148,425,28.3,30.9,25.8,00000
10.0,94.0,94.0,353,05,01,  Madhyapara,527,870,286,407,241,463,37.7,41.3,34.2,00000
10.0,94.0,94.0,467,01,01,  Sarkar Para,488,713,256,335,232,378,40.6,43.3,38.0,00000
10.0,94.0,94.0,467,02,01,  Dakshinpara,212,558,109,275,103,283,27.5,28.4,26.7,00000
10.0,94.0,94.0,467,03,01,  Mandal Para,219,336,108,161,111,175,39.5,40.1,38.8,00000
10.0,94.0,94.0,487,01,01,  Uttarpara,397,622,207,297,190,325,39.0,41.1,36.9,00000
10.0,94.0,94.0,487,02,01,  Kauli Para,644,881,355,418,289,463,42.2,45.9,38.4,00000
10.0,94.0,94.0,487,03,01,  Majh Para,400,503,216,229,184,274,44.3,48.5,40.2,00000
10.0,94.0,94.0,751,01,01,  Bara Narayanpur,340,359,192,152,148,207,48.6,55.8,41.7,00000
10.0,94.0,94.0,751,02,01,  Chhota Narayanpur,694,578,381,286,313,292,54.6,57.1,51.7,00000
10.0,94.0,94.0,982,01,01,  Purba Uthali,342,652,199,295,143,357,34.4,40.3,28.6,00000
10.0,94.0,94.0,982,02,01,  Paschim Uthali,978,737,542,327,436,410,57.0,62.4,51.5,00000
10.0,95.0,10.0,037,01,01,  Bagbari,230,274,133,115,97,159,45.6,53.6,37.9,00000
10.0,95.0,10.0,037,02,01,  Purkayet,170,268,91,123,79,145,38.8,42.5,35.3,00000
10.0,95.0,10.0,037,03,01,  Rakhalgachhi,234,190,123,81,111,109,55.2,60.3,50.5,00000
10.0,95.0,10.0,037,04,01,  Kusharghop,230,205,123,89,107,116,52.9,58.0,48.0,00000
10.0,95.0,10.0,037,05,01,  Janardanpur,118,217,75,84,43,133,35.2,47.2,24.4,00000
10.0,95.0,10.0,037,06,01,  Mukundapur,86,137,45,63,41,74,38.6,41.7,35.7,00000
10.0,95.0,10.0,037,07,01,  Chak Sayetpur,115,217,56,112,59,105,34.6,33.3,36.0,00000
10.0,95.0,10.0,068,01,01,  Barabalua,515,564,269,264,246,300,47.7,50.5,45.1,00000
10.0,95.0,10.0,068,02,01,  Samojatair,360,260,186,95,174,165,58.1,66.2,51.3,00000
10.0,95.0,10.0,281,01,01,  Dakshin Atkaria,826,1464,442,673,384,791,36.1,39.6,32.7,00000
10.0,95.0,10.0,281,02,01,  Jhinar Para,127,205,77,95,50,110,38.3,44.8,31.3,00000
10.0,95.0,10.0,326,01,01,  Dighir Para,160,147,90,74,70,73,52.1,54.9,49.0,00000
10.0,95.0,10.0,326,02,01,  Karni Para,121,139,54,65,67,74,46.5,45.4,47.5,00000
10.0,95.0,10.0,843,01,01,  Rashidpur,743,724,399,333,344,391,50.6,54.5,46.8,00000
10.0,95.0,10.0,843,02,01,  Patina Kuragram,247,279,119,137,128,142,47.0,46.5,47.4,00000
10.0,95.0,10.0,843,03,01,  Rashinabari,276,292,144,115,132,177,48.6,55.6,42.7,00000
10.0,95.0,10.0,957,01,01,  Uttar Dighalkandi,534,445,257,187,277,258,54.5,57.9,51.8,00000
10.0,95.0,10.0,957,02,01,  Baluapara,193,165,95,69,98,96,53.9,57.9,50.5,00000
10.0,95.0,31.0,668,01,01,  Mulbari,549,927,329,420,220,507,37.2,43.9,30.3,00000
10.0,95.0,31.0,668,02,01,  Koali Para,505,548,287,234,218,314,48.0,55.1,41.0,00000
10.0,95.0,31.0,729,01,01,  Nurpur,194,333,101,164,93,169,36.8,38.1,35.5,00000
10.0,95.0,31.0,729,02,01,  Chili Para,94,180,58,88,36,92,34.3,39.7,28.1,00000
10.0,95.0,31.0,896,01,01,  Sihipur,2117,1648,1144,719,973,929,56.2,61.4,51.2,00000
10.0,95.0,31.0,896,02,01,  Jahaneer Para,209,357,110,164,99,193,36.9,40.1,33.9,00000
10.0,95.0,42.0,083,01,01,  Uttar Boyra,485,611,248,280,237,331,44.3,47.0,41.7,00000
10.0,95.0,42.0,083,02,01,  Dakshin Boyra,522,518,268,237,254,281,50.2,53.1,47.5,00000
10.0,95.0,42.0,083,03,01,  Koshahata,256,279,129,127,127,152,47.9,50.4,45.5,00000
10.0,95.0,42.0,083,04,01,  Koradanga,244,203,124,90,120,113,54.6,57.9,51.5,00000
10.0,95.0,42.0,698,01,01,  Naodabaga,939,1694,519,804,420,890,35.7,39.2,32.1,00000
10.0,95.0,42.0,698,02,01,  Thakur Para,591,607,285,272,306,335,49.3,51.2,47.7,00000
10.0,95.0,42.0,698,03,01,  Hat Karamja,211,174,113,78,98,96,54.8,59.2,50.5,00000
10.0,95.0,42.0,698,04,01,  Gram Karamja,238,533,118,256,120,277,30.9,31.6,30.2,00000
10.0,95.0,42.0,888,01,01,  Sichar Para,1215,843,596,364,619,479,59.0,62.1,56.4,00000
10.0,95.0,42.0,888,02,01,  Bhelur Para,688,655,363,288,325,367,51.2,55.8,47.0,00000
10.0,95.0,42.0,888,03,01,  Kashibari,181,220,91,100,90,120,45.1,47.6,42.9,00000
10.0,95.0,42.0,972,01,01,  Uttar Jorgachha,845,825,448,342,397,483,50.6,56.7,45.1,00000
10.0,95.0,42.0,972,02,01,  Sonakania,1146,1780,618,820,528,960,39.2,43.0,35.5,00000
10.0,95.0,42.0,972,03,01,  Char Para,827,1043,448,455,379,588,44.2,49.6,39.2,00000
10.0,95.0,81.0,736,01,01,  Purba Padma Para,531,649,267,294,264,355,45.0,47.6,42.6,00000
10.0,95.0,81.0,736,02,01,  Paschim Padma Para,116,260,59,123,57,137,30.9,32.4,29.4,00000
10.0,95.0,81.0,744,01,01,  Pakulla Uttar Para,149,242,84,110,65,132,38.1,43.3,33.0,00000
10.0,95.0,81.0,744,02,01,  Pakulla,994,1510,540,685,454,825,39.7,44.1,35.5,00000
10.0,95.0,81.0,744,03,01,  Char Alkandi,358,748,212,359,146,389,32.4,37.1,27.3,00000
10.0,95.0,81.0,926,01,01,  Shyampur,644,775,341,362,303,413,45.4,48.5,42.3,00000
10.0,95.0,81.0,926,02,01,  Par Shyampur,242,379,129,175,113,204,39.0,42.4,35.6,00000
10.0,95.0,84.0,797,01,01,  Mashar Para Tekani,333,702,208,309,125,393,32.2,40.2,24.1,00000
10.0,95.0,84.0,797,02,01,  Mokamtala Para,774,1098,454,484,320,614,41.3,48.4,34.3,00000
10.0,95.0,84.0,797,03,01,  Purba Tekani,441,699,244,323,197,376,38.7,43.0,34.4,00000
88.0,11.0,27.0,343,01,01,  Ranipura,139,659,83,296,56,363,17.4,21.9,13.4,00000
88.0,11.0,27.0,343,02,01,  Dariapur,310,70,169,22,141,48,81.6,88.5,74.6,00000
88.0,11.0,27.0,343,03,01,  Char Delua,516,925,283,453,233,472,35.8,38.5,33.0,00000
88.0,11.0,27.0,343,04,01,  Delua (Part),113,92,53,39,60,53,55.1,57.6,53.1,00000
88.0,11.0,40.0,228,01,01,  Uttar Buniganti,1215,494,609,222,606,272,71.1,73.3,69.0,00000
88.0,11.0,40.0,228,02,01,  Dakshin Buniganti,1179,1103,645,500,534,603,51.7,56.3,47.0,00000
88.0,11.0,40.0,411,01,01,  Gabgachhi,703,1357,404,664,299,693,34.1,37.8,30.1,00000
88.0,11.0,40.0,411,02,01,  Chandangati,625,1058,329,515,296,543,37.1,39.0,35.3,00000
88.0,11.0,40.0,526,01,01,  Joknala,584,731,319,342,265,389,44.4,48.3,40.5,00000
88.0,11.0,40.0,526,02,01,  Chak Nalua,222,248,129,113,93,135,47.2,53.3,40.8,00000
88.0,11.0,40.0,526,03,01,  Char Joknala,590,782,303,407,287,375,43.0,42.7,43.4,00000
88.0,11.0,40.0,526,04,01,  Bhutia Para,174,246,119,93,55,153,41.4,56.1,26.4,00000
88.0,11.0,40.0,526,05,01,  Saldair,795,875,415,414,380,461,47.6,50.1,45.2,00000
88.0,11.0,40.0,972,01,01,  Tamai,6515,3716,3517,1920,2998,1796,63.7,64.7,62.5,00000
88.0,11.0,40.0,972,02,01,  Rayan Para,438,1507,255,744,183,763,22.5,25.5,19.3,00000
88.0,11.0,40.0,972,03,01,  Kalia Para,616,762,305,375,311,387,44.7,44.9,44.6,00000
88.0,11.0,40.0,972,04,01,  Kuthi Para,551,1022,307,478,244,544,35.0,39.1,31.0,00000
88.0,11.0,54.0,171,01,01,  Bhangabari,806,1015,445,470,361,545,44.3,48.6,39.8,00000
88.0,11.0,54.0,171,02,01,  Barapur,1375,1429,776,686,599,743,49.0,53.1,44.6,00000
88.0,11.0,54.0,331,01,01,  Daulatpur,3593,5178,1937,2598,1656,2580,41.0,42.7,39.1,00000
88.0,11.0,54.0,331,02,01,  Panch Takthukni,1796,2854,960,1432,836,1422,38.6,40.1,37.0,00000
88.0,11.0,54.0,709,01,01,  Mamudpur,1066,1351,601,673,465,678,44.1,47.2,40.7,00000
88.0,11.0,54.0,709,02,01,  Bilpara,13,17,8,9,5,8,43.3,47.1,38.5,00000
88.0,11.0,54.0,709,03,01,  Solakura,340,424,195,197,145,227,44.5,49.7,39.0,00000
88.0,11.0,67.0,160,01,01,  Dhukaria Bera,2802,2737,1465,1332,1337,1405,50.6,52.4,48.8,00000
88.0,11.0,67.0,160,02,01,  Bera Roypara,182,148,96,71,86,77,55.2,57.5,52.8,00000
88.0,11.0,67.0,297,01,01,  Char Ghughat,210,339,111,165,99,174,38.3,40.2,36.3,00000
88.0,11.0,67.0,297,02,01,  Balabari,310,438,164,209,146,229,41.4,44.0,38.9,00000
88.0,11.0,67.0,377,01,01,  Dhukaria,2367,1789,1267,804,1100,985,57.0,61.2,52.8,00000
88.0,11.0,67.0,377,02,01,  Pirar Char,555,542,290,257,265,285,50.6,53.0,48.2,00000
88.0,11.0,67.0,468,01,01,  Gopalpur,382,665,199,340,183,325,36.5,36.9,36.0,00000
88.0,11.0,67.0,468,02,01,  Char Gopalpur,428,641,236,312,192,329,40.0,43.1,36.9,00000
88.0,11.0,67.0,743,01,01,  Char Metuani,491,1066,279,501,212,565,31.5,35.8,27.3,00000
88.0,11.0,67.0,743,02,01,  Madhya Metuani,285,571,176,279,109,292,33.3,38.7,27.2,00000
88.0,11.0,67.0,743,03,01,  Talukdar Metuani,313,892,174,442,139,450,26.0,28.2,23.6,00000
88.0,11.0,67.0,743,04,01,  Metuani Jalua,136,129,79,57,57,72,51.3,58.1,44.2,00000
88.0,11.0,67.0,743,05,01,  Char Khashi,287,77,148,32,139,45,78.8,82.2,75.5,00000
88.0,11.0,67.0,834,01,01,  Saguna,1070,1263,571,601,499,662,45.9,48.7,43.0,00000
88.0,11.0,67.0,834,02,01,  Chhota Saguna,145,183,82,82,63,101,44.2,50.0,38.4,00000
88.0,11.0,67.0,880,01,01,  Saratail,947,1023,500,482,447,541,48.1,50.9,45.2,00000
88.0,11.0,67.0,880,02,01,  Khamar Ullah Para,1155,2184,617,1100,538,1084,34.6,35.9,33.2,00000
88.0,11.0,81.0,022,01,01,  Aguria,748,1813,410,890,338,923,29.2,31.5,26.8,00000
88.0,11.0,81.0,022,02,01,  Harinathpur,339,882,190,416,149,466,27.8,31.4,24.2,00000
88.0,11.0,81.0,080,01,01,  Bamanbaria,64,190,38,91,26,99,25.2,29.5,20.8,00000
88.0,11.0,81.0,080,02,01,  Kadamtali,824,558,448,263,376,295,59.6,63.0,56.0,00000
88.0,11.0,81.0,182,01,01,  Bhaturia,759,963,410,445,349,518,44.1,48.0,40.3,00000
88.0,11.0,81.0,182,02,01,  Boyalgachhi,115,194,51,98,64,96,37.2,34.2,40.0,00000
88.0,11.0,81.0,686,01,01,  Purba Majhail,1494,1251,796,589,698,662,54.4,57.5,51.3,00000
88.0,11.0,81.0,686,02,01,  Paschim Majhail,748,1470,379,749,369,721,33.7,33.6,33.9,00000
88.0,11.0,81.0,697,01,01,  Makimpur,106,455,52,231,54,224,18.9,18.4,19.4,00000
88.0,11.0,81.0,697,02,01,  Chak Makimpur,688,639,372,279,316,360,51.8,57.1,46.7,00000
88.0,11.0,81.0,812,01,01,  Uttar Rajapur,1248,1100,693,521,555,579,53.2,57.1,48.9,00000
88.0,11.0,81.0,812,02,01,  Tangrakhali,224,201,120,98,104,103,52.7,55.0,50.2,00000
88.0,11.0,81.0,812,03,01,  Dakshin Rajapur,930,1187,488,578,442,609,43.9,45.8,42.1,00000
88.0,11.0,81.0,812,04,01,  Samaspur,677,511,337,229,340,282,57.0,59.5,54.7,00000
88.0,11.0,81.0,812,05,01,  Boyal Gachhi,202,515,106,266,96,249,28.2,28.5,27.8,00000
88.0,11.0,81.0,823,01,01,  Purba Randhunibari,531,1058,236,542,295,516,33.4,30.3,36.4,00000
88.0,11.0,81.0,823,02,01,  Paschim Randhunibari,1356,692,701,306,655,386,66.2,69.6,62.9,00000
88.0,11.0,81.0,869,01,01,  Samaspur,663,932,359,465,304,467,41.6,43.6,39.4,00000
88.0,11.0,81.0,869,02,01,  Char Samaspur,494,867,257,434,237,433,36.3,37.2,35.4,00000
88.0,27.0,27.0,512,01,03,  Paschimpara,516,725,303,318,213,407,41.6,48.8,34.4,00000
88.0,27.0,27.0,512,02,03,  Uttarpara,1458,2634,854,1210,604,1424,35.6,41.4,29.8,00000
88.0,27.0,27.0,512,03,03,  Madhya Jotpara,1004,1391,559,598,445,793,41.9,48.3,35.9,00000
88.0,27.0,27.0,512,04,03,  Paschim Jotpara,595,941,331,461,264,480,38.7,41.8,35.5,00000
88.0,27.0,27.0,512,05,03,  Dakshin Jotpara,255,433,135,194,120,239,37.1,41.0,33.4,00000
88.0,27.0,27.0,512,06,03,  Madhyapara,127,491,69,230,58,261,20.6,23.1,18.2,00000
88.0,27.0,27.0,512,07,03,  Dakshinpara,208,535,111,259,97,276,28.0,30.0,26.0,00000
88.0,27.0,27.0,512,08,03,  Purba Jotpara,473,603,263,258,210,345,44.0,50.5,37.8,00000
88.0,27.0,31.0,160,01,01,  Paschim Kodalia,511,1314,296,629,215,685,28.0,32.0,23.9,00000
88.0,27.0,31.0,160,02,01,  Purba Kodalia,803,1106,412,483,391,623,42.1,46.0,38.6,00000
88.0,27.0,31.0,526,01,01,  Uttarpara,716,1328,400,587,316,741,35.0,40.5,29.9,00000
88.0,27.0,31.0,526,02,01,  Dakshinpara,882,2088,475,936,407,1152,29.7,33.7,26.1,00000
88.0,27.0,47.0,086,01,01,  Bindaha,237,485,128,253,109,232,32.8,33.6,32.0,00000
88.0,27.0,47.0,086,02,01,  Sahajada Para,130,269,80,133,50,136,32.6,37.6,26.9,00000
88.0,27.0,47.0,158,01,01,  Chandpur,1016,638,544,319,472,319,61.4,63.0,59.7,00000
88.0,44.0,19.0,090,01,01,  Beara,316,899,178,435,138,464,26.0,29.0,22.9,00000
88.0,44.0,19.0,090,02,01,  Nandina,727,860,357,394,370,466,45.8,47.5,44.3,00000
88.0,44.0,19.0,108,01,01,  Bhadraghat Bazar,1803,1702,917,851,886,851,51.4,51.9,51.0,00000
88.0,44.0,19.0,108,02,01,  Naya Para,104,217,61,104,43,113,32.4,37.0,27.6,00000
88.0,44.0,19.0,108,03,01,  Kachari Para,252,199,133,90,119,109,55.9,59.6,52.2,00000
88.0,44.0,19.0,108,04,01,  Kuthir Char,693,1233,372,576,321,657,36.0,39.2,32.8,00000
88.0,44.0,19.0,108,05,01,  Sathibari,109,222,61,97,48,125,32.9,38.6,27.7,00000
88.0,44.0,19.0,108,06,01,  Nayani Para,39,28,29,14,10,14,58.2,67.4,41.7,00000
88.0,44.0,19.0,108,07,01,  Bir Bhadraghat,159,247,75,113,84,134,39.2,39.9,38.5,00000
88.0,44.0,19.0,108,08,01,  Moghai,102,435,59,214,43,221,19.0,21.6,16.3,00000
88.0,44.0,19.0,325,01,01,  Dhamkul,373,760,168,371,205,389,32.9,31.2,34.5,00000
88.0,44.0,19.0,325,02,01,  Jangaliaganti,22,66,13,31,9,35,25.0,29.5,20.5,00000
88.0,44.0,19.0,361,01,01,  Char Dogachhi,461,935,261,449,200,486,33.0,36.8,29.2,00000
88.0,44.0,19.0,361,02,01,  Puran Dogachhi,120,605,58,302,62,303,16.6,16.1,17.0,00000
88.0,44.0,19.0,379,01,01,  Garabari,366,251,186,107,180,144,59.3,63.5,55.6,00000
88.0,44.0,19.0,379,02,01,  Char Garabari,223,229,117,107,106,122,49.3,52.2,46.5,00000
88.0,44.0,19.0,723,01,01,  Mug Belai,154,157,71,67,83,90,49.5,51.4,48.0,00000
88.0,44.0,19.0,723,02,01,  Sarkar Para,354,302,186,151,168,151,54.0,55.2,52.7,00000
88.0,44.0,19.0,994,01,01,  Nurnagar,331,520,165,253,166,267,38.9,39.5,38.3,00000
88.0,44.0,19.0,994,02,01,  Char Nurnagar,398,542,224,265,174,277,42.3,45.8,38.6,00000
88.0,44.0,38.0,271,01,01,  Dahsika,625,828,346,359,279,469,43.0,49.1,37.3,00000
88.0,44.0,38.0,271,02,01,  Char Dahsika,515,388,285,165,230,223,57.0,63.3,50.8,00000
88.0,44.0,38.0,488,01,03,  Kamarkhanda,641,722,323,326,318,396,47.0,49.8,44.5,00000
88.0,44.0,38.0,488,02,03,  Char Kamarkhanda,229,251,125,128,104,123,47.7,49.4,45.8,00000
88.0,44.0,38.0,596,01,01,  Kora Udaypur,505,499,260,213,245,286,50.3,55.0,46.1,00000
88.0,44.0,38.0,596,02,01,  Kora Udaypur Char Para,88,212,46,102,42,110,29.3,31.1,27.6,00000
88.0,44.0,38.0,633,01,01,  Bara Kura,1384,1201,691,537,693,664,53.5,56.3,51.1,00000
88.0,44.0,38.0,633,02,01,  Char Kura,758,1046,395,473,363,573,42.0,45.5,38.8,00000
88.0,44.0,38.0,633,03,01,  Dhunchi,64,143,43,66,21,77,30.9,39.4,21.4,00000
88.0,44.0,38.0,795,01,01,  Char Bara Dhul,111,398,55,185,56,213,21.8,22.9,20.8,00000
88.0,44.0,38.0,795,02,01,  Bara Pakuria,298,628,161,299,137,329,32.2,35.0,29.4,00000
88.0,44.0,38.0,795,03,01,  Chhota Pakuria,139,469,72,250,67,219,22.9,22.4,23.4,00000
88.0,44.0,38.0,795,04,01,  Krishna Diar,116,121,59,58,57,63,48.9,50.4,47.5,00000
88.0,44.0,38.0,976,01,01,  Alok Diar,936,880,460,399,476,481,51.5,53.6,49.7,00000
88.0,44.0,38.0,976,02,01,  Tengrail,168,258,99,119,69,139,39.4,45.4,33.2,00000
88.0,44.0,38.0,976,03,01,  Bhayer Char,340,296,161,147,179,149,53.5,52.3,54.6,00000
88.0,44.0,38.0,976,04,01,  Char Tengrail,1119,857,581,427,538,430,56.6,57.6,55.6,00000
88.0,44.0,57.0,180,01,01,  Nayachala,268,397,121,191,147,206,40.3,38.8,41.6,00000
88.0,44.0,57.0,180,02,01,  Chala,1116,950,586,415,530,535,54.0,58.5,49.8,00000
88.0,44.0,57.0,470,01,01,  Joyen Bara Dhul,886,977,467,446,419,531,47.6,51.2,44.1,00000
88.0,44.0,57.0,470,02,01,  Char Bara Dhul,661,889,351,392,310,497,42.6,47.2,38.4,00000
88.0,44.0,57.0,705,01,01,  Maynakandi,262,331,119,144,143,187,44.2,45.2,43.3,00000
88.0,44.0,57.0,705,02,01,  Kashiahati,176,180,88,81,88,99,49.4,52.1,47.1,00000
88.0,44.0,57.0,958,01,01,  Teghari,553,873,280,435,273,438,38.8,39.2,38.4,00000
88.0,44.0,57.0,958,02,01,  Saldair,165,197,93,105,72,92,45.6,47.0,43.9,00000
88.0,44.0,76.0,217,01,01,  Purba Chaubaria,1204,1017,606,455,598,562,54.2,57.1,51.6,00000
88.0,44.0,76.0,217,02,01,  Paschim Chaubaria,552,624,299,298,253,326,46.9,50.1,43.7,00000
88.0,44.0,76.0,217,03,01,  Balarampur,483,637,248,279,235,358,43.1,47.1,39.6,00000
88.0,44.0,76.0,289,01,01,  Uttar Roy Daulatpur,1004,829,512,366,492,463,54.8,58.3,51.5,00000
88.0,44.0,76.0,289,02,01,  Dakshin Roy Daulatpur,513,757,255,360,258,397,40.4,41.5,39.4,00000
88.0,44.0,76.0,307,01,01,  Dhaleshwar,776,754,400,324,376,430,50.7,55.2,46.7,00000
88.0,44.0,76.0,307,02,01,  Thakur Para,434,711,218,341,216,370,37.9,39.0,36.9,00000
88.0,44.0,76.0,307,03,01,  Haiderpur,758,561,378,231,380,330,57.5,62.1,53.5,00000
88.0,44.0,76.0,307,04,01,  Pechar Para,176,124,94,55,82,69,58.7,63.1,54.3,00000
88.0,44.0,76.0,850,01,01,  Rasulpur,1022,1542,554,702,468,840,39.9,44.1,35.8,00000
88.0,44.0,76.0,850,02,01,  Jatibari,369,378,172,175,197,203,49.4,49.6,49.3,00000
88.0,44.0,76.0,850,03,01,  Gopalpur,562,610,303,267,259,343,48.0,53.2,43.0,00000
88.0,44.0,76.0,850,04,01,  Sonapur,123,185,80,87,43,98,39.9,47.9,30.5,00000
88.0,44.0,76.0,868,01,01,  Sabazpur,1025,1115,541,477,484,638,47.9,53.1,43.1,00000
88.0,44.0,76.0,868,02,01,  Pathan Para,331,293,160,116,171,177,53.0,58.0,49.1,00000
88.0,50.0,15.0,389,01,01,  Guakhara (Guzabari),381,429,193,202,188,227,47.0,48.9,45.3,00000
88.0,50.0,15.0,389,02,01,  Guzabari,345,438,184,215,161,223,44.1,46.1,41.9,00000
88.0,50.0,17.0,118,01,01,  Bhanudanga,704,1860,377,877,327,983,27.5,30.1,25.0,00000
88.0,50.0,17.0,118,02,01,  Char Bhanduanga,1377,2775,761,1293,616,1482,33.2,37.0,29.4,00000
88.0,50.0,17.0,118,03,01,  Hajrahati,339,1025,173,489,166,536,24.9,26.1,23.6,00000
88.0,50.0,17.0,118,04,01,  Khuksia,140,135,83,61,57,74,50.9,57.6,43.5,00000
88.0,50.0,17.0,364,01,01,  Garaber,384,802,188,340,196,462,32.4,35.6,29.8,00000
88.0,50.0,17.0,364,02,01,  Godagari,175,309,90,131,85,178,36.2,40.7,32.3,00000
88.0,50.0,17.0,364,03,01,  Shimul Dair,1068,1781,555,774,513,1007,37.5,41.8,33.8,00000
88.0,50.0,17.0,364,04,01,  Shyampur,243,382,128,169,115,213,38.9,43.1,35.1,00000
88.0,50.0,25.0,068,01,01,  Baraitala,1045,980,570,435,475,545,51.6,56.7,46.6,00000
88.0,50.0,25.0,068,02,01,  Baraitala Naya Para,222,627,124,292,98,335,26.1,29.8,22.6,00000
88.0,50.0,25.0,354,01,01,  Uttar Gandail,704,870,342,382,362,488,44.7,47.2,42.6,00000
88.0,50.0,25.0,354,02,01,  Dakshin Gandail,1712,2046,889,958,823,1088,45.6,48.1,43.1,00000
88.0,50.0,25.0,354,03,01,  Naya Para,277,383,157,180,120,203,42.0,46.6,37.2,00000
88.0,50.0,25.0,354,04,01,  Khamar Para,166,305,89,137,77,168,35.2,39.4,31.4,00000
88.0,50.0,25.0,354,06,01,  Dublai Purba,397,661,205,275,192,386,37.5,42.7,33.2,00000
88.0,50.0,25.0,354,07,01,  Dublai Paschim,356,377,167,162,189,215,48.6,50.8,46.8,00000
88.0,50.0,25.0,354,08,01,  Bawaikhola,800,721,387,303,413,418,52.6,56.1,49.7,00000
88.0,50.0,25.0,354,09,01,  Purba Khuiksia,147,94,74,40,73,54,61.0,64.9,57.5,00000
88.0,50.0,25.0,354,10,01,  Khaskhuksia,332,217,183,85,149,132,60.5,68.3,53.0,00000
88.0,50.0,25.0,502,01,01,  Kalikapur,313,812,171,375,142,437,27.8,31.3,24.5,00000
88.0,50.0,25.0,502,02,01,  Ullah Para,262,569,145,280,117,289,31.5,34.1,28.8,00000
88.0,50.0,25.0,502,03,01,  Uatgari,447,588,257,254,190,334,43.2,50.3,36.3,00000
88.0,50.0,25.0,502,04,01,  Kunkunia,175,418,95,185,80,233,29.5,33.9,25.6,00000
88.0,50.0,25.0,561,01,01,  Paschim Khuksia,321,477,156,212,165,265,40.2,42.4,38.4,00000
88.0,50.0,25.0,561,02,01,  Chak Dampur,197,421,108,192,89,229,31.9,36.0,28.0,00000
88.0,50.0,25.0,797,01,01,  Paschim Betgari,268,625,133,276,135,349,30.0,32.5,27.9,00000
88.0,50.0,25.0,797,02,01,  Char Betgari,165,530,107,230,58,300,23.7,31.8,16.2,00000
88.0,50.0,25.0,797,03,01,  Tikria Bhita,202,450,110,189,92,261,31.0,36.8,26.1,00000
88.0,50.0,34.0,531,01,01,  Kazipur (Saudtala),667,1370,373,606,294,764,32.7,38.1,27.8,00000
88.0,50.0,34.0,531,02,01,  Manikpatal,409,571,245,252,164,319,41.7,49.3,34.0,00000
88.0,50.0,34.0,551,01,01,  Khudbandi,655,614,329,250,326,364,51.6,56.8,47.2,00000
88.0,50.0,34.0,551,02,01,  Fakir Para,245,216,119,89,126,127,53.1,57.2,49.8,00000
88.0,50.0,34.0,551,03,01,  Masuakandi,272,270,155,112,117,158,50.2,58.1,42.5,00000
88.0,50.0,34.0,689,01,01,  Palashpur,387,642,217,284,170,358,37.6,43.3,32.2,00000
88.0,50.0,34.0,689,02,01,  Natun Meghai,466,562,258,240,208,322,45.3,51.8,39.2,00000
88.0,50.0,34.0,689,03,01,  Meghai,941,1000,511,454,430,546,48.5,53.0,44.1,00000
88.0,50.0,34.0,689,04,01,  Baraitali,1367,1087,737,489,630,598,55.7,60.1,51.3,00000
88.0,50.0,34.0,689,05,01,  Muslim Para,1035,1126,554,507,481,619,47.9,52.2,43.7,00000
88.0,50.0,43.0,866,01,01,  Rajbari,393,503,213,241,180,262,43.9,46.9,40.7,00000
88.0,50.0,43.0,866,02,01,  Khas Rajbari,223,743,132,343,91,400,23.1,27.8,18.5,00000
88.0,50.0,51.0,610,01,01,  Chhalabhara,1730,2232,943,1024,787,1208,43.7,47.9,39.4,00000
88.0,50.0,51.0,610,02,01,  Beltail,718,1396,389,647,329,749,34.0,37.5,30.5,00000
88.0,50.0,51.0,610,03,01,  Chak Para,438,875,224,433,214,442,33.4,34.1,32.6,00000
88.0,50.0,51.0,650,01,01,  Bil Chatial,824,945,450,435,374,510,46.6,50.8,42.3,00000
88.0,50.0,51.0,650,02,01,  Maijbari,851,883,475,390,376,493,49.1,54.9,43.3,00000
88.0,50.0,51.0,650,03,01,  Sreepur,236,365,125,176,111,189,39.3,41.5,37.0,00000
88.0,50.0,51.0,650,04,01,  Badiarpara,210,419,112,194,98,225,33.4,36.6,30.3,00000
88.0,50.0,51.0,975,01,01,  Sutanara,57,143,30,73,27,70,28.5,29.1,27.8,00000
88.0,50.0,51.0,975,02,01,  Mallikpara,235,673,133,312,102,361,25.9,29.9,22.0,00000
88.0,50.0,60.0,896,01,01,  Rehai Suriber,1843,2811,1066,1322,777,1489,39.6,44.6,34.3,00000
88.0,50.0,60.0,896,02,01,  Khoragacha,292,463,148,217,144,246,38.7,40.5,36.9,00000
88.0,50.0,69.0,206,01,01,  Zazira,550,933,267,428,283,505,37.1,38.4,35.9,00000
88.0,50.0,69.0,206,02,01,  Decree Dorta,457,1012,261,470,196,542,31.1,35.7,26.6,00000
88.0,50.0,69.0,206,03,01,  Char Dorta,361,741,178,370,183,371,32.8,32.5,33.0,00000
88.0,50.0,69.0,256,01,01,  Char Panagari,666,986,370,457,296,529,40.3,44.7,35.9,00000
88.0,50.0,69.0,256,02,01,  Decree Dorta Paschimpara,303,554,172,248,131,306,35.4,41.0,30.0,00000
88.0,50.0,69.0,719,01,01,  Nishchintapur,683,1455,366,680,317,775,31.9,35.0,29.0,00000
88.0,50.0,69.0,719,02,01,  Ghuincha,99,351,57,167,42,184,22.0,25.4,18.6,00000
88.0,50.0,69.0,719,03,01,  Buatuatala,38,123,22,61,16,62,23.6,26.5,20.5,00000
88.0,50.0,69.0,719,04,01,  Banshjan,49,77,33,42,16,35,38.9,44.0,31.4,00000
88.0,50.0,69.0,719,05,01,  Laskmipur,55,297,34,156,21,141,15.6,17.9,13.0,00000
88.0,50.0,77.0,394,01,01,  Harinathpur,2427,3634,1204,1693,1223,1941,40.0,41.6,38.7,00000
88.0,50.0,77.0,394,02,01,  Char Kandahd,386,1033,195,444,191,589,27.2,30.5,24.5,00000
88.0,50.0,77.0,591,01,01,  Chak Parulkandi,689,1488,353,702,336,786,31.6,33.5,29.9,00000
88.0,50.0,77.0,591,02,01,  Gurajia,161,334,91,144,70,190,32.5,38.7,26.9,00000
88.0,50.0,77.0,591,03,01,  Sonamukhi Bazar,534,545,298,260,236,285,49.5,53.4,45.3,00000
88.0,50.0,77.0,738,01,01,  Uttar Paik Para,405,1034,199,501,206,533,28.1,28.4,27.9,00000
88.0,50.0,77.0,738,02,01,  Dakshin Paik Para,411,888,225,428,186,460,31.6,34.5,28.8,00000
88.0,50.0,77.0,906,01,01,  Rouhabari,987,1584,542,779,445,805,38.4,41.0,35.6,00000
88.0,50.0,77.0,906,02,01,  Gopalpur,147,546,72,249,75,297,21.2,22.4,20.2,00000
88.0,50.0,77.0,906,03,01,  Gachabari,416,482,215,221,201,261,46.3,49.3,43.5,00000
88.0,50.0,77.0,906,04,01,  Tatuahata,217,419,130,197,87,222,34.1,39.8,28.2,00000
88.0,50.0,86.0,285,01,01,  Chormara,142,218,79,93,63,125,39.4,45.9,33.5,00000
88.0,50.0,86.0,285,02,01,  Bangarpara,303,310,158,126,145,184,49.4,55.6,44.1,00000
88.0,50.0,86.0,305,01,01,  Daial,364,225,189,99,175,126,61.8,65.6,58.1,00000
88.0,50.0,86.0,305,02,01,  Tarakandi,223,299,104,134,119,165,42.7,43.7,41.9,00000
88.0,50.0,86.0,433,01,01,  Jhunkail,506,555,265,271,241,284,47.7,49.4,45.9,00000
88.0,50.0,86.0,433,02,01,  Khaspara,212,373,116,172,96,201,36.2,40.3,32.3,00000
88.0,50.0,86.0,433,03,01,  Jhunkail (Kazi Para),166,111,89,41,77,70,59.9,68.5,52.4,00000
88.0,50.0,86.0,433,04,01,  Afania,155,163,63,71,92,92,48.7,47.0,50.0,00000
88.0,50.0,86.0,433,05,01,  Chadnagar,228,377,108,167,120,210,37.7,39.3,36.4,00000
88.0,50.0,86.0,965,01,01,  Subhagachha,413,349,218,161,195,188,54.2,57.5,50.9,00000
88.0,50.0,86.0,965,02,01,  Bir Subhagachha,684,1057,363,479,321,578,39.3,43.1,35.7,00000
88.0,50.0,86.0,965,03,01,  Ghati Subhagachha,421,419,222,184,199,235,50.1,54.7,45.9,00000
88.0,50.0,94.0,315,01,01,  Tekani,548,794,300,371,248,423,40.8,44.7,37.0,00000
88.0,50.0,94.0,315,02,01,  Uttar Burungi,312,188,179,76,133,112,62.4,70.2,54.3,00000
88.0,50.0,94.0,315,03,01,  Kantanagar,159,260,91,111,68,149,37.9,45.0,31.3,00000
88.0,50.0,94.0,315,04,01,  Char Burungi,530,213,274,75,256,138,71.3,78.5,65.0,00000
88.0,50.0,94.0,315,05,01,  Char Kantanagar,425,385,253,161,172,224,52.5,61.1,43.4,00000
88.0,50.0,94.0,315,06,01,  Daskin Burungi,468,397,256,174,212,223,54.1,59.5,48.7,00000
88.0,61.0,13.0,051,01,01,  Khetabgati,146,530,60,263,86,267,21.6,18.6,24.4,00000
88.0,61.0,13.0,051,02,01,  Bamanbhag,270,589,135,296,135,293,31.4,31.3,31.5,00000
88.0,61.0,13.0,077,01,01,  Bil Chandi,130,451,58,232,72,219,22.4,20.0,24.7,00000
88.0,61.0,13.0,077,02,01,  Kalia Bil,260,428,115,199,145,229,37.8,36.6,38.8,00000
88.0,61.0,13.0,077,03,01,  Baraibhag,634,1587,304,781,330,806,28.5,28.0,29.0,00000
88.0,61.0,13.0,077,04,01,  Gopalpur,38,101,23,45,15,56,27.3,33.8,21.1,00000
88.0,61.0,13.0,170,01,01,  Char Brahmagachha,757,1598,390,793,367,805,32.1,33.0,31.3,00000
88.0,61.0,13.0,170,02,01,  Brahmagachha,431,442,227,202,204,240,49.4,52.9,45.9,00000
88.0,61.0,13.0,618,01,01,  Kutharganti,430,1010,223,562,207,448,29.9,28.4,31.6,00000
88.0,61.0,13.0,618,02,01,  Masem Hasel,70,170,40,81,30,89,29.2,33.1,25.2,00000
88.0,61.0,13.0,814,01,01,  Chak Gopal,89,140,41,68,48,72,38.9,37.6,40.0,00000
88.0,61.0,13.0,814,02,01,  Randila Bahadur,389,676,180,333,209,343,36.5,35.1,37.9,00000
88.0,61.0,13.0,969,01,01,  Hubanganti,208,305,118,155,90,150,40.5,43.2,37.5,00000
88.0,61.0,13.0,969,02,01,  Tebaria,546,1298,267,646,279,652,29.6,29.2,30.0,00000
88.0,61.0,13.0,969,03,01,  Chak Bhataria,30,50,14,25,16,25,37.5,35.9,39.0,00000
88.0,61.0,28.0,061,01,01,  Bnakai,467,972,250,416,217,556,32.5,37.5,28.1,00000
88.0,61.0,28.0,061,02,01,  Sikarpur,130,272,67,114,63,158,32.3,37.0,28.5,00000
88.0,61.0,28.0,551,01,01,  Khodadpur,105,228,64,102,41,126,31.5,38.6,24.6,00000
88.0,61.0,28.0,551,02,01,  Haldibari,26,56,16,22,10,34,31.7,42.1,22.7,00000
88.0,61.0,28.0,598,01,01,  Khirtala,334,243,182,90,152,153,57.9,66.9,49.8,00000
88.0,61.0,28.0,598,02,01,  Baitkamari,105,225,55,111,50,114,31.8,33.1,30.5,00000
88.0,61.0,28.0,598,03,01,  Mirzapur,82,128,47,56,35,72,39.0,45.6,32.7,00000
88.0,61.0,28.0,598,04,01,  Daulatpur,88,153,52,55,36,98,36.5,48.6,26.9,00000
88.0,61.0,28.0,598,05,01,  Chaka Bil,9,10,6,6,3,4,47.4,50.0,42.9,00000
88.0,61.0,28.0,598,06,01,  Chandiduar,3,35,1,17,2,18,7.9,5.6,10.0,00000
88.0,61.0,28.0,598,07,01,  Bhadli Para,98,281,57,131,41,150,25.9,30.3,21.5,00000
88.0,61.0,28.0,598,08,01,  Protap Guchchhagram,93,327,55,146,38,181,22.1,27.4,17.4,00000
88.0,61.0,28.0,881,01,01,  Saroil,115,421,67,180,48,241,21.5,27.1,16.6,00000
88.0,61.0,28.0,881,02,01,  Kholabaria,179,217,100,89,79,128,45.2,52.9,38.2,00000
88.0,61.0,28.0,902,01,01,  Shibpur,209,438,101,202,108,236,32.3,33.3,31.4,00000
88.0,61.0,28.0,902,02,01,  Kusta,199,206,103,89,96,117,49.1,53.6,45.1,00000
88.0,61.0,28.0,902,03,01,  Mahashacha Chapar,105,158,67,68,38,90,39.9,49.6,29.7,00000
88.0,61.0,28.0,902,04,01,  Debipur,84,114,52,44,32,70,42.4,54.2,31.4,00000
88.0,61.0,38.0,484,01,01,  Kazipur,229,447,133,217,96,230,33.9,38.0,29.4,00000
88.0,61.0,38.0,484,02,01,  Chak Abhiram,89,170,41,80,48,90,34.4,33.9,34.8,00000
88.0,61.0,38.0,484,03,01,  Kalicharan Jhapra,117,257,69,128,48,129,31.3,35.0,27.1,00000
88.0,61.0,38.0,484,04,01,  Mallikchand,176,340,85,173,91,167,34.1,32.9,35.3,00000
88.0,61.0,38.0,484,05,01,  Nauda,49,200,22,90,27,110,19.7,19.6,19.7,00000
88.0,61.0,38.0,484,07,01,  Ramnath (Part),265,261,141,127,124,134,50.4,52.6,48.1,00000
88.0,61.0,38.0,484,08,01,  Jhapra Abhiram,598,584,331,276,267,308,50.6,54.5,46.4,00000
88.0,61.0,38.0,484,09,01,  Bulakipur,180,379,104,199,76,180,32.2,34.3,29.7,00000
88.0,61.0,38.0,484,10,01,  Chandragathi,16,42,5,24,11,18,27.6,17.2,37.9,00000
88.0,61.0,38.0,716,01,01,  Nalchhia,366,917,198,454,168,463,28.5,30.4,26.6,00000
88.0,61.0,38.0,716,02,01,  Sonai,167,337,83,148,84,189,33.1,35.9,30.8,00000
88.0,61.0,38.0,840,01,03,  Royganj (Part),330,181,179,87,151,94,64.6,67.3,61.6,00000
88.0,61.0,38.0,840,02,03,  Lahor,312,289,166,125,146,164,51.9,57.0,47.1,00000
88.0,61.0,38.0,840,03,03,  Chak Chandaikona,105,134,61,55,44,79,43.9,52.6,35.8,00000
88.0,61.0,38.0,974,01,01,  Telijana,390,739,205,333,185,406,34.5,38.1,31.3,00000
88.0,61.0,38.0,974,02,01,  Chor Tezijona,579,752,306,331,273,421,43.5,48.0,39.3,00000
88.0,61.0,38.0,974,03,01,  Nishchintapur,185,373,98,185,87,188,33.2,34.6,31.6,00000
88.0,61.0,57.0,087,01,01,  Uttarpara,354,547,181,254,173,293,39.3,41.6,37.1,00000
88.0,61.0,57.0,087,02,01,  Dakshinpara,491,746,275,354,216,392,39.7,43.7,35.5,00000
88.0,61.0,57.0,087,03,01,  Buthar Char,133,213,70,102,63,111,38.4,40.7,36.2,00000
88.0,61.0,57.0,087,04,01,  Kutuber Char,104,222,71,114,33,108,31.9,38.4,23.4,00000
88.0,61.0,57.0,139,01,01,  Sthan Singhpur,221,305,125,138,96,167,42.0,47.5,36.5,00000
88.0,61.0,57.0,139,02,01,  Kalikapur,49,285,26,145,23,140,14.7,15.2,14.1,00000
88.0,61.0,57.0,139,03,01,  Bhuyaganty,42,117,20,58,22,59,26.4,25.6,27.2,00000
88.0,61.0,57.0,458,01,01,  Jagannathpur,578,1213,322,585,256,628,32.3,35.5,29.0,00000
88.0,61.0,57.0,458,02,01,  Jhanjali Para,362,492,195,240,167,252,42.4,44.8,39.9,00000
88.0,61.0,57.0,845,01,01,  Royhati,522,1420,298,667,224,753,26.9,30.9,22.9,00000
88.0,61.0,57.0,845,02,01,  Royhati Digharpar,351,505,194,248,157,257,41.0,43.9,37.9,00000
88.0,61.0,57.0,958,01,01,  Durgapur,135,230,64,114,71,116,37.0,36.0,38.0,00000
88.0,61.0,57.0,958,02,01,  Muraripur,154,283,80,147,74,136,35.2,35.2,35.2,00000
88.0,61.0,57.0,958,03,01,  Shyamnai,171,536,95,275,76,261,24.2,25.7,22.6,00000
88.0,61.0,66.0,020,01,01,  Alam Chandpur,161,180,82,85,79,95,47.2,49.1,45.4,00000
88.0,61.0,66.0,020,02,01,  Sorabari,87,172,50,75,37,97,33.6,40.0,27.6,00000
88.0,61.0,66.0,257,01,01,  Mahat Para,496,433,283,182,213,251,53.4,60.9,45.9,00000
88.0,61.0,66.0,257,02,01,  Kayesta Para,150,251,89,110,61,141,37.4,44.7,30.2,00000
88.0,61.0,66.0,257,03,01,  Daspara,126,269,80,118,46,151,31.9,40.4,23.4,00000
88.0,61.0,66.0,257,04,01,  Podder Para,212,304,103,148,109,156,41.1,41.0,41.1,00000
88.0,61.0,66.0,283,01,01,  Dattakusa,405,969,230,464,175,505,29.5,33.1,25.7,00000
88.0,61.0,66.0,283,02,01,  Kalipur,353,611,186,277,167,334,36.6,40.2,33.3,00000
88.0,61.0,66.0,355,01,01,  Hatkanda,297,449,144,214,153,235,39.8,40.2,39.4,00000
88.0,61.0,66.0,355,02,01,  Erandaha,1355,2521,751,1237,604,1284,35.0,37.8,32.0,00000
88.0,61.0,66.0,355,03,01,  Majhi Para,193,416,110,211,83,205,31.7,34.3,28.8,00000
88.0,61.0,66.0,479,01,01,  Jhakri,293,340,142,171,151,169,46.3,45.4,47.2,00000
88.0,61.0,66.0,479,02,01,  Horganti,640,766,337,372,303,394,45.5,47.5,43.5,00000
88.0,61.0,66.0,479,03,01,  Alakdia,182,374,100,189,82,185,32.7,34.6,30.7,00000
88.0,61.0,66.0,525,01,01,  Kanthalbaria,410,671,217,309,193,362,37.9,41.3,34.8,00000
88.0,61.0,66.0,525,02,01,  Boaliar Char,490,842,233,387,257,455,36.8,37.6,36.1,00000
88.0,61.0,66.0,603,01,01,  Kumajpur,447,820,247,390,200,430,35.3,38.8,31.7,00000
88.0,61.0,66.0,603,02,01,  Sahabganj,199,98,102,45,97,53,67.0,69.4,64.7,00000
88.0,61.0,66.0,603,03,01,  West Muradpur,55,67,34,26,21,41,45.1,56.7,33.9,00000
88.0,61.0,66.0,721,01,01,  Nalchhia,265,494,150,221,115,273,34.9,40.4,29.6,00000
88.0,61.0,66.0,721,02,01,  Shah Para,60,58,38,21,22,37,50.8,64.4,37.3,00000
88.0,61.0,66.0,726,01,01,  Nalka Sengati,777,1010,402,487,375,523,43.5,45.2,41.8,00000
88.0,61.0,66.0,726,02,01,  Kaimgram,270,403,149,179,121,224,40.1,45.4,35.1,00000
88.0,61.0,66.0,943,01,01,  Sujapur,556,608,305,286,251,322,47.8,51.6,43.8,00000
88.0,61.0,66.0,943,02,01,  Paschim Maturapur,90,224,51,106,39,118,28.7,32.5,24.8,00000
88.0,61.0,66.0,979,01,01,  Tin Nandina (Panch Para),124,139,62,68,62,71,47.1,47.7,46.6,00000
88.0,61.0,66.0,979,02,01,  Khamar Para,303,242,159,93,144,149,55.6,63.1,49.1,00000
88.0,61.0,66.0,979,03,01,  Khola Para,215,172,104,96,111,76,55.6,52.0,59.4,00000
88.0,61.0,66.0,979,04,01,  Adrosho Para (Kholapara),165,140,85,68,80,72,54.1,55.6,52.6,00000
88.0,61.0,76.0,103,01,01,  Majh Para,146,626,70,310,76,316,18.9,18.4,19.4,00000
88.0,61.0,76.0,103,02,01,  Uttarpara,383,683,192,343,191,340,35.9,35.9,36.0,00000
88.0,61.0,76.0,103,03,01,  Purbapara,208,447,119,213,89,234,31.8,35.8,27.6,00000
88.0,61.0,76.0,103,04,01,  Paschimpara,180,919,107,438,73,481,16.4,19.6,13.2,00000
88.0,61.0,76.0,103,05,01,  Baikunthapur,467,1160,232,585,235,575,28.7,28.4,29.0,00000
88.0,61.0,76.0,103,06,01,  Gangarampur,114,242,52,103,62,139,32.0,33.5,30.8,00000
88.0,61.0,76.0,103,07,01,  Manoharpur,310,825,177,380,133,445,27.3,31.8,23.0,00000
88.0,61.0,76.0,175,01,01,  Brahmanbaria,505,1066,267,511,238,555,32.1,34.3,30.0,00000
88.0,61.0,76.0,175,02,01,  Nizamganti,271,406,125,189,146,217,40.0,39.8,40.2,00000
88.0,61.0,76.0,175,03,01,  Dhangar Para,114,314,55,159,59,155,26.6,25.7,27.6,00000
88.0,61.0,76.0,402,01,01,  Gram Pangashi,1002,1478,538,694,464,784,40.4,43.7,37.2,00000
88.0,61.0,76.0,402,02,01,  Hatkanda,100,393,60,204,40,189,20.3,22.7,17.5,00000
88.0,61.0,76.0,433,01,01,  Hat Pangashi,867,1257,481,593,386,664,40.8,44.8,36.8,00000
88.0,61.0,76.0,433,02,01,  Chauraganti,166,505,89,236,77,269,24.7,27.4,22.3,00000
88.0,61.0,76.0,515,01,01,  Kalinja,195,592,105,302,90,290,24.8,25.8,23.7,00000
88.0,61.0,76.0,515,02,01,  Adarshapara,42,229,21,109,21,120,15.5,16.2,14.9,00000
88.0,61.0,76.0,732,01,01,  Purbapara,169,609,82,297,87,312,21.7,21.6,21.8,00000
88.0,61.0,76.0,732,02,01,  Paschimpara,373,726,194,353,179,373,33.9,35.5,32.4,00000
88.0,61.0,76.0,732,03,01,  Chak Anar Dumur,87,184,38,93,49,91,32.1,29.0,35.0,00000
88.0,61.0,76.0,732,04,01,  Narayan Salua,158,131,80,60,78,71,54.7,57.1,52.3,00000
88.0,61.0,76.0,732,05,01,  Kaya Bil,79,595,50,291,29,304,11.7,14.7,8.7,00000
88.0,61.0,76.0,732,06,01,  Nauda Dumur,82,261,41,142,41,119,23.9,22.4,25.6,00000
88.0,61.0,76.0,933,01,01,  Sreedasganti,308,747,183,372,125,375,29.2,33.0,25.0,00000
88.0,61.0,76.0,933,02,01,  Mamokarganti,101,246,51,115,50,131,29.1,30.7,27.6,00000
88.0,67.0,12.0,005,01,01,  Agbera,124,417,66,199,58,218,22.9,24.9,21.0,00000
88.0,67.0,12.0,005,02,01,  Bhennagachhi,352,459,181,204,171,255,43.4,47.0,40.1,00000
88.0,67.0,12.0,022,01,01,  Agnukali,625,1668,349,809,276,859,27.3,30.1,24.3,00000
88.0,67.0,12.0,022,02,01,  Lichimpur,246,433,133,186,113,247,36.2,41.7,31.4,00000
88.0,67.0,12.0,133,01,01,  Beltail Digar,184,652,106,317,78,335,22.0,25.1,18.9,00000
88.0,67.0,12.0,133,02,01,  Char Beltail,673,916,347,427,326,489,42.4,44.8,40.0,00000
88.0,67.0,12.0,133,03,01,  Chak Banshbaria,163,293,85,142,78,151,35.7,37.4,34.1,00000
88.0,67.0,12.0,283,01,01,  Char Betkandi,430,719,226,349,204,370,37.4,39.3,35.5,00000
88.0,67.0,12.0,283,02,01,  Shibrampur,505,307,265,137,240,170,62.2,65.9,58.5,00000
88.0,67.0,12.0,283,03,01,  Khagdiar,207,321,119,151,88,170,39.2,44.1,34.1,00000
88.0,67.0,12.0,283,04,01,  Sen Betkandi,240,553,117,288,123,265,30.3,28.9,31.7,00000
88.0,67.0,12.0,283,05,01,  Mohammadpur,297,562,156,276,141,286,34.6,36.1,33.0,00000
88.0,67.0,12.0,361,01,01,  Dhar Jamtail,574,714,297,355,277,359,44.6,45.6,43.6,00000
88.0,67.0,12.0,361,02,01,  Banshbaria,760,1141,393,551,367,590,40.0,41.6,38.3,00000
88.0,67.0,12.0,439,01,01,  Ghorsal,1277,2761,688,1323,589,1438,31.6,34.2,29.1,00000
88.0,67.0,12.0,439,02,01,  Hat Betkandi,122,280,69,131,53,149,30.3,34.5,26.2,00000
88.0,67.0,12.0,528,01,01,  Kadai Badla,784,1214,436,559,348,655,39.2,43.8,34.7,00000
88.0,67.0,12.0,528,02,01,  Char Kadai,510,1037,270,480,240,557,33.0,36.0,30.1,00000
88.0,67.0,12.0,644,01,01,  Purba Malatidanga,430,713,245,336,185,377,37.6,42.2,32.9,00000
88.0,67.0,12.0,644,02,01,  Paschim Malatidanga,461,732,250,330,211,402,38.6,43.1,34.4,00000
88.0,67.0,12.0,922,01,01,  Dakshinpara,1121,1345,637,753,484,592,45.5,45.8,45.0,00000
88.0,67.0,12.0,922,02,01,  Uttarpara,454,716,239,336,215,380,38.8,41.6,36.1,00000
88.0,67.0,12.0,922,03,01,  Kuthi Satbaria,633,673,342,310,291,363,48.5,52.5,44.5,00000
88.0,67.0,12.0,922,04,01,  Batiza Para,334,542,197,239,137,303,38.1,45.2,31.1,00000
88.0,67.0,14.0,100,01,01,  Barnia,423,1835,273,903,150,932,18.7,23.2,13.9,00000
88.0,67.0,14.0,100,02,01,  Mirzapur,65,176,32,80,33,96,27.0,28.6,25.6,00000
88.0,67.0,14.0,100,03,01,  Char Barnia,121,895,85,426,36,469,11.9,16.6,7.1,00000
88.0,67.0,14.0,100,04,01,  Barnia Haldar Para,93,236,49,112,44,124,28.3,30.4,26.2,00000
88.0,67.0,14.0,116,01,01,  Boyra,229,479,132,191,97,288,32.3,40.9,25.2,00000
88.0,67.0,14.0,116,02,01,  Gachh Boyra,158,662,95,314,63,348,19.3,23.2,15.3,00000
88.0,67.0,14.0,116,03,01,  Bhul Boyra,94,297,53,144,41,153,24.0,26.9,21.1,00000
88.0,67.0,14.0,383,01,03,  Paschim Berakhola,423,1327,232,585,191,742,24.2,28.4,20.5,00000
88.0,67.0,14.0,383,02,03,  Purba Berakhola,474,1851,286,782,188,1069,20.4,26.8,15.0,00000
88.0,67.0,14.0,383,03,03,  Gobindapur,210,682,122,279,88,403,23.5,30.4,17.9,00000
88.0,67.0,14.0,383,04,03,  Chikhulia,107,396,71,190,36,206,21.3,27.2,14.9,00000
88.0,67.0,14.0,389,01,01,  Bara Dugali,262,811,160,363,102,448,24.4,30.6,18.5,00000
88.0,67.0,14.0,389,02,01,  Par Dugali,485,931,275,418,210,513,34.3,39.7,29.0,00000
88.0,67.0,14.0,389,03,01,  Char Dugali,182,521,100,238,82,283,25.9,29.6,22.5,00000
88.0,67.0,14.0,411,01,01,  Fakir Para,330,1193,185,522,145,671,21.7,26.2,17.8,00000
88.0,67.0,14.0,411,02,01,  Gopinathpur,449,1094,265,499,184,595,29.1,34.7,23.6,00000
88.0,67.0,14.0,411,03,01,  Hariakanda,33,208,22,103,11,105,13.7,17.6,9.5,00000
88.0,67.0,14.0,411,04,01,  Gala,186,947,115,467,71,480,16.4,19.8,12.9,00000
88.0,67.0,14.0,411,05,01,  Mazzan,79,235,46,98,33,137,25.2,31.9,19.4,00000
88.0,67.0,14.0,967,01,01,  Taratia,248,895,150,403,98,492,21.7,27.1,16.6,00000
88.0,67.0,14.0,967,02,01,  Dewan Taratia,129,214,61,79,68,135,37.6,43.6,33.5,00000
88.0,67.0,21.0,094,01,01,  Kasiakola,165,366,75,197,90,169,31.1,27.6,34.7,00000
88.0,67.0,21.0,094,02,01,  Barai Tepri,516,932,253,461,263,471,35.6,35.4,35.8,00000
88.0,67.0,21.0,094,03,01,  Baoshagari,132,319,75,147,57,172,29.3,33.8,24.9,00000
88.0,67.0,21.0,094,04,01,  Char Tepri,383,515,187,262,196,253,42.7,41.6,43.7,00000
88.0,67.0,21.0,177,01,01,  Bhatta Garadaha,340,548,189,284,151,264,38.3,40.0,36.4,00000
88.0,67.0,21.0,177,02,01,  Sardar Para,501,625,272,292,229,333,44.5,48.2,40.7,00000
88.0,67.0,21.0,422,01,01,  Garadaha Char Para,744,918,377,426,367,492,44.8,46.9,42.7,00000
88.0,67.0,21.0,422,02,01,  Talgachhi,1018,987,534,504,484,483,50.8,51.4,50.1,00000
88.0,67.0,21.0,422,03,01,  Bhaya Biswas,338,785,179,356,159,429,30.1,33.5,27.0,00000
88.0,67.0,21.0,655,01,01,  Mashipur,1800,2056,954,993,846,1063,46.7,49.0,44.3,00000
88.0,67.0,21.0,655,02,01,  Sharishakola,601,572,323,253,278,319,51.2,56.1,46.6,00000
88.0,67.0,21.0,655,03,01,  Durgadah,357,241,190,110,167,131,59.7,63.3,56.0,00000
88.0,67.0,21.0,655,04,01,  Bazar Ghati,166,244,86,129,80,115,40.5,40.0,41.0,00000
88.0,67.0,21.0,655,05,01,  Paschim Mashipur,289,329,151,159,138,170,46.8,48.7,44.8,00000
88.0,67.0,21.0,655,06,01,  Lalpur,101,236,56,108,45,128,30.0,34.1,26.0,00000
88.0,67.0,21.0,683,01,01,  Nabipur,157,389,87,183,70,206,28.8,32.2,25.4,00000
88.0,67.0,21.0,683,02,01,  Tikua Para,347,449,176,225,171,224,43.6,43.9,43.3,00000
88.0,67.0,21.0,683,03,01,  Char Nabipur,690,960,363,457,327,503,41.8,44.3,39.4,00000
88.0,67.0,29.0,622,01,01,  Lochan Para,117,219,76,93,41,126,34.8,45.0,24.6,00000
88.0,67.0,29.0,622,02,01,  Chak Rupsi,76,127,49,63,27,64,37.4,43.8,29.7,00000
88.0,67.0,29.0,678,01,01,  Mulkandi,889,2470,495,1221,394,1249,26.5,28.8,24.0,00000
88.0,67.0,29.0,678,02,01,  Choubari,361,482,202,233,159,249,42.8,46.4,39.0,00000
88.0,67.0,36.0,444,01,01,  Gudhibari,1225,2294,700,1103,525,1191,34.8,38.8,30.6,00000
88.0,67.0,36.0,444,02,01,  Lahindakandi,419,1058,221,517,198,541,28.4,29.9,26.8,00000
88.0,67.0,36.0,444,03,01,  Gupiakhali,368,759,219,337,149,422,32.7,39.4,26.1,00000
88.0,67.0,36.0,444,04,01,  Char Gudhibari,241,648,139,316,102,332,27.1,30.5,23.5,00000
88.0,67.0,36.0,478,01,01,  Hat Panchil,543,1839,332,900,211,939,22.8,26.9,18.3,00000
88.0,67.0,36.0,478,02,01,  Monakosna,456,177,245,79,211,98,72.0,75.6,68.3,00000
88.0,67.0,36.0,500,01,01,  Purba Jagatala,1679,4012,1056,2030,623,1982,29.5,34.2,23.9,00000
88.0,67.0,36.0,500,02,01,  Paschim Jagatala,611,1353,367,674,244,679,31.1,35.3,26.4,00000
88.0,67.0,36.0,533,01,01,  Kaijuri,530,1156,292,551,238,605,31.4,34.6,28.2,00000
88.0,67.0,36.0,533,02,01,  Purba Char Kaijuri,808,1636,426,764,382,872,33.1,35.8,30.5,00000
88.0,67.0,36.0,533,03,01,  Paschim Char Kaijuri,1535,2124,811,1015,724,1109,42.0,44.4,39.5,00000
88.0,67.0,36.0,533,04,01,  Pathalia Para,991,1394,548,653,443,741,41.6,45.6,37.4,00000
88.0,67.0,43.0,072,01,01,  Baldi Para,303,564,154,258,149,306,34.9,37.4,32.7,00000
88.0,67.0,43.0,072,02,01,  Haldighar,473,548,236,242,237,306,46.3,49.4,43.6,00000
88.0,67.0,43.0,222,01,01,  Puran Para,430,477,226,225,204,252,47.4,50.1,44.7,00000
88.0,67.0,43.0,222,02,01,  Kati Para,521,327,281,149,240,178,61.4,65.3,57.4,00000
88.0,67.0,43.0,222,03,01,  Nedhur Para,366,471,212,216,154,255,43.7,49.5,37.7,00000
88.0,67.0,43.0,222,04,01,  Khalifa Para,136,565,79,261,57,304,19.4,23.2,15.8,00000
88.0,67.0,43.0,233,01,01,  Bri-Angaru,601,1483,298,710,303,773,28.8,29.6,28.2,00000
88.0,67.0,43.0,233,02,01,  Char Angaru,1043,1484,555,706,488,778,41.3,44.0,38.5,00000
88.0,67.0,43.0,233,03,01,  Panch Para,198,456,89,216,109,240,30.3,29.2,31.2,00000
88.0,67.0,43.0,233,04,01,  Bangal Para,246,522,127,250,119,272,32.0,33.7,30.4,00000
88.0,67.0,43.0,239,01,01,  Bangaon,1167,1566,634,757,533,809,42.7,45.6,39.7,00000
88.0,67.0,43.0,239,02,01,  Chithulia,764,1096,381,537,383,559,41.1,41.5,40.7,00000
88.0,67.0,43.0,239,03,01,  Chuldhari,283,383,128,186,155,197,42.5,40.8,44.0,00000
88.0,67.0,43.0,255,01,01,  Chak Haripur,549,886,297,443,252,443,38.3,40.1,36.3,00000
88.0,67.0,43.0,255,02,01,  China Dukuria,902,1009,454,470,448,539,47.2,49.1,45.4,00000
88.0,67.0,43.0,255,03,01,  Shimultali,154,239,72,109,82,130,39.2,39.8,38.7,00000
88.0,67.0,43.0,472,01,01,  Harirampur,292,502,166,252,126,250,36.8,39.7,33.5,00000
88.0,67.0,43.0,472,02,01,  Gopinathpur,163,139,94,66,69,73,54.0,58.8,48.6,00000
88.0,67.0,43.0,561,01,01,  Kayemkola,174,472,98,222,76,250,26.9,30.6,23.3,00000
88.0,67.0,43.0,561,02,01,  Sayestabad,292,486,135,226,157,260,37.5,37.4,37.6,00000
88.0,67.0,43.0,561,03,01,  Chak Krishnapur,174,200,103,74,71,126,46.5,58.2,36.0,00000
88.0,67.0,43.0,566,01,01,  Kayempur,923,1418,492,676,431,742,39.4,42.1,36.7,00000
88.0,67.0,43.0,566,02,01,  Batia Para,387,891,208,436,179,455,30.3,32.3,28.2,00000
88.0,67.0,43.0,566,03,01,  Shwaruppur,336,704,183,343,153,361,32.3,34.8,29.8,00000
88.0,67.0,43.0,566,04,01,  Azimpur,159,240,99,119,60,121,39.8,45.4,33.1,00000
88.0,67.0,43.0,566,05,01,  Kashinathpur,179,286,82,143,97,143,38.5,36.4,40.4,00000
88.0,67.0,43.0,566,06,01,  Gobindapur,60,133,33,66,27,67,31.1,33.3,28.7,00000
88.0,67.0,43.0,566,07,01,  Jogonathpur,134,352,70,182,64,170,27.6,27.8,27.4,00000
88.0,67.0,43.0,917,01,01,  Saratail,876,1610,456,759,420,851,35.2,37.5,33.0,00000
88.0,67.0,43.0,917,02,01,  Muratia,205,303,101,150,104,153,40.4,40.2,40.5,00000
88.0,67.0,43.0,956,01,01,  Shyambaria,412,482,208,220,204,262,46.1,48.6,43.8,00000
88.0,67.0,43.0,956,02,01,  Durgapur,175,230,93,100,82,130,43.2,48.2,38.7,00000
88.0,67.0,51.0,038,01,01,  Arkandi,161,291,89,140,72,151,35.6,38.9,32.3,00000
88.0,67.0,51.0,038,02,01,  Natun Para,207,180,110,83,97,97,53.5,57.0,50.0,00000
88.0,67.0,51.0,038,03,01,  Jele Para,34,277,19,136,15,141,10.9,12.3,9.6,00000
88.0,67.0,51.0,216,01,01,  Brahmangaon,1217,1579,694,750,523,829,43.5,48.1,38.7,00000
88.0,67.0,51.0,216,02,01,  Dakshinpara,252,268,146,137,106,131,48.5,51.6,44.7,00000
88.0,67.0,51.0,516,01,01,  Jogibari,351,919,174,481,177,438,27.6,26.6,28.8,00000
88.0,67.0,51.0,516,02,01,  Kamalpur,404,453,235,212,169,241,47.1,52.6,41.2,00000
88.0,67.0,51.0,600,01,01,  Nutan Para,1286,428,796,208,490,220,75.0,79.3,69.0,00000
88.0,67.0,51.0,600,02,01,  Uttarpara,874,1143,519,645,355,498,43.3,44.6,41.6,00000
88.0,67.0,51.0,600,03,01,  Paschimpara,792,705,401,365,391,340,52.9,52.3,53.5,00000
88.0,67.0,51.0,600,04,01,  Mollah Para,900,686,468,344,432,342,56.7,57.6,55.8,00000
88.0,67.0,51.0,600,05,01,  Madhyapara,804,488,429,258,375,230,62.2,62.4,62.0,00000
88.0,67.0,51.0,600,06,01,  Rathkhola,81,358,38,201,43,157,18.5,15.9,21.5,00000
88.0,67.0,51.0,600,07,01,  Kandi Para,1111,816,598,424,513,392,57.7,58.5,56.7,00000
88.0,67.0,51.0,600,08,01,  Kalipur,518,1109,281,552,237,557,31.8,33.7,29.8,00000
88.0,67.0,51.0,600,09,01,  Jhaugara,1171,2218,652,1142,519,1076,34.6,36.3,32.5,00000
88.0,67.0,51.0,878,01,01,  Rupnai Purbapara,752,1580,400,810,352,770,32.2,33.1,31.4,00000
88.0,67.0,51.0,878,02,01,  Rupnai Uttarpara,985,254,511,114,474,140,79.5,81.8,77.2,00000
88.0,67.0,51.0,878,03,01,  Gachh Para,1960,2851,1087,1412,873,1439,40.7,43.5,37.8,00000
88.0,67.0,51.0,883,01,01,  Rupsi,1808,2536,973,1239,835,1297,41.6,44.0,39.2,00000
88.0,67.0,51.0,883,02,01,  Sonatala,585,1002,336,483,249,519,36.9,41.0,32.4,00000
88.0,67.0,51.0,883,03,01,  Shibpur,1251,2263,693,1108,558,1155,35.6,38.5,32.6,00000
88.0,67.0,51.0,883,04,01,  Gopinathpur,1788,1909,1004,902,784,1007,48.4,52.7,43.8,00000
88.0,67.0,51.0,883,05,01,  Bishwanathpur,387,731,203,354,184,377,34.6,36.4,32.8,00000
88.0,67.0,58.0,111,01,01,  Batia Paschim,714,1007,369,478,345,529,41.5,43.6,39.5,00000
88.0,67.0,58.0,111,02,01,  Batia Purba,191,217,106,100,85,117,46.8,51.5,42.1,00000
88.0,67.0,58.0,111,03,01,  Char Batia,340,572,165,264,175,308,37.3,38.5,36.2,00000
88.0,67.0,58.0,111,04,01,  Joyrampur,597,643,289,280,308,363,48.1,50.8,45.9,00000
88.0,67.0,58.0,705,01,01,  Narina Uttarpara,394,849,228,413,166,436,31.7,35.6,27.6,00000
88.0,67.0,58.0,705,02,01,  Narina Madhyapara,541,796,293,388,248,408,40.5,43.0,37.8,00000
88.0,67.0,58.0,705,03,01,  Narina Dakshinpara,1120,1515,584,715,536,800,42.5,45.0,40.1,00000
88.0,67.0,58.0,705,04,01,  Nababila,435,815,246,395,189,420,34.8,38.4,31.0,00000
88.0,67.0,58.0,705,05,01,  Danga Para,112,127,61,60,51,67,46.9,50.4,43.2,00000
88.0,67.0,58.0,761,01,01,  Parkola,151,217,79,116,72,101,41.0,40.5,41.6,00000
88.0,67.0,58.0,761,02,01,  Jugnidaha,1135,1634,624,750,511,884,41.0,45.4,36.6,00000
88.0,67.0,58.0,761,03,01,  Tetiarkanda,771,767,379,360,392,407,50.1,51.3,49.1,00000
88.0,67.0,58.0,761,04,01,  Kanglakanda,296,466,167,223,129,243,38.8,42.8,34.7,00000
88.0,67.0,58.0,761,05,01,  Bachamara,601,605,356,252,245,353,49.8,58.6,41.0,00000
88.0,67.0,65.0,044,01,01,  Bachra,1424,2879,825,1357,599,1522,33.1,37.8,28.2,00000
88.0,67.0,65.0,044,02,01,  Char Bachra,202,718,130,324,72,394,22.0,28.6,15.5,00000
88.0,67.0,65.0,105,01,01,  Basuria,883,1473,500,693,383,780,37.5,41.9,32.9,00000
88.0,67.0,65.0,105,02,01,  Kanda Basuria,117,228,66,100,51,128,33.9,39.8,28.5,00000
88.0,67.0,65.0,105,03,01,  Char Basuria,264,200,136,83,128,117,56.9,62.1,52.2,00000
88.0,67.0,65.0,261,01,01,  Uttar Jamirta,1163,2290,669,1092,494,1198,33.7,38.0,29.2,00000
88.0,67.0,65.0,261,02,01,  Dakshin Jamirta,775,2314,455,1083,320,1231,25.1,29.6,20.6,00000
88.0,67.0,65.0,261,03,01,  Fechuamara,434,1321,254,646,180,675,24.7,28.2,21.1,00000
88.0,67.0,65.0,261,04,01,  Jote Para,554,1236,341,579,213,657,30.9,37.1,24.5,00000
88.0,67.0,65.0,261,05,01,  Chak Jamirta Cmarpara,376,1618,241,794,135,824,18.9,23.3,14.1,00000
88.0,67.0,65.0,539,01,01,  Kakuria,497,952,273,440,224,512,34.3,38.3,30.4,00000
88.0,67.0,65.0,539,02,01,  Khudra Putia,207,251,127,112,80,139,45.2,53.1,36.5,00000
88.0,67.0,65.0,700,01,01,  Uttar Nandalalpur,787,2019,436,993,351,1026,28.0,30.5,25.5,00000
88.0,67.0,65.0,700,02,01,  Dakshin Nandalalpur,712,1461,402,684,310,777,32.8,37.0,28.5,00000
88.0,67.0,65.0,700,03,01,  Jigarbaria,910,1562,505,733,405,829,36.8,40.8,32.8,00000
88.0,67.0,65.0,778,01,01,  Porjana,904,1271,516,591,388,680,41.6,46.6,36.3,00000
88.0,67.0,65.0,778,02,01,  Chhota Momrajpur,758,2126,438,999,320,1127,26.3,30.5,22.1,00000
88.0,67.0,65.0,778,03,01,  Harinathpur,264,763,141,319,123,444,25.7,30.7,21.7,00000
88.0,67.0,65.0,778,04,01,  Char Porjana,777,1834,471,858,306,976,29.8,35.4,23.9,00000
88.0,67.0,65.0,778,05,01,  Bara Maharajpur,698,1565,368,761,330,804,30.8,32.6,29.1,00000
88.0,67.0,73.0,689,01,01,  Boyra,314,301,173,137,141,164,51.1,55.8,46.2,00000
88.0,67.0,73.0,689,02,01,  Chhota Boyra,198,297,115,153,83,144,40.0,42.9,36.6,00000
88.0,67.0,73.0,783,01,01,  Potajia,2663,4797,1400,2341,1263,2456,35.7,37.4,34.0,00000
88.0,67.0,73.0,783,02,01,  Kakilanari,734,815,413,394,321,421,47.4,51.2,43.3,00000
88.0,67.0,73.0,783,03,01,  Madla,1502,2527,825,1181,677,1346,37.3,41.1,33.5,00000
88.0,67.0,73.0,783,04,01,  Reshambari,704,1027,341,511,363,516,40.7,40.0,41.3,00000
88.0,67.0,73.0,783,05,01,  Gangaprasad,442,792,229,405,213,387,35.8,36.1,35.5,00000
88.0,67.0,73.0,783,06,01,  Bhaimara,240,332,135,150,105,182,42.0,47.4,36.6,00000
88.0,67.0,73.0,856,01,01,  Rautara,714,1569,388,746,326,823,31.3,34.2,28.4,00000
88.0,67.0,73.0,856,02,01,  Chara Chithulia,1285,1449,678,722,607,727,47.0,48.4,45.5,00000
88.0,67.0,73.0,983,01,01,  Monamara,99,133,48,59,51,74,42.7,44.9,40.8,00000
88.0,67.0,73.0,983,02,01,  Tiorbanda,96,268,53,141,43,127,26.4,27.3,25.3,00000
88.0,67.0,80.0,055,01,01,  Baghdhunail,320,878,179,422,141,456,26.7,29.8,23.6,00000
88.0,67.0,80.0,055,02,01,  Kaiar Char,297,388,167,171,130,217,43.4,49.4,37.5,00000
88.0,67.0,80.0,205,01,01,  Bil Kalmi,214,207,99,96,115,111,50.8,50.8,50.9,00000
88.0,67.0,80.0,205,02,01,  Kharshamal,563,461,287,238,276,223,55.0,54.7,55.3,00000
88.0,67.0,80.0,372,01,01,  Dhunail,635,1708,367,797,268,911,27.1,31.5,22.7,00000
88.0,67.0,80.0,372,02,01,  Char Dhunail,90,187,46,80,44,107,32.5,36.5,29.1,00000
88.0,67.0,80.0,628,01,01,  Kuthibari,68,395,39,193,29,202,14.7,16.8,12.6,00000
88.0,67.0,80.0,628,02,01,  Sadamara,120,402,61,184,59,218,23.0,24.9,21.3,00000
88.0,67.0,80.0,628,03,01,  Andharmanik,165,669,95,316,70,353,19.8,23.1,16.5,00000
88.0,67.0,80.0,628,04,01,  Char Andharmanik,100,197,52,88,48,109,33.7,37.1,30.6,00000
88.0,67.0,87.0,494,01,01,  Badalbari,377,400,232,182,145,218,48.5,56.0,39.9,00000
88.0,67.0,87.0,494,02,01,  Hashakhola,333,298,184,154,149,144,52.8,54.4,50.9,00000
88.0,67.0,87.0,494,03,01,  Natur Para,187,215,109,98,78,117,46.5,52.7,40.0,00000
88.0,67.0,87.0,944,01,01,  Sreephaltala,771,800,375,374,396,426,49.1,50.1,48.2,00000
88.0,67.0,87.0,944,02,01,  Ghosh Sreephaltala,303,434,159,212,144,222,41.1,42.9,39.3,00000
88.0,67.0,94.0,366,01,01,  Dhitpur,292,1886,202,937,90,949,13.4,17.7,8.7,00000
88.0,67.0,94.0,366,02,01,  Baro Pakhia,327,839,203,401,124,438,28.0,33.6,22.1,00000
88.0,78.0,16.0,052,01,01,  Purba Baidya Dhaldob,196,462,82,245,114,217,29.8,25.1,34.4,00000
88.0,78.0,16.0,052,02,01,  Paschim Baidya Dhaldob,291,599,150,297,141,302,32.7,33.6,31.8,00000
88.0,78.0,16.0,119,01,01,  Bejganti,919,930,494,466,425,464,49.7,51.5,47.8,00000
88.0,78.0,16.0,119,02,01,  Khorarganti,314,626,167,308,147,318,33.4,35.2,31.6,00000
88.0,78.0,16.0,373,01,03,  Madhya Dattabari,607,1057,350,534,257,523,36.5,39.6,32.9,00000
88.0,78.0,16.0,373,02,03,  Purba Dattabari,759,1225,352,649,407,576,38.3,35.2,41.4,00000
88.0,78.0,16.0,373,03,03,  Paschim Dattabari,1462,1738,775,858,687,880,45.7,47.5,43.8,00000
88.0,78.0,16.0,397,01,01,  Purba Garudaha,719,1026,378,506,341,520,41.2,42.8,39.6,00000
88.0,78.0,16.0,397,02,01,  Paschim Garudaha,151,701,78,348,73,353,17.7,18.3,17.1,00000
88.0,78.0,16.0,406,01,01,  Purba Ghora Chara,949,739,451,371,498,368,56.2,54.9,57.5,00000
88.0,78.0,16.0,406,02,01,  Paschim Ghora Chara,1122,1258,567,639,555,619,47.1,47.0,47.3,00000
88.0,78.0,16.0,454,01,01,  Hasna,249,728,137,355,112,373,25.5,27.8,23.1,00000
88.0,78.0,16.0,454,02,01,  Char Hasna,266,615,143,313,123,302,30.2,31.4,28.9,00000
88.0,78.0,16.0,688,01,01,  Nandina,192,482,103,241,89,241,28.5,29.9,27.0,00000
88.0,78.0,16.0,688,02,01,  Char Nandina,230,455,110,216,120,239,33.6,33.7,33.4,00000
88.0,78.0,16.0,779,01,01,  Purba Phulkocha,1361,1523,667,736,694,787,47.2,47.5,46.9,00000
88.0,78.0,16.0,779,02,01,  Paschim Phulkocha,651,635,384,309,267,326,50.6,55.4,45.0,00000
88.0,78.0,17.0,200,01,01,  Brahmakhola,422,638,209,309,213,329,39.8,40.3,39.3,00000
88.0,78.0,17.0,200,02,01,  Char Berabari,8,27,6,12,2,15,22.9,33.3,11.8,00000
88.0,78.0,17.0,200,03,01,  Berabari,134,150,53,66,81,84,47.2,44.5,49.1,00000
88.0,78.0,17.0,200,04,01,  Gopinathpur,137,110,70,54,67,56,55.5,56.5,54.5,00000
88.0,78.0,17.0,267,01,01,  Chandpal,197,340,112,147,85,193,36.7,43.2,30.6,00000
88.0,78.0,17.0,267,02,01,  Bil Chandpal,99,94,47,45,52,49,51.3,51.1,51.5,00000
88.0,78.0,17.0,267,03,01,  Duthkarganti,97,42,53,20,44,22,69.8,72.6,66.7,00000
88.0,78.0,17.0,325,01,01,  Deoji,110,208,58,102,52,106,34.6,36.3,32.9,00000
88.0,78.0,17.0,325,02,01,  Char Deoji,36,113,22,59,14,54,24.2,27.2,20.6,00000
88.0,78.0,17.0,339,01,01,  Dhitpur Alal,741,746,374,360,367,386,49.8,51.0,48.7,00000
88.0,78.0,17.0,339,02,01,  Chak Chandi,185,102,88,52,97,50,64.5,62.9,66.0,00000
88.0,78.0,17.0,344,01,01,  Dhitpur Kanu,194,523,96,255,98,268,27.1,27.4,26.8,00000
88.0,78.0,17.0,344,02,01,  Char Dhitpur Kanu,41,148,18,76,23,72,21.7,19.1,24.2,00000
88.0,78.0,17.0,368,01,01,  Bhajon Dashganti,58,50,27,28,31,22,53.7,49.1,58.5,00000
88.0,78.0,17.0,368,02,01,  Dumur Golami,230,330,118,171,112,159,41.1,40.8,41.3,00000
88.0,78.0,17.0,368,03,01,  Paschim Dumur Musa,80,78,38,30,42,48,50.6,55.9,46.7,00000
88.0,78.0,17.0,368,04,01,  Dumur Isa,380,645,202,305,178,340,37.1,39.8,34.4,00000
88.0,78.0,17.0,368,05,01,  Dumur Barabari,53,134,29,68,24,66,28.3,29.9,26.7,00000
88.0,78.0,17.0,368,06,01,  Bil Gajaria,334,764,162,376,172,388,30.4,30.1,30.7,00000
88.0,78.0,17.0,368,07,01,  Joalbhanga,77,262,47,135,30,127,22.7,25.8,19.1,00000
88.0,78.0,17.0,530,01,01,  Kalidasganti,633,1410,361,705,272,705,31.0,33.9,27.8,00000
88.0,78.0,17.0,530,02,01,  Mokterganti,209,246,107,132,102,114,45.9,44.8,47.2,00000
88.0,78.0,17.0,530,03,01,  Alampur,296,137,153,54,143,83,68.4,73.9,63.3,00000
88.0,78.0,17.0,554,01,01,  Paschim Khaga,375,528,171,272,204,256,41.5,38.6,44.3,00000
88.0,78.0,17.0,554,02,01,  Purba Khaga,1336,1422,669,686,667,736,48.4,49.4,47.5,00000
88.0,78.0,17.0,712,01,01,  Niamatpur,214,557,115,260,99,297,27.8,30.7,25.0,00000
88.0,78.0,17.0,712,02,01,  Dighir Char,62,114,35,43,27,71,35.2,44.9,27.6,00000
88.0,78.0,17.0,722,01,01,  Islampur,135,636,77,303,58,333,17.5,20.3,14.8,00000
88.0,78.0,17.0,722,02,01,  Gobindapur,90,424,53,222,37,202,17.5,19.3,15.5,00000
88.0,78.0,17.0,722,03,01,  Char Islampur,115,330,60,162,55,168,25.8,27.0,24.7,00000
88.0,78.0,17.0,731,01,01,  Padumpal,386,948,194,485,192,463,28.9,28.6,29.3,00000
88.0,78.0,17.0,731,02,01,  Char Padumpal,77,106,46,51,31,55,42.1,47.4,36.0,00000
88.0,78.0,17.0,808,01,01,  Rahimpur,217,354,123,164,94,190,38.0,42.9,33.1,00000
88.0,78.0,17.0,808,02,01,  Dhopa Para,255,374,145,189,110,185,40.5,43.4,37.3,00000
88.0,78.0,17.0,808,03,01,  Dwobhanga,100,437,53,213,47,224,18.6,19.9,17.3,00000
88.0,78.0,17.0,813,01,01,  Rajapur,551,889,270,437,281,452,38.3,38.2,38.3,00000
88.0,78.0,17.0,813,02,01,  Machdakandi,316,772,150,348,166,424,29.0,30.1,28.1,00000
88.0,78.0,17.0,951,01,01,  Singarganti,75,29,41,15,34,14,72.1,73.2,70.8,00000
88.0,78.0,17.0,951,02,01,  Dumur Kabir,96,63,55,36,41,27,60.4,60.4,60.3,00000
88.0,78.0,25.0,071,01,01,  Paik Para,675,854,355,395,320,459,44.1,47.3,41.1,00000
88.0,78.0,25.0,071,02,01,  Banbaria,1432,1835,802,894,630,941,43.8,47.3,40.1,00000
88.0,78.0,25.0,071,03,01,  Dighalkandi,818,949,442,460,376,489,46.3,49.0,43.5,00000
88.0,78.0,25.0,071,04,01,  Char Banbaria,1240,779,660,347,580,432,61.4,65.5,57.3,00000
88.0,78.0,25.0,071,05,01,  Char Dighalkandi,102,155,60,76,42,79,39.7,44.1,34.7,00000
88.0,78.0,25.0,071,06,01,  Kadai,591,779,339,365,252,414,43.1,48.2,37.8,00000
88.0,78.0,25.0,071,07,01,  Kashiahata,409,387,237,180,172,207,51.4,56.8,45.4,00000
88.0,78.0,25.0,071,08,01,  Ghona Para,174,479,92,215,82,264,26.6,30.0,23.7,00000
88.0,78.0,25.0,521,01,01,  Kalia,1288,1988,721,935,567,1053,39.3,43.5,35.0,00000
88.0,78.0,25.0,521,02,01,  Kanda Para,3404,4280,2080,2272,1324,2008,44.3,47.8,39.7,00000
88.0,78.0,25.0,521,03,01,  Char Para,480,489,263,225,217,264,49.5,53.9,45.1,00000
88.0,78.0,25.0,521,04,01,  Kallani,599,485,303,219,296,266,55.3,58.0,52.7,00000
88.0,78.0,25.0,521,05,01,  Char Kallani,226,213,120,108,106,105,51.5,52.6,50.2,00000
88.0,78.0,25.0,521,06,01,  Sarkarpara,479,457,231,217,248,240,51.2,51.6,50.8,00000
88.0,78.0,25.0,521,07,01,  Moulvipara,530,324,269,156,261,168,62.1,63.3,60.8,00000
88.0,78.0,25.0,703,01,01,  Rajabnagar,315,224,168,99,147,125,58.4,62.9,54.0,00000
88.0,78.0,25.0,703,02,01,  Char Haripur,775,1586,406,829,369,757,32.8,32.9,32.8,00000
88.0,78.0,25.0,975,01,01,  Tentulia,312,535,171,232,141,303,36.8,42.4,31.8,00000
88.0,78.0,25.0,975,02,01,  Chuniahati,185,588,108,281,77,307,23.9,27.8,20.1,00000
88.0,78.0,25.0,975,03,01,  Kazi Para,317,259,141,136,176,123,55.0,50.9,58.9,00000
88.0,78.0,43.0,210,01,01,  Brahmanganti,366,580,192,286,174,294,38.7,40.2,37.2,00000
88.0,78.0,43.0,210,02,01,  Char Brahmanganti,426,420,214,214,212,206,50.4,50.0,50.7,00000
88.0,78.0,43.0,392,01,01,  Gonerganti,942,662,458,284,484,378,58.7,61.7,56.1,00000
88.0,78.0,43.0,392,02,01,  Chhota Ganerganti,181,200,94,88,87,112,47.5,51.6,43.7,00000
88.0,78.0,43.0,559,01,01,  Khalisakura,576,652,290,314,286,338,46.9,48.0,45.8,00000
88.0,78.0,43.0,559,02,01,  Noada Shailabari,363,482,183,207,180,275,43.0,46.9,39.6,00000
88.0,78.0,43.0,607,01,01,  Khoksabari,824,1058,417,468,407,590,43.8,47.1,40.8,00000
88.0,78.0,43.0,607,02,01,  Char Khoksabari,699,1003,368,474,331,529,41.1,43.7,38.5,00000
88.0,78.0,43.0,607,03,01,  Khokshabari Hospital,540,517,296,235,244,282,51.1,55.7,46.4,00000
88.0,78.0,43.0,607,04,01,  Puran Shailabari,540,786,246,380,294,406,40.7,39.3,42.0,00000
88.0,78.0,43.0,674,01,01,  Munsumi,413,354,199,177,214,177,53.8,52.9,54.7,00000
88.0,78.0,43.0,674,02,01,  Chandrakona Munsumi,343,455,180,242,163,213,43.0,42.7,43.4,00000
88.0,78.0,43.0,727,01,01,  Pachil,558,804,279,361,279,443,41.0,43.6,38.6,00000
88.0,78.0,43.0,727,02,01,  Talgachhi Pachil,235,293,109,124,126,169,44.5,46.8,42.7,00000
88.0,78.0,43.0,889,01,01,  Sailabari,488,388,281,162,207,226,55.7,63.4,47.8,00000
88.0,78.0,43.0,889,02,01,  Char Shailabari,122,258,66,133,56,125,32.1,33.2,30.9,00000
88.0,78.0,43.0,913,01,01,  Satikabari,565,584,248,288,317,296,49.2,46.3,51.7,00000
88.0,78.0,43.0,913,02,01,  Baniagati,230,520,109,273,121,247,30.7,28.5,32.9,00000
88.0,78.0,43.0,971,01,01,  Telkupi,94,370,51,174,43,196,20.3,22.7,18.0,00000
88.0,78.0,43.0,971,02,01,  Sultanganj Para,367,707,197,367,170,340,34.2,34.9,33.3,00000
88.0,78.0,43.0,971,03,01,  Nutanpara,222,261,114,132,108,129,46.0,46.3,45.6,00000
88.0,78.0,43.0,971,04,01,  Nailsapara,500,406,251,200,249,206,55.2,55.7,54.7,00000
88.0,78.0,51.0,669,01,01,  Suri Mechhra,449,601,242,270,207,331,42.8,47.3,38.5,00000
88.0,78.0,51.0,669,02,01,  Mechhara Khamar Para,456,433,239,198,217,235,51.3,54.7,48.0,00000
88.0,78.0,51.0,669,03,01,  Mechhara Hatpara,253,315,150,133,103,182,44.5,53.0,36.1,00000
88.0,78.0,51.0,865,01,01,  Ruksa,1359,2342,724,1140,635,1202,36.7,38.8,34.6,00000
88.0,78.0,51.0,865,02,01,  Neogibari,367,671,201,323,166,348,35.4,38.4,32.3,00000
88.0,78.0,60.0,004,01,01,  Ag Baira,284,857,157,396,127,461,24.9,28.4,21.6,00000
88.0,78.0,60.0,004,02,01,  Char Baira,86,271,46,129,40,142,24.1,26.3,22.0,00000
88.0,78.0,60.0,038,01,01,  Purba Bahuka,1372,1648,663,746,709,902,45.4,47.1,44.0,00000
88.0,78.0,60.0,038,02,01,  Paschim Bahuka,1019,1210,511,545,508,665,45.7,48.4,43.3,00000
88.0,78.0,60.0,038,03,01,  Gazaria,866,983,401,479,465,504,46.8,45.6,48.0,00000
88.0,78.0,60.0,038,04,01,  Bhemara,392,314,197,157,195,157,55.5,55.6,55.4,00000
88.0,78.0,60.0,220,01,01,  Kuri Para,322,560,163,256,159,304,36.5,38.9,34.3,00000
88.0,78.0,60.0,220,02,01,  Purba Kuralia,2006,1790,1009,839,997,951,52.8,54.6,51.2,00000
88.0,78.0,60.0,220,03,01,  Chilgacha,929,1652,505,739,424,913,36.0,40.6,31.7,00000
88.0,78.0,60.0,220,04,01,  Ruperber,154,140,71,64,83,76,52.4,52.6,52.2,00000
88.0,78.0,60.0,377,01,01,  Uttar Ekdala,1364,2248,699,1065,665,1183,37.8,39.6,36.0,00000
88.0,78.0,60.0,377,02,01,  Dakshin Ekdala,774,1791,380,888,394,903,30.2,30.0,30.4,00000
88.0,78.0,60.0,612,01,01,  Kholabari,169,206,81,91,88,115,45.1,47.1,43.3,00000
88.0,78.0,60.0,612,02,01,  Porabari,319,344,159,168,160,176,48.1,48.6,47.6,00000
88.0,78.0,60.0,707,01,01,  Narayandia,454,564,225,270,229,294,44.6,45.5,43.8,00000
88.0,78.0,60.0,707,02,01,  Krishna Jibpur,203,245,109,112,94,133,45.3,49.3,41.4,00000
88.0,78.0,60.0,707,03,01,  Madrabari,169,275,102,116,67,159,38.1,46.8,29.6,00000
88.0,78.0,60.0,770,01,01,  Phulbaira,199,481,113,226,86,255,29.3,33.3,25.2,00000
88.0,78.0,60.0,770,02,01,  Baira Narayan,114,200,67,88,47,112,36.3,43.2,29.6,00000
88.0,78.0,69.0,086,01,01,  Paschim Baoitara,1818,2535,951,1248,867,1287,41.8,43.2,40.3,00000
88.0,78.0,69.0,086,02,01,  Mulibari,600,821,309,405,291,416,42.2,43.3,41.2,00000
88.0,78.0,69.0,363,01,01,  Purba Dukhiabari,92,188,52,94,40,94,32.9,35.6,29.9,00000
88.0,78.0,69.0,363,02,01,  Paschim Dukhiabari,455,815,255,371,200,444,35.8,40.7,31.1,00000
88.0,78.0,69.0,382,01,01,  Purba Gachhabari,134,380,63,196,71,184,26.1,24.3,27.8,00000
88.0,78.0,69.0,382,02,01,  Paschim Gachhabari,650,571,365,284,285,287,53.2,56.2,49.8,00000
88.0,78.0,69.0,478,01,01,  Jamtail Khidirpur,401,342,206,154,195,188,54.0,57.2,50.9,00000
88.0,78.0,69.0,478,02,01,  Dighir Char,278,658,130,335,148,323,29.7,28.0,31.4,00000
88.0,78.0,69.0,483,01,01,  Uttar Porabari,797,483,424,212,373,271,62.3,66.7,57.9,00000
88.0,78.0,69.0,483,02,01,  Dakshin Porabari,565,454,293,194,272,260,55.4,60.2,51.1,00000
88.0,78.0,69.0,492,01,01,  Jarila,731,949,403,444,328,505,43.5,47.6,39.4,00000
88.0,78.0,69.0,492,02,01,  Maisura,103,239,62,111,41,128,30.1,35.8,24.3,00000
88.0,78.0,69.0,492,03,01,  Jarila Madhyapara,384,362,206,177,178,185,51.5,53.8,49.0,00000
88.0,78.0,69.0,492,04,01,  Jarila Digrir Char,207,129,99,59,108,70,61.6,62.7,60.7,00000
88.0,78.0,69.0,789,01,01,  Purba Mohanpur,168,1065,70,569,98,496,13.6,11.0,16.5,00000
88.0,78.0,69.0,789,02,01,  Paschim Mohanpur,206,484,87,254,119,230,29.9,25.5,34.1,00000
88.0,78.0,69.0,884,01,01,  Uttar Saidabad,718,1529,361,778,357,751,32.0,31.7,32.2,00000
88.0,78.0,69.0,884,02,01,  Dakshin Saidabad,911,1139,482,568,429,571,44.4,45.9,42.9,00000
88.0,78.0,69.0,884,03,01,  Kalibari,90,199,38,102,52,97,31.1,27.1,34.9,00000
88.0,78.0,69.0,908,01,01,  Bara Sartia,828,873,418,464,410,409,48.7,47.4,50.1,00000
88.0,78.0,69.0,908,02,01,  Natun Sartia,1039,1456,563,689,476,767,41.6,45.0,38.3,00000
88.0,78.0,69.0,908,03,01,  Purba Sartia Char,451,402,242,186,209,216,52.9,56.5,49.2,00000
88.0,78.0,69.0,908,04,01,  Paschim Sartia,520,513,273,223,247,290,50.3,55.0,46.0,00000
88.0,78.0,69.0,908,05,01,  Hat Sartia,539,969,286,447,253,522,35.7,39.0,32.6,00000
88.0,78.0,77.0,090,01,01,  Bara Hamkuria,745,708,372,336,373,372,51.3,52.5,50.1,00000
88.0,78.0,77.0,090,02,01,  Rajakhar Char,196,425,96,222,100,203,31.6,30.2,33.0,00000
88.0,78.0,77.0,263,01,01,  Chandidasganti,1573,1609,775,779,798,830,49.4,49.9,49.0,00000
88.0,78.0,77.0,263,02,01,  Saraichandi,229,258,108,120,121,138,47.0,47.4,46.7,00000
88.0,78.0,77.0,545,01,01,  Kayalganti,361,265,187,113,174,152,57.7,62.3,53.4,00000
88.0,78.0,77.0,545,02,01,  Shibnathpur,485,819,261,395,224,424,37.2,39.8,34.6,00000
88.0,78.0,77.0,621,01,01,  Khorda Shialkul,798,551,427,246,371,305,59.2,63.4,54.9,00000
88.0,78.0,77.0,621,02,01,  Char Para,200,333,108,163,92,170,37.5,39.9,35.1,00000
88.0,78.0,77.0,621,03,01,  Dairkalia,146,279,74,139,72,140,34.4,34.7,34.0,00000
88.0,78.0,77.0,798,01,01,  Raghunathpur,1059,1400,545,700,514,700,43.1,43.8,42.3,00000
88.0,78.0,77.0,798,02,01,  Badhayanath,877,755,485,374,392,381,53.7,56.5,50.7,00000
88.0,78.0,77.0,932,01,01,  Shialkul,925,803,505,379,420,424,53.5,57.1,49.8,00000
88.0,78.0,77.0,932,02,01,  Shyampur,603,900,299,451,304,449,40.1,39.9,40.4,00000
88.0,78.0,94.0,014,01,01,  Aminpur,570,777,261,359,309,418,42.3,42.1,42.5,00000
88.0,78.0,94.0,014,02,01,  Machhuakandi,163,244,84,129,79,115,40.0,39.4,40.7,00000
88.0,78.0,94.0,066,01,01,  Balighugri,718,926,338,460,380,466,43.7,42.4,44.9,00000
88.0,78.0,94.0,066,02,01,  Char Balighugri,256,707,131,333,125,374,26.6,28.2,25.1,00000
88.0,78.0,94.0,502,01,01,  Jhinaiganti,211,299,101,160,110,139,41.4,38.7,44.2,00000
88.0,78.0,94.0,502,02,01,  Dakatiabari,159,202,83,87,76,115,44.0,48.8,39.8,00000
88.0,78.0,94.0,597,01,01,  Kaim Khata,663,474,331,212,332,262,58.3,61.0,55.9,00000
88.0,78.0,94.0,597,02,01,  Par Khata,188,229,103,114,85,115,45.1,47.5,42.5,00000
88.0,78.0,94.0,597,03,01,  Char Khata,594,665,363,291,231,374,47.2,55.5,38.2,00000
88.0,78.0,94.0,947,01,01,  Simla,272,385,155,188,117,197,41.4,45.2,37.3,00000
88.0,78.0,94.0,947,02,01,  Par Simla,127,306,64,148,63,158,29.3,30.2,28.5,00000
88.0,89.0,10.0,178,01,01,  Binodpur,559,249,297,106,262,143,69.2,73.7,64.7,00000
88.0,89.0,10.0,178,02,01,  Kharkharia,273,251,149,106,124,145,52.1,58.4,46.1,00000
88.0,89.0,21.0,011,01,01,  Arangail,414,1333,229,607,185,726,23.7,27.4,20.3,00000
88.0,89.0,21.0,011,02,01,  Dogharia,131,78,74,40,57,38,62.7,64.9,60.0,00000
88.0,89.0,21.0,195,01,01,  Bishamdanga,86,112,51,46,35,66,43.4,52.6,34.7,00000
88.0,89.0,21.0,195,02,01,  Dattabari,141,170,80,74,61,96,45.3,51.9,38.9,00000
88.0,89.0,21.0,195,03,01,  Teghari,34,70,20,31,14,39,32.7,39.2,26.4,00000
88.0,89.0,21.0,195,04,01,  Boail,119,119,76,48,43,71,50.0,61.3,37.7,00000
88.0,89.0,21.0,195,05,01,  Ramballabhpur,52,64,35,23,17,41,44.8,60.3,29.3,00000
88.0,89.0,21.0,430,01,01,  Gurpipul,204,231,113,101,91,130,46.9,52.8,41.2,00000
88.0,89.0,21.0,430,02,01,  Chaymati,31,160,20,71,11,89,16.2,22.0,11.0,00000
88.0,89.0,21.0,430,03,01,  Doani Para,90,121,49,54,41,67,42.7,47.6,38.0,00000
88.0,89.0,21.0,430,04,01,  Chatria Para,68,79,34,35,34,44,46.3,49.3,43.6,00000
88.0,89.0,21.0,430,05,01,  Bausta Para,83,103,43,46,40,57,44.6,48.3,41.2,00000
88.0,89.0,21.0,430,06,01,  Josaipara,70,212,45,103,25,109,24.8,30.4,18.7,00000
88.0,89.0,21.0,989,01,01,  Shuhara,213,307,135,136,78,171,41.0,49.8,31.3,00000
88.0,89.0,21.0,989,02,01,  Shyampur,97,204,55,99,42,105,32.2,35.7,28.6,00000
88.0,89.0,31.0,335,01,01,  Kumar Para,83,301,50,144,33,157,21.6,25.8,17.4,00000
88.0,89.0,31.0,335,02,01,  Dhankunti,55,157,27,79,28,78,25.9,25.5,26.4,00000
88.0,89.0,31.0,469,01,01,  Jhurjhuri,415,510,202,252,213,258,44.9,44.5,45.2,00000
88.0,89.0,31.0,469,02,01,  Lakshipur,92,233,53,101,39,132,28.3,34.4,22.8,00000
88.0,89.0,31.0,514,01,01,  Kanchaneshwar,339,679,196,297,143,382,33.3,39.8,27.2,00000
88.0,89.0,31.0,514,02,01,  Akaijani,58,125,37,61,21,64,31.7,37.8,24.7,00000
88.0,89.0,31.0,654,01,01,  Madhainagar,559,930,322,389,237,541,37.5,45.3,30.5,00000
88.0,89.0,31.0,654,02,01,  Saha Para,107,132,64,75,43,57,44.8,46.0,43.0,00000
88.0,89.0,31.0,939,01,01,  Subhar,33,198,18,87,15,111,14.3,17.1,11.9,00000
88.0,89.0,31.0,939,02,01,  Thakur Pukur,16,127,9,55,7,72,11.2,14.1,8.9,00000
88.0,89.0,42.0,368,01,01,  Gauripur,418,343,218,154,200,189,54.9,58.6,51.4,00000
88.0,89.0,42.0,368,02,01,  Paik Lini,125,198,66,95,59,103,38.7,41.0,36.4,00000
88.0,89.0,42.0,374,01,01,  Ghargram,369,418,205,171,164,247,46.9,54.5,39.9,00000
88.0,89.0,42.0,374,02,01,  Badu Lini,339,547,171,260,168,287,38.3,39.7,36.9,00000
88.0,89.0,42.0,374,03,01,  Harirampur,187,300,104,136,83,164,38.4,43.3,33.6,00000
88.0,89.0,42.0,436,01,01,  Uttar Sekh Para,171,290,103,130,68,160,37.1,44.2,29.8,00000
88.0,89.0,42.0,436,02,01,  Madhya Sekh Para,187,257,92,111,95,146,42.1,45.3,39.4,00000
88.0,89.0,42.0,436,03,01,  Dakshin Sekh Para,241,587,127,279,114,308,29.1,31.3,27.0,00000
88.0,89.0,42.0,436,04,01,  Sarkar Para,208,370,111,183,97,187,36.0,37.8,34.2,00000
88.0,89.0,42.0,436,05,01,  Jalalpur,90,132,37,67,53,65,40.5,35.6,44.9,00000
88.0,89.0,42.0,436,06,01,  Khapara,352,212,157,106,195,106,62.4,59.7,64.8,00000
88.0,89.0,42.0,436,07,01,  Sardar Para,76,161,35,80,41,81,32.1,30.4,33.6,00000
88.0,89.0,42.0,436,08,01,  Dakshin Paschimpara,132,237,68,109,64,128,35.8,38.4,33.3,00000
88.0,89.0,42.0,436,09,01,  Char Hamkuria,211,274,108,123,103,151,43.5,46.8,40.6,00000
88.0,89.0,42.0,737,01,01,  Nadi Para,1009,1181,486,553,523,628,46.1,46.8,45.4,00000
88.0,89.0,42.0,737,02,01,  Khukni Para,211,546,126,242,85,304,27.9,34.2,21.9,00000
88.0,89.0,42.0,737,03,01,  Moshinda Para,192,523,114,282,78,241,26.9,28.8,24.5,00000
88.0,89.0,42.0,737,04,01,  Muslim Para,119,179,53,94,66,85,39.9,36.1,43.7,00000
88.0,89.0,42.0,737,05,01,  Patgari,166,196,88,95,78,101,45.9,48.1,43.6,00000
88.0,89.0,42.0,737,06,01,  Bahir Para,227,400,120,181,107,219,36.2,39.9,32.8,00000
88.0,89.0,42.0,737,07,01,  Bil Nado,73,351,45,180,28,171,17.2,20.0,14.1,00000
88.0,89.0,52.0,050,01,01,  Baniabau,237,480,128,222,109,258,33.1,36.6,29.7,00000
88.0,89.0,52.0,050,02,01,  Nabipur,151,239,82,108,69,131,38.7,43.2,34.5,00000
88.0,89.0,52.0,100,01,01,  Binod Bhatra,79,253,38,124,41,129,23.8,23.5,24.1,00000
88.0,89.0,52.0,100,02,01,  Hamidpur,45,166,24,83,21,83,21.3,22.4,20.2,00000
88.0,89.0,52.0,117,01,01,  Bhaiat,303,444,153,216,150,228,40.6,41.5,39.7,00000
88.0,89.0,52.0,117,02,01,  Banshbaria,478,477,260,201,218,276,50.1,56.4,44.1,00000
88.0,89.0,52.0,117,03,01,  Alokdiar,120,234,68,116,52,118,33.9,37.0,30.6,00000
88.0,89.0,52.0,117,04,01,  Chak Bhaiat,137,324,73,150,64,174,29.7,32.7,26.9,00000
88.0,89.0,52.0,307,01,01,  Debipur,431,506,224,224,207,282,46.0,50.0,42.3,00000
88.0,89.0,52.0,307,02,01,  Konabari,99,84,58,31,41,53,54.1,65.2,43.6,00000
88.0,89.0,52.0,307,03,01,  Chak Rauhali,60,91,37,40,23,51,39.7,48.1,31.1,00000
88.0,89.0,52.0,676,01,01,  Mahishluti,274,280,141,129,133,151,49.5,52.2,46.8,00000
88.0,89.0,52.0,676,02,01,  Goalgram,224,242,122,113,102,129,48.1,51.9,44.2,00000
88.0,89.0,52.0,754,01,01,  Naogaon Paschimpara,487,637,252,298,235,339,43.3,45.8,40.9,00000
88.0,89.0,52.0,754,02,01,  Naogaon Purbapara,662,942,348,454,314,488,41.3,43.4,39.2,00000
88.0,89.0,63.0,531,01,01,  Katabari,264,627,154,297,110,330,29.6,34.1,25.0,00000
88.0,89.0,63.0,531,02,01,  Naukhada,527,1331,263,635,264,696,28.4,29.3,27.5,00000
88.0,89.0,63.0,531,03,01,  Hemnagar,396,376,223,182,173,194,51.3,55.1,47.1,00000
88.0,89.0,63.0,531,04,01,  Ishwarpur,221,603,135,294,86,309,26.8,31.5,21.8,00000
88.0,89.0,63.0,531,05,01,  Dhamaich,60,283,35,140,25,143,17.5,20.0,14.9,00000
88.0,89.0,63.0,609,01,01,  Chak Para,407,666,251,274,156,392,37.9,47.8,28.5,00000
88.0,89.0,63.0,609,02,01,  Purbapara,134,222,77,88,57,134,37.6,46.7,29.8,00000
88.0,89.0,63.0,609,03,01,  Paschimpara,148,223,77,100,71,123,39.9,43.5,36.6,00000
88.0,89.0,63.0,609,04,01,  Uttarpara,160,177,85,87,75,90,47.5,49.4,45.5,00000
88.0,89.0,63.0,609,05,01,  Dakshinpara,123,139,70,48,53,91,46.9,59.3,36.8,00000
88.0,89.0,63.0,614,01,01,  Bil Kusabari,125,185,68,86,57,99,40.3,44.2,36.5,00000
88.0,89.0,63.0,614,02,01,  Char Kusabari,919,1594,495,780,424,814,36.6,38.8,34.2,00000
88.0,89.0,63.0,614,03,01,  Sabjuj Para,669,1561,331,763,338,798,30.0,30.3,29.8,00000
88.0,89.0,63.0,681,01,01,  Majhira,346,401,176,205,170,196,46.3,46.2,46.4,00000
88.0,89.0,63.0,681,02,01,  Lalua,70,399,40,187,30,212,14.9,17.6,12.4,00000
88.0,89.0,63.0,866,01,01,  Sanduria,485,586,246,267,239,319,45.3,48.0,42.8,00000
88.0,89.0,63.0,866,02,01,  Dhap,123,135,68,70,55,65,47.7,49.3,45.8,00000
88.0,89.0,73.0,067,01,01,  Muslim Para,170,157,84,70,86,87,52.0,54.5,49.7,00000
88.0,89.0,73.0,067,02,01,  Hindu Para,89,121,52,52,37,69,42.4,50.0,34.9,00000
88.0,89.0,73.0,301,01,01,  Paschim Damra Para,39,54,22,21,17,33,41.9,51.2,34.0,00000
88.0,89.0,73.0,301,02,01,  Purba Damra Para,105,96,61,31,44,65,52.2,66.3,40.4,00000
88.0,89.0,73.0,313,01,01,  Muslim Para,155,151,87,70,68,81,50.7,55.4,45.6,00000
88.0,89.0,73.0,313,02,01,  Hindu Para,98,135,49,56,49,79,42.1,46.7,38.3,00000
88.0,89.0,73.0,419,01,01,  Basnia Para,62,92,40,44,22,48,40.3,47.6,31.4,00000
88.0,89.0,73.0,419,02,01,  Paschimpara,135,147,76,57,59,90,47.9,57.1,39.6,00000
88.0,89.0,73.0,419,03,01,  Haji Para,72,130,39,62,33,68,35.6,38.6,32.7,00000
88.0,89.0,73.0,419,04,01,  Dogaria Para,254,254,142,115,112,139,50.0,55.3,44.6,00000
88.0,89.0,73.0,419,05,01,  Hindu Para,219,491,119,233,100,258,30.8,33.8,27.9,00000
88.0,89.0,73.0,463,01,01,  Muslim Para,282,651,157,280,125,371,30.2,35.9,25.2,00000
88.0,89.0,73.0,463,02,01,  Hindu Para,40,63,23,25,17,38,38.8,47.9,30.9,00000
88.0,89.0,73.0,491,01,01,  Muslim Para,305,285,169,126,136,159,51.7,57.3,46.1,00000
88.0,89.0,73.0,491,02,01,  Hindu Para,73,260,41,121,32,139,21.9,25.3,18.7,00000
88.0,89.0,73.0,570,01,01,  Ashal Para,154,118,87,54,67,64,56.6,61.7,51.1,00000
88.0,89.0,73.0,570,02,01,  Khas Para,155,224,80,102,75,122,40.9,44.0,38.1,00000
88.0,89.0,73.0,603,01,01,  Uttarpara,174,168,90,74,84,94,50.9,54.9,47.2,00000
88.0,89.0,73.0,603,02,01,  Dakshinpara,123,197,70,79,53,118,38.4,47.0,31.0,00000
88.0,89.0,73.0,603,03,01,  Paschimpara,75,71,45,30,30,41,51.4,60.0,42.3,00000
88.0,89.0,73.0,709,01,01,  Muslim Para,68,376,38,179,30,197,15.3,17.5,13.2,00000
88.0,89.0,73.0,709,02,01,  Hindu Para,66,119,46,56,20,63,35.7,45.1,24.1,00000
88.0,89.0,73.0,782,01,01,  Paschim Paril,108,103,68,46,40,57,51.2,59.6,41.2,00000
88.0,89.0,73.0,782,02,01,  Purba Paril,92,195,56,90,36,105,32.1,38.4,25.5,00000
88.0,89.0,73.0,905,01,01,  Nama Shilat,188,376,98,162,90,214,33.3,37.7,29.6,00000
88.0,89.0,73.0,905,02,01,  Khas Para,70,213,32,104,38,109,24.7,23.5,25.9,00000
88.0,89.0,73.0,905,03,01,  Upar Shilat,280,419,156,179,124,240,40.1,46.6,34.1,00000
88.0,89.0,73.0,905,04,01,  Boal Pukur,12,99,8,48,4,51,10.8,14.3,7.3,00000
88.0,89.0,73.0,950,01,01,  Hatkhola,239,478,129,232,110,246,33.3,35.7,30.9,00000
88.0,89.0,73.0,950,02,01,  Kachari Para,239,182,117,81,122,101,56.8,59.1,54.7,00000
88.0,89.0,73.0,950,03,01,  Madhyapara,216,173,122,68,94,105,55.5,64.2,47.2,00000
88.0,89.0,73.0,950,04,01,  Kashia Para,46,72,19,34,27,38,39.0,35.8,41.5,00000
88.0,89.0,73.0,950,05,01,  Soratala,193,113,96,49,97,64,63.1,66.2,60.2,00000
88.0,89.0,73.0,950,06,01,  Adar Para,213,493,133,224,80,269,30.2,37.3,22.9,00000
88.0,89.0,73.0,950,07,01,  Padma Para,127,223,73,98,54,125,36.3,42.7,30.2,00000
88.0,89.0,73.0,961,01,01,  Muslim Para,87,99,53,39,34,60,46.8,57.6,36.2,00000
88.0,89.0,73.0,961,02,01,  Hindu Para,58,120,32,56,26,64,32.6,36.4,28.9,00000
88.0,89.0,73.0,961,03,01,  Dhawa Para,44,56,24,25,20,31,44.0,49.0,39.2,00000
88.0,89.0,84.0,061,01,01,  Ulipur,295,198,159,90,136,108,59.8,63.9,55.7,00000
88.0,89.0,84.0,061,02,01,  Bri-Pachan,184,173,87,89,97,84,51.5,49.4,53.6,00000
88.0,89.0,84.0,290,01,01,  Dakshin Mathurapur,272,570,148,250,124,320,32.3,37.2,27.9,00000
88.0,89.0,84.0,290,02,01,  Chak Gopinathpur,34,227,24,103,10,124,13.0,18.9,7.5,00000
88.0,89.0,84.0,704,01,01,  Mangalbaria,163,203,82,104,81,99,44.5,44.1,45.0,00000
88.0,89.0,84.0,704,02,01,  Raghunili,158,389,85,183,73,206,28.9,31.7,26.2,00000
88.0,94.0,12.0,177,01,01,  Bhoynagar,313,625,177,296,136,329,33.4,37.4,29.2,00000
88.0,94.0,12.0,177,02,01,  Khojakhali,91,229,41,97,50,132,28.4,29.7,27.5,00000
88.0,94.0,12.0,211,01,01,  Chak Bangla,41,62,24,29,17,33,39.8,45.3,34.0,00000
88.0,94.0,12.0,211,02,01,  Katar Mahal,163,251,84,105,79,146,39.4,44.4,35.1,00000
88.0,94.0,12.0,211,03,01,  Garabari,83,127,51,54,32,73,39.5,48.6,30.5,00000
88.0,94.0,12.0,264,01,01,  Chengatia,292,767,159,344,133,423,27.6,31.6,23.9,00000
88.0,94.0,12.0,264,02,01,  Chanda Para,83,170,45,78,38,92,32.8,36.6,29.2,00000
88.0,94.0,12.0,382,01,01,  Bara Ghona,225,292,132,128,93,164,43.5,50.8,36.2,00000
88.0,94.0,12.0,382,02,01,  Choto Ghona,27,187,20,92,7,95,12.6,17.9,6.9,00000
88.0,94.0,12.0,382,03,01,  Chak Mehedi,77,182,43,93,34,89,29.7,31.6,27.6,00000
88.0,94.0,12.0,472,01,01,  Kaigathi,183,527,79,260,104,267,25.8,23.3,28.0,00000
88.0,94.0,12.0,472,02,01,  Mali Para,121,315,67,149,54,166,27.8,31.0,24.5,00000
88.0,94.0,12.0,749,01,01,  Pratap,1004,1646,506,733,498,913,37.9,40.8,35.3,00000
88.0,94.0,12.0,749,02,01,  Banamali Pratap,76,114,42,45,34,69,40.0,48.3,33.0,00000
88.0,94.0,12.0,805,01,01,  Rahimpur,207,275,116,118,91,157,42.9,49.6,36.7,00000
88.0,94.0,12.0,805,02,01,  Chak Ramkrishnapur,41,142,27,62,14,80,22.4,30.3,14.9,00000
88.0,94.0,14.0,124,01,01,  Nabanna Para,41,68,23,28,18,40,37.6,45.1,31.0,00000
88.0,94.0,14.0,124,02,01,  Madhyapara,129,257,68,117,61,140,33.4,36.8,30.3,00000
88.0,94.0,14.0,124,03,01,  Ballar Para,258,257,135,126,123,131,50.1,51.7,48.4,00000
88.0,94.0,14.0,124,04,01,  Khamar Para,785,654,431,286,354,368,54.6,60.1,49.0,00000
88.0,94.0,14.0,124,05,01,  Dakshinpara,1170,975,618,442,552,533,54.5,58.3,50.9,00000
88.0,94.0,14.0,204,01,01,  Brahma Kapali,1066,982,563,449,503,533,52.1,55.6,48.6,00000
88.0,94.0,14.0,204,02,01,  Bhutbaria,83,130,49,60,34,70,39.0,45.0,32.7,00000
88.0,94.0,14.0,325,01,01,  Dhunchi,159,189,89,86,70,103,45.7,50.9,40.5,00000
88.0,94.0,14.0,325,02,01,  Char Dhunchi,320,625,171,284,149,341,33.9,37.6,30.4,00000
88.0,94.0,14.0,450,01,01,  Uttarpara (Ulipur),889,1208,444,561,445,647,42.4,44.2,40.8,00000
88.0,94.0,14.0,450,02,01,  Dakshinpara,1312,1562,675,796,637,766,45.7,45.9,45.4,00000
88.0,94.0,21.0,238,01,01,  Chandraganti,400,819,205,388,195,431,32.8,34.6,31.2,00000
88.0,94.0,21.0,238,02,01,  Baruiganti,85,235,44,110,41,125,26.6,28.6,24.7,00000
88.0,94.0,21.0,654,01,01,  Narsingha Para,412,564,214,251,198,313,42.2,46.0,38.7,00000
88.0,94.0,21.0,654,02,01,  Shuklai,271,383,136,173,135,210,41.4,44.0,39.1,00000
88.0,94.0,21.0,870,01,01,  Saidpur,262,576,145,254,117,322,31.3,36.3,26.7,00000
88.0,94.0,21.0,870,02,01,  Matikata,90,179,53,83,37,96,33.5,39.0,27.8,00000
88.0,94.0,29.0,062,01,01,  Bagalpur,636,756,341,367,295,389,45.7,48.2,43.1,00000
88.0,94.0,29.0,062,02,01,  Hatkhola,29,45,11,21,18,24,39.2,34.4,42.9,00000
88.0,94.0,29.0,062,03,01,  Datta Para,420,234,218,105,202,129,64.2,67.5,61.0,00000
88.0,94.0,29.0,083,01,01,  Islampur,871,1343,476,641,395,702,39.3,42.6,36.0,00000
88.0,94.0,29.0,083,02,01,  Balsabari,2041,2414,1127,1120,914,1294,45.8,50.2,41.4,00000
88.0,94.0,29.0,143,01,01,  Bera Patia,210,398,106,175,104,223,34.5,37.7,31.8,00000
88.0,94.0,29.0,143,02,01,  Anandabaria,93,101,54,47,39,54,47.9,53.5,41.9,00000
88.0,94.0,29.0,162,01,01,  Bhairab,303,526,155,254,148,272,36.6,37.9,35.2,00000
88.0,94.0,29.0,162,02,01,  Chhoto Bhairab,106,327,49,147,57,180,24.5,25.0,24.1,00000
88.0,94.0,29.0,166,01,01,  Bhatbera,358,306,187,134,171,172,53.9,58.3,49.9,00000
88.0,94.0,29.0,166,02,01,  Char Bhatbera,402,637,219,316,183,321,38.7,40.9,36.3,00000
88.0,94.0,29.0,336,01,01,  Durganagar,280,60,139,20,141,40,82.4,87.4,77.9,00000
88.0,94.0,29.0,336,02,01,  Gharalganti,287,361,153,186,134,175,44.3,45.1,43.4,00000
88.0,94.0,29.0,336,03,01,  Alamnagar,227,191,139,85,88,106,54.3,62.1,45.4,00000
88.0,94.0,29.0,431,01,01,  Hemantabari,673,970,372,442,301,528,41.0,45.7,36.3,00000
88.0,94.0,29.0,431,02,01,  Senganti,281,455,148,226,133,229,38.2,39.6,36.7,00000
88.0,94.0,29.0,431,03,01,  Datpur,1329,1727,772,805,557,922,43.5,49.0,37.7,00000
88.0,94.0,29.0,431,04,01,  Babla Para,669,591,397,274,272,317,53.1,59.2,46.2,00000
88.0,94.0,29.0,461,01,01,  Joginibari,233,621,112,317,121,304,27.3,26.1,28.5,00000
88.0,94.0,29.0,461,02,01,  Madhupur,609,1041,351,497,258,544,36.9,41.4,32.2,00000
88.0,94.0,29.0,575,01,01,  Mahananda Para,103,133,49,59,54,74,43.6,45.4,42.2,00000
88.0,94.0,29.0,575,02,01,  Botebaria,49,52,28,24,21,28,48.5,53.8,42.9,00000
88.0,94.0,29.0,575,03,01,  Konabari,101,149,53,78,48,71,40.4,40.5,40.3,00000
88.0,94.0,29.0,578,01,01,  Kamar Para,128,146,70,67,58,79,46.7,51.1,42.3,00000
88.0,94.0,29.0,578,02,01,  Minar Para,205,293,105,132,100,161,41.2,44.3,38.3,00000
88.0,94.0,29.0,578,03,01,  Madhyapara,279,334,151,154,128,180,45.5,49.5,41.6,00000
88.0,94.0,29.0,578,04,01,  Paschimpara Tatipara,144,398,87,190,57,208,26.6,31.4,21.5,00000
88.0,94.0,29.0,597,01,01,  Maricha,516,1025,323,507,193,518,33.5,38.9,27.1,00000
88.0,94.0,29.0,597,02,01,  Janglipur,205,563,120,278,85,285,26.7,30.2,23.0,00000
88.0,94.0,29.0,616,01,01,  Mulbaria,276,495,148,256,128,239,35.8,36.6,34.9,00000
88.0,94.0,29.0,616,02,01,  Diarpara,0,77,0,39,0,38,0.0,0.0,0.0,00000
88.0,94.0,29.0,646,01,01,  Nandiganti,665,176,391,62,274,114,79.1,86.3,70.6,00000
88.0,94.0,29.0,646,02,01,  Charnamdiganti,133,200,73,97,60,103,39.9,42.9,36.8,00000
88.0,94.0,29.0,756,01,01,  Bamangaon,70,157,46,75,24,82,30.8,38.0,22.6,00000
88.0,94.0,29.0,756,02,01,  Bamangaon Hatkhola,167,69,83,25,84,44,70.8,76.9,65.6,00000
88.0,94.0,29.0,756,03,01,  Rudraganti,55,103,28,49,27,54,34.8,36.4,33.3,00000
88.0,94.0,29.0,756,04,01,  Diarpara,59,203,35,89,24,114,22.5,28.2,17.4,00000
88.0,94.0,29.0,813,01,01,  Daha Para,370,461,202,209,168,252,44.5,49.1,40.0,00000
88.0,94.0,29.0,813,02,01,  Char Para,215,226,121,102,94,124,48.8,54.3,43.1,00000
88.0,94.0,29.0,813,03,01,  Dahikhola,446,966,259,456,187,510,31.6,36.2,26.8,00000
88.0,94.0,29.0,813,04,01,  Laskar Para,46,86,24,46,22,40,34.8,34.3,35.5,00000
88.0,94.0,29.0,813,05,01,  Nishan Para,118,266,72,126,46,140,30.7,36.4,24.7,00000
88.0,94.0,29.0,858,01,01,  Rautan,392,780,223,370,169,410,33.4,37.6,29.2,00000
88.0,94.0,29.0,858,02,01,  Nandibera,292,318,151,144,141,174,47.9,51.2,44.8,00000
88.0,94.0,29.0,957,01,01,  Shyampur,1490,1073,816,468,674,605,58.1,63.6,52.7,00000
88.0,94.0,29.0,957,02,01,  Manushmura,201,433,96,214,105,219,31.7,31.0,32.4,00000
88.0,94.0,36.0,242,01,01,  Madhyapara,567,474,283,241,284,233,54.5,54.0,54.9,00000
88.0,94.0,36.0,242,02,01,  Kalibari,365,1077,200,527,165,550,25.3,27.5,23.1,00000
88.0,94.0,36.0,242,03,01,  Maichakandi,208,840,106,388,102,452,19.8,21.5,18.4,00000
88.0,94.0,36.0,242,04,01,  Ramar Char,132,207,60,98,72,109,38.9,38.0,39.8,00000
88.0,94.0,36.0,242,05,01,  Kamar Para,82,253,46,117,36,136,24.5,28.2,20.9,00000
88.0,94.0,36.0,242,06,01,  Kandi Para,370,790,190,365,180,425,31.9,34.2,29.8,00000
88.0,94.0,36.0,245,01,01,  Uttarpara,1184,1609,652,763,532,846,42.4,46.1,38.6,00000
88.0,94.0,36.0,245,02,01,  Sattarbaria,120,80,67,40,53,40,60.0,62.6,57.0,00000
88.0,94.0,36.0,245,03,01,  Dakshinpara,559,823,298,396,261,427,40.4,42.9,37.9,00000
88.0,94.0,36.0,245,04,01,  Kashinathpur,129,267,77,130,52,137,32.6,37.2,27.5,00000
88.0,94.0,36.0,245,05,01,  Golakpur,381,439,261,245,120,194,46.5,51.6,38.2,00000
88.0,94.0,36.0,245,06,01,  Chak Para,122,201,56,102,66,99,37.8,35.4,40.0,00000
88.0,94.0,36.0,419,01,01,  Hati Para,664,1467,361,695,303,772,31.2,34.2,28.2,00000
88.0,94.0,36.0,419,02,01,  Kachiar Char,194,433,106,220,88,213,30.9,32.5,29.2,00000
88.0,94.0,36.0,419,03,01,  Hatikumrul,363,615,208,296,155,319,37.1,41.3,32.7,00000
88.0,94.0,36.0,419,04,01,  Radhanagar,139,211,88,103,51,108,39.7,46.1,32.1,00000
88.0,94.0,36.0,419,05,01,  Ramnagar,91,381,45,200,46,181,19.3,18.4,20.3,00000
88.0,94.0,36.0,733,01,01,  Patdhari,881,1175,488,542,393,633,42.9,47.4,38.3,00000
88.0,94.0,36.0,733,02,01,  Raninagar,563,535,301,240,262,295,51.3,55.6,47.0,00000
88.0,94.0,36.0,733,03,01,  Kumarganti,211,358,106,181,105,177,37.1,36.9,37.2,00000
88.0,94.0,36.0,733,04,01,  Manik Diar,465,967,233,456,232,511,32.5,33.8,31.2,00000
88.0,94.0,36.0,843,01,01,  Rasidpur,468,665,241,317,227,348,41.3,43.2,39.5,00000
88.0,94.0,36.0,843,02,01,  Naya Rasidpur,105,211,54,104,51,107,33.2,34.2,32.3,00000
88.0,94.0,43.0,132,01,01,  Bardhangachha,1093,972,575,416,518,556,52.9,58.0,48.2,00000
88.0,94.0,43.0,132,02,01,  Char Bardhangachha,551,752,303,360,248,392,42.3,45.7,38.8,00000
88.0,94.0,43.0,295,01,01,  Lahiri Mohanpur,649,484,353,224,296,260,57.3,61.2,53.2,00000
88.0,94.0,43.0,295,02,01,  Ag Mohanpur,238,96,138,43,100,53,71.3,76.2,65.4,00000
88.0,94.0,43.0,295,03,01,  Mohanpur Bazar,749,186,398,72,351,114,80.1,84.7,75.5,00000
88.0,94.0,43.0,295,04,01,  Char Mohanpur,1060,1093,568,488,492,605,49.2,53.8,44.8,00000
88.0,94.0,43.0,344,01,01,  Satbila,534,626,293,281,241,345,46.0,51.0,41.1,00000
88.0,94.0,43.0,344,02,01,  Datta Para,318,673,184,298,134,375,32.1,38.2,26.3,00000
88.0,94.0,43.0,344,03,01,  Chak Para,333,534,181,239,152,295,38.4,43.1,34.0,00000
88.0,94.0,43.0,344,04,01,  Atiar Para,430,694,225,323,205,371,38.3,41.1,35.6,00000
88.0,94.0,43.0,344,05,01,  Gonaiganti,413,393,198,176,215,217,51.2,52.9,49.8,00000
88.0,94.0,43.0,344,06,01,  Kaimkona,128,185,58,91,70,94,40.9,38.9,42.7,00000
88.0,94.0,43.0,544,01,01,  Konabari,253,200,127,96,126,104,55.8,57.0,54.8,00000
88.0,94.0,43.0,544,02,01,  Daimurchi,182,68,90,35,92,33,72.8,72.0,73.6,00000
88.0,94.0,43.0,703,01,01,  Bamangaon,272,286,141,130,131,156,48.7,52.0,45.6,00000
88.0,94.0,43.0,703,02,01,  Balaiganti,111,73,56,24,55,49,60.3,70.0,52.9,00000
88.0,94.0,43.0,703,03,01,  Anchalganti,94,165,59,68,35,97,36.3,46.5,26.5,00000
88.0,94.0,51.0,109,01,01,  Bannakandi,1088,1316,584,591,504,725,45.3,49.7,41.0,00000
88.0,94.0,51.0,109,02,01,  Pechar Para,325,471,177,216,148,255,40.8,45.0,36.7,00000
88.0,94.0,51.0,109,03,01,  Char Pechar Para,341,577,188,257,153,320,37.1,42.2,32.3,00000
88.0,94.0,51.0,306,01,01,  Damdama,690,993,383,442,307,551,41.0,46.4,35.8,00000
88.0,94.0,51.0,306,02,01,  Char Damdama,399,633,198,272,201,361,38.7,42.1,35.8,00000
88.0,94.0,51.0,484,01,01,  Kaliganj,946,421,491,173,455,248,69.2,73.9,64.7,00000
88.0,94.0,51.0,484,02,01,  Char Kaliganj,409,299,198,125,211,174,57.8,61.3,54.8,00000
88.0,94.0,51.0,552,01,01,  Betkandi,1372,2212,747,1032,625,1180,38.3,42.0,34.6,00000
88.0,94.0,51.0,552,02,01,  Manirpur,207,336,112,149,95,187,38.1,42.9,33.7,00000
88.0,94.0,51.0,552,03,01,  Banbaria,495,431,271,188,224,243,53.5,59.0,48.0,00000
88.0,94.0,51.0,601,01,01,  Matikora,1135,1455,574,681,561,774,43.8,45.7,42.0,00000
88.0,94.0,51.0,601,02,01,  Kamar Para,74,29,45,12,29,17,71.8,78.9,63.0,00000
88.0,94.0,51.0,601,03,01,  Shahjahanpur,694,966,370,431,324,535,41.8,46.2,37.7,00000
88.0,94.0,51.0,601,04,01,  Bara Lakshmipur,410,646,199,322,211,324,38.8,38.2,39.4,00000
88.0,94.0,51.0,601,05,01,  Chhota Lakshmipur,128,298,62,135,66,163,30.0,31.5,28.8,00000
88.0,94.0,51.0,680,01,01,  Pancha Krushi,198,482,98,223,100,259,29.1,30.5,27.9,00000
88.0,94.0,51.0,680,02,01,  Pathar Para,144,462,74,221,70,241,23.8,25.1,22.5,00000
88.0,94.0,51.0,680,03,01,  Kazi Para,656,761,326,351,330,410,46.3,48.2,44.6,00000
88.0,94.0,51.0,786,01,01,  Satbaria,388,734,210,347,178,387,34.6,37.7,31.5,00000
88.0,94.0,51.0,786,02,01,  Char Satbaria,861,869,462,409,399,460,49.8,53.0,46.4,00000
88.0,94.0,51.0,798,01,01,  Raghab Baria,491,1031,250,471,241,560,32.3,34.7,30.1,00000
88.0,94.0,51.0,798,02,01,  Bhuiyan Para,90,283,58,130,32,153,24.1,30.9,17.3,00000
88.0,94.0,51.0,798,03,01,  Sadai,266,610,149,264,117,346,30.4,36.1,25.3,00000
88.0,94.0,58.0,351,01,01,  Faridpur,246,217,128,107,118,110,53.1,54.5,51.8,00000
88.0,94.0,58.0,351,02,01,  Hat Akannapur,176,176,92,92,84,84,50.0,50.0,50.0,00000
88.0,94.0,58.0,510,01,01,  Khamar Para,315,347,164,169,151,178,47.6,49.2,45.9,00000
88.0,94.0,58.0,510,02,01,  Harishpur,352,356,180,157,172,199,49.7,53.4,46.4,00000
88.0,94.0,58.0,510,03,01,  Ratandia,237,602,131,286,106,316,28.2,31.4,25.1,00000
88.0,94.0,58.0,537,01,01,  Khosalpur,331,512,182,247,149,265,39.3,42.4,36.0,00000
88.0,94.0,58.0,537,02,01,  Konaganti,256,376,143,174,113,202,40.5,45.1,35.9,00000
88.0,94.0,58.0,537,03,01,  Chak Rahim,100,101,61,40,39,61,49.8,60.4,39.0,00000
88.0,94.0,58.0,628,01,01,  Nagar Koyra,206,318,106,154,100,164,39.3,40.8,37.9,00000
88.0,94.0,58.0,628,02,01,  Char Para,963,658,524,315,439,343,59.4,62.5,56.1,00000
88.0,94.0,58.0,628,03,01,  Krishnapur,95,157,51,72,44,85,37.7,41.5,34.1,00000
88.0,94.0,58.0,692,01,01,  Parkul,551,650,288,301,263,349,45.9,48.9,43.0,00000
88.0,94.0,58.0,692,02,01,  Daha Para,393,825,229,395,164,430,32.3,36.7,27.6,00000
88.0,94.0,58.0,692,03,01,  Sreerampur,44,211,27,108,17,103,17.3,20.0,14.2,00000
88.0,94.0,58.0,790,01,01,  Purnimaganti,576,188,283,71,293,117,75.4,79.9,71.5,00000
88.0,94.0,58.0,790,02,01,  Hat Delua,552,744,266,361,286,383,42.6,42.4,42.8,00000
88.0,94.0,58.0,790,03,01,  Betuakani,412,442,222,224,190,218,48.2,49.8,46.6,00000
88.0,94.0,58.0,817,01,01,  Rakhalgachha,299,337,143,164,156,173,47.0,46.6,47.4,00000
88.0,94.0,58.0,817,02,01,  Manikdaha,206,430,110,219,96,211,32.4,33.4,31.3,00000
88.0,94.0,58.0,915,01,01,  Senganti,358,471,199,206,159,265,43.2,49.1,37.5,00000
88.0,94.0,58.0,915,02,01,  Araniarkandi,113,109,69,46,44,63,50.9,60.0,41.1,00000
88.0,94.0,58.0,915,03,01,  Bhagalgachhi,204,517,125,257,79,260,28.3,32.7,23.3,00000
88.0,94.0,58.0,915,04,01,  Jamalpur,100,165,57,84,43,81,37.7,40.4,34.7,00000
88.0,94.0,65.0,185,01,01,  Bhengri,515,735,266,350,249,385,41.2,43.2,39.3,00000
88.0,94.0,65.0,185,02,01,  Chak Baru,113,108,59,50,54,58,51.1,54.1,48.2,00000
88.0,94.0,65.0,208,01,01,  Chaitrahati,226,577,126,279,100,298,28.1,31.1,25.1,00000
88.0,94.0,65.0,208,02,01,  Chak Chaitrahati,57,120,33,59,24,61,32.2,35.9,28.2,00000
88.0,94.0,65.0,412,01,01,  Harinchhara,420,466,233,214,187,252,47.4,52.1,42.6,00000
88.0,94.0,65.0,412,02,01,  Char Harinchhara,267,272,151,117,116,155,49.5,56.3,42.8,00000
88.0,94.0,65.0,446,01,01,  Jalsuka,251,473,143,211,108,262,34.7,40.4,29.2,00000
88.0,94.0,65.0,446,02,01,  Pathan Para,162,473,102,221,60,252,25.5,31.6,19.2,00000
88.0,94.0,65.0,446,03,01,  Unukha,163,100,90,43,73,57,62.0,67.7,56.2,00000
88.0,94.0,65.0,522,01,01,  Khekshwar,307,335,175,156,132,179,47.8,52.9,42.4,00000
88.0,94.0,65.0,522,02,01,  Chak Sadi,100,135,71,77,29,58,42.6,48.0,33.3,00000
88.0,94.0,65.0,522,03,01,  Uttar Kalikpur,172,308,80,150,92,158,35.8,34.8,36.8,00000
88.0,94.0,65.0,522,04,01,  Mamrail,28,61,8,33,20,28,31.5,19.5,41.7,00000
88.0,94.0,65.0,590,01,01,  Bali Simla,106,220,57,113,49,107,32.5,33.5,31.4,00000
88.0,94.0,65.0,590,02,01,  Mamudpur,203,884,101,400,102,484,18.7,20.2,17.4,00000
88.0,94.0,65.0,639,01,01,  Nalua Dighi,74,149,30,78,44,71,33.2,27.8,38.3,00000
88.0,94.0,65.0,639,02,01,  Chak Nihal,247,532,122,252,125,280,31.7,32.6,30.9,00000
88.0,94.0,65.0,643,01,01,  Nanda Kusa,417,364,243,150,174,214,53.4,61.8,44.8,00000
88.0,94.0,65.0,643,02,01,  Serendajpur,109,238,60,114,49,124,31.4,34.5,28.3,00000
88.0,94.0,73.0,139,01,01,  Char Bera,313,489,181,205,132,284,39.0,46.9,31.7,00000
88.0,94.0,73.0,139,02,01,  Puran Bera,532,145,282,60,250,85,78.6,82.5,74.6,00000
88.0,94.0,73.0,257,01,01,  Uttarpara,444,820,217,372,227,448,35.1,36.8,33.6,00000
88.0,94.0,73.0,257,02,01,  Kashari Para,582,1073,316,493,266,580,35.2,39.1,31.4,00000
88.0,94.0,73.0,257,03,01,  Chak Para,157,466,82,196,75,270,25.2,29.5,21.7,00000
88.0,94.0,73.0,257,04,01,  Chak Chaubila Uttarpara,728,872,366,388,362,484,45.5,48.5,42.8,00000
88.0,94.0,73.0,257,05,01,  Chak Chaubila Dakshinpara,637,916,357,429,280,487,41.0,45.4,36.5,00000
88.0,94.0,73.0,393,01,01,  Bara Goja,789,1135,408,519,381,616,41.0,44.0,38.2,00000
88.0,94.0,73.0,393,02,01,  Char Goja,234,364,125,192,109,172,39.1,39.4,38.8,00000
88.0,94.0,73.0,393,03,01,  Diar Para,60,309,28,161,32,148,16.3,14.8,17.8,00000
88.0,94.0,73.0,393,04,01,  Chhota Goja,58,207,30,95,28,112,21.9,24.0,20.0,00000
88.0,94.0,73.0,442,01,01,  Jagjibanpur,613,841,332,381,281,460,42.2,46.6,37.9,00000
88.0,94.0,73.0,442,02,01,  Raninagar,321,348,179,165,142,183,48.0,52.0,43.7,00000
88.0,94.0,73.0,873,01,01,  Bawlatala,252,223,128,100,124,123,53.1,56.1,50.2,00000
88.0,94.0,73.0,873,02,01,  Kaukandi,60,70,34,32,26,38,46.2,51.5,40.6,00000
88.0,94.0,73.0,873,03,01,  Natun Para,344,406,171,176,173,230,45.9,49.3,42.9,00000
88.0,94.0,73.0,873,04,01,  Kismat Salanga,262,357,137,177,125,180,42.3,43.6,41.0,00000
88.0,94.0,73.0,873,05,01,  Kuthi Para,351,226,196,103,155,123,60.8,65.6,55.8,00000
88.0,94.0,80.0,408,01,01,  Haribhanga,255,299,139,148,116,151,46.0,48.4,43.4,00000
88.0,94.0,80.0,408,02,01,  Gopinathpur,487,307,287,138,200,169,61.3,67.5,54.2,00000
88.0,94.0,80.0,408,03,01,  Mohanpur,88,209,56,94,32,115,29.6,37.3,21.8,00000
88.0,94.0,80.0,465,01,01,  Habibganj,253,110,135,53,118,57,69.7,71.8,67.4,00000
88.0,94.0,80.0,465,02,01,  Jolahati,302,557,180,263,122,294,35.2,40.6,29.3,00000
88.0,94.0,80.0,499,01,01,  Kansona Goah Para,116,38,60,13,56,25,75.3,82.2,69.1,00000
88.0,94.0,80.0,499,02,01,  Kansona,350,157,174,61,176,96,69.0,74.0,64.7,00000
88.0,94.0,80.0,499,03,01,  Kashinatpur,380,349,192,159,188,190,52.1,54.7,49.7,00000
88.0,94.0,80.0,499,04,01,  Shak Para,326,129,159,56,167,73,71.6,74.0,69.6,00000
88.0,94.0,80.0,499,05,01,  Sonkerhat,79,29,41,18,38,11,73.1,69.5,77.6,00000
88.0,94.0,80.0,499,06,01,  Char Para,92,242,48,117,44,125,27.5,29.1,26.0,00000
88.0,94.0,80.0,635,01,01,  Nalsonda,1399,1288,739,563,660,725,52.1,56.8,47.7,00000
88.0,94.0,80.0,635,02,01,  Rajapur,215,747,127,366,88,381,22.3,25.8,18.8,00000
88.0,94.0,80.0,635,03,01,  Decree Char,179,36,99,18,80,18,83.3,84.6,81.6,00000
88.0,94.0,80.0,635,04,01,  Char Deceechar,351,355,187,171,164,184,49.7,52.2,47.1,00000
88.0,94.0,80.0,771,01,01,  Purba Lakshimkola,254,151,135,54,119,97,62.7,71.4,55.1,00000
88.0,94.0,80.0,771,02,01,  Charlakshimkola,198,103,119,47,79,56,65.8,71.7,58.5,00000
88.0,94.0,80.0,820,01,01,  Ramganti,218,113,108,39,110,74,65.9,73.5,59.8,00000
88.0,94.0,80.0,820,02,01,  Atbaki,143,215,68,102,75,113,39.9,40.0,39.9,00000
88.0,94.0,80.0,820,03,01,  Kalipur,276,137,135,55,141,82,66.8,71.1,63.2,00000
88.0,94.0,80.0,832,01,01,  Ramnagar,118,226,58,109,60,117,34.3,34.7,33.9,00000
88.0,94.0,80.0,832,02,01,  Pechtak,145,258,85,127,60,131,36.0,40.1,31.4,00000
88.0,94.0,80.0,832,03,01,  Bostanpur,235,370,126,160,109,210,38.8,44.1,34.2,00000
88.0,94.0,80.0,877,01,01,  Salap Char Para,117,278,65,134,52,144,29.6,32.7,26.5,00000
88.0,94.0,80.0,877,02,01,  Salpa,898,659,439,314,459,345,57.7,58.3,57.1,00000
88.0,94.0,80.0,892,01,01,  Santala,618,659,307,313,311,346,48.4,49.5,47.3,00000
88.0,94.0,80.0,892,02,01,  Natun Para Santala,214,491,125,250,89,241,30.4,33.3,27.0,00000
88.0,94.0,80.0,960,01,01,  Tarabaria,255,243,134,119,121,124,51.2,53.0,49.4,00000
88.0,94.0,80.0,960,02,01,  Bara Jumol,214,154,113,58,101,96,58.2,66.1,51.3,00000
88.0,94.0,80.0,960,03,01,  Char Tarabaria,491,736,293,321,198,415,40.0,47.7,32.3,00000
88.0,94.0,87.0,370,01,01,  Gareshwar,99,299,64,134,35,165,24.9,32.3,17.5,00000
88.0,94.0,87.0,370,02,01,  Teli Para,556,669,300,312,256,357,45.4,49.0,41.8,00000
88.0,94.0,87.0,495,01,01,  Kamal Marich,363,560,191,292,172,268,39.3,39.5,39.1,00000
88.0,94.0,87.0,495,02,01,  Chak Kamal Marich,153,234,74,108,79,126,39.5,40.7,38.5,00000
88.0,94.0,87.0,495,03,01,  Suberda Marich,331,708,179,319,152,389,31.9,35.9,28.1,00000
88.0,94.0,94.0,593,01,01,  Mandaljani,153,136,76,63,77,73,52.9,54.7,51.3,00000
88.0,94.0,94.0,593,02,01,  Bajrapur,487,413,273,183,214,230,54.1,59.9,48.2,00000
88.0,94.0,94.0,593,03,01,  Dari Para,420,341,228,139,192,202,55.2,62.1,48.7,00000
88.0,94.0,94.0,699,01,01,  Par Tentulia,409,625,220,291,189,334,39.6,43.1,36.1,00000
88.0,94.0,94.0,699,02,01,  Bhellabasree,167,368,87,182,80,186,31.2,32.3,30.1,00000
88.0,94.0,94.0,851,01,01,  Ratan Kawak,353,335,193,146,160,189,51.3,56.9,45.8,00000
88.0,94.0,94.0,851,02,01,  Chandpur,531,357,306,184,225,173,59.8,62.4,56.5,00000
81.0,10.0,22.0,073,01,01,  Teapukuria,647,772,308,386,339,386,45.6,44.4,46.8,00000
81.0,10.0,22.0,073,02,01,  Ahamadpur,371,750,200,355,171,395,33.1,36.0,30.2,00000
81.0,10.0,22.0,073,03,01,  Nouthika,596,546,296,257,300,289,52.2,53.5,50.9,00000
81.0,10.0,22.0,073,04,01,  Arifpur,257,551,133,270,124,281,31.8,33.0,30.6,00000
81.0,10.0,22.0,073,05,01,  Bara Khadia,168,211,95,109,73,102,44.3,46.6,41.7,00000
81.0,10.0,22.0,073,06,01,  Bajitpur,151,298,71,133,80,165,33.6,34.8,32.7,00000
81.0,12.0,20.0,027,01,01,  Auch Para,91,127,49,58,42,69,41.7,45.8,37.8,00000
81.0,12.0,20.0,027,02,01,  Sehali,127,126,66,59,61,67,50.2,52.8,47.7,00000
81.0,12.0,20.0,167,01,01,  Mirzapur,398,562,229,230,169,332,41.5,49.9,33.7,00000
81.0,12.0,20.0,167,02,01,  Khodapur,215,307,116,141,99,166,41.2,45.1,37.4,00000
81.0,12.0,20.0,482,01,01,  Kanaisar,371,468,222,199,149,269,44.2,52.7,35.6,00000
81.0,12.0,20.0,482,02,01,  Chak Jaladi,75,75,41,37,34,38,50.0,52.6,47.2,00000
81.0,12.0,20.0,482,03,01,  Saha Para,88,89,56,37,32,52,49.7,60.2,38.1,00000
81.0,12.0,20.0,523,01,01,  Khalgram,140,222,75,99,65,123,38.7,43.1,34.6,00000
81.0,12.0,20.0,523,02,01,  Naru Para,275,504,169,225,106,279,35.3,42.9,27.5,00000
81.0,12.0,20.0,523,03,01,  Achinpur,155,190,85,85,70,105,44.9,50.0,40.0,00000
81.0,12.0,20.0,567,01,01,  Bara Konda,757,736,431,324,326,412,50.7,57.1,44.2,00000
81.0,12.0,20.0,567,02,01,  Par Konda,198,157,111,63,87,94,55.8,63.8,48.1,00000
81.0,12.0,20.0,567,03,01,  Paschim Konda,237,299,143,126,94,173,44.2,53.2,35.2,00000
81.0,12.0,20.0,567,04,01,  Hari Ballabpur,113,123,64,53,49,70,47.9,54.7,41.2,00000
81.0,12.0,20.0,800,01,01,  Rakshit Para,498,766,278,362,220,404,39.4,43.4,35.3,00000
81.0,12.0,20.0,800,02,01,  Nalgaria,152,184,86,85,66,99,45.2,50.3,40.0,00000
81.0,12.0,20.0,800,03,01,  Hagla,151,246,87,124,64,122,38.0,41.2,34.4,00000
81.0,12.0,20.0,847,01,01,  Saidhara,327,499,188,224,139,275,39.6,45.6,33.6,00000
81.0,12.0,20.0,847,02,01,  Gandapur,116,129,71,53,45,76,47.3,57.3,37.2,00000
81.0,12.0,20.0,885,01,01,  Sarindi,360,621,218,298,142,323,36.7,42.2,30.5,00000
81.0,12.0,20.0,885,02,01,  Lesu Para,192,197,119,71,73,126,49.4,62.6,36.7,00000
81.0,12.0,20.0,885,03,01,  Bhasu Para,142,113,79,44,63,69,55.7,64.2,47.7,00000
81.0,12.0,20.0,957,01,01,  Takipur,529,443,294,188,235,255,54.4,61.0,48.0,00000
81.0,12.0,20.0,957,02,01,  Rampara,116,132,78,47,38,85,46.8,62.4,30.9,00000
81.0,12.0,20.0,957,03,01,  Narayan Para,187,370,106,173,81,197,33.6,38.0,29.1,00000
81.0,12.0,22.0,512,01,01,  Bara Kaya,220,437,139,189,81,248,33.5,42.4,24.6,00000
81.0,12.0,22.0,512,02,01,  Chhota Kaya,124,279,80,116,44,163,30.8,40.8,21.3,00000
81.0,12.0,22.0,909,01,01,  Khalishpur,147,121,74,50,73,71,54.9,59.7,50.7,00000
81.0,12.0,22.0,909,02,01,  Sindurlang,70,84,39,33,31,51,45.5,54.2,37.8,00000
81.0,12.0,24.0,047,01,01,  Balanagar,899,898,543,390,356,508,50.0,58.2,41.2,00000
81.0,12.0,24.0,047,02,01,  Madhbdanga,137,159,80,70,57,89,46.3,53.3,39.0,00000
81.0,12.0,24.0,283,01,01,  Deulia,951,1302,505,558,446,744,42.2,47.5,37.5,00000
81.0,12.0,24.0,283,02,01,  Krishnapur,319,231,167,102,152,129,58.0,62.1,54.1,00000
81.0,12.0,24.0,300,01,01,  Dipnagar,444,524,247,231,197,293,45.9,51.7,40.2,00000
81.0,12.0,24.0,300,02,01,  Sreedharpur,202,127,113,52,89,75,61.4,68.5,54.3,00000
81.0,12.0,24.0,711,01,01,  Bandigara,242,155,134,69,108,86,61.0,66.0,55.7,00000
81.0,12.0,24.0,711,02,01,  Danga Para,162,180,92,81,70,99,47.4,53.2,41.4,00000
81.0,12.0,31.0,536,01,01,  Khanpur,472,772,263,350,209,422,37.9,42.9,33.1,00000
81.0,12.0,31.0,536,02,01,  Khidri Khanpur,80,202,38,97,42,105,28.4,28.1,28.6,00000
81.0,12.0,31.0,707,01,01,  Nanur,430,689,238,305,192,384,38.4,43.8,33.3,00000
81.0,12.0,31.0,707,02,01,  Laubaria,386,855,237,381,149,474,31.1,38.3,23.9,00000
81.0,12.0,37.0,112,01,01,  Baje Goalkandi,84,218,41,113,43,105,27.8,26.6,29.1,00000
81.0,12.0,37.0,112,02,01,  Krishnapur,171,141,98,61,73,80,54.8,61.6,47.7,00000
81.0,12.0,37.0,239,01,01,  Cheukhali,950,1353,519,601,431,752,41.3,46.3,36.4,00000
81.0,12.0,37.0,239,02,01,  Kesabpur,10,12,6,4,4,8,45.5,60.0,33.3,00000
81.0,12.0,37.0,485,01,01,  Kana Para,654,604,350,259,304,345,52.0,57.5,46.8,00000
81.0,12.0,37.0,485,02,01,  Andir Para,55,44,34,16,21,28,55.6,68.0,42.9,00000
81.0,12.0,37.0,485,03,01,  Jamalpur,77,40,44,16,33,24,65.8,73.3,57.9,00000
81.0,12.0,37.0,485,04,01,  Dulali Para,150,138,86,50,64,88,52.1,63.2,42.1,00000
81.0,12.0,37.0,680,01,01,  Mohanpur,202,143,108,62,94,81,58.6,63.5,53.7,00000
81.0,12.0,37.0,680,02,01,  Nari Kalgachi,22,31,17,12,5,19,41.5,58.6,20.8,00000
81.0,12.0,37.0,680,03,01,  Racho Para,23,22,14,9,9,13,51.1,60.9,40.9,00000
81.0,12.0,37.0,865,01,01,  Samas Para,314,308,171,127,143,181,50.5,57.4,44.1,00000
81.0,12.0,37.0,865,02,01,  Arji Samas Para,128,341,71,150,57,191,27.3,32.1,23.0,00000
81.0,12.0,37.0,865,03,01,  Akdala Samas Para,182,305,110,132,72,173,37.4,45.5,29.4,00000
81.0,12.0,44.0,447,01,01,  Jiapara,158,228,95,100,63,128,40.9,48.7,33.0,00000
81.0,12.0,44.0,447,02,01,  Hariharpur,210,241,113,110,97,131,46.6,50.7,42.5,00000
81.0,12.0,44.0,492,01,01,  Karkhanda,174,267,96,122,78,145,39.5,44.0,35.0,00000
81.0,12.0,44.0,492,02,01,  Khajur,204,393,127,168,77,225,34.2,43.1,25.5,00000
81.0,12.0,50.0,253,01,01,  Dakshin Jamalpur,767,522,436,205,331,317,59.5,68.0,51.1,00000
81.0,12.0,50.0,253,02,01,  Khalispur,290,216,168,88,122,128,57.3,65.6,48.8,00000
81.0,12.0,50.0,519,01,01,  Kazihata,164,196,88,87,76,109,45.6,50.3,41.1,00000
81.0,12.0,50.0,519,02,01,  Bazekola,577,568,333,235,244,333,50.4,58.6,42.3,00000
81.0,12.0,50.0,618,01,01,  Mahabbatpur,409,588,221,273,188,315,41.0,44.7,37.4,00000
81.0,12.0,50.0,618,02,01,  Daki Para,217,255,126,112,91,143,46.0,52.9,38.9,00000
81.0,12.0,50.0,721,01,01,  Nemazgaon,175,201,109,79,66,122,46.5,58.0,35.1,00000
81.0,12.0,50.0,721,02,01,  Hasnabad,179,238,101,107,78,131,42.9,48.6,37.3,00000
81.0,12.0,56.0,564,01,01,  Konabaria,1333,1304,715,573,618,731,50.5,55.5,45.8,00000
81.0,12.0,56.0,564,02,01,  Talgharia,1072,1135,605,504,467,631,48.6,54.6,42.5,00000
81.0,12.0,69.0,188,01,01,  Bri-Kutsha,1104,1272,592,564,512,708,46.5,51.2,42.0,00000
81.0,12.0,69.0,188,02,01,  Gopinathpur,588,474,311,223,277,251,55.4,58.2,52.5,00000
81.0,12.0,72.0,465,01,01,  Kalikapur,783,526,470,186,313,340,59.8,71.6,47.9,00000
81.0,12.0,72.0,465,02,01,  Jangal Para,270,247,163,91,107,156,52.2,64.2,40.7,00000
81.0,12.0,72.0,608,01,01,  Madhupur,243,302,134,141,109,161,44.6,48.7,40.4,00000
81.0,12.0,72.0,608,02,01,  Mohanpur,728,1032,400,463,328,569,41.4,46.3,36.6,00000
81.0,12.0,75.0,013,01,01,  Annata Para,384,380,194,175,190,205,50.3,52.6,48.1,00000
81.0,12.0,75.0,013,02,01,  Bailasinga,226,166,122,66,104,100,57.7,64.9,51.0,00000
81.0,12.0,75.0,051,01,01,  Balia,256,437,139,203,117,234,36.9,40.6,33.3,00000
81.0,12.0,75.0,051,02,01,  Sadpara,243,125,132,60,111,65,66.0,68.8,63.1,00000
81.0,12.0,75.0,218,01,01,  Champakuri,124,269,78,124,46,145,31.6,38.6,24.1,00000
81.0,12.0,75.0,218,02,01,  Lalpur,62,109,35,51,27,58,36.3,40.7,31.8,00000
81.0,12.0,75.0,430,01,01,  Jatragachhi,186,186,103,86,83,100,50.0,54.5,45.4,00000
81.0,12.0,75.0,430,02,01,  Balida Para,241,136,144,57,97,79,63.9,71.6,55.1,00000
81.0,12.0,75.0,488,01,01,  Purba Kanthalbari,157,317,93,143,64,174,33.1,39.4,26.9,00000
81.0,12.0,75.0,488,02,01,  Paschim Kanthalbari,280,387,181,155,99,232,42.0,53.9,29.9,00000
81.0,12.0,75.0,509,01,01,  Baman Kaya,392,284,213,121,179,163,58.0,63.8,52.3,00000
81.0,12.0,75.0,509,02,01,  Bipra Kaya,184,141,109,56,75,85,56.6,66.1,46.9,00000
81.0,12.0,75.0,591,01,01,  Laru Para,167,391,84,186,83,205,29.9,31.1,28.8,00000
81.0,12.0,75.0,591,02,01,  Nimpara,230,141,125,54,105,87,62.0,69.8,54.7,00000
81.0,12.0,75.0,912,01,01,  Sitlai,214,280,114,121,100,159,43.3,48.5,38.6,00000
81.0,12.0,75.0,912,02,01,  Kala Para,125,112,70,47,55,65,52.7,59.8,45.8,00000
81.0,12.0,75.0,960,01,01,  Takta Para,294,274,173,106,121,168,51.8,62.0,41.9,00000
81.0,12.0,75.0,960,02,01,  Mamud Para,90,65,48,28,42,37,58.1,63.2,53.2,00000
81.0,12.0,75.0,960,03,01,  Toabari,52,42,30,18,22,24,55.3,62.5,47.8,00000
81.0,12.0,82.0,434,01,01,  Joypur(Part),98,203,63,91,35,112,32.6,40.9,23.8,00000
81.0,12.0,82.0,434,02,01,  Benipur,297,318,182,122,115,196,48.3,59.9,37.0,00000
81.0,12.0,88.0,417,01,01,  Ismailpur,264,305,146,147,118,158,46.4,49.8,42.8,00000
81.0,12.0,88.0,417,02,01,  Kazipur,221,271,116,128,105,143,44.9,47.5,42.3,00000
81.0,12.0,94.0,061,01,01,  Banaipur,938,703,489,306,449,397,57.2,61.5,53.1,00000
81.0,12.0,94.0,061,02,01,  Taldhara,95,151,58,65,37,86,38.6,47.2,30.1,00000
81.0,12.0,94.0,061,03,01,  Ladubari,29,82,17,43,12,39,26.1,28.3,23.5,00000
81.0,12.0,94.0,078,01,01,  Barigaon,976,958,582,383,394,575,50.5,60.3,40.7,00000
81.0,12.0,94.0,078,02,01,  Kowpara,59,171,36,78,23,93,25.7,31.6,19.8,00000
81.0,12.0,94.0,290,01,01,  Dhaminkaur,961,804,571,310,390,494,54.4,64.8,44.1,00000
81.0,12.0,94.0,290,02,01,  Tabaria,243,169,144,62,99,107,59.0,69.9,48.1,00000
81.0,12.0,94.0,714,01,01,  Narayan Para,225,111,123,49,102,62,67.0,71.5,62.2,00000
81.0,12.0,94.0,714,02,01,  Sankar Poi,305,239,171,94,134,145,56.1,64.5,48.0,00000
81.0,12.0,94.0,738,01,01,  Paik Para,357,261,205,104,152,157,57.8,66.3,49.2,00000
81.0,12.0,94.0,738,02,01,  Raghu Para,156,28,86,3,70,25,84.8,96.6,73.7,00000
49.7,37.5,81.0,022,16,998,Cantonment,1423,101,1169,42,254,59,93.4,96.5,81.2,00000
81.0,25.0,47.0,062,01,01,  Pasondia,384,465,196,216,188,249,45.2,47.6,43.0,00000
81.0,25.0,47.0,062,02,01,  Baduria,730,714,382,349,348,365,50.6,52.3,48.8,00000
81.0,25.0,47.0,172,01,01,  Chak Belgharia,1110,1180,575,567,535,613,48.5,50.4,46.6,00000
81.0,25.0,47.0,172,02,01,  Belgharia,548,758,286,369,262,389,42.0,43.7,40.2,00000
81.0,25.0,47.0,172,03,01,  Kakailkati,287,402,149,197,138,205,41.7,43.1,40.2,00000
81.0,25.0,47.0,172,04,01,  Mirkamari,327,490,162,236,165,254,40.0,40.7,39.4,00000
81.0,25.0,47.0,518,01,01,  Tangon (Part),856,1043,431,525,425,518,45.1,45.1,45.1,00000
81.0,25.0,47.0,518,02,01,  Sipai Para,700,565,373,260,327,305,55.3,58.9,51.7,00000
81.0,25.0,47.0,785,01,01,  Dalal Para,222,353,116,169,106,184,38.6,40.7,36.6,00000
81.0,25.0,47.0,785,02,01,  Naoda Para,316,531,171,254,145,277,37.3,40.2,34.4,00000
81.0,25.0,47.0,785,03,01,  Karalkati (Part),122,123,57,65,65,58,49.8,46.7,52.8,00000
81.0,25.0,47.0,911,01,01,  Sahapur,734,663,381,341,353,322,52.5,52.8,52.3,00000
81.0,25.0,47.0,911,02,01,  Tangon (Part),468,719,241,350,227,369,39.4,40.8,38.1,00000
81.0,25.0,47.0,911,03,01,  Belgharia (Part),809,1276,436,639,373,637,38.8,40.6,36.9,00000
81.0,25.0,47.0,911,04,01,  Karalkati (Part),144,87,76,46,68,41,62.3,62.3,62.4,00000
81.0,25.0,47.0,963,01,01,  Sreekhandi,408,684,195,342,213,342,37.4,36.3,38.4,00000
81.0,25.0,47.0,963,02,01,  Halidagachhi,78,114,40,56,38,58,40.6,41.7,39.6,00000
81.0,25.0,71.0,078,01,01,  Baladiar,896,1377,457,679,439,698,39.4,40.2,38.6,00000
81.0,25.0,71.0,078,02,01,  Omargari,426,392,230,166,196,226,52.1,58.1,46.4,00000
81.0,25.0,71.0,078,03,01,  Koydanga,222,224,115,108,107,116,49.8,51.6,48.0,00000
81.0,25.0,71.0,078,04,01,  Jagir Para,356,356,182,167,174,189,50.0,52.1,47.9,00000
81.0,25.0,71.0,146,01,01,  Barkatpur,466,710,230,334,236,376,39.6,40.8,38.6,00000
81.0,25.0,71.0,146,02,01,  Nandangachhi,189,321,96,168,93,153,37.1,36.4,37.8,00000
81.0,25.0,71.0,146,03,01,  Porabhita (Part),109,142,59,69,50,73,43.4,46.1,40.7,00000
81.0,25.0,71.0,151,01,01,  Basudebpur,518,399,282,194,236,205,56.5,59.2,53.5,00000
81.0,25.0,71.0,151,02,01,  Baghmari (Part),136,268,66,134,70,134,33.7,33.0,34.3,00000
81.0,25.0,71.0,157,01,01,  Basu Para,375,261,187,133,188,128,59.0,58.4,59.5,00000
81.0,25.0,71.0,157,02,01,  Fakira Para,767,446,387,198,380,248,63.2,66.2,60.5,00000
81.0,25.0,71.0,183,01,01,  Bhat Para,1313,1471,689,718,624,753,47.2,49.0,45.3,00000
81.0,25.0,71.0,183,02,01,  Jaubuna,270,512,150,258,120,254,34.5,36.8,32.1,00000
81.0,25.0,71.0,565,01,01,  Jot Kartik,425,422,227,211,198,211,50.2,51.8,48.4,00000
81.0,25.0,71.0,565,02,01,  Kalabi Para (Part),112,219,55,106,57,113,33.8,34.2,33.5,00000
81.0,25.0,71.0,565,03,01,  Baghmari (Part),38,36,18,16,20,20,51.4,52.9,50.0,00000
81.0,25.0,71.0,617,01,01,  Kaluhati,2083,2363,1045,1115,1038,1248,46.9,48.4,45.4,00000
81.0,25.0,71.0,617,02,01,  Ramchandpur (Part),312,554,169,270,143,284,36.0,38.5,33.5,00000
81.0,25.0,71.0,628,01,01,  Kamini Gangarampur,210,429,109,203,101,226,32.9,34.9,30.9,00000
81.0,25.0,71.0,628,02,01,  Kamini Kalabaria,536,279,275,130,261,149,65.8,67.9,63.7,00000
81.0,25.0,71.0,628,03,01,  Porabhita (Part),68,44,35,21,33,23,60.7,62.5,58.9,00000
81.0,25.0,71.0,801,01,01,  Nimpara,1470,1283,754,613,716,670,53.4,55.2,51.7,00000
81.0,25.0,71.0,801,02,01,  Kalabi Para,657,686,347,312,310,374,48.9,52.7,45.3,00000
81.0,25.0,71.0,801,03,01,  Bagmari (Part),45,117,19,56,26,61,27.8,25.3,29.9,00000
81.0,25.0,87.0,382,01,01,  Fatehpur,742,964,363,482,379,482,43.5,43.0,44.0,00000
81.0,25.0,87.0,382,02,01,  Balu Dear,641,1045,345,494,296,551,38.0,41.1,34.9,00000
81.0,25.0,87.0,471,01,01,  Haldigachhi,1663,2980,821,1474,842,1506,35.8,35.8,35.9,00000
81.0,25.0,87.0,471,02,01,  Absan,40,280,20,127,20,153,12.5,13.6,11.6,00000
81.0,25.0,87.0,523,01,01,  Jafarpur,528,810,277,384,251,426,39.5,41.9,37.1,00000
81.0,25.0,87.0,523,02,01,  Bathua,183,307,92,148,91,159,37.3,38.3,36.4,00000
81.0,25.0,87.0,738,01,01,  Maria,1069,1516,536,763,533,753,41.4,41.3,41.4,00000
81.0,25.0,87.0,738,02,01,  Kanajgari,227,373,132,177,95,196,37.8,42.7,32.6,00000
81.0,25.0,87.0,942,01,01,  Shibpur,830,1119,438,552,392,567,42.6,44.2,40.9,00000
81.0,25.0,87.0,942,02,01,  Kumra Badal,247,413,119,204,128,209,37.4,36.8,38.0,00000
81.0,31.0,23.0,322,01,01,  Gunagi Para,207,123,116,49,91,74,62.7,70.3,55.2,00000
81.0,31.0,23.0,322,02,01,  Andua,55,43,32,23,23,20,56.1,58.2,53.5,00000
81.0,31.0,23.0,322,03,01,  Teghar,67,61,28,30,39,31,52.3,48.3,55.7,00000
81.0,31.0,23.0,322,04,01,  Golabari,275,314,148,145,127,169,46.7,50.5,42.9,00000
81.0,31.0,47.0,427,01,01,  Joynagar,874,741,468,346,406,395,54.1,57.5,50.7,00000
81.0,31.0,47.0,427,02,01,  Kalantia,244,480,121,236,123,244,33.7,33.9,33.5,00000
81.0,31.0,47.0,427,03,01,  Durgadaha,498,523,259,235,239,288,48.8,52.4,45.4,00000
81.0,31.0,47.0,427,04,01,  Chak Joynagar,92,238,53,112,39,126,27.9,32.1,23.6,00000
81.0,31.0,47.0,733,01,01,  Narikelbaria,294,435,170,205,124,230,40.3,45.3,35.0,00000
81.0,31.0,47.0,733,02,01,  Nona Matial,469,380,254,157,215,223,55.2,61.8,49.1,00000
81.0,31.0,71.0,418,01,01,  Joykrishnapur (Part),1074,1105,577,514,497,591,49.3,52.9,45.7,00000
81.0,31.0,71.0,418,02,01,  Chak Krishanapur,218,227,106,127,112,100,49.0,45.5,52.8,00000
81.0,31.0,83.0,811,01,01,  Puran Tahirpur,1383,1359,756,607,627,752,50.4,55.5,45.5,00000
81.0,31.0,83.0,811,02,01,  Aliabad,548,526,289,260,259,266,51.0,52.6,49.3,00000
81.0,34.0,22.0,892,01,01,  Samaspur,175,274,85,148,90,126,39.0,36.5,41.7,00000
81.0,34.0,22.0,892,02,01,  Sahari Para,193,269,84,139,109,130,41.8,37.7,45.6,00000
81.0,34.0,25.0,045,01,01,  Bhuban Para,392,906,181,450,211,456,30.2,28.7,31.6,00000
81.0,34.0,25.0,045,02,01,  Ashariadaha Panipara,284,663,122,360,162,303,30.0,25.3,34.8,00000
81.0,34.0,25.0,045,03,01,  Ashariadaha(Natun Gram),862,1486,432,768,430,718,36.7,36.0,37.5,00000
81.0,34.0,25.0,045,04,01,  Kanapara(Uttar Kanapara),655,1636,313,885,342,751,28.6,26.1,31.3,00000
81.0,34.0,28.0,010,01,01,  Daing Para,110,85,63,34,47,51,56.4,64.9,48.0,00000
81.0,34.0,28.0,010,02,01,  Hatibanda,72,40,40,22,32,18,64.3,64.5,64.0,00000
81.0,34.0,28.0,010,03,01,  Kasari Para,166,141,90,66,76,75,54.1,57.7,50.3,00000
81.0,34.0,28.0,010,04,01,  Bilpara,61,70,34,27,27,43,46.6,55.7,38.6,00000
81.0,34.0,28.0,053,01,01,  Badalbarai Para,66,72,28,42,38,30,47.8,40.0,55.9,00000
81.0,34.0,28.0,053,02,01,  Kachia Para,219,330,95,169,124,161,39.9,36.0,43.5,00000
81.0,34.0,28.0,053,03,01,  Biana Bona,164,159,77,78,87,81,50.8,49.7,51.8,00000
81.0,34.0,28.0,053,04,01,  Daing Para,145,148,70,77,75,71,49.5,47.6,51.4,00000
81.0,34.0,28.0,053,05,01,  Kashem Sarkar Para,162,286,84,140,78,146,36.2,37.5,34.8,00000
81.0,34.0,28.0,053,06,01,  Kamir Para,103,163,54,85,49,78,38.7,38.8,38.6,00000
81.0,34.0,28.0,053,07,01,  Khorchaka,217,289,119,139,98,150,42.9,46.1,39.5,00000
81.0,34.0,28.0,053,08,01,  Nilbona,176,157,75,84,101,73,52.9,47.2,58.0,00000
81.0,34.0,28.0,163,01,01,  Bijoynagar,2031,1088,1058,542,973,546,65.1,66.1,64.1,00000
81.0,34.0,28.0,163,02,01,  Rashid Master Para,188,124,94,55,94,69,60.3,63.1,57.7,00000
81.0,34.0,28.0,198,01,01,  Gealmari,69,161,35,75,34,86,30.0,31.8,28.3,00000
81.0,34.0,28.0,198,02,01,  Brahman Pushkarni,152,97,88,39,64,58,61.0,69.3,52.5,00000
81.0,34.0,28.0,293,01,01,  Bardama,72,125,31,63,41,62,36.5,33.0,39.8,00000
81.0,34.0,28.0,293,02,01,  Bangla Kandar,396,375,190,182,206,193,51.4,51.1,51.6,00000
81.0,34.0,28.0,293,03,01,  Balpukur,118,75,56,34,62,41,61.1,62.2,60.2,00000
81.0,34.0,28.0,293,04,01,  Chak Para,115,133,59,69,56,64,46.4,46.1,46.7,00000
81.0,34.0,28.0,293,05,01,  Napit Para,54,107,33,56,21,51,33.5,37.1,29.2,00000
81.0,34.0,28.0,293,06,01,  Purakhali,213,130,116,62,97,68,62.1,65.2,58.8,00000
81.0,34.0,28.0,293,07,01,  Kakalbari,199,239,96,129,103,110,45.4,42.7,48.4,00000
81.0,34.0,28.0,293,08,01,  Deopara,288,278,147,142,141,136,50.9,50.9,50.9,00000
81.0,34.0,28.0,293,09,01,  Topsahar,98,88,48,41,50,47,52.7,53.9,51.5,00000
81.0,34.0,28.0,293,10,01,  Bhanka Para,106,116,49,58,57,58,47.7,45.8,49.6,00000
81.0,34.0,28.0,293,11,01,  Fakir Para(Kadamshahar),139,241,68,122,71,119,36.6,35.8,37.4,00000
81.0,34.0,28.0,293,12,01,  Jamdeha,292,473,179,300,113,173,38.2,37.4,39.5,00000
81.0,34.0,28.0,303,01,01,  Molkia Daing,225,159,119,73,106,86,58.6,62.0,55.2,00000
81.0,34.0,28.0,303,02,01,  Kazihata,305,205,152,98,153,107,59.8,60.8,58.8,00000
81.0,34.0,28.0,303,03,01,  Maligachha,289,234,155,128,134,106,55.3,54.8,55.8,00000
81.0,34.0,28.0,303,04,01,  Dharampur,558,216,291,93,267,123,72.1,75.8,68.5,00000
81.0,34.0,28.0,303,05,01,  Mathadanga,142,88,79,46,63,42,61.7,63.2,60.0,00000
81.0,34.0,28.0,303,06,01,  Sarkar Para,190,163,95,85,95,78,53.8,52.8,54.9,00000
81.0,34.0,28.0,352,01,01,  Udpara,87,101,41,53,46,48,46.3,43.6,48.9,00000
81.0,34.0,28.0,352,02,01,  Fulbari,666,295,351,146,315,149,69.3,70.6,67.9,00000
81.0,34.0,28.0,395,01,01,  Palashbari,79,84,46,42,33,42,48.5,52.3,44.0,00000
81.0,34.0,28.0,395,02,01,  Mathabhanga,105,159,64,74,41,85,39.8,46.4,32.5,00000
81.0,34.0,28.0,395,03,01,  Manganpur,111,176,50,104,61,72,38.7,32.5,45.9,00000
81.0,34.0,28.0,395,04,01,  Bangal Para,161,291,75,161,86,130,35.6,31.8,39.8,00000
81.0,34.0,28.0,395,05,01,  Golai,182,322,94,155,88,167,36.1,37.8,34.5,00000
81.0,34.0,28.0,581,01,01,  Nimtala,502,496,231,255,271,241,50.3,47.5,52.9,00000
81.0,34.0,28.0,581,02,01,  Chak Para,154,158,72,82,82,76,49.4,46.8,51.9,00000
81.0,34.0,28.0,581,03,01,  Mollah Para,528,419,258,227,270,192,55.8,53.2,58.4,00000
81.0,34.0,28.0,747,01,01,  Forsa Para,216,255,117,119,99,136,45.9,49.6,42.1,00000
81.0,34.0,28.0,747,02,01,  Sahana Para,284,173,153,82,131,91,62.1,65.1,59.0,00000
81.0,34.0,28.0,747,03,01,  Baldanga,71,184,42,91,29,93,27.8,31.6,23.8,00000
81.0,34.0,28.0,747,04,01,  Jogidaing,29,41,18,20,11,21,41.4,47.4,34.4,00000
81.0,34.0,28.0,785,01,01,  Palpur,724,665,362,339,362,326,52.1,51.6,52.6,00000
81.0,34.0,28.0,785,02,01,  Jogidaing,98,209,53,111,45,98,31.9,32.3,31.5,00000
81.0,34.0,28.0,808,01,01,  Borsapara,71,115,46,52,25,63,38.2,46.9,28.4,00000
81.0,34.0,28.0,808,02,01,  Nimgutu,50,124,26,51,24,73,28.7,33.8,24.7,00000
81.0,34.0,28.0,808,03,01,  Dahor Langi,63,89,42,41,21,48,41.4,50.6,30.4,00000
81.0,34.0,28.0,808,04,01,  Gonekar Daing,125,204,61,104,64,100,38.0,37.0,39.0,00000
81.0,34.0,28.0,808,05,01,  Nabi Bottala,288,169,151,73,137,96,63.0,67.4,58.8,00000
81.0,34.0,47.0,538,01,01,  Usra Kandar,439,233,225,121,214,112,65.3,65.0,65.6,00000
81.0,34.0,47.0,538,02,01,  Gogram Hatpara,404,253,207,121,197,132,61.5,63.1,59.9,00000
81.0,34.0,47.0,852,01,01,  Raninagar,418,462,217,210,201,252,47.5,50.8,44.4,00000
81.0,34.0,47.0,852,02,01,  Lala Dighi,118,259,69,124,49,135,31.3,35.8,26.6,00000
81.0,34.0,47.0,977,01,01,  Tera Para,191,356,98,181,93,175,34.9,35.1,34.7,00000
81.0,34.0,47.0,977,02,01,  Bottali,297,237,169,101,128,136,55.6,62.6,48.5,00000
81.0,34.0,57.0,104,01,01,  Basantapur,183,187,99,99,84,88,49.5,50.0,48.8,00000
81.0,34.0,57.0,104,02,01,  Chauduar,62,378,34,170,28,208,14.1,16.7,11.9,00000
81.0,34.0,85.0,028,01,01,  Alokchhatra Namo Para,107,65,62,19,45,46,62.2,76.5,49.5,00000
81.0,34.0,85.0,028,02,01,  Alokchhatra Mridha Daing,149,139,75,61,74,78,51.7,55.1,48.7,00000
81.0,34.0,85.0,028,03,01,  Alokchhatra Upar Para,202,289,115,128,87,161,41.1,47.3,35.1,00000
81.0,34.0,85.0,058,01,01,  Bilasi Musalman Para,197,208,96,105,101,103,48.6,47.8,49.5,00000
81.0,34.0,85.0,058,02,01,  Bilasi Sawtal Para,69,64,44,30,25,34,51.9,59.5,42.4,00000
81.0,34.0,85.0,079,01,01,  Bamahaln Patia Pukur,149,163,101,64,48,99,47.8,61.2,32.7,00000
81.0,34.0,85.0,079,02,01,  Bamahaln Amtali Para,203,412,102,199,101,213,33.0,33.9,32.2,00000
81.0,34.0,85.0,079,03,01,  Bamahaln,1073,1167,507,609,566,558,47.9,45.4,50.4,00000
81.0,34.0,85.0,227,01,01,  Chabbishnagar (Haji Para),222,351,92,189,130,162,38.7,32.7,44.5,00000
81.0,34.0,85.0,227,02,01,  Daing Para,273,351,129,191,144,160,43.8,40.3,47.4,00000
81.0,34.0,85.0,227,03,01,  Fultala,27,21,14,10,13,11,56.3,58.3,54.2,00000
81.0,34.0,85.0,227,04,01,  Dakshinpara,443,288,202,141,241,147,60.6,58.9,62.1,00000
81.0,34.0,85.0,227,05,01,  Sola Para,181,136,77,81,104,55,57.1,48.7,65.4,00000
81.0,34.0,85.0,227,06,01,  Chhayghai,47,211,25,89,22,122,18.2,21.9,15.3,00000
81.0,34.0,85.0,227,07,01,  Fulbari,41,58,22,27,19,31,41.4,44.9,38.0,00000
81.0,34.0,85.0,507,01,01,  Kadma,168,104,83,44,85,60,61.8,65.4,58.6,00000
81.0,34.0,85.0,507,02,01,  Muralipur,30,92,12,47,18,45,24.6,20.3,28.6,00000
81.0,34.0,85.0,507,03,01,  Fulbari,84,141,46,65,38,76,37.3,41.4,33.3,00000
81.0,34.0,85.0,551,01,01,  Kadapukur,63,155,32,68,31,87,28.9,32.0,26.3,00000
81.0,34.0,85.0,551,02,01,  Chhota Kashia,143,174,69,87,74,87,45.1,44.2,46.0,00000
81.0,34.0,85.0,551,03,01,  Bara Kashia,322,395,149,195,173,200,44.9,43.3,46.4,00000
81.0,34.0,85.0,821,01,01,  Hindu Para,82,114,43,50,39,64,41.8,46.2,37.9,00000
81.0,34.0,85.0,821,02,01,  Dakshinpara,87,152,42,72,45,80,36.4,36.8,36.0,00000
81.0,34.0,85.0,821,03,01,  Uttarpara,267,266,143,119,124,147,50.1,54.6,45.8,00000
81.0,34.0,85.0,864,01,01,  Bajna Para,112,40,65,16,47,24,73.7,80.2,66.2,00000
81.0,34.0,85.0,864,02,01,  School Para,362,534,185,246,177,288,40.4,42.9,38.1,00000
81.0,34.0,85.0,864,03,01,  Nich Para,352,205,178,85,174,120,63.2,67.7,59.2,00000
81.0,34.0,85.0,882,01,01,  Shahapur,208,401,107,199,101,202,34.2,35.0,33.3,00000
81.0,34.0,85.0,882,02,01,  Babupur,141,276,74,130,67,146,33.8,36.3,31.5,00000
81.0,34.0,85.0,882,03,01,  Daingpara,217,178,103,89,114,89,54.9,53.6,56.2,00000
81.0,34.0,85.0,966,01,01,  Kundulia Para,365,505,172,262,193,243,42.0,39.6,44.3,00000
81.0,34.0,85.0,966,02,01,  Shatni Para,265,485,135,246,130,239,35.3,35.4,35.2,00000
81.0,34.0,85.0,966,03,01,  Ramnagar,130,238,63,125,67,113,35.3,33.5,37.2,00000
81.0,53.0,54.0,333,01,01,  Dhorsa,958,922,507,420,451,502,51.0,54.7,47.3,00000
81.0,53.0,54.0,333,02,01,  Kotani Para,735,556,391,259,344,297,56.9,60.2,53.7,00000
81.0,72.0,27.0,016,01,01,  Amgachhi,447,408,246,185,201,223,52.3,57.1,47.4,00000
81.0,72.0,27.0,016,02,01,  Betkuri,134,98,75,44,59,54,57.8,63.0,52.2,00000
81.0,72.0,27.0,016,03,01,  Khanda Khatra,75,114,38,63,37,51,39.7,37.6,42.0,00000
81.0,72.0,27.0,132,01,01,  Bhabanipur,518,1113,245,551,273,562,31.8,30.8,32.7,00000
81.0,72.0,27.0,132,02,01,  Bara Balam,384,543,230,234,154,309,41.4,49.6,33.3,00000
81.0,72.0,27.0,256,01,01,  Dadpur,1591,1682,806,824,785,858,48.6,49.4,47.8,00000
81.0,72.0,27.0,256,02,01,  Bagicha Para,116,186,59,90,57,96,38.4,39.6,37.3,00000
81.0,72.0,27.0,414,01,01,  Joykrishnapur,462,511,248,242,214,269,47.5,50.6,44.3,00000
81.0,72.0,27.0,414,02,01,  Sonadanga,179,308,88,152,91,156,36.8,36.7,36.8,00000
81.0,72.0,27.0,434,01,01,  Jot Kandore,109,148,51,70,58,78,42.4,42.1,42.6,00000
81.0,72.0,27.0,434,02,01,  Chhota Amgachhi,303,316,166,154,137,162,48.9,51.9,45.8,00000
81.0,72.0,27.0,594,01,01,  Madhai Para,495,450,293,233,202,217,52.4,55.7,48.2,00000
81.0,72.0,27.0,594,02,01,  Kalu Para,657,401,362,178,295,223,62.1,67.0,56.9,00000
81.0,72.0,27.0,634,01,01,  Mathura,424,791,207,379,217,412,34.9,35.3,34.5,00000
81.0,72.0,27.0,634,02,01,  Naoda Para,117,78,63,28,54,50,60.0,69.2,51.9,00000
81.0,72.0,35.0,439,01,01,  Kadirpur,519,538,273,269,246,269,49.1,50.4,47.8,00000
81.0,72.0,35.0,439,02,01,  Tikor,397,545,202,273,195,272,42.1,42.5,41.8,00000
81.0,72.0,35.0,439,03,01,  Tikor Desla Para,150,248,74,132,76,116,37.7,35.9,39.6,00000
81.0,72.0,35.0,599,01,01,  Bendarampur,568,355,283,177,285,178,61.5,61.5,61.6,00000
81.0,72.0,35.0,599,02,01,  Madhupur,675,953,336,465,339,488,41.5,41.9,41.0,00000
81.0,72.0,35.0,599,03,01,  Moraripur,1204,896,640,444,564,452,57.3,59.0,55.5,00000
81.0,72.0,35.0,599,04,01,  Bhabki Madhupur,186,201,88,101,98,100,48.1,46.6,49.5,00000
81.0,72.0,35.0,599,05,01,  Jot Raban,435,527,213,278,222,249,45.2,43.4,47.1,00000
81.0,72.0,35.0,599,06,01,  Damkura,68,38,33,15,35,23,64.2,68.8,60.3,00000
81.0,72.0,35.0,869,01,01,  Sitlai,692,992,331,494,361,498,41.1,40.1,42.0,00000
81.0,72.0,35.0,869,02,01,  Gobindapur,306,332,158,179,148,153,48.0,46.9,49.2,00000
81.0,72.0,43.0,040,01,01,  Baghsail,137,226,64,116,73,110,37.7,35.6,39.9,00000
81.0,72.0,43.0,040,02,01,  Chandpur,97,109,46,51,51,58,47.1,47.4,46.8,00000
81.0,72.0,43.0,040,03,01,  Madhyapara,115,315,47,152,68,163,26.7,23.6,29.4,00000
81.0,72.0,43.0,040,04,01,  Purbapara,182,284,76,164,106,120,39.1,31.7,46.9,00000
81.0,72.0,43.0,096,01,01,  Barai Para,97,260,41,123,56,137,27.2,25.0,29.0,00000
81.0,72.0,43.0,096,02,01,  Shisha Para,61,131,30,64,31,67,31.8,31.9,31.6,00000
81.0,72.0,43.0,096,03,01,  Funanpur,31,52,17,23,14,29,37.3,42.5,32.6,00000
81.0,72.0,43.0,764,01,01,  Prasad Para,134,72,71,32,63,40,65.0,68.9,61.2,00000
81.0,72.0,43.0,764,02,01,  Shisha Para,35,24,15,11,20,13,59.3,57.7,60.6,00000
81.0,72.0,43.0,943,01,01,  Tentulia Danga,391,260,202,117,189,143,60.1,63.3,56.9,00000
81.0,72.0,43.0,943,02,01,  Nagar Para,183,137,93,69,90,68,57.2,57.4,57.0,00000
81.0,72.0,43.0,943,03,01,  Damdama,78,205,32,103,46,102,27.6,23.7,31.1,00000
81.0,72.0,51.0,064,01,01,  Balia,427,410,226,223,201,187,51.0,50.3,51.8,00000
81.0,72.0,51.0,064,02,01,  Balia Chai Para,695,742,344,380,351,362,48.4,47.5,49.2,00000
81.0,72.0,51.0,064,03,01,  Pacha Balia,297,333,163,163,134,170,47.1,50.0,44.1,00000
81.0,72.0,51.0,064,04,01,  Balia Kasiadanga,321,286,162,164,159,122,52.9,49.7,56.6,00000
81.0,72.0,51.0,104,01,01,  Basua,2001,1574,995,775,1006,799,56.0,56.2,55.7,00000
81.0,72.0,51.0,104,02,01,  Das Pukur,1492,1025,734,486,758,539,59.3,60.2,58.4,00000
81.0,72.0,51.0,429,01,01,  Jhujkai,281,814,144,407,137,407,25.7,26.1,25.2,00000
81.0,72.0,51.0,429,02,01,  Pakuria,129,358,74,180,55,178,26.5,29.1,23.6,00000
81.0,72.0,51.0,499,01,01,  Kashiadanga,584,375,293,193,291,182,60.9,60.3,61.5,00000
81.0,72.0,51.0,499,02,01,  Ferta Para,503,395,270,201,233,194,56.0,57.3,54.6,00000
81.0,72.0,51.0,499,03,01,  Adharia Chithalkul,330,388,177,198,153,190,46.0,47.2,44.6,00000
81.0,72.0,51.0,499,04,01,  Adharia Para,307,229,158,101,149,128,57.3,61.0,53.8,00000
81.0,72.0,51.0,499,05,01,  Guchchhagram,316,265,161,134,155,131,54.4,54.6,54.2,00000
81.0,72.0,51.0,534,01,01,  Nutan Khirshan Para,509,359,261,212,248,147,58.6,55.2,62.8,00000
81.0,72.0,51.0,534,02,01,  Khirshan Tika Para,476,786,237,425,239,361,37.7,35.8,39.8,00000
81.0,72.0,51.0,534,03,01,  Puratan Khirshan Para,315,241,160,117,155,124,56.7,57.8,55.6,00000
81.0,72.0,51.0,534,04,01,  Khirshan Fakir Para,157,230,82,119,75,111,40.6,40.8,40.3,00000
81.0,72.0,54.0,404,01,01,  Jagir Kazir Para,161,147,101,61,60,86,52.3,62.3,41.1,00000
81.0,72.0,54.0,404,02,01,  Jagir,530,504,304,233,226,271,51.3,56.6,45.5,00000
81.0,72.0,61.0,349,01,01,  Alimganj,352,445,182,226,170,219,44.2,44.6,43.7,00000
81.0,72.0,61.0,349,02,01,  Haldibuna,246,199,128,113,118,86,55.3,53.1,57.8,00000
81.0,72.0,61.0,349,03,01,  Gopalpur,125,200,64,94,61,106,38.5,40.5,36.5,00000
81.0,72.0,61.0,349,04,01,  Tangramari,313,174,165,86,148,88,64.3,65.7,62.7,00000
81.0,72.0,61.0,374,01,01,  Sonaikandi,1231,1007,590,522,641,485,55.0,53.1,56.9,00000
81.0,72.0,61.0,374,02,01,  Jangal Para,374,251,198,131,176,120,59.8,60.2,59.5,00000
81.0,72.0,61.0,374,03,01,  Berpara,910,993,473,488,437,505,47.8,49.2,46.4,00000
81.0,72.0,61.0,374,04,01,  Dargah Para,250,229,136,109,114,120,52.2,55.5,48.7,00000
81.0,72.0,61.0,374,05,01,  Dabir Mollah Para,291,219,146,120,145,99,57.1,54.9,59.4,00000
81.0,72.0,61.0,374,06,01,  Banpara,438,358,221,180,217,178,55.0,55.1,54.9,00000
81.0,72.0,61.0,374,07,01,  Haripur,1277,709,640,350,637,359,64.3,64.6,64.0,00000
81.0,72.0,61.0,494,01,01,  Nutan Kasba,565,293,295,138,270,155,65.9,68.1,63.5,00000
81.0,72.0,61.0,494,02,01,  Kasba,207,236,111,111,96,125,46.7,50.0,43.4,00000
81.0,72.0,61.0,494,03,01,  Khulabona,764,407,382,212,382,195,65.2,64.3,66.2,00000
81.0,72.0,61.0,494,04,01,  Andarkuti,251,207,127,97,124,110,54.8,56.7,53.0,00000
81.0,72.0,65.0,394,01,01,  Huzuri Para,512,619,254,300,258,319,45.3,45.8,44.7,00000
81.0,72.0,65.0,394,02,01,  Bajitpur,330,566,152,286,178,280,36.8,34.7,38.9,00000
81.0,72.0,65.0,394,03,01,  Sardar Para,169,253,74,136,95,117,40.0,35.2,44.8,00000
81.0,72.0,65.0,489,01,01,  Kornahar,499,640,242,324,257,316,43.8,42.8,44.9,00000
81.0,72.0,65.0,489,02,01,  Guchchhagram,38,192,16,100,22,92,16.5,13.8,19.3,00000
81.0,72.0,65.0,719,01,01,  Nepal Para,458,544,255,262,203,282,45.7,49.3,41.9,00000
81.0,72.0,65.0,719,02,01,  Arai Para,219,395,120,189,99,206,35.7,38.8,32.5,00000
81.0,72.0,65.0,719,03,01,  Deber Para,133,133,70,59,63,74,50.0,54.3,46.0,00000
81.0,72.0,65.0,784,01,01,  Shisha Para,305,509,166,252,139,257,37.5,39.7,35.1,00000
81.0,72.0,65.0,784,02,01,  Radhanagar,466,483,241,251,225,232,49.1,49.0,49.2,00000
81.0,72.0,65.0,784,03,01,  Guda Para,261,353,124,175,137,178,42.5,41.5,43.5,00000
81.0,72.0,65.0,784,04,01,  Bezora Para,494,536,246,274,248,262,48.0,47.3,48.6,00000
81.0,72.0,65.0,814,01,01,  Daingar Hat,357,306,177,160,180,146,53.8,52.5,55.2,00000
81.0,72.0,65.0,814,02,01,  Deber Para,189,301,90,160,99,141,38.6,36.0,41.3,00000
81.0,72.0,65.0,814,03,01,  Shahapur,661,478,344,234,317,244,58.0,59.5,56.5,00000
81.0,72.0,65.0,814,04,01,  Shair Pukur,344,588,170,301,174,287,36.9,36.1,37.7,00000
81.0,72.0,65.0,839,01,01,  Paschimpara,228,393,119,193,109,200,36.7,38.1,35.3,00000
81.0,72.0,65.0,839,02,01,  Dighi Para,192,143,93,70,99,73,57.3,57.1,57.6,00000
81.0,72.0,65.0,839,03,01,  Hatpara,174,57,92,27,82,30,75.3,77.3,73.2,00000
81.0,72.0,65.0,839,04,01,  Kayakuri Para,17,25,11,14,6,11,40.5,44.0,35.3,00000
81.0,72.0,65.0,839,05,01,  Salguli Para,156,198,82,95,74,103,44.1,46.3,41.8,00000
81.0,72.0,65.0,839,06,01,  Sarishakuri,177,250,93,123,84,127,41.5,43.1,39.8,00000
81.0,72.0,87.0,060,01,01,  Balanagar,318,355,154,165,164,190,47.3,48.3,46.3,00000
81.0,72.0,87.0,060,02,01,  Kalachika,221,223,114,115,107,108,49.8,49.8,49.8,00000
81.0,72.0,87.0,188,01,01,  Chak Parila,258,516,134,259,124,257,33.3,34.1,32.5,00000
81.0,72.0,87.0,188,02,01,  Kansonda Parila,222,247,114,119,108,128,47.3,48.9,45.8,00000
81.0,72.0,87.0,188,03,01,  Kamar Parila,192,124,104,55,88,69,60.8,65.4,56.1,00000
81.0,72.0,87.0,304,01,01,  Durga Para,202,177,104,95,98,82,53.3,52.3,54.4,00000
81.0,72.0,87.0,304,02,01,  Mollah Para,75,74,35,38,40,36,50.3,47.9,52.6,00000
81.0,72.0,87.0,304,03,01,  Shafadanga,146,103,80,53,66,50,58.6,60.2,56.9,00000
81.0,72.0,87.0,794,01,01,  Ramchandrapur,395,487,226,231,169,256,44.8,49.5,39.8,00000
81.0,72.0,87.0,794,02,01,  Dangair Para,134,376,60,188,74,188,26.3,24.2,28.2,00000
81.0,72.0,87.0,864,01,01,  Siralia,370,470,205,209,165,261,44.0,49.5,38.7,00000
81.0,72.0,87.0,864,02,01,  Godagari,108,77,61,36,47,41,58.4,62.9,53.4,00000
81.0,72.0,87.0,929,01,01,  Taraf Parila,512,865,276,418,236,447,37.2,39.8,34.6,00000
81.0,72.0,87.0,929,02,01,  Dighir Parila,432,466,261,209,171,257,48.1,55.5,40.0,00000
81.0,72.0,87.0,929,03,01,  Nagar Parila,17,110,8,56,9,54,13.4,12.5,14.3,00000
81.0,82.0,13.0,132,01,01,  Behari Para,258,391,129,210,129,181,39.8,38.1,41.6,00000
81.0,82.0,13.0,132,02,01,  Raghurampur,765,809,382,407,383,402,48.6,48.4,48.8,00000
81.0,82.0,13.0,132,03,01,  Shibpur,737,406,387,204,350,202,64.5,65.5,63.4,00000
81.0,82.0,13.0,349,01,01,  Dighalkandi,1157,1358,602,680,555,678,46.0,47.0,45.0,00000
81.0,82.0,13.0,349,02,01,  Chital Pukuria,177,377,83,205,94,172,31.9,28.8,35.3,00000
81.0,82.0,13.0,373,01,01,  Nowada Para,153,232,84,105,69,127,39.7,44.4,35.2,00000
81.0,82.0,13.0,373,02,01,  Palashbari,499,429,287,193,212,236,53.8,59.8,47.3,00000
81.0,82.0,13.0,373,03,01,  Bhuban Nagar,44,63,25,31,19,32,41.1,44.6,37.3,00000
81.0,82.0,13.0,373,04,01,  Sahbajpur,594,271,318,112,276,159,68.7,74.0,63.4,00000
81.0,82.0,13.0,373,05,01,  Par Sahbajpur,197,293,111,142,86,151,40.2,43.9,36.3,00000
81.0,82.0,13.0,544,01,01,  Jaram Danga,378,294,200,136,178,158,56.3,59.5,53.0,00000
81.0,82.0,13.0,544,02,01,  Bhuban Nagar (Part),111,227,62,120,49,107,32.8,34.1,31.4,00000
81.0,82.0,13.0,862,01,01,  Chhandabari(Part-2),232,104,114,56,118,48,69.0,67.1,71.1,00000
81.0,82.0,13.0,862,02,01,  Dholat Kamarpur(Part-2),88,461,57,240,31,221,16.0,19.2,12.3,00000
81.0,82.0,13.0,862,03,01,  Khuti Para,1432,1337,763,650,669,687,51.7,54.0,49.3,00000
81.0,82.0,13.0,862,04,01,  Jagir Para,519,398,282,194,237,204,56.6,59.2,53.7,00000
81.0,82.0,13.0,862,05,01,  Baliaghati,941,1011,491,505,450,506,48.2,49.3,47.1,00000
81.0,82.0,27.0,062,01,01,  Banis Pukuria,877,1072,471,525,406,547,45.0,47.3,42.6,00000
81.0,82.0,27.0,062,02,01,  Sibpur Natunpara,63,86,33,45,30,41,42.3,42.3,42.3,00000
81.0,82.0,27.0,139,01,01,  Belpukuria,594,555,325,251,269,304,51.7,56.4,46.9,00000
81.0,82.0,27.0,139,02,01,  Jot Bhagirothpur,453,438,246,207,207,231,50.8,54.3,47.3,00000
81.0,82.0,27.0,326,01,01,  Dhadas,804,929,457,452,347,477,46.4,50.3,42.1,00000
81.0,82.0,27.0,326,02,01,  Kamardhadas,396,446,226,216,170,230,47.0,51.1,42.5,00000
81.0,82.0,27.0,489,01,01,  Agla,669,701,351,354,318,347,48.8,49.8,47.8,00000
81.0,82.0,27.0,489,02,01,  Baduria,78,25,42,8,36,17,75.7,84.0,67.9,00000
81.0,82.0,27.0,489,03,01,  Chak Jamira,433,561,225,300,208,261,43.6,42.9,44.3,00000
81.0,82.0,27.0,489,04,01,  Dakshin Jamira,602,753,303,365,299,388,44.4,45.4,43.5,00000
81.0,82.0,27.0,489,05,01,  Durlabhpur,271,717,151,356,120,361,27.4,29.8,24.9,00000
81.0,82.0,27.0,489,06,01,  Halidagachhi,30,16,19,6,11,10,65.2,76.0,52.4,00000
81.0,82.0,27.0,489,07,01,  Joypur,130,162,63,83,67,79,44.5,43.2,45.9,00000
81.0,82.0,27.0,489,08,01,  Khudra Jamira,574,628,311,311,263,317,47.8,50.0,45.3,00000
81.0,82.0,27.0,489,09,01,  Kismat Jamira,447,534,247,263,200,271,45.6,48.4,42.5,00000
81.0,82.0,27.0,489,10,01,  Mollah Jamira,382,99,226,40,156,59,79.4,85.0,72.6,00000
81.0,82.0,27.0,489,11,01,  Madhya Jamira,594,197,327,79,267,118,75.1,80.5,69.4,00000
81.0,82.0,27.0,489,12,01,  Paschim Jamira,409,261,219,124,190,137,61.0,63.8,58.1,00000
81.0,82.0,27.0,489,13,01,  Belpukur Jamira,214,256,113,123,101,133,45.5,47.9,43.2,00000
81.0,82.0,27.0,855,01,01,  Satragachha,558,504,316,247,242,257,52.5,56.1,48.5,00000
81.0,82.0,27.0,855,02,01,  Chhandabari(Part-1),116,194,63,101,53,93,37.4,38.4,36.3,00000
81.0,82.0,27.0,855,03,01,  Dholat Kamarpur(Part-1),106,252,49,137,57,115,29.6,26.3,33.1,00000
81.0,82.0,40.0,120,01,01,  Huzuri Para,356,512,179,265,177,247,41.0,40.3,41.7,00000
81.0,82.0,40.0,120,02,01,  Khamar Para,563,582,306,293,257,289,49.2,51.1,47.1,00000
81.0,82.0,40.0,120,03,01,  Majh Para,361,393,197,193,164,200,47.9,50.5,45.1,00000
81.0,82.0,40.0,120,04,01,  Chak Para,296,311,152,146,144,165,48.8,51.0,46.6,00000
81.0,82.0,40.0,120,05,01,  Napit Para,166,130,84,59,82,71,56.1,58.7,53.6,00000
81.0,82.0,40.0,120,06,01,  Sardar Para,313,331,171,168,142,163,48.6,50.4,46.6,00000
81.0,82.0,40.0,120,07,01,  Mandal Para,209,239,110,119,99,120,46.7,48.0,45.2,00000
81.0,82.0,40.0,120,08,01,  Kona Para,152,259,81,135,71,124,37.0,37.5,36.4,00000
81.0,82.0,40.0,120,09,01,  Pasani Para,219,255,115,130,104,125,46.2,46.9,45.4,00000
81.0,82.0,40.0,120,10,01,  Nowda Para,271,290,135,143,136,147,48.3,48.6,48.1,00000
81.0,82.0,40.0,120,11,01,  Mridha Para,93,169,44,81,49,88,35.5,35.2,35.8,00000
81.0,82.0,40.0,120,12,01,  Nutan Para,83,124,43,54,40,70,40.1,44.3,36.4,00000
81.0,82.0,40.0,120,13,01,  Hatpara,84,139,38,66,46,73,37.7,36.5,38.7,00000
81.0,82.0,40.0,699,01,01,  Uttarpara,152,191,89,92,63,99,44.3,49.2,38.9,00000
81.0,82.0,40.0,699,02,01,  Noapara,359,523,170,280,189,243,40.7,37.8,43.8,00000
81.0,82.0,40.0,699,03,01,  Purbapara,598,743,328,359,270,384,44.6,47.7,41.3,00000
81.0,82.0,40.0,699,04,01,  Nutan Para,136,154,72,72,64,82,46.9,50.0,43.8,00000
81.0,82.0,54.0,318,01,01,  Dhopa Para,1252,1689,681,793,571,896,42.6,46.2,38.9,00000
81.0,82.0,54.0,318,02,01,  Harukhali,690,1434,361,707,329,727,32.5,33.8,31.2,00000
81.0,82.0,54.0,318,03,01,  Gobindanagar,104,287,56,132,48,155,26.6,29.8,23.6,00000
81.0,82.0,54.0,404,01,01,  Mach Para,279,160,153,65,126,95,63.6,70.2,57.0,00000
81.0,82.0,54.0,404,02,01,  Chhota Senbagh,449,317,233,148,216,169,58.6,61.2,56.1,00000
81.0,82.0,54.0,404,03,01,  Bara Senbagh,470,411,268,208,202,203,53.3,56.3,49.9,00000
81.0,82.0,54.0,404,04,01,  Natun Gaupara,158,323,81,171,77,152,32.8,32.1,33.6,00000
81.0,82.0,54.0,404,05,01,  Puratan Gaupara,288,173,147,80,141,93,62.5,64.8,60.3,00000
81.0,82.0,54.0,629,01,01,  Gani Para,185,258,93,123,92,135,41.8,43.1,40.5,00000
81.0,82.0,54.0,629,02,01,  Danga Para,410,366,212,174,198,192,52.8,54.9,50.8,00000
81.0,82.0,54.0,629,03,01,  Sarishabari,627,357,313,159,314,198,63.7,66.3,61.3,00000
81.0,82.0,54.0,629,04,01,  Madhukhali,536,520,292,268,244,252,50.8,52.1,49.2,00000
81.0,82.0,81.0,528,01,01,  Chhota Kaju Para,170,226,88,103,82,123,42.9,46.1,40.0,00000
81.0,82.0,81.0,528,02,01,  Bara Kaju Para,239,286,126,137,113,149,45.5,47.9,43.1,00000
81.0,82.0,81.0,660,01,01,  Mangal Para,798,828,418,400,380,428,49.1,51.1,47.0,00000
81.0,82.0,81.0,660,02,01,  Goragachhi,357,773,198,367,159,406,31.6,35.0,28.1,00000
81.0,82.0,81.0,660,03,01,  Kazir Pukur,84,190,45,101,39,89,30.7,30.8,30.5,00000
81.0,82.0,81.0,707,01,01,  Nandi Para-1,299,503,164,235,135,268,37.3,41.1,33.5,00000
81.0,82.0,81.0,707,02,01,  Nandi Para-2,211,204,109,95,102,109,50.8,53.4,48.3,00000
81.0,82.0,81.0,808,01,01,  Laskarpur,190,134,102,58,88,76,58.6,63.8,53.7,00000
81.0,82.0,81.0,808,02,01,  Kaiharia,78,156,38,78,40,78,33.3,32.8,33.9,00000
81.0,82.0,81.0,808,03,01,  Sadhanpur,311,618,165,295,146,323,33.5,35.9,31.1,00000
81.0,82.0,81.0,948,01,01,  Tebaria,251,302,134,148,117,154,45.4,47.5,43.2,00000
81.0,82.0,81.0,948,02,01,  Khalisakuri,190,165,108,79,82,86,53.5,57.8,48.8,00000
81.0,94.0,27.0,051,01,01,  Badhair,462,515,240,244,222,271,47.3,49.6,45.0,00000
81.0,94.0,27.0,051,02,01,  Paranpur,148,218,83,107,65,111,40.4,43.7,36.9,00000
81.0,94.0,27.0,577,01,01,  Jot Gokul,258,307,144,143,114,164,45.7,50.2,41.0,00000
81.0,94.0,27.0,732,01,01,  Maria,189,287,83,130,106,157,39.7,39.0,40.3,00000
81.0,94.0,27.0,732,02,01,  Jokar Para,107,349,37,189,70,160,23.5,16.4,30.4,00000
81.0,94.0,54.0,713,01,01,  Malbandha,659,347,318,182,341,165,65.5,63.6,67.4,00000
81.0,94.0,54.0,713,02,01,  Bhalkakanda,502,453,228,229,274,224,52.6,49.9,55.0,00000
81.0,94.0,54.0,713,03,01,  Fulbari,205,254,107,123,98,131,44.7,46.5,42.8,00000
81.0,94.0,54.0,713,04,01,  Kalu Para,160,157,94,76,66,81,50.5,55.3,44.9,00000
81.0,94.0,57.0,821,01,01,  Parisho,1035,581,533,249,502,332,64.0,68.2,60.2,00000
81.0,94.0,57.0,821,02,01,  Bataspur,395,363,226,147,169,216,52.1,60.6,43.9,00000
81.0,94.0,57.0,957,01,01,  Damdama,425,499,220,240,205,259,46.0,47.8,44.2,00000
81.0,94.0,57.0,957,02,01,  Majhi Para,67,169,40,76,27,93,28.4,34.5,22.5,00000
81.0,94.0,57.0,957,03,01,  Dostarampur,96,80,56,36,40,44,54.5,60.9,47.6,00000
81.0,94.0,57.0,957,04,01,  Sreekhanda,467,345,262,142,205,203,57.5,64.9,50.2,00000
81.0,94.0,81.0,347,01,01,  Deul,466,283,241,130,225,153,62.2,65.0,59.5,00000
81.0,94.0,81.0,347,02,01,  Haridebpur (Part),152,96,80,40,72,56,61.3,66.7,56.3,00000
81.0,94.0,81.0,347,03,01,  Kalna (Part),276,164,133,73,143,91,62.7,64.6,61.1,00000
64.0,3.0,10.0,019,01,01,  Amrul Kasba,706,817,389,385,317,432,46.4,50.3,42.3,00000
64.0,3.0,10.0,019,02,01,  Dariagathi,656,466,366,216,290,250,58.5,62.9,53.7,00000
64.0,3.0,10.0,019,03,01,  Ghosh Para,872,744,476,320,396,424,54.0,59.8,48.3,00000
64.0,3.0,10.0,224,01,01,  Brajapur,1021,1312,582,589,439,723,43.8,49.7,37.8,00000
64.0,3.0,10.0,224,02,01,  Par Brajapur,172,185,86,79,86,106,48.2,52.1,44.8,00000
64.0,3.0,10.0,333,01,01,  Digha,737,1235,387,594,350,641,37.4,39.4,35.3,00000
64.0,3.0,10.0,333,02,01,  Suktigachha,516,855,254,407,262,448,37.6,38.4,36.9,00000
64.0,3.0,10.0,481,01,03,  Jatamrul,901,593,477,276,424,317,60.3,63.3,57.2,00000
64.0,3.0,10.0,481,02,03,  Kazi Para,153,271,89,130,64,141,36.1,40.6,31.2,00000
64.0,3.0,10.0,481,03,03,  Khaliphapar,191,203,107,86,84,117,48.5,55.4,41.8,00000
64.0,3.0,21.0,160,01,01,  Bhopara,779,566,394,263,385,303,57.9,60.0,56.0,00000
64.0,3.0,21.0,160,02,01,  Kashiabari,1282,710,681,289,601,421,64.4,70.2,58.8,00000
64.0,3.0,21.0,186,01,03,  Bhar Tentulia,860,819,452,407,408,412,51.2,52.6,49.8,00000
64.0,3.0,21.0,186,02,03,  Khola Para,190,168,108,71,82,97,53.1,60.3,45.8,00000
64.0,3.0,21.0,475,01,01,  Jamgaon,804,1139,441,538,363,601,41.4,45.0,37.7,00000
64.0,3.0,21.0,475,02,01,  Sonaidanga,378,437,202,202,176,235,46.4,50.0,42.8,00000
64.0,3.0,21.0,475,03,01,  Nagberi,96,197,49,93,47,104,32.8,34.5,31.1,00000
64.0,3.0,21.0,962,01,01,  Tilabadur,844,1334,441,609,403,725,38.8,42.0,35.7,00000
64.0,3.0,21.0,962,02,01,  Poata Para,20,158,10,83,10,75,11.2,10.8,11.8,00000
64.0,3.0,31.0,680,01,01,  Mohan Ghosh,409,466,216,205,193,261,46.7,51.3,42.5,00000
64.0,3.0,31.0,680,02,01,  Par Mohan Ghosh,149,212,81,95,68,117,41.3,46.0,36.8,00000
64.0,3.0,31.0,706,01,01,  Nandigram,425,375,214,168,211,207,53.1,56.0,50.5,00000
64.0,3.0,31.0,706,02,01,  Kharsati,522,464,294,221,228,243,52.9,57.1,48.4,00000
64.0,3.0,42.0,892,01,01,  Chak Simla,471,710,281,301,190,409,39.9,48.3,31.7,00000
64.0,3.0,42.0,892,02,01,  Bara Simla,488,770,260,360,228,410,38.8,41.9,35.7,00000
64.0,3.0,52.0,044,01,01,  Atgaon,346,565,180,253,166,312,38.0,41.6,34.7,00000
64.0,3.0,52.0,044,02,01,  Danga Para,126,257,71,125,55,132,32.9,36.2,29.4,00000
64.0,3.0,52.0,044,03,01,  Bejpara,49,41,24,14,25,27,54.4,63.2,48.1,00000
64.0,3.0,52.0,044,04,01,  Harpur,358,447,197,200,161,247,44.5,49.6,39.5,00000
64.0,3.0,52.0,044,05,01,  Atgram Danga Para,102,106,58,40,44,66,49.0,59.2,40.0,00000
64.0,3.0,52.0,057,01,01,  Baghmara,74,83,48,34,26,49,47.1,58.5,34.7,00000
64.0,3.0,52.0,057,02,01,  Ulairbaria,77,190,39,94,38,96,28.8,29.3,28.4,00000
64.0,3.0,52.0,057,03,01,  Taranagar,241,117,126,53,115,64,67.3,70.4,64.2,00000
64.0,3.0,52.0,057,04,01,  Ujan Baghmara,62,33,40,11,22,22,65.3,78.4,50.0,00000
64.0,3.0,52.0,057,05,01,  Bishnapur,259,170,147,64,112,106,60.4,69.7,51.4,00000
64.0,3.0,52.0,372,01,01,  Madandanga,315,463,165,216,150,247,40.5,43.3,37.8,00000
64.0,3.0,52.0,372,02,01,  Gondagohali,256,560,146,249,110,311,31.4,37.0,26.1,00000
64.0,3.0,52.0,519,01,01,  Kalikapur,829,1360,454,614,375,746,37.9,42.5,33.5,00000
64.0,3.0,52.0,519,02,01,  Bowla Para,322,399,146,185,176,214,44.7,44.1,45.1,00000
64.0,3.0,63.0,423,01,01,  Hingulkandi,595,639,314,288,281,351,48.2,52.2,44.5,00000
64.0,3.0,63.0,423,02,01,  Dharmapur,139,135,63,69,76,66,50.7,47.7,53.5,00000
64.0,3.0,63.0,423,03,01,  Lalpara,102,211,58,95,44,116,32.6,37.9,27.5,00000
64.0,3.0,63.0,468,01,01,  Jalupota,255,223,133,102,122,121,53.3,56.6,50.2,00000
64.0,3.0,63.0,468,02,01,  Kya,12,30,8,14,4,16,28.6,36.4,20.0,00000
64.0,3.0,63.0,648,01,01,  Maniary,681,849,372,390,309,459,44.5,48.8,40.2,00000
64.0,3.0,63.0,648,02,01,  Khari Pukur,85,149,41,69,44,80,36.3,37.3,35.5,00000
64.0,3.0,63.0,654,01,01,  Marir,690,607,364,280,326,327,53.2,56.5,49.9,00000
64.0,3.0,63.0,654,02,01,  Bara Pukuria,110,43,62,15,48,28,71.9,80.5,63.2,00000
64.0,3.0,63.0,686,01,01,  Muskipur,410,582,241,266,169,316,41.3,47.5,34.8,00000
64.0,3.0,63.0,686,02,01,  Goalbaria,257,388,152,195,105,193,39.8,43.8,35.2,00000
64.0,3.0,63.0,686,03,01,  Salimpur,91,144,45,69,46,75,38.7,39.5,38.0,00000
64.0,3.0,63.0,686,04,01,  Nagendranagar,208,231,114,105,94,126,47.4,52.1,42.7,00000
64.0,3.0,63.0,686,05,01,  Krishnapur,44,51,30,25,14,26,46.3,54.5,35.0,00000
64.0,3.0,63.0,783,01,01,  Patisar,565,765,346,351,219,414,42.5,49.6,34.6,00000
64.0,3.0,63.0,783,02,01,  Mirjipur,24,105,12,52,12,53,18.6,18.8,18.5,00000
64.0,3.0,63.0,840,01,01,  Saguna,111,185,59,87,52,98,37.5,40.4,34.7,00000
64.0,3.0,63.0,840,02,01,  Kumra,29,113,17,56,12,57,20.4,23.3,17.4,00000
64.0,3.0,73.0,237,01,01,  Nababer Tambu,525,643,292,294,233,349,44.9,49.8,40.0,00000
64.0,3.0,73.0,237,02,01,  Pabandanga,243,171,116,71,127,100,58.7,62.0,55.9,00000
64.0,3.0,73.0,237,03,01,  Bipra Boalia,481,427,273,191,208,236,53.0,58.8,46.8,00000
64.0,3.0,73.0,391,01,01,  Gurnai,371,614,195,294,176,320,37.7,39.9,35.5,00000
64.0,3.0,73.0,391,02,01,  Par Gurnai,337,845,198,413,139,432,28.5,32.4,24.3,00000
64.0,3.0,73.0,391,03,01,  Kharerbari,100,134,63,58,37,76,42.7,52.1,32.7,00000
64.0,3.0,73.0,391,04,01,  Patkabari,41,71,23,36,18,35,36.6,39.0,34.0,00000
64.0,3.0,73.0,455,01,01,  Chak Bishnupur,228,302,130,145,98,157,43.0,47.3,38.4,00000
64.0,3.0,73.0,455,02,01,  Jagadas,165,447,89,206,76,241,27.0,30.2,24.0,00000
64.0,3.0,73.0,622,01,01,  Madhya Boalia,283,453,150,196,133,257,38.5,43.4,34.1,00000
64.0,3.0,73.0,622,02,01,  Joynathpur,172,296,93,126,79,170,36.8,42.5,31.7,00000
64.0,3.0,73.0,622,03,01,  Dhulauri,81,114,45,51,36,63,41.5,46.9,36.4,00000
64.0,3.0,73.0,751,01,03,  Panchpakhia,162,100,93,32,69,68,61.8,74.4,50.4,00000
64.0,3.0,73.0,751,02,03,  Jagadishpur,242,266,130,126,112,140,47.6,50.8,44.4,00000
64.0,3.0,73.0,751,03,03,  Shibpur,215,137,113,55,102,82,61.1,67.3,55.4,00000
64.0,3.0,73.0,757,01,01,  Panchupur,953,489,513,197,440,292,66.1,72.3,60.1,00000
64.0,3.0,73.0,757,02,01,  Par Panchupur,573,376,303,167,270,209,60.4,64.5,56.4,00000
64.0,3.0,73.0,757,03,01,  Ujan Para,330,481,167,223,163,258,40.7,42.8,38.7,00000
64.0,3.0,73.0,776,01,03,  Pathailjhara,2105,845,1072,384,1033,461,71.4,73.6,69.1,00000
64.0,3.0,73.0,776,02,03,  Mollah Para,171,235,95,113,76,122,42.1,45.7,38.4,00000
64.0,3.0,84.0,070,01,01,  Bahala,356,476,196,213,160,263,42.8,47.9,37.8,00000
64.0,3.0,84.0,070,02,01,  Jhanjhania,60,119,26,52,34,67,33.5,33.3,33.7,00000
64.0,3.0,84.0,847,01,01,  Sahagola,1158,1267,674,596,484,671,47.8,53.1,41.9,00000
64.0,3.0,84.0,847,02,01,  Sreerampur,164,180,92,84,72,96,47.7,52.3,42.9,00000
64.0,3.0,84.0,847,03,01,  Bera Hasan,148,264,111,99,37,165,35.9,52.9,18.3,00000
64.0,3.0,84.0,924,01,01,  Subarnakundu,0,97,0,42,0,55,0.0,0.0,0.0,00000
64.0,3.0,84.0,924,02,01,  Hatia Para,153,465,92,225,61,240,24.8,29.0,20.3,00000
64.0,3.0,84.0,937,01,01,  Taratia,369,274,197,104,172,170,57.4,65.4,50.3,00000
64.0,3.0,84.0,937,02,01,  Chhota Danga,178,356,100,174,78,182,33.3,36.5,30.0,00000
64.0,3.0,84.0,937,03,01,  Bara Danga,89,303,47,135,42,168,22.7,25.8,20.0,00000
64.0,3.0,84.0,937,04,01,  Jhanjhania,220,212,99,103,121,109,50.9,49.0,52.6,00000
64.0,28.0,21.0,161,01,01,  Bheram,231,268,134,121,97,147,46.3,52.5,39.8,00000
64.0,28.0,21.0,161,02,01,  Sonadighi,101,195,54,96,47,99,34.1,36.0,32.2,00000
64.0,28.0,21.0,194,01,01,  Naya Para,101,36,56,17,45,19,73.7,76.7,70.3,00000
64.0,28.0,21.0,194,02,01,  Chhilimpur,390,549,198,268,192,281,41.5,42.5,40.6,00000
64.0,28.0,21.0,194,03,01,  Talbona,126,79,63,38,63,41,61.5,62.4,60.6,00000
64.0,28.0,21.0,194,04,01,  Nagar Dighi,67,37,34,22,33,15,64.4,60.7,68.8,00000
64.0,28.0,21.0,754,01,01,  Mangalia,438,526,223,253,215,273,45.4,46.8,44.1,00000
64.0,28.0,21.0,754,02,01,  Sarkar Para,204,145,110,67,94,78,58.5,62.1,54.7,00000
64.0,28.0,21.0,907,01,01,  Dandu Para,58,63,33,29,25,34,47.9,53.2,42.4,00000
64.0,28.0,21.0,907,02,01,  Rangamati,565,410,299,192,266,218,57.9,60.9,55.0,00000
64.0,28.0,21.0,907,03,01,  Chaligram,215,189,125,82,90,107,53.2,60.4,45.7,00000
64.0,28.0,31.0,041,01,01,  Uttarpara,255,350,134,173,121,177,42.1,43.6,40.6,00000
64.0,28.0,31.0,041,02,01,  Dakshinpara,436,498,238,240,198,258,46.7,49.8,43.4,00000
64.0,28.0,31.0,041,03,01,  Sonar Para,148,147,77,71,71,76,50.2,52.0,48.3,00000
64.0,28.0,31.0,657,01,01,  Kazipur,716,476,349,234,367,242,60.1,59.9,60.3,00000
64.0,28.0,31.0,657,02,01,  Jamail,114,27,57,14,57,13,80.9,80.3,81.4,00000
64.0,28.0,63.0,124,01,01,  Kazi Para,204,294,105,124,99,170,41.0,45.9,36.8,00000
64.0,28.0,63.0,124,02,01,  Dhangola,158,143,78,81,80,62,52.5,49.1,56.3,00000
64.0,28.0,63.0,124,03,01,  Kata Para,512,650,260,321,252,329,44.1,44.8,43.4,00000
64.0,28.0,63.0,124,04,01,  Bara Shibpur,997,1429,516,705,481,724,41.1,42.3,39.9,00000
64.0,28.0,63.0,555,01,01,  Jahanpur Uttar,1556,1547,822,784,734,763,50.1,51.2,49.0,00000
64.0,28.0,63.0,555,02,01,  Dakshin Jahanpur,794,1329,438,633,356,696,37.4,40.9,33.8,00000
64.0,28.0,63.0,684,01,01,  Kokil,362,619,189,309,173,310,36.9,38.0,35.8,00000
64.0,28.0,63.0,684,02,01,  Sulpi Colony,368,382,193,178,175,204,49.1,52.0,46.2,00000
64.0,28.0,63.0,791,01,01,  Nanaich Uttar,84,196,49,93,35,103,30.0,34.5,25.4,00000
64.0,28.0,63.0,791,02,01,  Bagunbari,932,848,486,397,446,451,52.4,55.0,49.7,00000
64.0,28.0,63.0,791,03,01,  Naaich,827,1139,405,564,422,575,42.1,41.8,42.3,00000
64.0,28.0,77.0,166,01,01,  Mahato Para,96,292,56,127,40,165,24.7,30.6,19.5,00000
64.0,28.0,77.0,166,02,01,  Bhagabanpur,169,95,91,42,78,53,64.0,68.4,59.5,00000
64.0,28.0,77.0,166,03,01,  Colony Para,100,158,42,82,58,76,38.8,33.9,43.3,00000
64.0,28.0,77.0,305,01,01,  Khapura,48,27,25,15,23,12,64.0,62.5,65.7,00000
64.0,28.0,77.0,305,02,01,  Battali,87,99,46,49,41,50,46.8,48.4,45.1,00000
64.0,28.0,77.0,305,03,01,  Baratali,74,80,37,38,37,42,48.1,49.3,46.8,00000
64.0,28.0,77.0,513,01,01,  Ghab Barapur,193,225,105,101,88,124,46.2,51.0,41.5,00000
64.0,28.0,77.0,513,02,01,  Shimulta,69,154,28,79,41,75,30.9,26.2,35.3,00000
64.0,28.0,77.0,513,03,01,  Dakshin Gopirampur,213,95,109,43,104,52,69.2,71.7,66.7,00000
64.0,28.0,77.0,513,04,01,  Bakuri Hari Para,16,144,7,72,9,72,10.0,8.9,11.1,00000
64.0,28.0,77.0,513,05,01,  Ruimari,11,37,6,22,5,15,22.9,21.4,25.0,00000
64.0,28.0,77.0,518,01,01,  Desh Para,420,262,205,142,215,120,61.6,59.1,64.2,00000
64.0,28.0,77.0,518,02,01,  Baranta,187,204,90,107,97,97,47.8,45.7,50.0,00000
64.0,28.0,77.0,518,03,01,  Chhota Pukuria,47,35,25,16,22,19,57.3,61.0,53.7,00000
64.0,28.0,77.0,615,01,01,  Khata Pukur,39,96,24,45,15,51,28.9,34.8,22.7,00000
64.0,28.0,77.0,615,02,01,  Naya Para,93,167,44,93,49,74,35.8,32.1,39.8,00000
64.0,28.0,77.0,615,03,01,  Hari Pukur,58,121,28,62,30,59,32.4,31.1,33.7,00000
64.0,28.0,77.0,615,04,01,  Tala Para,19,124,14,56,5,68,13.3,20.0,6.8,00000
64.0,28.0,77.0,819,01,01,  School Para,6,27,3,14,3,13,18.2,17.6,18.8,00000
64.0,28.0,77.0,819,02,01,  Lalmatia,349,519,179,265,170,254,40.2,40.3,40.1,00000
64.0,28.0,77.0,819,03,01,  Ragda Para,23,80,13,40,10,40,22.3,24.5,20.0,00000
64.0,28.0,77.0,902,01,01,  Raspur,475,620,233,308,242,312,43.4,43.1,43.7,00000
64.0,28.0,77.0,902,02,01,  Kurshamari,44,103,23,50,21,53,29.9,31.5,28.4,00000
64.0,28.0,77.0,902,03,01,  Nala Dighi,41,130,17,67,24,63,24.0,20.2,27.6,00000
64.0,28.0,77.0,902,04,01,  Sona Dighi Para,15,61,9,26,6,35,19.7,25.7,14.6,00000
64.0,28.0,77.0,902,05,01,  Tatul Pukur,11,25,7,14,4,11,30.6,33.3,26.7,00000
64.0,28.0,77.0,985,01,01,  Bazari Para,40,31,19,12,21,19,56.3,61.3,52.5,00000
64.0,28.0,77.0,985,02,01,  Noagaon Para,358,294,198,147,160,147,54.9,57.4,52.1,00000
64.0,28.0,77.0,985,03,01,  Nal Pukur,132,163,65,81,67,82,44.7,44.5,45.0,00000
64.0,28.0,77.0,985,04,01,  Baglu Para,111,191,54,100,57,91,36.8,35.1,38.5,00000
64.0,28.0,77.0,985,05,01,  Thanthan Para,293,178,155,81,138,97,62.2,65.7,58.7,00000
64.0,28.0,77.0,985,06,01,  Dighirpar,77,151,39,72,38,79,33.8,35.1,32.5,00000
64.0,28.0,84.0,171,01,01,  Purbapara,427,459,213,223,214,236,48.2,48.9,47.6,00000
64.0,28.0,84.0,171,02,01,  Paschimpara,250,175,123,91,127,84,58.8,57.5,60.2,00000
64.0,28.0,84.0,467,01,01,  Durgapur,377,289,189,148,188,141,56.6,56.1,57.1,00000
64.0,28.0,84.0,467,02,01,  Durgapur Refujee Para,527,410,279,219,248,191,56.2,56.0,56.5,00000
64.0,28.0,84.0,643,01,01,  Katna,107,117,48,65,59,52,47.8,42.5,53.2,00000
64.0,28.0,84.0,643,02,01,  Chankuri,250,248,129,119,121,129,50.2,52.0,48.4,00000
64.0,28.0,84.0,981,01,01,  Chhota Pustail,93,29,49,14,44,15,76.2,77.8,74.6,00000
64.0,28.0,84.0,981,02,01,  Bara Pustail,238,94,134,49,104,45,71.7,73.2,69.8,00000
64.0,47.0,54.0,682,01,01,  Kusumba,3177,2792,1697,1246,1480,1546,53.2,57.7,48.9,00000
64.0,47.0,54.0,682,02,01,  Dangapara,210,137,103,57,107,80,60.5,64.4,57.2,00000
64.0,47.0,54.0,682,03,01,  Bagdewan,211,170,114,78,97,92,55.4,59.4,51.3,00000
64.0,47.0,54.0,911,01,01,  Samuk Khol,824,325,434,138,390,187,71.7,75.9,67.6,00000
64.0,47.0,54.0,911,02,01,  Buridah,118,35,68,11,50,24,77.1,86.1,67.6,00000
64.0,50.0,76.0,534,01,01,  Kalna,122,139,72,65,50,74,46.7,52.6,40.3,00000
64.0,50.0,76.0,534,02,01,  Chandra Para,123,89,72,37,51,52,58.0,66.1,49.5,00000
64.0,50.0,76.0,619,01,01,  Kundana,726,673,355,336,371,337,51.9,51.4,52.4,00000
64.0,50.0,76.0,619,02,01,  Malaipur,232,184,138,77,94,107,55.8,64.2,46.8,00000
64.0,50.0,76.0,622,01,01,  Kurail,612,367,318,182,294,185,62.5,63.6,61.4,00000
64.0,50.0,76.0,622,02,01,  Batkurail,154,308,96,154,58,154,33.3,38.4,27.4,00000
64.0,50.0,76.0,716,01,01,  Naikutti,151,115,88,49,63,66,56.8,64.2,48.8,00000
64.0,50.0,76.0,716,02,01,  Mara Pukuri,245,184,121,98,124,86,57.1,55.3,59.0,00000
64.0,50.0,76.0,816,01,01,  Roygaon,904,1049,501,499,403,550,46.3,50.1,42.3,00000
64.0,50.0,76.0,816,02,01,  Mataji,573,237,314,99,259,138,70.7,76.0,65.2,00000
64.0,50.0,95.0,366,01,01,  Dohali,958,605,520,273,438,332,61.3,65.6,56.9,00000
64.0,50.0,95.0,366,02,01,  Shibganj,1120,701,604,323,516,378,61.5,65.2,57.7,00000
64.0,60.0,14.0,839,01,01,  Payna,695,1166,395,510,300,656,37.3,43.6,31.4,00000
64.0,60.0,14.0,839,02,01,  Alaipur,245,195,132,88,113,107,55.7,60.0,51.4,00000
64.0,60.0,21.0,668,01,01,  Kasba,322,405,170,193,152,212,44.3,46.8,41.8,00000
64.0,60.0,21.0,668,02,01,  Kuanagar,170,175,93,87,77,88,49.3,51.7,46.7,00000
64.0,60.0,29.0,371,01,01,  Ekarkuri,424,345,219,153,205,192,55.1,58.9,51.6,00000
64.0,60.0,29.0,371,02,01,  Enatpur,547,1091,269,548,278,543,33.4,32.9,33.9,00000
64.0,60.0,29.0,581,01,01,  Sahapur,1767,1212,952,555,815,657,59.3,63.2,55.4,00000
64.0,60.0,29.0,581,02,01,  Dhamkuri,590,380,311,172,279,208,60.8,64.4,57.3,00000
64.0,60.0,43.0,189,01,01,  Chak Bolaki,670,736,354,335,316,401,47.7,51.4,44.1,00000
64.0,60.0,43.0,189,02,01,  Chak Ujir,429,324,221,144,208,180,57.0,60.5,53.6,00000
64.0,60.0,43.0,948,01,01,  Shimulia,2505,2458,1287,1142,1218,1316,50.5,53.0,48.1,00000
64.0,60.0,43.0,948,02,01,  Balughat,1048,698,506,352,542,346,60.0,59.0,61.0,00000
64.0,60.0,73.0,160,01,01,  Chuarpur,131,98,76,43,55,55,57.2,63.9,50.0,00000
64.0,60.0,73.0,160,02,01,  Chhota Keshabpur,68,245,42,118,26,127,21.7,26.3,17.0,00000
64.0,60.0,73.0,632,01,01,  Kochgari,335,556,183,262,152,294,37.6,41.1,34.1,00000
64.0,60.0,73.0,632,02,01,  Paik Para,312,412,170,191,142,221,43.1,47.1,39.1,00000
64.0,60.0,73.0,632,03,01,  Kadimpur,142,140,82,72,60,68,50.4,53.2,46.9,00000
64.0,60.0,73.0,632,04,01,  Kolbari,58,25,39,5,19,20,69.9,88.6,48.7,00000
64.0,60.0,73.0,982,01,01,  Tentulia,312,244,167,113,145,131,56.1,59.6,52.5,00000
64.0,60.0,73.0,982,02,01,  Bejahar,65,110,37,55,28,55,37.1,40.2,33.7,00000
64.0,60.0,94.0,320,01,01,  Roijoar,382,304,195,134,187,170,55.7,59.3,52.4,00000
64.0,60.0,94.0,320,02,01,  Dakahar,306,151,158,58,148,93,67.0,73.1,61.4,00000
64.0,60.0,94.0,716,01,01,  Malancha,267,202,135,88,132,114,56.9,60.5,53.7,00000
64.0,60.0,94.0,716,02,01,  Enayetpur,202,92,109,34,93,58,68.7,76.2,61.6,00000
64.0,60.0,94.0,784,01,01,  Narayanpur,367,270,196,126,171,144,57.6,60.9,54.3,00000
64.0,60.0,94.0,784,02,01,  Sreedharpur,217,412,120,177,97,235,34.5,40.4,29.2,00000
64.0,60.0,94.0,986,01,01,  Tilakpur,501,419,258,173,243,246,54.5,59.9,49.7,00000
64.0,60.0,94.0,986,02,01,  Basnai,426,397,233,169,193,228,51.8,58.0,45.8,00000
64.0,69.0,10.0,006,01,01,  Aghor,483,561,263,242,220,319,46.3,52.1,40.8,00000
64.0,69.0,10.0,006,02,01,  Akdalia,480,461,234,206,246,255,51.0,53.2,49.1,00000
64.0,69.0,10.0,052,01,01,  Badalpur,254,277,134,129,120,148,47.8,51.0,44.8,00000
64.0,69.0,10.0,052,02,01,  Latkuri,18,111,10,52,8,59,14.0,16.1,11.9,00000
64.0,69.0,10.0,074,01,01,  Balator,392,279,226,129,166,150,58.4,63.7,52.5,00000
64.0,69.0,10.0,074,02,01,  Uttarpara,178,138,87,68,91,70,56.3,56.1,56.5,00000
64.0,69.0,10.0,731,01,01,  Nakoil,181,382,86,182,95,200,32.1,32.1,32.2,00000
64.0,69.0,10.0,731,02,01,  Kachari Para,190,275,92,135,98,140,40.9,40.5,41.2,00000
64.0,69.0,10.0,731,03,01,  Purbapara,102,321,57,158,45,163,24.1,26.5,21.6,00000
64.0,69.0,10.0,864,01,01,  Sadapur,431,673,219,323,212,350,39.0,40.4,37.7,00000
64.0,69.0,10.0,864,02,01,  Danga Para,413,376,204,184,209,192,52.3,52.6,52.1,00000
64.0,69.0,31.0,080,01,01,  Dama Para,195,172,100,87,95,85,53.1,53.5,52.8,00000
64.0,69.0,31.0,080,02,01,  Bamain,153,120,70,60,83,60,56.0,53.8,58.0,00000
64.0,69.0,31.0,080,03,01,  Bhat Para,87,53,48,22,39,31,62.1,68.6,55.7,00000
64.0,69.0,31.0,080,04,01,  Deri Para,212,315,107,157,105,158,40.2,40.5,39.9,00000
64.0,69.0,31.0,223,01,01,  Budhuria,399,666,192,313,207,353,37.5,38.0,37.0,00000
64.0,69.0,31.0,223,02,01,  Budhuria Karamzai,108,299,40,154,68,145,26.5,20.6,31.9,00000
64.0,69.0,31.0,223,03,01,  Budhuria Danga Para,315,274,138,142,177,132,53.5,49.3,57.3,00000
64.0,69.0,31.0,316,01,01,  Chandan Nagar,557,395,278,177,279,218,58.5,61.1,56.1,00000
64.0,69.0,31.0,316,02,01,  Madhyapara,207,257,110,135,97,122,44.6,44.9,44.3,00000
64.0,69.0,31.0,316,03,01,  Cheragi Para,93,116,43,49,50,67,44.5,46.7,42.7,00000
64.0,69.0,31.0,316,04,01,  Begunbari,95,183,48,90,47,93,34.2,34.8,33.6,00000
64.0,69.0,31.0,316,05,01,  Shaotal Para,20,133,15,60,5,73,13.1,20.0,6.4,00000
64.0,69.0,31.0,316,06,01,  Padma Pukur,36,301,18,143,18,158,10.7,11.2,10.2,00000
64.0,69.0,31.0,316,07,01,  Ganesh Para,70,192,37,91,33,101,26.7,28.9,24.6,00000
64.0,69.0,31.0,316,08,01,  Tatihar,216,224,107,108,109,116,49.1,49.8,48.4,00000
64.0,69.0,31.0,316,09,01,  Lakshmidanga,213,286,103,133,110,153,42.7,43.6,41.8,00000
64.0,69.0,31.0,833,01,01,  Paschimpara,136,170,71,75,65,95,44.4,48.6,40.6,00000
64.0,69.0,31.0,833,02,01,  Purbapara,142,236,81,121,61,115,37.6,40.1,34.7,00000
64.0,69.0,31.0,833,03,01,  Chak Ramnagar,195,187,98,77,97,110,51.0,56.0,46.9,00000
64.0,69.0,42.0,593,01,01,  Khurda Champa,182,514,96,255,86,259,26.1,27.4,24.9,00000
64.0,69.0,42.0,593,02,01,  Ghughudanga,487,449,230,217,257,232,52.0,51.5,52.6,00000
64.0,69.0,42.0,691,01,01,  Maklahat,640,603,304,315,336,288,51.5,49.1,53.8,00000
64.0,69.0,42.0,691,02,01,  Narayanpur,835,942,378,475,457,467,47.0,44.3,49.5,00000
64.0,69.0,52.0,430,01,01,  Gurihari,250,542,137,262,113,280,31.6,34.3,28.8,00000
64.0,69.0,52.0,430,02,01,  Tikrampur,181,255,98,112,83,143,41.5,46.7,36.7,00000
64.0,69.0,52.0,901,01,01,  Sansail,284,509,145,228,139,281,35.8,38.9,33.1,00000
64.0,69.0,52.0,901,02,01,  Arjunpur,128,156,71,63,57,93,45.1,53.0,38.0,00000
64.0,69.0,52.0,901,03,01,  Tokipur,165,143,96,66,69,77,53.6,59.3,47.3,00000
64.0,69.0,52.0,970,01,01,  Nangpur,234,192,112,87,122,105,54.9,56.3,53.7,00000
64.0,69.0,52.0,970,02,01,  Tegharia,285,257,154,116,131,141,52.6,57.0,48.2,00000
64.0,69.0,84.0,263,01,01,  Chunia Para,351,313,171,151,180,162,52.9,53.1,52.6,00000
64.0,69.0,84.0,263,02,01,  Pathakail,198,120,95,64,103,56,62.3,59.7,64.8,00000
64.0,69.0,84.0,263,03,01,  Hindu Para,105,82,59,34,46,48,56.1,63.4,48.9,00000
64.0,69.0,84.0,313,01,01,  Chandail,269,371,135,167,134,204,42.0,44.7,39.6,00000
64.0,69.0,84.0,313,02,01,  Bona Para,93,408,46,200,47,208,18.6,18.7,18.4,00000
64.0,69.0,84.0,821,01,01,  Rajapur,275,714,147,336,128,378,27.8,30.4,25.3,00000
64.0,69.0,84.0,821,02,01,  Dargah Para,1172,1170,607,532,565,638,50.0,53.3,47.0,00000
64.0,69.0,84.0,877,01,01,  Kazi Para,127,146,68,65,59,81,46.5,51.1,42.1,00000
64.0,69.0,84.0,877,02,01,  Kathani Para,121,142,64,68,57,74,46.0,48.5,43.5,00000
64.0,69.0,84.0,877,03,01,  Zulu Para,558,613,295,291,263,322,47.7,50.3,45.0,00000
64.0,69.0,84.0,886,01,01,  Salbari,807,395,431,168,376,227,67.1,72.0,62.4,00000
64.0,69.0,84.0,886,02,01,  Danga Para,250,202,123,91,127,111,55.3,57.5,53.4,00000
64.0,69.0,84.0,948,01,01,  Dakshinpara,452,446,212,220,240,226,50.3,49.1,51.5,00000
64.0,69.0,84.0,948,02,01,  Madhyapara,888,616,476,258,412,358,59.0,64.9,53.5,00000
64.0,69.0,84.0,948,03,01,  Danga Para,463,464,243,216,220,248,49.9,52.9,47.0,00000
64.0,75.0,43.0,147,01,01,  Belgharia,373,484,188,241,185,243,43.5,43.8,43.2,00000
64.0,75.0,43.0,147,02,01,  Subarajpur,201,94,100,49,101,45,68.1,67.1,69.2,00000
64.0,75.0,60.0,525,01,01,  Kanchan,397,472,204,250,193,222,45.7,44.9,46.5,00000
64.0,75.0,60.0,525,02,01,  Padma Pakur,593,347,323,176,270,171,63.1,64.7,61.2,00000
64.0,75.0,69.0,469,01,01,  Jamdanga,75,58,43,25,32,33,56.4,63.2,49.2,00000
64.0,75.0,69.0,469,02,01,  Kanu Para,119,193,54,88,65,105,38.1,38.0,38.2,00000
64.0,75.0,69.0,469,03,01,  Hokmapur,63,190,32,104,31,86,24.9,23.5,26.5,00000
64.0,75.0,69.0,469,04,01,  Gangakuri,160,186,88,84,72,102,46.2,51.2,41.4,00000
64.0,75.0,69.0,469,05,01,  Noapara,89,117,43,55,46,62,43.2,43.9,42.6,00000
64.0,75.0,69.0,469,06,01,  Hatsaoli,337,180,180,89,157,91,65.2,66.9,63.3,00000
64.0,75.0,69.0,469,07,01,  Makhmal,47,44,23,24,24,20,51.6,48.9,54.5,00000
64.0,75.0,69.0,469,08,01,  Dighi Para,94,84,51,36,43,48,52.8,58.6,47.3,00000
64.0,75.0,77.0,351,01,01,  Bangla Para,118,96,74,48,44,48,55.1,60.7,47.8,00000
64.0,75.0,77.0,351,02,01,  Saotal Para,32,103,18,51,14,52,23.7,26.1,21.2,00000
64.0,75.0,77.0,351,03,01,  Kanthal Pukur,20,52,7,22,13,30,27.8,24.1,30.2,00000
64.0,75.0,77.0,395,01,01,  Chaudari Para,118,11,63,3,55,8,91.5,95.5,87.3,00000
64.0,75.0,77.0,395,02,01,  Madh Para,142,118,75,57,67,61,54.6,56.8,52.3,00000
64.0,75.0,77.0,395,03,01,  Chak Para,251,172,128,95,123,77,59.3,57.4,61.5,00000
64.0,75.0,77.0,395,04,01,  Sarung Para,168,62,85,35,83,27,73.0,70.8,75.5,00000
64.0,75.0,77.0,395,05,01,  Kabiraji Para,145,68,67,37,78,31,68.1,64.4,71.6,00000
64.0,75.0,77.0,760,01,01,  Banshbari,206,71,102,43,104,28,74.4,70.3,78.8,00000
64.0,75.0,77.0,760,02,01,  Jalu Para,49,36,22,21,27,15,57.6,51.2,64.3,00000
64.0,75.0,77.0,760,03,01,  Dhalahar,62,43,34,24,28,19,59.0,58.6,59.6,00000
64.0,75.0,77.0,760,04,01,  Paharkata,72,87,38,35,34,52,45.3,52.1,39.5,00000
64.0,75.0,77.0,760,05,01,  Uttar Chak Jejote,52,27,29,7,23,20,65.8,80.6,53.5,00000
64.0,75.0,77.0,760,06,01,  Dakshin Chak Jejote,124,124,63,70,61,54,50.0,47.4,53.0,00000
64.0,75.0,77.0,804,01,01,  Paschim Patichhara,354,134,208,67,146,67,72.5,75.6,68.5,00000
64.0,75.0,77.0,804,02,01,  Purba Patichhara,571,308,300,139,271,169,65.0,68.3,61.6,00000
64.0,79.0,15.0,169,01,01,  Belgharia,168,149,86,64,82,85,53.0,57.3,49.1,00000
64.0,79.0,15.0,169,02,01,  Shaki Para,64,91,41,45,23,46,41.3,47.7,33.3,00000
64.0,79.0,15.0,204,01,01,  Biprabhag,56,368,23,192,33,176,13.2,10.7,15.8,00000
64.0,79.0,15.0,204,02,01,  Kharipahar,114,309,51,170,63,139,27.0,23.1,31.2,00000
64.0,79.0,15.0,224,01,01,  Chhaor,726,395,393,219,333,176,64.8,64.2,65.4,00000
64.0,79.0,15.0,224,02,01,  Malkudanga,163,245,91,117,72,128,40.0,43.8,36.0,00000
64.0,79.0,15.0,224,03,01,  Aumbatuli,41,132,25,64,16,68,23.7,28.1,19.0,00000
64.0,79.0,15.0,224,04,01,  Soladanga,56,64,29,32,27,32,46.7,47.5,45.8,00000
64.0,79.0,15.0,224,05,01,  Ani Pukur,31,129,17,59,14,70,19.4,22.4,16.7,00000
64.0,79.0,15.0,507,01,01,  Kamardha,493,792,279,344,214,448,38.4,44.8,32.3,00000
64.0,79.0,15.0,507,02,01,  Saderdanga,69,168,32,87,37,81,29.1,26.9,31.4,00000
64.0,79.0,23.0,939,01,01,  Surananda,280,146,145,64,135,82,65.7,69.4,62.2,00000
64.0,79.0,23.0,939,02,01,  Dangapara,58,79,24,42,34,37,42.3,36.4,47.9,00000
64.0,79.0,31.0,136,01,01,  Sardar Para,204,228,115,101,89,127,47.2,53.2,41.2,00000
64.0,79.0,31.0,136,02,01,  Sahu Para,124,225,63,99,61,126,35.5,38.9,32.6,00000
64.0,79.0,31.0,136,03,01,  Kaiya Para,98,300,42,154,56,146,24.6,21.4,27.7,00000
64.0,79.0,31.0,136,04,01,  Jangli Para,63,153,32,78,31,75,29.2,29.1,29.2,00000
64.0,79.0,31.0,136,05,01,  Dakshinpara,226,261,134,142,92,119,46.4,48.6,43.6,00000
64.0,79.0,31.0,136,06,01,  Chak Abhiram,60,121,27,55,33,66,33.1,32.9,33.3,00000
64.0,79.0,31.0,136,07,01,  Chak Rajaram,81,135,51,69,30,66,37.5,42.5,31.3,00000
64.0,79.0,31.0,136,08,01,  Barabaria,78,247,38,107,40,140,24.0,26.2,22.2,00000
64.0,79.0,31.0,393,01,01,  Kachari Para,157,230,81,125,76,105,40.6,39.3,42.0,00000
64.0,79.0,31.0,393,02,01,  Hari Para,24,125,12,61,12,64,16.1,16.4,15.8,00000
64.0,79.0,31.0,393,03,01,  Sahu Para,205,80,108,39,97,41,71.9,73.5,70.3,00000
64.0,79.0,31.0,393,04,01,  Teli Para,209,149,95,75,114,74,58.4,55.9,60.6,00000
64.0,79.0,31.0,393,05,01,  Barakuri,21,40,11,21,10,19,34.4,34.4,34.5,00000
64.0,79.0,31.0,393,06,01,  Suklahar Para,52,236,28,114,24,122,18.1,19.7,16.4,00000
64.0,79.0,31.0,393,07,01,  Rajbanshi Para,36,34,24,15,12,19,51.4,61.5,38.7,00000
64.0,79.0,31.0,393,08,01,  Sonar Para,42,30,27,8,15,22,58.3,77.1,40.5,00000
64.0,79.0,31.0,393,09,01,  Bangal Para,34,42,15,14,19,28,44.7,51.7,40.4,00000
64.0,79.0,31.0,393,10,01,  Dulmani Para,140,92,74,46,66,46,60.3,61.7,58.9,00000
64.0,79.0,31.0,393,11,01,  Nagar Kuri Pukur,216,110,117,47,99,63,66.3,71.3,61.1,00000
64.0,79.0,31.0,393,12,01,  Paharia Pukur,162,134,82,64,80,70,54.7,56.2,53.3,00000
64.0,79.0,31.0,393,13,01,  Kanai Para,16,125,4,67,12,58,11.3,5.6,17.1,00000
64.0,79.0,31.0,393,14,01,  Ghatnagar Guchchhagram,36,130,12,61,24,69,21.7,16.4,25.8,00000
64.0,79.0,31.0,393,15,01,  Chhaighati Para,64,175,27,79,37,96,26.8,25.5,27.8,00000
64.0,79.0,31.0,393,16,01,  Hatkhola Para,21,83,13,42,8,41,20.2,23.6,16.3,00000
64.0,79.0,31.0,393,17,01,  Peada Para,95,97,52,46,43,51,49.5,53.1,45.7,00000
64.0,79.0,31.0,393,18,01,  Mollah Para,517,663,272,325,245,338,43.8,45.6,42.0,00000
64.0,79.0,47.0,104,01,01,  Balichand,279,262,150,130,129,132,51.6,53.6,49.4,00000
64.0,79.0,47.0,104,02,01,  Raktokaua,63,124,29,59,34,65,33.7,33.0,34.3,00000
64.0,79.0,47.0,104,03,01,  Saotal Para,3,76,2,39,1,37,3.8,4.9,2.6,00000
64.0,79.0,47.0,182,01,01,  Dakshinpara,132,195,73,91,59,104,40.4,44.5,36.2,00000
64.0,79.0,47.0,182,02,01,  Uttarpara,110,202,59,99,51,103,35.3,37.3,33.1,00000
64.0,79.0,47.0,234,01,01,  Uttarpara,151,149,75,67,76,82,50.3,52.8,48.1,00000
64.0,79.0,47.0,234,02,01,  Dakshinpara,244,283,132,140,112,143,46.3,48.5,43.9,00000
64.0,79.0,47.0,318,01,01,  Dasnagar,33,169,15,83,18,86,16.3,15.3,17.3,00000
64.0,79.0,47.0,318,02,01,  Saotal Para,16,52,8,27,8,25,23.5,22.9,24.2,00000
64.0,79.0,47.0,318,03,01,  Hazra Para,20,59,10,34,10,25,25.3,22.7,28.6,00000
64.0,79.0,47.0,318,04,01,  Bel Pukur,73,211,32,105,41,106,25.7,23.4,27.9,00000
64.0,79.0,47.0,380,01,01,  Ganapatipur(Dakshinpara),116,68,67,27,49,41,63.0,71.3,54.4,00000
64.0,79.0,47.0,380,02,01,  Gonapatipur(Uttarpara),242,173,127,89,115,84,58.3,58.8,57.8,00000
64.0,79.0,47.0,380,03,01,  Gonapatipur(Paschimpara),80,70,45,36,35,34,53.3,55.6,50.7,00000
64.0,79.0,47.0,419,01,01,  Purbapara,104,250,41,138,63,112,29.4,22.9,36.0,00000
64.0,79.0,47.0,419,02,01,  Paschim Para,249,94,124,45,125,49,72.6,73.4,71.8,00000
64.0,79.0,47.0,533,01,01,  Dafadar Para,96,43,53,20,43,23,69.1,72.6,65.2,00000
64.0,79.0,47.0,533,02,01,  Peada Para,53,101,29,57,24,44,34.4,33.7,35.3,00000
64.0,79.0,47.0,533,03,01,  Mol Para,91,75,47,32,44,43,54.8,59.5,50.6,00000
64.0,79.0,47.0,533,04,01,  Danga Para,104,117,55,58,49,59,47.1,48.7,45.4,00000
64.0,79.0,47.0,533,05,01,  Bilpara,57,73,28,37,29,36,43.8,43.1,44.6,00000
64.0,79.0,47.0,533,06,01,  Khotapukur,16,43,3,25,13,18,27.1,10.7,41.9,00000
64.0,79.0,47.0,585,01,01,  Khrpa Uttarpara,174,98,86,52,88,46,64.0,62.3,65.7,00000
64.0,79.0,47.0,585,02,01,  Harpabazzar Para,394,94,229,43,165,51,80.7,84.2,76.4,00000
64.0,79.0,47.0,585,03,01,  Kharpa Dakshin Para,151,107,76,52,75,55,58.5,59.4,57.7,00000
64.0,79.0,47.0,585,04,01,  Bhuli Para,94,81,44,42,50,39,53.7,51.2,56.2,00000
64.0,79.0,47.0,708,01,01,  Shahaji Para,145,67,81,30,64,37,68.4,73.0,63.4,00000
64.0,79.0,47.0,708,02,01,  Dakshinpara,33,66,16,32,17,34,33.3,33.3,33.3,00000
64.0,79.0,47.0,708,03,01,  Mangal Para,64,67,38,31,26,36,48.9,55.1,41.9,00000
64.0,79.0,47.0,874,01,01,  Uttar Para,34,78,15,43,19,35,30.4,25.9,35.2,00000
64.0,79.0,47.0,874,02,01,  Hindupara,149,440,76,210,73,230,25.3,26.6,24.1,00000
64.0,79.0,47.0,874,03,01,  Satalpara,202,429,97,203,105,226,32.0,32.3,31.7,00000
64.0,79.0,47.0,874,04,01,  Talapara,52,33,28,15,24,18,61.2,65.1,57.1,00000
64.0,79.0,47.0,900,01,01,  Shisha,345,89,168,45,177,44,79.5,78.9,80.1,00000
64.0,79.0,47.0,900,02,01,  Narsingahar Para,247,77,129,31,118,46,76.2,80.6,72.0,00000
64.0,79.0,47.0,900,03,01,  Sardar Para,168,107,101,42,67,65,61.1,70.6,50.8,00000
64.0,79.0,47.0,900,04,01,  Danga Para,67,122,29,56,38,66,35.4,34.1,36.5,00000
64.0,79.0,55.0,214,01,01,  Uttar Bishnupur,190,278,90,147,100,131,40.6,38.0,43.3,00000
64.0,79.0,55.0,214,02,01,  Dakshin Bishnupur,138,349,63,176,75,173,28.3,26.4,30.2,00000
64.0,79.0,55.0,214,03,01,  Bijlee Para,110,539,41,281,69,258,16.9,12.7,21.1,00000
64.0,79.0,55.0,214,04,01,  Ranga Pukur,110,315,53,144,57,171,25.9,26.9,25.0,00000
64.0,79.0,55.0,214,05,01,  Battali,76,402,32,207,44,195,15.9,13.4,18.4,00000
64.0,79.0,55.0,214,06,01,  Berachoki,116,180,52,100,64,80,39.2,34.2,44.4,00000
64.0,79.0,55.0,409,01,03,  Gopinathpur,370,757,154,412,216,345,32.8,27.2,38.5,00000
64.0,79.0,55.0,409,02,03,  Dighi Para,317,574,130,298,187,276,35.6,30.4,40.4,00000
64.0,79.0,55.0,494,01,01,  Kalaibari,356,1099,175,572,181,527,24.5,23.4,25.6,00000
64.0,79.0,55.0,494,02,01,  Islampur,70,82,34,37,36,45,46.1,47.9,44.4,00000
64.0,79.0,55.0,494,03,01,  Jogidanga,133,399,60,188,73,211,25.0,24.2,25.7,00000
64.0,79.0,55.0,494,04,01,  Daurpal,985,1411,427,752,558,659,41.1,36.2,45.9,00000
64.0,79.0,55.0,494,05,01,  Saotal Para,83,203,43,101,40,102,29.0,29.9,28.2,00000
64.0,79.0,55.0,731,01,03,  Bangal Para,919,437,460,184,459,253,67.8,71.4,64.5,00000
64.0,79.0,55.0,731,02,03,  Masterpara,990,509,535,232,455,277,66.0,69.8,62.2,00000
64.0,79.0,55.0,731,03,03,  Kumar Para,787,1012,408,507,379,505,43.7,44.6,42.9,00000
64.0,79.0,55.0,731,04,03,  Natun Deara Para,740,1246,336,629,404,617,37.3,34.8,39.6,00000
64.0,79.0,55.0,773,01,01,  Tektha,155,748,69,377,86,371,17.2,15.5,18.8,00000
64.0,79.0,55.0,773,02,01,  Dhawa Para,69,307,34,162,35,145,18.4,17.3,19.4,00000
64.0,79.0,55.0,907,01,01,  Fikir Para,80,142,37,77,43,65,36.0,32.5,39.8,00000
64.0,79.0,55.0,907,02,01,  Shitali,123,566,46,300,77,266,17.9,13.3,22.4,00000
64.0,79.0,55.0,907,03,01,  Balashahid Para,157,309,59,170,98,139,33.7,25.8,41.4,00000
64.0,79.0,55.0,920,01,01,  Battala,47,190,20,97,27,93,19.8,17.1,22.5,00000
64.0,79.0,55.0,920,02,01,  Goherpur,252,531,126,277,126,254,32.2,31.3,33.2,00000
64.0,79.0,55.0,920,03,01,  Kuladanga,352,727,160,381,192,346,32.6,29.6,35.7,00000
64.0,79.0,55.0,926,01,01,  Suhati,278,177,145,87,133,90,61.1,62.5,59.6,00000
64.0,79.0,55.0,926,02,01,  Baidhyapur,201,97,104,48,97,49,67.4,68.4,66.4,00000
64.0,79.0,87.0,143,01,01,  Dhuladanga,183,285,86,131,97,154,39.1,39.6,38.6,00000
64.0,79.0,87.0,143,02,01,  Sreekola,112,403,62,200,50,203,21.7,23.7,19.8,00000
64.0,79.0,87.0,143,03,01,  Matbari,18,173,6,84,12,89,9.4,6.7,11.9,00000
64.0,79.0,87.0,143,04,01,  Gopalpur,150,317,75,160,75,157,32.1,31.9,32.3,00000
64.0,79.0,87.0,143,05,01,  Kath Pukur,60,141,36,60,24,81,29.9,37.5,22.9,00000
64.0,79.0,87.0,143,06,01,  Madhupur,38,131,29,51,9,80,22.5,36.3,10.1,00000
64.0,79.0,87.0,143,07,01,  Shapara,137,133,62,67,75,66,50.7,48.1,53.2,00000
64.0,79.0,87.0,143,08,01,  Thanthania Para,104,165,51,73,53,92,38.7,41.1,36.6,00000
64.0,79.0,87.0,321,01,01,  Dayahar,165,448,83,209,82,239,26.9,28.4,25.5,00000
64.0,79.0,87.0,321,02,01,  Sekh Para,195,142,144,74,51,68,57.9,66.1,42.9,00000
64.0,79.0,87.0,438,01,01,  Ilam,130,277,65,128,65,149,31.9,33.7,30.4,00000
64.0,79.0,87.0,438,02,01,  Maktapur,111,315,60,158,51,157,26.1,27.5,24.5,00000
64.0,79.0,87.0,793,01,01,  Madhyabari,177,22,92,10,85,12,88.9,90.2,87.6,00000
64.0,79.0,87.0,793,02,01,  Purbabari,124,26,59,11,65,15,82.7,84.3,81.3,00000
64.0,79.0,87.0,793,03,01,  Gabirakuri,701,635,365,317,336,318,52.5,53.5,51.4,00000
64.0,79.0,87.0,793,04,01,  Maulvi Para,132,45,68,21,64,24,74.6,76.4,72.7,00000
64.0,79.0,87.0,793,05,01,  Manuza Para,103,57,52,26,51,31,64.4,66.7,62.2,00000
64.0,79.0,87.0,793,06,01,  Paschimbari,73,9,38,5,35,4,89.0,88.4,89.7,00000
64.0,79.0,87.0,793,07,01,  Turi Para,21,141,11,61,10,80,13.0,15.3,11.1,00000
64.0,79.0,87.0,793,08,01,  Islampur,1283,420,961,276,322,144,75.3,77.7,69.1,00000
64.0,79.0,87.0,793,09,01,  Banshbari,463,128,247,71,216,57,78.3,77.7,79.1,00000
64.0,79.0,87.0,793,10,01,  Hari Para,121,149,65,75,56,74,44.8,46.4,43.1,00000
64.0,79.0,87.0,793,11,01,  Itta Pukur,74,225,37,114,37,111,24.7,24.5,25.0,00000
64.0,79.0,87.0,793,12,01,  Khatkurai,77,223,35,104,42,119,25.7,25.2,26.1,00000
64.0,79.0,87.0,793,13,01,  Nayansahi,206,28,96,14,110,14,88.0,87.3,88.7,00000
64.0,79.0,87.0,793,14,01,  Noapara,263,301,113,150,150,151,46.6,43.0,49.8,00000
64.0,79.0,87.0,793,15,01,  Dighi Para,272,312,125,156,147,156,46.6,44.5,48.5,00000
64.0,85.0,10.0,335,01,01,  Deula,344,335,212,132,132,203,50.7,61.6,39.4,00000
64.0,85.0,10.0,335,02,01,  Soliya,264,418,143,185,121,233,38.7,43.6,34.2,00000
64.0,85.0,10.0,335,03,01,  Palna,41,110,22,51,19,59,27.2,30.1,24.4,00000
64.0,85.0,10.0,335,04,01,  Blidagasi,330,178,155,73,175,105,65.0,68.0,62.5,00000
64.0,85.0,42.0,665,01,01,  Madhupur,150,354,78,166,72,188,29.8,32.0,27.7,00000
64.0,85.0,42.0,665,02,01,  Alonker Dighi,383,355,204,180,179,175,51.9,53.1,50.6,00000
64.0,85.0,42.0,665,03,01,  Guchiagari,159,263,79,125,80,138,37.7,38.7,36.7,00000
64.0,85.0,84.0,607,01,01,  Khatteshwar Raninagar,1691,2251,919,1046,772,1205,42.9,46.8,39.0,00000
64.0,85.0,84.0,607,02,01,  Daudpur,465,314,261,137,204,177,59.7,65.6,53.5,00000
64.0,85.0,84.0,607,03,01,  Bishnapur,149,181,81,89,68,92,45.2,47.6,42.5,00000
64.0,86.0,17.0,013,01,01,  Purbapara,118,211,63,106,55,105,35.9,37.3,34.4,00000
64.0,86.0,17.0,013,02,01,  Babu Para,201,238,100,108,101,130,45.8,48.1,43.7,00000
64.0,86.0,17.0,013,03,01,  Dighi Para,100,363,56,185,44,178,21.6,23.2,19.8,00000
64.0,86.0,17.0,013,04,01,  Madhyapara,209,231,98,115,111,116,47.5,46.0,48.9,00000
64.0,86.0,17.0,013,05,01,  Dakshinpara,90,95,51,43,39,52,48.6,54.3,42.9,00000
64.0,86.0,17.0,013,06,01,  Bagha Pukur,121,129,52,71,69,58,48.4,42.3,54.3,00000
64.0,86.0,17.0,013,07,01,  Bashinda Para,230,238,114,119,116,119,49.1,48.9,49.4,00000
64.0,86.0,17.0,045,01,01,  Mollah Para,189,167,100,75,89,92,53.1,57.1,49.2,00000
64.0,86.0,17.0,045,02,01,  Mandal Para,190,127,99,60,91,67,59.9,62.3,57.6,00000
64.0,86.0,17.0,045,03,01,  Uttarpara,95,206,51,98,44,108,31.6,34.2,28.9,00000
64.0,86.0,17.0,045,04,01,  Katani Para,218,324,116,163,102,161,40.2,41.6,38.8,00000
64.0,86.0,17.0,045,05,01,  Dakshinpara,179,164,97,79,82,85,52.2,55.1,49.1,00000
64.0,86.0,17.0,185,01,01,  Bhabuk,194,327,98,152,96,175,37.2,39.2,35.4,00000
64.0,86.0,17.0,185,02,01,  Danga Para,170,147,78,74,92,73,53.6,51.3,55.8,00000
64.0,86.0,17.0,185,03,01,  Hans Pukur,155,250,65,118,90,132,38.3,35.5,40.5,00000
64.0,86.0,17.0,227,01,01,  Chhatahar,195,253,96,131,99,122,43.5,42.3,44.8,00000
64.0,86.0,17.0,227,02,01,  Saotal Para,8,51,4,26,4,25,13.6,13.3,13.8,00000
64.0,86.0,17.0,390,01,01,  Sarkar Para,148,223,77,112,71,111,39.9,40.7,39.0,00000
64.0,86.0,17.0,390,02,01,  Paschimpara,92,383,39,194,53,189,19.4,16.7,21.9,00000
64.0,86.0,17.0,390,03,01,  Bholkeydanga,3,44,1,24,2,20,6.4,4.0,9.1,00000
64.0,86.0,17.0,663,01,01,  Uttarpara,138,258,74,128,64,130,34.8,36.6,33.0,00000
64.0,86.0,17.0,663,02,01,  Madhyampara,90,426,45,215,45,211,17.4,17.3,17.6,00000
64.0,86.0,17.0,663,03,01,  Dakshinpara,263,149,135,80,128,69,63.8,62.8,65.0,00000
64.0,86.0,17.0,715,01,01,  Naopara,63,73,29,37,34,36,46.3,43.9,48.6,00000
64.0,86.0,17.0,715,02,01,  Jor Pukur,74,57,34,28,40,29,56.5,54.8,58.0,00000
64.0,86.0,17.0,835,01,01,  Khola Pukur,188,270,109,123,79,147,41.0,47.0,35.0,00000
64.0,86.0,17.0,835,02,01,  Dakshinpara,56,84,33,43,23,41,40.0,43.4,35.9,00000
64.0,86.0,17.0,835,03,01,  Thakur Para,78,136,40,69,38,67,36.4,36.7,36.2,00000
64.0,86.0,17.0,835,04,01,  Madhyapara,50,112,26,55,24,57,30.9,32.1,29.6,00000
64.0,86.0,17.0,835,05,01,  Purbapara,87,147,36,79,51,68,37.2,31.3,42.9,00000
64.0,86.0,17.0,871,01,01,  Sarali,112,315,64,159,48,156,26.2,28.7,23.5,00000
64.0,86.0,17.0,871,02,01,  Badia Para,17,154,6,78,11,76,9.9,7.1,12.6,00000
64.0,86.0,39.0,055,01,01,  Teta Para Anarpur,142,116,69,52,73,64,55.0,57.0,53.3,00000
64.0,86.0,39.0,055,02,01,  Palpara,225,151,111,71,114,80,59.8,61.0,58.8,00000
64.0,86.0,39.0,165,01,01,  Beldanga,247,708,116,334,131,374,25.9,25.8,25.9,00000
64.0,86.0,39.0,165,02,01,  Dakshin Beldanga,140,248,89,116,51,132,36.1,43.4,27.9,00000
64.0,86.0,39.0,396,01,01,  Goala,429,486,242,220,187,266,46.9,52.4,41.3,00000
64.0,86.0,39.0,396,02,01,  Kadamdanga,202,335,118,171,84,164,37.6,40.8,33.9,00000
64.0,86.0,39.0,396,03,01,  Lakshmitala,123,363,71,185,52,178,25.3,27.7,22.6,00000
64.0,86.0,39.0,396,04,01,  Mandal Para,339,424,196,206,143,218,44.4,48.8,39.6,00000
64.0,86.0,39.0,396,05,01,  Kharibona,216,423,99,220,117,203,33.8,31.0,36.6,00000
64.0,86.0,39.0,425,01,01,  Andhar Dighi,619,1317,285,641,334,676,32.0,30.8,33.1,00000
64.0,86.0,39.0,425,02,01,  Shialmara,141,394,63,193,78,201,26.4,24.6,28.0,00000
64.0,86.0,39.0,435,01,01,  Dipidanga,120,303,65,146,55,157,28.4,30.8,25.9,00000
64.0,86.0,39.0,435,02,01,  Kepradanga,275,346,132,173,143,173,44.3,43.3,45.3,00000
64.0,86.0,39.0,487,01,01,  Dumuria Para,249,543,109,287,140,256,31.4,27.5,35.4,00000
64.0,86.0,39.0,487,02,01,  Shrokdanga,224,135,123,59,101,76,62.4,67.6,57.1,00000
64.0,86.0,39.0,487,03,01,  Kaibartagram,123,423,60,236,63,187,22.5,20.3,25.2,00000
64.0,86.0,39.0,510,01,01,  Kamaspur,457,1059,234,530,223,529,30.1,30.6,29.7,00000
64.0,86.0,39.0,510,02,01,  Kamardanga,76,340,23,169,53,171,18.3,12.0,23.7,00000
64.0,86.0,39.0,517,01,01,  Karangabari,191,220,108,106,83,114,46.5,50.5,42.1,00000
64.0,86.0,39.0,517,02,01,  Gatula,111,343,54,175,57,168,24.4,23.6,25.3,00000
64.0,86.0,39.0,517,03,01,  Alinagar,96,44,46,24,50,20,68.6,65.7,71.4,00000
64.0,86.0,39.0,559,01,01,  Satpara,371,203,193,84,178,119,64.6,69.7,59.9,00000
64.0,86.0,39.0,559,02,01,  Kachari Para,135,179,74,97,61,82,43.0,43.3,42.7,00000
64.0,86.0,39.0,559,03,01,  Hari Para,9,32,6,14,3,18,22.0,30.0,14.3,00000
64.0,86.0,39.0,559,04,01,  Dakshinpara,107,133,52,69,55,64,44.6,43.0,46.2,00000
64.0,86.0,39.0,595,01,01,  Danga Para,133,267,59,129,74,138,33.3,31.4,34.9,00000
64.0,86.0,39.0,595,02,01,  Jiga Para,121,141,65,72,56,69,46.2,47.4,44.8,00000
64.0,86.0,39.0,595,03,01,  Paik Para,79,177,34,101,45,76,30.9,25.2,37.2,00000
64.0,86.0,39.0,595,04,01,  Paschimpara,274,391,145,192,129,199,41.2,43.0,39.3,00000
64.0,86.0,39.0,595,05,01,  Uttarpara,126,119,67,55,59,64,51.4,54.9,48.0,00000
64.0,86.0,39.0,595,06,01,  Goal Para,44,19,19,8,25,11,69.8,70.4,69.4,00000
64.0,86.0,39.0,595,07,01,  Dakshinpara,37,51,22,23,15,28,42.0,48.9,34.9,00000
64.0,86.0,39.0,595,08,01,  Katabona,72,95,40,46,32,49,43.1,46.5,39.5,00000
64.0,86.0,39.0,725,01,01,  Nischintapur,316,389,174,186,142,203,44.8,48.3,41.2,00000
64.0,86.0,39.0,725,02,01,  Baradanga,186,351,98,172,88,179,34.6,36.3,33.0,00000
64.0,86.0,39.0,845,01,01,  Akheyal,112,125,62,56,50,69,47.3,52.5,42.0,00000
64.0,86.0,39.0,845,02,01,  Mulpara,152,98,77,49,75,49,60.8,61.1,60.5,00000
64.0,86.0,39.0,845,03,01,  Hindu Para,132,208,63,104,69,104,38.8,37.7,39.9,00000
64.0,86.0,39.0,916,01,01,  Palashdanga,223,544,108,262,115,282,29.1,29.2,29.0,00000
64.0,86.0,39.0,916,02,01,  Islampur,318,1002,156,499,162,503,24.1,23.8,24.4,00000
64.0,86.0,63.0,084,01,01,  Baikunthapur,319,671,154,340,165,331,32.2,31.2,33.3,00000
64.0,86.0,63.0,084,02,01,  Baikunthapur Adatala,318,643,174,302,144,341,33.1,36.6,29.7,00000
64.0,86.0,63.0,084,03,01,  Baikuntha Jalsukha,82,243,41,119,41,124,25.2,25.6,24.8,00000
64.0,86.0,63.0,084,04,01,  Baikuntha Kawabaiasha,111,312,52,161,59,151,26.2,24.4,28.1,00000
64.0,86.0,63.0,084,05,01,  Baikuntha Haripal,70,369,30,168,40,201,15.9,15.2,16.6,00000
64.0,86.0,63.0,523,01,01,  Karmudanga,1665,4460,741,2320,924,2140,27.2,24.2,30.2,00000
64.0,86.0,63.0,523,02,01,  Karia Para,143,191,60,93,83,98,42.8,39.2,45.9,00000
64.0,86.0,71.0,029,01,01,  Majid Para,382,391,196,197,186,194,49.4,49.9,48.9,00000
64.0,86.0,71.0,029,02,01,  Balukadanga,202,142,108,68,94,74,58.7,61.4,56.0,00000
64.0,86.0,71.0,126,01,01,  Fakir Para,147,65,71,34,76,31,69.3,67.6,71.0,00000
64.0,86.0,71.0,126,02,01,  Kata Para,96,283,56,142,40,141,25.3,28.3,22.1,00000
64.0,86.0,71.0,126,03,01,  Ganja Pukuri,21,60,11,27,10,33,25.9,28.9,23.3,00000
64.0,86.0,71.0,126,04,01,  Baidhyapur Mirzapur,74,52,41,29,33,23,58.7,58.6,58.9,00000
64.0,86.0,71.0,191,01,01,  Purbapara,180,85,104,38,76,47,67.9,73.2,61.8,00000
64.0,86.0,71.0,191,02,01,  Hemol Para,109,165,57,81,52,84,39.8,41.3,38.2,00000
64.0,86.0,71.0,191,03,01,  Palpara,55,54,28,24,27,30,50.5,53.8,47.4,00000
64.0,86.0,71.0,198,01,01,  Binodpur,183,167,81,84,102,83,52.3,49.1,55.1,00000
64.0,86.0,71.0,198,02,01,  Tola Para,87,117,44,55,43,62,42.6,44.4,41.0,00000
64.0,86.0,71.0,471,01,03,  Joypur,1261,320,813,138,448,182,79.8,85.5,71.1,00000
64.0,86.0,71.0,471,02,03,  Palpara,1414,343,791,154,623,189,80.5,83.7,76.7,00000
64.0,86.0,71.0,471,03,03,  Guchchhagram,55,65,33,32,22,33,45.8,50.8,40.0,00000
64.0,86.0,71.0,513,01,01,  Danga Para,481,458,280,222,201,236,51.2,55.8,46.0,00000
64.0,86.0,71.0,513,02,01,  Ganjakuri,283,290,148,133,135,157,49.4,52.7,46.2,00000
64.0,86.0,71.0,513,03,01,  Tenrakuri,171,231,102,117,69,114,42.5,46.6,37.7,00000
64.0,86.0,71.0,513,04,01,  Uchadanga,189,514,91,250,98,264,26.9,26.7,27.1,00000
64.0,86.0,71.0,543,01,01,  Bouna Para,111,116,67,48,44,68,48.9,58.3,39.3,00000
64.0,86.0,71.0,543,02,01,  Khidirpur,83,67,39,37,44,30,55.3,51.3,59.5,00000
64.0,86.0,71.0,549,01,01,  Pakrahar,126,151,63,75,63,76,45.5,45.7,45.3,00000
64.0,86.0,71.0,549,02,01,  Katipur,28,80,14,39,14,41,25.9,26.4,25.5,00000
64.0,86.0,71.0,738,01,01,  Nurpur,136,121,67,55,69,66,52.9,54.9,51.1,00000
64.0,86.0,71.0,738,02,01,  Guchchhagram,71,124,34,64,37,60,36.4,34.7,38.1,00000
64.0,86.0,71.0,786,01,01,  Noadanga,277,140,136,61,141,79,66.4,69.0,64.1,00000
64.0,86.0,71.0,786,02,01,  Madhyapara,149,197,78,89,71,108,43.1,46.7,39.7,00000
64.0,86.0,71.0,786,03,01,  Mulpara,99,221,56,105,43,116,30.9,34.8,27.0,00000
64.0,86.0,71.0,786,04,01,  Singahar,98,103,55,51,43,52,48.8,51.9,45.3,00000
64.0,86.0,71.0,848,01,01,  Sahabazpur,139,285,76,121,63,164,32.8,38.6,27.8,00000
64.0,86.0,71.0,848,02,01,  Dakshinpara,150,179,82,79,68,100,45.6,50.9,40.5,00000
64.0,86.0,71.0,848,03,01,  Paschimpara,235,237,119,105,116,132,49.8,53.1,46.8,00000
64.0,86.0,71.0,864,01,03,  Chowdhury Para,134,63,79,28,55,35,68.0,73.8,61.1,00000
64.0,86.0,71.0,864,02,03,  Sapahar Bazar,291,41,145,20,146,21,87.7,87.9,87.4,00000
64.0,86.0,71.0,864,03,03,  Donni Para,512,50,294,13,218,37,91.1,95.8,85.5,00000
64.0,86.0,71.0,864,04,03,  Saha Para,923,549,502,268,421,281,62.7,65.2,60.0,00000
64.0,86.0,71.0,864,05,03,  Kandar Para,625,523,288,249,337,274,54.4,53.6,55.2,00000
64.0,86.0,71.0,864,06,03,  Puratan Sapahar,855,929,381,465,474,464,47.9,45.0,50.5,00000
64.0,86.0,71.0,975,01,01,  Tulsi Para,133,210,64,103,69,107,38.8,38.3,39.2,00000
64.0,86.0,71.0,975,02,01,  Diar Para,140,212,67,108,73,104,39.8,38.3,41.2,00000
64.0,86.0,79.0,842,01,01,  Roypur,452,955,215,504,237,451,32.1,29.9,34.4,00000
64.0,86.0,79.0,842,02,01,  Roypur(Katabuna),27,75,10,43,17,32,26.5,18.9,34.7,00000
64.0,86.0,94.0,048,01,01,  Babupur,186,213,101,105,85,108,46.6,49.0,44.0,00000
64.0,86.0,94.0,048,02,01,  Duani Para,226,225,119,107,107,118,50.1,52.7,47.6,00000
64.0,86.0,94.0,741,01,01,  Oranpur,324,520,148,255,176,265,38.4,36.7,39.9,00000
64.0,86.0,94.0,741,02,01,  Moradanga,174,21,89,8,85,13,89.2,91.8,86.7,00000
64.0,86.0,94.0,968,01,01,  Changkuri,301,487,157,235,144,252,38.2,40.1,36.4,00000
64.0,86.0,94.0,968,02,01,  Dighi Para,270,234,147,109,123,125,53.6,57.4,49.6,00000
64.0,86.0,94.0,968,03,01,  Chak,282,308,150,168,132,140,47.8,47.2,48.5,00000
64.0,86.0,94.0,968,04,01,  Bazar Para,85,159,46,73,39,86,34.8,38.7,31.2,00000
64.0,86.0,94.0,968,05,01,  Sutar Para,28,80,11,39,17,41,25.9,22.0,29.3,00000
64.0,86.0,94.0,968,06,01,  Khocha Para,32,106,20,54,12,52,23.2,27.0,18.8,00000
64.0,86.0,94.0,968,07,01,  Boram Para,137,200,81,87,56,113,40.7,48.2,33.1,00000
64.0,86.0,94.0,968,08,01,  Dhanti Para,190,197,94,94,96,103,49.1,50.0,48.2,00000
64.0,86.0,94.0,968,09,01,  Hindu Para,285,187,161,79,124,108,60.4,67.1,53.4,00000
64.0,86.0,94.0,968,10,01,  Kotch Para,18,57,11,27,7,30,24.0,28.9,18.9,00000
76.0,5.0,15.0,170,01,01,  Chandba,498,662,247,320,251,342,42.9,43.6,42.3,00000
76.0,5.0,15.0,170,02,01,  Sanjoypur,1174,1404,554,694,620,710,45.5,44.4,46.6,00000
76.0,5.0,15.0,170,03,01,  Kushtia Para (Part),121,198,54,99,67,99,37.9,35.3,40.4,00000
76.0,5.0,15.0,170,04,01,  Kuti Para,246,160,127,65,119,95,60.6,66.1,55.6,00000
76.0,5.0,15.0,609,01,01,  Nagdaha,949,1003,438,491,511,512,48.6,47.1,50.0,00000
76.0,5.0,15.0,609,02,01,  Kadamdanga,404,675,196,327,208,348,37.4,37.5,37.4,00000
76.0,5.0,31.0,197,01,01,  Chandpur,409,819,198,416,211,403,33.3,32.2,34.4,00000
76.0,5.0,31.0,197,02,01,  Roypur,127,256,56,122,71,134,33.2,31.5,34.6,00000
76.0,5.0,31.0,761,01,01,  Raghunathpur,211,261,98,131,113,130,44.7,42.8,46.5,00000
76.0,5.0,31.0,761,02,01,  Singharia,491,618,225,321,266,297,44.3,41.2,47.2,00000
76.0,5.0,31.0,977,01,01,  Tarapasha,95,412,47,193,48,219,18.7,19.6,18.0,00000
76.0,5.0,31.0,977,02,01,  Gangarampur,144,318,82,152,62,166,31.2,35.0,27.2,00000
76.0,5.0,47.0,215,01,01,  Chaukibari,117,336,70,157,47,179,25.8,30.8,20.8,00000
76.0,5.0,47.0,215,02,01,  Chak Chaukibari,264,449,140,216,124,233,37.0,39.3,34.7,00000
76.0,5.0,47.0,268,01,01,  Dengargram,570,293,269,148,301,145,66.0,64.5,67.5,00000
76.0,5.0,47.0,268,02,01,  Maheshpur,97,226,45,113,52,113,30.0,28.5,31.5,00000
76.0,5.0,47.0,322,01,01,  Ekdanta Debottar,227,214,128,98,99,116,51.5,56.6,46.0,00000
76.0,5.0,47.0,322,02,01,  Ekdantta Bazar,231,212,124,102,107,110,52.1,54.9,49.3,00000
76.0,5.0,47.0,385,01,01,  Haidharpur,155,335,89,164,66,171,31.6,35.2,27.8,00000
76.0,5.0,47.0,385,02,01,  Hiranandapur,124,270,63,135,61,135,31.5,31.8,31.1,00000
76.0,5.0,47.0,627,01,01,  Narjan,237,595,108,316,129,279,28.5,25.5,31.6,00000
76.0,5.0,47.0,627,02,01,  Ramnagar,556,190,276,87,280,103,74.5,76.0,73.1,00000
76.0,5.0,47.0,627,03,01,  Niamatpur,149,649,71,337,78,312,18.7,17.4,20.0,00000
76.0,5.0,63.0,708,01,01,  Phalia,471,593,227,293,244,300,44.3,43.7,44.9,00000
76.0,5.0,63.0,708,02,01,  Balughat,228,502,118,252,110,250,31.2,31.9,30.6,00000
76.0,5.0,63.0,708,03,01,  Balarampur,323,546,157,282,166,264,37.2,35.8,38.6,00000
76.0,5.0,63.0,708,04,01,  Kashabpur,122,253,68,131,54,122,32.5,34.2,30.7,00000
76.0,5.0,63.0,959,01,01,  Sreepur,494,1225,251,646,243,579,28.7,28.0,29.6,00000
76.0,5.0,63.0,959,02,01,  Char Sreepur,154,481,72,252,82,229,24.3,22.2,26.4,00000
76.0,5.0,79.0,224,01,01,  Khidirpur,215,425,104,210,111,215,33.6,33.1,34.0,00000
76.0,5.0,79.0,224,02,01,  Bangsi Para,223,156,98,80,125,76,58.8,55.1,62.2,00000
76.0,5.0,79.0,295,01,01,  Durgapur,496,519,253,248,243,271,48.9,50.5,47.3,00000
76.0,5.0,79.0,295,02,01,  Islampur,370,808,185,380,185,428,31.4,32.7,30.2,00000
76.0,5.0,79.0,295,03,01,  Nasirampur,369,441,197,206,172,235,45.6,48.9,42.3,00000
76.0,5.0,79.0,591,01,01,  Naduria,784,738,375,347,409,391,51.5,51.9,51.1,00000
76.0,5.0,79.0,591,02,01,  Kumargari,437,736,224,364,213,372,37.3,38.1,36.4,00000
76.0,5.0,79.0,591,03,01,  Kaitdangi,100,145,40,73,60,72,40.8,35.4,45.5,00000
76.0,5.0,79.0,672,01,01,  Parasidhai,631,672,317,350,314,322,48.4,47.5,49.4,00000
76.0,5.0,79.0,672,02,01,  Hatigara,182,127,97,63,85,64,58.9,60.6,57.0,00000
76.0,5.0,79.0,941,01,01,  Kalamnagar,257,280,125,127,132,153,47.9,49.6,46.3,00000
76.0,5.0,79.0,941,02,01,  Sonakandar,268,567,136,268,132,299,32.1,33.7,30.6,00000
76.0,16.0,31.0,475,01,01,  Haturi (Part),2277,4300,1172,2095,1105,2205,34.6,35.9,33.4,00000
76.0,16.0,31.0,475,02,01,  Nutun Pzchakhola,1924,1996,989,915,935,1081,49.1,51.9,46.4,00000
76.0,16.0,31.0,475,03,01,  Jaganathpur,2226,3216,1114,1511,1112,1705,40.9,42.4,39.5,00000
76.0,16.0,31.0,475,04,01,  Narayanpur,643,766,323,373,320,393,45.6,46.4,44.9,00000
76.0,16.0,31.0,778,01,01,  U.Maldaha Para P.Khola,780,1088,409,469,371,619,41.8,46.6,37.5,00000
76.0,16.0,31.0,778,02,01,  Pechakhola,620,925,325,431,295,494,40.1,43.0,37.4,00000
76.0,16.0,42.0,309,01,01,  Charkandi,454,623,274,302,180,321,42.2,47.6,35.9,00000
76.0,16.0,42.0,309,02,01,  Rajnarayanpur,1479,1045,807,457,672,588,58.6,63.8,53.3,00000
76.0,16.0,42.0,309,03,01,  Dantia,790,975,445,440,345,535,44.8,50.3,39.2,00000
76.0,16.0,42.0,309,04,01,  Razzakpur,345,463,196,226,149,237,42.7,46.4,38.6,00000
76.0,16.0,42.0,309,05,01,  Nutan Para Bashawnathpur,112,151,58,67,54,84,42.6,46.4,39.1,00000
76.0,16.0,42.0,494,01,01,  Jatsakhni,229,332,128,167,101,165,40.8,43.4,38.0,00000
76.0,16.0,42.0,494,02,01,  Aminpur,1652,1804,926,808,726,996,47.8,53.4,42.2,00000
76.0,16.0,42.0,494,03,01,  Chakbaria,423,298,208,138,215,160,58.7,60.1,57.3,00000
76.0,16.0,42.0,494,04,01,  Khas Aminpur,1001,1589,571,773,430,816,38.6,42.5,34.5,00000
76.0,16.0,42.0,494,05,01,  Sinduri,510,702,273,325,237,377,42.1,45.7,38.6,00000
76.0,16.0,42.0,667,01,01,  Mirzapur,599,448,309,205,290,243,57.2,60.1,54.4,00000
76.0,16.0,42.0,667,02,01,  Bagh,152,188,81,86,71,102,44.7,48.5,41.0,00000
76.0,16.0,42.0,846,01,01,  Ranigram,368,396,196,195,172,201,48.2,50.1,46.1,00000
76.0,16.0,42.0,846,02,01,  Krishnapur,290,699,147,347,143,352,29.3,29.8,28.9,00000
76.0,16.0,42.0,846,03,01,  Pratappur,200,210,113,111,87,99,48.8,50.4,46.8,00000
76.0,16.0,42.0,846,04,01,  Chak Krishnapur,226,218,126,85,100,133,50.9,59.7,42.9,00000
76.0,16.0,42.0,846,05,01,  Chakbandi,103,223,48,122,55,101,31.6,28.2,35.3,00000
76.0,16.0,42.0,927,01,01,  Singhasan Ujan Para,1152,1524,633,712,519,812,43.0,47.1,39.0,00000
76.0,16.0,42.0,927,02,01,  Basantapur,1112,2242,575,1106,537,1136,33.2,34.2,32.1,00000
76.0,16.0,42.0,957,01,01,  Tangbari,1557,1303,804,598,753,705,54.4,57.3,51.6,00000
76.0,16.0,42.0,957,02,01,  Mastia,440,648,217,325,223,323,40.4,40.0,40.8,00000
76.0,16.0,47.0,432,01,01,  Ghior,420,742,218,335,202,407,36.1,39.4,33.2,00000
76.0,16.0,47.0,432,02,01,  Maskhali,353,540,185,261,168,279,39.5,41.5,37.6,00000
76.0,16.0,47.0,457,01,01,  Kytola,683,459,373,207,310,252,59.8,64.3,55.2,00000
76.0,16.0,47.0,457,02,01,  Harirampur,708,816,343,409,365,407,46.5,45.6,47.3,00000
76.0,16.0,47.0,457,03,01,  Joynagar,1417,2030,750,955,667,1075,41.1,44.0,38.3,00000
76.0,16.0,47.0,457,04,01,  Maniknagar,552,914,250,429,302,485,37.7,36.8,38.4,00000
76.0,16.0,47.0,457,05,01,  Monakusa,261,356,124,161,137,195,42.3,43.5,41.3,00000
76.0,16.0,47.0,457,06,01,  Bzgoynagar,142,396,75,183,67,213,26.4,29.1,23.9,00000
76.0,16.0,47.0,457,07,01,  Bengaua,88,137,48,57,40,80,39.1,45.7,33.3,00000
76.0,16.0,47.0,457,08,01,  Nutan Maniknagar,153,220,72,110,81,110,41.0,39.6,42.4,00000
76.0,16.0,52.0,655,01,01,  Puran Masundia,635,838,340,376,295,462,43.1,47.5,39.0,00000
76.0,16.0,52.0,655,02,01,  Kazi Para,398,434,204,208,194,226,47.8,49.5,46.2,00000
76.0,16.0,52.0,655,03,01,  Madhyapara,428,438,207,201,221,237,49.4,50.7,48.3,00000
76.0,16.0,52.0,655,04,01,  Fakirkandi,433,509,239,225,194,284,46.0,51.5,40.6,00000
76.0,16.0,52.0,655,05,01,  Khanibari,639,657,363,308,276,349,49.3,54.1,44.2,00000
76.0,16.0,52.0,655,06,01,  Rupganj,426,369,236,159,190,210,53.6,59.7,47.5,00000
76.0,16.0,52.0,933,01,01,  Ratanganj,637,737,348,315,289,422,46.4,52.5,40.6,00000
76.0,16.0,52.0,933,02,01,  Sitalpur,354,327,184,132,170,195,52.0,58.2,46.6,00000
76.0,16.0,63.0,049,01,01,  Bagchar,477,1041,257,495,220,546,31.4,34.2,28.7,00000
76.0,16.0,63.0,049,02,01,  Nutun Bharanga,821,1221,424,558,397,663,40.2,43.2,37.5,00000
76.0,16.0,63.0,889,01,01,  Marich Para,240,516,124,237,116,279,31.7,34.3,29.4,00000
76.0,16.0,63.0,889,02,01,  Naulai Para,131,203,74,91,57,112,39.2,44.8,33.7,00000
76.0,16.0,63.0,889,03,01,  Batiakhara,968,1472,522,647,446,825,39.7,44.7,35.1,00000
76.0,16.0,63.0,889,04,01,  Nutan Batiakhara,128,286,67,131,61,155,30.9,33.8,28.2,00000
76.0,16.0,63.0,889,05,01,  Chak Para,261,238,166,107,95,131,52.3,60.8,42.0,00000
76.0,16.0,63.0,889,06,01,  Raksha,530,873,294,420,236,453,37.8,41.2,34.3,00000
76.0,16.0,63.0,889,07,01,  Sona Padma,835,992,444,430,391,562,45.7,50.8,41.0,00000
76.0,16.0,63.0,889,08,01,  Saphulla,665,492,372,211,293,281,57.5,63.8,51.0,00000
76.0,16.0,63.0,889,09,01,  Char Saphulla,96,178,58,87,38,91,35.0,40.0,29.5,00000
76.0,16.0,63.0,889,10,01,  Baghsoua,178,407,93,184,85,223,30.4,33.6,27.6,00000
76.0,16.0,73.0,154,01,01,  Baktarpur,320,602,170,279,150,323,34.7,37.9,31.7,00000
76.0,16.0,73.0,154,02,01,  Boramara,186,570,105,283,81,287,24.6,27.1,22.0,00000
76.0,16.0,73.0,809,01,01,  Harinathpur,789,681,414,314,375,367,53.7,56.9,50.5,00000
76.0,16.0,73.0,809,02,01,  Raghunathpur,965,635,524,277,441,358,60.3,65.4,55.2,00000
76.0,16.0,84.0,142,01,01,  Gobinda,127,222,78,109,49,113,36.4,41.7,30.2,00000
76.0,16.0,84.0,142,02,01,  Bhuiyan Para,435,785,246,375,189,410,35.7,39.6,31.6,00000
76.0,16.0,84.0,580,01,01,  Char Para,661,945,368,438,293,507,41.2,45.7,36.6,00000
76.0,16.0,84.0,580,02,01,  Madhyapara,109,95,52,43,57,52,53.4,54.7,52.3,00000
76.0,16.0,84.0,580,03,01,  Palpara,241,362,126,159,115,203,40.0,44.2,36.2,00000
76.0,16.0,84.0,580,05,01,  Natun Para,249,240,139,104,110,136,50.9,57.2,44.7,00000
76.0,16.0,84.0,580,06,01,  Paikkandi,631,722,352,314,279,408,46.6,52.9,40.6,00000
76.0,16.0,84.0,580,07,01,  Sona Para,242,239,130,96,112,143,50.3,57.5,43.9,00000
76.0,16.0,84.0,852,01,01,  Dharmaganj,201,201,115,97,86,104,50.0,54.2,45.3,00000
76.0,16.0,84.0,852,02,01,  Sakini Para,613,978,329,459,284,519,38.5,41.8,35.4,00000
76.0,16.0,84.0,852,03,01,  Ruppur,479,943,262,471,217,472,33.7,35.7,31.5,00000
76.0,16.0,84.0,852,04,01,  Khataldangi,496,507,280,242,216,265,49.5,53.6,44.9,00000
76.0,19.0,15.0,031,01,01,  Ashta Manisha,1091,989,564,456,527,533,52.5,55.3,49.7,00000
76.0,19.0,15.0,031,02,01,  Hariharpur,213,315,130,149,83,166,40.3,46.6,33.3,00000
76.0,19.0,15.0,119,01,01,  Bara Bisakol,580,676,305,327,275,349,46.2,48.3,44.1,00000
76.0,19.0,15.0,119,02,01,  Denga Para,158,238,81,122,77,116,39.9,39.9,39.9,00000
76.0,19.0,15.0,323,01,01,  Gadai Rupsi,193,586,100,295,93,291,24.8,25.3,24.2,00000
76.0,19.0,15.0,323,02,01,  Jhoka,37,135,17,67,20,68,21.5,20.2,22.7,00000
76.0,19.0,15.0,608,01,01,  Nurnagar,639,871,336,419,303,452,42.3,44.5,40.1,00000
76.0,19.0,15.0,608,02,01,  Mouhat,69,38,35,22,34,16,64.5,61.4,68.0,00000
76.0,19.0,15.0,653,01,01,  Namkan,213,318,112,149,101,169,40.1,42.9,37.4,00000
76.0,19.0,15.0,653,02,01,  Shingari,279,392,158,180,121,212,41.6,46.7,36.3,00000
76.0,19.0,15.0,653,03,01,  Jagannathpur,62,194,34,86,28,108,24.2,28.3,20.6,00000
76.0,19.0,15.0,653,04,01,  Jhabjhabia,472,391,239,195,233,196,54.7,55.1,54.3,00000
76.0,19.0,15.0,863,01,01,  Rupsi,414,792,232,381,182,411,34.3,37.8,30.7,00000
76.0,19.0,15.0,863,02,01,  Baoihat,193,238,113,119,80,119,44.8,48.7,40.2,00000
76.0,19.0,15.0,863,03,01,  Bhanga Jola,307,499,154,247,153,252,38.1,38.4,37.8,00000
76.0,19.0,15.0,918,01,01,  Sahanagar,596,598,335,318,261,280,49.9,51.3,48.2,00000
76.0,19.0,15.0,918,02,01,  Mohat,157,82,80,39,77,43,65.7,67.2,64.2,00000
76.0,19.0,31.0,046,01,01,  Dahparar,277,417,142,200,135,217,39.9,41.5,38.4,00000
76.0,19.0,31.0,046,02,01,  Boalmari,306,376,168,165,138,211,44.9,50.5,39.5,00000
76.0,19.0,31.0,046,03,01,  Tuni Para,329,259,176,114,153,145,56.0,60.7,51.3,00000
76.0,19.0,31.0,046,04,01,  Gazarmara,330,288,168,141,162,147,53.4,54.4,52.4,00000
76.0,19.0,31.0,143,01,01,  Bhangura Dakhin Para,175,264,85,131,90,133,39.9,39.4,40.4,00000
76.0,19.0,31.0,143,02,01,  Bhangura Khapara,664,994,327,492,337,502,40.0,39.9,40.2,00000
76.0,19.0,31.0,143,03,01,  Char Bhangura (Purba Para),684,1149,360,555,324,594,37.3,39.3,35.3,00000
76.0,19.0,31.0,143,04,01,  Bhangura Puran Para,88,334,46,165,42,169,20.9,21.8,19.9,00000
76.0,19.0,31.0,143,05,01,  Noabaria,876,994,467,476,409,518,46.8,49.5,44.1,00000
76.0,19.0,31.0,143,06,01,  Char Para,178,343,93,183,85,160,34.2,33.7,34.7,00000
76.0,19.0,31.0,143,07,01,  Bhangura Sarker Para,278,322,140,157,138,165,46.3,47.1,45.5,00000
76.0,19.0,31.0,143,08,01,  Puibill,23,72,6,41,17,31,24.2,12.8,35.4,00000
76.0,19.0,31.0,203,01,01,  Chowbaria Takpara,76,112,40,49,36,63,40.4,44.9,36.4,00000
76.0,19.0,31.0,203,02,01,  Chowbaria Haropara,146,260,66,136,80,124,36.0,32.7,39.2,00000
76.0,19.0,31.0,442,01,01,  Uttar Kalkati,330,911,174,438,156,473,26.6,28.4,24.8,00000
76.0,19.0,31.0,442,02,01,  Jhinaigari Kalkati,399,453,197,224,202,229,46.8,46.8,46.9,00000
76.0,19.0,31.0,442,03,01,  Singari Kalkati,469,512,250,241,219,271,47.8,50.9,44.7,00000
76.0,19.0,31.0,578,01,01,  Menda,397,433,198,200,199,233,47.8,49.7,46.1,00000
76.0,19.0,31.0,578,02,01,  Khalpat,248,297,119,149,129,148,45.5,44.4,46.6,00000
76.0,19.0,31.0,624,01,01,  Malikchak,292,427,147,232,145,195,40.6,38.8,42.6,00000
76.0,19.0,31.0,624,02,01,  Kandi Para,145,211,64,99,81,112,40.7,39.3,42.0,00000
76.0,19.0,31.0,677,01,01,  Mondotesh,448,284,216,134,232,150,61.2,61.7,60.7,00000
76.0,19.0,31.0,677,02,01,  Sujapara,156,117,87,42,69,75,57.1,67.4,47.9,00000
76.0,19.0,31.0,677,03,01,  Dear Para,159,137,81,59,78,78,53.7,57.9,50.0,00000
76.0,19.0,47.0,047,01,01,  Ag Bahar,125,296,65,138,60,158,29.7,32.0,27.5,00000
76.0,19.0,47.0,047,02,01,  Pachh Bahar,155,137,85,56,70,81,53.1,60.3,46.4,00000
76.0,19.0,47.0,117,01,01,  Betuan,1033,1637,522,779,511,858,38.7,40.1,37.3,00000
76.0,19.0,47.0,117,02,01,  Agbetuan,247,371,133,175,114,196,40.0,43.2,36.8,00000
76.0,19.0,47.0,117,03,01,  Panch Betuan,306,635,170,308,136,327,32.5,35.6,29.4,00000
76.0,19.0,47.0,173,01,01,  Chalk Lakshmikol (Chak),116,184,79,92,37,92,38.7,46.2,28.7,00000
76.0,19.0,47.0,173,02,01,  Puibil,86,265,51,130,35,135,24.5,28.2,20.6,00000
76.0,19.0,47.0,263,01,01,  Dil Pasar,225,409,120,192,105,217,35.5,38.5,32.6,00000
76.0,19.0,47.0,263,02,01,  Kuragasa,12,60,6,26,6,34,16.7,18.8,15.0,00000
76.0,19.0,47.0,368,01,01,  Hat Udhunia,412,308,203,121,209,187,57.2,62.7,52.8,00000
76.0,19.0,47.0,368,02,01,  Baguan,108,381,58,141,50,240,22.1,29.1,17.2,00000
76.0,19.0,47.0,368,03,01,  Chowbaria,41,95,19,50,22,45,30.1,27.5,32.8,00000
76.0,19.0,47.0,788,01,01,  Patul,171,510,96,235,75,275,25.1,29.0,21.4,00000
76.0,19.0,47.0,788,02,01,  Tarapur,25,110,15,57,10,53,18.5,20.8,15.9,00000
76.0,19.0,47.0,788,03,01,  Basuria,3,40,3,19,0,21,7.0,13.6,0.0,00000
76.0,19.0,63.0,278,01,01,  Dudhbaria,272,482,146,226,126,256,36.1,39.2,33.0,00000
76.0,19.0,63.0,278,02,01,  Bara Pukuria,185,496,105,233,80,263,27.2,31.1,23.3,00000
76.0,19.0,63.0,383,01,01,  Helencha,342,494,173,231,169,263,40.9,42.8,39.1,00000
76.0,19.0,63.0,383,02,01,  Chak Digar,134,587,71,277,63,310,18.6,20.4,16.9,00000
76.0,19.0,63.0,383,03,01,  Aliahmadpur,9,118,3,61,6,57,7.1,4.7,9.5,00000
76.0,19.0,63.0,383,04,01,  Pozaspur,12,151,6,72,6,79,7.4,7.7,7.1,00000
76.0,19.0,63.0,458,01,01,  Karatkandi,602,467,338,204,264,263,56.3,62.4,50.1,00000
76.0,19.0,63.0,458,02,01,  Chandpur,135,311,79,142,56,169,30.3,35.7,24.9,00000
76.0,19.0,63.0,503,01,01,  Khan Marich,241,584,139,269,102,315,29.2,34.1,24.5,00000
76.0,19.0,63.0,503,02,01,  Miah Para,53,255,32,129,21,126,17.2,19.9,14.3,00000
76.0,19.0,63.0,503,03,01,  Bridha Marich,412,836,241,392,171,444,33.0,38.1,27.8,00000
76.0,19.0,63.0,503,04,01,  Candipur,145,628,72,308,73,320,18.8,18.9,18.6,00000
76.0,19.0,63.0,592,01,01,  Michhu Methair,130,52,68,20,62,32,71.4,77.3,66.0,00000
76.0,19.0,63.0,592,02,01,  Das Belay,78,204,49,93,29,111,27.7,34.5,20.7,00000
76.0,19.0,63.0,592,03,01,  Ghosh Belay,104,97,56,43,48,54,51.7,56.6,47.1,00000
76.0,19.0,63.0,608,01,01,  Mahish Bathan,165,507,83,260,82,247,24.6,24.2,24.9,00000
76.0,19.0,63.0,608,02,01,  Nandi Marich,140,355,66,168,74,187,28.3,28.2,28.4,00000
76.0,19.0,63.0,623,01,01,  Mundumala,123,628,77,293,46,335,16.4,20.8,12.1,00000
76.0,19.0,63.0,623,02,01,  Kalianjiri,119,333,69,173,50,160,26.3,28.5,23.8,00000
76.0,19.0,63.0,743,01,01,  Paramanandapur,260,278,136,127,124,151,48.3,51.7,45.1,00000
76.0,19.0,63.0,743,02,01,  Kathabaria,88,218,64,97,24,121,28.8,39.8,16.6,00000
76.0,19.0,79.0,158,01,01,  Bheramara,1116,962,566,454,550,508,53.7,55.5,52.0,00000
76.0,19.0,79.0,158,02,01,  Char Para,285,372,133,181,152,191,43.4,42.4,44.3,00000
76.0,19.0,79.0,353,01,01,  Hatgram,985,1074,519,522,466,552,47.8,49.9,45.8,00000
76.0,19.0,79.0,353,02,01,  Kalikadha,343,476,169,227,174,249,41.9,42.7,41.1,00000
76.0,19.0,79.0,353,03,01,  Madhurgati,86,114,55,56,31,58,43.0,49.5,34.8,00000
76.0,19.0,79.0,773,01,01,  Patharghata,526,503,264,214,262,289,51.1,55.2,47.5,00000
76.0,19.0,79.0,773,02,01,  Taltalia Para,263,179,132,82,131,97,59.5,61.7,57.5,00000
76.0,19.0,79.0,773,03,01,  Chakro Para,449,497,221,234,228,263,47.5,48.6,46.4,00000
76.0,19.0,79.0,773,04,01,  Baral Gussogram,55,99,26,52,29,47,35.7,33.3,38.2,00000
76.0,19.0,79.0,773,05,01,  Rokon Pur,38,93,20,50,18,43,29.0,28.6,29.5,00000
76.0,22.0,11.0,134,01,01,  Baradanagar,812,973,423,446,389,527,45.5,48.7,42.5,00000
76.0,22.0,11.0,134,02,01,  Banamalinagar,212,144,114,64,98,80,59.6,64.0,55.1,00000
76.0,22.0,11.0,134,03,01,  Kukragari,205,367,93,165,112,202,35.8,36.0,35.7,00000
76.0,22.0,11.0,264,01,01,  Char Madhupur,96,160,54,79,42,81,37.5,40.6,34.1,00000
76.0,22.0,11.0,264,02,01,  Uttarpara,343,392,181,182,162,210,46.7,49.9,43.5,00000
76.0,22.0,11.0,264,03,01,  Sunahar Para,423,516,225,247,198,269,45.0,47.7,42.4,00000
76.0,22.0,11.0,264,04,01,  Khara Para,188,351,104,171,84,180,34.9,37.8,31.8,00000
76.0,22.0,11.0,264,05,01,  Sarkar Para,209,294,104,143,105,151,41.6,42.1,41.0,00000
76.0,22.0,11.0,264,06,01,  Purbapara,472,691,254,345,218,346,40.6,42.4,38.7,00000
76.0,22.0,11.0,264,07,01,  Paschimpara,964,1583,493,761,471,822,37.8,39.3,36.4,00000
76.0,22.0,11.0,264,08,01,  Karikar Para,230,418,126,200,104,218,35.5,38.7,32.3,00000
76.0,22.0,11.0,264,09,01,  Sardar Para,160,398,81,190,79,208,28.7,29.9,27.5,00000
76.0,22.0,11.0,264,10,01,  Nadi Para,428,235,233,107,195,128,64.6,68.5,60.4,00000
76.0,22.0,11.0,264,11,01,  Fakir Para,267,226,142,111,125,115,54.2,56.1,52.1,00000
76.0,22.0,11.0,264,12,01,  Dakshinpara,307,330,176,146,131,184,48.2,54.7,41.6,00000
76.0,22.0,11.0,264,13,01,  Char Chhaikola,173,158,95,71,78,87,52.3,57.2,47.3,00000
76.0,22.0,11.0,264,14,01,  Sabuj Para,249,424,124,212,125,212,37.0,36.9,37.1,00000
76.0,22.0,11.0,341,01,01,  Dighalgaon,548,753,287,379,261,374,42.1,43.1,41.1,00000
76.0,22.0,11.0,341,02,01,  Kanai Char,228,649,127,309,101,340,26.0,29.1,22.9,00000
76.0,22.0,11.0,514,01,01,  Uttar Katenga Para,1409,2027,717,998,692,1029,41.0,41.8,40.2,00000
76.0,22.0,11.0,514,02,01,  Dakshin Katenga Para,678,699,346,339,332,360,49.2,50.5,48.0,00000
76.0,22.0,11.0,514,03,01,  Gobindanagar,37,135,19,64,18,71,21.5,22.9,20.2,00000
76.0,22.0,13.0,197,01,01,  Bonthar Paschim,690,433,353,208,337,225,61.4,62.9,60.0,00000
76.0,22.0,13.0,197,02,01,  Bonthar Purba,890,515,463,242,427,273,63.3,65.7,61.0,00000
76.0,22.0,13.0,197,03,01,  Sonaharpara,248,464,128,230,120,234,34.8,35.8,33.9,00000
76.0,22.0,13.0,990,01,01,  Notabriya,679,944,327,469,352,475,41.8,41.1,42.6,00000
76.0,22.0,13.0,990,02,01,  Char Sengram,384,497,199,238,185,259,43.6,45.5,41.7,00000
76.0,22.0,13.0,990,03,01,  Mohajer Para,127,183,59,100,68,83,41.0,37.1,45.0,00000
76.0,22.0,13.0,990,04,01,  Hindu Para,127,188,73,87,54,101,40.3,45.6,34.8,00000
76.0,22.0,13.0,990,05,01,  Dari Para,261,279,139,118,122,161,48.3,54.1,43.1,00000
76.0,22.0,13.0,990,06,01,  Dodariya,158,289,68,128,90,161,35.3,34.7,35.9,00000
76.0,22.0,34.0,482,01,01,  Kachugari,430,1100,238,517,192,583,28.1,31.5,24.8,00000
76.0,22.0,34.0,482,02,01,  Dupalia,33,101,18,55,15,46,24.6,24.7,24.6,00000
76.0,22.0,34.0,639,01,01,  Pobakhali,598,1288,325,626,273,662,31.7,34.2,29.2,00000
76.0,22.0,34.0,639,02,01,  Kadamtali,372,519,190,248,182,271,41.8,43.4,40.2,00000
76.0,22.0,34.0,639,03,01,  Kuyabashi,1001,1639,509,845,492,794,37.9,37.6,38.3,00000
76.0,22.0,34.0,639,04,01,  Chak Maram,188,371,100,175,88,196,33.6,36.4,31.0,00000
76.0,22.0,34.0,639,05,01,  Kuti Para,51,210,24,101,27,109,19.5,19.2,19.9,00000
76.0,22.0,34.0,639,06,01,  Jagannathpur,606,1795,308,908,298,887,25.2,25.3,25.1,00000
76.0,22.0,34.0,639,07,01,  Magar Para,381,388,206,175,175,213,49.5,54.1,45.1,00000
76.0,22.0,34.0,639,08,01,  Jabjabeya,704,600,404,266,300,334,54.0,60.3,47.3,00000
76.0,22.0,34.0,639,09,01,  Lakshmipur,954,1168,531,568,423,600,45.0,48.3,41.3,00000
76.0,22.0,34.0,639,10,01,  Idelpur,338,968,186,480,152,488,25.9,27.9,23.8,00000
76.0,22.0,34.0,639,11,01,  Kachia,303,395,152,179,151,216,43.4,45.9,41.1,00000
76.0,22.0,34.0,639,12,01,  Bara Dubla Para,107,571,64,288,43,283,15.8,18.2,13.2,00000
76.0,22.0,34.0,639,13,01,  Diar Para,295,801,158,402,137,399,26.9,28.2,25.6,00000
76.0,22.0,34.0,639,14,01,  Chhota Dubla Para,124,302,67,157,57,145,29.1,29.9,28.2,00000
76.0,22.0,43.0,129,01,01,  Bara Salikha,343,339,176,167,167,172,50.3,51.3,49.3,00000
76.0,22.0,43.0,129,02,01,  Hial Daha,278,196,137,93,141,103,58.6,59.6,57.8,00000
76.0,22.0,43.0,403,01,01,  Gunaigachha,534,731,271,367,263,364,42.2,42.5,41.9,00000
76.0,22.0,43.0,403,02,01,  Natun Para,382,325,197,142,185,183,54.0,58.1,50.3,00000
76.0,22.0,43.0,403,03,01,  Shibakhali,45,19,21,12,24,7,70.3,63.6,77.4,00000
76.0,22.0,43.0,403,04,01,  Daripara,88,141,40,77,48,64,38.4,34.2,42.9,00000
76.0,22.0,43.0,442,01,01,  Jabarkol,583,347,275,171,308,176,62.7,61.7,63.6,00000
76.0,22.0,43.0,442,02,01,  Pailanpur,801,612,382,288,419,324,56.7,57.0,56.4,00000
76.0,22.0,43.0,442,03,01,  Charpara,128,252,54,121,74,131,33.7,30.9,36.1,00000
76.0,22.0,43.0,442,04,01,  Bishipara,219,206,102,99,117,107,51.5,50.7,52.2,00000
76.0,22.0,43.0,826,01,01,  Purba Mathurapur,250,200,123,100,127,100,55.6,55.2,55.9,00000
76.0,22.0,43.0,826,02,01,  Charpara,611,519,313,241,298,278,54.1,56.5,51.7,00000
76.0,22.0,51.0,302,01,01,  Dakshin Patiata,227,151,118,59,109,92,60.1,66.7,54.2,00000
76.0,22.0,51.0,302,02,01,  Darabpur,242,216,117,102,125,114,52.8,53.4,52.3,00000
76.0,22.0,51.0,302,03,01,  Kharpukur,47,159,32,88,15,71,22.8,26.7,17.4,00000
76.0,22.0,51.0,927,01,01,  Sidhinagar,607,916,325,455,282,461,39.9,41.7,38.0,00000
76.0,22.0,51.0,927,02,01,  Hossainpur,131,280,75,135,56,145,31.9,35.7,27.9,00000
76.0,22.0,60.0,163,01,01,  Dhulauri,1990,2343,1042,1125,948,1218,45.9,48.1,43.8,00000
76.0,22.0,60.0,163,02,01,  Dayarampur,124,134,64,73,60,61,48.1,46.7,49.6,00000
76.0,22.0,60.0,163,03,01,  Jhankra,334,602,159,304,175,298,35.7,34.3,37.0,00000
76.0,22.0,70.0,038,01,01,  Araji Uthali Khamarpar,271,239,139,111,132,128,53.1,55.6,50.8,00000
76.0,22.0,70.0,038,02,01,  Rajar Diar,114,110,61,50,53,60,50.9,55.0,46.9,00000
76.0,22.0,70.0,273,01,01,  Chhota Guakhara,295,452,147,217,148,235,39.5,40.4,38.6,00000
76.0,22.0,70.0,273,02,01,  Bara Guakhara,707,466,346,225,361,241,60.3,60.6,60.0,00000
76.0,22.0,70.0,788,01,01,  Paschim Mathurapur,901,754,438,365,463,389,54.4,54.5,54.3,00000
76.0,22.0,70.0,788,02,01,  Purba Mathurapur,524,489,261,226,263,263,51.7,53.6,50.0,00000
76.0,22.0,70.0,970,01,01,  Uthali,580,415,280,176,300,239,58.3,61.4,55.7,00000
76.0,22.0,70.0,970,02,01,  Echakhali,103,76,50,31,53,45,57.5,61.7,54.1,00000
76.0,22.0,77.0,067,01,01,  Atlanka,477,648,222,317,255,331,42.4,41.2,43.5,00000
76.0,22.0,77.0,067,02,01,  Natungram,114,221,60,104,54,117,34.0,36.6,31.6,00000
76.0,22.0,77.0,067,03,01,  Bannagari,179,642,94,322,85,320,21.8,22.6,21.0,00000
76.0,22.0,77.0,067,04,01,  Shibpur,444,463,222,223,222,240,49.0,49.9,48.1,00000
76.0,22.0,77.0,547,01,01,  Dakshin Khatbari Para,70,304,36,155,34,149,18.7,18.8,18.6,00000
76.0,22.0,77.0,547,02,01,  Paschim Khatbari Para,426,527,227,245,199,282,44.7,48.1,41.4,00000
76.0,22.0,77.0,547,03,01,  Purba Khatbari Para,249,330,136,161,113,169,43.0,45.8,40.1,00000
76.0,22.0,86.0,110,01,01,  Baniabahau,114,279,63,135,51,144,29.0,31.8,26.2,00000
76.0,22.0,86.0,110,02,01,  Sonabahu,8,35,5,18,3,17,18.6,21.7,15.0,00000
76.0,22.0,86.0,283,01,01,  Chinabhatkur,698,1143,386,569,312,574,37.9,40.4,35.2,00000
76.0,22.0,86.0,283,02,01,  Binnabari,683,679,356,315,327,364,50.1,53.1,47.3,00000
76.0,22.0,86.0,283,03,01,  Dhankunia,662,1170,336,547,326,623,36.1,38.1,34.4,00000
76.0,22.0,86.0,379,01,01,  Gauripur,191,357,109,179,82,178,34.9,37.8,31.5,00000
76.0,22.0,86.0,379,02,01,  Kamulla,58,143,32,60,26,83,28.9,34.8,23.9,00000
76.0,22.0,86.0,379,03,01,  Belgachi,65,102,31,51,34,51,38.9,37.8,40.0,00000
76.0,22.0,86.0,379,04,01,  Chak Para,29,77,11,31,18,46,27.4,26.2,28.1,00000
76.0,22.0,86.0,504,01,01,  Karkola,487,914,282,452,205,462,34.8,38.4,30.7,00000
76.0,22.0,86.0,504,02,01,  Gournagar,218,440,119,220,99,220,33.1,35.1,31.0,00000
76.0,22.0,86.0,552,01,01,  Kola,65,135,33,65,32,70,32.5,33.7,31.4,00000
76.0,22.0,86.0,552,02,01,  Biswanathpur,33,167,19,82,14,85,16.5,18.8,14.1,00000
76.0,22.0,86.0,615,01,01,  Majhgaon,204,493,103,237,101,256,29.3,30.3,28.3,00000
76.0,22.0,86.0,615,02,01,  Par Majhgaon,76,362,36,180,40,182,17.4,16.7,18.0,00000
76.0,22.0,86.0,735,01,01,  Nimaichara,320,810,161,407,159,403,28.3,28.3,28.3,00000
76.0,22.0,86.0,735,02,01,  Par Nimaichhara,72,309,44,159,28,150,18.9,21.7,15.7,00000
76.0,22.0,86.0,735,03,01,  Darmagachha,49,101,26,43,23,58,32.7,37.7,28.4,00000
76.0,22.0,86.0,735,04,01,  Baradanagar,437,1324,245,679,192,645,24.8,26.5,22.9,00000
76.0,22.0,86.0,908,01,01,  Rajpara,38,144,19,68,19,76,20.9,21.8,20.0,00000
76.0,22.0,86.0,908,02,01,  Samaj Balajpur,307,806,163,387,144,419,27.6,29.6,25.6,00000
76.0,22.0,86.0,908,03,01,  Chala Para,220,287,122,136,98,151,43.4,47.3,39.4,00000
76.0,22.0,86.0,908,04,01,  Khandubaria,82,306,54,148,28,158,21.1,26.7,15.1,00000
76.0,22.0,86.0,908,05,01,  Miapara,426,477,220,223,206,254,47.2,49.7,44.8,00000
76.0,22.0,86.0,908,06,01,  Karatkandi,129,676,74,310,55,366,16.0,19.3,13.1,00000
76.0,22.0,86.0,908,07,01,  Dakshin Samaj Para,187,802,101,402,86,400,18.9,20.1,17.7,00000
76.0,22.0,86.0,908,08,01,  Sitlai,276,644,168,317,108,327,30.0,34.6,24.8,00000
76.0,22.0,94.0,596,01,01,  Mahela,1182,1204,585,532,597,672,49.5,52.4,47.0,00000
76.0,22.0,94.0,596,02,01,  Barkona,285,265,130,137,155,128,51.8,48.7,54.8,00000
76.0,22.0,94.0,783,01,01,  Parshadanga,689,1180,339,578,350,602,36.9,37.0,36.8,00000
76.0,22.0,94.0,783,02,01,  Alipur,461,414,253,191,208,223,52.7,57.0,48.3,00000
76.0,22.0,94.0,783,03,01,  Baludiar,133,227,76,109,57,118,36.9,41.1,32.6,00000
76.0,33.0,10.0,585,01,01,  Khalisadaha,572,978,298,467,274,511,36.9,39.0,34.9,00000
76.0,33.0,10.0,585,02,01,  Maderjani,421,562,218,285,203,277,42.8,43.3,42.3,00000
76.0,33.0,10.0,585,03,01,  Banwarinagar,152,274,66,144,86,130,35.7,31.4,39.8,00000
76.0,33.0,10.0,585,04,01,  Dakshin Tiak Para,176,153,103,79,73,74,53.5,56.6,49.7,00000
76.0,33.0,10.0,585,05,01,  Natun Para Kalisada,270,284,123,148,147,136,48.7,45.4,51.9,00000
76.0,33.0,10.0,901,01,01,  Uttar Gopal Nagar,388,675,200,325,188,350,36.5,38.1,34.9,00000
76.0,33.0,10.0,901,02,01,  Dakhin Gopal Nagar,625,1211,273,624,352,587,34.0,30.4,37.5,00000
76.0,33.0,10.0,901,03,01,  Uttar Sona Hara,178,286,85,141,93,145,38.4,37.6,39.1,00000
76.0,33.0,10.0,901,04,01,  Madhya Sona Hara,158,259,85,119,73,140,37.9,41.7,34.3,00000
76.0,33.0,10.0,901,05,01,  Dakhin Sona Hara,268,390,143,184,125,206,40.7,43.7,37.8,00000
76.0,33.0,10.0,901,06,01,  Kashipur,290,585,150,279,140,306,33.1,35.0,31.4,00000
76.0,33.0,10.0,983,01,01,  Uttar Sonahara,158,266,70,138,88,128,37.3,33.7,40.7,00000
76.0,33.0,10.0,983,02,01,  Madhya Sona Hara,158,120,78,54,80,66,56.8,59.1,54.8,00000
76.0,33.0,10.0,983,03,01,  Dakshin Sona Hara,84,108,42,56,42,52,43.8,42.9,44.7,00000
76.0,33.0,31.0,234,01,01,  Bri-Lahiribari,1133,1325,601,610,532,715,46.1,49.6,42.7,00000
76.0,33.0,31.0,234,02,01,  Ramnagar,841,282,398,132,443,150,74.9,75.1,74.7,00000
76.0,33.0,42.0,339,01,01,  Demra,1822,2453,976,1191,846,1262,42.6,45.0,40.1,00000
76.0,33.0,42.0,339,02,01,  Demra Char Para,152,310,84,156,68,154,32.9,35.0,30.6,00000
76.0,33.0,42.0,538,01,01,  Kalyani,1071,808,547,370,524,438,57.0,59.7,54.5,00000
76.0,33.0,42.0,538,02,01,  Brikalyani,151,221,77,114,74,107,40.6,40.3,40.9,00000
76.0,33.0,42.0,550,01,01,  Chak Chakia,383,214,199,96,184,118,64.2,67.5,60.9,00000
76.0,33.0,42.0,550,02,01,  Bara Golkata,165,138,91,65,74,73,54.5,58.3,50.3,00000
76.0,33.0,42.0,550,03,01,  Chhota Golkata,270,173,137,81,133,92,60.9,62.8,59.1,00000
76.0,33.0,42.0,795,01,01,  Mridha Para,396,565,209,269,187,296,41.2,43.7,38.7,00000
76.0,33.0,42.0,795,02,01,  Haro Danga Char Para,104,176,51,84,53,92,37.1,37.8,36.6,00000
76.0,33.0,42.0,795,03,01,  Harodanga,179,476,94,249,85,227,27.3,27.4,27.2,00000
76.0,33.0,42.0,795,04,01,  Khagoria,189,639,103,323,86,316,22.8,24.2,21.4,00000
76.0,33.0,42.0,795,05,01,  Shakpala,319,283,154,156,165,127,53.0,49.7,56.5,00000
76.0,33.0,42.0,795,06,01,  Panchuriabari,302,756,151,381,151,375,28.5,28.4,28.7,00000
76.0,33.0,42.0,795,07,01,  Zianagar,17,214,9,111,8,103,7.4,7.5,7.2,00000
76.0,33.0,52.0,409,01,01,  Berhaulia,1774,1858,907,846,867,1012,48.8,51.7,46.1,00000
76.0,33.0,52.0,409,02,01,  Hangragari,261,330,133,155,128,175,44.2,46.2,42.2,00000
76.0,33.0,52.0,409,03,01,  Krishnanagar,240,179,114,91,126,88,57.3,55.6,58.9,00000
76.0,33.0,52.0,409,04,01,  Bil Bakri,403,328,202,160,201,168,55.1,55.8,54.5,00000
76.0,33.0,52.0,409,05,01,  Chandpur,169,253,85,115,84,138,40.0,42.5,37.8,00000
76.0,33.0,52.0,409,06,01,  Par Faridpur,708,527,341,260,367,267,57.3,56.7,57.9,00000
76.0,33.0,52.0,409,07,01,  Nesra Para,580,1297,303,658,277,639,30.9,31.5,30.2,00000
76.0,33.0,52.0,409,08,01,  Kachua Para,50,56,26,26,24,30,47.2,50.0,44.4,00000
76.0,33.0,52.0,924,01,01,  Sabar Khagarbaria,1327,2628,672,1314,655,1314,33.6,33.8,33.3,00000
76.0,33.0,52.0,924,02,01,  Sabar,438,1058,238,501,200,557,29.3,32.2,26.4,00000
76.0,33.0,63.0,433,01,01,  Hadal,1332,2337,753,1175,579,1162,36.3,39.1,33.3,00000
76.0,33.0,63.0,433,02,01,  Khetabagha,150,382,93,169,57,213,28.2,35.5,21.1,00000
76.0,33.0,63.0,632,01,01,  Kuchlia,207,423,107,210,100,213,32.9,33.8,31.9,00000
76.0,33.0,63.0,632,02,01,  Bhata Kuchlia,159,81,84,40,75,41,66.3,67.7,64.7,00000
76.0,33.0,63.0,632,03,01,  Bannakandi,144,415,78,199,66,216,25.8,28.2,23.4,00000
76.0,33.0,63.0,678,01,01,  Manangram,74,437,34,230,40,207,14.5,12.9,16.2,00000
76.0,33.0,63.0,678,02,01,  Mangalgram,744,1517,360,780,384,737,32.9,31.6,34.3,00000
76.0,33.0,63.0,678,03,01,  Haripur,68,121,40,65,28,56,36.0,38.1,33.3,00000
76.0,33.0,63.0,690,01,01,  Maud,378,778,207,366,171,412,32.7,36.1,29.3,00000
76.0,33.0,63.0,690,02,01,  Puratan Maud,188,235,87,133,101,102,44.4,39.5,49.8,00000
76.0,33.0,63.0,690,03,01,  Salika Para,225,250,125,104,100,146,47.4,54.6,40.7,00000
76.0,33.0,63.0,690,04,01,  Masiamura,324,557,171,283,153,274,36.8,37.7,35.8,00000
76.0,33.0,63.0,784,01,01,  Dhanuaghata,1013,1668,525,805,488,863,37.8,39.5,36.1,00000
76.0,33.0,63.0,784,02,01,  Balughata,496,696,259,339,237,357,41.6,43.3,39.9,00000
76.0,33.0,84.0,023,01,01,  Agpungali,781,1478,422,678,359,800,34.6,38.4,31.0,00000
76.0,33.0,84.0,023,02,01,  Bayra Para,211,445,124,213,87,232,32.2,36.8,27.3,00000
76.0,33.0,84.0,023,03,01,  Masdaghata,263,431,143,201,120,230,37.9,41.6,34.3,00000
76.0,33.0,84.0,023,04,01,  Take Para,68,219,37,106,31,113,23.7,25.9,21.5,00000
76.0,33.0,84.0,971,01,01,  Dighalia Uttarpara,1085,1412,601,669,484,743,43.5,47.3,39.4,00000
76.0,33.0,84.0,971,02,01,  Dighalia Dakshinpara,1066,1156,584,534,482,622,48.0,52.2,43.7,00000
76.0,39.0,42.0,134,01,01,  Baharpur,705,507,352,259,353,248,58.2,57.6,58.7,00000
76.0,39.0,42.0,134,02,01,  Rajanagar,572,318,292,148,280,170,64.3,66.4,62.2,00000
76.0,39.0,42.0,920,01,01,  Saraikandi,431,459,217,241,214,218,48.4,47.4,49.5,00000
76.0,39.0,42.0,920,02,01,  Dargah Para,682,509,321,279,361,230,57.3,53.5,61.1,00000
76.0,39.0,42.0,920,03,01,  Kurighar Para,304,191,142,104,162,87,61.4,57.7,65.1,00000
76.0,39.0,42.0,920,04,01,  Ramnathpur,220,210,92,112,128,98,51.2,45.1,56.6,00000
76.0,39.0,42.0,927,01,01,  Sekh Para,639,923,312,451,327,472,40.9,40.9,40.9,00000
76.0,39.0,42.0,927,02,01,  Hazari Para,390,415,193,211,197,204,48.4,47.8,49.1,00000
76.0,39.0,52.0,119,01,01,  Baghail,5302,3277,2795,1613,2507,1664,61.8,63.4,60.1,00000
76.0,39.0,52.0,119,02,01,  Zuktitala,1744,711,899,343,845,368,71.0,72.4,69.7,00000
76.0,39.0,52.0,119,03,01,  Civil Hat,317,151,161,68,156,83,67.7,70.3,65.3,00000
76.0,39.0,52.0,344,01,01,  Char Ruppur,5625,2931,2679,1391,2946,1540,65.7,65.8,65.7,00000
76.0,39.0,52.0,344,02,01,  Notun Puppur,1720,859,833,395,887,464,66.7,67.8,65.7,00000
76.0,39.0,52.0,433,01,01,  Diar Baghail,3822,1945,2000,990,1822,955,66.3,66.9,65.6,00000
76.0,39.0,52.0,433,02,01,  Babu Para,772,101,408,43,364,58,88.4,90.5,86.3,00000
76.0,39.0,52.0,433,03,01,  Jhaotala,916,362,468,159,448,203,71.7,74.6,68.8,00000
76.0,39.0,63.0,097,01,01,  Babulchara,1510,2190,642,1068,868,1122,40.8,37.5,43.6,00000
76.0,39.0,63.0,097,02,01,  Dhigha,591,852,289,413,302,439,41.0,41.2,40.8,00000
76.0,39.0,63.0,097,03,01,  Ghargari,747,630,394,311,353,319,54.2,55.9,52.5,00000
76.0,39.0,63.0,097,04,01,  Tilakpur,685,786,289,367,396,419,46.6,44.1,48.6,00000
76.0,39.0,63.0,097,05,01,  Rahimpur,803,927,351,459,452,468,46.4,43.3,49.1,00000
76.0,39.0,63.0,890,01,01,  Sahapur,4681,4135,2223,2126,2458,2009,53.1,51.1,55.0,00000
76.0,39.0,63.0,890,02,01,  Diarsapara,932,794,435,415,497,379,54.0,51.2,56.7,00000
76.0,39.0,63.0,890,03,01,  Char Sahapur,574,340,280,172,294,168,62.8,61.9,63.6,00000
76.0,39.0,73.0,336,01,01,  Char Mirkamari,3094,1826,1598,973,1496,853,62.9,62.2,63.7,00000
76.0,39.0,73.0,336,02,01,  Baraichhara,1890,1346,914,714,976,632,58.4,56.1,60.7,00000
76.0,39.0,73.0,336,03,01,  Kallarkandi,345,192,179,107,166,85,64.2,62.6,66.1,00000
76.0,39.0,73.0,336,04,01,  Shakerdiar,104,93,48,49,56,44,52.8,49.5,56.0,00000
76.0,39.0,73.0,336,05,01,  Mathal Para,1295,825,633,447,662,378,61.1,58.6,63.7,00000
76.0,39.0,73.0,336,06,01,  Nowdapara,318,435,162,211,156,224,42.2,43.4,41.1,00000
76.0,39.0,73.0,336,07,01,  Mirkamari (Part),52,103,24,61,28,42,33.5,28.2,40.0,00000
76.0,39.0,73.0,351,01,01,  Char Silimpur,302,535,137,258,165,277,36.1,34.7,37.3,00000
76.0,39.0,73.0,351,02,01,  Baktherpur,752,616,357,346,395,270,55.0,50.8,59.4,00000
76.0,39.0,73.0,351,03,01,  Kathalbaria,414,324,204,166,210,158,56.1,55.1,57.1,00000
76.0,39.0,73.0,351,04,01,  Puradiar,294,350,132,192,162,158,45.7,40.7,50.6,00000
76.0,39.0,73.0,351,05,01,  Kharediar,360,490,176,273,184,217,42.4,39.2,45.9,00000
76.0,39.0,73.0,351,06,01,  Charkadimpara,559,303,264,158,295,145,64.8,62.6,67.0,00000
76.0,39.0,73.0,538,01,01,  Jagannathpur,1458,1740,703,908,755,832,45.6,43.6,47.6,00000
76.0,39.0,73.0,538,02,01,  Mirkamari,1437,924,771,473,666,451,60.9,62.0,59.6,00000
76.0,39.0,73.0,538,03,01,  Shaker Dieyr (Part),546,379,275,192,271,187,59.0,58.9,59.2,00000
76.0,39.0,73.0,538,04,01,  Amsardari,443,408,223,220,220,188,52.1,50.3,53.9,00000
76.0,39.0,73.0,576,01,01,  Joynagar,3383,2066,1758,1036,1625,1030,62.1,62.9,61.2,00000
76.0,39.0,73.0,576,02,01,  Mirkamari  (Part),261,200,131,101,130,99,56.6,56.5,56.8,00000
76.0,39.0,84.0,680,01,01,  Ilshamari,585,423,296,193,289,230,58.0,60.5,55.7,00000
76.0,39.0,84.0,680,02,01,  Gaokulnagar,1203,833,594,405,609,428,59.1,59.5,58.7,00000
76.0,39.0,84.0,680,03,01,  Mazdia (Rail&Munsipara),3193,2973,1606,1489,1587,1484,51.8,51.9,51.7,00000
76.0,39.0,84.0,905,01,01,  Sara,644,726,332,377,312,349,47.0,46.8,47.2,00000
76.0,39.0,84.0,905,02,01,  Saheb Nagor,81,166,47,82,34,84,32.8,36.4,28.8,00000
76.0,55.0,16.0,019,01,01,  Ataikola,1223,2201,654,1104,569,1097,35.7,37.2,34.2,00000
76.0,55.0,16.0,019,02,01,  Saradangi,810,669,439,336,371,333,54.8,56.6,52.7,00000
76.0,55.0,16.0,019,03,01,  Tajiar Para,237,464,117,229,120,235,33.8,33.8,33.8,00000
76.0,55.0,17.0,110,01,01,  Diarpar,346,969,150,464,196,505,26.3,24.4,28.0,00000
76.0,55.0,17.0,110,02,01,  Kalurpar,474,590,223,283,251,307,44.5,44.1,45.0,00000
76.0,55.0,17.0,110,03,01,  Ataikanda,430,647,213,290,217,357,39.9,42.3,37.8,00000
76.0,55.0,17.0,110,04,01,  Katuli,219,842,93,447,126,395,20.6,17.2,24.2,00000
76.0,55.0,17.0,110,05,01,  Natun Para,304,504,134,233,170,271,37.6,36.5,38.5,00000
76.0,55.0,17.0,110,06,01,  Purba Kadim,232,488,111,224,121,264,32.2,33.1,31.4,00000
76.0,55.0,17.0,110,07,01,  Paschim Kadim,143,583,64,287,79,296,19.7,18.2,21.1,00000
76.0,55.0,17.0,182,01,01,  Purba Char Bhabanipur,243,796,113,371,130,425,23.4,23.3,23.4,00000
76.0,55.0,17.0,182,02,01,  Paschim Char Bhabanipur,132,703,70,351,62,352,15.8,16.6,15.0,00000
76.0,55.0,17.0,459,01,01,  Purba Jamua,259,311,119,161,140,150,45.4,42.5,48.3,00000
76.0,55.0,17.0,459,02,01,  Madhya Jamua,541,958,225,485,316,473,36.1,31.7,40.1,00000
76.0,55.0,17.0,459,03,01,  Paschim Jamua,411,776,170,400,241,376,34.6,29.8,39.1,00000
76.0,55.0,17.0,459,04,01,  Dighalkandi,251,395,131,192,120,203,38.9,40.6,37.2,00000
76.0,55.0,17.0,586,01,01,  Khurda Chandpur,203,283,104,150,99,133,41.8,40.9,42.7,00000
76.0,55.0,17.0,586,02,01,  Char Khurda Chandpur,20,42,11,27,9,15,32.3,28.9,37.5,00000
76.0,55.0,17.0,598,01,01,  Purba Koladi,1135,1700,535,805,600,895,40.0,39.9,40.1,00000
76.0,55.0,17.0,598,02,01,  Paschim Koladi,333,468,162,223,171,245,41.6,42.1,41.1,00000
76.0,55.0,25.0,241,01,01,  Baliadangi,456,380,227,196,229,184,54.5,53.7,55.4,00000
76.0,55.0,25.0,241,02,01,  Aria Gohailbari,338,494,159,258,179,236,40.6,38.1,43.1,00000
76.0,55.0,25.0,241,03,01,  Natun Tanti Para,338,440,180,212,158,228,43.4,45.9,40.9,00000
76.0,55.0,25.0,241,04,01,  Tanti Para,1127,1086,563,530,564,556,50.9,51.5,50.4,00000
76.0,55.0,25.0,241,05,01,  Chowkidar Para,264,411,135,223,129,188,39.1,37.7,40.7,00000
76.0,55.0,25.0,241,06,01,  Daspara,465,674,218,319,247,355,40.8,40.6,41.0,00000
76.0,55.0,25.0,241,07,01,  Khapadangi,30,94,16,50,14,44,24.2,24.2,24.1,00000
76.0,55.0,25.0,241,08,01,  Atgharia Para,85,474,44,220,41,254,15.2,16.7,13.9,00000
76.0,55.0,25.0,241,09,01,  Kanchi Para,494,593,235,279,259,314,45.4,45.7,45.2,00000
76.0,55.0,25.0,241,10,01,  Natun Gohailbari,511,896,229,447,282,449,36.3,33.9,38.6,00000
76.0,55.0,25.0,241,11,01,  Dighi Gohailbari,254,740,110,365,144,375,25.6,23.2,27.7,00000
76.0,55.0,25.0,241,12,01,  Bhaduriadangi,280,686,175,370,105,316,29.0,32.1,24.9,00000
76.0,55.0,25.0,241,13,01,  Bahir Char,248,452,112,243,136,209,35.4,31.5,39.4,00000
76.0,55.0,25.0,241,14,01,  Hogladangi,123,310,63,162,60,148,28.4,28.0,28.8,00000
76.0,55.0,25.0,241,15,01,  Bakchi Para,109,441,57,214,52,227,19.8,21.0,18.6,00000
76.0,55.0,25.0,241,16,01,  Kolchhari,679,1587,321,803,358,784,30.0,28.6,31.3,00000
76.0,55.0,25.0,241,17,01,  Sukchar,561,1015,262,489,299,526,35.6,34.9,36.2,00000
76.0,55.0,25.0,241,18,01,  Bakchidangi,330,778,163,381,167,397,29.8,30.0,29.6,00000
76.0,55.0,25.0,582,01,01,  Tarabari Purbapara,1361,1710,689,825,672,885,44.3,45.5,43.2,00000
76.0,55.0,25.0,582,02,01,  Tarabari Paschimpara,1280,1880,632,903,648,977,40.5,41.2,39.9,00000
76.0,55.0,43.0,178,01,01,  Ashutosh,2282,4589,1108,2296,1174,2293,33.2,32.5,33.9,00000
76.0,55.0,43.0,178,02,01,  Dipchar,2988,2985,1407,1506,1581,1479,50.0,48.3,51.7,00000
76.0,55.0,43.0,634,01,01,  Rajapur,1518,1811,763,904,755,907,45.6,45.8,45.4,00000
76.0,55.0,43.0,634,02,01,  Dia Rajapur,364,551,173,267,191,284,39.8,39.3,40.2,00000
76.0,55.0,51.0,416,01,01,  Hamidpur,483,961,246,462,237,499,33.4,34.7,32.2,00000
76.0,55.0,51.0,416,02,01,  Pirgachha,156,235,86,118,70,117,39.9,42.2,37.4,00000
76.0,55.0,51.0,646,01,01,  Uttar Machhimpur,551,628,271,321,280,307,46.7,45.8,47.7,00000
76.0,55.0,51.0,646,02,01,  Dakshin Machhimpur,932,673,631,358,301,315,58.1,63.8,48.9,00000
76.0,55.0,60.0,043,01,01,  Char Banga Bari,898,501,467,236,431,265,64.2,66.4,61.9,00000
76.0,55.0,60.0,043,02,01,  Sanirdiar,483,410,247,199,236,211,54.1,55.4,52.8,00000
76.0,55.0,60.0,133,01,01,  Bhagiratpur,218,224,108,116,110,108,49.3,48.2,50.5,00000
76.0,55.0,60.0,133,02,01,  Vurrasam,95,337,37,192,58,145,22.0,16.2,28.6,00000
76.0,55.0,60.0,432,01,01,  Hemayetpur,2083,1879,1004,911,1079,968,52.6,52.4,52.7,00000
76.0,55.0,60.0,432,02,01,  Baikunthapur,349,318,224,151,125,167,52.3,59.7,42.8,00000
76.0,55.0,60.0,479,01,01,  Afuri,820,812,391,409,429,403,50.2,48.9,51.6,00000
76.0,55.0,60.0,479,02,01,  Kumargari,244,302,118,159,126,143,44.7,42.6,46.8,00000
76.0,55.0,60.0,590,01,01,  Kismat Pratappur,650,985,322,539,328,446,39.8,37.4,42.4,00000
76.0,55.0,60.0,590,02,01,  Islampur,128,335,59,198,69,137,27.6,23.0,33.5,00000
76.0,55.0,60.0,769,01,01,  Panchuria,258,404,135,231,123,173,39.0,36.9,41.6,00000
76.0,55.0,60.0,769,02,01,  Bangabari,239,144,122,58,117,86,62.4,67.8,57.6,00000
76.0,55.0,69.0,122,01,01,  Bil Kula,244,291,113,153,131,138,45.6,42.5,48.7,00000
76.0,55.0,69.0,122,02,01,  Hossainpur,92,199,42,107,50,92,31.6,28.2,35.2,00000
76.0,55.0,69.0,348,01,01,  Fakirpur,427,671,195,325,232,346,38.9,37.5,40.1,00000
76.0,55.0,69.0,348,02,01,  Bri Gurampur,194,266,92,145,102,121,42.2,38.8,45.7,00000
76.0,55.0,69.0,412,01,01,  Hamchapur,636,543,326,254,310,289,53.9,56.2,51.8,00000
76.0,55.0,69.0,412,02,01,  Bhabanipur,387,349,155,206,232,143,52.6,42.9,61.9,00000
76.0,55.0,69.0,943,01,01,  Noydapara,113,83,51,49,62,34,57.7,51.0,64.6,00000
76.0,55.0,69.0,943,02,01,  Sreedharpur,269,339,134,179,135,160,44.2,42.8,45.8,00000
76.0,55.0,77.0,384,01,01,  Gharlagra,1033,1436,462,731,571,705,41.8,38.7,44.7,00000
76.0,55.0,77.0,384,02,01,  Ruppur,633,767,278,422,355,345,45.2,39.7,50.7,00000
76.0,55.0,77.0,384,03,01,  Gopalpur,191,338,88,167,103,171,36.1,34.5,37.6,00000
76.0,55.0,77.0,384,04,01,  Nutan Bhangabaria,237,321,105,167,132,154,42.5,38.6,46.2,00000
76.0,55.0,77.0,384,05,01,  Puratan Bhangabaria,267,506,126,263,141,243,34.5,32.4,36.7,00000
76.0,55.0,77.0,384,06,01,  Naoda Para,274,332,118,174,156,158,45.2,40.4,49.7,00000
76.0,55.0,77.0,384,07,01,  Badal Para,287,293,141,157,146,136,49.5,47.3,51.8,00000
76.0,55.0,77.0,677,01,01,  Maligachha,1157,1308,542,660,615,648,46.9,45.1,48.7,00000
76.0,55.0,77.0,677,02,01,  Jotkalsa,206,291,93,148,113,143,41.4,38.6,44.1,00000
76.0,55.0,77.0,681,01,01,  Manoharpur,1053,1087,496,547,557,540,49.2,47.6,50.8,00000
76.0,55.0,77.0,681,02,01,  Chhota Manoharpur,581,691,277,355,304,336,45.7,43.8,47.5,00000
76.0,55.0,77.0,840,01,01,  Kumargari,455,373,234,196,221,177,55.0,54.4,55.5,00000
76.0,55.0,77.0,840,02,01,  Gaspara,381,522,167,264,214,258,42.2,38.7,45.3,00000
76.0,55.0,77.0,840,03,01,  Ramanandapur,756,1375,341,716,415,659,35.5,32.3,38.6,00000
76.0,55.0,77.0,840,04,01,  Bil Veduri,867,944,416,461,451,483,47.9,47.4,48.3,00000
76.0,55.0,77.0,840,05,01,  Chak Ramanandapur,433,409,208,207,225,202,51.4,50.1,52.7,00000
76.0,55.0,77.0,840,06,01,  Chak Joyenpur,531,191,267,81,264,110,73.5,76.7,70.6,00000
76.0,55.0,94.0,352,01,01,  Faradpur,377,931,173,471,204,460,28.8,26.9,30.7,00000
76.0,55.0,94.0,352,02,01,  Daspara,297,640,139,334,158,306,31.7,29.4,34.1,00000
76.0,55.0,94.0,947,01,01,  Sreekul,957,2018,442,997,515,1021,32.2,30.7,33.5,00000
76.0,55.0,94.0,947,02,01,  Dari Sreekul,332,515,138,247,194,268,39.2,35.8,42.0,00000
76.0,55.0,94.0,971,01,01,  Teligram,918,1509,467,769,451,740,37.8,37.8,37.9,00000
76.0,55.0,94.0,971,02,01,  Char Para,363,816,176,419,187,397,30.8,29.6,32.0,00000
76.0,55.0,94.0,971,03,01,  Kamardanga,259,625,126,325,133,300,29.3,27.9,30.7,00000
76.0,72.0,15.0,062,01,01,  Bangaon,2246,1915,1146,925,1100,990,54.0,55.3,52.6,00000
76.0,72.0,15.0,062,02,01,  Bamandanga,622,548,291,247,331,301,53.2,54.1,52.4,00000
76.0,72.0,15.0,169,01,01,  Atiadangi,302,588,159,298,143,290,33.9,34.8,33.0,00000
76.0,72.0,15.0,169,02,01,  Chaitrahati,274,716,138,339,136,377,27.7,28.9,26.5,00000
76.0,72.0,15.0,305,01,01,  Gangahati,1559,1124,801,525,758,599,58.1,60.4,55.9,00000
76.0,72.0,15.0,305,02,01,  Gangahati Nutan Para,333,255,154,112,179,143,56.6,57.9,55.6,00000
76.0,72.0,15.0,305,03,01,  Char Para,861,899,414,453,447,446,48.9,47.8,50.1,00000
76.0,72.0,15.0,537,01,01,  Kumirgari,812,784,386,381,426,403,50.9,50.3,51.4,00000
76.0,72.0,15.0,537,02,01,  Islampur,132,167,66,84,66,83,44.1,44.0,44.3,00000
76.0,72.0,15.0,763,01,01,  Raghunathpur,4232,2125,2208,1063,2024,1062,66.6,67.5,65.6,00000
76.0,72.0,15.0,763,02,01,  Putigari,749,1084,400,521,349,563,40.9,43.4,38.3,00000
76.0,72.0,17.0,299,01,01,  Ganeshpur,255,497,125,251,130,246,33.9,33.2,34.6,00000
76.0,72.0,17.0,299,02,01,  Bhoina Para,215,265,114,131,101,134,44.8,46.5,43.0,00000
76.0,72.0,17.0,299,03,01,  Kalugram,60,133,36,62,24,71,31.1,36.7,25.3,00000
76.0,72.0,17.0,424,01,01,  Jagannathpur,523,895,274,448,249,447,36.9,38.0,35.8,00000
76.0,72.0,17.0,424,02,01,  Gosai Para,244,503,124,259,120,244,32.7,32.4,33.0,00000
76.0,72.0,17.0,955,01,01,  Swargram,812,1116,398,602,414,514,42.1,39.8,44.6,00000
76.0,72.0,17.0,955,02,01,  Swar Bhabanipur,185,858,94,417,91,441,17.7,18.4,17.1,00000
76.0,72.0,25.0,265,01,01,  Dhopadaha,897,1063,468,517,429,546,45.8,47.5,44.0,00000
76.0,72.0,25.0,265,02,01,  Porat,364,346,185,184,179,162,51.3,50.1,52.5,00000
76.0,72.0,25.0,339,01,01,  Gopalpur,600,720,296,345,304,375,45.5,46.2,44.8,00000
76.0,72.0,25.0,339,02,01,  Paikasha,425,697,218,344,207,353,37.9,38.8,37.0,00000
76.0,72.0,25.0,339,03,01,  Par Gopalpur,648,514,338,238,310,276,55.8,58.7,52.9,00000
76.0,72.0,25.0,361,01,01,  Haludaghar,735,1021,390,506,345,515,41.9,43.5,40.1,00000
76.0,72.0,25.0,361,02,01,  Dayarampur,344,408,179,183,165,225,45.7,49.4,42.3,00000
76.0,72.0,25.0,593,01,01,  Matka,315,731,168,360,147,371,30.1,31.8,28.4,00000
76.0,72.0,25.0,593,02,01,  Chak Madhupur,309,433,157,221,152,212,41.6,41.5,41.8,00000
76.0,72.0,34.0,005,01,01,  Alakdiar,796,992,414,466,382,526,44.5,47.0,42.1,00000
76.0,72.0,34.0,005,02,01,  Terkhada,163,374,82,183,81,191,30.4,30.9,29.8,00000
76.0,72.0,34.0,141,01,01,  Bil Salangi,501,684,252,325,249,359,42.3,43.7,41.0,00000
76.0,72.0,34.0,141,02,01,  Matharbaria,228,399,125,203,103,196,36.4,38.1,34.4,00000
76.0,72.0,34.0,141,03,01,  Kashinathpur,115,139,48,59,67,80,45.3,44.9,45.6,00000
76.0,72.0,34.0,271,01,01,  Dhulauri,2318,1851,1239,849,1079,1002,55.6,59.3,51.9,00000
76.0,72.0,34.0,271,02,01,  Puran Dhulauri,261,305,128,156,133,149,46.1,45.1,47.2,00000
76.0,72.0,34.0,271,03,01,  Nutan Dhulauri,528,1200,261,608,267,592,30.6,30.0,31.1,00000
76.0,72.0,34.0,819,01,01,  Rupsi,265,694,130,352,135,342,27.6,27.0,28.3,00000
76.0,72.0,34.0,819,02,01,  Baushgari,491,698,248,351,243,347,41.3,41.4,41.2,00000
76.0,72.0,34.0,819,03,01,  Lakshmipur,568,767,278,379,290,388,42.5,42.3,42.8,00000
76.0,72.0,34.0,927,01,01,  Sonakandar,210,359,109,173,101,186,36.9,38.7,35.2,00000
76.0,72.0,34.0,927,02,01,  Char Para,775,1253,392,642,383,611,38.2,37.9,38.5,00000
76.0,72.0,34.0,927,03,01,  Daharzani,727,699,375,333,352,366,51.0,53.0,49.0,00000
76.0,72.0,43.0,028,01,01,  Arazi Gopinathpur,258,433,135,217,123,216,37.3,38.4,36.3,00000
76.0,72.0,43.0,028,02,01,  Satbila,235,369,119,181,116,188,38.9,39.7,38.2,00000
76.0,72.0,43.0,028,03,01,  Satanir Char,322,676,173,348,149,328,32.3,33.2,31.2,00000
76.0,72.0,43.0,310,01,01,  Gaurigram,1168,1357,589,683,579,674,46.3,46.3,46.2,00000
76.0,72.0,43.0,310,02,01,  Bil Mahishar Char,505,366,265,178,240,188,58.0,59.8,56.1,00000
76.0,72.0,43.0,310,03,01,  Ikorjana,206,672,102,312,104,360,23.5,24.6,22.4,00000
76.0,72.0,43.0,310,04,01,  Ghona Para,128,355,75,176,53,179,26.5,29.9,22.8,00000
76.0,72.0,43.0,310,05,01,  Chak Patta,192,424,97,218,95,206,31.2,30.8,31.6,00000
76.0,72.0,43.0,310,06,01,  Gaurigram Dakshinpara,148,226,81,110,67,116,39.6,42.4,36.6,00000
76.0,72.0,43.0,322,01,01,  Ghughudaha,1286,2891,684,1366,602,1525,30.8,33.4,28.3,00000
76.0,72.0,43.0,322,02,01,  Rayekmari,177,275,102,133,75,142,39.2,43.4,34.6,00000
76.0,72.0,43.0,542,01,01,  Machhkhali,165,181,84,78,81,103,47.7,51.9,44.0,00000
76.0,72.0,43.0,542,02,01,  Baliakandi,125,225,76,105,49,120,35.7,42.0,29.0,00000
76.0,72.0,43.0,542,03,01,  Char Machhkhali,387,452,209,213,178,239,46.1,49.5,42.7,00000
76.0,72.0,43.0,672,01,01,  Pakuria,123,185,64,90,59,95,39.9,41.6,38.3,00000
76.0,72.0,43.0,672,02,01,  Char Pakuria,257,376,141,182,116,194,40.6,43.7,37.4,00000
76.0,72.0,43.0,672,03,01,  Sukchar,135,189,65,92,70,97,41.7,41.4,41.9,00000
76.0,72.0,43.0,672,04,01,  Char Bandiram,433,475,218,240,215,235,47.7,47.6,47.8,00000
76.0,72.0,43.0,672,05,01,  Puran Char,380,490,196,252,184,238,43.7,43.8,43.6,00000
76.0,72.0,43.0,898,01,01,  Shibrampur,186,173,83,84,103,89,51.8,49.7,53.6,00000
76.0,72.0,43.0,898,02,01,  Shibrampur Purbapara,157,184,75,84,82,100,46.0,47.2,45.1,00000
76.0,72.0,51.0,073,01,01,  Baragram,313,517,183,254,130,263,37.7,41.9,33.1,00000
76.0,72.0,51.0,073,02,01,  Samukjani,279,519,146,254,133,265,35.0,36.5,33.4,00000
76.0,72.0,51.0,073,03,01,  Dattapara,411,576,199,309,212,267,41.6,39.2,44.3,00000
76.0,72.0,51.0,463,01,01,  Amaikhola,952,703,476,370,476,333,57.5,56.3,58.8,00000
76.0,72.0,51.0,463,02,01,  Par Karanja,344,518,179,257,165,261,39.9,41.1,38.7,00000
76.0,72.0,51.0,463,03,01,  Paschim Karanja,1736,2630,880,1352,856,1278,39.8,39.4,40.1,00000
76.0,72.0,51.0,463,04,01,  Purba Karanja,2291,2604,1181,1315,1110,1289,46.8,47.3,46.3,00000
76.0,72.0,51.0,463,05,01,  Baya,752,1354,412,696,340,658,35.7,37.2,34.1,00000
76.0,72.0,51.0,746,01,01,  Punduria,903,1001,440,480,463,521,47.4,47.8,47.1,00000
76.0,72.0,51.0,746,02,01,  Baitola,440,409,240,197,200,212,51.8,54.9,48.5,00000
76.0,72.0,51.0,746,03,01,  Mahishakhola,490,522,261,252,229,270,48.4,50.9,45.9,00000
76.0,72.0,51.0,876,01,01,  Sarisha,1243,1259,622,577,621,682,49.7,51.9,47.7,00000
76.0,72.0,51.0,876,02,01,  Amaikhola,153,160,69,83,84,77,48.9,45.4,52.2,00000
76.0,72.0,60.0,277,01,01,  Edrakpur,1155,855,601,395,554,460,57.5,60.3,54.6,00000
76.0,72.0,60.0,277,02,01,  Hedayet Para,219,301,122,145,97,156,42.1,45.7,38.3,00000
76.0,72.0,60.0,440,01,01,  Kabarikola,1071,988,568,453,503,535,52.0,55.6,48.5,00000
76.0,72.0,60.0,440,02,01,  Mehdinagar,488,301,239,146,249,155,61.9,62.1,61.6,00000
76.0,72.0,60.0,440,03,01,  Char Kabarikona,138,85,71,39,67,46,61.9,64.5,59.3,00000
76.0,72.0,60.0,452,01,01,  Kalagachhi,345,529,190,261,155,268,39.5,42.1,36.6,00000
76.0,72.0,60.0,452,02,01,  Char Kalagachhi,207,206,102,105,105,101,50.1,49.3,51.0,00000
76.0,72.0,60.0,480,01,01,  Kashinathpur,2837,1423,1508,671,1329,752,66.6,69.2,63.9,00000
76.0,72.0,60.0,480,02,01,  Marich Puran,1054,727,545,347,509,380,59.2,61.1,57.3,00000
76.0,72.0,60.0,480,03,01,  Sathiakola,1640,1410,853,665,787,745,53.8,56.2,51.4,00000
76.0,72.0,60.0,525,01,01,  Khudra Gopalpur,469,299,220,133,249,166,61.1,62.3,60.0,00000
76.0,72.0,60.0,525,02,01,  Satradisuka,192,375,102,181,90,194,33.9,36.0,31.7,00000
76.0,72.0,60.0,661,01,01,  Paschim Paikarhati,409,407,217,195,192,212,50.1,52.7,47.5,00000
76.0,72.0,60.0,661,02,01,  Shahidnagar,833,755,445,339,388,416,52.5,56.8,48.3,00000
76.0,72.0,60.0,661,03,01,  Purba Paikarhati,1071,1680,606,846,465,834,38.9,41.7,35.8,00000
76.0,72.0,69.0,146,01,01,  Bishnubaria,303,541,158,244,145,297,35.9,39.3,32.8,00000
76.0,72.0,69.0,146,02,01,  Nishi Para,500,641,251,273,249,368,43.8,47.9,40.4,00000
76.0,72.0,69.0,152,01,01,  Bishnapur,906,939,457,428,449,511,49.1,51.6,46.8,00000
76.0,72.0,69.0,152,02,01,  Rayekmari,403,553,202,258,201,295,42.2,43.9,40.5,00000
76.0,72.0,69.0,390,01,01,  Rajapur,373,396,194,196,179,200,48.5,49.7,47.2,00000
76.0,72.0,69.0,390,02,01,  Samanya Para,218,342,105,161,113,181,38.9,39.5,38.4,00000
76.0,72.0,69.0,390,03,01,  Bahalbaria,401,524,196,240,205,284,43.4,45.0,41.9,00000
76.0,72.0,69.0,395,01,01,  Hasanpur,520,835,280,393,240,442,38.4,41.6,35.2,00000
76.0,72.0,69.0,395,02,01,  Khalaibhara,381,747,205,348,176,399,33.8,37.1,30.6,00000
76.0,72.0,69.0,508,01,01,  Khetu Para,494,922,254,464,240,458,34.9,35.4,34.4,00000
76.0,72.0,69.0,508,02,01,  Paik Para,748,1439,359,674,389,765,34.2,34.8,33.7,00000
76.0,72.0,69.0,508,03,01,  Golabari,214,130,115,60,99,70,62.2,65.7,58.6,00000
76.0,72.0,69.0,508,04,01,  Gangarampur,178,291,92,148,86,143,38.0,38.3,37.6,00000
76.0,72.0,69.0,508,05,01,  Dhatalpur,205,530,99,269,106,261,27.9,26.9,28.9,00000
76.0,72.0,69.0,508,06,01,  Baliakandi,173,580,93,290,80,290,23.0,24.3,21.6,00000
76.0,72.0,69.0,559,01,01,  Majhgaon,366,869,188,430,178,439,29.6,30.4,28.8,00000
76.0,72.0,69.0,559,02,01,  Dop Majhgaon,399,566,200,289,199,277,41.3,40.9,41.8,00000
76.0,72.0,69.0,797,01,01,  Rasulpur,784,657,390,304,394,353,54.4,56.2,52.7,00000
76.0,72.0,69.0,797,02,01,  Chandpur,124,377,60,196,64,181,24.8,23.4,26.1,00000
76.0,72.0,77.0,701,01,01,  Chhota Pathailhat,575,768,262,390,313,378,42.8,40.2,45.3,00000
76.0,72.0,77.0,701,02,01,  Bara Pathailhat,1022,1319,552,632,470,687,43.7,46.6,40.6,00000
76.0,72.0,77.0,881,01,01,  Patgari,928,718,474,288,454,430,56.4,62.2,51.4,00000
76.0,72.0,77.0,881,02,01,  Bhita Para,827,1231,413,613,414,618,40.2,40.3,40.1,00000
76.0,72.0,77.0,910,01,01,  Silanda,1115,1896,615,925,500,971,37.0,39.9,34.0,00000
76.0,72.0,77.0,910,02,01,  Chinanari,530,667,278,298,252,369,44.3,48.3,40.6,00000
76.0,72.0,77.0,938,01,01,  Sonatala Paschimpara,1705,2697,912,1330,793,1367,38.7,40.7,36.7,00000
76.0,72.0,77.0,938,02,01,  Sonatala Bhata Para,721,1524,353,750,368,774,32.1,32.0,32.2,00000
76.0,72.0,77.0,938,03,01,  Sonatala Beragi Para,673,1565,378,756,295,809,30.1,33.3,26.7,00000
76.0,72.0,86.0,407,01,01,  Hatbaria,1045,1067,543,542,502,525,49.5,50.0,48.9,00000
76.0,72.0,86.0,407,02,01,  Buailmari,712,1296,385,635,327,661,35.5,37.7,33.1,00000
76.0,72.0,86.0,520,01,01,  Krishnapur,40,120,19,60,21,60,25.0,24.1,25.9,00000
76.0,72.0,86.0,520,02,01,  Debgram,13,71,2,33,11,38,15.5,5.7,22.4,00000
76.0,72.0,86.0,565,01,01,  Mamudpur,1176,1870,616,937,560,933,38.6,39.7,37.5,00000
76.0,72.0,86.0,565,02,01,  Halhalia,44,53,19,26,25,27,45.4,42.2,48.1,00000
76.0,72.0,86.0,633,01,01,  Chak Nandanpur,471,411,257,205,214,206,53.4,55.6,51.0,00000
76.0,72.0,86.0,633,02,01,  Nandanpur,727,353,362,178,365,175,67.3,67.0,67.6,00000
76.0,72.0,86.0,723,01,01,  Piadaha,439,546,243,252,196,294,44.6,49.1,40.0,00000
76.0,72.0,86.0,723,02,01,  Sagardaria,186,196,101,104,85,92,48.7,49.3,48.0,00000
76.0,72.0,86.0,723,03,01,  Bhadrakola,219,381,107,200,112,181,36.5,34.9,38.2,00000
76.0,72.0,86.0,723,04,01,  Char Bhadrakola,418,852,230,430,188,422,32.9,34.8,30.8,00000
76.0,72.0,86.0,848,01,01,  Sankar Pasha,443,322,212,157,231,165,57.9,57.5,58.3,00000
76.0,72.0,86.0,848,02,01,  Char Sankar Pasha,162,197,81,88,81,109,45.1,47.9,42.6,00000
76.0,83.0,19.0,092,01,01,  Jor Pukuria,771,866,414,416,357,450,47.1,49.9,44.2,00000
76.0,83.0,19.0,092,02,01,  Char Jorpukuria,151,276,74,141,77,135,35.4,34.4,36.3,00000
76.0,83.0,19.0,092,03,01,  Ramkantapur,23,85,14,48,9,37,21.3,22.6,19.6,00000
76.0,83.0,19.0,092,04,01,  Nutanpara,224,419,115,198,109,221,34.8,36.7,33.0,00000
76.0,83.0,19.0,092,05,01,  Santipur,655,569,333,264,322,305,53.5,55.8,51.4,00000
76.0,83.0,19.0,325,01,01,  Dulai,1651,1813,850,841,801,972,47.7,50.3,45.2,00000
76.0,83.0,19.0,325,02,01,  Char Dulai,1903,2250,953,1070,950,1180,45.8,47.1,44.6,00000
76.0,83.0,19.0,798,01,01,  Roy Shimuli,706,960,376,458,330,502,42.4,45.1,39.7,00000
76.0,83.0,19.0,798,02,01,  Binna Dangni,140,165,86,83,54,82,45.9,50.9,39.7,00000
76.0,83.0,19.0,872,01,01,  Char Chinkhara,193,367,104,171,89,196,34.5,37.8,31.2,00000
76.0,83.0,19.0,872,02,01,  Chinkhara,706,1051,407,503,299,548,40.2,44.7,35.3,00000
76.0,83.0,19.0,872,03,01,  Adharkota,898,888,462,422,436,466,50.3,52.3,48.3,00000
76.0,83.0,38.0,079,01,01,  Bankhola,2492,2913,1277,1391,1215,1522,46.1,47.9,44.4,00000
76.0,83.0,38.0,079,02,01,  Chargojaria,158,196,75,101,83,95,44.6,42.6,46.6,00000
76.0,83.0,38.0,866,01,01,  Roypur,462,468,241,216,221,252,49.7,52.7,46.7,00000
76.0,83.0,38.0,866,02,01,  Sau Khetu Para,554,756,280,346,274,410,42.3,44.7,40.1,00000
76.0,83.0,38.0,866,03,01,  Bil Khetu Para,567,1397,301,679,266,718,28.9,30.7,27.0,00000
76.0,83.0,47.0,706,01,01,  Narayanpur,307,424,162,217,145,207,42.0,42.7,41.2,00000
76.0,83.0,47.0,706,02,01,  Chhota Narayanpur,49,129,23,64,26,65,27.5,26.4,28.6,00000
76.0,83.0,57.0,171,01,01,  Bil Degha,0,2,0,1,0,1,0.0,0.0,0.0,00000
76.0,83.0,57.0,171,02,01,  Sarirbhita,372,447,201,230,171,217,45.4,46.6,44.1,00000
76.0,83.0,57.0,171,03,01,  Bostal,104,274,50,139,54,135,27.5,26.5,28.6,00000
76.0,83.0,57.0,171,04,01,  Oadai,437,457,228,217,209,240,48.9,51.2,46.5,00000
76.0,83.0,66.0,380,01,01,  Gobindapur,1282,2461,707,1139,575,1322,34.3,38.3,30.3,00000
76.0,83.0,66.0,380,02,01,  Baliadangi,125,328,73,149,52,179,27.6,32.9,22.5,00000
76.0,83.0,66.0,380,03,01,  Madiarkandi,303,359,137,169,166,190,45.8,44.8,46.6,00000
76.0,83.0,66.0,515,01,01,  Muraripur,959,841,508,365,451,476,53.3,58.2,48.7,00000
76.0,83.0,66.0,515,02,01,  Barbhagia,101,322,57,153,44,169,23.9,27.1,20.7,00000
76.0,83.0,66.0,515,03,01,  Chak Kumuria,121,96,60,37,61,59,55.8,61.9,50.8,00000
76.0,83.0,66.0,515,04,01,  Khalilpur,432,759,220,342,212,417,36.3,39.1,33.7,00000
76.0,83.0,66.0,515,05,01,  Kumuria,143,213,75,94,68,119,40.2,44.4,36.4,00000
76.0,83.0,66.0,767,01,01,  Badhi Pukurnia,160,423,87,224,73,199,27.4,28.0,26.8,00000
76.0,83.0,66.0,767,02,01,  Pukurnia,539,739,287,352,252,387,42.2,44.9,39.4,00000
76.0,83.0,66.0,878,01,01,  Paschim Sinduri Baruria,908,1728,523,827,385,901,34.4,38.7,29.9,00000
76.0,83.0,66.0,878,02,01,  Purba Sinduri Baruria,433,988,229,465,204,523,30.5,33.0,28.1,00000
76.0,83.0,66.0,878,03,01,  Bazar Sinduri Baavria,199,468,112,224,87,244,29.8,33.3,26.3,00000
76.0,83.0,66.0,926,01,01,  Purba Shyamsundarpur,418,367,190,155,228,212,53.2,55.1,51.8,00000
76.0,83.0,66.0,926,02,01,  Paschim Shyamsundarpur,633,892,325,399,308,493,41.5,44.9,38.5,00000
76.0,83.0,66.0,926,03,01,  Katia Shyamsundarpur,149,454,70,215,79,239,24.7,24.6,24.8,00000
76.0,83.0,76.0,479,01,01,  Kadoa,876,2016,463,939,413,1077,30.3,33.0,27.7,00000
76.0,83.0,76.0,479,02,01,  Kanchuri,901,702,449,334,452,368,56.2,57.3,55.1,00000
76.0,83.0,76.0,479,03,01,  Upendranagar,368,620,188,289,180,331,37.2,39.4,35.2,00000
76.0,83.0,76.0,761,01,01,  Phakitpur,572,792,310,389,262,403,41.9,44.3,39.4,00000
76.0,83.0,76.0,761,02,01,  Satbaia,213,89,110,41,103,48,70.5,72.8,68.2,00000
76.0,83.0,76.0,761,03,01,  Tarabaria,810,1197,422,604,388,593,40.4,41.1,39.6,00000
76.0,83.0,76.0,804,01,01,  Ramchandarpur,143,116,78,53,65,63,55.2,59.5,50.8,00000
76.0,83.0,76.0,804,02,01,  Jona,251,427,124,198,127,229,37.0,38.5,35.7,00000
76.0,83.0,85.0,147,01,01,  Math Para,57,271,29,129,28,142,17.4,18.4,16.5,00000
76.0,83.0,85.0,147,02,01,  Kaihabaria,119,334,65,148,54,186,26.3,30.5,22.5,00000
76.0,83.0,85.0,147,03,01,  Bhayna,698,1252,346,639,352,613,35.8,35.1,36.5,00000
76.0,83.0,85.0,190,01,01,  Char Para,703,790,336,414,367,376,47.1,44.8,49.4,00000
76.0,83.0,85.0,190,02,01,  Chalna,433,451,225,211,208,240,49.0,51.6,46.4,00000
76.0,83.0,85.0,190,03,01,  Char Chalna,113,111,59,57,54,54,50.4,50.9,50.0,00000
76.0,83.0,85.0,571,01,01,  Lakshmipur,77,137,42,68,35,69,36.0,38.2,33.7,00000
76.0,83.0,85.0,571,02,01,  Gopalpur,307,770,163,382,144,388,28.5,29.9,27.1,00000
76.0,83.0,95.0,362,01,01,  Ghoradaha,983,990,500,484,483,506,49.8,50.8,48.8,00000
76.0,83.0,95.0,362,02,01,  Bhabanipur,324,593,158,285,166,308,35.3,35.7,35.0,00000
76.0,83.0,95.0,552,01,01,  Kror Dulia,712,1389,361,681,351,708,33.9,34.6,33.1,00000
76.0,83.0,95.0,552,02,01,  Funal Dulia,169,284,85,135,84,149,37.3,38.6,36.1,00000
76.0,83.0,95.0,951,01,01,  Tantibanda,344,1064,195,517,149,547,24.4,27.4,21.4,00000
76.0,83.0,95.0,951,02,01,  Huder Para,449,719,240,360,209,359,38.4,40.0,36.8,00000
70.0,18.0,18.0,066,01,01,  Alalpur,361,652,152,356,209,296,35.6,29.9,41.4,00000
70.0,18.0,18.0,066,02,01,  Hossain Bhita,467,445,207,230,260,215,51.2,47.4,54.7,00000
70.0,18.0,18.0,066,03,01,  Kharobatra,176,386,88,209,88,177,31.3,29.6,33.2,00000
70.0,18.0,18.0,066,04,01,  Chamusa,380,617,135,343,245,274,38.1,28.2,47.2,00000
70.0,18.0,18.0,198,01,03,  Bholahat,459,203,232,92,227,111,69.3,71.6,67.2,00000
70.0,18.0,18.0,198,02,03,  Jadunagar,265,79,131,35,134,44,77.0,78.9,75.3,00000
70.0,18.0,18.0,353,01,03,  Dharampur,436,611,233,301,203,310,41.6,43.6,39.6,00000
70.0,18.0,18.0,353,02,03,  Char Dhadrampur,1165,895,551,465,614,430,56.6,54.2,58.8,00000
70.0,18.0,18.0,442,01,03,  Gopinathpur (Part),1436,657,705,327,731,330,68.6,68.3,68.9,00000
70.0,18.0,18.0,442,02,03,  Char Dharampur,170,169,79,88,91,81,50.1,47.3,52.9,00000
70.0,18.0,18.0,442,03,03,  Emamnagar,149,223,77,117,72,106,40.1,39.7,40.4,00000
70.0,18.0,18.0,530,01,01,  Imamnagar,683,450,309,264,374,186,60.3,53.9,66.8,00000
70.0,18.0,18.0,530,02,01,  Panch Tikri,608,605,308,306,300,299,50.1,50.2,50.1,00000
70.0,18.0,18.0,530,03,01,  Hans Pukur,299,431,138,226,161,205,41.0,37.9,44.0,00000
70.0,18.0,18.0,530,04,01,  Jadnagar,397,178,185,83,212,95,69.0,69.0,69.1,00000
70.0,18.0,18.0,596,01,03,  Jhaubona,686,367,335,167,351,200,65.1,66.7,63.7,00000
70.0,18.0,18.0,596,02,03,  Joyrampur,72,53,39,28,33,25,57.6,58.2,56.9,00000
70.0,18.0,18.0,596,03,03,  Khalishakuri,252,184,103,89,149,95,57.8,53.6,61.1,00000
70.0,18.0,18.0,596,04,03,  Kashimpur,161,66,86,28,75,38,70.9,75.4,66.4,00000
70.0,18.0,18.0,596,05,03,  Tanti Para,541,135,272,59,269,76,80.0,82.2,78.0,00000
70.0,18.0,18.0,906,01,01,  Sikari,495,1391,195,725,300,666,26.2,21.2,31.1,00000
70.0,18.0,18.0,906,02,01,  Alalpur,372,732,162,370,210,362,33.7,30.5,36.7,00000
70.0,18.0,18.0,906,03,01,  Hossain Bhita,624,400,311,214,313,186,60.9,59.2,62.7,00000
70.0,18.0,18.0,994,01,03,  Teli Para,599,399,293,195,306,204,60.0,60.0,60.0,00000
70.0,18.0,18.0,994,02,03,  Bhadurganj,604,358,303,166,301,192,62.8,64.6,61.1,00000
70.0,18.0,18.0,994,03,03,  Char Dharampur,198,156,101,77,97,79,55.9,56.7,55.1,00000
70.0,18.0,37.0,022,01,01,  Adatala,352,394,172,185,180,209,47.2,48.2,46.3,00000
70.0,18.0,37.0,022,02,01,  Panchanandapur (Part),290,427,140,228,150,199,40.4,38.0,43.0,00000
70.0,18.0,37.0,022,03,01,  Haripur,367,524,171,268,196,256,41.2,39.0,43.4,00000
70.0,18.0,37.0,176,01,01,  Musribhuja,155,283,59,147,96,136,35.4,28.6,41.4,00000
70.0,18.0,37.0,176,02,01,  Pirgachhi (Part),167,447,68,212,99,235,27.2,24.3,29.6,00000
70.0,18.0,37.0,221,01,01,  Mayamari,516,622,240,286,276,336,45.3,45.6,45.1,00000
70.0,18.0,37.0,221,02,01,  Beltala,105,232,41,115,64,117,31.2,26.3,35.4,00000
70.0,18.0,37.0,221,03,01,  Islampur (Part),172,211,77,108,95,103,44.9,41.6,48.0,00000
70.0,18.0,37.0,221,04,01,  Panchanandapur (Part),117,150,49,80,68,70,43.8,38.0,49.3,00000
70.0,18.0,37.0,331,01,01,  Bindu Para,315,281,133,146,182,135,52.9,47.7,57.4,00000
70.0,18.0,37.0,331,02,01,  Barai Para,410,439,204,216,206,223,48.3,48.6,48.0,00000
70.0,18.0,37.0,331,03,01,  Pirgachhi (Part),362,273,187,126,175,147,57.0,59.7,54.3,00000
70.0,18.0,37.0,331,04,01,  Ghaibari,483,425,236,196,247,229,53.2,54.6,51.9,00000
70.0,18.0,37.0,331,05,01,  Daldali,440,410,211,201,229,209,51.8,51.2,52.3,00000
70.0,18.0,37.0,331,06,01,  Upar Musribhuja,752,899,353,482,399,417,45.5,42.3,48.9,00000
70.0,18.0,37.0,331,07,01,  Balutungi (Part),81,199,27,102,54,97,28.9,20.9,35.8,00000
70.0,18.0,37.0,331,08,01,  Chamamusri Bhvja,415,173,220,73,195,100,70.6,75.1,66.1,00000
70.0,18.0,37.0,751,01,01,  Madhupur,175,274,76,142,99,132,39.0,34.9,42.9,00000
70.0,18.0,37.0,751,02,01,  Battala,630,488,296,227,334,261,56.4,56.6,56.1,00000
70.0,18.0,37.0,751,03,01,  Kharakpur,970,1060,459,551,511,509,47.8,45.4,50.1,00000
70.0,18.0,37.0,751,04,01,  Namo Musribhuja,386,279,181,135,205,144,58.0,57.3,58.7,00000
70.0,18.0,37.0,751,05,01,  Musribhuja (Part),825,829,392,427,433,402,49.9,47.9,51.9,00000
70.0,18.0,37.0,751,06,01,  Chamo Musribhuja,329,283,145,143,184,140,53.8,50.3,56.8,00000
70.0,18.0,37.0,818,01,01,  Haji Para (Poladanga),147,139,75,69,72,70,51.4,52.1,50.7,00000
70.0,18.0,37.0,818,02,01,  Kashmir Para,105,202,47,101,58,101,34.2,31.8,36.5,00000
70.0,18.0,37.0,818,03,01,  School Para,148,142,65,67,83,75,51.0,49.2,52.5,00000
70.0,18.0,37.0,818,04,01,  Ghontala (Poladanga),165,112,79,52,86,60,59.6,60.3,58.9,00000
70.0,18.0,37.0,818,05,01,  Lamba Tola,222,315,93,158,129,157,41.3,37.1,45.1,00000
70.0,18.0,37.0,818,06,01,  Lambatala (Poladanga),489,273,228,143,261,130,64.2,61.5,66.8,00000
70.0,18.0,37.0,818,07,01,  Kashiabona,90,243,60,103,30,140,27.0,36.8,17.6,00000
70.0,18.0,37.0,818,08,01,  Nazirpur (Poladanga),258,275,121,144,137,131,48.4,45.7,51.1,00000
70.0,18.0,37.0,818,09,01,  Islampur (Part) Poladanga,89,202,51,92,38,110,30.6,35.7,25.7,00000
70.0,18.0,37.0,818,10,01,  Uladanga (Poladanga),286,330,131,186,155,144,46.4,41.3,51.8,00000
70.0,18.0,37.0,818,11,01,  Jinnahnagar (Poladanga),181,250,91,128,90,122,42.0,41.6,42.5,00000
70.0,18.0,37.0,818,12,01,  Nutan Haji Para (Poladanga),251,134,134,60,117,74,65.2,69.1,61.3,00000
70.0,18.0,37.0,862,01,01,  Balutungi (Part),135,195,52,104,83,91,40.9,33.3,47.7,00000
70.0,18.0,37.0,862,02,01,  Pirgachhi,127,234,49,125,78,109,35.2,28.2,41.7,00000
70.0,18.0,56.0,420,01,01,  Gohalbari,1669,1575,785,810,884,765,51.4,49.2,53.6,00000
70.0,18.0,56.0,420,02,01,  Kumirjan,428,249,209,126,219,123,63.2,62.4,64.0,00000
70.0,18.0,56.0,420,03,01,  Tiloki,509,736,213,417,296,319,40.9,33.8,48.1,00000
70.0,18.0,56.0,442,01,01,  Bireshwarpur,1340,1572,648,764,692,808,46.0,45.9,46.1,00000
70.0,18.0,56.0,442,02,01,  Ahmedpur,256,441,129,229,127,212,36.7,36.0,37.5,00000
70.0,18.0,56.0,442,03,01,  Pachtikri,131,30,73,18,58,12,81.4,80.2,82.9,00000
70.0,18.0,56.0,675,01,01,  Kanahat Sahapara,526,286,249,128,277,158,64.8,66.0,63.7,00000
70.0,18.0,56.0,675,02,01,  Bazar Tek,1001,1673,484,804,517,869,37.4,37.6,37.3,00000
70.0,18.0,56.0,675,03,01,  Piran Chak,516,580,250,277,266,303,47.1,47.4,46.7,00000
70.0,18.0,56.0,675,04,01,  Ali Sahaspur,436,320,194,153,242,167,57.7,55.9,59.2,00000
70.0,18.0,56.0,675,05,01,  Munshiganj,198,501,91,238,107,263,28.3,27.7,28.9,00000
70.0,18.0,56.0,840,01,01,  Radhanagar,457,287,211,150,246,137,61.4,58.4,64.2,00000
70.0,18.0,56.0,840,02,01,  Radhanagar Colony,441,353,215,164,226,189,55.5,56.7,54.5,00000
70.0,18.0,56.0,950,01,01,  Suranpur,1187,1742,550,915,637,827,40.5,37.5,43.5,00000
70.0,18.0,56.0,950,02,01,  Pachtikril,446,318,247,159,199,159,58.4,60.8,55.6,00000
70.0,18.0,75.0,088,01,01,  Andipur,222,596,97,290,125,306,27.1,25.1,29.0,00000
70.0,18.0,75.0,088,02,01,  Bara Gachhi,690,1208,348,609,342,599,36.4,36.4,36.3,00000
70.0,18.0,75.0,265,01,01,  Brahmangram,71,252,39,125,32,127,22.0,23.8,20.1,00000
70.0,18.0,75.0,265,02,01,  Adampur,257,399,126,188,131,211,39.2,40.1,38.3,00000
70.0,18.0,75.0,685,01,01,  Kalinagar,207,717,99,378,108,339,22.4,20.8,24.2,00000
70.0,18.0,75.0,685,02,01,  Kashiabari,178,326,74,157,104,169,35.3,32.0,38.1,00000
70.0,18.0,75.0,685,03,01,  Dharampur,152,450,71,226,81,224,25.2,23.9,26.6,00000
70.0,18.0,75.0,795,01,01,  Mirpur,62,226,31,114,31,112,21.5,21.4,21.7,00000
70.0,18.0,75.0,795,02,01,  Durgapur,534,766,245,398,289,368,41.1,38.1,44.0,00000
70.0,37.0,10.0,023,01,01,  Imamnagar,896,1478,417,723,479,755,37.7,36.6,38.8,00000
70.0,37.0,10.0,023,02,01,  Alinagar,1762,2011,879,931,883,1080,46.7,48.6,45.0,00000
70.0,37.0,10.0,611,01,01,  Mokrampur,1627,2324,724,1160,903,1164,41.2,38.4,43.7,00000
70.0,37.0,10.0,611,02,01,  Nadarabad,994,1915,428,981,566,934,34.2,30.4,37.7,00000
70.0,37.0,21.0,059,01,01,  Begunbari,252,353,118,165,134,188,41.7,41.7,41.6,00000
70.0,37.0,21.0,059,02,01,  Uttar Brajanathpur,544,1348,251,692,293,656,28.8,26.6,30.9,00000
70.0,37.0,21.0,059,03,01,  Paschim Brajanathpur,246,938,114,470,132,468,20.8,19.5,22.0,00000
70.0,37.0,21.0,059,04,01,  Purba Brajanathpur,349,904,169,449,180,455,27.9,27.3,28.3,00000
70.0,37.0,21.0,059,05,01,  Sumpur,1089,1208,521,599,568,609,47.4,46.5,48.3,00000
70.0,37.0,21.0,059,06,01,  Bangabari Islampur,821,1172,379,551,442,621,41.2,40.8,41.6,00000
70.0,37.0,21.0,059,07,01,  Azagara,649,1137,321,538,328,599,36.3,37.4,35.4,00000
70.0,37.0,21.0,059,08,01,  Shishatola,345,310,170,129,175,181,52.7,56.9,49.2,00000
70.0,37.0,21.0,245,01,01,  Mohananda Bad,518,1111,203,573,315,538,31.8,26.2,36.9,00000
70.0,37.0,21.0,245,02,01,  Jorgachha,51,177,13,94,38,83,22.4,12.1,31.4,00000
70.0,37.0,21.0,911,01,01,  Uttar Santoshpur,714,1138,354,578,360,560,38.6,38.0,39.1,00000
70.0,37.0,21.0,911,02,01,  Dakshin Santoshpur,916,1316,436,632,480,684,41.0,40.8,41.2,00000
70.0,37.0,31.0,017,01,01,  Alampur,301,709,145,326,156,383,29.8,30.8,28.9,00000
70.0,37.0,31.0,017,02,01,  Mohanpur,76,187,30,102,46,85,28.9,22.7,35.1,00000
70.0,37.0,31.0,017,03,01,  Daulatpur,160,357,64,175,96,182,30.9,26.8,34.5,00000
70.0,37.0,31.0,017,04,01,  Lalapur,419,636,180,312,239,324,39.7,36.6,42.5,00000
70.0,37.0,31.0,017,05,01,  Durgapur Paschim,449,390,205,207,244,183,53.5,49.8,57.1,00000
70.0,37.0,31.0,017,06,01,  Durgapur Purba,254,507,110,252,144,255,33.4,30.4,36.1,00000
70.0,37.0,31.0,017,07,01,  Babupur,196,611,91,298,105,313,24.3,23.4,25.1,00000
70.0,37.0,31.0,017,08,01,  Kalupur,376,421,175,202,201,219,47.2,46.4,47.9,00000
70.0,37.0,31.0,017,09,01,  Chhota Bangasarpur,274,369,129,181,145,188,42.6,41.6,43.5,00000
70.0,37.0,31.0,017,10,01,  Bara Bangasarpur,518,641,242,302,276,339,44.7,44.5,44.9,00000
70.0,37.0,31.0,017,11,01,  Khanchantala Paschim,780,1011,378,514,402,497,43.6,42.4,44.7,00000
70.0,37.0,31.0,017,12,01,  Khanchantala Purba,532,637,240,293,292,344,45.5,45.0,45.9,00000
70.0,37.0,31.0,017,13,01,  Phulbagh,161,163,73,86,88,77,49.7,45.9,53.3,00000
70.0,37.0,31.0,017,14,01,  Marator,95,95,37,52,58,43,50.0,41.6,57.4,00000
70.0,37.0,31.0,017,15,01,  Kashiabari,460,409,228,207,232,202,52.9,52.4,53.5,00000
70.0,37.0,31.0,209,01,01,  Boalia,252,587,131,311,121,276,30.0,29.6,30.5,00000
70.0,37.0,31.0,209,02,01,  Naoda Padra,267,326,127,173,140,153,45.0,42.3,47.8,00000
70.0,37.0,31.0,209,03,01,  Lakshmi Naranyanpur,1026,1176,495,564,531,612,46.6,46.7,46.5,00000
70.0,37.0,31.0,209,04,01,  Ghatnagar,489,883,207,451,282,432,35.6,31.5,39.5,00000
70.0,37.0,31.0,209,05,01,  Bakhariahatha Para,62,198,27,94,35,104,23.8,22.3,25.2,00000
70.0,37.0,31.0,299,01,01,  Darbarpur,275,141,143,63,132,78,66.1,69.4,62.9,00000
70.0,37.0,31.0,299,02,01,  Gauripur,570,643,262,320,308,323,47.0,45.0,48.8,00000
70.0,37.0,31.0,299,03,01,  Kawa Bansa,559,940,260,496,299,444,37.3,34.4,40.2,00000
70.0,37.0,31.0,905,01,01,  Sahapur Kalan,284,438,122,225,162,213,39.3,35.2,43.2,00000
70.0,37.0,31.0,905,02,01,  Lalgarh,41,100,17,52,24,48,29.1,24.6,33.3,00000
70.0,37.0,42.0,083,01,01,  Basani Para,541,890,236,443,305,447,37.8,34.8,40.6,00000
70.0,37.0,42.0,083,02,01,  Danrabad,137,352,60,172,77,180,28.0,25.9,30.0,00000
70.0,37.0,42.0,083,03,01,  Nandalalpur,869,1716,384,892,485,824,33.6,30.1,37.1,00000
70.0,37.0,42.0,227,01,03,  Chowdala,502,734,253,343,249,391,40.6,42.4,38.9,00000
70.0,37.0,42.0,227,02,03,  Biram Para,517,1406,235,731,282,675,26.9,24.3,29.5,00000
70.0,37.0,42.0,227,03,03,  Momin Para,588,759,294,366,294,393,43.7,44.5,42.8,00000
70.0,37.0,42.0,227,04,03,  Sonar Para,496,718,245,348,251,370,40.9,41.3,40.4,00000
70.0,37.0,42.0,227,05,03,  Para Manik Para,193,255,95,119,98,136,43.1,44.4,41.9,00000
70.0,37.0,42.0,227,06,03,  Refujee Para,186,275,93,119,93,156,40.3,43.9,37.3,00000
70.0,37.0,42.0,227,07,03,  Bazar Para,289,274,145,133,144,141,51.3,52.2,50.5,00000
70.0,37.0,42.0,227,08,03,  Line Para,614,1917,263,1012,351,905,24.3,20.6,27.9,00000
70.0,37.0,42.0,329,01,01,  Uttar Islampur,159,604,63,305,96,299,20.8,17.1,24.3,00000
70.0,37.0,42.0,329,02,01,  Balutungi,283,652,129,329,154,323,30.3,28.2,32.3,00000
70.0,37.0,42.0,329,03,01,  Uttar Hausenagar,346,485,154,256,192,229,41.6,37.6,45.6,00000
70.0,37.0,42.0,329,04,01,  Dakshin Hausenagar,269,293,125,152,144,141,47.9,45.1,50.5,00000
70.0,37.0,42.0,329,05,01,  Diar Islampur,352,517,146,276,206,241,40.5,34.6,46.1,00000
70.0,37.0,42.0,329,06,01,  Paschim Sahebgram,224,516,90,255,134,261,30.3,26.1,33.9,00000
70.0,37.0,42.0,329,07,01,  Purba Sahebgram,291,548,127,280,164,268,34.7,31.2,38.0,00000
70.0,37.0,42.0,329,08,01,  Udaynagar,524,1185,216,616,308,569,30.7,26.0,35.1,00000
70.0,37.0,42.0,329,09,01,  Char Udaynagar,33,275,11,139,22,136,10.7,7.3,13.9,00000
70.0,37.0,42.0,971,01,01,  Sukrabarihat,487,793,253,388,234,405,38.0,39.5,36.6,00000
70.0,37.0,42.0,971,02,01,  Kadamtali,407,880,171,471,236,409,31.6,26.6,36.6,00000
70.0,37.0,42.0,971,03,01,  Harinagar,30,307,8,145,22,162,8.9,5.2,12.0,00000
70.0,37.0,42.0,971,04,01,  Sahebgaram,498,1169,217,595,281,574,29.9,26.7,32.9,00000
70.0,37.0,42.0,971,05,01,  Dakshin Islampur,480,549,204,304,276,245,46.6,40.2,53.0,00000
70.0,37.0,52.0,333,01,01,  Shersabad,233,604,111,319,122,285,27.8,25.8,30.0,00000
70.0,37.0,52.0,333,02,01,  Debenagar,144,351,60,180,84,171,29.1,25.0,32.9,00000
70.0,37.0,52.0,341,01,01,  Dosimani,792,1421,367,734,425,687,35.8,33.3,38.2,00000
70.0,37.0,52.0,341,02,01,  Kumarpur,294,325,152,158,142,167,47.5,49.0,46.0,00000
70.0,37.0,52.0,371,01,03,  Khoshal Para-1,828,1485,379,736,449,749,35.8,34.0,37.5,00000
70.0,37.0,52.0,371,02,03,  Fakir Para,689,648,344,298,345,350,51.5,53.6,49.6,00000
70.0,37.0,52.0,371,03,03,  Kashipur,827,521,420,231,407,290,61.4,64.5,58.4,00000
70.0,37.0,52.0,371,04,03,  Durlovepur,269,142,127,58,142,84,65.5,68.6,62.8,00000
70.0,37.0,52.0,371,05,03,  Khoshal Para-2,390,404,180,193,210,211,49.1,48.3,49.9,00000
70.0,37.0,52.0,371,06,03,  Bazar Para,896,701,446,307,450,394,56.1,59.2,53.3,00000
70.0,37.0,52.0,371,07,03,  Koyldiar,171,273,92,132,79,141,38.5,41.1,35.9,00000
70.0,37.0,52.0,371,08,03,  Nimtala,592,1320,289,710,303,610,31.0,28.9,33.2,00000
70.0,37.0,52.0,371,09,03,  Binpara,141,182,67,90,74,92,43.7,42.7,44.6,00000
70.0,37.0,52.0,383,01,01,  Gopalnagar,120,271,46,149,74,122,30.7,23.6,37.8,00000
70.0,37.0,52.0,383,02,01,  Marichadanga,73,167,31,93,42,74,30.4,25.0,36.2,00000
70.0,37.0,52.0,407,01,01,  Hogla,983,1488,436,765,547,723,39.8,36.3,43.1,00000
70.0,37.0,52.0,407,02,01,  Begumnagar,641,1176,292,588,349,588,35.3,33.2,37.2,00000
70.0,37.0,52.0,407,03,01,  Bhitabari,265,398,122,187,143,211,40.0,39.5,40.4,00000
70.0,37.0,52.0,407,04,01,  Darabaz,551,884,258,443,293,441,38.4,36.8,39.9,00000
70.0,37.0,52.0,653,01,01,  Nasibandinagar,187,371,77,189,110,182,33.5,28.9,37.7,00000
70.0,37.0,52.0,653,02,01,  Bogla,223,208,100,98,123,110,51.7,50.5,52.8,00000
70.0,37.0,52.0,659,01,01,  Naya Diari,1471,2886,677,1442,794,1444,33.8,31.9,35.5,00000
70.0,37.0,52.0,659,02,01,  Balugram,428,692,190,346,238,346,38.2,35.4,40.8,00000
70.0,37.0,52.0,659,03,01,  Rajarampur,633,1079,292,546,341,533,37.0,34.8,39.0,00000
70.0,37.0,52.0,659,04,01,  Chay Para,352,591,175,296,177,295,37.3,37.2,37.5,00000
70.0,37.0,52.0,659,05,01,  Shimaltala,24,163,7,86,17,77,12.8,7.5,18.1,00000
70.0,37.0,63.0,071,01,01,  Bara Dadpur,697,780,321,356,376,424,47.2,47.4,47.0,00000
70.0,37.0,63.0,071,02,01,  Garamri,165,384,95,179,70,205,30.1,34.7,25.5,00000
70.0,37.0,63.0,071,03,01,  Balaka Para,55,106,40,50,15,56,34.2,44.4,21.1,00000
70.0,37.0,63.0,071,04,01,  Lulapur,24,75,12,36,12,39,24.2,25.0,23.5,00000
70.0,37.0,63.0,311,01,01,  Deupura,187,100,109,46,78,54,65.2,70.3,59.1,00000
70.0,37.0,63.0,311,02,01,  Harishpur,141,215,66,106,75,109,39.6,38.4,40.8,00000
70.0,37.0,63.0,323,01,01,  Dharmapur,175,208,88,101,87,107,45.7,46.6,44.8,00000
70.0,37.0,63.0,323,02,01,  Khan Pur,9,14,6,7,3,7,39.1,46.2,30.0,00000
70.0,37.0,63.0,545,01,01,  Krishnapur,162,281,93,127,69,154,36.6,42.3,30.9,00000
70.0,37.0,63.0,545,02,01,  Kamarbari,91,33,44,14,47,19,73.4,75.9,71.2,00000
70.0,37.0,63.0,545,03,01,  Tali Pukur,69,47,43,18,26,29,59.5,70.5,47.3,00000
70.0,37.0,63.0,545,04,01,  Panditpur,112,101,49,54,63,47,52.6,47.6,57.3,00000
70.0,37.0,63.0,569,01,01,  Madhaipur,170,166,68,84,102,82,50.6,44.7,55.4,00000
70.0,37.0,63.0,569,02,01,  Maheshpur,176,205,89,103,87,102,46.2,46.4,46.0,00000
70.0,37.0,63.0,569,03,01,  Dawakandar,115,78,64,33,51,45,59.6,66.0,53.1,00000
70.0,37.0,63.0,695,01,01,  Parbatipur,117,242,50,131,67,111,32.6,27.6,37.6,00000
70.0,37.0,63.0,695,02,01,  Futnagar,128,51,61,22,67,29,71.5,73.5,69.8,00000
70.0,37.0,63.0,695,03,01,  Chandapur,247,231,122,121,125,110,51.7,50.2,53.2,00000
70.0,37.0,63.0,695,04,01,  Balka Para,204,272,113,127,91,145,42.9,47.1,38.6,00000
70.0,37.0,63.0,845,01,01,  Purba Fazilpur,128,197,66,94,62,103,39.4,41.3,37.6,00000
70.0,37.0,63.0,845,02,01,  Danga  Para,80,66,42,31,38,35,54.8,57.5,52.1,00000
70.0,37.0,63.0,988,01,01,  Tikarampur,89,112,43,56,46,56,44.3,43.4,45.1,00000
70.0,37.0,63.0,988,02,01,  Kormaga,119,121,72,57,47,64,49.6,55.8,42.3,00000
70.0,37.0,73.0,281,01,01,  Damail,280,623,128,326,152,297,31.0,28.2,33.9,00000
70.0,37.0,73.0,281,02,01,  Labudanga,776,620,367,330,409,290,55.6,52.7,58.5,00000
70.0,37.0,73.0,281,03,01,  Shishadanga,218,595,110,288,108,307,26.8,27.6,26.0,00000
70.0,37.0,73.0,347,01,01,  Dubail,883,1956,403,974,480,982,31.1,29.3,32.8,00000
70.0,37.0,73.0,347,02,01,  Eshorpurganj,915,724,448,362,467,362,55.8,55.3,56.3,00000
70.0,37.0,73.0,347,03,01,  Charadanga,433,339,225,155,208,184,56.1,59.2,53.1,00000
70.0,37.0,73.0,689,01,01,  Charaldanga,314,463,145,228,169,235,40.4,38.9,41.8,00000
70.0,37.0,73.0,689,02,01,  Mira Kanthal,469,401,227,196,242,205,53.9,53.7,54.1,00000
70.0,37.0,73.0,793,01,01,  Islampur,137,236,67,130,70,106,36.7,34.0,39.8,00000
70.0,37.0,73.0,793,02,01,  Radhanagar,185,485,103,233,82,252,27.6,30.7,24.6,00000
70.0,37.0,73.0,869,01,01,  Ramkandar,88,100,40,44,48,56,46.8,47.6,46.2,00000
70.0,37.0,73.0,869,02,01,  Kashiadanga,186,94,105,31,81,63,66.4,77.2,56.3,00000
70.0,37.0,73.0,887,01,01,  Rokanpur,1075,1315,509,675,566,640,45.0,43.0,46.9,00000
70.0,37.0,73.0,887,02,01,  Nagar Para,281,565,120,286,161,279,33.2,29.6,36.6,00000
70.0,37.0,84.0,065,01,01,  Bangpur,91,374,54,203,37,171,19.6,21.0,17.8,00000
70.0,37.0,84.0,065,02,01,  Dangapar,16,129,9,54,7,75,11.0,14.3,8.5,00000
70.0,37.0,84.0,065,03,01,  Tetul Tola Part,45,123,25,62,20,61,26.8,28.7,24.7,00000
70.0,37.0,84.0,065,04,01,  Nazirpur Part,61,257,24,129,37,128,19.2,15.7,22.4,00000
70.0,37.0,84.0,605,01,01,  Mirapur,91,550,32,264,59,286,14.2,10.8,17.1,00000
70.0,37.0,84.0,605,02,01,  Nazirpur Part,56,130,31,65,25,65,30.1,32.3,27.8,00000
70.0,37.0,84.0,635,01,01,  Kazigram,1322,2198,621,1147,701,1051,37.6,35.1,40.0,00000
70.0,37.0,84.0,635,02,01,  Naoda Shar Buruz,653,1298,268,669,385,629,33.5,28.6,38.0,00000
70.0,37.0,84.0,665,01,01,  Nazirpur,62,88,31,42,31,46,41.3,42.5,40.3,00000
70.0,37.0,84.0,665,02,01,  Mira Pur Part,47,249,16,122,31,127,15.9,11.6,19.6,00000
70.0,37.0,84.0,665,03,01,  Ranga Mati,198,252,108,120,90,132,44.0,47.4,40.5,00000
70.0,56.0,38.0,014,01,01,  Ajhair,265,558,106,256,159,302,32.2,29.3,34.5,00000
70.0,56.0,38.0,014,02,01,  Anukha Dighi,298,411,138,214,160,197,42.0,39.2,44.8,00000
70.0,56.0,38.0,539,01,01,  Kasba,554,998,243,529,311,469,35.7,31.5,39.9,00000
70.0,56.0,38.0,539,02,01,  Gulabari,176,281,77,146,99,135,38.5,34.5,42.3,00000
70.0,56.0,57.0,386,01,01,  Ghion,683,594,300,311,383,283,53.5,49.1,57.5,00000
70.0,56.0,57.0,386,02,01,  Hamidpur,182,158,89,71,93,87,53.5,55.6,51.7,00000
70.0,56.0,57.0,386,03,01,  Janaki Para,277,227,127,120,150,107,55.0,51.4,58.4,00000
70.0,56.0,57.0,643,01,01,  Dighir Para,436,573,223,274,213,299,43.2,44.9,41.6,00000
70.0,56.0,57.0,643,02,01,  Rajbari,217,369,95,178,122,191,37.0,34.8,39.0,00000
70.0,56.0,57.0,643,03,01,  Mohammadpur,237,329,117,163,120,166,41.9,41.8,42.0,00000
70.0,56.0,57.0,663,01,01,  Maktapur,692,1054,329,545,363,509,39.6,37.6,41.6,00000
70.0,56.0,57.0,663,02,01,  Bara Choki,313,150,145,82,168,68,67.6,63.9,71.2,00000
70.0,56.0,57.0,663,03,01,  Jhaljhalia,203,222,98,121,105,101,47.8,44.7,51.0,00000
70.0,56.0,57.0,663,04,01,  Bhagorin,81,169,39,91,42,78,32.4,30.0,35.0,00000
70.0,56.0,76.0,089,01,01,  Baipur,342,342,180,153,162,189,50.0,54.1,46.2,00000
70.0,56.0,76.0,089,02,01,  Zahidpur,145,426,84,198,61,228,25.4,29.8,21.1,00000
70.0,56.0,76.0,089,03,01,  Muralidanga,282,178,142,84,140,94,61.3,62.8,59.8,00000
70.0,56.0,76.0,108,01,01,  Bara Bakail,226,229,104,115,122,114,49.7,47.5,51.7,00000
70.0,56.0,76.0,108,02,01,  Banshbaria Bakail,194,287,97,138,97,149,40.3,41.3,39.4,00000
70.0,56.0,76.0,321,01,01,  Diara,320,352,156,170,164,182,47.6,47.9,47.4,00000
70.0,56.0,76.0,321,02,01,  Faujdar Para,82,179,35,95,47,84,31.4,26.9,35.9,00000
70.0,56.0,76.0,717,01,01,  Nizampur,499,452,273,220,226,232,52.5,55.4,49.3,00000
70.0,56.0,76.0,717,02,01,  Goiabari,348,420,178,213,170,207,45.3,45.5,45.1,00000
70.0,56.0,76.0,717,03,01,  Kathalpara,94,85,41,48,53,37,52.5,46.1,58.9,00000
70.0,56.0,76.0,717,04,01,  Morafala,115,95,49,47,66,48,54.8,51.0,57.9,00000
70.0,56.0,76.0,717,05,01,  Paschimpara,247,224,117,99,130,125,52.4,54.2,51.0,00000
70.0,56.0,76.0,717,06,01,  Jampukuria,12,40,5,20,7,20,23.1,20.0,25.9,00000
70.0,56.0,76.0,806,01,01,  Purba Lakshmanpur,78,153,28,75,50,78,33.8,27.2,39.1,00000
70.0,56.0,76.0,806,02,01,  Tekharia,111,167,58,78,53,89,39.9,42.6,37.3,00000
70.0,56.0,76.0,806,03,01,  Danga Para,69,64,29,26,40,38,51.9,52.7,51.3,00000
70.0,56.0,76.0,806,04,01,  Dauadanga,47,128,29,56,18,72,26.9,34.1,20.0,00000
70.0,66.0,17.0,830,01,01,  Raninagar,431,1428,225,730,206,698,23.2,23.6,22.8,00000
70.0,66.0,17.0,830,02,01,  Baligram,254,1336,114,668,140,668,16.0,14.6,17.3,00000
70.0,66.0,17.0,830,03,01,  Joyrasia,194,1259,94,652,100,607,13.4,12.6,14.1,00000
70.0,66.0,18.0,325,01,01,  Dinanathpur,474,475,212,256,262,219,49.9,45.3,54.5,00000
70.0,66.0,18.0,325,02,01,  Nadda Para,181,316,91,162,90,154,36.4,36.0,36.9,00000
70.0,66.0,18.0,921,01,01,  Shimultala,1128,1119,501,570,627,549,50.2,46.8,53.3,00000
70.0,66.0,18.0,921,02,01,  Jadupur,730,687,320,330,410,357,51.5,49.2,53.5,00000
70.0,66.0,19.0,838,01,01,  Laharpur,1093,711,578,323,515,388,60.6,64.2,57.0,00000
70.0,66.0,19.0,838,02,01,  Chamagram,1931,1254,843,513,1088,741,60.6,62.2,59.5,00000
70.0,66.0,19.0,838,03,01,  Baragharia,2022,1480,992,661,1030,819,57.7,60.0,55.7,00000
70.0,66.0,19.0,838,04,01,  Natun Bazar,950,1291,473,739,477,552,42.4,39.0,46.4,00000
70.0,66.0,19.0,838,05,01,  Lakshmipur,4270,5497,1847,2789,2423,2708,43.7,39.8,47.2,00000
70.0,66.0,20.0,037,01,01,  Anupnagar,1998,2980,861,1598,1137,1382,40.1,35.0,45.1,00000
70.0,66.0,20.0,037,02,01,  Char Anupnagar,1089,1560,499,774,590,786,41.1,39.2,42.9,00000
70.0,66.0,22.0,233,01,01,  Bakerali,312,2709,132,1345,180,1364,10.3,8.9,11.7,00000
70.0,66.0,22.0,233,02,01,  Goaldubi,332,723,143,338,189,385,31.5,29.7,32.9,00000
70.0,66.0,22.0,233,03,01,  Sona Patti,215,685,110,334,105,351,23.9,24.8,23.0,00000
70.0,66.0,22.0,233,04,01,  Kata Para,220,649,86,317,134,332,25.3,21.3,28.8,00000
70.0,66.0,22.0,233,05,01,  Gorai Para,289,859,127,433,162,426,25.2,22.7,27.6,00000
70.0,66.0,22.0,233,06,01,  Chak Para,191,753,75,378,116,375,20.2,16.6,23.6,00000
70.0,66.0,22.0,233,07,01,  Gidni Para,279,684,114,315,165,369,29.0,26.6,30.9,00000
70.0,66.0,22.0,233,08,01,  Gotha Para,347,1404,128,618,219,786,19.8,17.2,21.8,00000
70.0,66.0,22.0,233,09,01,  Manik Haji Para,177,1136,98,524,79,612,13.5,15.8,11.4,00000
70.0,66.0,22.0,233,10,01,  Jhaira Mondalpara,186,655,94,332,92,323,22.1,22.1,22.2,00000
70.0,66.0,22.0,233,11,01,  Bathan Para,102,405,56,194,46,211,20.1,22.4,17.9,00000
70.0,66.0,22.0,614,01,01,  Yunus Biswastala,138,368,55,179,83,189,27.3,23.5,30.5,00000
70.0,66.0,22.0,614,02,01,  Rahim Mondal Tola,149,673,51,320,98,353,18.1,13.7,21.7,00000
70.0,66.0,22.0,614,03,01,  Bilat Ali Mandaltala,178,473,78,219,100,254,27.3,26.3,28.2,00000
70.0,66.0,22.0,614,04,01,  Jhatu Mandaltala,93,321,35,131,58,190,22.5,21.1,23.4,00000
70.0,66.0,27.0,037,01,01,  Harma,1157,2860,548,1480,609,1380,28.8,27.0,30.6,00000
70.0,66.0,27.0,037,02,01,  Namdharma,384,1318,158,684,226,634,22.6,18.8,26.3,00000
70.0,66.0,33.0,415,01,01,  Gobratala,1033,1077,487,524,546,553,49.0,48.2,49.7,00000
70.0,66.0,33.0,415,02,01,  Ghughudima,421,569,194,283,227,286,42.5,40.7,44.2,00000
70.0,66.0,33.0,415,03,01,  Kalitala,51,122,20,68,31,54,29.5,22.7,36.5,00000
70.0,66.0,39.0,096,01,01,  Bara Rasia,890,3046,409,1477,481,1569,22.6,21.7,23.5,00000
70.0,66.0,39.0,096,02,01,  Krarjbaro Roshia,89,290,34,135,55,155,23.5,20.1,26.2,00000
70.0,66.0,39.0,096,03,01,  Charbaro Roshia,76,511,31,254,45,257,12.9,10.9,14.9,00000
70.0,66.0,39.0,449,01,01,  Natun Islampur,154,648,78,332,76,316,19.2,19.0,19.4,00000
70.0,66.0,39.0,449,02,01,  Ilishmari,609,1322,255,626,354,696,31.5,28.9,33.7,00000
70.0,66.0,39.0,449,03,01,  Islampur,605,2132,277,1065,328,1067,22.1,20.6,23.5,00000
70.0,66.0,39.0,739,01,01,  Kazi Para,376,1552,167,760,209,792,19.5,18.0,20.9,00000
70.0,66.0,39.0,739,02,01,  Lakshmi Narayanpur,802,2184,345,1046,457,1138,26.9,24.8,28.7,00000
70.0,66.0,44.0,466,01,01,  Jhilim Bazar,2047,2079,1029,1017,1018,1062,49.6,50.3,48.9,00000
70.0,66.0,44.0,466,02,01,  Amurabari Bazar,1989,1454,1006,738,983,716,57.8,57.7,57.9,00000
70.0,66.0,55.0,844,01,01,  Goaltuli,1278,1524,533,740,745,784,45.6,41.9,48.7,00000
70.0,66.0,55.0,844,02,01,  Miah Para,1385,1909,660,868,725,1041,42.0,43.2,41.1,00000
70.0,66.0,55.0,844,03,01,  Mintala,692,559,311,258,381,301,55.3,54.7,55.9,00000
70.0,66.0,55.0,844,04,01,  Bhagabanpur,977,1734,427,795,550,939,36.0,34.9,36.9,00000
70.0,66.0,55.0,844,05,01,  Tilak Chandpur,619,723,236,338,383,385,46.1,41.1,49.9,00000
70.0,66.0,55.0,844,06,01,  Mohammadpur,1336,1278,596,554,740,724,51.1,51.8,50.5,00000
70.0,66.0,55.0,844,07,01,  Munshi Mandalertala,1491,1869,653,917,838,952,44.4,41.6,46.8,00000
70.0,66.0,55.0,844,08,01,  Sekh Para (1),797,1089,374,517,423,572,42.3,42.0,42.5,00000
70.0,66.0,55.0,844,09,01,  Salim Dolpara,927,1214,383,602,544,612,43.3,38.9,47.1,00000
70.0,66.0,55.0,844,10,01,  Tikra,532,779,238,394,294,385,40.6,37.7,43.3,00000
70.0,66.0,67.0,483,01,01,  Kasari Para,167,234,81,111,86,123,41.6,42.2,41.1,00000
70.0,66.0,67.0,483,02,01,  Ghuti Para,227,194,96,93,131,101,53.9,50.8,56.5,00000
70.0,66.0,67.0,483,03,01,  Alim Nagar,132,405,44,216,88,189,24.6,16.9,31.8,00000
70.0,66.0,67.0,483,04,01,  Surjya Narayanpur,40,393,16,206,24,187,9.2,7.2,11.4,00000
70.0,66.0,67.0,483,05,01,  Tiklir Char,218,251,89,118,129,133,46.5,43.0,49.2,00000
70.0,66.0,67.0,483,06,01,  Maharajnagar,87,393,30,194,57,199,18.1,13.4,22.3,00000
70.0,66.0,67.0,699,01,01,  Narayanpur,1174,3462,532,1830,642,1632,25.3,22.5,28.2,00000
70.0,66.0,67.0,699,02,01,  Satrashia,218,1028,112,535,106,493,17.5,17.3,17.7,00000
70.0,66.0,67.0,699,03,01,  Madrasa Para,208,713,99,349,109,364,22.6,22.1,23.0,00000
70.0,66.0,67.0,699,04,01,  Deb Pur,169,337,63,179,106,158,33.4,26.0,40.2,00000
70.0,66.0,67.0,699,05,01,  Narayanpur Ghon,76,429,27,213,49,216,15.0,11.3,18.5,00000
70.0,66.0,67.0,699,06,01,  Zohor Pur,122,445,53,234,69,211,21.5,18.5,24.6,00000
70.0,66.0,67.0,699,07,01,  Tokma Para,41,575,20,292,21,283,6.7,6.4,6.9,00000
70.0,66.0,67.0,699,08,01,  Bal Para,193,415,84,229,109,186,31.7,26.8,36.9,00000
70.0,66.0,83.0,807,01,01,  Ramchandrapur,1490,2098,606,999,884,1099,41.5,37.8,44.6,00000
70.0,66.0,83.0,807,02,01,  Ramchandrapur Hat,624,282,308,115,316,167,68.9,72.8,65.4,00000
70.0,66.0,83.0,807,03,01,  Uttar Krishna Gobindapur,930,1019,407,498,523,521,47.7,45.0,50.1,00000
70.0,66.0,83.0,807,04,01,  Hothat Para,378,746,155,357,223,389,33.6,30.3,36.4,00000
70.0,66.0,83.0,841,01,01,  Ghorapakhia,1456,1325,665,636,791,689,52.4,51.1,53.4,00000
70.0,66.0,83.0,841,02,01,  Kamlakanto Pur,503,449,229,212,274,237,52.8,51.9,53.6,00000
70.0,66.0,83.0,841,03,01,  Baharam,944,1331,441,661,503,670,41.5,40.0,42.9,00000
70.0,66.0,83.0,841,04,01,  Nayala Bhanga,61,89,25,40,36,49,40.7,38.5,42.4,00000
70.0,66.0,83.0,841,05,01,  Chunakhali,1566,1607,711,781,855,826,49.4,47.7,50.9,00000
70.0,66.0,83.0,841,06,01,  Purbochak Churiakhali,443,339,218,142,225,197,56.6,60.6,53.3,00000
70.0,66.0,83.0,841,07,01,  Chak Baharam,1048,1028,473,486,575,542,50.5,49.3,51.5,00000
70.0,66.0,83.0,841,08,01,  Dhumi Hayatpur,854,884,405,377,449,507,49.1,51.8,47.0,00000
70.0,66.0,83.0,841,09,01,  Krishna Gobindapur,1127,1191,508,529,619,662,48.6,49.0,48.3,00000
70.0,66.0,83.0,841,10,01,  Chak Alampur,1035,1179,477,520,558,659,46.7,47.8,45.9,00000
70.0,66.0,89.0,898,01,01,  Narendrapur,1193,4506,510,2135,683,2371,20.9,19.3,22.4,00000
70.0,66.0,89.0,898,02,01,  Shakhalipur,569,1465,191,731,378,734,28.0,20.7,34.0,00000
70.0,66.0,89.0,898,03,01,  Joynalpur,270,464,113,225,157,239,36.8,33.4,39.6,00000
70.0,66.0,89.0,898,04,01,  Harishpur,403,998,202,480,201,518,28.8,29.6,28.0,00000
70.0,66.0,89.0,898,05,01,  Hakimpur,548,1785,244,822,304,963,23.5,22.9,24.0,00000
70.0,66.0,89.0,898,06,01,  Sujan Para,956,1541,412,749,544,792,38.3,35.5,40.7,00000
70.0,66.0,94.0,164,01,01,  Badyanathpur,154,358,75,167,79,191,30.1,31.0,29.3,00000
70.0,66.0,94.0,164,02,01,  Natun Nawab Zaigir,206,202,100,101,106,101,50.5,49.8,51.2,00000
70.0,66.0,94.0,164,03,01,  Puraton Nawab Jaigir,510,637,230,322,280,315,44.5,41.7,47.1,00000
70.0,66.0,94.0,494,01,01,  Kalinagar,2304,3477,999,1724,1305,1753,39.9,36.7,42.7,00000
70.0,66.0,94.0,494,02,01,  Dowatola,227,219,97,103,130,116,50.9,48.5,52.8,00000
70.0,66.0,94.0,818,01,01,  Chha Bhania,509,549,226,267,283,282,48.1,45.8,50.1,00000
70.0,66.0,94.0,818,02,01,  Kichnidaha,347,446,158,219,189,227,43.8,41.9,45.4,00000
70.0,66.0,94.0,818,03,01,  Mallan,326,328,160,159,166,169,49.8,50.2,49.6,00000
70.0,66.0,94.0,818,04,01,  Bera Para,675,1139,285,590,390,549,37.2,32.6,41.5,00000
70.0,66.0,94.0,818,05,01,  Fata Para,269,601,126,307,143,294,30.9,29.1,32.7,00000
70.0,66.0,94.0,818,06,01,  Maharajnagar,283,704,117,349,166,355,28.7,25.1,31.9,00000
70.0,66.0,94.0,818,07,01,  Sundar Pur,355,473,162,221,193,252,42.9,42.3,43.4,00000
70.0,66.0,94.0,818,08,01,  Joandi Pur,402,931,150,477,252,454,30.2,23.9,35.7,00000
70.0,66.0,94.0,938,01,01,  Baghdanga,569,822,276,430,293,392,40.9,39.1,42.8,00000
70.0,66.0,94.0,938,02,01,  Namo Sundarpur,257,286,123,133,134,153,47.3,48.0,46.7,00000
70.0,66.0,94.0,938,03,01,  Salim Haji Para,197,359,79,187,118,172,35.4,29.7,40.7,00000
70.0,66.0,94.0,938,04,01,  Panka Para,174,370,81,173,93,197,32.0,31.9,32.1,00000
70.0,66.0,94.0,938,05,01,  Pachim Bagdanga,454,705,216,349,238,356,39.2,38.2,40.1,00000
70.0,88.0,10.0,005,01,01,  Airamari,737,428,370,202,367,226,63.3,64.7,61.9,00000
70.0,88.0,10.0,005,02,01,  Chhota Airamari,36,447,18,220,18,227,7.5,7.6,7.3,00000
70.0,88.0,10.0,090,01,01,  Riaz Bishwastala,430,452,231,221,199,231,48.8,51.1,46.3,00000
70.0,88.0,10.0,090,02,01,  Zahrdi Bishwastala,192,181,99,84,93,97,51.5,54.1,48.9,00000
70.0,88.0,10.0,090,03,01,  Sadharitala,193,331,120,161,73,170,36.8,42.7,30.0,00000
70.0,88.0,10.0,090,04,01,  Kabirajtala,257,321,129,171,128,150,44.5,43.0,46.0,00000
70.0,88.0,10.0,090,05,01,  Eradat Biswastala,224,588,103,309,121,279,27.6,25.0,30.3,00000
70.0,88.0,10.0,090,06,01,  Pankatala,246,225,116,116,130,109,52.2,50.0,54.4,00000
70.0,88.0,10.0,090,07,01,  Khaserhat,150,144,79,71,71,73,51.0,52.7,49.3,00000
70.0,88.0,10.0,090,08,01,  Paikartala,237,227,128,116,109,111,51.1,52.5,49.5,00000
70.0,88.0,10.0,090,09,01,  Bhatritala,48,144,18,76,30,68,25.0,19.1,30.6,00000
70.0,88.0,10.0,100,01,01,  Zafartala,66,108,33,51,33,57,37.9,39.3,36.7,00000
70.0,88.0,10.0,100,02,01,  Chhaygharia,163,222,71,118,92,104,42.3,37.6,46.9,00000
70.0,88.0,10.0,100,03,01,  Tilkitala,87,133,43,72,44,61,39.5,37.4,41.9,00000
70.0,88.0,10.0,100,04,01,  Aziz Biswastala,541,1071,272,525,269,546,33.6,34.1,33.0,00000
70.0,88.0,10.0,100,05,01,  Sirajtala,255,402,113,211,142,191,38.8,34.9,42.6,00000
70.0,88.0,10.0,100,06,01,  Kermattala,69,138,37,75,32,63,33.3,33.0,33.7,00000
70.0,88.0,10.0,100,07,01,  Refujeetala,196,396,102,211,94,185,33.1,32.6,33.7,00000
70.0,88.0,10.0,201,01,01,  Chandsikari,402,390,215,176,187,214,50.8,55.0,46.6,00000
70.0,88.0,10.0,201,02,01,  Kamat,276,550,129,281,147,269,33.4,31.5,35.3,00000
70.0,88.0,10.0,301,01,01,  Jabbar Biswastala,552,673,292,324,260,349,45.1,47.4,42.7,00000
70.0,88.0,10.0,301,02,01,  Pandatala,395,275,209,130,186,145,59.0,61.7,56.2,00000
70.0,88.0,10.0,301,03,01,  Saheb Biswastala,102,78,55,33,47,45,56.7,62.5,51.1,00000
70.0,88.0,10.0,301,04,01,  Hakitala,178,255,80,121,98,134,41.1,39.8,42.2,00000
70.0,88.0,10.0,301,05,01,  Chapratala,237,301,122,151,115,150,44.1,44.7,43.4,00000
70.0,88.0,10.0,301,06,01,  Doctortala,141,212,63,108,78,104,39.9,36.8,42.9,00000
70.0,88.0,10.0,301,07,01,  Shanommadtoli,423,262,210,121,213,141,61.8,63.4,60.2,00000
70.0,88.0,10.0,422,01,01,  Sekhtala,288,603,143,301,145,302,32.3,32.2,32.4,00000
70.0,88.0,10.0,422,02,01,  Karimtala,413,772,199,381,214,391,34.9,34.3,35.4,00000
70.0,88.0,10.0,442,01,01,  Kismattala,136,109,64,57,72,52,55.5,52.9,58.1,00000
70.0,88.0,10.0,442,02,01,  Mobaraktala,160,445,88,209,72,236,26.4,29.6,23.4,00000
70.0,88.0,10.0,442,03,01,  Muradtala,209,393,100,203,109,190,34.7,33.0,36.5,00000
70.0,88.0,10.0,442,04,01,  Sardartala,400,469,197,256,203,213,46.0,43.5,48.8,00000
70.0,88.0,10.0,442,05,01,  Tamiz Biswastala,192,267,85,139,107,128,41.8,37.9,45.5,00000
70.0,88.0,10.0,442,06,01,  Ismail Biswastala,636,1297,304,635,332,662,32.9,32.4,33.4,00000
70.0,88.0,10.0,442,07,01,  Manurditala,123,255,51,136,72,119,32.5,27.3,37.7,00000
70.0,88.0,10.0,442,08,01,  Lazibtala,138,287,63,152,75,135,32.5,29.3,35.7,00000
70.0,88.0,10.0,442,09,01,  Chapratala,147,206,68,104,79,102,41.6,39.5,43.6,00000
70.0,88.0,10.0,442,10,01,  Rahamattala,76,237,36,123,40,114,24.3,22.6,26.0,00000
70.0,88.0,10.0,442,11,01,  Paikartala,77,196,37,99,40,97,28.2,27.2,29.2,00000
70.0,88.0,10.0,497,01,01,  Kismattala,118,169,50,81,68,88,41.1,38.2,43.6,00000
70.0,88.0,10.0,497,02,01,  Jharutala,304,440,154,230,150,210,40.9,40.1,41.7,00000
70.0,88.0,10.0,507,01,01,  Mistri Para,613,854,299,432,314,422,41.8,40.9,42.7,00000
70.0,88.0,10.0,507,02,01,  Hindutala,188,310,96,164,92,146,37.8,36.9,38.7,00000
70.0,88.0,10.0,507,03,01,  Zahirditala,108,258,60,125,48,133,29.5,32.4,26.5,00000
70.0,88.0,10.0,507,04,01,  Fazle Haque Mastartala,162,115,80,52,82,63,58.5,60.6,56.6,00000
70.0,88.0,10.0,738,01,01,  Bablabona,160,284,83,147,77,137,36.0,36.1,36.0,00000
70.0,88.0,10.0,738,02,01,  Chihattorbighi,330,399,161,218,169,181,45.3,42.5,48.3,00000
70.0,88.0,10.0,814,01,01,  Saha Mohammaditala,287,393,121,203,166,190,42.2,37.3,46.6,00000
70.0,88.0,10.0,814,02,01,  Dafadartala,147,382,83,203,64,179,27.8,29.0,26.3,00000
70.0,88.0,10.0,814,03,01,  Ayubtala,110,295,56,158,54,137,27.2,26.2,28.3,00000
70.0,88.0,10.0,814,04,01,  Satrasia,298,588,127,308,171,280,33.6,29.2,37.9,00000
70.0,88.0,10.0,814,05,01,  Khonda,526,815,236,457,290,358,39.2,34.1,44.8,00000
70.0,88.0,10.0,924,01,01,  Bara Tapu,440,1089,216,553,224,536,28.8,28.1,29.5,00000
70.0,88.0,10.0,924,02,01,  Chhota Tapu,268,278,144,145,124,133,49.1,49.8,48.2,00000
70.0,88.0,10.0,924,03,01,  Bhotritala,101,131,49,72,52,59,43.5,40.5,46.8,00000
70.0,88.0,11.0,080,01,01,  Bimarshi,455,1012,189,514,266,498,31.0,26.9,34.8,00000
70.0,88.0,11.0,080,02,01,  Gaurisankarpur,449,1344,180,677,269,667,25.0,21.0,28.7,00000
70.0,88.0,11.0,080,03,01,  Uttar Krisnachandrapur,100,192,53,93,47,99,34.2,36.3,32.2,00000
70.0,88.0,11.0,080,04,01,  Dublibandar,150,523,57,272,93,251,22.3,17.3,27.0,00000
70.0,88.0,11.0,170,01,01,  Chak Kirti,1380,2717,688,1453,692,1264,33.7,32.1,35.4,00000
70.0,88.0,11.0,170,02,01,  Gauri Sankarpur,204,301,88,145,116,156,40.4,37.8,42.6,00000
70.0,88.0,11.0,170,03,01,  Dubli Bhandar,696,1144,333,597,363,547,37.8,35.8,39.9,00000
70.0,88.0,11.0,206,01,01,  Akhera,135,520,65,256,70,264,20.6,20.2,21.0,00000
70.0,88.0,11.0,206,02,01,  Sahebgram,361,1105,142,551,219,554,24.6,20.5,28.3,00000
70.0,88.0,11.0,206,03,01,  Lahlamari,136,336,68,178,68,158,28.8,27.6,30.1,00000
70.0,88.0,11.0,206,04,01,  Madia,104,233,46,114,58,119,30.9,28.8,32.8,00000
70.0,88.0,11.0,206,05,01,  Char Charaktala,112,383,61,183,51,200,22.6,25.0,20.3,00000
70.0,88.0,11.0,718,01,01,  Chandpur,693,1041,358,497,335,544,40.0,41.9,38.1,00000
70.0,88.0,11.0,718,02,01,  Kanshra,99,484,42,247,57,237,17.0,14.5,19.4,00000
70.0,88.0,11.0,718,03,01,  Gab Tala,139,409,57,209,82,200,25.4,21.4,29.1,00000
70.0,88.0,11.0,793,01,01,  Ranibari,1574,3670,735,1818,839,1852,30.0,28.8,31.2,00000
70.0,88.0,11.0,793,02,01,  Par Ranibari,39,30,16,12,23,18,56.5,57.1,56.1,00000
70.0,88.0,17.0,185,01,01,  Daipukuria,126,333,63,164,63,169,27.5,27.8,27.2,00000
70.0,88.0,17.0,185,02,01,  Chak Sreeram,407,929,180,492,227,437,30.5,26.8,34.2,00000
70.0,88.0,17.0,185,03,01,  Shaheribata,333,560,167,286,166,274,37.3,36.9,37.7,00000
70.0,88.0,17.0,251,01,01,  Darigachha,266,710,120,369,146,341,27.3,24.5,30.0,00000
70.0,88.0,17.0,251,02,01,  Gazipur,669,733,317,368,352,365,47.7,46.3,49.1,00000
70.0,88.0,17.0,261,01,01,  Houshnagar,183,259,91,141,92,118,41.4,39.2,43.8,00000
70.0,88.0,17.0,261,02,01,  Baghbari,582,820,300,397,282,423,41.5,43.0,40.0,00000
70.0,88.0,17.0,306,01,01,  Eklaspur,381,882,181,437,200,445,30.2,29.3,31.0,00000
70.0,88.0,17.0,306,02,01,  Padlasbari,105,328,45,172,60,156,24.2,20.7,27.8,00000
70.0,88.0,17.0,562,01,01,  Mirzapur,1440,3586,690,1840,750,1746,28.7,27.3,30.0,00000
70.0,88.0,17.0,562,02,01,  Kamalpur,443,1023,213,539,230,484,30.2,28.3,32.2,00000
70.0,88.0,17.0,608,01,01,  English,159,916,78,457,81,459,14.8,14.6,15.0,00000
70.0,88.0,17.0,608,02,01,  Chaipar,208,257,106,124,102,133,44.7,46.1,43.4,00000
70.0,88.0,23.0,140,01,01,  Pirgachhi (Part),358,673,162,346,196,327,34.7,31.9,37.5,00000
70.0,88.0,23.0,140,02,01,  Goptamanik (Part),716,848,332,458,384,390,45.8,42.0,49.6,00000
70.0,88.0,23.0,140,03,01,  Bamangaon,918,1661,393,852,525,809,35.6,31.6,39.4,00000
70.0,88.0,23.0,140,04,01,  Chaitanpur (Part),828,1185,387,572,441,613,41.1,40.4,41.8,00000
70.0,88.0,23.0,286,01,01,  Polladanga,654,607,321,298,333,309,51.9,51.9,51.9,00000
70.0,88.0,23.0,286,02,01,  Dhainagar,984,1566,451,795,533,771,38.6,36.2,40.9,00000
70.0,88.0,23.0,286,03,01,  Raninagar,1437,1494,703,714,734,780,49.0,49.6,48.5,00000
70.0,88.0,23.0,286,04,01,  Ankhira,268,171,129,89,139,82,61.0,59.2,62.9,00000
70.0,88.0,23.0,286,05,01,  Hajibhanga,123,465,46,242,77,223,20.9,16.0,25.7,00000
70.0,88.0,23.0,286,06,01,  Pirgachhi (Part),631,680,287,341,344,339,48.1,45.7,50.4,00000
70.0,88.0,23.0,286,07,01,  Gopta Manik (Part),1166,1361,530,701,636,660,46.1,43.1,49.1,00000
70.0,88.0,23.0,356,01,01,  Gonsaibari,564,759,291,389,273,370,42.6,42.8,42.5,00000
70.0,88.0,23.0,356,02,01,  Daratala,266,524,115,258,151,266,33.7,30.8,36.2,00000
70.0,88.0,23.0,577,01,01,  Chaitanpur (Part),1143,1746,516,881,627,865,39.6,36.9,42.0,00000
70.0,88.0,23.0,577,02,01,  Maheshpur,1415,2039,631,1068,784,971,41.0,37.1,44.7,00000
70.0,88.0,23.0,663,01,01,  Balihapur,398,486,177,249,221,237,45.0,41.5,48.3,00000
70.0,88.0,23.0,663,02,01,  Jabri Kazi Para,506,675,201,364,305,311,42.8,35.6,49.5,00000
70.0,88.0,29.0,296,01,01,  Jagannathpur Babar Mollartala,235,218,121,111,114,107,51.9,52.2,51.6,00000
70.0,88.0,29.0,296,02,01,  Kalupur,1850,2106,851,1132,999,974,46.8,42.9,50.6,00000
70.0,88.0,29.0,296,03,01,  Par Kalupur,760,817,379,424,381,393,48.2,47.2,49.2,00000
70.0,88.0,29.0,296,04,01,  Amtala,102,339,42,159,60,180,23.1,20.9,25.0,00000
70.0,88.0,29.0,296,05,01,  15 Rasia,768,1063,354,546,414,517,41.9,39.3,44.5,00000
70.0,88.0,29.0,296,06,01,  17 Rasia,138,233,75,117,63,116,37.2,39.1,35.2,00000
70.0,88.0,29.0,296,07,01,  8 Rasia,397,755,190,388,207,367,34.5,32.9,36.1,00000
70.0,88.0,29.0,296,08,01,  40 Rasia,145,173,76,76,69,97,45.6,50.0,41.6,00000
70.0,88.0,29.0,296,09,01,  33 Rasia,153,220,77,117,76,103,41.0,39.7,42.5,00000
70.0,88.0,29.0,296,10,01,  Maruaritala,130,146,53,85,77,61,47.1,38.4,55.8,00000
70.0,88.0,29.0,296,11,01,  32 Rasia,330,452,158,244,172,208,42.2,39.3,45.3,00000
70.0,88.0,29.0,296,12,01,  5 Rasia,114,322,64,175,50,147,26.1,26.8,25.4,00000
70.0,88.0,29.0,296,13,01,  Damudiartala,247,756,116,382,131,374,24.6,23.3,25.9,00000
70.0,88.0,29.0,296,14,01,  Durlabhapur,786,1851,350,907,436,944,29.8,27.8,31.6,00000
70.0,88.0,29.0,296,15,01,  Gangarampur,386,117,191,66,195,51,76.7,74.3,79.3,00000
70.0,88.0,29.0,296,16,01,  8 Bighi,64,139,29,85,35,54,31.5,25.4,39.3,00000
70.0,88.0,29.0,296,17,01,  Sherpur Bhandar,820,771,402,403,418,368,51.5,49.9,53.2,00000
70.0,88.0,29.0,296,18,01,  Lakshmipur-1,144,209,72,110,72,99,40.8,39.6,42.1,00000
70.0,88.0,29.0,296,19,01,  Ghuntala,71,268,38,143,33,125,20.9,21.0,20.9,00000
70.0,88.0,29.0,296,20,01,  Chama Bhandar,154,245,69,127,85,118,38.6,35.2,41.9,00000
70.0,88.0,29.0,296,21,01,  Chak Chama,74,249,31,149,43,100,22.9,17.2,30.1,00000
70.0,88.0,29.0,296,22,01,  Puran 12 Rasia,704,1103,334,574,370,529,39.0,36.8,41.2,00000
70.0,88.0,29.0,296,23,01,  Natun 12 Rasia,423,569,191,291,232,278,42.6,39.6,45.5,00000
70.0,88.0,29.0,296,24,01,  Dadan Chak,1430,1727,712,887,718,840,45.3,44.5,46.1,00000
70.0,88.0,29.0,296,25,01,  Balutangi,829,1447,434,739,395,708,36.4,37.0,35.8,00000
70.0,88.0,29.0,296,26,01,  Puran Balutangi,355,435,180,238,175,197,44.9,43.1,47.0,00000
70.0,88.0,29.0,296,27,01,  Siddiquetala,110,289,47,151,63,138,27.6,23.7,31.3,00000
70.0,88.0,29.0,296,28,01,  Jagannathpur Bathanbari,299,496,116,257,183,239,37.6,31.1,43.4,00000
70.0,88.0,29.0,296,29,01,  Kangali Mollartala,94,101,40,52,54,49,48.2,43.5,52.4,00000
70.0,88.0,29.0,296,30,01,  Ganesh Chowkidartala,55,257,29,117,26,140,17.6,19.9,15.7,00000
70.0,88.0,29.0,296,31,01,  Mota Mollartala,166,307,76,139,90,168,35.1,35.3,34.9,00000
70.0,88.0,29.0,296,32,01,  Rahim Biswasertala,212,200,108,97,104,103,51.5,52.7,50.2,00000
70.0,88.0,29.0,296,33,01,  Lakshmipur-2,191,437,93,231,98,206,30.4,28.7,32.2,00000
70.0,88.0,29.0,412,01,01,  Payalmari,653,819,316,411,337,408,44.4,43.5,45.2,00000
70.0,88.0,29.0,412,02,01,  Ghughudanga,335,1202,169,571,166,631,21.8,22.8,20.8,00000
70.0,88.0,29.0,412,03,01,  Dakat Para,109,301,56,155,53,146,26.6,26.5,26.6,00000
70.0,88.0,29.0,412,04,01,  Dubhaga,482,750,236,375,246,375,39.1,38.6,39.6,00000
70.0,88.0,29.0,412,05,01,  Ayub Biswasertala,209,623,124,294,85,329,25.1,29.7,20.5,00000
70.0,88.0,29.0,412,06,01,  Farijuddin Biswasertala,106,277,48,139,58,138,27.7,25.7,29.6,00000
70.0,88.0,29.0,412,07,01,  Pandith Para,95,339,56,168,39,171,21.9,25.0,18.6,00000
70.0,88.0,29.0,412,08,01,  Menitala,323,868,165,461,158,407,27.1,26.4,28.0,00000
70.0,88.0,29.0,412,09,01,  Tangra Para,131,577,59,300,72,277,18.5,16.4,20.6,00000
70.0,88.0,29.0,412,10,01,  Khorshed Mollartala,232,429,128,217,104,212,35.1,37.1,32.9,00000
70.0,88.0,29.0,412,11,01,  Samadmoller Tala,26,228,17,115,9,113,10.2,12.9,7.4,00000
70.0,88.0,29.0,412,12,01,  Katha Para,24,183,16,96,8,87,11.6,14.3,8.4,00000
70.0,88.0,29.0,412,13,01,  Joyedmollertola,59,147,37,79,22,68,28.6,31.9,24.4,00000
70.0,88.0,29.0,412,14,01,  Ful Diary,38,112,26,60,12,52,25.3,30.2,18.8,00000
70.0,88.0,29.0,412,15,01,  Meher Pur,100,398,35,207,65,191,20.1,14.5,25.4,00000
70.0,88.0,29.0,783,01,01,  Montaz Mollartala,191,607,95,313,96,294,23.9,23.3,24.6,00000
70.0,88.0,29.0,783,02,01,  Samsul Mollartala,147,346,61,186,86,160,29.8,24.7,35.0,00000
70.0,88.0,29.0,783,03,01,  Dadan Mollartala,100,525,42,263,58,262,16.0,13.8,18.1,00000
70.0,88.0,29.0,783,04,01,  Ranathpur,59,418,27,212,32,206,12.4,11.3,13.4,00000
70.0,88.0,35.0,336,01,01,  Bhabanipur,275,157,117,65,158,92,63.7,64.3,63.2,00000
70.0,88.0,35.0,336,02,01,  Dhumi Kutuni Para,128,159,55,93,73,66,44.6,37.2,52.5,00000
70.0,88.0,35.0,336,03,01,  Dhumi Ghasha Para,239,261,110,125,129,136,47.8,46.8,48.7,00000
70.0,88.0,35.0,336,04,01,  Dhumi Chand Ghasha Para,125,357,65,183,60,174,25.9,26.2,25.6,00000
70.0,88.0,35.0,336,05,01,  Dhumi Hayatpur,131,192,58,91,73,101,40.6,38.9,42.0,00000
70.0,88.0,35.0,336,06,01,  Krishna Gobindapur,90,178,35,85,55,93,33.6,29.2,37.2,00000
70.0,88.0,35.0,336,07,01,  Debuttar Bilpara,110,141,47,63,63,78,43.8,42.7,44.7,00000
70.0,88.0,35.0,336,08,01,  Chak Bhabanipur,207,101,107,40,100,61,67.2,72.8,62.1,00000
70.0,88.0,35.0,336,09,01,  Chak Debuttar,97,125,46,55,51,70,43.7,45.5,42.1,00000
70.0,88.0,35.0,336,10,01,  Debuttar,157,269,61,122,96,147,36.9,33.3,39.5,00000
70.0,88.0,35.0,336,11,01,  Chak,188,254,89,119,99,135,42.5,42.8,42.3,00000
70.0,88.0,35.0,336,12,01,  Par Krishna Gobindpur,532,588,220,262,312,326,47.5,45.6,48.9,00000
70.0,88.0,35.0,336,14,01,  Rupnagar,183,219,88,105,95,114,45.5,45.6,45.5,00000
70.0,88.0,35.0,336,15,01,  Chak Chunakhali,12,25,4,10,8,15,32.4,28.6,34.8,00000
70.0,88.0,35.0,336,16,01,  Chak Alampur,139,192,46,91,93,101,42.0,33.6,47.9,00000
70.0,88.0,35.0,336,17,01,  Par Kalinagar,710,355,346,154,364,201,66.7,69.2,64.4,00000
70.0,88.0,35.0,336,18,01,  Sundarnagar,207,271,105,112,102,159,43.3,48.4,39.1,00000
70.0,88.0,35.0,336,19,01,  Tero Rasia,211,221,88,102,123,119,48.8,46.3,50.8,00000
70.0,88.0,35.0,336,20,01,  Kalinagar(Bablabona),88,189,38,86,50,103,31.8,30.6,32.7,00000
70.0,88.0,35.0,336,21,01,  Char Mohon Pur,301,543,126,284,175,259,35.7,30.7,40.3,00000
70.0,88.0,35.0,336,22,01,  Baharam,142,92,78,46,64,46,60.7,62.9,58.2,00000
70.0,88.0,35.0,336,23,01,  Par Dhumi Hayatpur,478,726,213,370,265,356,39.7,36.5,42.7,00000
70.0,88.0,35.0,336,24,01,  Hatath Para,267,273,104,116,163,157,49.4,47.3,50.9,00000
70.0,88.0,35.0,336,25,01,  Nutun Gram,929,1272,376,559,553,713,42.2,40.2,43.7,00000
70.0,88.0,35.0,336,26,01,  Rasia (Chama),408,627,140,294,268,333,39.4,32.3,44.6,00000
70.0,88.0,41.0,391,01,01,  Haripur,350,1118,156,529,194,589,23.8,22.8,24.8,00000
70.0,88.0,41.0,391,02,01,  Chak Haripur,553,1127,252,595,301,532,32.9,29.8,36.1,00000
70.0,88.0,41.0,457,01,03,  Bahlabari,659,1098,309,585,350,513,37.5,34.6,40.6,00000
70.0,88.0,41.0,457,02,03,  Kansat,1435,1463,724,686,711,777,49.5,51.3,47.8,00000
70.0,88.0,41.0,457,03,03,  Gopalnagar,679,827,364,439,315,388,45.1,45.3,44.8,00000
70.0,88.0,41.0,587,01,01,  Raghobpur,361,683,153,351,208,332,34.6,30.4,38.5,00000
70.0,88.0,41.0,587,02,01,  Balu Char,665,2539,305,1308,360,1231,20.8,18.9,22.6,00000
70.0,88.0,41.0,703,01,01,  Pukuria,671,649,341,327,330,322,50.8,51.0,50.6,00000
70.0,88.0,41.0,703,02,01,  Bansh Mahal,118,305,55,162,63,143,27.9,25.3,30.6,00000
70.0,88.0,41.0,703,03,01,  Salimabad,146,101,76,46,70,55,59.1,62.3,56.0,00000
70.0,88.0,47.0,321,01,01,  Battala,102,519,35,286,67,233,16.4,10.9,22.3,00000
70.0,88.0,47.0,321,02,01,  Gangarampur,478,411,239,229,239,182,53.8,51.1,56.8,00000
70.0,88.0,47.0,321,03,01,  Danialpur,147,281,65,156,82,125,34.3,29.4,39.6,00000
70.0,88.0,47.0,371,01,01,  Guabari Chandpur,1445,2566,712,1332,733,1234,36.0,34.8,37.3,00000
70.0,88.0,47.0,371,02,01,  Sahebgram,224,225,110,119,114,106,49.9,48.0,51.8,00000
70.0,88.0,47.0,371,03,01,  Sahebnagar,510,1116,246,575,264,541,31.4,30.0,32.8,00000
70.0,88.0,47.0,371,04,01,  Ranibari,76,329,32,169,44,160,18.8,15.9,21.6,00000
70.0,88.0,47.0,432,01,01,  Kalabari,281,307,128,163,153,144,47.8,44.0,51.5,00000
70.0,88.0,47.0,432,02,01,  Joharpur,151,143,70,83,81,60,51.4,45.8,57.4,00000
70.0,88.0,47.0,462,01,01,  Kansat Sikarpur,268,585,120,321,148,264,31.4,27.2,35.9,00000
70.0,88.0,47.0,462,02,01,  Gushogram,188,319,86,158,102,161,37.1,35.2,38.8,00000
70.0,88.0,47.0,512,01,01,  Lahapur,135,321,76,165,59,156,29.6,31.5,27.4,00000
70.0,88.0,47.0,512,02,01,  Bagbari,77,277,38,143,39,134,21.8,21.0,22.5,00000
70.0,88.0,47.0,522,01,01,  Lakshmipur,548,1054,282,520,266,534,34.2,35.2,33.3,00000
70.0,88.0,47.0,522,02,01,  Dari Chak,132,356,61,181,71,175,27.0,25.2,28.9,00000
70.0,88.0,47.0,522,03,01,  Kharokpur,185,235,101,122,84,113,44.0,45.3,42.6,00000
70.0,88.0,47.0,904,01,01,  Shikarpur,370,908,179,464,191,444,29.0,27.8,30.1,00000
70.0,88.0,47.0,904,02,01,  Daipukuria,280,864,139,454,141,410,24.5,23.4,25.6,00000
70.0,88.0,47.0,904,03,01,  Dhumaninagar,198,267,82,151,116,116,42.6,35.2,50.0,00000
70.0,88.0,53.0,065,01,01,  Singnagar,521,718,255,371,266,347,42.1,40.7,43.4,00000
70.0,88.0,53.0,065,02,01,  Bhabanipur,258,1205,120,575,138,630,17.6,17.3,18.0,00000
70.0,88.0,53.0,120,01,01,  Par Chauka,588,743,272,405,316,338,44.2,40.2,48.3,00000
70.0,88.0,53.0,120,02,01,  Puradihi,110,582,42,301,68,281,15.9,12.2,19.5,00000
70.0,88.0,53.0,120,03,01,  Kulapahari,474,520,231,268,243,252,47.7,46.3,49.1,00000
70.0,88.0,53.0,120,04,01,  Raghabbati,459,343,231,170,228,173,57.2,57.6,56.9,00000
70.0,88.0,53.0,120,05,01,  Chauka,502,520,274,264,228,256,49.1,50.9,47.1,00000
70.0,88.0,53.0,120,06,01,  Kharial,582,924,252,501,330,423,38.6,33.5,43.8,00000
70.0,88.0,53.0,120,07,01,  Chauka Manakasa,596,507,324,256,272,251,54.0,55.9,52.0,00000
70.0,88.0,53.0,125,01,01,  Nahiuddin Biswastala,290,276,161,137,129,139,51.2,54.0,48.1,00000
70.0,88.0,53.0,125,02,01,  Chauka Arazi Bankul,463,548,258,252,205,296,45.8,50.6,40.9,00000
70.0,88.0,53.0,125,03,01,  Bankul,398,351,182,175,216,176,53.1,51.0,55.1,00000
70.0,88.0,53.0,633,01,01,  Thota Para,1789,2728,915,1388,874,1340,39.6,39.7,39.5,00000
70.0,88.0,53.0,633,02,01,  Mistri Para,1084,2230,516,1075,568,1155,32.7,32.4,33.0,00000
70.0,88.0,53.0,633,03,01,  Pura Para,345,680,159,349,186,331,33.7,31.3,36.0,00000
70.0,88.0,53.0,768,01,01,  Hangami,794,1029,402,522,392,507,43.6,43.5,43.6,00000
70.0,88.0,53.0,768,02,01,  Singnagar,257,400,115,207,142,193,39.1,35.7,42.4,00000
70.0,88.0,53.0,768,03,01,  Kurkitola,307,280,157,147,150,133,52.3,51.6,53.0,00000
70.0,88.0,53.0,768,04,01,  Hausnagar,1021,712,515,362,506,350,58.9,58.7,59.1,00000
70.0,88.0,53.0,768,05,01,  Satrashiah,650,997,320,510,330,487,39.5,38.6,40.4,00000
70.0,88.0,53.0,768,06,01,  Manakosa,1060,886,547,468,513,418,54.5,53.9,55.1,00000
70.0,88.0,53.0,768,07,01,  Namotali,474,612,238,318,236,294,43.6,42.8,44.5,00000
70.0,88.0,53.0,768,08,01,  Tokana,359,697,187,355,172,342,34.0,34.5,33.5,00000
70.0,88.0,53.0,839,01,01,  Munshi Para,251,606,125,305,126,301,29.3,29.1,29.5,00000
70.0,88.0,53.0,839,02,01,  Kayat Para,349,274,175,146,174,128,56.0,54.5,57.6,00000
70.0,88.0,53.0,839,03,01,  Saha Para,426,829,191,412,235,417,33.9,31.7,36.0,00000
70.0,88.0,53.0,839,04,01,  Bilat Mandaler Para,151,301,81,150,70,151,33.4,35.1,31.7,00000
70.0,88.0,53.0,869,01,01,  Raninagar,1400,1324,668,705,732,619,51.4,48.7,54.2,00000
70.0,88.0,53.0,869,02,01,  Hangami,233,339,96,192,137,147,40.7,33.3,48.2,00000
70.0,88.0,53.0,919,01,01,  Ayub Daktarertala,322,776,150,387,172,389,29.3,27.9,30.7,00000
70.0,88.0,53.0,919,02,01,  Gafur Para,120,357,78,179,42,178,25.2,30.4,19.1,00000
70.0,88.0,59.0,040,01,01,  Babupur,563,1319,240,661,323,658,29.9,26.6,32.9,00000
70.0,88.0,59.0,040,02,01,  Babupur (Miratali),303,674,122,352,181,322,31.0,25.7,36.0,00000
70.0,88.0,59.0,597,01,01,  Sabek Naobhanga,1681,2637,785,1298,896,1339,38.9,37.7,40.1,00000
70.0,88.0,59.0,597,02,01,  Rasiknagar,347,488,150,236,197,252,41.6,38.9,43.9,00000
70.0,88.0,59.0,597,03,01,  Chak Ghorapakhia,224,138,97,55,127,83,61.9,63.8,60.5,00000
70.0,88.0,59.0,597,04,01,  Hausnagar,311,226,156,104,155,122,57.9,60.0,56.0,00000
70.0,88.0,59.0,597,05,01,  Kamlakanto Pur,772,684,392,350,380,334,53.0,52.8,53.2,00000
70.0,88.0,59.0,628,01,01,  Naya Naobhanga,3744,3963,1722,1985,2022,1978,48.6,46.5,50.6,00000
70.0,88.0,59.0,628,02,01,  Nichjami,567,606,260,312,307,294,48.3,45.5,51.1,00000
70.0,88.0,59.0,653,01,01,  Kamala Kantapur,485,310,268,156,217,154,61.0,63.2,58.5,00000
70.0,88.0,59.0,653,02,01,  Ranihati,981,831,480,390,501,441,54.1,55.2,53.2,00000
70.0,88.0,65.0,035,01,01,  Babupur,1398,1838,643,947,755,891,43.2,40.4,45.9,00000
70.0,88.0,65.0,035,02,01,  Kasirra,343,689,163,363,180,326,33.2,31.0,35.6,00000
70.0,88.0,65.0,517,01,01,  Lakshmipur,714,1101,313,576,401,525,39.3,35.2,43.3,00000
70.0,88.0,65.0,517,02,01,  Lakshmi Gourangapur,310,826,160,407,150,419,27.3,28.2,26.4,00000
70.0,88.0,65.0,643,01,01,  Dakhin Panka Char,560,1562,253,794,307,768,26.4,24.2,28.6,00000
70.0,88.0,65.0,643,02,01,  Dakhin Pankalisy Para,163,421,72,216,91,205,27.9,25.0,30.7,00000
70.0,88.0,65.0,643,03,01,  Dakhin Panka 13/Roshia,353,674,167,342,186,332,34.4,32.8,35.9,00000
70.0,88.0,65.0,648,01,01,  Uttar Panka,496,1522,207,755,289,767,24.6,21.5,27.4,00000
70.0,88.0,65.0,648,02,01,  Ckar Panka,598,1838,279,946,319,892,24.5,22.8,26.3,00000
70.0,88.0,65.0,648,03,01,  Paschim Panka,524,1726,250,882,274,844,23.3,22.1,24.5,00000
70.0,88.0,71.0,447,01,01,  Kamla Kantapur,1346,1509,605,733,741,776,47.1,45.2,48.8,00000
70.0,88.0,71.0,447,02,01,  Chak Ghorapakhia,275,368,124,180,151,188,42.8,40.8,44.5,00000
70.0,88.0,71.0,723,01,01,  Purba Jahangir Para,1116,1067,532,524,584,543,51.1,50.4,51.8,00000
70.0,88.0,71.0,723,02,01,  Bohalabari Ghat Para,353,596,142,293,211,303,37.2,32.6,41.1,00000
70.0,88.0,71.0,804,01,01,  Rasiknagar,1087,1004,456,511,631,493,52.0,47.2,56.1,00000
70.0,88.0,71.0,804,02,01,  Bahalabari (Uppar),287,262,139,139,148,123,52.3,50.0,54.6,00000
70.0,88.0,71.0,804,03,01,  Chak Ghorapakhia,470,542,217,253,253,289,46.4,46.2,46.7,00000
70.0,88.0,71.0,804,04,01,  Jukta Radhakantapur,227,139,114,65,113,74,62.0,63.7,60.4,00000
70.0,88.0,77.0,030,01,01,  Namo Chak Para,686,1503,351,777,335,726,31.3,31.1,31.6,00000
70.0,88.0,77.0,030,02,01,  Upar Chak Para,713,809,382,421,331,388,46.8,47.6,46.0,00000
70.0,88.0,77.0,030,03,01,  Unish Bighi,394,613,190,316,204,297,39.1,37.5,40.7,00000
70.0,88.0,77.0,030,04,01,  Bagicha Para,182,306,92,158,90,148,37.3,36.8,37.8,00000
70.0,88.0,77.0,030,05,01,  Hudma Para,262,380,134,204,128,176,40.8,39.6,42.1,00000
70.0,88.0,77.0,030,06,01,  Dhuli Para,240,303,108,176,132,127,44.2,38.0,51.0,00000
70.0,88.0,77.0,030,07,01,  Mandal Para,319,500,157,262,162,238,38.9,37.5,40.5,00000
70.0,88.0,77.0,030,08,01,  Mollahtala,402,488,209,240,193,248,45.2,46.5,43.8,00000
70.0,88.0,77.0,030,09,01,  Daud Sardarertala,114,180,65,93,49,87,38.8,41.1,36.0,00000
70.0,88.0,77.0,221,01,01,  Chapar,29,214,13,103,16,111,11.9,11.2,12.6,00000
70.0,88.0,77.0,221,02,01,  Shialmara,1196,1684,605,842,591,842,41.5,41.8,41.2,00000
70.0,88.0,77.0,221,03,01,  Jirpur,67,201,32,95,35,106,25.0,25.2,24.8,00000
70.0,88.0,77.0,221,04,01,  Nator,36,64,21,26,15,38,36.0,44.7,28.3,00000
70.0,88.0,77.0,291,01,01,  Tera Rasia,1246,1934,604,1023,642,911,39.2,37.1,41.3,00000
70.0,88.0,77.0,291,02,01,  Hazar Bighi,838,1153,399,611,439,542,42.1,39.5,44.8,00000
70.0,88.0,77.0,291,03,01,  Bholamari,527,1134,270,566,257,568,31.7,32.3,31.2,00000
70.0,88.0,77.0,291,04,01,  Kagmari,292,551,153,287,139,264,34.6,34.8,34.5,00000
70.0,88.0,77.0,291,05,01,  Chandpur,1112,1595,569,792,543,803,41.1,41.8,40.3,00000
70.0,88.0,77.0,291,06,01,  Sahebnagar,226,391,109,213,117,178,36.6,33.9,39.7,00000
70.0,88.0,77.0,291,07,01,  Naldubri,692,1057,333,539,359,518,39.6,38.2,40.9,00000
70.0,88.0,89.0,055,01,01,  Bahadur Mandaltala,432,451,233,235,199,216,48.9,49.8,48.0,00000
70.0,88.0,89.0,055,02,01,  Chini Para,260,200,132,101,128,99,56.5,56.7,56.4,00000
70.0,88.0,89.0,055,03,01,  Irat Biswastala,126,425,53,226,73,199,22.9,19.0,26.8,00000
70.0,88.0,89.0,055,04,01,  Natungram,288,579,124,316,164,263,33.2,28.2,38.4,00000
70.0,88.0,89.0,055,05,01,  Puratangram,244,461,124,230,120,231,34.6,35.0,34.2,00000
70.0,88.0,89.0,055,06,01,  Chowdhury Para,114,91,53,46,61,45,55.6,53.5,57.5,00000
70.0,88.0,89.0,055,07,01,  Bilpara,141,219,71,110,70,109,39.2,39.2,39.1,00000
70.0,88.0,89.0,241,01,01,  Khonch Para,117,363,60,190,57,173,24.4,24.0,24.8,00000
70.0,88.0,89.0,241,02,01,  Omarpur,856,2045,419,1063,437,982,29.5,28.3,30.8,00000
70.0,88.0,89.0,381,01,01,  Hadinagar Baragram,913,1372,468,715,445,657,40.0,39.6,40.4,00000
70.0,88.0,89.0,381,02,01,  Chamatala,524,708,268,370,256,338,42.5,42.0,43.1,00000
70.0,88.0,89.0,381,03,01,  Kamatala,194,446,92,243,102,203,30.3,27.5,33.4,00000
70.0,88.0,89.0,482,01,01,  Sanyasikup,121,207,61,116,60,91,36.9,34.5,39.7,00000
70.0,88.0,89.0,482,02,01,  Upar Kayla,159,365,74,197,85,168,30.3,27.3,33.6,00000
70.0,88.0,89.0,482,03,01,  Kayla Diar,1524,2687,733,1372,791,1315,36.2,34.8,37.6,00000
70.0,88.0,89.0,728,01,01,  Chak Shyampur,546,625,261,333,285,292,46.6,43.9,49.4,00000
70.0,88.0,89.0,728,02,01,  Nutangram,447,532,231,281,216,251,45.7,45.1,46.3,00000
70.0,88.0,89.0,728,03,01,  Hazarbhiti,258,656,142,324,116,332,28.2,30.5,25.9,00000
70.0,88.0,89.0,728,04,01,  Atbhiti,42,159,23,82,19,77,20.9,21.9,19.8,00000
70.0,88.0,89.0,728,05,01,  Kalupur,308,535,147,267,161,268,36.5,35.5,37.5,00000
70.0,88.0,89.0,824,01,01,  Nayebtola,664,1026,328,546,336,480,39.3,37.5,41.2,00000
70.0,88.0,89.0,824,02,01,  Tikosh,225,728,124,359,101,369,23.6,25.7,21.5,00000
70.0,88.0,89.0,824,03,01,  Azgobi,668,1428,302,748,366,680,31.9,28.8,35.0,00000
70.0,88.0,89.0,824,04,01,  Edghapara,193,254,111,122,82,132,43.2,47.6,38.3,00000
70.0,88.0,89.0,824,05,01,  Sharatnagar,270,621,150,306,120,315,30.3,32.9,27.6,00000
70.0,88.0,89.0,859,01,01,  Sharatnagar,214,510,108,256,106,254,29.6,29.7,29.4,00000
70.0,88.0,89.0,859,02,01,  Chamabhandar,364,777,166,429,198,348,31.9,27.9,36.3,00000
70.0,88.0,89.0,859,03,01,  Mian Para,404,488,211,247,193,241,45.3,46.1,44.5,00000
70.0,88.0,89.0,859,04,01,  Dhuli Para,84,382,44,181,40,201,18.0,19.6,16.6,00000
70.0,88.0,95.0,994,01,01,  Uttar Uzirpur,1908,2330,887,1131,1021,1199,45.0,44.0,46.0,00000
70.0,88.0,95.0,994,02,01,  Dakshin Uzirpur,1721,1464,779,665,942,799,54.0,53.9,54.1,00000
69.0,9.0,19.0,042,01,01,  Bagatipara,190,248,127,113,63,135,43.4,52.9,31.8,00000
69.0,9.0,19.0,042,02,01,  Kayali Para,518,298,255,124,263,174,63.5,67.3,60.2,00000
69.0,9.0,19.0,524,01,01,  Kakpho,552,731,280,328,272,403,43.0,46.1,40.3,00000
69.0,9.0,19.0,524,02,01,  Dulauri,131,375,65,191,66,184,25.9,25.4,26.4,00000
69.0,9.0,19.0,524,03,01,  Taton Para,473,394,241,171,232,223,54.6,58.5,51.0,00000
69.0,9.0,19.0,524,04,01,  Diar Musuria,218,85,107,49,111,36,71.9,68.6,75.5,00000
69.0,9.0,19.0,791,01,01,  Nurpur Malanchi,550,520,266,220,284,300,51.4,54.7,48.6,00000
69.0,9.0,19.0,791,02,01,  Tamal Tola,759,446,379,203,380,243,63.0,65.1,61.0,00000
69.0,9.0,38.0,299,01,01,  Guchchhagram,182,166,82,83,100,83,52.3,49.7,54.6,00000
69.0,9.0,38.0,299,02,01,  Chandra Khair,1023,666,495,336,528,330,60.6,59.6,61.5,00000
69.0,9.0,38.0,320,01,01,  Dayarampur,183,8,83,3,100,5,95.8,96.5,95.2,00000
69.0,9.0,38.0,320,02,01,  Taltala,854,600,423,308,431,292,58.7,57.9,59.6,00000
69.0,9.0,38.0,320,03,01,  Bilpara,232,113,112,49,120,64,67.2,69.6,65.2,00000
69.0,9.0,38.0,320,04,01,  Kazi Para,189,31,86,16,103,15,85.9,84.3,87.3,00000
69.0,9.0,38.0,320,05,01,  Kadirabad Cantonment+Berak,1634,43,1336,13,298,30,97.4,99.0,90.9,00000
69.0,9.0,38.0,342,01,01,  Dumrai,936,660,480,327,456,333,58.6,59.5,57.8,00000
69.0,9.0,38.0,342,02,01,  Dhaka Para,510,466,259,207,251,259,52.3,55.6,49.2,00000
69.0,9.0,38.0,342,03,01,  Rampara,247,102,132,43,115,59,70.8,75.4,66.1,00000
69.0,9.0,38.0,342,04,01,  Char Para,107,174,66,74,41,100,38.1,47.1,29.1,00000
69.0,9.0,38.0,342,05,01,  Pabna Para,312,129,156,59,156,70,70.7,72.6,69.0,00000
69.0,9.0,38.0,342,06,01,  Sardiar Para,219,153,119,72,100,81,58.9,62.3,55.2,00000
69.0,9.0,38.0,438,01,01,  Hijli,767,568,399,248,368,320,57.5,61.7,53.5,00000
69.0,9.0,38.0,438,02,01,  Dighi Para,745,431,356,199,389,232,63.4,64.1,62.6,00000
69.0,9.0,38.0,438,03,01,  Hijli Sonapur,305,131,162,46,143,85,70.0,77.9,62.7,00000
69.0,9.0,38.0,770,01,01,  Nandakuja,1404,668,696,312,708,356,67.8,69.0,66.5,00000
69.0,9.0,38.0,770,02,01,  Chethuli Para,593,349,301,158,292,191,63.0,65.6,60.5,00000
69.0,9.0,38.0,770,03,01,  Kazir Dear,269,196,137,91,132,105,57.8,60.1,55.7,00000
69.0,9.0,42.0,406,01,01,  Hardoul,546,505,259,236,287,269,52.0,52.3,51.6,00000
69.0,9.0,42.0,406,02,01,  Swaruppur,440,422,232,173,208,249,51.0,57.3,45.5,00000
69.0,9.0,42.0,802,01,01,  Pachuria,628,434,335,203,293,231,59.1,62.3,55.9,00000
69.0,9.0,42.0,802,02,01,  Shanel Para,818,827,423,411,395,416,49.7,50.7,48.7,00000
69.0,9.0,42.0,802,03,01,  Phagura Diar,607,521,306,250,301,271,53.8,55.0,52.6,00000
69.0,9.0,42.0,802,04,01,  Mahajaypur,572,459,321,198,251,261,55.5,61.8,49.0,00000
69.0,9.0,42.0,802,05,01,  Noapara,502,356,252,177,250,179,58.5,58.7,58.3,00000
69.0,9.0,42.0,802,06,01,  Natun Kala Baria,386,357,201,176,185,181,52.0,53.3,50.5,00000
69.0,9.0,42.0,909,01,01,  Bhat Para,162,267,83,125,79,142,37.8,39.9,35.7,00000
69.0,9.0,42.0,909,02,01,  Kumar Para,159,231,81,110,78,121,40.8,42.4,39.2,00000
69.0,9.0,42.0,909,03,01,  Bhuiyan Para,387,319,223,137,164,182,54.8,61.9,47.4,00000
69.0,9.0,42.0,909,04,01,  Salkona,437,508,221,241,216,267,46.2,47.8,44.7,00000
69.0,9.0,76.0,310,01,01,  Dakarmaria,186,318,95,155,91,163,36.9,38.0,35.8,00000
69.0,9.0,76.0,310,02,01,  Debnagar,281,345,137,137,144,208,44.9,50.0,40.9,00000
69.0,9.0,76.0,460,01,01,  Dubela,189,262,90,121,99,141,41.9,42.7,41.3,00000
69.0,9.0,76.0,460,02,01,  Omargari,147,150,71,69,76,81,49.5,50.7,48.4,00000
69.0,9.0,76.0,460,03,01,  Paschimpara,652,317,327,146,325,171,67.3,69.1,65.5,00000
69.0,9.0,76.0,460,04,01,  Malla Para,305,217,159,94,146,123,58.4,62.8,54.3,00000
69.0,9.0,76.0,460,05,01,  Chowdhury Para,100,59,55,24,45,35,62.9,69.6,56.3,00000
69.0,9.0,76.0,460,06,01,  Narasundarpur,51,38,27,12,24,26,57.3,69.2,48.0,00000
69.0,9.0,76.0,460,07,01,  Kutipara,286,367,154,171,132,196,43.8,47.4,40.2,00000
69.0,9.0,76.0,460,08,01,  Raushan Gire Para,348,254,194,109,154,145,57.8,64.0,51.5,00000
69.0,9.0,76.0,460,09,01,  Palpara,47,121,23,59,24,62,28.0,28.0,27.9,00000
69.0,9.0,76.0,460,10,01,  Shakhari Para,239,155,125,75,114,80,60.7,62.5,58.8,00000
69.0,9.0,76.0,460,11,01,  Kayesta Para,57,61,29,32,28,29,48.3,47.5,49.1,00000
69.0,9.0,76.0,460,12,01,  Tele Para,153,89,84,40,69,49,63.2,67.7,58.5,00000
69.0,9.0,76.0,460,13,01,  Ghosh Para,212,280,107,139,105,141,43.1,43.5,42.7,00000
69.0,9.0,76.0,460,14,01,  Gaulargup,409,567,204,273,205,294,41.9,42.8,41.1,00000
69.0,9.0,76.0,460,15,01,  Mandal Para,159,183,90,96,69,87,46.5,48.4,44.2,00000
69.0,9.0,76.0,460,16,01,  Purbapara,85,83,48,41,37,42,50.6,53.9,46.8,00000
69.0,9.0,76.0,460,17,01,  Kahar Para,43,70,25,31,18,39,38.1,44.6,31.6,00000
69.0,9.0,76.0,460,18,01,  Kaipukharia,404,459,211,210,193,249,46.8,50.1,43.7,00000
69.0,9.0,76.0,460,19,01,  Majpara,125,154,66,71,59,83,44.8,48.2,41.5,00000
69.0,9.0,76.0,460,20,01,  Pukur Para,82,67,37,34,45,33,55.0,52.1,57.7,00000
69.0,9.0,76.0,460,21,01,  Kaichar Para,282,191,159,69,123,122,59.6,69.7,50.2,00000
69.0,9.0,76.0,460,22,01,  Munshi Para,370,386,189,168,181,218,48.9,52.9,45.4,00000
69.0,9.0,76.0,460,23,01,  Saha Para,250,127,132,55,118,72,66.3,70.6,62.1,00000
69.0,15.0,21.0,058,01,01,  Bagdob,743,1278,359,614,384,664,36.8,36.9,36.6,00000
69.0,15.0,21.0,058,02,01,  Par Bagdob,329,478,169,236,160,242,40.8,41.7,39.8,00000
69.0,15.0,21.0,130,01,01,  Bharatpur (Part),826,753,400,386,426,367,52.3,50.9,53.7,00000
69.0,15.0,21.0,130,02,01,  Guchchhagram,62,104,32,50,30,54,37.3,39.0,35.7,00000
69.0,15.0,21.0,906,01,01,  Fulbati,220,244,127,117,93,127,47.4,52.0,42.3,00000
69.0,15.0,21.0,906,02,01,  Bajidpur,456,353,249,166,207,187,56.4,60.0,52.5,00000
69.0,15.0,21.0,906,03,01,  Bharat,673,776,341,382,332,394,46.4,47.2,45.7,00000
69.0,15.0,21.0,906,04,01,  Manikpur,319,315,179,147,140,168,50.3,54.9,45.5,00000
69.0,15.0,21.0,906,05,01,  Chakpara,305,446,166,219,139,227,40.6,43.1,38.0,00000
69.0,15.0,21.0,906,06,01,  Dair Para,149,230,70,120,79,110,39.3,36.8,41.8,00000
69.0,15.0,21.0,906,07,01,  Charoikol,85,254,55,120,30,134,25.1,31.4,18.3,00000
69.0,15.0,23.0,268,01,01,  Dasgram,1190,1525,626,768,564,757,43.8,44.9,42.7,00000
69.0,15.0,23.0,268,02,01,  Ragendapur,728,977,386,465,342,512,42.7,45.4,40.0,00000
69.0,15.0,23.0,353,01,01,  Garfa,1247,1694,640,829,607,865,42.4,43.6,41.2,00000
69.0,15.0,23.0,353,02,01,  Diar Garfa,294,419,143,223,151,196,41.2,39.1,43.5,00000
69.0,15.0,35.0,386,01,01,  Gosainpur,320,141,164,67,156,74,69.4,71.0,67.8,00000
69.0,15.0,35.0,386,02,01,  Arzunpur,432,337,221,147,211,190,56.2,60.1,52.6,00000
69.0,15.0,35.0,458,01,01,  Kachua,311,238,160,104,151,134,56.6,60.6,53.0,00000
69.0,15.0,35.0,458,02,01,  Mreda Para,195,256,97,123,98,133,43.2,44.1,42.4,00000
69.0,15.0,35.0,458,03,01,  Daulatpur,382,419,199,184,183,235,47.7,52.0,43.8,00000
69.0,15.0,35.0,857,01,01,  Purnakalas,2001,1288,998,604,1003,684,60.8,62.3,59.5,00000
69.0,15.0,35.0,857,02,01,  Rajapur,407,111,208,75,199,36,78.6,73.5,84.7,00000
69.0,15.0,35.0,857,03,01,  Arzunpur,249,130,125,60,124,70,65.7,67.6,63.9,00000
69.0,15.0,47.0,117,01,01,  Bhabanipur,2623,1825,1277,885,1346,940,59.0,59.1,58.9,00000
69.0,15.0,47.0,117,02,01,  Chandipur,505,306,239,138,266,168,62.3,63.4,61.3,00000
69.0,15.0,47.0,445,01,01,  Nouda Joar,373,501,189,231,184,270,42.7,45.0,40.5,00000
69.0,15.0,47.0,445,02,01,  Joari,1172,1229,597,583,575,646,48.8,50.6,47.1,00000
69.0,15.0,59.0,163,01,01,  Borni,814,578,393,260,421,318,58.5,60.2,57.0,00000
69.0,15.0,59.0,163,02,01,  Par Borni,611,340,287,162,324,178,64.2,63.9,64.5,00000
69.0,15.0,59.0,336,01,01,  Kachughari,1081,962,556,469,525,493,52.9,54.2,51.6,00000
69.0,15.0,59.0,336,02,01,  Bhita Kazipur,872,1762,438,848,434,914,33.1,34.1,32.2,00000
69.0,15.0,59.0,336,03,01,  Dwarikusi,1258,1769,657,857,601,912,41.6,43.4,39.7,00000
69.0,15.0,59.0,916,01,01,  Sangrampur,486,362,234,159,252,203,57.3,59.5,55.4,00000
69.0,15.0,59.0,916,02,01,  Nagerpur,697,799,355,386,342,413,46.6,47.9,45.3,00000
69.0,15.0,71.0,072,01,01,  Bahimali,1093,1297,528,637,565,660,45.7,45.3,46.1,00000
69.0,15.0,71.0,072,02,01,  Bolidaghati,229,160,127,64,102,96,58.9,66.5,51.5,00000
69.0,15.0,71.0,288,01,01,  Dhulia,368,538,183,269,185,269,40.6,40.5,40.7,00000
69.0,15.0,71.0,288,02,01,  Chulkati,235,212,110,105,125,107,52.6,51.2,53.9,00000
69.0,15.0,71.0,674,01,01,  Manikpur,626,791,310,403,316,388,44.2,43.5,44.9,00000
69.0,15.0,71.0,674,02,01,  Tongi Para,157,240,69,131,88,109,39.5,34.5,44.7,00000
69.0,15.0,83.0,432,01,01,  Malikpur,303,374,161,180,142,194,44.8,47.2,42.3,00000
69.0,15.0,83.0,432,02,01,  Jalla,649,461,345,225,304,236,58.5,60.5,56.3,00000
69.0,15.0,83.0,700,01,01,  Masinda,625,700,327,339,298,361,47.2,49.1,45.2,00000
69.0,15.0,83.0,700,02,01,  Dighalkandi,116,186,60,95,56,91,38.4,38.7,38.1,00000
69.0,15.0,83.0,752,01,01,  Nagar,1262,1695,675,868,587,827,42.7,43.7,41.5,00000
69.0,15.0,83.0,752,02,01,  Neati Nagar,348,535,193,257,155,278,39.4,42.9,35.8,00000
69.0,15.0,83.0,837,01,01,  Bara Pingan,259,408,138,209,121,199,38.8,39.8,37.8,00000
69.0,15.0,83.0,837,02,01,  Chhota Pingan,112,219,57,105,55,114,33.8,35.2,32.5,00000
69.0,15.0,83.0,968,01,01,  Talso,904,1531,487,745,417,786,37.1,39.5,34.7,00000
69.0,15.0,83.0,968,02,01,  Kunda Para,340,408,176,202,164,206,45.5,46.6,44.3,00000
69.0,41.0,13.0,095,01,01,  Biaghat,1067,1808,554,879,513,929,37.1,38.7,35.6,00000
69.0,41.0,13.0,095,02,01,  Bablatola,257,423,131,212,126,211,37.8,38.2,37.4,00000
69.0,41.0,27.0,220,01,01,  Chak Dighali,40,185,22,95,18,90,17.8,18.8,16.7,00000
69.0,41.0,27.0,220,02,01,  Abason,115,217,61,103,54,114,34.6,37.2,32.1,00000
69.0,41.0,27.0,621,01,01,  Khamar Pathuria,919,1556,463,702,456,854,37.1,39.7,34.8,00000
69.0,41.0,27.0,621,02,01,  Roypur,263,313,144,144,119,169,45.7,50.0,41.3,00000
69.0,41.0,27.0,880,01,01,  Rashidpur,849,675,468,306,381,369,55.7,60.5,50.8,00000
69.0,41.0,27.0,880,02,01,  Mokimpur,536,1264,269,581,267,683,29.8,31.6,28.1,00000
69.0,41.0,40.0,353,01,01,  Daudia Talbari,345,619,165,312,180,307,35.8,34.6,37.0,00000
69.0,41.0,40.0,353,02,01,  Talbari,337,500,180,237,157,263,40.3,43.2,37.4,00000
69.0,41.0,40.0,774,01,01,  Patpara,569,823,287,381,282,442,40.9,43.0,39.0,00000
69.0,41.0,40.0,774,02,01,  Dari Para,916,1091,518,493,398,598,45.6,51.2,40.0,00000
69.0,41.0,40.0,774,03,01,  Zahu Para,863,1305,453,634,410,671,39.8,41.7,37.9,00000
69.0,41.0,60.0,832,01,01,  Pipla,1143,1144,630,568,513,576,50.0,52.6,47.1,00000
69.0,41.0,60.0,832,02,01,  Char Pipla,248,697,129,327,119,370,26.2,28.3,24.3,00000
69.0,41.0,67.0,698,01,01,  Majh Para,872,1760,452,848,420,912,33.1,34.8,31.5,00000
69.0,41.0,67.0,698,02,01,  Kandi Para,488,794,258,362,230,432,38.1,41.6,34.7,00000
69.0,41.0,67.0,698,03,01,  Char Para,604,1279,319,591,285,688,32.1,35.1,29.3,00000
69.0,41.0,67.0,698,04,01,  Shikarpur,877,1345,445,626,432,719,39.5,41.5,37.5,00000
69.0,41.0,67.0,698,05,01,  Shikar Para,565,768,288,378,277,390,42.4,43.2,41.5,00000
69.0,41.0,67.0,698,06,01,  Bahadur Para,623,1482,324,751,299,731,29.6,30.1,29.0,00000
69.0,41.0,67.0,908,01,01,  Sahapur Uttar,724,1232,386,583,338,649,37.0,39.8,34.2,00000
69.0,41.0,67.0,908,02,01,  Sahapur Dakhin,596,832,329,388,267,444,41.7,45.9,37.6,00000
69.0,41.0,81.0,764,01,01,  Nazirpur,668,928,340,448,328,480,41.9,43.1,40.6,00000
69.0,41.0,81.0,764,02,01,  Natun Para,540,321,279,150,261,171,62.7,65.0,60.4,00000
69.0,44.0,17.0,064,01,01,  Bara Bilsalia,255,233,109,136,146,97,52.3,44.5,60.1,00000
69.0,44.0,17.0,064,02,01,  Chhota Bilsalia,337,216,162,111,175,105,60.9,59.3,62.5,00000
69.0,44.0,17.0,064,03,01,  Arjun Para,164,226,77,124,87,102,42.1,38.3,46.0,00000
69.0,44.0,17.0,064,04,01,  Garabhita,126,180,63,86,63,94,41.2,42.3,40.1,00000
69.0,44.0,28.0,103,01,01,  Baora,384,415,187,202,197,213,48.1,48.1,48.0,00000
69.0,44.0,28.0,103,02,01,  Islampur,536,645,284,317,252,328,45.4,47.3,43.4,00000
69.0,44.0,28.0,940,01,01,  Sirazipur,299,469,154,230,145,239,38.9,40.1,37.8,00000
69.0,44.0,28.0,940,02,01,  Diar Para,279,336,138,166,141,170,45.4,45.4,45.3,00000
69.0,44.0,28.0,940,03,01,  Chandigachha,311,330,164,160,147,170,48.5,50.6,46.4,00000
69.0,44.0,28.0,940,04,01,  Dair Para,383,215,195,106,188,109,64.0,64.8,63.3,00000
69.0,44.0,28.0,945,01,01,  Sobh (Nagdaha),435,426,213,209,222,217,50.5,50.5,50.6,00000
69.0,44.0,28.0,945,02,01,  Magdaja Sobh,618,1219,293,600,325,619,33.6,32.8,34.4,00000
69.0,44.0,28.0,990,01,01,  Uttar Banshbaria,321,232,177,107,144,125,58.0,62.3,53.5,00000
69.0,44.0,28.0,990,02,01,  Banshbaria,410,443,214,217,196,226,48.1,49.7,46.4,00000
69.0,44.0,28.0,990,03,01,  Goal Para,319,277,176,130,143,147,53.5,57.5,49.3,00000
69.0,44.0,28.0,990,04,01,  Laskarpur,65,127,35,62,30,65,33.9,36.1,31.6,00000
69.0,44.0,38.0,398,01,01,  Duaria,394,549,226,274,168,275,41.8,45.2,37.9,00000
69.0,44.0,38.0,398,02,01,  Hapania,250,162,128,75,122,87,60.7,63.1,58.4,00000
69.0,44.0,38.0,398,03,01,  Nawda Para,271,219,139,113,132,106,55.3,55.2,55.5,00000
69.0,44.0,38.0,398,04,01,  Danga Para,463,688,234,336,229,352,40.2,41.1,39.4,00000
69.0,44.0,38.0,655,01,01,  Maheshwar,554,590,270,296,284,294,48.4,47.7,49.1,00000
69.0,44.0,38.0,655,02,01,  Ramnarayanpur (Part),197,112,92,59,105,53,63.8,60.9,66.5,00000
69.0,44.0,38.0,655,03,01,  Kashimpur (Part),342,347,172,170,170,177,49.6,50.3,49.0,00000
69.0,44.0,38.0,980,01,01,  Titla,771,689,378,338,393,351,52.8,52.8,52.8,00000
69.0,44.0,38.0,980,02,01,  Ramnarayanpur (Part),249,279,123,138,126,141,47.2,47.1,47.2,00000
69.0,44.0,47.0,403,01,01,  Durduria,1961,1612,1033,763,928,849,54.9,57.5,52.2,00000
69.0,44.0,47.0,403,02,01,  Maniharpur,936,437,498,213,438,224,68.2,70.0,66.2,00000
69.0,44.0,57.0,142,01,01,  Baramhati,638,363,318,183,320,180,63.7,63.5,64.0,00000
69.0,44.0,57.0,142,02,01,  Faridpur,134,175,68,79,66,96,43.4,46.3,40.7,00000
69.0,44.0,57.0,332,01,01,  Dahar Shaila,720,835,366,415,354,420,46.3,46.9,45.7,00000
69.0,44.0,57.0,332,02,01,  Seer Ramgari,652,548,350,259,302,289,54.3,57.5,51.1,00000
69.0,44.0,76.0,344,01,01,  Danga Para,369,285,185,137,184,148,56.4,57.5,55.4,00000
69.0,44.0,76.0,344,02,01,  Pukur Para,320,182,161,83,159,99,63.7,66.0,61.6,00000
69.0,44.0,76.0,364,01,01,  Dhala,781,670,400,345,381,325,53.8,53.7,54.0,00000
69.0,44.0,76.0,364,02,01,  Dear Para,276,327,142,158,134,169,45.8,47.3,44.2,00000
69.0,44.0,85.0,088,01,01,  Balitita Islampur,2045,2054,1010,1063,1035,991,49.9,48.7,51.1,00000
69.0,44.0,85.0,088,02,01,  Balitita Ramkrishnap,1936,1837,1025,907,911,930,51.3,53.1,49.5,00000
69.0,44.0,85.0,630,01,01,  Uttar Lalpur,1916,1668,960,814,956,854,53.5,54.1,52.8,00000
69.0,44.0,85.0,630,02,01,  Dakshin Lalpur,1159,717,620,354,539,363,61.8,63.7,59.8,00000
69.0,44.0,85.0,630,03,01,  Lalpur Colony,443,606,237,310,206,296,42.2,43.3,41.0,00000
69.0,44.0,95.0,359,01,01,  Dhupail,4042,1646,2102,755,1940,891,71.1,73.6,68.5,00000
69.0,44.0,95.0,359,02,01,  Hazaragari,611,336,301,156,310,180,64.5,65.9,63.3,00000
69.0,44.0,95.0,394,01,01,  Dilalpur,1893,1373,951,687,942,686,58.0,58.1,57.9,00000
69.0,44.0,95.0,394,02,01,  Chak Nazirpur,101,82,47,41,54,41,55.2,53.4,56.8,00000
69.0,44.0,95.0,891,01,01,  Ruhigari,224,267,107,140,117,127,45.6,43.3,48.0,00000
69.0,44.0,95.0,891,02,01,  Kandi Para,65,30,37,18,28,12,68.4,67.3,70.0,00000
69.0,44.0,95.0,994,01,01,  Walia,4493,3539,2175,1765,2318,1774,55.9,55.2,56.6,00000
69.0,44.0,95.0,994,02,01,  Diar Para,353,430,178,215,175,215,45.1,45.3,44.9,00000
69.0,63.0,20.0,105,01,01,  Goaldanga,832,560,411,269,421,291,59.8,60.4,59.1,00000
69.0,63.0,20.0,105,02,01,  Bara Harishpur,1116,572,639,299,477,273,66.1,68.1,63.6,00000
69.0,63.0,20.0,166,01,01,  Diar Bhita,864,599,457,304,407,295,59.1,60.1,58.0,00000
69.0,63.0,20.0,166,02,01,  Bara Bhita,430,333,208,158,222,175,56.4,56.8,55.9,00000
69.0,63.0,20.0,177,01,01,  Joythiyan,304,333,162,163,142,170,47.7,49.8,45.5,00000
69.0,63.0,20.0,177,02,01,  Jolarkandi,66,94,36,45,30,49,41.3,44.4,38.0,00000
69.0,63.0,20.0,393,01,01,  Noda Para,219,115,121,56,98,59,65.6,68.4,62.4,00000
69.0,63.0,20.0,393,02,01,  Fatenga Para,492,629,255,297,237,332,43.9,46.2,41.7,00000
69.0,63.0,20.0,431,01,01,  Gunarigram,260,279,143,131,117,148,48.2,52.2,44.2,00000
69.0,63.0,20.0,431,02,01,  Guchchhagram,184,336,95,162,89,174,35.4,37.0,33.8,00000
69.0,63.0,20.0,631,01,01,  Shibpur,89,279,42,139,47,140,24.2,23.2,25.1,00000
69.0,63.0,20.0,631,02,01,  Datta Para,1321,963,708,444,613,519,57.8,61.5,54.2,00000
69.0,63.0,20.0,631,03,01,  Lalmanipur,504,590,255,280,249,310,46.1,47.7,44.5,00000
69.0,63.0,20.0,809,01,01,  Jujurhat,168,288,83,138,85,150,36.8,37.6,36.2,00000
69.0,63.0,20.0,809,02,01,  Sankarbhag,467,513,250,246,217,267,47.7,50.4,44.8,00000
69.0,63.0,20.0,809,03,01,  Pirji Para,779,930,396,448,383,482,45.6,46.9,44.3,00000
69.0,63.0,20.0,828,01,01,  Joynagar,225,173,119,86,106,87,56.5,58.0,54.9,00000
69.0,63.0,20.0,828,02,01,  Rabirhat,190,248,93,126,97,122,43.4,42.5,44.3,00000
69.0,63.0,23.0,200,01,01,  Chairman Para,322,312,177,147,145,165,50.8,54.6,46.8,00000
69.0,63.0,23.0,200,02,01,  Kamar Para,434,510,227,251,207,259,46.0,47.5,44.4,00000
69.0,63.0,23.0,200,03,01,  Shah Para,685,691,351,327,334,364,49.8,51.8,47.9,00000
69.0,63.0,23.0,200,04,01,  Hadayeti Para,467,467,231,245,236,222,50.0,48.5,51.5,00000
69.0,63.0,23.0,208,01,01,  Bipra Belgharia,1148,907,608,432,540,475,55.9,58.5,53.2,00000
69.0,63.0,23.0,208,02,01,  Diar Kazipur,521,661,281,322,240,339,44.1,46.6,41.5,00000
69.0,63.0,23.0,208,03,01,  Chak Para,580,396,303,168,277,228,59.4,64.3,54.9,00000
69.0,63.0,23.0,208,04,01,  Bamangram,263,189,147,81,116,108,58.2,64.5,51.8,00000
69.0,63.0,23.0,692,01,01,  Mirzapur Digha,638,517,340,242,298,275,55.2,58.4,52.0,00000
69.0,63.0,23.0,692,02,01,  Mirzapur Diar Para,354,512,194,234,160,278,40.9,45.3,36.5,00000
69.0,63.0,23.0,692,03,01,  Taghor Para,205,469,104,224,101,245,30.4,31.7,29.2,00000
69.0,63.0,23.0,692,04,01,  Dhaman Para,200,174,111,80,89,94,53.5,58.1,48.6,00000
69.0,63.0,23.0,692,05,01,  Kathuagari,221,304,116,141,105,163,42.1,45.1,39.2,00000
69.0,63.0,29.0,015,01,01,  Agdigha,1603,1796,846,841,757,955,47.2,50.1,44.2,00000
69.0,63.0,29.0,015,02,01,  Agdigha Basila Para,434,435,223,191,211,244,49.9,53.9,46.4,00000
69.0,63.0,29.0,022,01,01,  Chak Amhati (Part),482,617,236,301,246,316,43.9,43.9,43.8,00000
69.0,63.0,29.0,022,02,01,  Ghoragachha Amhati (Part),427,417,209,198,218,219,50.6,51.4,49.9,00000
69.0,63.0,29.0,022,03,01,  Ulipur Amhati (Part),96,164,45,78,51,86,36.9,36.6,37.2,00000
69.0,63.0,29.0,022,04,01,  Bejpara Amhati,535,248,276,105,259,143,68.3,72.4,64.4,00000
69.0,63.0,29.0,022,05,01,  Bhatdara (Part),197,309,101,159,96,150,38.9,38.8,39.0,00000
69.0,63.0,29.0,022,06,01,  Madanhat,410,338,220,163,190,175,54.8,57.4,52.1,00000
69.0,63.0,29.0,242,01,01,  Chhatni,964,794,507,372,457,422,54.8,57.7,52.0,00000
69.0,63.0,29.0,242,02,01,  Bhabni,408,400,207,188,201,212,50.5,52.4,48.7,00000
69.0,63.0,29.0,242,03,01,  Chhatni Dakshinpara,368,247,194,114,174,133,59.8,63.0,56.7,00000
69.0,63.0,29.0,242,04,01,  Chhatni Diar,474,635,257,289,217,346,42.7,47.1,38.5,00000
69.0,63.0,29.0,242,05,01,  Chhatni Purba Para,111,70,53,35,58,35,61.3,60.2,62.4,00000
69.0,63.0,29.0,249,01,01,  Chhatni Shibpur,86,66,50,25,36,41,56.6,66.7,46.8,00000
69.0,63.0,29.0,249,02,01,  Baroghoria Guchchhagram,220,282,113,138,107,144,43.8,45.0,42.6,00000
69.0,63.0,29.0,389,01,01,  Faridpur Amhati,247,162,132,76,115,86,60.4,63.5,57.2,00000
69.0,63.0,29.0,389,02,01,  Roy Amhati,396,301,207,145,189,156,56.8,58.8,54.8,00000
69.0,63.0,29.0,662,01,01,  Majhdigha,1171,1307,600,630,571,677,47.3,48.8,45.8,00000
69.0,63.0,29.0,662,02,01,  Majhdigha Shibpur,500,508,256,221,244,287,49.6,53.7,46.0,00000
69.0,63.0,29.0,767,01,01,  Panditgram,622,625,353,339,269,286,49.9,51.0,48.5,00000
69.0,63.0,29.0,767,02,01,  Barogharia,823,743,448,343,375,400,52.6,56.6,48.4,00000
69.0,63.0,29.0,870,01,01,  Roypur,210,181,115,79,95,102,53.7,59.3,48.2,00000
69.0,63.0,29.0,870,02,01,  Roypur Guchchhagram,166,216,83,113,83,103,43.5,42.3,44.6,00000
69.0,63.0,29.0,960,01,01,  Telkupi Shyampur,1566,1167,841,541,725,626,57.3,60.9,53.7,00000
69.0,63.0,29.0,960,02,01,  Guchchhagram,33,69,19,27,14,42,32.4,41.3,25.0,00000
69.0,63.0,36.0,064,01,01,  Bhabanipur,276,182,139,90,137,92,60.3,60.7,59.8,00000
69.0,63.0,36.0,064,02,01,  Baladkhal,278,350,154,174,124,176,44.3,47.0,41.3,00000
69.0,63.0,36.0,064,03,01,  Danga Para,1456,1254,819,586,637,668,53.7,58.3,48.8,00000
69.0,63.0,36.0,351,01,01,  Dharial,836,1060,450,488,386,572,44.1,48.0,40.3,00000
69.0,63.0,36.0,351,02,01,  Gobindanagar,237,170,124,84,113,86,58.2,59.6,56.8,00000
69.0,63.0,36.0,397,01,01,  Gangail,380,470,201,212,179,258,44.7,48.7,41.0,00000
69.0,63.0,36.0,397,02,01,  Aladi,87,178,51,87,36,91,32.8,37.0,28.3,00000
69.0,63.0,43.0,034,01,01,  Aorail,732,1349,379,647,353,702,35.2,36.9,33.5,00000
69.0,63.0,43.0,034,02,01,  Sultanpur,781,948,386,454,395,494,45.2,46.0,44.4,00000
69.0,63.0,43.0,034,03,01,  Gouripur,522,611,255,300,267,311,46.1,45.9,46.2,00000
69.0,63.0,51.0,230,01,01,  Chaugachhi,627,786,332,366,295,420,44.4,47.6,41.3,00000
69.0,63.0,51.0,230,02,01,  Biltongi,266,212,130,101,136,111,55.6,56.3,55.1,00000
69.0,63.0,51.0,506,01,01,  Jalalabad,997,898,490,433,507,465,52.6,53.1,52.2,00000
69.0,63.0,51.0,506,02,01,  Kamarpur,218,201,105,87,113,114,52.0,54.7,49.8,00000
69.0,63.0,58.0,590,01,01,  Khajura,1557,2041,833,908,724,1133,43.3,47.8,39.0,00000
69.0,63.0,58.0,590,02,01,  Khajur Bhato Para,101,140,48,66,53,74,41.9,42.1,41.7,00000
69.0,63.0,58.0,658,01,01,  Mahishdanga,698,566,377,255,321,311,55.2,59.7,50.8,00000
69.0,63.0,58.0,658,02,01,  Guchhgram,31,59,19,27,12,32,34.4,41.3,27.3,00000
69.0,63.0,58.0,885,01,01,  Sadhnagar,535,309,294,111,241,198,63.4,72.6,54.9,00000
69.0,63.0,58.0,885,02,01,  Dulaure,55,112,36,41,19,71,32.9,46.8,21.1,00000
69.0,63.0,58.0,885,03,01,  Gouripur,197,253,108,103,89,150,43.8,51.2,37.2,00000
69.0,63.0,58.0,885,04,01,  Mirpur,36,126,19,57,17,69,22.2,25.0,19.8,00000
69.0,63.0,65.0,628,01,01,  Lakshmipur,1355,1434,685,682,670,752,48.6,50.1,47.1,00000
69.0,63.0,65.0,628,02,01,  Kholabaria,1750,1612,928,754,822,858,52.1,55.2,48.9,00000
69.0,63.0,73.0,817,01,01,  Purba Madhnagar,1129,762,592,329,537,433,59.7,64.3,55.4,00000
69.0,63.0,73.0,817,02,01,  Noapara,378,444,204,215,174,229,46.0,48.7,43.2,00000
69.0,63.0,87.0,953,01,01,  Surjyabari,185,255,104,113,81,142,42.0,47.9,36.3,00000
69.0,63.0,87.0,953,02,01,  Bangram,232,142,124,68,108,74,62.0,64.6,59.3,00000
69.0,63.0,87.0,991,01,01,  Thakur Lakshmikul,1520,1650,763,796,757,854,47.9,48.9,47.0,00000
69.0,63.0,87.0,991,02,01,  Senbhaga Lakshmikul,1056,918,569,451,487,467,53.5,55.8,51.0,00000
69.0,63.0,87.0,991,03,01,  Madanhat,304,573,164,266,140,307,34.7,38.1,31.3,00000
69.0,63.0,87.0,991,04,01,  Bhaturia Lakshmikul,159,107,89,50,70,57,59.8,64.0,55.1,00000
69.0,63.0,94.0,083,01,01,  Ban Belgharia (Part),1924,1600,962,801,962,799,54.6,54.6,54.6,00000
69.0,63.0,94.0,083,02,01,  Chak Sremantapur,116,42,57,18,59,24,73.4,76.0,71.1,00000
69.0,63.0,94.0,302,01,01,  Baliadanga,351,546,177,246,174,300,39.1,41.8,36.7,00000
69.0,63.0,94.0,302,02,01,  Royerbhag,347,359,176,175,171,184,49.2,50.1,48.2,00000
69.0,63.0,94.0,302,03,01,  Kacharigachha,340,349,175,173,165,176,49.3,50.3,48.4,00000
69.0,63.0,94.0,302,04,01,  Bangabaria,356,463,177,223,179,240,43.5,44.3,42.7,00000
69.0,63.0,94.0,302,05,01,  Chandrakala,590,638,301,317,289,321,48.0,48.7,47.4,00000
69.0,63.0,94.0,302,06,01,  Dolerbhag,199,208,113,91,86,117,48.9,55.4,42.4,00000
69.0,91.0,12.0,037,01,01,  Puran Para,263,187,138,96,125,91,58.4,59.0,57.9,00000
69.0,91.0,12.0,037,02,01,  Kandi Para,459,538,232,297,227,241,46.0,43.9,48.5,00000
69.0,91.0,12.0,037,03,01,  Fatha Para,522,353,274,160,248,193,59.7,63.1,56.2,00000
69.0,91.0,12.0,173,01,01,  Bildaha,1246,1549,691,694,555,855,44.6,49.9,39.4,00000
69.0,91.0,12.0,173,02,01,  Krishannagar,955,1097,572,470,383,627,46.5,54.9,37.9,00000
69.0,91.0,12.0,173,03,01,  Anandanagar,460,901,246,449,214,452,33.8,35.4,32.1,00000
69.0,91.0,12.0,298,01,01,  Chamari,191,174,100,83,91,91,52.3,54.6,50.0,00000
69.0,91.0,12.0,298,02,01,  Sonaghati,443,487,224,233,219,254,47.6,49.0,46.3,00000
69.0,91.0,12.0,298,03,01,  Kalinagar,169,426,88,202,81,224,28.4,30.3,26.6,00000
69.0,91.0,12.0,298,04,01,  Holaigari,265,271,136,126,129,145,49.4,51.9,47.1,00000
69.0,91.0,12.0,298,05,01,  Chamari Bagchi Para,210,539,112,263,98,276,28.0,29.9,26.2,00000
69.0,91.0,12.0,616,01,01,  Gutia Mahishmari,408,1125,217,550,191,575,26.6,28.3,24.9,00000
69.0,91.0,12.0,616,02,01,  Mahishmari,1318,2027,672,976,646,1051,39.4,40.8,38.1,00000
69.0,91.0,12.0,616,03,01,  Dari Mahismari,203,493,115,222,88,271,29.2,34.1,24.5,00000
69.0,91.0,12.0,616,04,01,  Gutia,583,1133,298,531,285,602,34.0,35.9,32.1,00000
69.0,91.0,12.0,912,01,01,  Gayan Para,94,248,52,112,42,136,27.5,31.7,23.6,00000
69.0,91.0,12.0,912,02,01,  Kandi Para,233,601,120,291,113,310,27.9,29.2,26.7,00000
69.0,91.0,12.0,912,03,01,  Madhyapara,171,324,87,155,84,169,34.5,36.0,33.2,00000
69.0,91.0,12.0,912,04,01,  Natun Para,33,116,20,51,13,65,22.1,28.2,16.7,00000
69.0,91.0,12.0,912,05,01,  Uttarpara,357,425,175,213,182,212,45.7,45.1,46.2,00000
69.0,91.0,15.0,113,01,01,  Barabaria,659,670,348,301,311,369,49.6,53.6,45.7,00000
69.0,91.0,15.0,113,02,01,  Ramnagar,380,592,202,276,178,316,39.1,42.3,36.0,00000
69.0,91.0,15.0,113,03,01,  Dhanuria,85,159,51,75,34,84,34.8,40.5,28.8,00000
69.0,91.0,15.0,155,01,01,  Bhulbaria,723,691,390,320,333,371,51.1,54.9,47.3,00000
69.0,91.0,15.0,155,02,01,  Matikata,58,762,29,385,29,377,7.1,7.0,7.1,00000
69.0,91.0,15.0,209,01,01,  Chhatar Dighi,589,603,302,294,287,309,49.4,50.7,48.2,00000
69.0,91.0,15.0,209,02,01,  Radhanagar,53,359,26,171,27,188,12.9,13.2,12.6,00000
69.0,91.0,15.0,209,03,01,  Anandanagar,123,189,58,88,65,101,39.4,39.7,39.2,00000
69.0,91.0,15.0,209,04,01,  Kaliganj,605,286,338,132,267,154,67.9,71.9,63.4,00000
69.0,91.0,15.0,209,05,01,  Purba Bahadurpur,115,304,61,150,54,154,27.4,28.9,26.0,00000
69.0,91.0,15.0,494,01,01,  Karachmaria,363,803,204,393,159,410,31.1,34.2,27.9,00000
69.0,91.0,15.0,494,02,01,  Paschim Bahadurpur,182,132,93,60,89,72,58.0,60.8,55.3,00000
69.0,91.0,15.0,494,03,01,  Sreerampur,170,71,94,30,76,41,70.5,75.8,65.0,00000
69.0,91.0,15.0,775,01,01,  Mirzapur,109,495,58,245,51,250,18.0,19.1,16.9,00000
69.0,91.0,15.0,775,02,01,  Aktabnagar,81,174,43,79,38,95,31.8,35.2,28.6,00000
69.0,91.0,23.0,431,01,01,  Sardanagar,173,517,103,240,70,277,25.1,30.0,20.2,00000
69.0,91.0,23.0,431,02,01,  Hulhulia,691,270,348,126,343,144,71.9,73.4,70.4,00000
69.0,91.0,31.0,447,01,01,  Jatbyas,715,1566,419,747,296,819,31.3,35.9,26.5,00000
69.0,91.0,39.0,002,01,01,  Achalkot,577,637,298,294,279,343,47.5,50.3,44.9,00000
69.0,91.0,39.0,002,02,01,  Tarapur,169,118,98,51,71,67,58.9,65.8,51.4,00000
69.0,91.0,39.0,002,03,01,  Aladi,218,193,115,88,103,105,53.0,56.7,49.5,00000
69.0,91.0,39.0,111,01,01,  Bara Sawail,1367,1397,713,648,654,749,49.5,52.4,46.6,00000
69.0,91.0,39.0,111,02,01,  Hazipur,337,295,174,143,163,152,53.3,54.9,51.7,00000
69.0,91.0,39.0,345,01,01,  Dhuliadanga,469,672,242,318,227,354,41.1,43.2,39.1,00000
69.0,91.0,39.0,345,02,01,  Hasighati,139,366,71,176,68,190,27.5,28.7,26.4,00000
69.0,91.0,39.0,345,03,01,  Ulupur,52,155,27,73,25,82,25.1,27.0,23.4,00000
69.0,91.0,39.0,353,01,01,  Dighalgaon,476,418,245,178,231,240,53.2,57.9,49.0,00000
69.0,91.0,39.0,353,02,01,  Malochbaria,97,88,62,37,35,51,52.4,62.6,40.7,00000
69.0,91.0,39.0,353,03,01,  Nalbata Gupti Para,203,144,108,64,95,80,58.5,62.8,54.3,00000
69.0,91.0,39.0,353,04,01,  Nalbata Mirda Para,149,105,80,50,69,55,58.7,61.5,55.6,00000
69.0,91.0,39.0,393,01,01,  Gunaikhara,568,689,298,319,270,370,45.2,48.3,42.2,00000
69.0,91.0,39.0,393,02,01,  Batu Para,508,764,242,343,266,421,39.9,41.4,38.7,00000
69.0,91.0,39.0,596,01,01,  Natun Basti,250,414,126,188,124,226,37.7,40.1,35.4,00000
69.0,91.0,39.0,596,02,01,  Kazi Para,71,69,38,33,33,36,50.7,53.5,47.8,00000
69.0,91.0,39.0,596,03,01,  Panchlarua,219,341,128,153,91,188,39.1,45.6,32.6,00000
69.0,91.0,39.0,596,04,01,  Aglarua,373,579,192,276,181,303,39.2,41.0,37.4,00000
69.0,91.0,39.0,596,05,01,  Naraynpur,222,259,125,115,97,144,46.2,52.1,40.2,00000
69.0,91.0,39.0,596,06,01,  Chaklarua,86,297,44,142,42,155,22.5,23.7,21.3,00000
69.0,91.0,39.0,672,01,01,  Nalbata Sardar Para,157,266,88,120,69,146,37.1,42.3,32.1,00000
69.0,91.0,39.0,672,02,01,  Mora Patia,92,356,50,175,42,181,20.5,22.2,18.8,00000
69.0,91.0,39.0,776,01,01,  Patsawail,324,366,166,168,158,198,47.0,49.7,44.4,00000
69.0,91.0,39.0,776,02,01,  Kusabari,432,733,238,373,194,360,37.1,39.0,35.0,00000
69.0,91.0,39.0,776,03,01,  Patkandi,100,152,51,73,49,79,39.7,41.1,38.3,00000
69.0,91.0,39.0,854,01,01,  Mandal Para,599,786,301,343,298,443,43.2,46.7,40.2,00000
69.0,91.0,39.0,854,02,01,  Saha Para,304,279,144,157,160,122,52.1,47.8,56.7,00000
69.0,91.0,39.0,854,03,01,  Taltali Para,92,70,49,33,43,37,56.8,59.8,53.8,00000
69.0,91.0,47.0,823,01,01,  Ratal,188,301,100,149,88,152,38.4,40.2,36.7,00000
69.0,91.0,47.0,823,02,01,  Salikha Para,94,158,50,72,44,86,37.3,41.0,33.8,00000
69.0,91.0,47.0,823,03,01,  Satara,41,363,22,172,19,191,10.1,11.3,9.0,00000
69.0,91.0,47.0,823,04,01,  Dighi Para,75,323,41,166,34,157,18.8,19.8,17.8,00000
69.0,91.0,55.0,409,01,01,  Harina,632,589,318,269,314,320,51.8,54.2,49.5,00000
69.0,91.0,55.0,409,02,01,  Balidaghati,137,90,66,37,71,53,60.4,64.1,57.3,00000
69.0,91.0,55.0,445,01,01,  Jagatpur,67,182,33,92,34,90,26.9,26.4,27.4,00000
69.0,91.0,55.0,445,02,01,  Ramkrishnapur,153,159,85,77,68,82,49.0,52.5,45.3,00000
69.0,91.0,55.0,480,01,01,  Nagar Para,192,498,105,239,87,259,27.8,30.5,25.1,00000
69.0,91.0,55.0,480,02,01,  Santanagar,146,244,86,110,60,134,37.4,43.9,30.9,00000
69.0,91.0,55.0,480,03,01,  Debdor,183,244,94,110,89,134,42.9,46.1,39.9,00000
69.0,91.0,55.0,480,04,01,  Nasiarkanda,682,1524,357,735,325,789,30.9,32.7,29.2,00000
69.0,91.0,55.0,480,05,01,  Kalinagar,1356,2495,692,1218,664,1277,35.2,36.2,34.2,00000
69.0,91.0,55.0,556,01,01,  Krishnapur,201,245,100,122,101,123,45.1,45.0,45.1,00000
69.0,91.0,55.0,556,02,01,  Par Krishnapur,127,303,73,158,54,145,29.5,31.6,27.1,00000
69.0,91.0,55.0,565,01,01,  Kumar Para,455,401,250,184,205,217,53.2,57.6,48.6,00000
69.0,91.0,55.0,565,02,01,  Baliabari,521,535,292,263,229,272,49.3,52.6,45.7,00000
69.0,91.0,55.0,585,01,01,  Lakshmipur,196,202,107,107,89,95,49.2,50.0,48.4,00000
69.0,91.0,55.0,585,02,01,  Nurpur,513,801,299,377,214,424,39.0,44.2,33.5,00000
69.0,91.0,55.0,585,03,01,  Bijoynagar,322,271,172,137,150,134,54.3,55.7,52.8,00000
69.0,91.0,55.0,754,01,01,  Par Saoail,703,670,404,288,299,382,51.2,58.4,43.9,00000
69.0,91.0,55.0,754,02,01,  Mahesh Chandrapur(Part),670,912,372,469,298,443,42.4,44.2,40.2,00000
69.0,91.0,63.0,024,01,01,  Ataikula,450,582,249,339,201,243,43.6,42.3,45.3,00000
69.0,91.0,63.0,024,02,01,  Adarsha Gram,136,455,69,217,67,238,23.0,24.1,22.0,00000
69.0,91.0,63.0,077,01,01,  Uttarpara,327,299,170,145,157,154,52.2,54.0,50.5,00000
69.0,91.0,63.0,077,02,01,  Dakshinpara,261,416,141,200,120,216,38.6,41.3,35.7,00000
69.0,91.0,63.0,077,03,01,  Madhyapara,344,339,172,156,172,183,50.4,52.4,48.5,00000
69.0,91.0,63.0,085,01,01,  Bara Belgharia (Paranpur),354,405,178,194,176,211,46.6,47.8,45.5,00000
69.0,91.0,63.0,085,02,01,  Mondalpara,197,150,106,72,91,78,56.8,59.6,53.8,00000
69.0,91.0,63.0,085,03,01,  Nutanpara,167,130,79,53,88,77,56.2,59.8,53.3,00000
69.0,91.0,63.0,102,01,01,  Nagar Majhgaon,436,687,225,332,211,355,38.8,40.4,37.3,00000
69.0,91.0,63.0,102,02,01,  Barabari,570,837,314,371,256,466,40.5,45.8,35.5,00000
69.0,91.0,63.0,222,01,01,  Chhota Baraihati,102,291,56,140,46,151,26.0,28.6,23.4,00000
69.0,91.0,63.0,222,02,01,  Gopandranagar,99,247,45,122,54,125,28.6,26.9,30.2,00000
69.0,91.0,63.0,251,01,01,  Majhgram,409,513,237,233,172,280,44.4,50.4,38.1,00000
69.0,91.0,63.0,251,02,01,  Bhandar,297,481,173,263,124,218,38.2,39.7,36.3,00000
69.0,91.0,63.0,251,03,01,  Gopalpur,168,156,97,66,71,90,51.9,59.5,44.1,00000
69.0,91.0,63.0,643,01,01,  Matgram,180,90,99,38,81,52,66.7,72.3,60.9,00000
69.0,91.0,63.0,643,02,01,  Nalbata,236,563,141,246,95,317,29.5,36.4,23.1,00000
69.0,91.0,63.0,809,01,01,  Raksa,99,132,53,66,46,66,42.9,44.5,41.1,00000
69.0,91.0,63.0,809,02,01,  Sonaidanga,164,267,88,139,76,128,38.1,38.8,37.3,00000
69.0,91.0,63.0,992,01,01,  Uttar Dhakdhar,311,375,163,182,148,193,45.3,47.2,43.4,00000
69.0,91.0,63.0,992,02,01,  Sanadanga,17,37,11,18,6,19,31.5,37.9,24.0,00000
69.0,91.0,71.0,251,01,01,  Chou Pukuria,279,698,153,327,126,371,28.6,31.9,25.4,00000
69.0,91.0,71.0,251,02,01,  Thaoil,519,906,306,426,213,480,36.4,41.8,30.7,00000
69.0,91.0,71.0,251,03,01,  Bakaikuri,112,450,64,212,48,238,19.9,23.2,16.8,00000
69.0,91.0,71.0,251,04,01,  Gavankuri,101,178,51,74,50,104,36.2,40.8,32.5,00000
69.0,91.0,79.0,086,01,01,  Khagorbari,240,817,131,396,109,421,22.7,24.9,20.6,00000
69.0,91.0,79.0,086,02,01,  Nilchora,211,521,124,241,87,280,28.8,34.0,23.7,00000
69.0,91.0,79.0,104,01,01,  Bara Nagarkandi(Ujanpara),203,293,99,147,104,146,40.9,40.2,41.6,00000
69.0,91.0,79.0,104,02,01,  Nagarkandi,133,270,72,123,61,147,33.0,36.9,29.3,00000
69.0,91.0,79.0,160,01,01,  Bhag Nagarkandi,182,608,96,289,86,319,23.0,24.9,21.2,00000
69.0,91.0,79.0,160,02,01,  Bairagi Para,176,168,97,74,79,94,51.2,56.7,45.7,00000
69.0,91.0,79.0,160,03,01,  Par Para,116,311,66,147,50,164,27.2,31.0,23.4,00000
69.0,91.0,79.0,242,01,01,  Chhota Mabakuri,51,36,22,18,29,18,58.6,55.0,61.7,00000
69.0,91.0,79.0,242,02,01,  Choto Nagar Kandi,16,46,9,25,7,21,25.8,26.5,25.0,00000
69.0,91.0,79.0,716,01,01,  Pamgaon,247,596,142,277,105,319,29.3,33.9,24.8,00000
69.0,91.0,79.0,716,02,01,  Puthimari,788,1060,430,499,358,561,42.6,46.3,39.0,00000
69.0,91.0,79.0,718,01,01,  Panchberia,164,332,91,187,73,145,33.1,32.7,33.5,00000
69.0,91.0,79.0,718,02,01,  Sonapur,200,272,92,127,108,145,42.4,42.0,42.7,00000
69.0,91.0,79.0,883,01,01,  Raninagar,748,645,382,296,366,349,53.7,56.3,51.2,00000
69.0,91.0,79.0,883,02,01,  Agpara,1351,1670,710,760,641,910,44.7,48.3,41.3,00000
69.0,91.0,79.0,883,03,01,  Math Para (Majh Para,141,167,80,90,61,77,45.8,47.1,44.2,00000
69.0,91.0,79.0,883,04,01,  Panch Para Sherkul,603,369,320,175,283,194,62.0,64.6,59.3,00000
69.0,91.0,79.0,883,05,01,  Sherkole,516,272,258,140,258,132,65.5,64.8,66.2,00000
69.0,91.0,79.0,883,06,01,  Sreerampur,278,190,140,92,138,98,59.4,60.3,58.5,00000
69.0,91.0,79.0,883,07,01,  Kanshapur,385,414,190,207,195,207,48.2,47.9,48.5,00000
69.0,91.0,79.0,883,08,01,  Harubaria,343,428,169,210,174,218,44.5,44.6,44.4,00000
69.0,91.0,79.0,883,09,01,  Dhulauri,655,829,343,382,312,447,44.1,47.3,41.1,00000
69.0,91.0,79.0,952,01,01,  Temukh,87,216,45,101,42,115,28.7,30.8,26.8,00000
69.0,91.0,79.0,952,02,01,  Palpara,163,213,97,90,66,123,43.4,51.9,34.9,00000
69.0,91.0,79.0,952,03,01,  Nawda Para,194,214,99,82,95,132,47.5,54.7,41.9,00000
69.0,91.0,87.0,040,01,01,  Bazrahar,86,98,45,55,41,43,46.7,45.0,48.8,00000
69.0,91.0,87.0,040,02,01,  Kamarpur,57,231,33,102,24,129,19.8,24.4,15.7,00000
69.0,91.0,87.0,040,03,01,  Nilampur,137,165,71,77,66,88,45.4,48.0,42.9,00000
69.0,91.0,87.0,158,01,01,  Bhaduri Para,44,84,19,41,25,43,34.4,31.7,36.8,00000
69.0,91.0,87.0,158,02,01,  Char Tazpur,97,142,51,67,46,75,40.6,43.2,38.0,00000
69.0,91.0,87.0,939,01,01,  Tajpur,191,397,106,175,85,222,32.5,37.7,27.7,00000
69.0,91.0,87.0,939,02,01,  Joynagar,444,390,225,179,219,211,53.2,55.7,50.9,00000
69.0,91.0,87.0,939,03,01,  Keshabpur,78,55,40,25,38,30,58.6,61.5,55.9,00000
38.0,13.0,15.0,025,01,01,  Khayerkuri,102,85,61,34,41,51,54.5,64.2,44.6,00000
38.0,13.0,15.0,025,02,01,  Ahladipur,399,303,223,122,176,181,56.8,64.6,49.3,00000
38.0,13.0,15.0,137,01,01,  Belgharia,119,77,56,39,63,38,60.7,58.9,62.4,00000
38.0,13.0,15.0,137,02,01,  Ratnahar,224,205,115,97,109,108,52.2,54.2,50.2,00000
38.0,13.0,15.0,394,01,01,  Haripur,135,16,63,5,72,11,89.4,92.6,86.7,00000
38.0,13.0,15.0,394,02,01,  Lochanpara,211,10,101,5,110,5,95.5,95.3,95.7,00000
38.0,13.0,15.0,960,01,01,  Temaria,378,250,185,115,193,135,60.2,61.7,58.8,00000
38.0,13.0,15.0,960,02,01,  Nohar Para,197,108,92,56,105,52,64.6,62.2,66.9,00000
38.0,13.0,15.0,960,03,01,  Daskuri,83,18,42,7,41,11,82.2,85.7,78.8,00000
38.0,13.0,31.0,077,01,01,  Ambari,236,285,123,136,113,149,45.3,47.5,43.1,00000
38.0,13.0,31.0,077,02,01,  Baluka Para,168,161,81,74,87,87,51.1,52.3,50.0,00000
38.0,13.0,31.0,077,03,01,  Khapara,125,112,66,54,59,58,52.7,55.0,50.4,00000
38.0,13.0,31.0,102,01,01,  Chandrapail,198,74,100,36,98,38,72.8,73.5,72.1,00000
38.0,13.0,31.0,102,02,01,  Harinatara,94,109,44,57,50,52,46.3,43.6,49.0,00000
38.0,13.0,31.0,102,03,01,  Bagirbaria,273,133,140,60,133,73,67.2,70.0,64.6,00000
38.0,13.0,31.0,248,01,01,  Banamali Para,501,491,259,222,242,269,50.5,53.8,47.4,00000
38.0,13.0,31.0,248,02,01,  Chak Bishturampur,810,471,386,220,424,251,63.2,63.7,62.8,00000
38.0,13.0,31.0,274,01,01,  Chak Budhai,171,173,80,83,91,90,49.7,49.1,50.3,00000
38.0,13.0,31.0,274,02,01,  Chak Bhabani,328,463,181,215,147,248,41.5,45.7,37.2,00000
38.0,13.0,31.0,274,03,01,  Deora,180,356,90,182,90,174,33.6,33.1,34.1,00000
38.0,13.0,31.0,634,01,01,  Maligaon,463,362,251,163,212,199,56.1,60.6,51.6,00000
38.0,13.0,31.0,634,02,01,  Madhai Pukur,176,179,97,82,79,97,49.6,54.2,44.9,00000
38.0,13.0,31.0,746,01,01,  Aushagari,115,283,55,132,60,151,28.9,29.4,28.4,00000
38.0,13.0,31.0,746,02,01,  Gholagari,67,87,33,44,34,43,43.5,42.9,44.2,00000
38.0,13.0,31.0,746,03,01,  Dighalgari,47,102,20,53,27,49,31.5,27.4,35.5,00000
38.0,13.0,31.0,746,04,01,  Baoudhya Pukur,77,78,44,33,33,45,49.7,57.1,42.3,00000
38.0,13.0,31.0,746,05,01,  Dukha Para,62,84,33,42,29,42,42.5,44.0,40.8,00000
38.0,13.0,31.0,746,06,01,  Narikeli,420,481,214,205,206,276,46.6,51.1,42.7,00000
38.0,13.0,31.0,814,01,01,  Kalikapur,201,244,112,116,89,128,45.2,49.1,41.0,00000
38.0,13.0,31.0,814,02,01,  Khapara,107,259,59,129,48,130,29.2,31.4,27.0,00000
38.0,13.0,31.0,814,03,01,  Hargachha,204,499,113,228,91,271,29.0,33.1,25.1,00000
38.0,13.0,31.0,814,04,01,  Sreegal Dighi,151,181,71,86,80,95,45.5,45.2,45.7,00000
38.0,13.0,31.0,814,05,01,  Guchchhagram,75,162,32,77,43,85,31.6,29.4,33.6,00000
38.0,13.0,31.0,814,06,01,  Roykali,338,269,190,106,148,163,55.7,64.2,47.6,00000
38.0,13.0,79.0,188,01,01,  Bhatta Palashi,163,96,83,48,80,48,62.9,63.4,62.5,00000
38.0,13.0,79.0,188,02,01,  Purbapara,239,277,106,124,133,153,46.3,46.1,46.5,00000
38.0,13.0,79.0,317,01,01,  Chardighi,143,134,74,65,69,69,51.6,53.2,50.0,00000
38.0,13.0,79.0,317,02,01,  Pukhuria Para,113,151,60,59,53,92,42.8,50.4,36.6,00000
38.0,13.0,79.0,317,03,01,  Bamanigram,337,192,181,79,156,113,63.7,69.6,58.0,00000
38.0,13.0,79.0,488,01,01,  Kadoa,164,107,74,42,90,65,60.5,63.8,58.1,00000
38.0,13.0,79.0,488,02,01,  Kholagari,181,78,84,35,97,43,69.9,70.6,69.3,00000
38.0,13.0,79.0,523,01,01,  Karamji,272,144,146,53,126,91,65.4,73.4,58.1,00000
38.0,13.0,79.0,523,02,01,  Kaigari,25,10,15,4,10,6,71.4,78.9,62.5,00000
38.0,13.0,79.0,566,01,01,  Khanpura,188,74,97,35,91,39,71.8,73.5,70.0,00000
38.0,13.0,79.0,566,02,01,  Chak Ismailpur,131,35,66,15,65,20,78.9,81.5,76.5,00000
38.0,13.0,79.0,591,01,01,  Krishnakola,148,130,68,56,80,74,53.2,54.8,51.9,00000
38.0,13.0,79.0,591,02,01,  Chichuria,184,170,86,78,98,92,52.0,52.4,51.6,00000
38.0,13.0,79.0,660,01,01,  Manikpur,220,433,119,212,101,221,33.7,36.0,31.4,00000
38.0,13.0,79.0,660,02,01,  Jafrapara,172,104,91,45,81,59,62.3,66.9,57.9,00000
38.0,13.0,79.0,660,03,01,  Padmapukur,66,22,32,6,34,16,75.0,84.2,68.0,00000
38.0,13.0,79.0,677,01,01,  Marma,188,222,105,103,83,119,45.9,50.5,41.1,00000
38.0,13.0,79.0,677,02,01,  Miah Para,220,52,113,21,107,31,80.9,84.3,77.5,00000
38.0,13.0,79.0,703,01,01,  Bargachha,270,133,128,56,142,77,67.0,69.6,64.8,00000
38.0,13.0,79.0,703,02,01,  Jhalgharia,278,185,156,80,122,105,60.0,66.1,53.7,00000
38.0,13.0,79.0,711,01,01,  Mohanpur,593,389,339,153,254,236,60.4,68.9,51.8,00000
38.0,13.0,79.0,711,02,01,  Bagapukur,51,36,32,14,19,22,58.6,69.6,46.3,00000
38.0,13.0,79.0,754,01,01,  Dararkul,402,266,196,120,206,146,60.2,62.0,58.5,00000
38.0,13.0,79.0,754,02,01,  Kachari Para,443,210,260,95,183,115,67.8,73.2,61.4,00000
38.0,13.0,79.0,754,03,01,  Paschim Bazar,395,85,227,35,168,50,82.3,86.6,77.1,00000
38.0,13.0,79.0,754,04,01,  Shiala Para,250,337,123,161,127,176,42.6,43.3,41.9,00000
38.0,13.0,79.0,754,05,01,  Majhi Para,49,81,26,36,23,45,37.7,41.9,33.8,00000
38.0,13.0,79.0,754,06,01,  Naya Para,98,122,54,56,44,66,44.5,49.1,40.0,00000
38.0,13.0,79.0,754,07,01,  Purba Bazar,536,150,289,63,247,87,78.1,82.1,74.0,00000
38.0,13.0,79.0,840,01,01,  Roynagar,294,233,146,97,148,136,55.8,60.1,52.1,00000
38.0,13.0,79.0,840,02,01,  Fulbari,196,101,110,45,86,56,66.0,71.0,60.6,00000
38.0,47.0,17.0,546,01,01,  Chak Para,174,94,94,41,80,53,64.9,69.6,60.2,00000
38.0,47.0,17.0,546,02,01,  Dhole Para,381,188,201,95,180,93,67.0,67.9,65.9,00000
38.0,47.0,17.0,546,03,01,  Fakir Para,574,464,289,234,285,230,55.3,55.3,55.3,00000
38.0,47.0,17.0,546,04,01,  Palikadoa,916,376,484,173,432,203,70.9,73.7,68.0,00000
38.0,47.0,17.0,546,05,01,  Kayra Para,231,102,124,49,107,53,69.4,71.7,66.9,00000
38.0,47.0,17.0,556,01,01,  Kaitahar,1571,800,818,353,753,447,66.3,69.9,62.8,00000
38.0,47.0,17.0,556,02,01,  Hatubhanga,560,291,296,120,264,171,65.8,71.2,60.7,00000
38.0,47.0,17.0,600,01,01,  Naya Para,181,123,94,61,87,62,59.5,60.6,58.4,00000
38.0,47.0,17.0,600,02,01,  Jala Para,52,92,25,38,27,54,36.1,39.7,33.3,00000
38.0,47.0,17.0,600,03,01,  Kendul,1240,671,687,286,553,385,64.9,70.6,59.0,00000
38.0,47.0,17.0,724,01,01,  Mitna,580,295,310,142,270,153,66.3,68.6,63.8,00000
38.0,47.0,17.0,724,02,01,  Pater Pukur,223,51,125,21,98,30,81.4,85.6,76.6,00000
38.0,47.0,17.0,789,01,01,  Paikar,358,202,197,86,161,116,63.9,69.6,58.1,00000
38.0,47.0,17.0,789,02,01,  Monna Para,94,172,60,87,34,85,35.3,40.8,28.6,00000
38.0,47.0,17.0,892,01,01,  Ghona Para,152,34,88,9,64,25,81.7,90.7,71.9,00000
38.0,47.0,17.0,892,02,01,  Rangta,371,247,201,105,170,142,60.0,65.7,54.5,00000
38.0,47.0,17.0,892,03,01,  Chowdhury Para,209,68,113,29,96,39,75.5,79.6,71.1,00000
38.0,47.0,17.0,935,01,01,  Teghara,114,62,62,28,52,34,64.8,68.9,60.5,00000
38.0,47.0,17.0,935,02,01,  Dandapani,510,271,267,121,243,150,65.3,68.8,61.8,00000
38.0,47.0,47.0,362,01,01,  Dakshin Dogachhi,454,465,250,218,204,247,49.4,53.4,45.2,00000
38.0,47.0,47.0,362,02,01,  Uttar Dogachhi,1721,1158,885,549,836,609,59.8,61.7,57.9,00000
38.0,47.0,47.0,832,01,01,  Purba Paturia,1248,859,693,384,555,475,59.2,64.3,53.9,00000
38.0,47.0,47.0,832,02,01,  Paschim Paturia,425,414,244,190,181,224,50.7,56.2,44.7,00000
38.0,47.0,47.0,838,01,01,  Purba Pechulia,1238,862,680,400,558,462,59.0,63.0,54.7,00000
38.0,47.0,47.0,838,02,01,  Paschim Pechulia,1190,1074,641,529,549,545,52.6,54.8,50.2,00000
38.0,47.0,66.0,297,01,01,  Chak Dadra,570,283,309,120,261,163,66.8,72.0,61.6,00000
38.0,47.0,66.0,297,02,01,  Khetu Crarbaria,453,219,253,101,200,118,67.4,71.5,62.9,00000
38.0,47.0,66.0,297,03,01,  Jandi Sardar Para,1480,500,781,221,699,279,74.7,77.9,71.5,00000
38.0,47.0,66.0,297,04,01,  Madhya Dadra Jandigram,1052,567,588,279,464,288,65.0,67.8,61.7,00000
38.0,47.0,66.0,297,05,01,  Suktahar,930,242,524,88,406,154,79.4,85.6,72.5,00000
38.0,47.0,66.0,297,06,01,  Dhulatar,1201,508,634,216,567,292,70.3,74.6,66.0,00000
38.0,47.0,66.0,297,07,01,  Dakshin Dadra,313,99,167,40,146,59,76.0,80.7,71.2,00000
38.0,47.0,66.0,508,01,01,  Uttar Jamalpur,2277,1160,1194,539,1083,621,66.2,68.9,63.6,00000
38.0,47.0,66.0,508,02,01,  Dakshin Jamalpur,1080,408,561,172,519,236,72.6,76.5,68.7,00000
38.0,47.0,66.0,897,01,01,  Purba Sahapur,921,395,486,168,435,227,70.0,74.3,65.7,00000
38.0,47.0,66.0,897,02,01,  Paschim Sahapur,964,384,501,162,463,222,71.5,75.6,67.6,00000
38.0,58.0,38.0,095,01,01,  Balait,269,310,152,133,117,177,46.5,53.3,39.8,00000
38.0,58.0,38.0,095,02,01,  Paratgara,58,74,32,36,26,38,43.9,47.1,40.6,00000
38.0,58.0,38.0,095,03,01,  Surail,174,187,101,78,73,109,48.2,56.4,40.1,00000
38.0,58.0,38.0,171,01,01,  Uttar Bhabki,403,481,225,212,178,269,45.6,51.5,39.8,00000
38.0,58.0,38.0,171,02,01,  Dakshin Bhabki,123,172,65,81,58,91,41.7,44.5,38.9,00000
38.0,58.0,38.0,217,01,01,  Borai,420,564,248,242,172,322,42.7,50.6,34.8,00000
38.0,58.0,38.0,217,02,01,  Raghabpur,270,286,137,129,133,157,48.6,51.5,45.9,00000
38.0,58.0,38.0,429,01,01,  Hatior,789,952,430,417,359,535,45.3,50.8,40.2,00000
38.0,58.0,38.0,429,02,01,  Dargapara,77,273,46,131,31,142,22.0,26.0,17.9,00000
38.0,58.0,38.0,570,01,01,  Uttar Pakuria,142,130,82,55,60,75,52.2,59.9,44.4,00000
38.0,58.0,38.0,570,02,01,  Dakshin Pakuria,222,158,118,68,104,90,58.4,63.4,53.6,00000
38.0,58.0,38.0,964,01,01,  Naya Para (Koshilpur),206,159,105,70,101,89,56.4,60.0,53.2,00000
38.0,58.0,38.0,964,02,01,  Haji Para,182,197,94,91,88,106,48.0,50.8,45.4,00000
38.0,58.0,66.0,106,01,01,  Baligram,530,667,306,297,224,370,44.3,50.7,37.7,00000
38.0,58.0,66.0,106,02,01,  Chak Shalukgari,218,345,118,149,100,196,38.7,44.2,33.8,00000
38.0,58.0,66.0,196,01,01,  Biala,954,1058,475,499,479,559,47.4,48.8,46.1,00000
38.0,58.0,66.0,196,02,01,  Bauza Patrar,238,141,132,63,106,78,62.8,67.7,57.6,00000
38.0,58.0,66.0,247,01,01,  Chhatragram,302,438,163,205,139,233,40.8,44.3,37.4,00000
38.0,58.0,66.0,247,02,01,  Ragunathpur,266,151,139,74,127,77,63.8,65.3,62.3,00000
38.0,58.0,66.0,297,01,01,  Daudia,341,217,183,98,158,119,61.1,65.1,57.0,00000
38.0,58.0,66.0,297,02,01,  Ashurail,218,213,110,95,108,118,50.6,53.7,47.8,00000
38.0,58.0,66.0,454,01,01,  Ulipur,364,370,205,147,159,223,49.6,58.2,41.6,00000
38.0,58.0,66.0,454,02,01,  Paikoshor,176,191,93,81,83,110,48.0,53.4,43.0,00000
38.0,58.0,66.0,868,01,01,  Samsira,462,396,224,176,238,220,53.8,56.0,52.0,00000
38.0,58.0,66.0,868,02,01,  Balakhur,239,260,134,129,105,131,47.9,51.0,44.5,00000
38.0,58.0,66.0,909,01,01,  Silimpur,233,333,116,172,117,161,41.2,40.3,42.1,00000
38.0,58.0,66.0,909,02,01,  Lakichapar,205,293,101,152,104,141,41.2,39.9,42.4,00000
38.0,58.0,66.0,909,03,01,  Bhagina Pathar,160,129,82,71,78,58,55.4,53.6,57.4,00000
38.0,58.0,76.0,227,01,01,  Burail,326,419,185,184,141,235,43.8,50.1,37.5,00000
38.0,58.0,76.0,227,02,01,  Chakalmua,419,590,222,266,197,324,41.5,45.5,37.8,00000
38.0,58.0,76.0,273,01,01,  Nandail,410,997,223,445,187,552,29.1,33.4,25.3,00000
38.0,58.0,76.0,273,02,01,  Chak Murail,159,294,87,135,72,159,35.1,39.2,31.2,00000
38.0,58.0,76.0,273,03,01,  Dighi Para,152,342,73,159,79,183,30.8,31.5,30.2,00000
38.0,58.0,76.0,388,01,01,  Gohara,46,122,26,59,20,63,27.4,30.6,24.1,00000
38.0,58.0,76.0,388,02,01,  Utrail,125,156,70,72,55,84,44.5,49.3,39.6,00000
38.0,58.0,76.0,742,01,01,  Panchgaon,1411,1541,787,662,624,879,47.8,54.3,41.5,00000
38.0,58.0,76.0,742,02,01,  Tisra Para,243,282,122,136,121,146,46.3,47.3,45.3,00000
38.0,58.0,76.0,787,01,01,  Punat,2102,1693,1164,709,938,984,55.4,62.1,48.8,00000
38.0,58.0,76.0,787,02,01,  Panchpaika,600,507,320,224,280,283,54.2,58.8,49.7,00000
38.0,58.0,76.0,787,03,01,  Paschim Nayapara,122,109,72,48,50,61,52.8,60.0,45.0,00000
38.0,58.0,76.0,787,04,01,  Purba Nayapara,204,197,110,87,94,110,50.9,55.8,46.1,00000
38.0,58.0,76.0,787,05,01,  Bafalgari,531,508,302,209,229,299,51.1,59.1,43.4,00000
38.0,58.0,76.0,787,06,01,  Kharpa,210,64,124,21,86,43,76.6,85.5,66.7,00000
38.0,58.0,76.0,787,07,01,  Dingrapara,387,409,239,162,148,247,48.6,59.6,37.5,00000
38.0,58.0,76.0,904,01,01,  Sikta,1008,896,562,401,446,495,52.9,58.4,47.4,00000
38.0,58.0,76.0,904,02,01,  Dap Sitka,512,374,285,161,227,213,57.8,63.9,51.6,00000
38.0,58.0,76.0,949,01,01,  Talkhur,214,183,131,76,83,107,53.9,63.3,43.7,00000
38.0,58.0,76.0,949,02,01,  Bugoil,522,613,281,286,241,327,46.0,49.6,42.4,00000
38.0,58.0,85.0,075,01,01,  Bahuti,273,216,155,94,118,122,55.8,62.2,49.2,00000
38.0,58.0,85.0,075,02,01,  Durgapur,390,246,211,110,179,136,61.3,65.7,56.8,00000
38.0,58.0,85.0,338,01,01,  Dudhail,338,285,158,129,180,156,54.3,55.1,53.6,00000
38.0,58.0,85.0,338,02,01,  Naya Para,319,200,170,81,149,119,61.5,67.7,55.6,00000
38.0,58.0,85.0,338,03,01,  Akala Para,301,455,173,217,128,238,39.8,44.4,35.0,00000
38.0,58.0,85.0,363,01,01,  Alyagari,104,169,61,81,43,88,38.1,43.0,32.8,00000
38.0,58.0,85.0,363,02,01,  Bashia Para,185,440,97,208,88,232,29.6,31.8,27.5,00000
38.0,58.0,85.0,363,03,01,  Gangadaspur,332,317,170,136,162,181,51.2,55.6,47.2,00000
38.0,58.0,85.0,363,04,01,  Amla Pukur,29,63,11,25,18,38,31.5,30.6,32.1,00000
38.0,58.0,85.0,540,01,01,  Kashipur,79,168,41,86,38,82,32.0,32.3,31.7,00000
38.0,58.0,85.0,540,02,01,  Joypur,199,158,107,69,92,89,55.7,60.8,50.8,00000
38.0,58.0,85.0,540,03,01,  Simril,285,171,151,87,134,84,62.5,63.4,61.5,00000
38.0,58.0,85.0,792,01,01,  Pur,322,314,168,131,154,183,50.6,56.2,45.7,00000
38.0,58.0,85.0,792,02,01,  Sakpur,206,197,129,79,77,118,51.1,62.0,39.5,00000
38.0,58.0,85.0,792,03,01,  Maltia,115,64,63,26,52,38,64.2,70.8,57.8,00000
38.0,58.0,85.0,792,04,01,  Jaminpur,164,94,91,45,73,49,63.6,66.9,59.8,00000
38.0,58.0,85.0,939,01,01,  Takahut,822,283,448,121,374,162,74.4,78.7,69.8,00000
38.0,58.0,85.0,939,02,01,  Chak Takahut,185,129,100,56,85,73,58.9,64.1,53.8,00000
38.0,58.0,85.0,969,01,01,  Udaypur,316,166,160,73,156,93,65.6,68.7,62.7,00000
38.0,58.0,85.0,969,02,01,  Thal,364,338,204,148,160,190,51.9,58.0,45.7,00000
38.0,58.0,85.0,994,01,01,  Uttar Telihar,427,564,222,262,205,302,43.1,45.9,40.4,00000
38.0,58.0,85.0,994,02,01,  Bhusha,140,203,77,102,63,101,40.8,43.0,38.4,00000
38.0,58.0,95.0,085,01,01,  Bakhara,877,859,479,386,398,473,50.5,55.4,45.7,00000
38.0,58.0,95.0,085,02,01,  Balgaria,137,185,72,89,65,96,42.5,44.7,40.4,00000
38.0,58.0,95.0,353,01,01,  Elta,434,294,239,115,195,179,59.6,67.5,52.1,00000
38.0,58.0,95.0,353,02,01,  Imampur,222,215,135,77,87,138,50.8,63.7,38.7,00000
38.0,58.0,95.0,378,01,01,  Ghaturia,416,796,228,372,188,424,34.3,38.0,30.7,00000
38.0,58.0,95.0,378,02,01,  Nanahar,185,183,98,88,87,95,50.3,52.7,47.8,00000
38.0,58.0,95.0,434,01,01,  Hajipur,508,503,257,236,251,267,50.2,52.1,48.5,00000
38.0,58.0,95.0,434,02,01,  Bistapur,122,147,64,68,58,79,45.4,48.5,42.3,00000
38.0,58.0,95.0,494,01,01,  Kadirpur,944,718,495,318,449,400,56.8,60.9,52.9,00000
38.0,58.0,95.0,494,02,01,  Dap Kadirpur,97,208,53,100,44,108,31.8,34.6,28.9,00000
38.0,58.0,95.0,494,03,01,  Molamgari,783,746,428,322,355,424,51.2,57.1,45.6,00000
38.0,58.0,95.0,595,01,01,  Purba Kujail,447,291,242,113,205,178,60.6,68.2,53.5,00000
38.0,58.0,95.0,595,02,01,  Paschim Kujail,349,384,197,166,152,218,47.6,54.3,41.1,00000
38.0,58.0,95.0,808,01,01,  Purba Itail,913,1018,498,428,415,590,47.3,53.8,41.3,00000
38.0,58.0,95.0,808,02,01,  Damtra,82,65,53,23,29,42,55.8,69.7,40.8,00000
38.0,61.0,15.0,015,01,01,  Aklas,120,93,61,41,59,52,56.3,59.8,53.2,00000
38.0,61.0,15.0,015,02,01,  Shyampur,106,48,52,25,54,23,68.8,67.5,70.1,00000
38.0,61.0,15.0,020,01,01,  Alampur,1126,973,635,424,491,549,53.6,60.0,47.2,00000
38.0,61.0,15.0,020,02,01,  Nalpukur,75,197,38,91,37,106,27.6,29.5,25.9,00000
38.0,61.0,15.0,121,01,01,  Banaich,342,193,188,80,154,113,63.9,70.1,57.7,00000
38.0,61.0,15.0,121,02,01,  Alipur,360,248,191,106,169,142,59.2,64.3,54.3,00000
38.0,61.0,15.0,121,03,01,  Tahamra,142,118,73,51,69,67,54.6,58.9,50.7,00000
38.0,61.0,15.0,121,04,01,  Hapania,117,61,69,30,48,31,65.7,69.7,60.8,00000
38.0,61.0,15.0,131,01,01,  Bania Chapar,625,134,328,46,297,88,82.3,87.7,77.1,00000
38.0,61.0,15.0,131,02,01,  Amunia Para,238,163,129,64,109,99,59.4,66.8,52.4,00000
38.0,61.0,15.0,303,01,01,  Daulatpur,692,814,394,339,298,475,45.9,53.8,38.6,00000
38.0,61.0,15.0,303,02,01,  Kanaipukur,170,90,89,33,81,57,65.4,73.0,58.7,00000
38.0,61.0,15.0,702,01,01,  Nasirpur,234,411,122,205,112,206,36.3,37.3,35.2,00000
38.0,61.0,15.0,702,02,01,  Mirzapur,132,394,71,179,61,215,25.1,28.4,22.1,00000
38.0,61.0,15.0,732,01,01,  Pachul,604,718,345,307,259,411,45.7,52.9,38.7,00000
38.0,61.0,15.0,732,02,01,  Khottar Para,151,142,81,65,70,77,51.5,55.5,47.6,00000
38.0,61.0,15.0,732,03,01,  Phopra Para,213,71,114,20,99,51,75.0,85.1,66.0,00000
38.0,61.0,19.0,510,01,01,  Kanchakul,159,233,82,113,77,120,40.6,42.1,39.1,00000
38.0,61.0,19.0,510,02,01,  Kharikata Part-2,127,40,61,19,66,21,76.0,76.3,75.9,00000
38.0,61.0,19.0,560,01,01,  Uttar Kesurata,147,160,83,70,64,90,47.9,54.2,41.6,00000
38.0,61.0,19.0,560,02,01,  Dakshin Kesurta,142,165,83,72,59,93,46.3,53.5,38.8,00000
38.0,61.0,19.0,585,01,01,  Tarakul,667,427,359,197,308,230,61.0,64.6,57.2,00000
38.0,61.0,19.0,585,02,01,  Fakir Para,375,579,194,276,181,303,39.3,41.3,37.4,00000
38.0,61.0,19.0,585,03,01,  Shalban,708,488,380,231,328,257,59.2,62.2,56.1,00000
38.0,61.0,19.0,585,04,01,  Madhyapara,282,384,164,175,118,209,42.3,48.4,36.1,00000
38.0,61.0,19.0,585,05,01,  Maziathal,604,420,313,181,291,239,59.0,63.4,54.9,00000
38.0,61.0,19.0,585,06,01,  Nazir Para,270,275,144,117,126,158,49.5,55.2,44.4,00000
38.0,61.0,19.0,696,01,01,  Naitika,243,186,127,80,116,106,56.6,61.4,52.3,00000
38.0,61.0,19.0,696,02,01,  Butpara,74,66,39,32,35,34,52.9,54.9,50.7,00000
38.0,61.0,19.0,777,01,01,  Pathan Para,142,193,82,91,60,102,42.4,47.4,37.0,00000
38.0,61.0,19.0,777,02,01,  Karikata (Part-1),135,110,70,51,65,59,55.1,57.9,52.4,00000
38.0,61.0,19.0,838,01,01,  Roair,188,428,103,204,85,224,30.5,33.6,27.5,00000
38.0,61.0,19.0,838,02,01,  Amani Para,100,301,64,139,36,162,24.9,31.5,18.2,00000
38.0,61.0,19.0,838,03,01,  Ghorshil,47,196,29,91,18,105,19.3,24.2,14.6,00000
38.0,61.0,19.0,954,01,01,  Baratara,828,726,438,324,390,402,53.3,57.5,49.2,00000
38.0,61.0,19.0,954,02,01,  Bagha Para,315,271,172,129,143,142,53.8,57.1,50.2,00000
38.0,61.0,19.0,979,01,01,  Uttar Hatsahar,463,320,247,140,216,180,59.1,63.8,54.5,00000
38.0,61.0,19.0,979,02,01,  Naopara,97,85,57,31,40,54,53.3,64.8,42.6,00000
38.0,61.0,19.0,979,03,01,  Haji Para (Part-2),152,135,76,61,76,74,53.0,55.5,50.7,00000
38.0,61.0,19.0,984,01,01,  Uttar Maheshpur,260,278,144,135,116,143,48.3,51.6,44.8,00000
38.0,61.0,19.0,984,02,01,  Shalukdubi,300,264,168,120,132,144,53.2,58.3,47.8,00000
38.0,61.0,28.0,207,01,01,  Binay,688,560,361,239,327,321,55.1,60.2,50.5,00000
38.0,61.0,28.0,207,02,01,  Binay Panchkhupi,287,283,157,119,130,164,50.4,56.9,44.2,00000
38.0,61.0,28.0,207,03,01,  Haripur,42,78,23,35,19,43,35.0,39.7,30.6,00000
38.0,61.0,28.0,207,04,01,  Pratappara,82,200,47,91,35,109,29.1,34.1,24.3,00000
38.0,61.0,28.0,535,01,01,  Hinda Kasba,596,428,320,177,276,251,58.2,64.4,52.4,00000
38.0,61.0,28.0,535,02,01,  Hinda Bazar Barahi,289,195,155,95,134,100,59.7,62.0,57.3,00000
38.0,61.0,28.0,535,03,01,  Gangair,201,83,118,27,83,56,70.8,81.4,59.7,00000
38.0,61.0,28.0,535,04,01,  Rajbinay,117,115,56,48,61,67,50.4,53.8,47.7,00000
38.0,61.0,28.0,762,01,01,  Paschim Itail,138,89,69,41,69,48,60.8,62.7,59.0,00000
38.0,61.0,28.0,762,02,01,  Hinda Panchkhupy,395,164,206,64,189,100,70.7,76.3,65.4,00000
38.0,61.0,28.0,883,01,01,  Shashigram,173,137,98,55,75,82,55.8,64.1,47.8,00000
38.0,61.0,28.0,883,02,01,  Belgari,138,105,77,47,61,58,56.8,62.1,51.3,00000
38.0,61.0,47.0,060,01,01,  Ati,583,458,314,231,269,227,56.0,57.6,54.2,00000
38.0,61.0,47.0,060,02,01,  Ghuguil,554,143,294,62,260,81,79.5,82.6,76.2,00000
38.0,61.0,47.0,060,03,01,  Dighi Para,208,144,119,70,89,74,59.1,63.0,54.6,00000
38.0,61.0,47.0,292,01,01,  Shial Para,162,151,87,74,75,77,51.8,54.0,49.3,00000
38.0,61.0,47.0,292,02,01,  Uttarpara,136,262,75,128,61,134,34.2,36.9,31.3,00000
38.0,61.0,47.0,292,03,01,  Maligari,323,106,173,39,150,67,75.3,81.6,69.1,00000
38.0,61.0,47.0,292,04,01,  Mosandal,146,219,75,103,71,116,40.0,42.1,38.0,00000
38.0,61.0,47.0,292,05,01,  Monjhar,93,133,43,71,50,62,41.2,37.7,44.6,00000
38.0,61.0,47.0,292,06,01,  Dwapukur,275,340,153,170,122,170,44.7,47.4,41.8,00000
38.0,61.0,47.0,292,07,01,  Kazi Para,144,43,78,22,66,21,77.0,78.0,75.9,00000
38.0,61.0,47.0,292,08,01,  Fakir Para,143,247,78,124,65,123,36.7,38.6,34.6,00000
38.0,61.0,47.0,292,09,01,  Khan Para,113,24,57,7,56,17,82.5,89.1,76.7,00000
38.0,61.0,47.0,292,10,01,  Talsana (Part-2),219,204,142,99,77,105,51.8,58.9,42.3,00000
38.0,61.0,47.0,590,01,03,  Sadar,1025,215,554,92,471,123,82.7,85.8,79.3,00000
38.0,61.0,47.0,590,02,03,  Rashal Para,185,142,91,66,94,76,56.6,58.0,55.3,00000
38.0,61.0,47.0,590,03,03,  Khalisagari,280,311,135,148,145,163,47.4,47.7,47.1,00000
38.0,61.0,47.0,590,04,03,  Mandail,622,419,305,203,317,216,59.8,60.0,59.5,00000
38.0,61.0,47.0,590,05,03,  Khungia,39,273,21,136,18,137,12.5,13.4,11.6,00000
38.0,61.0,47.0,590,06,03,  Harakula,212,157,118,70,94,87,57.5,62.8,51.9,00000
38.0,61.0,47.0,590,07,03,  Gadhuka,135,61,71,22,64,39,68.9,76.3,62.1,00000
38.0,61.0,47.0,590,08,03,  Itakhola,469,190,261,82,208,108,71.2,76.1,65.8,00000
38.0,61.0,47.0,590,09,03,  Fakir Para,354,115,188,56,166,59,75.5,77.0,73.8,00000
38.0,61.0,47.0,590,10,03,  Sardar Para,91,154,44,74,47,80,37.1,37.3,37.0,00000
38.0,61.0,47.0,590,11,03,  Jalia Para,399,388,220,173,179,215,50.7,56.0,45.4,00000
38.0,61.0,47.0,590,12,03,  Rampura,357,410,167,206,190,204,46.5,44.8,48.2,00000
38.0,61.0,47.0,590,13,03,  Koralgari,476,302,257,137,219,165,61.2,65.2,57.0,00000
38.0,61.0,47.0,590,14,03,  Kanpara,54,58,31,24,23,34,48.2,56.4,40.4,00000
38.0,61.0,47.0,590,15,03,  Bakasi Para,136,63,78,27,58,36,68.3,74.3,61.7,00000
38.0,61.0,47.0,590,16,03,  Surjaban,419,310,210,135,209,175,57.5,60.9,54.4,00000
38.0,61.0,47.0,590,17,03,  Mali Para,256,165,140,64,116,101,60.8,68.6,53.5,00000
38.0,61.0,47.0,590,18,03,  Paik Para,170,191,85,88,85,103,47.1,49.1,45.2,00000
38.0,61.0,47.0,590,19,03,  Dankurail,277,206,134,101,143,105,57.3,57.0,57.7,00000
38.0,61.0,47.0,590,20,03,  Sagarampur,101,48,59,12,42,36,67.8,83.1,53.8,00000
38.0,61.0,47.0,590,21,03,  Kazi Para,105,42,61,15,44,27,71.4,80.3,62.0,00000
38.0,61.0,57.0,010,01,01,  Aimapur,602,577,306,271,296,306,51.1,53.0,49.2,00000
38.0,61.0,57.0,010,02,01,  Konia Para,168,67,95,31,73,36,71.5,75.4,67.0,00000
38.0,61.0,57.0,161,01,01,  Bandighi,134,207,79,89,55,118,39.3,47.0,31.8,00000
38.0,61.0,57.0,161,02,01,  Belta,123,90,72,36,51,54,57.7,66.7,48.6,00000
38.0,61.0,57.0,161,03,01,  Amjhuki,92,67,49,30,43,37,57.9,62.0,53.8,00000
38.0,61.0,57.0,621,01,01,  Mahabatpur,2054,1541,1059,764,995,777,57.1,58.1,56.2,00000
38.0,61.0,57.0,621,02,01,  Dighir Para,101,85,54,44,47,41,54.3,55.1,53.4,00000
38.0,61.0,57.0,757,01,01,  Paschim Durgapur,36,37,16,22,20,15,49.3,42.1,57.1,00000
38.0,61.0,57.0,757,02,01,  Jaisinga,58,54,30,25,28,29,51.8,54.5,49.1,00000
38.0,61.0,57.0,757,03,01,  Khandar,58,78,35,38,23,40,42.6,47.9,36.5,00000
38.0,74.0,10.0,138,01,01,  Mugar Pundipur,169,158,87,75,82,83,51.7,53.7,49.7,00000
38.0,74.0,10.0,138,02,01,  Dugar Para,392,176,218,85,174,91,69.0,71.9,65.7,00000
38.0,74.0,10.0,138,03,01,  Jantari,181,228,91,115,90,113,44.3,44.2,44.3,00000
38.0,74.0,10.0,170,01,01,  Bharahut,147,412,79,211,68,201,26.3,27.2,25.3,00000
38.0,74.0,10.0,170,02,01,  Haripur,82,239,43,122,39,117,25.5,26.1,25.0,00000
38.0,74.0,10.0,170,03,01,  Kharia Para,74,110,39,53,35,57,40.2,42.4,38.0,00000
38.0,74.0,10.0,170,04,01,  Naya Para,250,294,141,126,109,168,46.0,52.8,39.4,00000
38.0,74.0,10.0,170,05,01,  Shirati,325,712,175,349,150,363,31.3,33.4,29.2,00000
38.0,74.0,10.0,721,01,01,  Panial,694,690,377,316,317,374,50.1,54.4,45.9,00000
38.0,74.0,10.0,721,02,01,  Mamuda Para,39,19,20,6,19,13,67.2,76.9,59.4,00000
38.0,74.0,10.0,811,01,01,  Roygaon,279,334,140,159,139,175,45.5,46.8,44.3,00000
38.0,74.0,10.0,811,02,01,  Chatkhur,303,501,164,236,139,265,37.7,41.0,34.4,00000
38.0,74.0,10.0,811,03,01,  Makul,127,305,58,159,69,146,29.4,26.7,32.1,00000
38.0,74.0,10.0,811,04,01,  Naodoba,366,421,192,180,174,241,46.5,51.6,41.9,00000
38.0,74.0,10.0,811,05,01,  Fatehpur,233,157,125,76,108,81,59.7,62.2,57.1,00000
38.0,74.0,10.0,811,06,01,  Dahuria,307,464,156,217,151,247,39.8,41.8,37.9,00000
38.0,74.0,10.0,873,01,01,  Salatti,261,383,146,176,115,207,40.5,45.3,35.7,00000
38.0,74.0,10.0,873,02,01,  Binni Para,161,242,90,102,71,140,40.0,46.9,33.6,00000
38.0,74.0,10.0,873,03,01,  Bania Pukur,144,250,71,112,73,138,36.5,38.8,34.6,00000
38.0,74.0,10.0,887,01,01,  Dole Para,429,454,233,217,196,237,48.6,51.8,45.3,00000
38.0,74.0,10.0,887,02,01,  Chak Siddeshwari,23,31,14,14,9,17,42.6,50.0,34.6,00000
38.0,74.0,21.0,040,01,01,  Mukundapur,321,110,172,51,149,59,74.5,77.1,71.6,00000
38.0,74.0,21.0,040,02,01,  Sarakchara,93,49,56,17,37,32,65.5,76.7,53.6,00000
38.0,74.0,21.0,040,03,01,  Fulbhan,83,70,45,29,38,41,54.2,60.8,48.1,00000
38.0,74.0,21.0,040,04,01,  Angara,428,360,232,164,196,196,54.3,58.6,50.0,00000
38.0,74.0,21.0,062,01,01,  Atapur,694,547,371,252,323,295,55.9,59.6,52.3,00000
38.0,74.0,21.0,062,02,01,  Galakata,350,361,170,168,180,193,49.2,50.3,48.3,00000
38.0,74.0,21.0,412,01,01,  Fiphar Char,141,235,61,104,80,131,37.5,37.0,37.9,00000
38.0,74.0,21.0,412,02,01,  Hazrapur,406,123,210,52,196,71,76.7,80.2,73.4,00000
38.0,74.0,21.0,605,01,01,  Dhayaipur,274,173,154,76,120,97,61.3,67.0,55.3,00000
38.0,74.0,21.0,605,02,01,  Mahipur,882,717,521,334,361,383,55.2,60.9,48.5,00000
38.0,74.0,21.0,690,01,01,  Nilti Para,327,188,176,72,151,116,63.5,71.0,56.6,00000
38.0,74.0,21.0,690,02,01,  Nilti,226,135,114,69,112,66,62.6,62.3,62.9,00000
38.0,74.0,21.0,968,01,01,  Surjahpur,1012,455,582,178,430,277,69.0,76.6,60.8,00000
38.0,74.0,21.0,968,02,01,  Chak Para,198,296,104,153,94,143,40.1,40.5,39.7,00000
38.0,74.0,21.0,968,03,01,  Kaimari,176,137,101,71,75,66,56.2,58.7,53.2,00000
38.0,74.0,21.0,968,04,01,  Uchai,202,261,111,121,91,140,43.6,47.8,39.4,00000
38.0,74.0,31.0,488,01,01,  Lakshma,526,193,272,92,254,101,73.2,74.7,71.5,00000
38.0,74.0,31.0,488,02,01,  Satbaria,394,337,207,146,187,191,53.9,58.6,49.5,00000
38.0,74.0,31.0,488,03,01,  Kadubari,546,594,282,299,264,295,47.9,48.5,47.2,00000
38.0,74.0,31.0,488,04,01,  Nadyana,140,221,77,102,63,119,38.8,43.0,34.6,00000
38.0,74.0,31.0,488,05,01,  Karia,1388,1044,735,509,653,535,57.1,59.1,55.0,00000
38.0,74.0,42.0,900,01,01,  Sekta,958,504,526,196,432,308,65.5,72.9,58.4,00000
38.0,74.0,42.0,900,02,01,  Danga Para,454,346,239,160,215,186,56.8,59.9,53.6,00000
38.0,74.0,52.0,486,01,01,  Dargah Para,518,176,269,69,249,107,74.6,79.6,69.9,00000
38.0,74.0,52.0,486,02,01,  Bhagabanpur,162,57,88,29,74,28,74.0,75.2,72.5,00000
38.0,74.0,52.0,486,03,01,  Radhanagar,119,44,60,17,59,27,73.0,77.9,68.6,00000
38.0,74.0,73.0,358,01,01,  Kadam Pukur,132,106,75,48,57,58,55.5,61.0,49.6,00000
38.0,74.0,73.0,358,02,01,  Kata Pukur,228,272,112,121,116,151,45.6,48.1,43.4,00000
38.0,74.0,73.0,358,03,01,  Kashiabari,150,129,86,58,64,71,53.8,59.7,47.4,00000
38.0,74.0,73.0,358,04,01,  Joyhar,273,406,141,194,132,212,40.2,42.1,38.4,00000
38.0,74.0,73.0,358,05,01,  Abar Para,173,184,91,87,82,97,48.5,51.1,45.8,00000
38.0,74.0,73.0,358,06,01,  Math Para,337,376,192,174,145,202,47.3,52.5,41.8,00000
38.0,74.0,73.0,358,07,01,  Pirpal,407,350,230,153,177,197,53.8,60.1,47.3,00000
38.0,74.0,73.0,358,08,01,  Khamar Para,345,308,172,153,173,155,52.8,52.9,52.7,00000
38.0,74.0,73.0,358,09,01,  Sharar Para,317,278,158,130,159,148,53.3,54.9,51.8,00000
38.0,74.0,73.0,358,10,01,  Latpara,277,331,149,165,128,166,45.6,47.5,43.5,00000
13.0,22.0,76.0,068,01,01,  Ralasia,271,1648,152,831,119,817,14.1,15.5,12.7,00000
13.0,22.0,76.0,068,02,01,  Raher Char,39,416,25,200,14,216,8.6,11.1,6.1,00000
13.0,22.0,76.0,068,03,01,  Goalnagar,287,1066,159,526,128,540,21.2,23.2,19.2,00000
13.0,22.0,76.0,068,04,01,  Baliar Char,152,946,75,471,77,475,13.8,13.7,13.9,00000
13.0,22.0,90.0,624,01,01,  Lakshmipur,3243,3499,1596,1785,1647,1714,48.1,47.2,49.0,00000
13.0,22.0,90.0,624,02,01,  Kamalapur,951,1852,425,990,526,862,33.9,30.0,37.9,00000
13.0,22.0,90.0,624,03,01,  Sreerampur,1558,2026,693,1058,865,968,43.5,39.6,47.2,00000
13.0,45.0,71.0,545,01,01,  Uttar Karaitali,2053,832,910,401,1143,431,71.2,69.4,72.6,00000
13.0,45.0,71.0,545,02,01,  Dakshin Karaitali,671,519,287,245,384,274,56.4,53.9,58.4,00000
13.0,45.0,77.0,393,01,01,  Gabdergaon,1414,1255,616,577,798,678,53.0,51.6,54.1,00000
13.0,45.0,77.0,393,02,01,  Para Iabdergaon,1612,1172,690,549,922,623,57.9,55.7,59.7,00000
13.0,47.0,35.0,007,01,01,  Dakshin Bhairabi,541,180,279,63,262,117,75.0,81.6,69.1,00000
13.0,47.0,35.0,007,02,01,  U.Bhairabi Musalman Para,953,473,503,221,450,252,66.8,69.5,64.1,00000
13.0,47.0,35.0,007,03,01,  Uttar Bhairabi Nama Para,662,287,342,117,320,170,69.8,74.5,65.3,00000
13.0,47.0,35.0,007,04,01,  Chokdarkandi,104,247,61,124,43,123,29.6,33.0,25.9,00000
13.0,47.0,35.0,007,05,01,  Haldarkandi,233,374,113,190,120,184,38.4,37.3,39.5,00000
13.0,47.0,35.0,007,06,01,  Uttar Bagulakandi,945,763,497,390,448,373,55.3,56.0,54.6,00000
13.0,47.0,35.0,007,07,01,  Dakshin Bagulakandi,1207,689,608,335,599,354,63.7,64.5,62.9,00000
13.0,47.0,35.0,007,08,01,  Bagula Para,966,687,497,322,469,365,58.4,60.7,56.2,00000
13.0,47.0,35.0,007,09,01,  Jaliar Char(Pradhan)Kandi,1170,1960,611,980,559,980,37.4,38.4,36.3,00000
13.0,47.0,71.0,022,01,01,  Jabbar Mollakandi,79,232,44,115,35,117,25.4,27.7,23.0,00000
13.0,47.0,71.0,022,02,01,  Atabuddin Sikdar Kandi,105,258,61,129,44,129,28.9,32.1,25.4,00000
13.0,47.0,71.0,022,03,01,  Chokidar Kandi,167,126,97,72,70,54,57.0,57.4,56.5,00000
13.0,47.0,71.0,022,04,01,  Bapari Kandi,62,246,37,129,25,117,20.1,22.3,17.6,00000
13.0,47.0,71.0,022,05,01,  Dakshin Dira Kandi,127,241,68,134,59,107,34.5,33.7,35.5,00000
13.0,47.0,71.0,025,01,01,  Suruja Kamal(Malak)Sardarkandi,28,297,16,153,12,144,8.6,9.5,7.7,00000
13.0,47.0,71.0,025,02,01,  Teher/Kashim(Rahimsardar Kandi,152,705,82,353,70,352,17.7,18.9,16.6,00000
13.0,47.0,71.0,025,03,01,  Khalil(Khlak)Sardar Kandi,48,261,25,119,23,142,15.5,17.4,13.9,00000
13.0,47.0,71.0,030,01,01,  Kamal Sharder Kandi,141,177,61,75,80,102,44.3,44.9,44.0,00000
13.0,47.0,71.0,030,02,01,  Mannan Mal Kandi,233,486,125,232,108,254,32.4,35.0,29.8,00000
13.0,47.0,71.0,030,03,01,  Giashuddin Sikder Kandi,101,259,54,119,47,140,28.1,31.2,25.1,00000
13.0,47.0,71.0,065,01,01,  Sultan Mollarkandi,281,553,158,261,123,292,33.7,37.7,29.6,00000
13.0,47.0,71.0,065,02,01,  Hamid Mollarkandi,221,358,113,172,108,186,38.2,39.6,36.7,00000
13.0,47.0,71.0,065,03,01,  Sona Mia Bapari Kandi,93,254,46,133,47,121,26.8,25.7,28.0,00000
13.0,47.0,71.0,065,04,01,  Shabuddin Sharder,85,218,40,98,45,120,28.1,29.0,27.3,00000
13.0,47.0,71.0,065,05,01,  Ishanbala Bazar,104,230,55,126,49,104,31.1,30.4,32.0,00000
13.0,47.0,71.0,065,06,01,  Terashe Kandi,167,609,77,295,90,314,21.5,20.7,22.3,00000
13.0,47.0,71.0,065,07,01,  Kala Bepari Kandi,78,356,42,174,36,182,18.0,19.4,16.5,00000
13.0,47.0,71.0,065,08,01,  Habib Sardar Kandi,110,248,58,121,52,127,30.7,32.4,29.1,00000
13.0,47.0,71.0,085,01,01,  Ukil Kandi,137,191,76,95,61,96,41.8,44.4,38.9,00000
13.0,47.0,71.0,085,02,01,  Aliullah Bapari Kandi,75,193,47,104,28,89,28.0,31.1,23.9,00000
13.0,47.0,71.0,085,03,01,  Shazan Molla Kandi,142,172,71,86,71,86,45.2,45.2,45.2,00000
13.0,47.0,71.0,085,04,01,  Amo Haldar Kandi,92,271,45,133,47,138,25.3,25.3,25.4,00000
13.0,47.0,71.0,085,05,01,  Monsi Kandi,132,209,66,115,66,94,38.7,36.5,41.3,00000
13.0,47.0,71.0,085,06,01,  Topazal Sardar,145,203,69,114,76,89,41.7,37.7,46.1,00000
13.0,47.0,71.0,085,07,01,  Hasam Malar Kandi,149,245,85,123,64,122,37.8,40.9,34.4,00000
13.0,47.0,71.0,085,08,01,  Napal Kandi,87,208,42,106,45,102,29.5,28.4,30.6,00000
13.0,47.0,71.0,085,09,01,  Sikdar Kandi,61,263,32,126,29,137,18.8,20.3,17.5,00000
13.0,47.0,71.0,085,10,01,  Hazi Kandi,34,276,22,145,12,131,11.0,13.2,8.4,00000
13.0,47.0,71.0,085,11,01,  Ratan Hazi Kandi,72,256,36,128,36,128,22.0,22.0,22.0,00000
13.0,47.0,71.0,085,12,01,  Mazi Kandi,114,526,62,264,52,262,17.8,19.0,16.6,00000
13.0,47.0,71.0,085,13,01,  Sardar Kandi,110,263,59,131,51,132,29.5,31.1,27.9,00000
13.0,47.0,71.0,085,14,01,  Ali Hossani Kandi,139,240,76,121,63,119,36.7,38.6,34.6,00000
13.0,47.0,71.0,085,15,01,  Bapari Kandi,96,103,55,54,41,49,48.2,50.5,45.6,00000
13.0,47.0,71.0,085,16,01,  Pada(Chokidar)Kandi,208,501,127,230,81,271,29.3,35.6,23.0,00000
13.0,49.0,18.0,074,01,01,  Uttar Barkul,1081,308,536,126,545,182,77.8,81.0,75.0,00000
13.0,49.0,18.0,074,02,01,  Madhya Barkul,561,450,232,192,329,258,55.5,54.7,56.0,00000
13.0,49.0,18.0,074,03,01,  Dakshin Barkul,919,222,458,101,461,121,80.5,81.9,79.2,00000
13.0,49.0,18.0,074,04,01,  Mohanpur,308,19,158,7,150,12,94.2,95.8,92.6,00000
13.0,49.0,18.0,074,05,01,  Annatoli,854,428,415,199,439,229,66.6,67.6,65.7,00000
13.0,49.0,18.0,811,01,01,  Rasulpur,202,151,111,75,91,76,57.2,59.7,54.5,00000
13.0,49.0,18.0,811,02,01,  Nasirpur,198,132,88,64,110,68,60.0,57.9,61.8,00000
13.0,49.0,18.0,815,01,01,  Uttar Raicho,962,1008,445,473,517,535,48.8,48.5,49.1,00000
13.0,49.0,18.0,815,02,01,  Dakshin Raicho,895,798,436,396,459,402,52.9,52.4,53.3,00000
13.0,49.0,18.0,815,03,01,  Nobadda,481,309,231,144,250,165,60.9,61.6,60.2,00000
13.0,49.0,20.0,505,01,01,  Kurali,128,577,55,264,73,313,18.2,17.2,18.9,00000
13.0,49.0,20.0,505,02,01,  Gupalkhur,392,145,169,80,223,65,73.0,67.9,77.4,00000
13.0,49.0,25.0,277,01,01,  Maligaon,1063,1165,419,545,644,620,47.7,43.5,50.9,00000
13.0,49.0,25.0,277,02,01,  Gandharbapur,876,997,367,522,509,475,46.8,41.3,51.7,00000
13.0,49.0,25.0,277,03,01,  Shamuli Guchchhagram,15,143,8,66,7,77,9.5,10.8,8.3,00000
13.0,49.0,30.0,233,01,01,  Deshgaon,2062,1157,886,538,1176,619,64.1,62.2,65.5,00000
13.0,49.0,30.0,233,02,01,  Khagaria,673,241,309,97,364,144,73.6,76.1,71.7,00000
13.0,49.0,35.0,424,01,03,  Purba Kazirgaon,1311,639,599,298,712,341,67.2,66.8,67.6,00000
13.0,49.0,35.0,424,02,03,  Paschim Kazirgaon,499,185,230,90,269,95,73.0,71.9,73.9,00000
13.0,49.0,35.0,944,01,01,  Suilpur,1826,1072,857,520,969,552,63.0,62.2,63.7,00000
13.0,49.0,35.0,944,02,01,  Kasbaria,518,176,215,71,303,105,74.6,75.2,74.3,00000
13.0,49.0,35.0,944,03,01,  Shapur,266,112,133,56,133,56,70.4,70.4,70.4,00000
13.0,49.0,50.0,404,01,01,  Kapaikap,1034,702,546,362,488,340,59.6,60.1,58.9,00000
13.0,49.0,50.0,404,02,01,  Rabidas Para,356,55,152,27,204,28,86.6,84.9,87.9,00000
13.0,49.0,55.0,393,01,01,  Kalocho,1330,681,598,295,732,386,66.1,67.0,65.5,00000
13.0,49.0,55.0,393,02,01,  Mahamadpur,465,246,190,110,275,136,65.4,63.3,66.9,00000
13.0,49.0,55.0,652,01,01,  Nohata,1592,1304,637,640,955,664,55.0,49.9,59.0,00000
13.0,49.0,55.0,652,02,01,  Chandpur,870,575,444,287,426,288,60.2,60.7,59.7,00000
13.0,49.0,55.0,652,03,01,  Saksi Para,1137,788,444,363,693,425,59.1,55.0,62.0,00000
13.0,49.0,55.0,685,01,01,  Orpur,878,1209,372,557,506,652,42.1,40.0,43.7,00000
13.0,49.0,55.0,685,02,01,  Noapara,583,358,220,173,363,185,62.0,56.0,66.2,00000
13.0,49.0,60.0,417,01,01,  Kanthali,872,625,384,281,488,344,58.2,57.7,58.7,00000
13.0,49.0,60.0,417,02,01,  Sarasia,358,393,138,207,220,186,47.7,40.0,54.2,00000
13.0,49.0,60.0,719,01,01,  Patanis,2225,1298,1034,654,1191,644,63.2,61.3,64.9,00000
13.0,49.0,60.0,719,02,01,  Nischintapur,365,212,150,115,215,97,63.3,56.6,68.9,00000
13.0,49.0,65.0,088,01,01,  Rajapur,228,100,121,50,107,50,69.5,70.8,68.2,00000
13.0,49.0,65.0,088,02,01,  Belghar,2137,2141,930,1044,1207,1097,50.0,47.1,52.4,00000
13.0,49.0,65.0,332,01,01,  Hatila,3169,2015,1342,978,1827,1037,61.1,57.8,63.8,00000
13.0,49.0,65.0,332,02,01,  Ganganagar,325,159,152,80,173,79,67.1,65.5,68.7,00000
13.0,49.0,70.0,580,01,01,  Menapur,1242,615,491,299,751,316,66.9,62.2,70.4,00000
13.0,49.0,70.0,580,02,01,  Pepia,185,171,64,76,121,95,52.0,45.7,56.0,00000
13.0,49.0,70.0,590,01,01,  Mukundasar,1477,556,668,261,809,295,72.7,71.9,73.3,00000
13.0,49.0,70.0,590,02,01,  Singair,331,103,135,48,196,55,76.3,73.8,78.1,00000
13.0,49.0,70.0,590,03,01,  Kumarchar,213,172,100,78,113,94,55.3,56.2,54.6,00000
13.0,49.0,70.0,621,01,01,  Nasirkot,914,392,413,164,501,228,70.0,71.6,68.7,00000
13.0,49.0,70.0,621,02,01,  Char Riani,412,758,170,348,242,410,35.2,32.8,37.1,00000
13.0,49.0,70.0,787,01,01,  Purba Rajargaon,3446,2389,1497,1146,1949,1243,59.1,56.6,61.1,00000
13.0,49.0,70.0,787,02,01,  Paschim Rajargaon,3724,2610,1497,1270,2227,1340,58.8,54.1,62.4,00000
13.0,49.0,75.0,845,01,01,  Sanna,1814,967,819,473,995,494,65.2,63.4,66.8,00000
13.0,49.0,75.0,845,02,01,  Khola Para,554,399,266,207,288,192,58.1,56.2,60.0,00000
13.0,58.0,13.0,775,01,01,  Punsahi,2161,1770,924,863,1237,907,55.0,51.7,57.7,00000
13.0,58.0,13.0,775,02,01,  Junasar,466,315,199,138,267,177,59.7,59.1,60.1,00000
13.0,58.0,15.0,100,01,01,  Baichhara,1187,748,533,322,654,426,61.3,62.3,60.6,00000
13.0,58.0,15.0,100,02,01,  Laia Mohar,237,112,114,47,123,65,67.9,70.8,65.4,00000
13.0,58.0,15.0,100,03,01,  Pasdara,506,440,242,203,264,237,53.5,54.4,52.7,00000
13.0,58.0,15.0,100,04,01,  Nowapara,1055,481,498,227,557,254,68.7,68.7,68.7,00000
13.0,58.0,15.0,195,01,01,  Bitara,2255,2187,1123,986,1132,1201,50.8,53.2,48.5,00000
13.0,58.0,15.0,195,02,01,  Durgapur,951,1246,436,599,515,647,43.3,42.1,44.3,00000
13.0,58.0,15.0,195,03,01,  Jola Bitara,57,241,26,122,31,119,19.1,17.6,20.7,00000
13.0,58.0,15.0,207,01,01,  Budhanda,1065,1188,475,548,590,640,47.3,46.4,48.0,00000
13.0,58.0,15.0,207,02,01,  Mazigachha,2225,1466,1039,663,1186,803,60.3,61.0,59.6,00000
13.0,58.0,15.0,207,03,01,  Jugichapor,415,230,201,93,214,137,64.3,68.4,61.0,00000
13.0,58.0,15.0,207,04,01,  Changpur,389,643,189,313,200,330,37.7,37.6,37.7,00000
13.0,58.0,15.0,207,05,01,  Teguria,528,301,282,118,246,183,63.7,70.5,57.3,00000
13.0,58.0,15.0,207,06,01,  Saidpur,441,162,208,66,233,96,73.1,75.9,70.8,00000
13.0,58.0,15.0,207,07,01,  Batapukuria,35,207,16,101,19,106,14.5,13.7,15.2,00000
13.0,58.0,15.0,207,08,01,  Shajirpar,78,257,35,110,43,147,23.3,24.1,22.6,00000
13.0,58.0,15.0,207,09,01,  Chand Para,390,616,188,273,202,343,38.8,40.8,37.1,00000
13.0,58.0,15.0,207,10,01,  Haripur,488,404,232,167,256,237,54.7,58.1,51.9,00000
13.0,58.0,15.0,556,01,01,  Kundapur,274,233,136,107,138,126,54.0,56.0,52.3,00000
13.0,58.0,15.0,556,02,01,  Sorialkandi,232,288,138,117,94,171,44.6,54.1,35.5,00000
13.0,58.0,15.0,864,01,01,  Silastambha,995,675,439,323,556,352,59.6,57.6,61.2,00000
13.0,58.0,15.0,864,02,01,  Silastambha Tely,258,69,126,32,132,37,78.9,79.7,78.1,00000
13.0,58.0,39.0,645,01,01,  Nahara,689,877,308,408,381,469,44.0,43.0,44.8,00000
13.0,58.0,39.0,645,02,01,  Uttar Karaia,29,136,17,60,12,76,17.6,22.1,13.6,00000
13.0,58.0,39.0,645,03,01,  Latifpur,62,311,25,157,37,154,16.6,13.7,19.4,00000
13.0,58.0,39.0,935,01,01,  Tetaia,2847,2841,1222,1353,1625,1488,50.1,47.5,52.2,00000
13.0,58.0,39.0,935,02,01,  Jala Tetaia,241,659,113,293,128,366,26.8,27.8,25.9,00000
13.0,58.0,47.0,029,01,01,  Akania,1004,1168,445,570,559,598,46.2,43.8,48.3,00000
13.0,58.0,47.0,029,02,01,  Rasulpur,41,82,16,44,25,38,33.3,26.7,39.7,00000
13.0,58.0,55.0,082,01,01,  Ayma,420,215,213,95,207,120,66.1,69.2,63.3,00000
13.0,58.0,55.0,082,02,01,  Sasankhola,1011,407,407,180,604,227,71.3,69.3,72.7,00000
13.0,58.0,55.0,082,03,01,  Tegharia,400,47,196,23,204,24,89.5,89.5,89.5,00000
13.0,58.0,55.0,136,01,01,  Baraigaon,432,265,188,113,244,152,62.0,62.5,61.6,00000
13.0,58.0,55.0,136,02,01,  Sahapur,113,100,54,46,59,54,53.1,54.0,52.2,00000
13.0,58.0,55.0,615,01,01,  Manpur,2767,1655,1220,815,1547,840,62.6,60.0,64.8,00000
13.0,58.0,55.0,615,02,01,  Nayakandi,280,197,146,90,134,107,58.7,61.9,55.6,00000
13.0,58.0,55.0,615,03,01,  Sakhipura,144,164,64,83,80,81,46.8,43.5,49.7,00000
13.0,58.0,55.0,615,04,01,  Bhatabaria,296,113,138,48,158,65,72.4,74.2,70.9,00000
13.0,58.0,63.0,035,01,01,  Akania,1787,1524,811,775,976,749,54.0,51.1,56.6,00000
13.0,58.0,63.0,035,02,01,  Nairpur,678,384,285,177,393,207,63.8,61.7,65.5,00000
13.0,58.0,71.0,171,01,01,  Bayek,715,501,358,220,357,281,58.8,61.9,56.0,00000
13.0,58.0,71.0,171,02,01,  Joynagar,783,1043,392,513,391,530,42.9,43.3,42.5,00000
13.0,58.0,71.0,787,01,01,  Ragdail,1425,1784,658,771,767,1013,44.4,46.0,43.1,00000
13.0,58.0,71.0,787,02,01,  Bazarikhola,888,1019,388,466,500,553,46.6,45.4,47.5,00000
13.0,58.0,71.0,787,03,01,  Gograbari,89,146,50,72,39,74,37.9,41.0,34.5,00000
13.0,58.0,71.0,811,01,01,  Sachar,924,898,493,447,431,451,50.7,52.4,48.9,00000
13.0,58.0,71.0,811,02,01,  Kandirpar,179,299,104,135,75,164,37.4,43.5,31.4,00000
13.0,58.0,71.0,811,03,01,  Nayakandi,360,469,164,217,196,252,43.4,43.0,43.8,00000
13.0,58.0,71.0,811,04,01,  Rajarampur,156,428,64,213,92,215,26.7,23.1,30.0,00000
13.0,58.0,71.0,811,05,01,  Kalakopa,268,209,143,90,125,119,56.2,61.4,51.2,00000
13.0,58.0,71.0,811,06,01,  Maithar Dighirpar,116,181,62,90,54,91,39.1,40.8,37.2,00000
13.0,58.0,71.0,811,07,01,  Chowdhury Dighirpar,296,276,159,136,137,140,51.7,53.9,49.5,00000
13.0,58.0,71.0,811,08,01,  Hatirbandh,506,962,239,459,267,503,34.5,34.2,34.7,00000
13.0,58.0,71.0,811,09,01,  Ramer Dighirpar,106,350,61,164,45,186,23.2,27.1,19.5,00000
13.0,58.0,71.0,811,10,01,  Gupir Pukurpar,93,122,46,47,47,75,43.3,49.5,38.5,00000
13.0,58.0,71.0,811,11,01,  Jamaddarer Pukurpar,235,81,127,30,108,51,74.4,80.9,67.9,00000
13.0,58.0,71.0,811,12,01,  Poddarer Pukurpar,42,93,27,44,15,49,31.1,38.0,23.4,00000
13.0,58.0,71.0,811,13,01,  Sachar Bazar,383,239,225,119,158,120,61.6,65.4,56.8,00000
13.0,58.0,71.0,912,01,01,  Surail,1371,1646,671,784,700,862,45.4,46.1,44.8,00000
13.0,58.0,71.0,912,02,01,  Chalakanda,158,254,76,117,82,137,38.3,39.4,37.4,00000
13.0,58.0,71.0,912,03,01,  Mongalmura,134,111,63,50,71,61,54.7,55.8,53.8,00000
13.0,58.0,71.0,912,04,01,  Nayakandi (Part),319,212,154,84,165,128,60.1,64.7,56.3,00000
13.0,58.0,79.0,011,01,01,  Atomor,1127,1019,520,458,607,561,52.5,53.2,52.0,00000
13.0,58.0,79.0,011,02,01,  Burburia,54,87,23,45,31,42,38.3,33.8,42.5,00000
13.0,58.0,79.0,130,01,01,  Baraiara,1194,1302,556,660,638,642,47.8,45.7,49.8,00000
13.0,58.0,79.0,130,02,01,  Hatmura,207,254,100,115,107,139,44.9,46.5,43.5,00000
13.0,58.0,79.0,148,01,01,  Bardail,1459,1445,647,647,812,798,50.2,50.0,50.4,00000
13.0,58.0,79.0,148,02,01,  Ramdebpur,77,111,35,48,42,63,41.0,42.2,40.0,00000
13.0,58.0,79.0,148,03,01,  Ujjalpur,64,79,35,34,29,45,44.8,50.7,39.2,00000
13.0,58.0,79.0,183,01,01,  Bhati Chinaia,384,55,198,19,186,36,87.5,91.2,83.8,00000
13.0,58.0,79.0,183,02,01,  Darikandi,77,66,31,31,46,35,53.8,50.0,56.8,00000
13.0,58.0,79.0,604,01,01,  Maligaon,290,1015,135,481,155,534,22.2,21.9,22.5,00000
13.0,58.0,79.0,604,02,01,  Madhupur,51,190,27,100,24,90,21.2,21.3,21.1,00000
13.0,58.0,79.0,758,01,01,  Pathair,1078,557,534,248,544,309,65.9,68.3,63.8,00000
13.0,58.0,79.0,758,02,01,  Bhagulia Para,110,64,53,33,57,31,63.2,61.6,64.8,00000
13.0,58.0,79.0,758,03,01,  Barakota,792,858,366,429,426,429,48.0,46.0,49.8,00000
13.0,58.0,79.0,829,01,01,  Tarini,191,207,76,105,115,102,48.0,42.0,53.0,00000
13.0,58.0,79.0,829,02,01,  Gobarkhola,390,435,174,214,216,221,47.3,44.8,49.4,00000
13.0,58.0,87.0,023,01,01,  Ainpur,266,713,109,319,157,394,27.2,25.5,28.5,00000
13.0,58.0,87.0,023,02,01,  Haolakandi,100,154,53,70,47,84,39.4,43.1,35.9,00000
13.0,58.0,87.0,023,03,01,  Shankarpur,274,574,105,263,169,311,32.3,28.5,35.2,00000
13.0,58.0,87.0,065,01,01,  Asharkota,275,442,127,195,148,247,38.4,39.4,37.5,00000
13.0,58.0,87.0,065,02,01,  Uttar Nayakandi,74,94,31,39,43,55,44.0,44.3,43.9,00000
13.0,58.0,87.0,189,01,01,  Bhuiara,620,972,302,451,318,521,38.9,40.1,37.9,00000
13.0,58.0,87.0,189,02,01,  Hatpukuria,232,454,120,179,112,275,33.8,40.1,28.9,00000
13.0,58.0,87.0,189,03,01,  Dakshin Nayakandi,69,183,30,97,39,86,27.4,23.6,31.2,00000
13.0,58.0,87.0,313,01,01,  Doati,1080,1307,549,575,531,732,45.2,48.8,42.0,00000
13.0,58.0,87.0,313,02,01,  Tilakiabhta,199,266,109,107,90,159,42.8,50.5,36.1,00000
13.0,58.0,87.0,337,01,01,  Enayetpur,403,542,172,242,231,300,42.6,41.5,43.5,00000
13.0,58.0,87.0,337,02,01,  Dojana,153,321,70,132,83,189,32.3,34.7,30.5,00000
13.0,58.0,87.0,734,01,01,  Palakhal,1659,1871,782,898,877,973,47.0,46.5,47.4,00000
13.0,58.0,87.0,734,02,01,  Dahulia,255,420,124,205,131,215,37.8,37.7,37.9,00000
13.0,58.0,94.0,047,01,01,  Aliara,683,1125,334,478,349,647,37.8,41.1,35.0,00000
13.0,58.0,94.0,047,02,01,  Tarabaria,258,323,127,127,131,196,44.4,50.0,40.1,00000
13.0,58.0,94.0,047,03,01,  Kanthalia,56,219,26,111,30,108,20.4,19.0,21.7,00000
13.0,58.0,94.0,047,04,01,  Jagir,90,101,51,44,39,57,47.1,53.7,40.6,00000
13.0,58.0,94.0,473,01,01,  Kandi Roypur,48,12,24,4,24,8,80.0,85.7,75.0,00000
13.0,58.0,94.0,473,02,01,  Nayakandi,48,29,24,14,24,15,62.3,63.2,61.5,00000
13.0,58.0,94.0,769,01,01,  Prasannakap,1571,1170,709,475,862,695,57.3,59.9,55.4,00000
13.0,58.0,94.0,769,02,01,  Kandirpar,391,619,192,275,199,344,38.7,41.1,36.6,00000
13.0,58.0,94.0,769,03,01,  Bagmara,64,145,32,63,32,82,30.6,33.7,28.1,00000
13.0,58.0,94.0,870,01,01,  Singua,1515,1718,771,786,744,932,46.9,49.5,44.4,00000
13.0,58.0,94.0,870,02,01,  Kadirkhil,397,271,196,104,201,167,59.4,65.3,54.6,00000
13.0,58.0,94.0,870,03,01,  Malchoa,379,413,210,172,169,241,47.9,55.0,41.2,00000
13.0,58.0,94.0,959,01,01,  Tulpai,1876,1498,802,689,1074,809,55.6,53.8,57.0,00000
13.0,58.0,94.0,959,02,01,  Fatehpur,932,622,437,299,495,323,60.0,59.4,60.5,00000
13.0,58.0,94.0,959,03,01,  Nangla,229,169,110,63,119,106,57.5,63.6,52.9,00000
13.0,58.0,94.0,959,04,01,  Saidapur,705,1165,326,546,379,619,37.7,37.4,38.0,00000
13.0,76.0,34.0,707,01,01,  Mirama,140,227,63,106,77,121,38.1,37.3,38.9,00000
13.0,76.0,34.0,707,02,01,  Nagdah,1836,1567,780,667,1056,900,54.0,53.9,54.0,00000
13.0,76.0,56.0,530,01,01,  Bakchar,529,400,257,179,272,221,56.9,58.9,55.2,00000
13.0,76.0,56.0,530,02,01,  Sholadana,163,50,79,23,84,27,76.5,77.5,75.7,00000
13.0,76.0,56.0,530,03,01,  Khidirpur,348,205,170,91,178,114,62.9,65.1,61.0,00000
13.0,76.0,56.0,530,04,01,  Biswaspur,233,89,122,34,111,55,72.4,78.2,66.9,00000
13.0,76.0,56.0,530,05,01,  Nandikhola,1158,726,593,305,565,421,61.5,66.0,57.3,00000
13.0,76.0,56.0,530,06,01,  Daserband,282,192,142,92,140,100,59.5,60.7,58.3,00000
13.0,76.0,56.0,530,07,01,  Kachiara,395,260,225,112,170,148,60.3,66.8,53.5,00000
13.0,76.0,56.0,809,01,01,  Masunda,478,172,215,84,263,88,73.5,71.9,74.9,00000
13.0,76.0,56.0,809,02,01,  Pearikhola,763,893,376,397,387,496,46.1,48.6,43.8,00000
13.0,76.0,56.0,809,03,01,  Naoujan,639,547,329,233,310,314,53.9,58.5,49.7,00000
13.0,76.0,56.0,809,04,01,  Uttar Baragaon,629,422,294,171,335,251,59.8,63.2,57.2,00000
13.0,76.0,56.0,809,05,01,  Dakshin Baragaon,1210,721,563,309,647,412,62.7,64.6,61.1,00000
13.0,76.0,56.0,809,06,01,  Lak,358,183,164,86,194,97,66.2,65.6,66.7,00000
13.0,76.0,56.0,809,07,01,  Panchdona,272,274,127,124,145,150,49.8,50.6,49.2,00000
13.0,76.0,60.0,057,01,01,  Bahari,1993,1902,793,848,1200,1054,51.2,48.3,53.2,00000
13.0,76.0,60.0,057,02,01,  Legakandi,548,469,216,197,332,272,53.9,52.3,55.0,00000
13.0,76.0,60.0,731,01,01,  Naogaon,2784,1260,1259,528,1525,732,68.8,70.5,67.6,00000
13.0,76.0,60.0,731,02,01,  Panchak Para,280,119,136,58,144,61,70.2,70.1,70.2,00000
13.0,76.0,82.0,041,01,01,  Aswinpur,1622,936,747,415,875,521,63.4,64.3,62.7,00000
13.0,76.0,82.0,041,02,01,  Uttar Nayergaon,591,941,305,433,286,508,38.6,41.3,36.0,00000
13.0,76.0,82.0,041,03,01,  Patan,860,1017,446,440,414,577,45.8,50.3,41.8,00000
13.0,76.0,82.0,041,04,01,  Char Nayergaon,8,171,5,92,3,79,4.5,5.2,3.7,00000
13.0,76.0,82.0,041,05,01,  Nayergaon Bazar,422,406,266,239,156,167,51.0,52.7,48.3,00000
13.0,76.0,82.0,534,01,01,  Kaziara,1036,1057,461,496,575,561,49.5,48.2,50.6,00000
13.0,76.0,82.0,534,02,01,  Meharun,1280,1194,697,524,583,670,51.7,57.1,46.5,00000
13.0,79.0,11.0,160,01,01,  Chhota Kena Chak,628,309,331,125,297,184,67.0,72.6,61.7,00000
13.0,79.0,11.0,160,02,01,  Bara Kena Chak,505,322,260,140,245,182,61.1,65.0,57.4,00000
13.0,79.0,11.0,353,01,01,  Khandakarkandi,362,207,213,105,149,102,63.6,67.0,59.4,00000
13.0,79.0,11.0,353,02,01,  Ichakhali,597,527,285,236,312,291,53.1,54.7,51.7,00000
13.0,79.0,11.0,415,01,01,  Galimkhan,769,625,351,294,418,331,55.2,54.4,55.8,00000
13.0,79.0,11.0,415,02,01,  Barurkandi,422,392,191,174,231,218,51.8,52.3,51.4,00000
13.0,79.0,11.0,653,01,01,  Royerkandi,1566,1272,759,611,807,661,55.2,55.4,55.0,00000
13.0,79.0,11.0,653,02,01,  Nayakandi,429,308,211,140,218,168,58.2,60.1,56.5,00000
13.0,79.0,11.0,875,01,01,  Santoshpur,33,59,9,27,24,32,35.9,25.0,42.9,00000
13.0,79.0,11.0,875,02,01,  Dhanagoda,312,226,168,96,144,130,58.0,63.6,52.6,00000
13.0,79.0,11.0,875,03,01,  Baluakandi,138,326,67,144,71,182,29.7,31.8,28.1,00000
13.0,79.0,11.0,875,04,01,  Taltali,563,509,261,219,302,290,52.5,54.4,51.0,00000
13.0,79.0,11.0,875,05,01,  Dakshin Mandertali,415,593,180,274,235,319,41.2,39.6,42.4,00000
13.0,79.0,11.0,875,06,01,  Uttar Mandertali,173,276,77,138,96,138,38.5,35.8,41.0,00000
13.0,79.0,13.0,086,01,01,  Uttar Sardarkandi,375,908,160,407,215,501,29.2,28.2,30.0,00000
13.0,79.0,13.0,086,02,01,  Dakshin Sardarkandi,587,818,243,356,344,462,41.8,40.6,42.7,00000
13.0,79.0,13.0,086,03,01,  Namakandi,127,145,53,67,74,78,46.7,44.2,48.7,00000
13.0,79.0,13.0,086,04,01,  Maizkandi,477,522,174,234,303,288,47.7,42.6,51.3,00000
13.0,79.0,13.0,086,05,01,  Hajipur,625,790,275,354,350,436,44.2,43.7,44.5,00000
13.0,79.0,13.0,086,06,01,  Shakhari Para,331,295,118,132,213,163,52.9,47.2,56.6,00000
13.0,79.0,13.0,086,07,01,  Nayakandi,266,210,117,86,149,124,55.9,57.6,54.6,00000
13.0,79.0,13.0,086,08,01,  Tafadar Para,288,212,136,96,152,116,57.6,58.6,56.7,00000
13.0,79.0,13.0,086,09,01,  Uttar Rampur,242,249,109,109,133,140,49.3,50.0,48.7,00000
13.0,79.0,13.0,086,10,01,  Mirpur,118,214,59,101,59,113,35.5,36.9,34.3,00000
13.0,79.0,13.0,086,11,01,  Thakur Para,279,327,136,149,143,178,46.0,47.7,44.5,00000
13.0,79.0,13.0,086,12,01,  Farajikandi,693,659,360,386,333,273,51.3,48.3,55.0,00000
13.0,79.0,13.0,086,13,01,  Sarkar Para,225,233,103,90,122,143,49.1,53.4,46.0,00000
13.0,79.0,13.0,086,14,01,  Sonar Para,306,296,115,136,191,160,50.8,45.8,54.4,00000
13.0,79.0,13.0,086,15,01,  Balu Char,709,831,341,409,368,422,46.0,45.5,46.6,00000
13.0,79.0,13.0,086,16,01,  Sekhnagar,96,158,39,77,57,81,37.8,33.6,41.3,00000
13.0,79.0,13.0,238,01,01,  Uttar Char Machhua,351,356,167,138,184,218,49.6,54.8,45.8,00000
13.0,79.0,13.0,238,02,01,  Dakshin Char Machhua,476,685,199,317,277,368,41.0,38.6,42.9,00000
13.0,79.0,13.0,300,01,01,  Ramnathganj,97,211,69,114,28,97,31.5,37.7,22.4,00000
13.0,79.0,13.0,300,02,01,  Kacharikandi,185,206,86,86,99,120,47.3,50.0,45.2,00000
13.0,79.0,13.0,300,03,01,  Dakshin Rampur,893,1203,403,563,490,640,42.6,41.7,43.4,00000
13.0,79.0,13.0,300,04,01,  Uttar Induria,142,160,67,72,75,88,47.0,48.2,46.0,00000
13.0,79.0,13.0,300,05,01,  Muktipalli,78,421,21,207,57,214,15.6,9.2,21.0,00000
13.0,79.0,13.0,472,01,01,  Bara Haldia,1471,1147,638,512,833,635,56.2,55.5,56.7,00000
13.0,79.0,13.0,472,02,01,  Chhota Haldia,1211,1260,574,555,637,705,49.0,50.8,47.5,00000
13.0,79.0,13.0,834,01,01,  Ramdaspur,483,491,216,201,267,290,49.6,51.8,47.9,00000
13.0,79.0,13.0,834,02,01,  Islamia Market,249,118,193,77,56,41,67.8,71.5,57.7,00000
13.0,79.0,13.0,834,03,01,  Aminpur,839,635,389,253,450,382,56.9,60.6,54.1,00000
13.0,79.0,13.0,834,04,01,  Nishankhola,205,281,87,115,118,166,42.2,43.1,41.5,00000
13.0,79.0,15.0,037,01,01,  Paschim Anwarpur,417,418,188,173,229,245,49.9,52.1,48.3,00000
13.0,79.0,15.0,037,02,01,  Purba Anwarpur,98,206,44,93,54,113,32.2,32.1,32.3,00000
13.0,79.0,15.0,090,01,01,  Banikyakandi,181,193,78,88,103,105,48.4,47.0,49.5,00000
13.0,79.0,15.0,090,02,01,  Majumdarkandi,237,433,125,185,112,248,35.4,40.3,31.1,00000
13.0,79.0,15.0,090,03,01,  Chowmohani,146,174,67,76,79,98,45.6,46.9,44.6,00000
13.0,79.0,15.0,090,04,01,  Hizlakandi,197,362,97,177,100,185,35.2,35.4,35.1,00000
13.0,79.0,15.0,090,05,01,  Rishikandi,50,742,40,472,10,270,6.3,7.8,3.6,00000
13.0,79.0,15.0,090,06,01,  Bara Durgapur,802,706,353,303,449,403,53.2,53.8,52.7,00000
13.0,79.0,15.0,090,07,01,  Khalpur Durgapur,162,242,73,104,89,138,40.1,41.2,39.2,00000
13.0,79.0,15.0,090,08,01,  Satbariakandi,262,212,132,90,130,122,55.3,59.5,51.6,00000
13.0,79.0,15.0,156,01,01,  Brahman Chak,554,271,260,134,294,137,67.2,66.0,68.2,00000
13.0,79.0,15.0,156,02,01,  Pathan Chak,148,115,67,51,81,64,56.3,56.8,55.9,00000
13.0,79.0,15.0,304,01,01,  Chhota Durgapur,119,214,54,103,65,111,35.7,34.4,36.9,00000
13.0,79.0,15.0,304,02,01,  Bhitikandi,86,92,46,42,40,50,48.3,52.3,44.4,00000
13.0,79.0,15.0,645,01,01,  Momrezkandi,559,635,265,264,294,371,46.8,50.1,44.2,00000
13.0,79.0,15.0,645,02,01,  Kasimnagar,137,86,62,36,75,50,61.4,63.3,60.0,00000
13.0,79.0,15.0,694,01,01,  Uttar Nabairkandi,332,127,159,43,173,84,72.3,78.7,67.3,00000
13.0,79.0,15.0,694,02,01,  Dakshin Nabairkandi,404,475,168,210,236,265,46.0,44.4,47.1,00000
13.0,79.0,15.0,694,03,01,  Bhaigar Char,205,113,86,59,119,54,64.5,59.3,68.8,00000
13.0,79.0,15.0,777,01,01,  Nischintapur,870,724,407,321,463,403,54.6,55.9,53.5,00000
13.0,79.0,15.0,777,02,01,  Harina,290,324,117,137,173,187,47.2,46.1,48.1,00000
13.0,79.0,17.0,390,01,01,  Sipaikandi,522,450,235,185,287,265,53.7,56.0,52.0,00000
13.0,79.0,17.0,390,02,01,  Maizkandi,181,158,76,63,105,95,53.4,54.7,52.5,00000
13.0,79.0,17.0,390,03,01,  Char Harigop,252,242,137,108,115,134,51.0,55.9,46.2,00000
13.0,79.0,17.0,390,04,01,  Enayetnagar,507,276,245,119,262,157,64.8,67.3,62.5,00000
13.0,79.0,17.0,390,05,01,  Bara Hatia,282,188,137,89,145,99,60.0,60.6,59.4,00000
13.0,79.0,17.0,398,01,01,  Uttar Fatehpur,544,460,259,197,285,263,54.2,56.8,52.0,00000
13.0,79.0,17.0,398,02,01,  Dakshin Fatehpur,774,701,363,321,411,380,52.5,53.1,52.0,00000
13.0,79.0,17.0,633,01,01,  Uttar Ludhua,1359,1158,607,509,752,649,54.0,54.4,53.7,00000
13.0,79.0,17.0,633,02,01,  Dakshin Ludhua,1397,826,622,366,775,460,62.8,63.0,62.8,00000
13.0,79.0,17.0,966,01,01,  Uttar Thetalia,847,374,409,177,438,197,69.4,69.8,69.0,00000
13.0,79.0,17.0,966,02,01,  Dakshin Thetalia,437,443,185,232,252,211,49.7,44.4,54.4,00000
13.0,79.0,23.0,411,01,01,  Gajra,477,257,259,122,218,135,65.0,68.0,61.8,00000
13.0,79.0,23.0,411,02,01,  Sadardia,188,226,117,99,71,127,45.4,54.2,35.9,00000
13.0,79.0,23.0,641,01,01,  Maisadi,438,304,246,145,192,159,59.0,62.9,54.7,00000
13.0,79.0,23.0,641,02,01,  Kashimnagar,186,132,85,69,101,63,58.5,55.2,61.6,00000
13.0,79.0,23.0,846,01,01,  Purba Royerdia,280,386,161,188,119,198,42.0,46.1,37.5,00000
13.0,79.0,23.0,846,02,01,  Paschim Royerdia,333,651,189,313,144,338,33.8,37.6,29.9,00000
13.0,79.0,23.0,949,01,01,  Tarkikanda,504,349,269,171,235,178,59.1,61.1,56.9,00000
13.0,79.0,23.0,949,02,01,  Amuakanda,513,192,279,80,234,112,72.8,77.7,67.6,00000
13.0,79.0,23.0,949,03,01,  Naza Mohammederkanda,136,57,70,26,66,31,70.5,72.9,68.0,00000
13.0,79.0,25.0,505,01,01,  Roypur Islamabad,781,596,379,256,402,340,56.7,59.7,54.2,00000
13.0,79.0,25.0,505,02,01,  Paschim Islamabad,341,149,165,59,176,90,69.6,73.7,66.2,00000
13.0,79.0,25.0,505,03,01,  Madhya Islamabad,439,543,227,236,212,307,44.7,49.0,40.8,00000
13.0,79.0,25.0,505,04,01,  Purba Islamabad,755,831,332,369,423,462,47.6,47.4,47.8,00000
13.0,79.0,25.0,719,01,01,  Nandalalpur,512,666,245,293,267,373,43.5,45.5,41.7,00000
13.0,79.0,25.0,719,02,01,  Nandalalpur Bazar,21,6,14,1,7,5,77.8,93.3,58.3,00000
13.0,79.0,25.0,719,03,01,  Titarkandi,701,1030,379,485,322,545,40.5,43.9,37.1,00000
13.0,79.0,25.0,900,01,01,  Shibpur,126,240,60,103,66,137,34.4,36.8,32.5,00000
13.0,79.0,25.0,900,02,01,  Char Shibpur,119,215,54,95,65,120,35.6,36.2,35.1,00000
13.0,79.0,30.0,764,01,01,  Nedamdi,1190,824,580,379,610,445,59.1,60.5,57.8,00000
13.0,79.0,30.0,764,02,01,  Nedamdi Matha Bhanga,651,431,308,202,343,229,60.2,60.4,60.0,00000
13.0,79.0,32.0,772,01,01,  Uttardasani,616,466,304,218,312,248,56.9,58.2,55.7,00000
13.0,79.0,32.0,772,02,01,  Dakshin Dashani,611,474,323,231,288,243,56.3,58.3,54.2,00000
13.0,79.0,32.0,772,03,01,  Madday Dashani,473,310,255,144,218,166,60.4,63.9,56.8,00000
13.0,79.0,32.0,772,04,01,  Purba Hanirpar,910,508,474,214,436,294,64.2,68.9,59.7,00000
13.0,79.0,32.0,772,05,01,  Paschim Hanirpar,500,525,255,268,245,257,48.8,48.8,48.8,00000
13.0,79.0,32.0,772,06,01,  Uttar Milarchar,846,347,440,153,406,194,70.9,74.2,67.7,00000
13.0,79.0,32.0,772,07,01,  Dakshin Milarchar,491,252,237,103,254,149,66.1,69.7,63.0,00000
13.0,79.0,38.0,016,01,01,  Aithadi (Mathabhanga),1608,585,843,264,765,321,73.3,76.2,70.4,00000
13.0,79.0,38.0,016,02,01,  Kamaldi (Mathabhanga),924,1004,450,488,474,516,47.9,48.0,47.9,00000
13.0,79.0,38.0,016,03,01,  Panchani,1104,623,510,301,594,322,63.9,62.9,64.8,00000
13.0,79.0,38.0,016,04,01,  Dewankandi,158,136,72,65,86,71,53.7,52.6,54.8,00000
13.0,79.0,38.0,678,01,01,  Mohanpur (P.U.River),1027,718,555,366,472,352,58.9,60.3,57.3,00000
13.0,79.0,38.0,678,02,01,  Mohammadpur (P.U.River),1131,551,609,249,522,302,67.2,71.0,63.3,00000
13.0,79.0,38.0,678,03,01,  Fatuakandi,557,531,286,242,271,289,51.2,54.2,48.4,00000
13.0,79.0,38.0,678,04,01,  Kumarkhola,702,295,364,137,338,158,70.4,72.7,68.1,00000
13.0,79.0,38.0,678,05,01,  Mudafar,1096,543,541,242,555,301,66.9,69.1,64.8,00000
13.0,79.0,64.0,045,01,01,  Mollakandi,767,661,369,300,398,361,53.7,55.2,52.4,00000
13.0,79.0,64.0,045,02,01,  Beltali,87,153,56,89,31,64,36.3,38.6,32.6,00000
13.0,79.0,64.0,045,03,01,  Badarpur,700,409,361,183,339,226,63.1,66.4,60.0,00000
13.0,79.0,64.0,045,04,01,  Nayakandi,131,136,67,65,64,71,49.1,50.8,47.4,00000
13.0,79.0,64.0,045,05,01,  Gopalkandi(North),233,274,98,136,135,138,46.0,41.9,49.5,00000
13.0,79.0,64.0,168,01,01,  Chandarkandi,652,629,308,301,344,328,50.9,50.6,51.2,00000
13.0,79.0,64.0,168,02,01,  Purba Putiyarpar,313,238,177,112,136,126,56.8,61.2,51.9,00000
13.0,79.0,64.0,168,03,01,  Paschim Putiyarpar,471,360,230,164,241,196,56.7,58.4,55.1,00000
13.0,79.0,64.0,168,04,01,  Shosairkandi,200,199,88,92,112,107,50.1,48.9,51.1,00000
13.0,79.0,64.0,559,01,01,  Paduarpar,149,218,65,95,84,123,40.6,40.6,40.6,00000
13.0,79.0,64.0,559,02,01,  Gazir Gachhkhola,319,102,176,47,143,55,75.8,78.9,72.2,00000
13.0,79.0,64.0,559,03,01,  Shyamnagar,317,310,132,150,185,160,50.6,46.8,53.6,00000
13.0,79.0,64.0,559,04,01,  Kumardone,232,5,110,1,122,4,97.9,99.1,96.8,00000
13.0,79.0,64.0,559,05,01,  Pathan Bazar,15,9,8,6,7,3,62.5,57.1,70.0,00000
13.0,79.0,64.0,682,01,01,  Uttar Moktirkandi,981,767,472,312,509,455,56.1,60.2,52.8,00000
13.0,79.0,64.0,682,02,01,  Dakshin Muktarkandi,413,194,189,84,224,110,68.0,69.2,67.1,00000
13.0,79.0,64.0,682,03,01,  Jamalpur,449,413,211,178,238,235,52.1,54.2,50.3,00000
13.0,79.0,64.0,851,01,01,  Sadullapur,1156,587,554,241,602,346,66.3,69.7,63.5,00000
13.0,79.0,64.0,851,02,01,  Failakata,178,108,102,51,76,57,62.2,66.7,57.1,00000
13.0,79.0,64.0,851,03,01,  Andhar Manik,29,18,15,9,14,9,61.7,62.5,60.9,00000
13.0,79.0,73.0,620,01,01,  Kalipurgram,595,398,311,221,284,177,59.9,58.5,61.6,00000
13.0,79.0,73.0,620,02,01,  Madday Kalipur,547,303,285,132,262,171,64.4,68.3,60.5,00000
13.0,79.0,73.0,620,03,01,  Imampur,611,624,317,292,294,332,49.5,52.1,47.0,00000
13.0,79.0,73.0,620,04,01,  Purba Lalpur,1023,360,533,158,490,202,74.0,77.1,70.8,00000
13.0,79.0,73.0,620,05,01,  Baribhanga,633,565,359,296,274,269,52.8,54.8,50.5,00000
13.0,79.0,73.0,620,06,01,  Paschim Lalpur,700,440,346,200,354,240,61.4,63.4,59.6,00000
13.0,79.0,73.0,896,01,01,  Malopara,160,714,85,370,75,344,18.3,18.7,17.9,00000
13.0,79.0,73.0,896,02,01,  Satnal Bazar,59,28,59,27,0,1,67.8,68.6,0.0,00000
13.0,79.0,73.0,896,03,01,  Meherullah Pradhanerkandi,333,249,157,126,176,123,57.2,55.5,58.9,00000
13.0,79.0,73.0,896,04,01,  Ashan Ali Pradhanerkandi,351,239,207,115,144,124,59.5,64.3,53.7,00000
13.0,79.0,73.0,896,05,01,  Rangu Kharkandi,488,410,261,206,227,204,54.3,55.9,52.7,00000
13.0,79.0,73.0,896,06,01,  Kandu Sarkarkandi,550,320,284,165,266,155,63.2,63.3,63.2,00000
13.0,79.0,73.0,896,07,01,  Bara Satnal,2152,1330,1218,593,934,737,61.8,67.3,55.9,00000
13.0,79.0,90.0,094,01,01,  Bara Lakshmipur,374,198,168,88,206,110,65.4,65.6,65.2,00000
13.0,79.0,90.0,094,02,01,  Binandapur,331,327,137,135,194,192,50.3,50.4,50.3,00000
13.0,79.0,90.0,126,01,01,  Dakshin Islamabad,189,201,92,85,97,116,48.5,52.0,45.5,00000
13.0,79.0,90.0,126,02,01,  Jamal Pradankandi,117,77,54,27,63,50,60.3,66.7,55.8,00000
13.0,79.0,90.0,126,03,01,  Majlispur,172,154,81,67,91,87,52.8,54.7,51.1,00000
13.0,79.0,90.0,263,01,01,  Char Pathalia,304,188,154,65,150,123,61.8,70.3,54.9,00000
13.0,79.0,90.0,263,02,01,  Dakshin Shibpur,238,406,148,238,90,168,37.0,38.3,34.9,00000
13.0,79.0,90.0,489,01,01,  Hatighata,626,318,304,129,322,189,66.3,70.2,63.0,00000
13.0,79.0,90.0,489,02,01,  Nayakandi,93,72,32,36,61,36,56.4,47.1,62.9,00000
13.0,79.0,90.0,945,01,01,  Dakshin Tarki,518,472,222,216,296,256,52.3,50.7,53.6,00000
13.0,79.0,90.0,945,02,01,  Madhya Tarki,464,302,201,125,263,177,60.6,61.7,59.8,00000
13.0,79.0,90.0,945,03,01,  Uttar Tarki,907,580,406,251,501,329,61.0,61.8,60.4,00000
13.0,79.0,94.0,217,01,01,  Failakandi,544,573,234,242,310,331,48.7,49.2,48.4,00000
13.0,79.0,94.0,217,02,01,  Dighulipar,768,475,347,204,421,271,61.8,63.0,60.8,00000
13.0,79.0,94.0,217,03,01,  Mandartali,825,643,382,292,443,351,56.2,56.7,55.8,00000
13.0,79.0,94.0,217,04,01,  Urdumadi,42,64,20,24,22,40,39.6,45.5,35.5,00000
13.0,79.0,94.0,217,05,01,  Kazikandi,296,134,138,65,158,69,68.8,68.0,69.6,00000
13.0,79.0,94.0,217,06,01,  Naburkandi,540,432,244,194,296,238,55.6,55.7,55.4,00000
13.0,79.0,94.0,407,01,01,  Dakshin Gazipur,805,720,354,322,451,398,52.8,52.4,53.1,00000
13.0,79.0,94.0,407,02,01,  Uttar Gazipur,804,874,349,415,455,459,47.9,45.7,49.8,00000
13.0,79.0,94.0,756,01,01,  Uttar Nauri,326,358,153,161,173,197,47.7,48.7,46.8,00000
13.0,79.0,94.0,756,02,01,  Paschim Nauri,480,413,198,168,282,245,53.8,54.1,53.5,00000
13.0,79.0,94.0,756,03,01,  Bazar Nauri,158,216,69,102,89,114,42.2,40.4,43.8,00000
13.0,79.0,94.0,756,04,01,  Purba Nauri,172,325,70,150,102,175,34.6,31.8,36.8,00000
13.0,79.0,94.0,756,05,01,  Nauri Hindupara,154,134,69,63,85,71,53.5,52.3,54.5,00000
13.0,79.0,94.0,756,06,01,  Dakshin Nauri Uttar,402,239,181,102,221,137,62.7,64.0,61.7,00000
13.0,79.0,94.0,949,01,01,  Rarikandi,1017,599,477,248,540,351,62.9,65.8,60.6,00000
13.0,79.0,94.0,949,02,01,  Rarikandi Dakshin,493,367,218,169,275,198,57.3,56.3,58.1,00000
13.0,95.0,20.0,478,01,01,  Kherihar,2280,1487,1017,736,1263,751,60.5,58.0,62.7,00000
13.0,95.0,20.0,478,02,01,  Babupur,191,206,84,98,107,108,48.1,46.2,49.8,00000
13.0,95.0,20.0,478,03,01,  Satbaria,393,203,158,94,235,109,65.9,62.7,68.3,00000
13.0,95.0,20.0,886,01,01,  Shimail,326,211,151,99,175,112,60.7,60.4,61.0,00000
13.0,95.0,20.0,886,02,01,  Raghabpur,185,93,89,46,96,47,66.5,65.9,67.1,00000
13.0,95.0,60.0,859,01,01,  Sengaon,461,782,190,378,271,404,37.1,33.5,40.1,00000
13.0,95.0,60.0,859,02,01,  Karba,340,684,121,347,219,337,33.2,25.9,39.4,00000
13.0,95.0,85.0,201,01,01,  Daikamta,810,681,377,353,433,328,54.3,51.6,56.9,00000
13.0,95.0,85.0,201,02,01,  Chhatar Paia,234,179,107,81,127,98,56.7,56.9,56.4,00000
13.0,95.0,85.0,913,01,01,  Dakshin Sorsak,1131,1008,522,486,609,522,52.9,51.8,53.8,00000
13.0,95.0,85.0,913,02,01,  Uttar Sorsak,1697,1452,817,802,880,650,53.9,50.5,57.5,00000
13.0,95.0,85.0,935,01,01,  Suchi Para,1257,835,580,401,677,434,60.1,59.1,60.9,00000
13.0,95.0,85.0,935,02,01,  Noapara,268,198,129,96,139,102,57.5,57.3,57.7,00000
13.0,95.0,90.0,625,01,01,  Narasinghapur,2524,1740,1039,810,1485,930,59.2,56.2,61.5,00000
13.0,95.0,90.0,625,02,01,  Dasna Para,494,347,185,167,309,180,58.7,52.6,63.2,00000
13.0,95.0,95.0,054,01,01,  Balasid,1973,1432,818,697,1155,735,57.9,54.0,61.1,00000
13.0,95.0,95.0,054,02,01,  Taralia,303,196,120,95,183,101,60.7,55.8,64.4,00000
13.0,95.0,95.0,054,03,01,  Changachal,516,156,208,79,308,77,76.8,72.5,80.0,00000
13.0,95.0,95.0,054,04,01,  Joginagar,112,55,55,25,57,30,67.1,68.8,65.5,00000
3.0,4.0,31.0,142,01,03,  Saber Miah Para,370,610,183,303,187,307,37.8,37.7,37.9,00000
3.0,4.0,31.0,142,02,03,  Mangfu Mahajan Para,202,176,119,74,83,102,53.4,61.7,44.9,00000
3.0,4.0,31.0,142,03,03,  Upazila Parishad,368,383,231,181,137,202,49.0,56.1,40.4,00000
3.0,4.0,31.0,142,04,03,  Bazar Para,295,101,160,48,135,53,74.5,76.9,71.8,00000
3.0,4.0,31.0,142,05,03,  Uttar Bazar,170,106,91,48,79,58,61.6,65.5,57.7,00000
3.0,4.0,31.0,142,06,03,  Dakshin Bazar,142,84,76,39,66,45,62.8,66.1,59.5,00000
3.0,4.0,31.0,142,07,03,  Bazar Mogh Para,240,155,135,66,105,89,60.8,67.2,54.1,00000
3.0,4.0,31.0,142,08,03,  Khulla Mia Para,259,76,124,44,135,32,77.3,73.8,80.8,00000
3.0,4.0,31.0,142,09,03,  Anwar Hossain Chairman Para,414,265,213,134,201,131,61.0,61.4,60.5,00000
3.0,4.0,31.0,142,10,03,  Ali Muddin Para,262,124,143,51,119,73,67.9,73.7,62.0,00000
3.0,4.0,31.0,142,11,03,  Danu Sardar  Para,650,1026,380,493,270,533,38.8,43.5,33.6,00000
3.0,4.0,31.0,142,12,03,  Uttar Palong Para,341,518,189,253,152,265,39.7,42.8,36.5,00000
3.0,4.0,31.0,142,13,03,  Purba Palong Para,451,1324,244,679,207,645,25.4,26.4,24.3,00000
3.0,4.0,31.0,142,14,03,  Mong Soi Pru Para,40,238,22,124,18,114,14.4,15.1,13.6,00000
3.0,4.0,31.0,142,15,03,  Daya Chan Dra Para,38,160,19,87,19,73,19.2,17.9,20.7,00000
3.0,4.0,31.0,142,16,03,  Mong Golu Para,47,93,33,37,14,56,33.6,47.1,20.0,00000
3.0,4.0,31.0,142,17,03,  Mostack Para,114,109,72,53,42,56,51.1,57.6,42.9,00000
3.0,4.0,31.0,142,18,03,  Chion Para,2,94,1,44,1,50,2.1,2.2,2.0,00000
3.0,4.0,31.0,142,19,03,  Taluk Ddar Para,4,20,4,11,0,9,16.7,26.7,0.0,00000
3.0,4.0,31.0,142,20,03,  Godar Par Para,151,288,81,145,70,143,34.4,35.8,32.9,00000
3.0,4.0,31.0,142,21,03,  Amtali Para,217,371,118,183,99,188,36.9,39.2,34.5,00000
3.0,4.0,31.0,284,01,01,  Ka-You Karbari Para,1,63,0,31,1,32,1.6,0.0,3.0,00000
3.0,4.0,31.0,284,02,01,  Ra-Lai-Para,5,254,5,132,0,122,1.9,3.6,0.0,00000
3.0,4.0,31.0,284,03,01,  Man Rom Para,0,166,0,81,0,85,0.0,0.0,0.0,00000
3.0,4.0,31.0,284,04,01,  Man Long Para,0,22,0,12,0,10,0.0,0.0,0.0,00000
3.0,4.0,31.0,284,05,01,  Payea  Para,11,71,11,34,0,37,13.4,24.4,0.0,00000
3.0,4.0,31.0,284,06,01,  Menlay Para,0,124,0,63,0,61,0.0,0.0,0.0,00000
3.0,4.0,31.0,284,07,01,  Prova Para,0,69,0,36,0,33,0.0,0.0,0.0,00000
3.0,4.0,31.0,284,08,01,  Paley Para,5,192,3,97,2,95,2.5,3.0,2.1,00000
3.0,4.0,31.0,284,09,01,  Langthong,7,60,5,27,2,33,10.4,15.6,5.7,00000
3.0,4.0,31.0,284,10,01,  Bu-Li  Para,1,51,1,20,0,31,1.9,4.8,0.0,00000
3.0,4.0,31.0,284,11,01,  Ching Chong Karbari Para,2,109,2,59,0,50,1.8,3.3,0.0,00000
3.0,4.0,31.0,284,12,01,  Da-Khoi Para,1,49,0,27,1,22,2.0,0.0,4.3,00000
3.0,4.0,31.0,284,13,01,  Ba Choa Para,0,27,0,14,0,13,0.0,0.0,0.0,00000
3.0,4.0,31.0,284,14,01,  Rai To Moni Karbari Para,56,319,42,152,14,167,14.9,21.6,7.7,00000
3.0,4.0,31.0,284,15,01,  Padi Para,0,108,0,55,0,53,0.0,0.0,0.0,00000
3.0,4.0,31.0,284,16,01,  Chak Lam Karbari Para,7,56,4,30,3,26,11.1,11.8,10.3,00000
3.0,4.0,31.0,284,17,01,  Do Basi Para,0,74,0,32,0,42,0.0,0.0,0.0,00000
3.0,4.0,31.0,284,18,01,  Chandra Moni Para,41,19,22,7,19,12,68.3,75.9,61.3,00000
3.0,4.0,31.0,284,19,01,  Langchong,9,128,9,62,0,66,6.6,12.7,0.0,00000
3.0,4.0,31.0,284,20,01,  Mencock,2,101,2,47,0,54,1.9,4.1,0.0,00000
3.0,4.0,31.0,284,21,01,  Menning,3,103,3,46,0,57,2.8,6.1,0.0,00000
3.0,4.0,31.0,284,22,01,  Johonmaster,7,58,3,28,4,30,10.8,9.7,11.8,00000
3.0,4.0,31.0,284,23,01,  Menku Para,0,104,0,58,0,46,0.0,0.0,0.0,00000
3.0,4.0,31.0,284,24,01,  Khido Para,1,151,1,76,0,75,0.7,1.3,0.0,00000
3.0,4.0,31.0,284,25,01,  Motaparow,41,94,30,50,11,44,30.4,37.5,20.0,00000
3.0,4.0,31.0,700,01,01,  Langchong Para,17,242,13,110,4,132,6.6,10.6,2.9,00000
3.0,4.0,31.0,700,02,01,  Satirang Para,0,73,0,36,0,37,0.0,0.0,0.0,00000
3.0,4.0,31.0,700,03,01,  Adoy Para,47,199,31,98,16,101,19.1,24.0,13.7,00000
3.0,4.0,31.0,700,04,01,  Kain Prey Para,1,234,0,132,1,102,0.4,0.0,1.0,00000
3.0,4.0,31.0,700,05,01,  Consola Para,18,98,15,47,3,51,15.5,24.2,5.6,00000
3.0,4.0,31.0,700,06,01,  Bhaluk Para,2,50,1,28,1,22,3.8,3.4,4.3,00000
3.0,4.0,31.0,700,10,01,  Babu Para,141,251,92,106,49,145,36.0,46.5,25.3,00000
3.0,4.0,31.0,700,11,01,  Zira Para,114,72,61,34,53,38,61.3,64.2,58.2,00000
3.0,4.0,31.0,700,12,01,  Janaly Para,35,0,35,0,0,0,100.0,100.0,0.0,00000
3.0,4.0,31.0,700,13,01,  Aungsuy Para,6,97,4,49,2,48,5.8,7.5,4.0,00000
3.0,4.0,31.0,700,14,01,  Tili Para,38,281,38,139,0,142,11.9,21.5,0.0,00000
3.0,4.0,31.0,700,15,01,  Ringlot Para,6,254,5,126,1,128,2.3,3.8,0.8,00000
3.0,4.0,31.0,700,16,01,  Krokpata Bazar,33,162,21,85,12,77,16.9,19.8,13.5,00000
3.0,4.0,31.0,700,17,01,  Khampur Para,18,234,10,111,8,123,7.1,8.3,6.1,00000
3.0,4.0,31.0,700,18,01,  Patoy Para,50,115,34,54,16,61,30.3,38.6,20.8,00000
3.0,4.0,31.0,700,19,01,  Awoy Para,1,237,1,110,0,127,0.4,0.9,0.0,00000
3.0,4.0,31.0,700,20,01,  Menry Para,2,131,2,56,0,75,1.5,3.4,0.0,00000
3.0,4.0,31.0,700,21,01,  Mencrat Para,0,109,0,62,0,47,0.0,0.0,0.0,00000
3.0,4.0,31.0,700,22,01,  Khamtok Para,15,202,13,121,2,81,6.9,9.7,2.4,00000
3.0,4.0,31.0,700,23,01,  Langpung Para,41,42,41,16,0,26,49.4,71.9,0.0,00000
3.0,4.0,31.0,700,24,01,  Maliram Para,5,297,4,145,1,152,1.7,2.7,0.7,00000
3.0,4.0,31.0,700,25,01,  Jeoung Way Para,10,304,8,152,2,152,3.2,5.0,1.3,00000
3.0,4.0,31.0,700,27,01,  Indu Mukh Para,15,291,12,145,3,146,4.9,7.6,2.0,00000
3.0,4.0,31.0,700,28,01,  Mendir Para,8,243,6,117,2,126,3.2,4.9,1.6,00000
3.0,4.0,31.0,700,29,01,  Kengkaw Para,32,218,30,102,2,116,12.8,22.7,1.7,00000
3.0,4.0,31.0,700,30,01,  Chowkraon Para,6,257,3,131,3,126,2.3,2.2,2.3,00000
3.0,4.0,31.0,700,31,01,  Doge Chondra Para,1,209,0,105,1,104,0.5,0.0,1.0,00000
3.0,4.0,31.0,994,01,01,  Jabiram Karbari Para,177,234,99,96,78,138,43.1,50.8,36.1,00000
3.0,4.0,31.0,994,02,01,  Thoiwio  Goa Para,5,7,3,3,2,4,41.7,50.0,33.3,00000
3.0,4.0,31.0,994,03,01,  Yunus Member Para,108,177,67,90,41,87,37.9,42.7,32.0,00000
3.0,4.0,31.0,994,04,01,  Langri Para,51,130,37,64,14,66,28.2,36.6,17.5,00000
3.0,4.0,31.0,994,05,01,  Ba Chaiya Para,27,88,12,48,15,40,23.5,20.0,27.3,00000
3.0,4.0,31.0,994,06,01,  Chang Li Para,3,82,3,42,0,40,3.5,6.7,0.0,00000
3.0,4.0,31.0,994,07,01,  Man Rom Para,1,45,0,24,1,21,2.2,0.0,4.5,00000
3.0,4.0,31.0,994,08,01,  Jalanta Mani Para,39,141,27,60,12,81,21.7,31.0,12.9,00000
3.0,4.0,31.0,994,09,01,  Klaing Para,4,85,2,54,2,31,4.5,3.6,6.1,00000
3.0,4.0,31.0,994,10,01,  A-Sa-Ti Tripura Para,67,152,33,70,34,82,30.6,32.0,29.3,00000
3.0,4.0,31.0,994,11,01,  Bulu Para,0,79,0,47,0,32,0.0,0.0,0.0,00000
3.0,4.0,31.0,994,12,01,  Rai Nai Karbari Para,0,51,0,25,0,26,0.0,0.0,0.0,00000
3.0,4.0,31.0,994,13,01,  Uk-Ling Para,0,32,0,15,0,17,0.0,0.0,0.0,00000
3.0,4.0,31.0,994,14,01,  Diri Para,0,23,0,13,0,10,0.0,0.0,0.0,00000
3.0,4.0,31.0,994,15,01,  Kang Oya Para,0,61,0,35,0,26,0.0,0.0,0.0,00000
3.0,4.0,31.0,994,16,01,  Chilochandra Para,9,69,8,33,1,36,11.5,19.5,2.7,00000
3.0,4.0,31.0,994,17,01,  Kransing Para,2,91,1,50,1,41,2.2,2.0,2.4,00000
3.0,4.0,31.0,994,18,01,  Agula Trapura Para,9,20,7,5,2,15,31.0,58.3,11.8,00000
3.0,4.0,31.0,994,19,01,  Man Poya Para,0,12,0,6,0,6,0.0,0.0,0.0,00000
3.0,4.0,31.0,994,20,01,  Babi Para,1,133,1,68,0,65,0.7,1.4,0.0,00000
3.0,4.0,31.0,994,21,01,  Pai Toi Karbari Para,3,99,3,48,0,51,2.9,5.9,0.0,00000
3.0,4.0,31.0,994,22,01,  Ni-Ang Para,0,44,0,25,0,19,0.0,0.0,0.0,00000
0.0,3.0,4.0,031,998,02,*Cantonment,728,5,680,1,48,4,99.3,99.9,92.3,00000
3.0,4.0,63.0,426,01,01,  Thoaichhi Para,31,157,20,70,11,87,16.5,22.2,11.2,00000
3.0,4.0,63.0,426,02,01,  Mannan Member Para,201,262,108,127,93,135,43.4,46.0,40.8,00000
3.0,4.0,63.0,426,03,01,  Puterjhiri Para,50,100,32,47,18,53,33.3,40.5,25.4,00000
3.0,4.0,63.0,426,04,01,  Gurumia Para,116,201,64,103,52,98,36.6,38.3,34.7,00000
3.0,4.0,63.0,426,05,01,  Sanichary Paraa,137,216,66,102,71,114,38.8,39.3,38.4,00000
3.0,4.0,63.0,426,06,01,  Barir Muk Para,216,363,123,193,93,170,37.3,38.9,35.4,00000
3.0,4.0,63.0,426,07,01,  Maila Karbari Para,7,161,7,80,0,81,4.2,8.0,0.0,00000
3.0,4.0,63.0,426,08,01,  Mohd Ali Para,18,42,10,22,8,20,30.0,31.3,28.6,00000
3.0,4.0,63.0,426,09,01,  Siddque Para,115,157,60,85,55,72,42.3,41.4,43.3,00000
3.0,4.0,63.0,426,10,01,  Mong Ching Para,34,191,17,96,17,95,15.1,15.0,15.2,00000
3.0,4.0,63.0,426,11,01,  Akibar Para,55,68,30,26,25,42,44.7,53.6,37.3,00000
3.0,4.0,63.0,426,12,01,  Ali Member Para,32,207,16,102,16,105,13.4,13.6,13.2,00000
3.0,4.0,63.0,426,13,01,  Kashem Member Para,78,107,36,53,42,54,42.2,40.4,43.8,00000
3.0,4.0,63.0,426,14,01,  Pokhaiya Jiri Para,51,123,25,62,26,61,29.3,28.7,29.9,00000
3.0,4.0,63.0,426,15,01,  Panijiri Para,18,69,11,30,7,39,20.7,26.8,15.2,00000
3.0,4.0,63.0,426,16,01,  Obaidul Hakim Para,127,347,58,174,69,173,26.8,25.0,28.5,00000
3.0,4.0,63.0,426,18,01,  Shiraj Karbari Para,48,183,29,90,19,93,20.8,24.4,17.0,00000
3.0,4.0,63.0,426,19,01,  Sonachandra Tripura Para,48,130,28,58,20,72,27.0,32.6,21.7,00000
3.0,4.0,63.0,426,20,01,  Tara Bunia Para,15,307,9,165,6,142,4.7,5.2,4.1,00000
3.0,4.0,63.0,426,21,01,  Padoymorong Para,8,158,2,82,6,76,4.8,2.4,7.3,00000
3.0,4.0,63.0,426,22,01,  Cairi Morong Para,8,94,8,44,0,50,7.8,15.4,0.0,00000
3.0,4.0,63.0,426,23,01,  Oti Chandra Para,9,41,4,19,5,22,18.0,17.4,18.5,00000
3.0,4.0,63.0,568,01,01,  Ramju Para,1,41,1,18,0,23,2.4,5.3,0.0,00000
3.0,4.0,63.0,568,02,01,  Joynal Para,2,12,1,6,1,6,14.3,14.3,14.3,00000
3.0,4.0,63.0,568,03,01,  Ruirok Para,15,141,8,76,7,65,9.6,9.5,9.7,00000
3.0,4.0,63.0,568,04,01,  Chhatra Para,28,60,18,27,10,33,31.8,40.0,23.3,00000
3.0,4.0,63.0,568,05,01,  Tang Tuipara,0,29,0,16,0,13,0.0,0.0,0.0,00000
3.0,4.0,63.0,568,06,01,  Ruipa Para,1,88,0,38,1,50,1.1,0.0,2.0,00000
3.0,4.0,63.0,568,07,01,  Rang Yeua Karbari Para,0,17,0,9,0,8,0.0,0.0,0.0,00000
3.0,4.0,63.0,568,08,01,  Menrua Para,7,44,7,22,0,22,13.7,24.1,0.0,00000
3.0,4.0,63.0,568,09,01,  Mempa Para,25,96,23,39,2,57,20.7,37.1,3.4,00000
3.0,4.0,63.0,568,10,01,  Laru Para,2,43,1,24,1,19,4.4,4.0,5.0,00000
3.0,4.0,63.0,568,11,01,  Adu  Para,28,123,20,57,8,66,18.5,26.0,10.8,00000
3.0,4.0,63.0,568,12,01,  Sang Chung,0,12,0,5,0,7,0.0,0.0,0.0,00000
3.0,4.0,63.0,568,13,01,  Khakue Para,0,34,0,18,0,16,0.0,0.0,0.0,00000
3.0,4.0,63.0,568,14,01,  Khingpong Para,0,51,0,28,0,23,0.0,0.0,0.0,00000
3.0,4.0,63.0,568,15,01,  Namsak Para,0,55,0,29,0,26,0.0,0.0,0.0,00000
3.0,4.0,63.0,568,16,01,  Pubola Para,0,50,0,25,0,25,0.0,0.0,0.0,00000
3.0,4.0,63.0,568,17,01,  Basa Chandra Para,7,42,4,17,3,25,14.3,19.0,10.7,00000
3.0,4.0,63.0,568,18,01,  Sak Lang Para,43,120,23,66,20,54,26.4,25.8,27.0,00000
3.0,4.0,63.0,852,01,01,  Mongbu Karbari Para,45,87,20,49,25,38,34.1,29.0,39.7,00000
3.0,4.0,63.0,852,02,01,  Chibatali Para,247,211,132,98,115,113,53.9,57.4,50.4,00000
3.0,4.0,63.0,852,03,01,  Repar Para Bazar,473,763,276,378,197,385,38.3,42.2,33.8,00000
3.0,4.0,63.0,852,04,01,  Dopru Morong Para,10,69,4,37,6,32,12.7,9.8,15.8,00000
3.0,4.0,63.0,852,05,01,  Pattakhaiya Para,317,443,167,211,150,232,41.7,44.2,39.3,00000
3.0,4.0,63.0,852,06,01,  Shilbunia,137,75,79,31,58,44,64.6,71.8,56.9,00000
3.0,4.0,63.0,852,07,01,  Kerajiripara,7,122,5,65,2,57,5.4,7.1,3.4,00000
3.0,4.0,63.0,852,08,01,  Mangkhai Para,0,69,0,37,0,32,0.0,0.0,0.0,00000
3.0,4.0,63.0,852,09,01,  Dardari/Abul Kashem Para,78,156,37,79,41,77,33.3,31.9,34.7,00000
3.0,4.0,63.0,852,10,01,  Bager Jiri  Para,32,41,12,19,20,22,43.8,38.7,47.6,00000
3.0,4.0,63.0,852,11,01,  Youkki Para,4,20,3,11,1,9,16.7,21.4,10.0,00000
3.0,4.0,63.0,852,12,01,  Punarbasan-1,35,91,27,37,8,54,27.8,42.2,12.9,00000
3.0,4.0,63.0,852,15,01,  Bonku Morong Para,4,81,4,40,0,41,4.7,9.1,0.0,00000
3.0,4.0,63.0,852,16,01,  Jogendra Para,14,111,12,60,2,51,11.2,16.7,3.8,00000
3.0,4.0,63.0,852,17,01,  Bulu Para,236,136,139,55,97,81,63.4,71.6,54.5,00000
3.0,4.0,63.0,852,19,01,  Mangchha Para,350,603,180,316,170,287,36.7,36.3,37.2,00000
3.0,4.0,63.0,852,20,01,  Kalu Karbari Para,268,548,138,279,130,269,32.8,33.1,32.6,00000
3.0,4.0,63.0,852,21,01,  Naya Para Muslin,628,1127,346,561,282,566,35.8,38.1,33.3,00000
3.0,4.0,63.0,852,22,01,  Ishak Para,165,320,89,160,76,160,34.0,35.7,32.2,00000
3.0,4.0,63.0,852,23,01,  Naya Para Mog,228,229,119,104,109,125,49.9,53.4,46.6,00000
3.0,4.0,63.0,852,24,01,  Kalar Jiri,21,193,14,91,7,102,9.8,13.3,6.4,00000
3.0,4.0,63.0,852,25,01,  Mong Paikhy Hadman Para,35,211,25,99,10,112,14.2,20.2,8.2,00000
3.0,4.0,63.0,852,27,01,  Karmokar Para,216,116,112,55,104,61,65.1,67.1,63.0,00000
3.0,4.0,63.0,852,28,01,  Laru Morung Para,0,54,0,26,0,28,0.0,0.0,0.0,00000
3.0,4.0,63.0,852,29,01,  Roheni Karbari Para,49,78,29,34,20,44,38.6,46.0,31.3,00000
3.0,4.0,63.0,852,30,01,  Bosudeb Karbari Para,52,152,37,71,15,81,25.5,34.3,15.6,00000
3.0,4.0,63.0,852,31,01,  Banopur Chakma Para,11,79,8,38,3,41,12.2,17.4,6.8,00000
57.8,3.0,14.0,002,998,02,*Cantonment Area,1229,73,1033,33,196,40,94.4,96.9,83.1,00000
3.0,14.0,15.0,062,01,01,  Bagan Para,4,18,3,8,1,10,18.2,27.3,9.1,00000
3.0,14.0,15.0,062,02,01,  Kataly  Para,31,123,23,54,8,69,20.1,29.9,10.4,00000
3.0,14.0,15.0,062,03,01,  Lamu Jree Namar Para,47,98,25,56,22,42,32.4,30.9,34.4,00000
3.0,14.0,15.0,062,04,01,  Joy Mohan Para,9,65,4,34,5,31,12.2,10.5,13.9,00000
3.0,14.0,15.0,062,05,01,  Natun  Para,0,7,0,4,0,3,0.0,0.0,0.0,00000
3.0,14.0,15.0,062,06,01,  Uzi Chhara Para,38,107,27,56,11,51,26.2,32.5,17.7,00000
3.0,14.0,15.0,062,07,01,  Manu Head Man Para,1,58,1,33,0,25,1.7,2.9,0.0,00000
3.0,14.0,15.0,062,08,01,  Habron Para,26,77,14,35,12,42,25.2,28.6,22.2,00000
3.0,14.0,15.0,062,09,01,  Tangpru Para,51,70,30,32,21,38,42.1,48.4,35.6,00000
3.0,14.0,15.0,062,10,01,  Mangu Pru  Para,22,125,17,67,5,58,15.0,20.2,7.9,00000
3.0,14.0,15.0,062,11,01,  Lamu Jiree Upar Para,47,112,26,54,21,58,29.6,32.5,26.6,00000
3.0,14.0,15.0,062,12,01,  Brikhang Para,1,3,0,2,1,1,25.0,0.0,50.0,00000
3.0,14.0,15.0,062,13,01,  Lamu Jiree Muslim Para,100,134,67,79,33,55,42.7,45.9,37.5,00000
3.0,14.0,15.0,062,14,01,  Purba Balaghata,5,6,5,3,0,3,45.5,62.5,0.0,00000
3.0,14.0,15.0,124,01,01,  Goaliakhola Para,273,279,130,141,143,138,49.5,48.0,50.9,00000
3.0,14.0,15.0,124,02,01,  Uttar Goaliakhola Char,117,139,57,63,60,76,45.7,47.5,44.1,00000
3.0,14.0,15.0,124,03,01,  Doluar Bakpara,20,72,12,42,8,30,21.7,22.2,21.1,00000
3.0,14.0,15.0,124,04,01,  Rowaja Para,37,114,23,49,14,65,24.5,31.9,17.7,00000
3.0,14.0,15.0,124,05,01,  Dalujire Para,13,42,9,22,4,20,23.6,29.0,16.7,00000
3.0,14.0,15.0,124,06,01,  Dumkee Para,29,103,18,50,11,53,22.0,26.5,17.2,00000
3.0,14.0,15.0,124,07,01,  Bangamura Para,39,151,22,83,17,68,20.5,21.0,20.0,00000
3.0,14.0,15.0,124,08,01,  Bichhinnarbag Para,0,19,0,9,0,10,0.0,0.0,0.0,00000
3.0,14.0,15.0,124,09,01,  Sitamura Para,20,93,18,46,2,47,17.7,28.1,4.1,00000
3.0,14.0,15.0,124,10,01,  Dath Bhanga Para,33,65,21,29,12,36,33.7,42.0,25.0,00000
3.0,14.0,15.0,124,11,01,  Tamru Para,27,28,13,18,14,10,49.1,41.9,58.3,00000
3.0,14.0,15.0,124,12,01,  Jiniang    Para,60,50,37,18,23,32,54.5,67.3,41.8,00000
3.0,14.0,15.0,124,13,01,  Lamba Ghona Para,68,127,44,56,24,71,34.9,44.0,25.3,00000
3.0,14.0,15.0,124,14,01,  Sat Kamal  Para (N),255,196,155,83,100,113,56.5,65.1,46.9,00000
3.0,14.0,15.0,124,15,01,  Kana Bom Para,46,43,25,15,21,28,51.7,62.5,42.9,00000
3.0,14.0,15.0,124,16,01,  Reichha Thali Para,326,260,194,119,132,141,55.6,62.0,48.4,00000
3.0,14.0,15.0,124,17,01,  Reichha Bazar Alaka,184,378,105,179,79,199,32.7,37.0,28.4,00000
3.0,14.0,15.0,124,18,01,  Fisheiri Out Alaka,68,57,47,26,21,31,54.4,64.4,40.4,00000
3.0,14.0,15.0,124,19,01,  Senior  Para,173,198,121,88,52,110,46.6,57.9,32.1,00000
3.0,14.0,15.0,124,20,01,  Talukder    Elaka,361,123,252,53,109,70,74.6,82.6,60.9,00000
3.0,14.0,15.0,124,21,01,  Lai Para,189,111,103,42,86,69,63.0,71.0,55.5,00000
3.0,14.0,15.0,124,22,01,  Hafez Ghona Police Camp,11,59,4,30,7,29,15.7,11.8,19.4,00000
3.0,14.0,15.0,124,23,01,  Chainga Marmapara,8,11,7,4,1,7,42.1,63.6,12.5,00000
3.0,14.0,15.0,124,24,01,  Hati Banga  Para,43,85,24,37,19,48,33.6,39.3,28.4,00000
3.0,14.0,15.0,124,25,01,  Tripura    Para,24,37,16,14,8,23,39.3,53.3,25.8,00000
3.0,14.0,15.0,373,01,01,  Krikkong Para,57,140,44,58,13,82,28.9,43.1,13.7,00000
3.0,14.0,15.0,373,02,01,  Dalu Jiree Upar Para,1,52,1,30,0,22,1.9,3.2,0.0,00000
3.0,14.0,15.0,373,03,01,  Dalu Jiree Nicher Para,22,103,10,53,12,50,17.6,15.9,19.4,00000
3.0,14.0,15.0,373,04,01,  Alikhang Para,0,45,0,23,0,22,0.0,0.0,0.0,00000
3.0,14.0,15.0,373,05,01,  Lu Line Purnabasan Para,12,113,7,55,5,58,9.6,11.3,7.9,00000
3.0,14.0,15.0,373,06,01,  Naya Patang Mukh Para,6,66,4,30,2,36,8.3,11.8,5.3,00000
3.0,14.0,15.0,373,07,01,  Lu Line Head Man Para,12,156,10,78,2,78,7.1,11.4,2.5,00000
3.0,14.0,15.0,373,08,01,  Halapai Mukh  Para,32,182,24,90,8,92,15.0,21.1,8.0,00000
3.0,14.0,15.0,373,09,01,  Samuk Jikee Punabasan Para,1,43,0,24,1,19,2.3,0.0,5.0,00000
3.0,14.0,15.0,373,10,01,  Samuk Jire Para,0,5,0,3,0,2,0.0,0.0,0.0,00000
3.0,14.0,31.0,186,01,01,  Kaobuk Para,122,154,73,71,49,83,44.2,50.7,37.1,00000
3.0,14.0,31.0,186,02,01,  Amtali Para,121,120,66,53,55,67,50.2,55.5,45.1,00000
3.0,14.0,31.0,186,03,01,  Khaya Paschim Para,49,92,30,38,19,54,34.8,44.1,26.0,00000
3.0,14.0,31.0,186,04,01,  Khaya Para Purba,16,18,11,10,5,8,47.1,52.4,38.5,00000
3.0,14.0,31.0,186,05,01,  Chao Para,47,90,26,48,21,42,34.3,35.1,33.3,00000
3.0,14.0,31.0,186,06,01,  Ugga Para,36,67,18,36,18,31,35.0,33.3,36.7,00000
3.0,14.0,31.0,186,07,01,  Nao Para,26,91,17,43,9,48,22.2,28.3,15.8,00000
3.0,14.0,31.0,186,08,01,  Kanaijo  Para,29,51,15,24,14,27,36.3,38.5,34.1,00000
3.0,14.0,31.0,186,09,01,  Buree Para,6,38,5,16,1,22,13.6,23.8,4.3,00000
3.0,14.0,31.0,186,10,01,  Chemi Dalu Para,316,541,171,261,145,280,36.9,39.6,34.1,00000
3.0,14.0,31.0,186,11,01,  Khaya Tong Para,26,75,11,37,15,38,25.7,22.9,28.3,00000
3.0,14.0,31.0,186,12,01,  Gungru Maoham Para,25,73,21,32,4,41,25.5,39.6,8.9,00000
3.0,14.0,31.0,186,13,01,  Gongru Mukh Para,29,71,20,35,9,36,29.0,36.4,20.0,00000
3.0,14.0,31.0,186,14,01,  Gungru Uper Para,22,180,9,96,13,84,10.9,8.6,13.4,00000
3.0,14.0,31.0,186,15,01,  Gongru Lamar/Agarpara,20,46,12,23,8,23,30.3,34.3,25.8,00000
3.0,14.0,31.0,186,16,01,  Amtali Kolasy Para,18,24,14,15,4,9,42.9,48.3,30.8,00000
3.0,14.0,31.0,497,01,01,  Uzi Head Man Para,56,147,32,68,24,79,27.6,32.0,23.3,00000
3.0,14.0,31.0,497,02,01,  Pruma U Headman Para,63,127,41,57,22,70,33.2,41.8,23.9,00000
3.0,14.0,31.0,497,03,01,  Jardan Para,47,89,20,43,27,46,34.6,31.7,37.0,00000
3.0,14.0,31.0,497,04,01,  Ching Lung Para,24,36,12,20,12,16,40.0,37.5,42.9,00000
3.0,14.0,31.0,559,01,01,  Barathali Chairman Para,113,140,61,69,52,71,44.7,46.9,42.3,00000
3.0,14.0,31.0,559,02,01,  Barathali Member Para,31,60,21,26,10,34,34.1,44.7,22.7,00000
3.0,14.0,31.0,559,03,01,  Bagmara Mongla Karbari Para,60,144,30,76,30,68,29.4,28.3,30.6,00000
3.0,14.0,31.0,559,04,01,  Do-Aungheo Kheang Para,39,99,22,46,17,53,28.3,32.4,24.3,00000
3.0,14.0,31.0,559,05,01,  U.Baghmara Chimpru-Para,21,42,9,20,12,22,33.3,31.0,35.3,00000
3.0,14.0,31.0,559,06,01,  Saipiu Kheang Karbari Para,37,61,24,25,13,36,37.8,49.0,26.5,00000
3.0,14.0,31.0,559,07,01,  Chemir Mukh Para,97,131,49,56,48,75,42.5,46.7,39.0,00000
3.0,14.0,31.0,559,08,01,  Vhanga Mura Para,108,158,69,69,39,89,40.6,50.0,30.5,00000
3.0,14.0,31.0,559,09,01,  Kuhalong Barua Para,36,28,17,8,19,20,56.3,68.0,48.7,00000
3.0,14.0,31.0,559,10,01,  Kuhalong Headman Para,35,229,21,115,14,114,13.3,15.4,10.9,00000
3.0,14.0,31.0,559,11,01,  Langir Char Para,19,68,10,30,9,38,21.8,25.0,19.1,00000
3.0,14.0,31.0,559,12,01,  Bhora Khali Para,76,161,35,76,41,85,32.1,31.5,32.5,00000
3.0,14.0,31.0,559,13,01,  Kamolong Battali Para,37,34,22,14,15,20,52.1,61.1,42.9,00000
3.0,14.0,31.0,559,14,01,  Kamolong Jusai Karbari Para,99,59,57,26,42,33,62.7,68.7,56.0,00000
3.0,14.0,31.0,559,15,01,  Kamolong Chaisaimong Karbaripa,59,106,34,48,25,58,35.8,41.5,30.1,00000
3.0,14.0,31.0,559,16,01,  Kamolong Nithui Karbari Para,56,83,49,70,7,13,40.3,41.2,35.0,00000
3.0,14.0,31.0,559,17,01,  Kamolong Thoaishapru Kar.Para,42,66,19,29,23,37,38.9,39.6,38.3,00000
3.0,14.0,31.0,559,18,01,  Kamolong Mongnu Karbari Para,64,77,42,26,22,51,45.4,61.8,30.1,00000
3.0,14.0,31.0,559,19,01,  Pole Para,178,248,113,121,65,127,41.8,48.3,33.9,00000
3.0,14.0,31.0,559,21,01,  Bikrechara Muslim Para,311,289,166,156,145,133,51.8,51.6,52.2,00000
3.0,14.0,31.0,559,22,01,  Puran Charui Para,101,104,52,35,49,69,49.3,59.8,41.5,00000
3.0,14.0,31.0,559,23,01,  Natun Charui Para,37,130,22,61,15,69,22.2,26.5,17.9,00000
3.0,14.0,31.0,559,24,01,  Thoainga Para,66,240,34,125,32,115,21.6,21.4,21.8,00000
3.0,14.0,31.0,559,25,01,  Bikri Chara Para,23,28,13,13,10,15,45.1,50.0,40.0,00000
3.0,14.0,31.0,559,26,01,  Bikri Chara Lamar Para,35,64,24,29,11,35,35.4,45.3,23.9,00000
3.0,14.0,31.0,559,27,01,  Bikri Chara Upar Para,1,23,1,9,0,14,4.2,10.0,0.0,00000
3.0,14.0,31.0,559,28,01,  Minjiree Para,81,150,47,72,34,78,35.1,39.5,30.4,00000
3.0,14.0,31.0,559,29,01,  Kangba Para,31,191,20,114,11,77,14.0,14.9,12.5,00000
3.0,14.0,31.0,559,30,01,  Tungkhayang  Para,74,148,42,70,32,78,33.3,37.5,29.1,00000
3.0,14.0,31.0,559,31,01,  3No.Punarbasan Para,29,146,20,68,9,78,16.6,22.7,10.3,00000
3.0,14.0,31.0,559,32,01,  Baki Chara Bar Thali Para,22,85,16,38,6,47,20.6,29.6,11.3,00000
3.0,14.0,31.0,559,33,01,  Baki Chara Namar Para,17,97,9,46,8,51,14.9,16.4,13.6,00000
3.0,14.0,31.0,559,34,01,  Baki Chara Majer Para,31,131,19,63,12,68,19.1,23.2,15.0,00000
3.0,14.0,31.0,559,35,01,  Baki Chararabar Bagan-2,15,38,8,20,7,18,28.3,28.6,28.0,00000
3.0,14.0,47.0,435,01,01,  Swechak Para,1,61,1,33,0,28,1.6,2.9,0.0,00000
3.0,14.0,47.0,435,02,01,  Muruk Khong Mukpara,2,60,1,27,1,33,3.2,3.6,2.9,00000
3.0,14.0,47.0,435,03,01,  Thangree Para,5,54,1,28,4,26,8.5,3.4,13.3,00000
3.0,14.0,47.0,435,04,01,  Punarbasan Para,1,39,1,19,0,20,2.5,5.0,0.0,00000
3.0,14.0,47.0,435,05,01,  Hapigho Para,13,80,9,38,4,42,14.0,19.1,8.7,00000
3.0,14.0,47.0,435,06,01,  Rowaja Para,12,80,8,41,4,39,13.0,16.3,9.3,00000
3.0,14.0,47.0,435,07,01,  Mongjoy Para,90,439,58,200,32,239,17.0,22.5,11.8,00000
3.0,14.0,47.0,621,01,01,  Wabram Para,34,157,24,79,10,78,17.8,23.3,11.4,00000
3.0,14.0,47.0,621,02,01,  Khamadong Para,20,108,8,50,12,58,15.6,13.8,17.1,00000
3.0,14.0,47.0,621,03,01,  Kalicharan Para,17,24,16,12,1,12,41.5,57.1,7.7,00000
3.0,14.0,47.0,621,04,01,  Jung Chhari Upar Para,14,107,9,52,5,55,11.6,14.8,8.3,00000
3.0,14.0,47.0,621,05,01,  Jung Chhari Lamar Para/S Para,20,423,11,200,9,223,4.5,5.2,3.9,00000
3.0,14.0,47.0,621,06,01,  Muruk Khong Headman Para,38,141,21,61,17,80,21.2,25.6,17.5,00000
3.0,14.0,47.0,621,07,01,  Baghmara Para,55,118,35,40,20,78,31.8,46.7,20.4,00000
3.0,14.0,47.0,621,08,01,  Jung Chhari Chakma Para,19,94,10,44,9,50,16.8,18.5,15.3,00000
3.0,14.0,47.0,621,09,01,  Baghmara Hindu Para,78,70,48,32,30,38,52.7,60.0,44.1,00000
3.0,14.0,47.0,621,10,01,  Baghmara Bazar & Police Camp,106,75,70,38,36,37,58.6,64.8,49.3,00000
3.0,14.0,47.0,621,12,01,  Guggadon Para,45,124,25,65,20,59,26.6,27.8,25.3,00000
3.0,14.0,47.0,621,13,01,  Sikkah Para,37,91,23,44,14,47,28.9,34.3,23.0,00000
3.0,14.0,47.0,621,14,01,  Muruk Khong Mukpara,27,89,16,42,11,47,23.3,27.6,19.0,00000
3.0,14.0,47.0,621,15,01,  Lakshi Mohan Para,23,37,16,14,7,23,38.3,53.3,23.3,00000
3.0,14.0,47.0,684,01,01,  Rajbila Upar & Nichar Para,119,164,65,80,54,84,42.0,44.8,39.1,00000
3.0,14.0,47.0,684,02,01,  Rajbila Chakma Para,63,157,35,76,28,81,28.6,31.5,25.7,00000
3.0,14.0,47.0,684,03,01,  Udalbunia Para,522,852,309,414,213,438,38.0,42.7,32.7,00000
3.0,14.0,47.0,684,04,01,  Ramatia Para,61,79,45,45,16,34,43.6,50.0,32.0,00000
3.0,14.0,47.0,684,05,01,  Mosabania Para,46,145,31,73,15,72,24.1,29.8,17.2,00000
3.0,14.0,47.0,684,06,01,  Thongjoma Para,68,120,46,54,22,66,36.2,46.0,25.0,00000
3.0,14.0,47.0,684,08,01,  Rajbila Muslim Para,64,155,30,71,34,84,29.2,29.7,28.8,00000
3.0,14.0,47.0,684,09,01,  Magha Karbari Para,54,124,31,64,23,60,30.3,32.6,27.7,00000
3.0,14.0,47.0,684,10,01,  Junka Para,68,156,38,67,30,89,30.4,36.2,25.2,00000
3.0,14.0,47.0,684,11,01,  Tayingkhali Para & Bazar,50,120,29,57,21,63,29.4,33.7,25.0,00000
3.0,14.0,47.0,684,12,01,  Rainy Para,33,171,12,78,21,93,16.2,13.3,18.4,00000
3.0,14.0,47.0,684,13,01,  Buree Para,53,91,25,43,28,48,36.8,36.8,36.8,00000
3.0,14.0,47.0,684,14,01,  Meoa Para,39,89,19,45,20,44,30.5,29.7,31.3,00000
3.0,14.0,47.0,684,15,01,  Kangra Chari Para,38,104,24,51,14,53,26.8,32.0,20.9,00000
3.0,14.0,47.0,684,16,01,  Punarbashan Para,64,251,40,130,24,121,20.3,23.5,16.6,00000
3.0,14.0,47.0,684,17,01,  Islampur,191,193,99,89,92,104,49.7,52.7,46.9,00000
3.0,14.0,47.0,684,18,01,  Pathorban,61,69,30,34,31,35,46.9,46.9,47.0,00000
3.0,14.0,63.0,746,01,01,  Bhaiggakul Para,33,161,21,75,12,86,17.0,21.9,12.2,00000
3.0,14.0,63.0,746,02,01,  Baburchi Para,44,88,24,34,20,54,33.3,41.4,27.0,00000
3.0,14.0,63.0,746,03,01,  Rangli Para,30,59,22,22,8,37,33.7,50.0,17.8,00000
3.0,14.0,63.0,746,04,01,  Hindu Para,11,14,4,7,7,7,44.0,36.4,50.0,00000
3.0,14.0,63.0,746,05,01,  Member Para,48,153,29,70,19,83,23.9,29.3,18.6,00000
3.0,14.0,63.0,746,06,01,  Deba Para,10,68,9,27,1,41,12.8,25.0,2.4,00000
3.0,14.0,63.0,746,07,01,  Gayal Mara Para,40,137,21,69,19,68,22.6,23.3,21.8,00000
3.0,14.0,63.0,746,08,01,  Kachchap Tali Para,19,62,11,30,8,32,23.5,26.8,20.0,00000
3.0,14.0,63.0,746,09,01,  Pura Para,31,87,15,36,16,51,26.3,29.4,23.9,00000
3.0,14.0,63.0,746,10,01,  C.C.D.B.Para,25,104,13,38,12,66,19.4,25.5,15.4,00000
3.0,14.0,63.0,746,11,01,  Nutan Chatang Para,33,166,26,77,7,89,16.6,25.2,7.3,00000
3.0,14.0,63.0,746,12,01,  Karamaoy Para,215,35,211,17,4,18,86.0,92.5,18.2,00000
3.0,14.0,63.0,808,01,01,  Sultanpur & Bisari Kholapara,326,359,158,174,168,185,47.6,47.6,47.6,00000
3.0,14.0,63.0,808,02,01,  Udrukka Para,11,65,6,35,5,30,14.5,14.6,14.3,00000
3.0,14.0,63.0,808,03,01,  Sikdar Para,246,294,122,141,124,153,45.6,46.4,44.8,00000
3.0,14.0,63.0,808,04,01,  Sulak Bazar Alaka,185,243,96,123,89,120,43.2,43.8,42.6,00000
3.0,14.0,63.0,808,05,01,  Kaichtali Para,297,389,152,176,145,213,43.3,46.3,40.5,00000
3.0,14.0,63.0,808,06,01,  Daikka Khola Para,58,100,30,49,28,51,36.7,38.0,35.4,00000
3.0,14.0,63.0,808,07,01,  Prantik Lake,17,45,8,25,9,20,27.4,24.2,31.0,00000
3.0,14.0,63.0,808,08,01,  Tulatali Para,65,143,45,65,20,78,31.3,40.9,20.4,00000
3.0,14.0,63.0,808,09,01,  Kadukhula Para,168,212,87,100,81,112,44.2,46.5,42.0,00000
3.0,14.0,63.0,808,10,01,  Lamar Para,106,276,59,193,47,83,27.7,23.4,36.2,00000
3.0,14.0,63.0,808,11,01,  Lamar Rastar Mata,249,135,186,82,63,53,64.8,69.4,54.3,00000
3.0,14.0,63.0,808,12,01,  Kamer Para,133,98,102,45,31,53,57.6,69.4,36.9,00000
3.0,14.0,63.0,808,13,01,  Headman  Para,108,271,66,122,42,149,28.5,35.1,22.0,00000
3.0,14.0,63.0,808,14,01,  Majer Para,145,198,75,84,70,114,42.3,47.2,38.0,00000
3.0,14.0,63.0,808,15,01,  Banga Para,140,126,109,67,31,59,52.6,61.9,34.4,00000
3.0,14.0,63.0,808,16,01,  Farukh Para,355,106,185,28,170,78,77.0,86.9,68.5,00000
3.0,14.0,63.0,808,17,01,  Keshmoni Para,49,118,32,46,17,72,29.3,41.0,19.1,00000
3.0,14.0,63.0,808,18,01,  Giri Shova Para,0,22,0,12,0,10,0.0,0.0,0.0,00000
3.0,14.0,63.0,808,19,01,  Sheran  Para,47,141,36,61,11,80,25.0,37.1,12.1,00000
3.0,14.0,63.0,808,20,01,  Basanta Para & Bagan Para,33,156,22,64,11,92,17.5,25.6,10.7,00000
3.0,14.0,63.0,808,21,01,  Amtali Tang Changa Para,125,262,84,154,41,108,32.3,35.3,27.5,00000
3.0,14.0,63.0,808,22,01,  Amtali Marma Para,114,361,69,175,45,186,24.0,28.3,19.5,00000
3.0,14.0,63.0,808,23,01,  Noya Para,33,63,18,26,15,37,34.4,40.9,28.8,00000
3.0,14.0,63.0,808,24,01,  Gonesh Para,62,142,48,105,14,37,30.4,31.4,27.5,00000
3.0,14.0,63.0,808,25,01,  Prafulla Para,57,112,39,85,18,27,33.7,31.5,40.0,00000
3.0,14.0,63.0,808,26,01,  Ching Pru Para,14,10,10,6,4,4,58.3,62.5,50.0,00000
3.0,14.0,63.0,808,27,01,  Lamba Raster Para,69,148,42,76,27,72,31.8,35.6,27.3,00000
3.0,14.0,79.0,248,01,01,  Safiqur Rahman Para,17,60,11,34,6,26,22.1,24.4,18.8,00000
3.0,14.0,79.0,248,02,01,  Lakri Para,10,74,6,34,4,40,11.9,15.0,9.1,00000
3.0,14.0,79.0,248,03,01,  Nutan Miza Para & Cmakkoy Para,3,80,2,42,1,38,3.6,4.5,2.6,00000
3.0,14.0,79.0,248,04,01,  Miza Para,11,73,9,33,2,40,13.1,21.4,4.8,00000
3.0,14.0,79.0,248,05,01,  Bali Para,8,80,5,41,3,39,9.1,10.9,7.1,00000
3.0,14.0,79.0,248,06,01,  Hatirdera Para,4,28,2,12,2,16,12.5,14.3,11.1,00000
3.0,14.0,79.0,248,07,01,  Fenai Karbari Para,16,100,10,43,6,57,13.8,18.9,9.5,00000
3.0,14.0,79.0,248,08,01,  Chimbuk Para,24,241,17,124,7,117,9.1,12.1,5.6,00000
3.0,14.0,79.0,248,09,01,  Naring Para & Aungla Para,0,48,0,22,0,26,0.0,0.0,0.0,00000
3.0,14.0,79.0,248,10,01,  Mering Para,3,73,2,35,1,38,3.9,5.4,2.6,00000
3.0,14.0,79.0,248,11,01,  Ramju Para,10,43,8,23,2,20,18.9,25.8,9.1,00000
3.0,14.0,79.0,248,12,01,  Haimra Para,72,159,56,91,16,68,31.2,38.1,19.0,00000
3.0,14.0,79.0,248,13,01,  Chimbuk Towar & Comondty Centr,6,7,4,4,2,3,46.2,50.0,40.0,00000
3.0,14.0,79.0,310,01,01,  Chinkruk Para,7,79,6,28,1,51,8.1,17.6,1.9,00000
3.0,14.0,79.0,310,02,01,  Khangjang Para,1,84,1,40,0,44,1.2,2.4,0.0,00000
3.0,14.0,79.0,310,03,01,  Krung  Tang Para,20,105,15,59,5,46,16.0,20.3,9.8,00000
3.0,14.0,79.0,310,04,01,  Laru  Para,1,60,1,30,0,30,1.6,3.2,0.0,00000
3.0,14.0,79.0,310,05,01,  Markinna Para,0,85,0,40,0,45,0.0,0.0,0.0,00000
3.0,14.0,79.0,310,06,01,  Ching Crati Para/Kanku,3,65,2,31,1,34,4.4,6.1,2.9,00000
3.0,14.0,79.0,870,01,01,  Chini Para,8,187,6,100,2,87,4.1,5.7,2.2,00000
3.0,14.0,79.0,870,02,01,  Dari  Para,0,70,0,30,0,40,0.0,0.0,0.0,00000
3.0,14.0,79.0,870,03,01,  Kaytang Para,7,71,6,29,1,42,9.0,17.1,2.3,00000
3.0,14.0,79.0,870,04,01,  Ampu Para,8,55,6,20,2,35,12.7,23.1,5.4,00000
3.0,14.0,79.0,870,05,01,  Ayuk Para,1,23,0,14,1,9,4.2,0.0,10.0,00000
3.0,14.0,79.0,870,06,01,  Napang Para,0,35,0,15,0,20,0.0,0.0,0.0,00000
3.0,14.0,79.0,870,07,01,  Patue Para,1,53,1,29,0,24,1.9,3.3,0.0,00000
3.0,14.0,79.0,870,08,01,  New Ramju Para,1,94,1,44,0,50,1.1,2.2,0.0,00000
3.0,14.0,79.0,932,01,01,  Zumlai  Para/Buetta Para,9,223,7,132,2,91,3.9,5.0,2.2,00000
3.0,14.0,79.0,932,02,01,  Menrung  Para/Kakdue Para,1,40,1,17,0,23,2.4,5.6,0.0,00000
3.0,14.0,79.0,932,03,01,  Lata Jhiri Para/New Patue Pa,2,61,2,30,0,31,3.2,6.3,0.0,00000
3.0,14.0,79.0,932,04,01,  Chakm Purnabasan Para,8,90,5,53,3,37,8.2,8.6,7.5,00000
3.0,14.0,79.0,932,05,01,  Tripura Purnabasan Para,6,60,4,32,2,28,9.1,11.1,6.7,00000
3.0,14.0,79.0,932,06,01,  Tankabati Headman Para/Noapa,8,234,7,132,1,102,3.3,5.0,1.0,00000
3.0,14.0,79.0,932,07,01,  Forest Office Area,11,89,9,76,2,13,11.0,10.6,13.3,00000
3.0,14.0,79.0,995,01,01,  Ali Nagar,5,76,5,39,0,37,6.2,11.4,0.0,00000
3.0,14.0,79.0,995,02,01,  Chander Para,22,184,14,101,8,83,10.7,12.2,8.8,00000
3.0,14.0,79.0,995,03,01,  Baitta Para,21,238,16,107,5,131,8.1,13.0,3.7,00000
3.0,14.0,79.0,995,04,01,  Ramri   Para,53,145,48,56,5,89,26.8,46.2,5.3,00000
3.0,14.0,79.0,995,05,01,  Bagan  Para,24,89,21,35,3,54,21.2,37.5,5.3,00000
3.0,14.0,79.0,995,06,01,  Asur Para/Brick Field,3,43,3,21,0,22,6.5,12.5,0.0,00000
3.0,14.0,79.0,995,07,01,  Nuitan Bangali Para,11,32,5,15,6,17,25.6,25.0,26.1,00000
3.0,14.0,79.0,995,08,01,  Nutan Murung Para,20,172,15,76,5,96,10.4,16.5,5.0,00000
3.0,14.0,79.0,995,09,01,  Chakma Para,49,58,31,29,18,29,45.8,51.7,38.3,00000
3.0,51.0,15.0,110,01,01,  Amtali Para,72,163,41,74,31,89,30.6,35.7,25.8,00000
3.0,51.0,15.0,110,02,01,  Dullia Para,9,105,5,45,4,60,7.9,10.0,6.3,00000
3.0,51.0,15.0,110,03,01,  Gurulora Para,34,188,20,90,14,98,15.3,18.2,12.5,00000
3.0,51.0,15.0,110,04,01,  Chala Aung Para,53,99,30,51,23,48,34.9,37.0,32.4,00000
3.0,51.0,15.0,110,05,01,  Kracho Aung Mrung Para,0,95,0,50,0,45,0.0,0.0,0.0,00000
3.0,51.0,15.0,110,07,01,  Chandakul Para,12,14,8,8,4,6,46.2,50.0,40.0,00000
3.0,51.0,15.0,110,08,01,  Chairman Para,663,384,375,158,288,226,63.3,70.4,56.0,00000
3.0,51.0,15.0,110,09,01,  Headman Para,178,240,112,93,66,147,42.6,54.6,31.0,00000
3.0,51.0,15.0,110,10,01,  Sattar Match Fact.Elaka Rd.,126,44,75,23,51,21,74.1,76.5,70.8,00000
3.0,51.0,15.0,110,12,01,  Aziz Factory Para,107,22,96,22,11,0,82.9,81.4,100.0,00000
3.0,51.0,15.0,110,14,01,  Talunia Para,124,299,62,142,62,157,29.3,30.4,28.3,00000
3.0,51.0,15.0,110,15,01,  Sandwip Para,85,46,46,21,39,25,64.9,68.7,60.9,00000
3.0,51.0,15.0,110,16,01,  Kattali Para,14,17,6,11,8,6,45.2,35.3,57.1,00000
3.0,51.0,15.0,110,17,01,  Harinmara Para,105,160,63,88,42,72,39.6,41.7,36.8,00000
3.0,51.0,15.0,110,18,01,  Cheoni Mostapa Para,14,28,8,11,6,17,33.3,42.1,26.1,00000
3.0,51.0,15.0,110,19,01,  Sajramtri Para,53,24,33,10,20,14,68.8,76.7,58.8,00000
3.0,51.0,15.0,110,20,01,  Fordhan Jhiripara,23,86,9,47,14,39,21.1,16.1,26.4,00000
3.0,51.0,15.0,110,21,01,  Khyanjhiri Para,19,61,14,29,5,32,23.8,32.6,13.5,00000
3.0,51.0,15.0,110,22,01,  Himchhari Para,110,234,58,108,52,126,32.0,34.9,29.2,00000
3.0,51.0,15.0,110,23,01,  Uttar Aziznagar Para,192,313,104,145,88,168,38.0,41.8,34.4,00000
3.0,51.0,15.0,110,25,01,  Hatirdora Para,126,95,64,44,62,51,57.0,59.3,54.9,00000
3.0,51.0,15.0,110,26,01,  Kashem Para,1,11,0,6,1,5,8.3,0.0,16.7,00000
3.0,51.0,15.0,110,27,01,  Peyalatali Para,80,104,37,54,43,50,43.5,40.7,46.2,00000
3.0,51.0,15.0,110,29,01,  Chambi Mafiz Bazar,33,22,30,18,3,4,60.0,62.5,42.9,00000
3.0,51.0,15.0,110,30,01,  Road Para,94,127,49,67,45,60,42.5,42.2,42.9,00000
3.0,51.0,15.0,110,31,01,  Muslim Para,102,135,65,49,37,86,43.0,57.0,30.1,00000
3.0,51.0,15.0,110,32,01,  Talinnha Para,166,4,70,3,96,1,97.6,95.9,99.0,00000
3.0,51.0,15.0,110,33,01,  Mison  Para,470,232,253,101,217,131,67.0,71.5,62.4,00000
3.0,51.0,15.0,110,34,01,  Imam Para,37,44,20,21,17,23,45.7,48.8,42.5,00000
3.0,51.0,15.0,110,35,01,  Tohid Para,25,28,19,11,6,17,47.2,63.3,26.1,00000
3.0,51.0,15.0,110,36,01,  Asraf Para,33,24,18,9,15,15,57.9,66.7,50.0,00000
3.0,51.0,15.0,110,37,01,  Ananda Tri Para,69,45,37,20,32,25,60.5,64.9,56.1,00000
3.0,51.0,15.0,110,38,01,  Saraar Para,40,43,23,17,17,26,48.2,57.5,39.5,00000
3.0,51.0,15.0,110,39,01,  Mizan Para,40,17,23,7,17,10,70.2,76.7,63.0,00000
3.0,51.0,15.0,110,40,01,  Qddus Para,89,112,51,49,38,63,44.3,51.0,37.6,00000
3.0,51.0,15.0,110,41,01,  Rabhar Bagan Para,16,13,14,11,2,2,55.2,56.0,50.0,00000
3.0,51.0,15.0,110,42,01,  Doarkhata Para,19,23,14,16,5,7,45.2,46.7,41.7,00000
3.0,51.0,15.0,110,43,01,  Sottasiruni Para,11,23,6,11,5,12,32.4,35.3,29.4,00000
3.0,51.0,15.0,110,45,01,  Danumia Para,57,44,28,19,29,25,56.4,59.6,53.7,00000
3.0,51.0,15.0,110,46,01,  Nurul Alam Para,44,57,25,27,19,30,43.6,48.1,38.8,00000
3.0,51.0,15.0,110,47,01,  Mastar Para,40,62,23,26,17,36,39.2,46.9,32.1,00000
3.0,51.0,15.0,110,49,01,  Janay Alam Para,64,64,34,31,30,33,50.0,52.3,47.6,00000
3.0,51.0,15.0,110,50,01,  Gias Para,73,57,35,30,38,27,56.2,53.8,58.5,00000
3.0,51.0,15.0,110,51,01,  Zahed Para,66,58,37,29,29,29,53.2,56.1,50.0,00000
3.0,51.0,15.0,110,52,01,  Anwar Para,65,108,26,57,39,51,37.6,31.3,43.3,00000
3.0,51.0,15.0,110,53,01,  Kair Para,28,161,19,69,9,92,14.8,21.6,8.9,00000
3.0,51.0,15.0,110,54,01,  Ahid Para,88,147,44,75,44,72,37.4,37.0,37.9,00000
3.0,51.0,15.0,110,55,01,  Baksadang Para,45,33,29,17,16,16,57.7,63.0,50.0,00000
3.0,51.0,15.0,110,56,01,  Lamujhiri Para,29,162,14,75,15,87,15.2,15.7,14.7,00000
3.0,51.0,27.0,387,01,01,  Padu Chhara Para,28,233,16,160,12,73,10.7,9.1,14.1,00000
3.0,51.0,27.0,387,02,01,  Headman Para,117,412,95,200,22,212,22.1,32.2,9.4,00000
3.0,51.0,27.0,387,03,01,  Khederband Para,183,331,90,155,93,176,35.6,36.7,34.6,00000
3.0,51.0,27.0,387,04,01,  Mognama Para,143,312,79,180,64,132,31.4,30.5,32.7,00000
3.0,51.0,27.0,387,05,01,  Amtali Para,82,48,45,27,37,21,63.1,62.5,63.8,00000
3.0,51.0,27.0,387,06,01,  Mong Potuai Para,44,278,40,161,4,117,13.7,19.9,3.3,00000
3.0,51.0,27.0,387,07,01,  Kariaung Para,9,76,5,42,4,34,10.6,10.6,10.5,00000
3.0,51.0,27.0,387,10,01,  Harin Khaia Para,35,229,30,177,5,52,13.3,14.5,8.8,00000
3.0,51.0,27.0,387,11,01,  Kahijja Para,56,142,40,80,16,62,28.3,33.3,20.5,00000
3.0,51.0,27.0,387,12,01,  Mong Bha Ching Para,35,219,23,150,12,69,13.8,13.3,14.8,00000
3.0,51.0,27.0,387,13,01,  Kandakhiya Para,4,15,4,5,0,10,21.1,44.4,0.0,00000
3.0,51.0,27.0,387,14,01,  Anching Para,11,39,9,19,2,20,22.0,32.1,9.1,00000
3.0,51.0,27.0,387,15,01,  Lambasia Para,55,163,43,121,12,42,25.2,26.2,22.2,00000
3.0,51.0,27.0,387,16,01,  Rangarjhiri Para,80,195,29,97,51,98,29.1,23.0,34.2,00000
3.0,51.0,27.0,387,17,01,  Bara Muslim Para,41,60,23,31,18,29,40.6,42.6,38.3,00000
3.0,51.0,27.0,387,19,01,  Meonda Muslim Para,55,95,26,48,29,47,36.7,35.1,38.2,00000
3.0,51.0,27.0,387,20,01,  Dhulla Chhari Para,138,333,63,171,75,162,29.3,26.9,31.6,00000
3.0,51.0,27.0,387,21,01,  Sutabadi Para,278,452,136,210,142,242,38.1,39.3,37.0,00000
3.0,51.0,27.0,387,23,01,  Ramchhari Para,57,17,37,10,20,7,77.0,78.7,74.1,00000
3.0,51.0,27.0,387,24,01,  Bangali Para,15,117,12,65,3,52,11.4,15.6,5.5,00000
3.0,51.0,27.0,387,25,01,  Malla Jhiri Para,19,157,12,85,7,72,10.8,12.4,8.9,00000
3.0,51.0,27.0,387,26,01,  Rowaza Para,31,178,21,101,10,77,14.8,17.2,11.5,00000
3.0,51.0,27.0,387,27,01,  Pattara Para,74,72,42,31,32,41,50.7,57.5,43.8,00000
3.0,51.0,27.0,387,28,01,  Sonai Chhari Para,70,83,40,44,30,39,45.8,47.6,43.5,00000
3.0,51.0,27.0,387,29,01,  Cuni Ziri Para,4,28,2,16,2,12,12.5,11.1,14.3,00000
3.0,51.0,27.0,387,30,01,  Chubetali Para,96,238,76,161,20,77,28.7,32.1,20.6,00000
3.0,51.0,27.0,387,31,01,  Naya Para,479,314,237,127,242,187,60.4,65.1,56.4,00000
3.0,51.0,27.0,387,32,01,  Burir Chikan Para,92,220,44,104,48,116,29.5,29.7,29.3,00000
3.0,51.0,27.0,387,36,01,  Aungratali Para,61,94,34,44,27,50,39.4,43.6,35.1,00000
3.0,51.0,27.0,387,37,01,  Siortali Para,73,108,41,60,32,48,40.3,40.6,40.0,00000
3.0,51.0,27.0,387,38,01,  Bazar Para,39,147,21,73,18,74,21.0,22.3,19.6,00000
3.0,51.0,27.0,387,39,01,  Thandhar Jhiri Para,15,41,8,23,7,18,26.8,25.8,28.0,00000
3.0,51.0,27.0,387,40,01,  Karbinatri Para,34,89,21,42,13,47,27.6,33.3,21.7,00000
3.0,51.0,27.0,387,41,01,  Malichand Para,23,65,16,34,7,31,26.1,32.0,18.4,00000
3.0,51.0,27.0,387,42,01,  Kauchin Kharbari Para,15,109,11,48,4,61,12.1,18.6,6.2,00000
3.0,51.0,27.0,387,43,01,  Polao Para,16,24,8,13,8,11,40.0,38.1,42.1,00000
3.0,51.0,27.0,387,44,01,  Mayaungda Para,113,110,60,64,53,46,50.7,48.4,53.5,00000
3.0,51.0,27.0,387,45,01,  Raikka Kolha Para,147,162,93,88,54,74,47.6,51.4,42.2,00000
3.0,51.0,27.0,387,46,01,  Muslim Para,72,156,31,73,41,83,31.6,29.8,33.1,00000
3.0,51.0,31.0,442,01,01,  Bichanar Chhara Para,56,180,29,91,27,89,23.7,24.2,23.3,00000
3.0,51.0,31.0,442,02,01,  Pannar Para,96,128,51,64,45,64,42.9,44.3,41.3,00000
3.0,51.0,31.0,442,03,01,  Rangajhiri Para,169,302,81,150,88,152,35.9,35.1,36.7,00000
3.0,51.0,31.0,442,04,01,  Khalkuila Para,42,138,15,66,27,72,23.3,18.5,27.3,00000
3.0,51.0,31.0,442,05,01,  Morajhiri Para,76,165,42,76,34,89,31.5,35.6,27.6,00000
3.0,51.0,31.0,442,06,01,  Ishkata Para,79,183,37,88,42,95,30.2,29.6,30.7,00000
3.0,51.0,31.0,442,09,01,  Murongjhiri Para,13,200,8,102,5,98,6.1,7.3,4.9,00000
3.0,51.0,31.0,442,10,01,  Banshkali Para,72,167,30,86,42,81,30.1,25.9,34.1,00000
3.0,51.0,31.0,442,12,01,  Bamhatir Chhara Para,106,151,60,77,46,74,41.2,43.8,38.3,00000
3.0,51.0,31.0,442,13,01,  Danhatir Chhara Para,125,350,66,167,59,183,26.3,28.3,24.4,00000
3.0,51.0,31.0,442,14,01,  Hadarnasi Para,1152,1581,547,762,605,819,42.2,41.8,42.5,00000
3.0,51.0,31.0,442,15,01,  Angsharjhiri Para,48,181,21,95,27,86,21.0,18.1,23.9,00000
3.0,51.0,31.0,442,16,01,  Uttar Maleumma Para,112,403,51,192,61,211,21.7,21.0,22.4,00000
3.0,51.0,31.0,442,17,01,  Burijhom Para,11,80,6,65,5,15,12.1,8.5,25.0,00000
3.0,51.0,31.0,442,18,01,  Bagaichhari Para,231,198,119,86,112,112,53.8,58.0,50.0,00000
3.0,51.0,31.0,442,19,01,  Rankhla Para,184,272,105,128,79,144,40.4,45.1,35.4,00000
3.0,51.0,31.0,442,21,01,  Goalmara Para,14,42,5,22,9,20,25.0,18.5,31.0,00000
3.0,51.0,31.0,442,22,01,  Gilatali Para,132,130,73,59,59,71,50.4,55.3,45.4,00000
3.0,51.0,31.0,442,23,01,  Kachukhola Para,20,41,11,19,9,22,32.8,36.7,29.0,00000
3.0,51.0,31.0,442,24,01,  Kumari Para,213,444,102,269,111,175,32.4,27.5,38.8,00000
3.0,51.0,31.0,442,25,01,  Bara Sankhola Para,45,184,32,104,13,80,19.7,23.5,14.0,00000
3.0,51.0,31.0,442,26,01,  Nalbun Para,46,175,25,90,21,85,20.8,21.7,19.8,00000
3.0,51.0,31.0,442,27,01,  Dhochhari Muslim Para,106,163,53,72,53,91,39.4,42.4,36.8,00000
3.0,51.0,31.0,442,28,01,  Pagliraga Para,170,489,88,275,82,214,25.8,24.2,27.7,00000
3.0,51.0,31.0,442,29,01,  Kuruk Patar Jhiri Para,150,248,77,126,73,122,37.7,37.9,37.4,00000
3.0,51.0,31.0,442,30,01,  Hargachha Para,84,262,44,130,40,132,24.3,25.3,23.3,00000
3.0,51.0,31.0,442,31,01,  Abdullar Jhiri Para,62,265,32,134,30,131,19.0,19.3,18.6,00000
3.0,51.0,31.0,442,32,01,  Fakirkhola Para,149,213,70,118,79,95,41.2,37.2,45.4,00000
3.0,51.0,31.0,442,33,01,  Sapergara Para,143,622,82,304,61,318,18.7,21.2,16.1,00000
3.0,51.0,31.0,442,34,01,  Lailarmar Para,110,335,49,170,61,165,24.7,22.4,27.0,00000
3.0,51.0,31.0,442,35,01,  Headman Para,78,419,44,239,34,180,15.7,15.5,15.9,00000
3.0,51.0,31.0,884,01,01,  Ramgati Para,20,180,16,84,4,96,10.0,16.0,4.0,00000
3.0,51.0,31.0,884,03,01,  Rowza Murong Para,0,213,0,93,0,120,0.0,0.0,0.0,00000
3.0,51.0,31.0,884,04,01,  Sumak Khola,4,237,4,121,0,116,1.7,3.2,0.0,00000
3.0,51.0,31.0,884,06,01,  Muslim Para,54,177,33,95,21,82,23.4,25.8,20.4,00000
3.0,51.0,31.0,884,07,01,  Row Headman Para,4,49,3,20,1,29,7.5,13.0,3.3,00000
3.0,51.0,31.0,884,08,01,  Soti KarbariTri.Para,3,119,2,63,1,56,2.5,3.1,1.8,00000
3.0,51.0,31.0,884,09,01,  Amtoli Para,26,201,19,99,7,102,11.5,16.1,6.4,00000
3.0,51.0,31.0,884,12,01,  Goial Mara,75,381,58,181,17,200,16.4,24.3,7.8,00000
3.0,51.0,31.0,994,01,01,  Pailajhiri Para,15,58,11,29,4,29,20.5,27.5,12.1,00000
3.0,51.0,31.0,994,02,01,  Membar Para,487,757,270,360,217,397,39.1,42.9,35.3,00000
3.0,51.0,31.0,994,03,01,  Aogri Para,57,169,26,84,31,85,25.2,23.6,26.7,00000
3.0,51.0,31.0,994,04,01,  Khilkhata Para,26,44,10,23,16,21,37.1,30.3,43.2,00000
3.0,51.0,31.0,994,05,01,  Himchhari Para,175,432,100,227,75,205,28.8,30.6,26.8,00000
3.0,51.0,31.0,994,06,01,  Katrol Chhara Para,83,205,53,93,30,112,28.8,36.3,21.1,00000
3.0,51.0,31.0,994,07,01,  Headman Para,70,237,37,112,33,125,22.8,24.8,20.9,00000
3.0,51.0,31.0,994,08,01,  Kalir Jhiri Para,20,100,11,47,9,53,16.7,19.0,14.5,00000
3.0,51.0,31.0,994,09,01,  Monchasui Para,66,307,41,145,25,162,17.7,22.0,13.4,00000
3.0,51.0,31.0,994,10,01,  Bonful Para,44,213,37,110,7,103,17.1,25.2,6.4,00000
3.0,51.0,31.0,994,11,01,  Bara Para,105,314,67,131,38,183,25.1,33.8,17.2,00000
3.0,51.0,31.0,994,12,01,  Chompot Murong Para,0,32,0,22,0,10,0.0,0.0,0.0,00000
3.0,51.0,31.0,994,13,01,  Thandar Jhiri Para,26,198,18,101,8,97,11.6,15.1,7.6,00000
3.0,51.0,31.0,994,14,01,  Khaikkar Jhiri Para,8,41,4,21,4,20,16.3,16.0,16.7,00000
3.0,51.0,31.0,994,15,01,  Puang Bari Para,37,432,25,248,12,184,7.9,9.2,6.1,00000
3.0,51.0,47.0,055,01,01,  Gainga Para,192,234,123,110,69,124,45.1,52.8,35.8,00000
3.0,51.0,47.0,055,02,01,  Biash Fari Headman Para,50,77,32,29,18,48,39.4,52.5,27.3,00000
3.0,51.0,47.0,055,03,01,  Bara Para,87,169,54,75,33,94,34.0,41.9,26.0,00000
3.0,51.0,47.0,055,04,01,  Dakir Chara Para,25,66,17,32,8,34,27.5,34.7,19.0,00000
3.0,51.0,47.0,055,05,01,  Battali Para,130,553,72,292,58,261,19.0,19.8,18.2,00000
3.0,51.0,47.0,055,06,01,  Baishpari Notun Para,65,258,32,120,33,138,20.1,21.1,19.3,00000
3.0,51.0,47.0,055,07,01,  Borma Para,53,202,37,105,16,97,20.8,26.1,14.2,00000
3.0,51.0,47.0,221,01,01,  Araporajhira Para,13,198,8,121,5,77,6.2,6.2,6.1,00000
3.0,51.0,47.0,221,02,01,  Noa  Para,13,122,9,68,4,54,9.6,11.7,6.9,00000
3.0,51.0,47.0,221,03,01,  Kolikka Para,36,220,30,124,6,96,14.1,19.5,5.9,00000
3.0,51.0,47.0,221,04,01,  Chhoto Bomu Para,60,158,35,74,25,84,27.5,32.1,22.9,00000
3.0,51.0,47.0,221,05,01,  Panissakhal Para,1,81,1,46,0,35,1.2,2.1,0.0,00000
3.0,51.0,47.0,497,02,01,  Minjjhiri  Para,25,135,12,65,13,70,15.6,15.6,15.7,00000
3.0,51.0,47.0,497,03,01,  Sapmara Jhiri  Para,80,170,42,93,38,77,32.0,31.1,33.0,00000
3.0,51.0,47.0,497,04,01,  Manikjan Para,76,128,47,42,29,86,37.3,52.8,25.2,00000
3.0,51.0,47.0,497,06,01,  Durjadhan Para,17,147,12,63,5,84,10.4,16.0,5.6,00000
3.0,51.0,47.0,497,07,01,  Gatiram Para,92,260,48,133,44,127,26.1,26.5,25.7,00000
3.0,51.0,47.0,497,09,01,  Ray Ongse Para,23,70,11,34,12,36,24.7,24.4,25.0,00000
3.0,51.0,47.0,497,10,01,  Akiram Para,98,381,64,187,34,194,20.5,25.5,14.9,00000
3.0,51.0,47.0,497,11,01,  Rasonga Para,27,163,16,76,11,87,14.2,17.4,11.2,00000
3.0,51.0,47.0,497,13,01,  Keholachng Para,96,406,67,211,29,195,19.1,24.1,12.9,00000
3.0,51.0,47.0,497,15,01,  Reong Para,44,325,30,176,14,149,11.9,14.6,8.6,00000
3.0,51.0,47.0,497,16,01,  Gajalia Headman Para,135,268,73,122,62,146,33.5,37.4,29.8,00000
3.0,51.0,47.0,497,17,01,  Bongo Para,110,114,66,44,44,70,49.1,60.0,38.6,00000
3.0,51.0,47.0,497,18,01,  Gajalia Bazar Para,135,174,104,90,31,84,43.7,53.6,27.0,00000
3.0,51.0,47.0,497,19,01,  Aongthoaicha Para,8,117,5,64,3,53,6.4,7.2,5.4,00000
3.0,51.0,47.0,497,20,01,  Mohammed Para,255,389,154,190,101,199,39.6,44.8,33.7,00000
3.0,51.0,47.0,497,21,01,  Khrijjanuna Osman Para,50,194,26,139,24,55,20.5,15.8,30.4,00000
3.0,51.0,47.0,718,01,01,  Chintaba Para,59,610,38,292,21,318,8.8,11.5,6.2,00000
3.0,51.0,47.0,718,02,01,  Bochha Para,5,178,3,100,2,78,2.7,2.9,2.5,00000
3.0,51.0,47.0,718,03,01,  Talae Para,8,250,5,126,3,124,3.1,3.8,2.4,00000
3.0,51.0,47.0,718,04,01,  Aloke Para,17,273,13,161,4,112,5.9,7.5,3.4,00000
3.0,51.0,47.0,718,05,01,  Lulaing Headman Para,44,247,33,136,11,111,15.1,19.5,9.0,00000
3.0,51.0,47.0,718,06,01,  Kalabara Para,12,137,11,80,1,57,8.1,12.1,1.7,00000
3.0,51.0,63.0,166,01,01,  Hospital Para,137,179,80,82,57,97,43.4,49.4,37.0,00000
3.0,51.0,63.0,166,02,01,  Sokuntoly,13,32,6,19,7,13,28.9,24.0,35.0,00000
3.0,51.0,63.0,166,03,01,  Roza Ziry,20,33,9,19,11,14,37.7,32.1,44.0,00000
3.0,51.0,63.0,166,04,01,  Modu Ziry,37,122,14,59,23,63,23.3,19.2,26.7,00000
3.0,51.0,63.0,166,05,01,  Hospital Pahary Ziry Para,103,116,49,56,54,60,47.0,46.7,47.4,00000
3.0,51.0,63.0,166,06,01,  Nunar Ziry,76,153,37,71,39,82,33.2,34.3,32.2,00000
3.0,51.0,63.0,166,07,01,  Miringa,19,64,8,30,11,34,22.9,21.1,24.4,00000
3.0,51.0,63.0,166,08,01,  Line Ziry,86,69,40,33,46,36,55.5,54.8,56.1,00000
3.0,51.0,63.0,166,09,01,  Combot Para,2,110,2,61,0,49,1.8,3.2,0.0,00000
3.0,51.0,63.0,166,10,01,  Dakkin Silattoa,50,83,28,39,22,44,37.6,41.8,33.3,00000
3.0,51.0,63.0,166,11,01,  Dakaita Ziry,30,71,13,39,17,32,29.7,25.0,34.7,00000
3.0,51.0,63.0,607,01,01,  Kalumurong Para,81,340,43,171,38,169,19.2,20.1,18.4,00000
3.0,51.0,63.0,607,02,01,  Begunna Jhiri Para,105,123,51,70,54,53,46.1,42.1,50.5,00000
3.0,51.0,63.0,607,03,01,  Mera Khola Hindu Para,116,100,71,40,45,60,53.7,64.0,42.9,00000
3.0,51.0,63.0,607,04,01,  Mera Khola Muslim Para,247,490,129,235,118,255,33.5,35.4,31.6,00000
3.0,51.0,63.0,607,05,01,  Headman Para,37,191,27,93,10,98,16.2,22.5,9.3,00000
3.0,51.0,63.0,607,06,01,  Boillar Chhar Para,168,507,97,234,71,273,24.9,29.3,20.6,00000
3.0,51.0,63.0,607,07,01,  Asram Para,311,639,178,307,133,332,32.7,36.7,28.6,00000
3.0,51.0,63.0,828,01,01,  Chianirmukh Para,0,84,0,48,0,36,0.0,0.0,0.0,00000
3.0,51.0,63.0,828,02,01,  Taimurung Para,6,170,5,84,1,86,3.4,5.6,1.1,00000
3.0,51.0,63.0,828,04,01,  Panshi Para,0,136,0,71,0,65,0.0,0.0,0.0,00000
3.0,51.0,63.0,828,05,01,  Kai Murong Para,0,37,0,19,0,18,0.0,0.0,0.0,00000
3.0,51.0,63.0,828,06,01,  Kangku Murong Para,0,34,0,17,0,17,0.0,0.0,0.0,00000
3.0,51.0,63.0,828,07,01,  Ghila Para,39,183,25,86,14,97,17.6,22.5,12.6,00000
3.0,51.0,63.0,828,08,01,  Kairong Murong Para,64,140,35,76,29,64,31.4,31.5,31.2,00000
3.0,51.0,63.0,828,09,01,  Headman Para,113,148,74,64,39,84,43.3,53.6,31.7,00000
3.0,51.0,63.0,828,10,01,  Lakkhan Jhiri Para,26,133,18,69,8,64,16.4,20.7,11.1,00000
3.0,51.0,63.0,828,11,01,  Dochori Para,46,183,26,92,20,91,20.1,22.0,18.0,00000
3.0,51.0,63.0,828,13,01,  Sailank Para,0,65,0,34,0,31,0.0,0.0,0.0,00000
3.0,51.0,63.0,828,16,01,  Phif Para,1,79,1,35,0,44,1.3,2.8,0.0,00000
3.0,51.0,63.0,828,17,01,  Kristan Para,4,44,3,24,1,20,8.3,11.1,4.8,00000
3.0,51.0,68.0,331,01,01,  Siddique Para,114,160,53,94,61,66,41.6,36.1,48.0,00000
3.0,51.0,68.0,331,02,01,  Noyamong Para,29,28,15,10,14,18,50.9,60.0,43.8,00000
3.0,51.0,68.0,331,03,01,  Bamphiling Para,71,131,34,58,37,73,35.1,37.0,33.6,00000
3.0,51.0,68.0,331,04,01,  Bidya Bhita Para,132,306,60,154,72,152,30.1,28.0,32.1,00000
3.0,51.0,68.0,331,05,01,  Tailla Bhita Para,118,203,66,109,52,94,36.8,37.7,35.6,00000
3.0,51.0,68.0,331,06,01,  Choang Para,94,163,56,78,38,85,36.6,41.8,30.9,00000
3.0,51.0,68.0,331,07,01,  Thoaihala Para,99,261,50,125,49,136,27.5,28.6,26.5,00000
3.0,51.0,68.0,331,08,01,  Dulang Para,57,139,32,62,25,77,29.1,34.0,24.5,00000
3.0,51.0,68.0,331,09,01,  Mangsuipru Para,54,157,30,74,24,83,25.6,28.8,22.4,00000
3.0,51.0,68.0,331,10,01,  Dardari Noa Para,82,158,37,74,45,84,34.2,33.3,34.9,00000
3.0,51.0,68.0,331,11,01,  Ibrahim Leader Para,312,162,167,87,145,75,65.8,65.7,65.9,00000
3.0,51.0,68.0,331,12,01,  Pukuriakhala Para,51,153,24,75,27,78,25.0,24.2,25.7,00000
3.0,51.0,68.0,331,13,01,  Anghala Para,84,125,41,54,43,71,40.2,43.2,37.7,00000
3.0,51.0,68.0,331,14,01,  Halachhai Para,68,325,41,166,27,159,17.3,19.8,14.5,00000
3.0,51.0,68.0,331,15,01,  Murang Jhiri Para,101,215,49,121,52,94,32.0,28.8,35.6,00000
3.0,51.0,68.0,331,16,01,  Anghalarduri Para,62,139,40,72,22,67,30.8,35.7,24.7,00000
3.0,51.0,68.0,331,17,01,  Tear Jhiri Para,53,313,32,152,21,161,14.5,17.4,11.5,00000
3.0,51.0,68.0,331,18,01,  Badrasen Para,58,188,36,96,22,92,23.6,27.3,19.3,00000
3.0,51.0,68.0,331,19,01,  Nurali Para,31,99,17,52,14,47,23.8,24.6,23.0,00000
3.0,51.0,68.0,331,20,01,  Dardari Barura Para,66,171,39,83,27,88,27.8,32.0,23.5,00000
3.0,51.0,68.0,331,21,01,  Dardari Marma Para,10,195,9,84,1,111,4.9,9.7,0.9,00000
3.0,51.0,68.0,331,22,01,  Police Camp Para,32,69,18,26,14,43,31.7,40.9,24.6,00000
3.0,51.0,68.0,331,23,01,  Noya  Para,15,142,11,64,4,78,9.6,14.7,4.9,00000
3.0,51.0,68.0,331,24,01,  Opi Post Para,73,108,43,41,30,67,40.3,51.2,30.9,00000
3.0,51.0,68.0,331,25,01,  Bakhyang Mukh Para,41,212,28,102,13,110,16.2,21.5,10.6,00000
3.0,51.0,68.0,331,26,01,  Uthoai Para,14,123,8,57,6,66,10.2,12.3,8.3,00000
3.0,51.0,68.0,331,27,01,  Rupashi Bazar Para,141,130,100,68,41,62,52.0,59.5,39.8,00000
3.0,51.0,68.0,331,28,01,  Chingkong Para,23,202,17,102,6,100,10.2,14.3,5.7,00000
3.0,51.0,68.0,331,29,01,  Muslim Para,119,122,60,55,59,67,49.4,52.2,46.8,00000
3.0,51.0,68.0,331,30,01,  Gaji Para,68,107,43,63,25,44,38.9,40.6,36.2,00000
3.0,51.0,68.0,552,01,01,  Mongpru Para,15,126,9,74,6,52,10.6,10.8,10.3,00000
3.0,51.0,68.0,552,02,01,  Mechhong Para,12,211,7,113,5,98,5.4,5.8,4.9,00000
3.0,51.0,68.0,552,03,01,  Puna Para,9,226,6,116,3,110,3.8,4.9,2.7,00000
3.0,51.0,68.0,552,04,01,  Jamalpur Para,12,192,8,104,4,88,5.9,7.1,4.3,00000
3.0,51.0,68.0,552,05,01,  Rewang Para,3,246,3,131,0,115,1.2,2.2,0.0,00000
3.0,51.0,68.0,552,06,01,  Rupashi Marma  Para,3,87,1,42,2,45,3.3,2.3,4.3,00000
3.0,51.0,68.0,552,07,01,  Menthoai Para,11,156,6,76,5,80,6.6,7.3,5.9,00000
3.0,51.0,68.0,773,01,01,  Lama Agga Para,3,139,1,75,2,64,2.1,1.3,3.0,00000
3.0,51.0,68.0,773,02,01,  Alimong Babu Para,20,66,13,30,7,36,23.3,30.2,16.3,00000
3.0,51.0,68.0,773,03,01,  Reyang Para,0,85,0,41,0,44,0.0,0.0,0.0,00000
3.0,51.0,68.0,773,04,01,  Raja Para,3,71,3,41,0,30,4.1,6.8,0.0,00000
3.0,51.0,68.0,773,05,01,  Maikka Para,1,77,1,38,0,39,1.3,2.6,0.0,00000
3.0,51.0,68.0,773,06,01,  Menha Para,8,105,5,54,3,51,7.1,8.5,5.6,00000
3.0,51.0,68.0,773,07,01,  Chybon Headman Para,9,59,5,32,4,27,13.2,13.5,12.9,00000
3.0,51.0,79.0,276,01,01,  Devraj Miea Para,56,139,29,70,27,69,28.7,29.3,28.1,00000
3.0,51.0,79.0,276,02,01,  Battali Mogpara,21,73,10,31,11,42,22.3,24.4,20.8,00000
3.0,51.0,79.0,276,03,01,  Kalam Box Para,87,117,57,47,30,70,42.6,54.8,30.0,00000
3.0,51.0,79.0,276,04,01,  Fuitajhiri Para,26,148,12,73,14,75,14.9,14.1,15.7,00000
3.0,51.0,79.0,276,05,01,  Muslim Para,34,52,16,31,18,21,39.5,34.0,46.2,00000
3.0,51.0,79.0,276,06,01,  Bazar  Para,212,271,139,147,73,124,43.9,48.6,37.1,00000
3.0,51.0,79.0,276,07,01,  Kutubdia  Para,38,47,23,20,15,27,44.7,53.5,35.7,00000
3.0,51.0,79.0,276,09,01,  Keya Bania Para,18,83,11,40,7,43,17.8,21.6,14.0,00000
3.0,51.0,79.0,276,10,01,  Gangajan Para (Mazer),33,34,21,15,12,19,49.3,58.3,38.7,00000
3.0,51.0,79.0,276,11,01,  Dekir Chhara Para,10,103,8,63,2,40,8.8,11.3,4.8,00000
3.0,51.0,79.0,276,12,01,  Chiuar Chhara Para,1,93,1,38,0,55,1.1,2.6,0.0,00000
3.0,51.0,79.0,276,13,01,  Head Man  Para,54,48,30,21,24,27,52.9,58.8,47.1,00000
3.0,51.0,79.0,276,14,01,  Chakma Para,21,5,12,1,9,4,80.8,92.3,69.2,00000
3.0,51.0,79.0,276,15,01,  Jatky Bania Para,48,86,23,43,25,43,35.8,34.8,36.8,00000
3.0,51.0,79.0,276,16,01,  Kalma Khola Para,22,179,7,103,15,76,10.9,6.4,16.5,00000
3.0,51.0,79.0,276,17,01,  Dunsha Para,59,67,32,36,27,31,46.8,47.1,46.6,00000
3.0,51.0,79.0,276,18,01,  Aorj Para,104,83,56,35,48,48,55.6,61.5,50.0,00000
3.0,51.0,79.0,276,19,01,  Ishaq Member Para,37,73,22,37,15,36,33.6,37.3,29.4,00000
3.0,51.0,79.0,276,20,01,  Kampania Para,130,159,75,65,55,94,45.0,53.6,36.9,00000
3.0,51.0,79.0,276,21,01,  Lamoa Khola Para,182,320,106,161,76,159,36.3,39.7,32.3,00000
3.0,51.0,79.0,276,22,01,  Bachari Para,13,99,6,50,7,49,11.6,10.7,12.5,00000
3.0,51.0,79.0,276,23,01,  Folar Ahga Para,444,204,398,109,46,95,68.5,78.5,32.6,00000
3.0,51.0,79.0,276,24,01,  Adari Jamal Para,29,173,15,87,14,86,14.4,14.7,14.0,00000
3.0,51.0,79.0,276,25,01,  Tonga Jhiri Para,85,163,54,56,31,107,34.3,49.1,22.5,00000
3.0,51.0,79.0,276,26,01,  Kampo Para,10,7,6,2,4,5,58.8,75.0,44.4,00000
3.0,51.0,79.0,276,27,01,  Jhoge Candar Para,10,11,6,4,4,7,47.6,60.0,36.4,00000
3.0,51.0,79.0,276,28,01,  Sabiran Dara Para,84,85,45,38,39,47,49.7,54.2,45.3,00000
3.0,51.0,79.0,276,29,01,  Ghajar Para,43,189,30,105,13,84,18.5,22.2,13.4,00000
3.0,51.0,79.0,276,31,01,  Jumparay Para,7,89,3,43,4,46,7.3,6.5,8.0,00000
3.0,51.0,79.0,276,32,01,  Fordan Jhiri Para,25,147,16,70,9,77,14.5,18.6,10.5,00000
3.0,51.0,79.0,663,01,01,  Beng Para,6,100,4,49,2,51,5.7,7.5,3.8,00000
3.0,51.0,79.0,663,02,01,  Headman Para,1,68,1,30,0,38,1.4,3.2,0.0,00000
3.0,51.0,79.0,663,03,01,  Rangi Para,8,127,7,62,1,65,5.9,10.1,1.5,00000
3.0,51.0,79.0,663,04,01,  Monglai Para,1,50,1,23,0,27,2.0,4.2,0.0,00000
3.0,51.0,79.0,663,05,01,  Joarghaya Para,0,47,0,26,0,21,0.0,0.0,0.0,00000
3.0,51.0,79.0,663,06,01,  Dewan Para,1,106,1,52,0,54,0.9,1.9,0.0,00000
3.0,51.0,79.0,663,07,01,  Shalha Para,18,61,18,28,0,33,22.8,39.1,0.0,00000
3.0,51.0,79.0,663,08,01,  Amtali Para,0,84,0,49,0,35,0.0,0.0,0.0,00000
3.0,51.0,79.0,663,09,01,  Khapora Para,13,165,6,78,7,87,7.3,7.1,7.4,00000
3.0,51.0,79.0,939,02,01,  Badur Baper Jara  Para,33,50,18,26,15,24,39.8,40.9,38.5,00000
3.0,51.0,79.0,939,03,01,  Uttar Dulla Para,16,145,10,64,6,81,9.9,13.5,6.9,00000
3.0,51.0,79.0,939,04,01,  Habur Rahman Para,99,198,42,105,57,93,33.3,28.6,38.0,00000
3.0,51.0,79.0,939,05,01,  South Dulla Para,35,237,19,115,16,122,12.9,14.2,11.6,00000
3.0,51.0,79.0,939,06,01,  Amir Hamja Para,139,150,78,91,61,59,48.1,46.2,50.8,00000
3.0,51.0,79.0,939,07,01,  Salam Para,7,87,4,41,3,46,7.4,8.9,6.1,00000
3.0,51.0,79.0,939,09,01,  Naissa Jhiri Para,106,138,60,74,46,64,43.4,44.8,41.8,00000
3.0,51.0,79.0,939,10,01,  Killar Chara Para,68,253,30,133,38,120,21.2,18.4,24.1,00000
3.0,51.0,79.0,939,12,01,  Toinna Para,87,140,43,70,44,70,38.3,38.1,38.6,00000
3.0,51.0,79.0,939,13,01,  Hasna Para.1,90,134,53,68,37,66,40.2,43.8,35.9,00000
3.0,51.0,79.0,939,14,01,  Folang Para,30,111,16,53,14,58,21.3,23.2,19.4,00000
3.0,51.0,79.0,939,17,01,  Farid Member Para,21,54,11,28,10,26,28.0,28.2,27.8,00000
3.0,51.0,79.0,939,19,01,  Noaya Para,4,129,3,70,1,59,3.0,4.1,1.7,00000
3.0,73.0,19.0,058,01,01,  Dhullya Ziri,23,81,12,41,11,40,22.1,22.6,21.6,00000
3.0,73.0,19.0,058,02,01,  Pora Ziri,12,19,8,8,4,11,38.7,50.0,26.7,00000
3.0,73.0,19.0,058,03,01,  Alekkhyong Para,101,131,65,66,36,65,43.5,49.6,35.6,00000
3.0,73.0,19.0,058,04,01,  Tutuk Khali,18,98,9,49,9,49,15.5,15.5,15.5,00000
3.0,73.0,19.0,058,05,01,  Head Man Para,5,51,2,23,3,28,8.9,8.0,9.7,00000
3.0,73.0,19.0,058,06,01,  Mirjiri Para,5,29,4,14,1,15,14.7,22.2,6.3,00000
3.0,73.0,19.0,058,07,01,  Hammara Ziri,1,38,1,22,0,16,2.6,4.3,0.0,00000
3.0,73.0,19.0,058,08,01,  Baddu Ziri,5,72,5,41,0,31,6.5,10.9,0.0,00000
3.0,73.0,19.0,175,01,01,  Tomim Golal Para.,39,197,20,98,19,99,16.5,16.9,16.1,00000
3.0,73.0,19.0,175,02,01,  Muiyaung Para,42,91,30,39,12,52,31.6,43.5,18.8,00000
3.0,73.0,19.0,175,03,01,  Uttar Karalia Mura,103,37,52,20,51,17,73.6,72.2,75.0,00000
3.0,73.0,19.0,175,04,01,  Shiapara,67,63,37,40,30,23,51.5,48.1,56.6,00000
3.0,73.0,19.0,175,05,01,  Karalia Murza,94,164,44,87,50,77,36.4,33.6,39.4,00000
3.0,73.0,19.0,175,06,01,  South Karalia Murza,102,99,42,47,60,52,50.7,47.2,53.6,00000
3.0,73.0,19.0,175,07,01,  Haladishia,258,602,142,263,116,339,30.0,35.1,25.5,00000
3.0,73.0,19.0,175,08,01,  Tuilong Para,74,121,42,57,32,64,37.9,42.4,33.3,00000
3.0,73.0,19.0,175,09,01,  Sailla Toli,1,66,1,38,0,28,1.5,2.6,0.0,00000
3.0,73.0,19.0,175,10,01,  Titer Para,26,177,15,89,11,88,12.8,14.4,11.1,00000
3.0,73.0,19.0,175,11,01,  Sadu Para,33,55,18,30,15,25,37.5,37.5,37.5,00000
3.0,73.0,19.0,175,12,01,  Zothokamer Para,227,218,111,109,116,109,51.0,50.5,51.6,00000
3.0,73.0,19.0,175,13,01,  Uparchak Para,48,127,30,50,18,77,27.4,37.5,18.9,00000
3.0,73.0,19.0,175,14,01,  Maddam Chakpara,73,72,45,28,28,44,50.3,61.6,38.9,00000
3.0,73.0,19.0,175,15,01,  Chak Headman Para,76,129,46,55,30,74,37.1,45.5,28.8,00000
3.0,73.0,19.0,175,16,01,  Natun Chakpara,60,82,30,40,30,42,42.3,42.9,41.7,00000
3.0,73.0,19.0,175,17,01,  East Baishari Para,147,152,70,81,77,71,49.2,46.4,52.0,00000
3.0,73.0,19.0,175,18,01,  Uttar Baishari,297,375,169,179,128,196,44.2,48.6,39.5,00000
3.0,73.0,19.0,175,19,01,  Tupanali Para,89,197,38,91,51,106,31.1,29.5,32.5,00000
3.0,73.0,19.0,175,20,01,  Ali Mia Para,55,85,26,43,29,42,39.3,37.7,40.8,00000
3.0,73.0,19.0,175,21,01,  Punarbashan Para,81,186,37,81,44,105,30.3,31.4,29.5,00000
3.0,73.0,19.0,175,22,01,  Daiyer Baper Para,28,265,15,132,13,133,9.6,10.2,8.9,00000
3.0,73.0,19.0,175,23,01,  Uttar Narish Bunia,101,154,51,69,50,85,39.6,42.5,37.0,00000
3.0,73.0,19.0,175,24,01,  South Narish Bunia,104,326,53,153,51,173,24.2,25.7,22.8,00000
3.0,73.0,19.0,175,25,01,  Harin Khaiya Para,58,162,36,69,22,93,26.4,34.3,19.1,00000
3.0,73.0,19.0,175,26,01,  Thimchari Para,19,69,10,32,9,37,21.6,23.8,19.6,00000
3.0,73.0,19.0,175,27,01,  Sagalkhiya Para,5,22,4,11,1,11,18.5,26.7,8.3,00000
3.0,73.0,19.0,175,28,01,  Maddam Baishari,285,427,175,228,110,199,40.0,43.4,35.6,00000
3.0,73.0,19.0,175,29,01,  Dabankhali Para,57,67,31,32,26,35,46.0,49.2,42.6,00000
3.0,73.0,19.0,175,30,01,  Godown Para,23,22,11,9,12,13,51.1,55.0,48.0,00000
3.0,73.0,19.0,175,31,01,  West Baishari,92,22,46,9,46,13,80.7,83.6,78.0,00000
3.0,73.0,19.0,175,32,01,  South Baishari,245,306,130,151,115,155,44.5,46.3,42.6,00000
3.0,73.0,19.0,175,33,01,  Lambabil,101,206,45,108,56,98,32.9,29.4,36.4,00000
3.0,73.0,19.0,409,01,01,  Kaguzikhola,143,219,91,115,52,104,39.5,44.2,33.3,00000
3.0,73.0,19.0,409,02,01,  Ziolchhara/Headmanpara,2,29,1,15,1,14,6.5,6.3,6.7,00000
3.0,73.0,19.0,409,03,01,  Athouimongpara,10,102,6,45,4,57,8.9,11.8,6.6,00000
3.0,73.0,19.0,409,04,01,  Keingarbil,4,220,3,119,1,101,1.8,2.5,1.0,00000
3.0,73.0,19.0,409,05,01,  Patal Kata,5,38,2,26,3,12,11.6,7.1,20.0,00000
3.0,73.0,19.0,409,06,01,  Kethoyai Para,108,364,70,216,38,148,22.9,24.5,20.4,00000
3.0,73.0,19.0,409,07,01,  Dalujhiri Para,3,94,3,48,0,46,3.1,5.9,0.0,00000
3.0,73.0,19.0,409,08,01,  Garzan Tali Para,1,32,1,18,0,14,3.0,5.3,0.0,00000
3.0,73.0,19.0,409,09,01,  Tripura Para,11,46,7,26,4,20,19.3,21.2,16.7,00000
3.0,73.0,19.0,409,10,01,  Chakma Para,1,59,1,28,0,31,1.7,3.4,0.0,00000
3.0,73.0,19.0,409,11,01,  Rangaziri,16,167,9,92,7,75,8.7,8.9,8.5,00000
3.0,73.0,19.0,409,12,01,  Baraichara,12,63,7,31,5,32,16.0,18.4,13.5,00000
3.0,73.0,19.0,585,01,01,  Khowaijhiri Para,0,88,0,48,0,40,0.0,0.0,0.0,00000
3.0,73.0,19.0,585,02,01,  Moshala Para,0,73,0,37,0,36,0.0,0.0,0.0,00000
3.0,73.0,19.0,585,03,01,  Namlea Para,0,76,0,40,0,36,0.0,0.0,0.0,00000
3.0,73.0,19.0,585,04,01,  Hatir Datziri Para,0,58,0,31,0,27,0.0,0.0,0.0,00000
3.0,73.0,19.0,585,05,01,  Charui Para(Headman Para),0,95,0,44,0,51,0.0,0.0,0.0,00000
3.0,73.0,19.0,585,06,01,  Harziri Para,0,41,0,21,0,20,0.0,0.0,0.0,00000
3.0,73.0,38.0,117,01,01,  Chagalkhiya,53,160,43,81,10,79,24.9,34.7,11.2,00000
3.0,73.0,38.0,117,02,01,  Longkhai,8,107,4,53,4,54,7.0,7.0,6.9,00000
3.0,73.0,38.0,117,03,01,  Mamabaginer Ziri+Childaziri,22,110,12,46,10,64,16.7,20.7,13.5,00000
3.0,73.0,38.0,117,04,01,  Lodur Muk+Hamirchara,49,109,29,62,20,47,31.0,31.9,29.9,00000
3.0,73.0,38.0,117,05,01,  Sikonchhari,35,177,20,90,15,87,16.5,18.2,14.7,00000
3.0,73.0,38.0,117,06,01,  Doluziri,31,185,20,99,11,86,14.4,16.8,11.3,00000
3.0,73.0,38.0,117,07,01,  Palankhai+Baichang,16,121,9,64,7,57,11.7,12.3,10.9,00000
3.0,73.0,38.0,117,08,01,  Muslempara & Mruinqhai,11,111,8,52,3,59,9.0,13.3,4.8,00000
3.0,73.0,38.0,292,01,01,  Kulachi,32,160,18,81,14,79,16.7,18.2,15.1,00000
3.0,73.0,38.0,292,02,01,  Lebutali Para,13,116,5,62,8,54,10.1,7.5,12.9,00000
3.0,73.0,38.0,292,03,01,  Harinkhiya Para,23,84,11,45,12,39,21.5,19.6,23.5,00000
3.0,73.0,38.0,292,04,01,  Oachakhali Para,46,146,21,68,25,78,24.0,23.6,24.3,00000
3.0,73.0,38.0,292,05,01,  Alpara,5,100,3,52,2,48,4.8,5.5,4.0,00000
3.0,73.0,38.0,292,06,01,  Kalur Ghat,36,164,19,77,17,87,18.0,19.8,16.3,00000
3.0,73.0,38.0,292,07,01,  Lemuchhari,89,268,47,124,42,144,24.9,27.5,22.6,00000
3.0,73.0,38.0,292,08,01,  Muslem Para/Mruinghai,20,64,12,28,8,36,23.8,30.0,18.2,00000
3.0,73.0,38.0,292,09,01,  Dolujiri,6,101,4,47,2,54,5.6,7.8,3.6,00000
3.0,73.0,38.0,292,10,01,  Zarulia Chhari,6,166,5,78,1,88,3.5,6.0,1.1,00000
3.0,73.0,38.0,292,11,01,  Tulatali,40,255,22,121,18,134,13.6,15.4,11.8,00000
3.0,73.0,38.0,292,12,01,  Shilghat,0,15,0,8,0,7,0.0,0.0,0.0,00000
3.0,73.0,38.0,292,13,01,  Guraniakata,14,199,8,107,6,92,6.6,7.0,6.1,00000
3.0,73.0,38.0,292,14,01,  Bahirmat,171,375,112,164,59,211,31.3,40.6,21.9,00000
3.0,73.0,38.0,292,15,01,  Painc-Hhari,33,164,21,86,12,78,16.8,19.6,13.3,00000
3.0,73.0,38.0,292,16,01,  Damerchhari,16,140,12,77,4,63,10.3,13.5,6.0,00000
3.0,73.0,38.0,292,17,01,  Headman Para,30,63,14,31,16,32,32.3,31.1,33.3,00000
3.0,73.0,38.0,292,18,01,  Pongraw/Langri/Niaz/Monpry,6,379,6,207,0,172,1.6,2.8,0.0,00000
3.0,73.0,38.0,292,19,01,  Mamabagani Giri,10,88,4,43,6,45,10.2,8.5,11.8,00000
3.0,73.0,38.0,463,01,01,  Chakpar,13,43,11,21,2,22,23.2,34.4,8.3,00000
3.0,73.0,38.0,463,02,01,  Keolsing Para/Raindo,45,48,26,17,19,31,48.4,60.5,38.0,00000
3.0,73.0,38.0,463,03,01,  Balath Murug Para,0,58,0,32,0,26,0.0,0.0,0.0,00000
3.0,73.0,38.0,526,01,01,  Reopara,2,27,1,13,1,14,6.9,7.1,6.7,00000
3.0,73.0,38.0,526,02,01,  Taylang Para,0,42,0,22,0,20,0.0,0.0,0.0,00000
3.0,73.0,38.0,526,03,01,  Earing Para,0,40,0,18,0,22,0.0,0.0,0.0,00000
3.0,73.0,38.0,526,04,01,  Headman Para,0,63,0,35,0,28,0.0,0.0,0.0,00000
3.0,73.0,38.0,526,05,01,  Layaung Para,0,34,0,14,0,20,0.0,0.0,0.0,00000
3.0,73.0,38.0,526,06,01,  Chak Para,34,62,25,28,9,34,35.4,47.2,20.9,00000
3.0,73.0,38.0,526,07,01,  Pungri Para,1,43,1,21,0,22,2.3,4.5,0.0,00000
3.0,73.0,38.0,526,08,01,  Tuing Para,0,28,0,14,0,14,0.0,0.0,0.0,00000
3.0,73.0,38.0,526,09,01,  Tripura Para,45,68,24,30,21,38,39.8,44.4,35.6,00000
3.0,73.0,38.0,526,11,01,  Kayang Para,8,25,6,12,2,13,24.2,33.3,13.3,00000
3.0,73.0,38.0,526,12,01,  Amziri Para,2,87,1,44,1,43,2.2,2.2,2.3,00000
3.0,73.0,38.0,526,13,01,  Rangdui Para,3,105,2,48,1,57,2.8,4.0,1.7,00000
3.0,73.0,38.0,936,01,01,  Targo Manthan Para,0,43,0,19,0,24,0.0,0.0,0.0,00000
3.0,73.0,38.0,936,02,01,  Elong Para,0,31,0,15,0,16,0.0,0.0,0.0,00000
3.0,73.0,38.0,936,03,01,  Angkay Para,0,39,0,18,0,21,0.0,0.0,0.0,00000
3.0,73.0,38.0,936,04,01,  Engli Para,0,30,0,16,0,14,0.0,0.0,0.0,00000
3.0,73.0,57.0,351,01,01,  Azukhiya,117,518,52,256,65,262,18.4,16.9,19.9,00000
3.0,73.0,57.0,351,02,01,  Barabil,102,112,48,60,54,52,47.7,44.4,50.9,00000
3.0,73.0,57.0,351,03,01,  Mogghat,180,447,80,217,100,230,28.7,26.9,30.3,00000
3.0,73.0,57.0,351,04,01,  Barua Para,437,415,217,192,220,223,51.3,53.1,49.7,00000
3.0,73.0,57.0,351,05,01,  Dakbangla,198,169,110,85,88,84,54.0,56.4,51.2,00000
3.0,73.0,57.0,351,06,01,  Kashubunia,188,272,102,130,86,142,40.9,44.0,37.7,00000
3.0,73.0,57.0,351,07,01,  Gonapara,171,212,89,99,82,113,44.6,47.3,42.1,00000
3.0,73.0,57.0,351,08,01,  Kulalpara,59,43,32,18,27,25,57.8,64.0,51.9,00000
3.0,73.0,57.0,351,09,01,  Headman Para,145,157,65,71,80,86,48.0,47.8,48.2,00000
3.0,73.0,57.0,351,10,01,  Zolpai Tola,27,10,12,4,15,6,73.0,75.0,71.4,00000
3.0,73.0,57.0,351,11,01,  Camp Para,135,95,78,40,57,55,58.7,66.1,50.9,00000
3.0,73.0,57.0,351,12,01,  Dakkin Para,120,63,60,25,60,38,65.6,70.6,61.2,00000
3.0,73.0,57.0,351,13,01,  Pashim Para,247,142,122,60,125,82,63.5,67.0,60.4,00000
3.0,73.0,57.0,351,14,01,  Fakiragona,29,174,10,85,19,89,14.3,10.5,17.6,00000
3.0,73.0,57.0,351,15,01,  Betbuniya Para,69,56,31,24,38,32,55.2,56.4,54.3,00000
3.0,73.0,57.0,351,16,01,  Purba Para,63,49,32,23,31,26,56.3,58.2,54.4,00000
3.0,73.0,57.0,351,17,01,  Maddam Para,65,131,24,72,41,59,33.2,25.0,41.0,00000
3.0,73.0,57.0,819,01,01,  Sulla Para,5,42,3,22,2,20,10.6,12.0,9.1,00000
3.0,73.0,57.0,819,02,01,  Refuzi Para,26,152,14,73,12,79,14.6,16.1,13.2,00000
3.0,73.0,57.0,819,03,01,  Headman Para,73,242,43,121,30,121,23.2,26.2,19.9,00000
3.0,73.0,57.0,819,04,01,  Kumira Para,83,116,46,53,37,63,41.7,46.5,37.0,00000
3.0,73.0,57.0,819,05,01,  Baiddachara,84,229,54,109,30,120,26.8,33.1,20.0,00000
3.0,73.0,57.0,819,06,01,  Jamirtoli,30,496,23,258,7,238,5.7,8.2,2.9,00000
3.0,73.0,57.0,819,07,01,  Baraitoli,52,354,38,172,14,182,12.8,18.1,7.1,00000
3.0,73.0,57.0,819,08,01,  Mongzai Para,83,281,57,141,26,140,22.8,28.8,15.7,00000
3.0,73.0,57.0,819,09,01,  Ballukhiya Para,36,177,17,82,19,95,16.9,17.2,16.7,00000
3.0,73.0,57.0,819,10,01,  Fatra Ziri,90,320,76,155,14,165,22.0,32.9,7.8,00000
3.0,73.0,57.0,819,11,01,  Garzan Bunia Para,29,206,20,112,9,94,12.3,15.2,8.7,00000
3.0,73.0,57.0,819,12,01,  Amtoli Para,33,231,29,117,4,114,12.5,19.9,3.4,00000
3.0,73.0,57.0,819,13,01,  Rezu Mog Para,20,86,9,45,11,41,18.9,16.7,21.2,00000
3.0,73.0,57.0,819,14,01,  Reju Dhakshinpara,20,62,10,28,10,34,24.4,26.3,22.7,00000
3.0,73.0,57.0,819,15,01,  Futtaziri,11,108,6,56,5,52,9.2,9.7,8.8,00000
3.0,73.0,57.0,994,01,01,  Gonar Paraa,113,129,58,62,55,67,46.7,48.3,45.1,00000
3.0,73.0,57.0,994,02,01,  Fakira Gona,67,81,42,40,25,41,45.3,51.2,37.9,00000
3.0,73.0,57.0,994,03,01,  Mohamedpur,0,4,0,2,0,2,0.0,0.0,0.0,00000
3.0,73.0,57.0,994,04,01,  Ulubunia,34,116,21,56,13,60,22.7,27.3,17.8,00000
3.0,73.0,57.0,994,05,01,  Tandaziri,30,142,12,67,18,75,17.4,15.2,19.4,00000
3.0,73.0,57.0,994,06,01,  Baishpari,11,102,8,46,3,56,9.7,14.8,5.1,00000
3.0,73.0,57.0,994,07,01,  Headman Para,12,67,8,32,4,35,15.2,20.0,10.3,00000
3.0,73.0,57.0,994,08,01,  Baza Bunia,157,271,72,129,85,142,36.7,35.8,37.4,00000
3.0,73.0,57.0,994,09,01,  Maddam Para,154,59,84,27,70,32,72.3,75.7,68.6,00000
3.0,73.0,57.0,994,10,01,  Uttar Para,81,77,44,32,37,45,51.3,57.9,45.1,00000
3.0,73.0,57.0,994,11,01,  Kulalpara,56,93,27,50,29,43,37.6,35.1,40.3,00000
3.0,73.0,57.0,994,12,01,  Camp Para,138,104,77,53,61,51,57.0,59.2,54.5,00000
3.0,73.0,57.0,994,13,01,  Konar Para,84,75,36,42,48,33,52.8,46.2,59.3,00000
3.0,73.0,57.0,994,14,01,  Bazar Para,41,226,20,109,21,117,15.4,15.5,15.2,00000
3.0,73.0,57.0,994,15,01,  Tumbru West Kull,185,193,101,91,84,102,48.9,52.6,45.2,00000
3.0,73.0,57.0,994,16,01,  Kizzry Gona,142,212,58,110,84,102,40.1,34.5,45.2,00000
3.0,73.0,57.0,994,17,01,  Hindu Para,104,114,50,58,54,56,47.7,46.3,49.1,00000
3.0,73.0,57.0,994,18,01,  Chakma Para,18,214,11,99,7,115,7.8,10.0,5.7,00000
3.0,73.0,76.0,234,01,01,  Bhalukkhaya,28,115,14,60,14,55,19.6,18.9,20.3,00000
3.0,73.0,76.0,234,02,01,  Dakibunia Para,5,73,1,36,4,37,6.4,2.7,9.8,00000
3.0,73.0,76.0,234,03,01,  Bamhatir Chara,35,92,19,45,16,47,27.6,29.7,25.4,00000
3.0,73.0,76.0,234,04,01,  Fultali,56,237,47,117,9,120,19.1,28.7,7.0,00000
3.0,73.0,76.0,234,05,01,  Selorchara,2,24,1,12,1,12,7.7,7.7,7.7,00000
3.0,73.0,76.0,234,06,01,  Baraitoli,12,74,8,34,4,40,14.0,19.0,9.1,00000
3.0,73.0,76.0,468,01,01,  Refujee Para,5,83,1,48,4,35,5.7,2.0,10.3,00000
3.0,73.0,76.0,468,02,01,  Rasul Pur,15,53,6,25,9,28,22.1,19.4,24.3,00000
3.0,73.0,76.0,468,03,01,  Fular Chara,4,18,3,10,1,8,18.2,23.1,11.1,00000
3.0,73.0,76.0,468,04,01,  Mogpara,13,219,8,105,5,114,5.6,7.1,4.2,00000
3.0,73.0,76.0,468,05,01,  Mazor Para,29,128,16,65,13,63,18.5,19.8,17.1,00000
3.0,73.0,76.0,702,01,03,  Adarsha Gram,419,555,220,261,199,294,43.0,45.7,40.4,00000
3.0,73.0,76.0,702,02,03,  Saddar,902,215,538,97,364,118,80.8,84.7,75.5,00000
3.0,73.0,76.0,702,03,03,  Madrasha Gona (Sadar),114,147,62,73,52,74,43.7,45.9,41.3,00000
3.0,73.0,76.0,702,04,03,  Moszid Gona,259,121,157,60,102,61,68.2,72.4,62.6,00000
3.0,73.0,76.0,702,05,03,  Saddar Dungri Headman M.Para,216,133,122,38,94,95,61.9,76.3,49.7,00000
3.0,73.0,76.0,702,06,03,  Saddar Zothokamer Para,37,157,22,68,15,89,19.1,24.4,14.4,00000
3.0,73.0,76.0,702,07,03,  Babshi Para,107,124,68,63,39,61,46.3,51.9,39.0,00000
3.0,73.0,76.0,702,08,03,  Mondallagona,45,54,20,27,25,27,45.5,42.6,48.1,00000
3.0,73.0,76.0,702,09,03,  Saddar Baruapara,63,31,30,10,33,21,67.0,75.0,61.1,00000
3.0,73.0,76.0,702,10,03,  Gillatoli,101,129,59,62,42,67,43.9,48.8,38.5,00000
3.0,73.0,76.0,702,11,03,  Tandaziri,79,161,34,76,45,85,32.9,30.9,34.6,00000
3.0,73.0,76.0,702,12,03,  Uttar Bicha Mara,300,155,179,69,121,86,65.9,72.2,58.5,00000
3.0,73.0,76.0,702,13,03,  Bagan Gona,152,260,79,116,73,144,36.9,40.5,33.6,00000
3.0,73.0,76.0,702,14,03,  South Bichamara,242,231,149,113,93,118,51.2,56.9,44.1,00000
3.0,73.0,76.0,702,15,03,  Purba Bichamara,104,214,57,101,47,113,32.7,36.1,29.4,00000
3.0,73.0,76.0,702,16,03,  Katikata,51,95,28,48,23,47,34.9,36.8,32.9,00000
3.0,73.0,76.0,702,17,03,  Chak Headman Para,81,119,49,47,32,72,40.5,51.0,30.8,00000
3.0,73.0,76.0,702,18,03,  Futtaziri,44,133,19,72,25,61,24.9,20.9,29.1,00000
3.0,73.0,76.0,702,19,03,  Chak Zotho Kamar,11,42,6,19,5,23,20.8,24.0,17.9,00000
3.0,73.0,76.0,702,20,03,  Natun Ckak Para,24,76,13,31,11,45,24.0,29.5,19.6,00000
3.0,73.0,76.0,702,21,03,  Boktarakola,43,75,20,37,23,38,36.4,35.1,37.7,00000
3.0,73.0,76.0,702,22,03,  Uttar Salami Para,73,119,39,61,34,58,38.0,39.0,37.0,00000
3.0,73.0,76.0,702,23,03,  Maddam Chak Para,75,74,46,16,29,58,50.3,74.2,33.3,00000
3.0,73.0,76.0,702,24,03,  Kaissa Bunia,15,40,8,23,7,17,27.3,25.8,29.2,00000
3.0,73.0,76.0,702,25,03,  South Salami Para,80,472,45,225,35,247,14.5,16.7,12.4,00000
3.0,73.0,76.0,702,26,03,  Ashraf Mia Para,68,109,37,48,31,61,38.4,43.5,33.7,00000
3.0,73.0,76.0,702,28,03,  Bazar Para (Chak Dalai),108,130,56,57,52,73,45.4,49.6,41.6,00000
3.0,73.0,76.0,702,29,03,  Amir Hamza Para,22,82,16,46,6,36,21.2,25.8,14.3,00000
3.0,73.0,76.0,702,30,03,  Merasang Karbari Chak Para,30,82,17,34,13,48,26.8,33.3,21.3,00000
3.0,73.0,76.0,702,31,03,  Siddikabad,37,132,19,68,18,64,21.9,21.8,22.0,00000
3.0,73.0,76.0,702,32,03,  Satuzi Para,29,43,19,17,10,26,40.3,52.8,27.8,00000
3.0,73.0,76.0,702,33,03,  Natun Para,16,77,9,46,7,31,17.2,16.4,18.4,00000
3.0,73.0,76.0,702,34,03,  Gayal Kata,8,121,2,66,6,55,6.2,2.9,9.8,00000
3.0,73.0,76.0,702,35,03,  Idris Kalifa Para,15,31,9,11,6,20,32.6,45.0,23.1,00000
3.0,73.0,76.0,702,36,03,  Olibaksu Mat,44,87,25,38,19,49,33.6,39.7,27.9,00000
3.0,73.0,76.0,702,37,03,  Meherpur,1,184,1,88,0,96,0.5,1.1,0.0,00000
3.0,73.0,76.0,702,38,03,  Barachara  Para,55,223,23,118,32,105,19.8,16.3,23.4,00000
3.0,73.0,76.0,702,39,03,  Satgoria Para,13,10,8,6,5,4,56.5,57.1,55.6,00000
3.0,73.0,76.0,702,40,03,  Kalufakir Para,39,12,35,5,4,7,76.5,87.5,36.4,00000
3.0,73.0,76.0,702,41,03,  Hamidia Para,54,286,31,125,23,161,15.9,19.9,12.5,00000
3.0,73.0,76.0,702,42,03,  Serar Aga,2,49,1,25,1,24,3.9,3.8,4.0,00000
3.0,73.0,76.0,702,43,03,  Amtolimat,65,178,37,86,28,92,26.7,30.1,23.3,00000
3.0,73.0,76.0,702,44,03,  Lamba Mat,43,144,28,64,15,80,23.0,30.4,15.8,00000
3.0,73.0,76.0,702,45,03,  Serar Kul,63,313,31,160,32,153,16.8,16.2,17.3,00000
3.0,73.0,76.0,702,46,03,  Serakmat,67,271,33,132,34,139,19.8,20.0,19.7,00000
3.0,73.0,76.0,702,47,03,  Barachan Kola,22,88,14,44,8,44,20.0,24.1,15.4,00000
3.0,73.0,76.0,702,48,03,  Fazurchara,17,101,11,51,6,50,14.4,17.7,10.7,00000
3.0,73.0,76.0,702,49,03,  Gayalmara,33,158,19,68,14,90,17.3,21.8,13.5,00000
3.0,73.0,76.0,702,50,03,  Zamchari,4,193,4,81,0,112,2.0,4.7,0.0,00000
3.0,73.0,76.0,702,51,03,  Kambania,100,387,52,173,48,214,20.5,23.1,18.3,00000
3.0,73.0,76.0,702,52,03,  Zarulia Chari,51,267,26,139,25,128,16.0,15.8,16.3,00000
3.0,73.0,76.0,702,53,03,  Pardan Ziri,30,267,22,132,8,135,10.1,14.3,5.6,00000
3.0,73.0,76.0,702,54,03,  Shapmara Ziri,5,104,3,57,2,47,4.6,5.0,4.1,00000
3.0,73.0,76.0,702,55,03,  Ashar Toli,115,499,73,268,42,231,18.7,21.4,15.4,00000
3.0,73.0,76.0,702,56,03,  B.D.R. Camp(Sadar),338,19,278,11,60,8,94.7,96.2,88.2,00000
3.0,73.0,76.0,702,57,03,  Chairman Para,67,115,36,61,31,54,36.8,37.1,36.5,00000
3.0,73.0,76.0,702,58,03,  Gonar Para,44,138,21,69,23,69,24.2,23.3,25.0,00000
3.0,73.0,76.0,702,60,03,  Kalukata,23,106,14,52,9,54,17.8,21.2,14.3,00000
3.0,73.0,76.0,877,01,01,  Nannakata,92,172,53,79,39,93,34.8,40.2,29.5,00000
3.0,73.0,76.0,877,02,01,  Khudir Para,109,140,75,46,34,94,43.8,62.0,26.6,00000
3.0,73.0,76.0,877,03,01,  Natun Para,41,97,26,51,15,46,29.7,33.8,24.6,00000
3.0,73.0,76.0,877,04,01,  Keang Para,42,374,27,176,15,198,10.1,13.3,7.0,00000
3.0,73.0,76.0,877,05,01,  Head Man Para,68,221,49,97,19,124,23.5,33.6,13.3,00000
3.0,73.0,76.0,877,06,01,  Mari Gga Para,85,140,57,66,28,74,37.8,46.3,27.5,00000
3.0,73.0,76.0,877,07,01,  Baiddapara,27,101,20,41,7,60,21.1,32.8,10.4,00000
3.0,73.0,76.0,877,08,01,  Battholi Para,40,170,25,74,15,96,19.0,25.3,13.5,00000
3.0,73.0,76.0,877,09,01,  Zomkhola,25,65,19,33,6,32,27.8,36.5,15.8,00000
3.0,73.0,76.0,877,10,01,  Keorppara,25,201,12,104,13,97,11.1,10.3,11.8,00000
3.0,73.0,76.0,877,11,01,  Baniyajiri,14,56,10,35,4,21,20.0,22.2,16.0,00000
3.0,89.0,19.0,153,01,01,  Lalitmohan Tong Para,8,20,4,10,4,10,28.6,28.6,28.6,00000
3.0,89.0,19.0,153,02,01,  Lakky Chandra Para,14,49,12,21,2,28,22.2,36.4,6.7,00000
3.0,89.0,19.0,153,03,01,  Oyabre Para/Moungtho Para,27,93,19,44,8,49,22.5,30.2,14.0,00000
3.0,89.0,19.0,153,04,01,  Boomheadman Para,13,12,7,2,6,10,52.0,77.8,37.5,00000
3.0,89.0,19.0,153,05,01,  Mangpru Para,46,195,31,88,15,107,19.1,26.1,12.3,00000
3.0,89.0,19.0,153,06,01,  Gura Para,7,36,5,16,2,20,16.3,23.8,9.1,00000
3.0,89.0,19.0,153,07,01,  Binngga Para,0,5,0,3,0,2,0.0,0.0,0.0,00000
3.0,89.0,19.0,153,08,01,  Roro Para,23,68,21,27,2,41,25.3,43.8,4.7,00000
3.0,89.0,19.0,153,09,01,  Cini Para,21,52,16,17,5,35,28.8,48.5,12.5,00000
3.0,89.0,19.0,153,10,01,  Moung Para/Mounobau Para,11,35,7,13,4,22,23.9,35.0,15.4,00000
3.0,89.0,19.0,153,11,01,  Moung Thoui Para,20,126,13,70,7,56,13.7,15.7,11.1,00000
3.0,89.0,19.0,153,12,01,  Mohandra Para,65,53,37,21,28,32,55.1,63.8,46.7,00000
3.0,89.0,19.0,153,13,01,  Kilo Para,11,52,4,23,7,29,17.5,14.8,19.4,00000
3.0,89.0,19.0,153,14,01,  Suan Bil Para,91,21,45,9,46,12,81.3,83.3,79.3,00000
3.0,89.0,19.0,153,15,01,  Model Para,84,19,42,11,42,8,81.6,79.2,84.0,00000
3.0,89.0,19.0,153,16,01,  Dayakumar Para,46,30,33,9,13,21,60.5,78.6,38.2,00000
3.0,89.0,19.0,153,17,01,  Pratigga Para,39,46,24,16,15,30,45.9,60.0,33.3,00000
3.0,89.0,19.0,153,18,01,  Panduri Angolandas Para,8,16,6,6,2,10,33.3,50.0,16.7,00000
3.0,89.0,19.0,229,01,01,  Alaygai Para,19,51,13,24,6,27,27.1,35.1,18.2,00000
3.0,89.0,19.0,229,02,01,  Bakhyong Para,32,74,20,34,12,40,30.2,37.0,23.1,00000
3.0,89.0,19.0,229,03,01,  Kachhaptali Para,45,166,25,75,20,91,21.3,25.0,18.0,00000
3.0,89.0,19.0,229,04,01,  Chhahala Para,113,128,71,56,42,72,46.9,55.9,36.8,00000
3.0,89.0,19.0,229,05,01,  Kachhap Tali Bazar Tipra Para,14,30,9,12,5,18,31.8,42.9,21.7,00000
3.0,89.0,19.0,229,06,01,  Gurukhyong Para,42,130,17,64,25,66,24.4,21.0,27.5,00000
3.0,89.0,19.0,229,07,01,  Jamachandra  Para,20,46,11,21,9,25,30.3,34.4,26.5,00000
3.0,89.0,19.0,229,08,01,  Hantukri Para /Bijoypara,54,56,34,24,20,32,49.1,58.6,38.5,00000
3.0,89.0,19.0,229,09,01,  Natukri  Para,6,55,4,28,2,27,9.8,12.5,6.9,00000
3.0,89.0,19.0,229,10,01,  Bhanga Mura Para,201,216,118,115,83,101,48.2,50.6,45.1,00000
3.0,89.0,19.0,229,11,01,  Wagay Para,308,248,184,102,124,146,55.4,64.3,45.9,00000
3.0,89.0,19.0,229,13,01,  Nathing Jiri Gita Para,20,57,11,29,9,28,26.0,27.5,24.3,00000
3.0,89.0,19.0,535,01,01,  Sadhu Headmanpara,56,97,37,33,19,64,36.6,52.9,22.9,00000
3.0,89.0,19.0,535,02,01,  Narain Para,19,51,16,16,3,35,27.1,50.0,7.9,00000
3.0,89.0,19.0,535,03,01,  Posha-Upara,18,73,12,35,6,38,19.8,25.5,13.6,00000
3.0,89.0,19.0,535,04,01,  Pakhyong Para,20,27,15,15,5,12,42.6,50.0,29.4,00000
3.0,89.0,19.0,535,05,01,  Aunga Para,11,21,8,10,3,11,34.4,44.4,21.4,00000
3.0,89.0,19.0,535,06,01,  Lapagai Para,25,87,13,46,12,41,22.3,22.0,22.6,00000
3.0,89.0,19.0,535,07,01,  Chanmoni Para,31,18,19,6,12,12,63.3,76.0,50.0,00000
3.0,89.0,19.0,535,08,01,  Shilbanda Para,8,86,7,43,1,43,8.5,14.0,2.3,00000
3.0,89.0,19.0,535,09,01,  Khyang Para,13,51,8,22,5,29,20.3,26.7,14.7,00000
3.0,89.0,19.0,535,10,01,  Tripura Para,13,41,8,18,5,23,24.1,30.8,17.9,00000
3.0,89.0,19.0,535,11,01,  Surjaban Para,0,48,0,32,0,16,0.0,0.0,0.0,00000
3.0,89.0,19.0,535,12,01,  Sipri Para,9,16,6,9,3,7,36.0,40.0,30.0,00000
3.0,89.0,38.0,459,01,01,  Kokhyong Headman Para,19,144,14,66,5,78,11.7,17.5,6.0,00000
3.0,89.0,38.0,459,02,01,  Thali Para,38,76,25,33,13,43,33.3,43.1,23.2,00000
3.0,89.0,38.0,459,03,01,  Minjhiri,0,5,0,2,0,3,0.0,0.0,0.0,00000
3.0,89.0,38.0,459,04,01,  Narai Mroung Para,12,37,9,15,3,22,24.5,37.5,12.0,00000
3.0,89.0,38.0,688,01,01,  Sonaisepru Para,23,143,14,78,9,65,13.9,15.2,12.2,00000
3.0,89.0,38.0,688,02,01,  Baghmara Mukh Purba Marmapar,74,79,44,35,30,44,48.4,55.7,40.5,00000
3.0,89.0,38.0,688,03,01,  Dochari,10,77,7,40,3,37,11.5,14.9,7.5,00000
3.0,89.0,38.0,688,04,01,  Dulachare Para,9,43,7,17,2,26,17.3,29.2,7.1,00000
3.0,89.0,38.0,688,05,01,  Baghmara Bitor Para,21,101,13,47,8,54,17.2,21.7,12.9,00000
3.0,89.0,38.0,688,06,01,  Dulochhari Chakma Para,12,34,6,18,6,16,26.1,25.0,27.3,00000
3.0,89.0,38.0,688,07,01,  Bagra Sun Para,48,38,27,15,21,23,55.8,64.3,47.7,00000
3.0,89.0,38.0,688,08,01,  Alachu Para,4,90,1,53,3,37,4.3,1.9,7.5,00000
3.0,89.0,38.0,688,09,01,  Sapusya Para,14,88,12,46,2,42,13.7,20.7,4.5,00000
3.0,89.0,38.0,765,01,01,  Ganjak Headman Para,26,140,20,70,6,70,15.7,22.2,7.9,00000
3.0,89.0,38.0,765,02,01,  Antaha Tripura Para,96,171,70,74,26,97,36.0,48.6,21.1,00000
3.0,89.0,38.0,765,03,01,  Antaha Tonchanga Para,47,51,29,24,18,27,48.0,54.7,40.0,00000
3.0,89.0,38.0,765,04,01,  Sonai Para,13,38,10,14,3,24,25.5,41.7,11.1,00000
3.0,89.0,38.0,765,05,01,  Nachhalong Para,99,262,61,106,38,156,27.4,36.5,19.6,00000
3.0,89.0,38.0,765,06,01,  Kanaiju Para,132,280,85,142,47,138,32.0,37.4,25.4,00000
3.0,89.0,38.0,765,07,01,  Batangpara,24,46,18,20,6,26,34.3,47.4,18.8,00000
3.0,89.0,38.0,765,08,01,  Antaha Para Bazar,88,82,51,26,37,56,51.8,66.2,39.8,00000
3.0,89.0,38.0,765,09,01,  Nachalong Ton Para,35,69,21,27,14,42,33.7,43.8,25.0,00000
3.0,89.0,38.0,765,10,01,  Gongkhang,60,90,37,43,23,47,40.0,46.3,32.9,00000
3.0,89.0,38.0,765,11,01,  Sonaaga Para,3,52,1,29,2,23,5.5,3.3,8.0,00000
3.0,89.0,38.0,765,12,01,  Shil Jiri Para,0,35,0,19,0,16,0.0,0.0,0.0,00000
3.0,89.0,38.0,765,13,01,  Baya Para,13,86,9,42,4,44,13.1,17.6,8.3,00000
3.0,89.0,38.0,765,14,01,  Thouicha Para,0,37,0,20,0,17,0.0,0.0,0.0,00000
3.0,89.0,38.0,765,15,01,  Maniram Para,2,48,1,24,1,24,4.0,4.0,4.0,00000
3.0,89.0,38.0,765,16,01,  Jatiya Para,0,27,0,16,0,11,0.0,0.0,0.0,00000
3.0,89.0,38.0,765,17,01,  Maga Para,0,18,0,7,0,11,0.0,0.0,0.0,00000
3.0,89.0,38.0,765,18,01,  Kaimrang Nuton Para,8,54,4,31,4,23,12.9,11.4,14.8,00000
3.0,89.0,38.0,765,19,01,  Anglai Khang Para,1,84,0,46,1,38,1.2,0.0,2.6,00000
3.0,89.0,38.0,765,20,01,  Gung Khaong Para,1,57,1,27,0,30,1.7,3.6,0.0,00000
3.0,89.0,57.0,382,01,01,  Chhiamukh Para,37,110,23,58,14,52,25.2,28.4,21.2,00000
3.0,89.0,57.0,382,02,01,  Barasila Punarbasan Para,8,41,6,19,2,22,16.3,24.0,8.3,00000
3.0,89.0,57.0,382,03,01,  Barashila Para,53,147,26,73,27,74,26.5,26.3,26.7,00000
3.0,89.0,57.0,382,04,01,  Ghorawbhitar Para,28,119,17,48,11,71,19.0,26.2,13.4,00000
3.0,89.0,57.0,382,05,01,  Ma0ngbai Para,6,175,5,90,1,85,3.3,5.3,1.2,00000
3.0,89.0,57.0,382,06,01,  Durnibar Para,17,36,11,12,6,24,32.1,47.8,20.0,00000
3.0,89.0,57.0,382,07,01,  Ramtham Para,15,53,12,24,3,29,22.1,33.3,9.4,00000
3.0,89.0,57.0,382,08,01,  Abichalita Para,23,33,14,16,9,17,41.1,46.7,34.6,00000
3.0,89.0,57.0,382,09,01,  Ghorao Gransha Para,6,37,4,15,2,22,14.0,21.1,8.3,00000
3.0,89.0,57.0,818,01,03,  Taimrung Chhara Para,71,94,58,51,13,43,43.0,53.2,23.2,00000
3.0,89.0,57.0,818,02,03,  Aunig Gurd Para,20,65,17,33,3,32,23.5,34.0,8.6,00000
3.0,89.0,57.0,818,03,03,  Pagla Chhara Marma Para,170,195,124,82,46,113,46.6,60.2,28.9,00000
3.0,89.0,57.0,818,04,03,  Kainthir Mukh Para,48,169,33,73,15,96,22.1,31.1,13.5,00000
3.0,89.0,57.0,818,05,03,  Lapagai Para,34,127,21,63,13,64,21.1,25.0,16.9,00000
3.0,89.0,57.0,818,06,03,  Suyanalo Para,157,65,71,26,86,39,70.7,73.2,68.8,00000
3.0,89.0,57.0,818,07,03,  Rowang Chhari Natun Para,147,256,94,112,53,144,36.5,45.6,26.9,00000
3.0,89.0,57.0,818,08,03,  Khang Para,6,42,6,22,0,20,12.5,21.4,0.0,00000
3.0,89.0,57.0,818,09,03,  Rowang Chhari Bazar Para,380,208,272,117,108,91,64.6,69.9,54.3,00000
3.0,89.0,57.0,818,10,03,  Rowang Chhari Para,507,360,312,160,195,200,58.5,66.1,49.4,00000
3.0,89.0,57.0,818,11,03,  Talukdar Para,24,146,18,76,6,70,14.1,19.1,7.9,00000
3.0,89.0,57.0,818,12,03,  Khabi Para,21,33,14,17,7,16,38.9,45.2,30.4,00000
3.0,89.0,57.0,818,13,03,  Sukna Chhari Para,8,62,7,26,1,36,11.4,21.2,2.7,00000
3.0,89.0,57.0,818,14,03,  Tulachhari Punarbasan Para,5,32,5,16,0,16,13.5,23.8,0.0,00000
3.0,89.0,57.0,818,15,03,  Tula Chhari Tupapupa Para,17,67,11,31,6,36,20.2,26.2,14.3,00000
3.0,89.0,57.0,818,16,03,  Roychandra Kar Para,11,37,7,17,4,20,22.9,29.2,16.7,00000
3.0,89.0,57.0,818,17,03,  Tulachhari Para,36,120,19,58,17,62,23.1,24.7,21.5,00000
3.0,89.0,57.0,818,18,03,  Aungjai Para,46,162,25,73,21,89,22.1,25.5,19.1,00000
3.0,89.0,57.0,818,19,03,  Munthar Para,21,8,12,2,9,6,72.4,85.7,60.0,00000
3.0,89.0,57.0,818,20,03,  Beng Chhari Bazzar,44,26,29,9,15,17,62.9,76.3,46.9,00000
3.0,89.0,57.0,818,21,03,  Chakhulal Para,29,42,21,15,8,27,40.8,58.3,22.9,00000
3.0,89.0,57.0,818,22,03,  Shimul Para,75,76,52,25,23,51,49.7,67.5,31.1,00000
3.0,89.0,57.0,841,01,01,  Bangchhari Para,133,418,98,203,35,215,24.1,32.6,14.0,00000
3.0,89.0,57.0,841,02,01,  Painkhong Punarbasan Para,17,57,12,27,5,30,23.0,30.8,14.3,00000
3.0,89.0,57.0,841,03,01,  Joydhar Para,14,69,13,28,1,41,16.9,31.7,2.4,00000
3.0,89.0,57.0,841,04,01,  Kyaprutong Para,47,96,26,45,21,51,32.9,36.6,29.2,00000
3.0,89.0,57.0,841,05,01,  Shanka Moni Para,52,73,35,28,17,45,41.6,55.6,27.4,00000
3.0,89.0,57.0,841,06,01,  K0ual Para,50,54,28,21,22,33,48.1,57.1,40.0,00000
3.0,89.0,57.0,841,07,01,  Kheyang Para,11,32,8,16,3,16,25.6,33.3,15.8,00000
3.0,89.0,57.0,841,08,01,  Ranin Para,137,37,74,14,63,23,78.7,84.1,73.3,00000
3.0,89.0,57.0,841,09,01,  Nutan Para,27,118,21,58,6,60,18.6,26.6,9.1,00000
3.0,89.0,57.0,841,10,01,  Paikhoyang Para,276,60,151,20,125,40,82.1,88.3,75.8,00000
3.0,89.0,57.0,841,11,01,  Langla Para,62,62,37,26,25,36,50.0,58.7,41.0,00000
3.0,89.0,57.0,841,12,01,  Khamtang Para,46,53,30,21,16,32,46.5,58.8,33.3,00000
3.0,89.0,57.0,841,13,01,  Ripu Para,15,39,15,13,0,26,27.8,53.6,0.0,00000
3.0,89.0,76.0,072,01,01,  Danrui/ Manthoui Para,2,90,1,47,1,43,2.2,2.1,2.3,00000
3.0,89.0,76.0,072,02,01,  Pradoy Karbari Para,28,92,26,38,2,54,23.3,40.6,3.6,00000
3.0,89.0,76.0,072,03,01,  Manroy Karbari Para,12,80,5,41,7,39,13.0,10.9,15.2,00000
3.0,89.0,76.0,072,04,01,  Chaho Headman Para,51,172,44,79,7,93,22.9,35.8,7.0,00000
3.0,89.0,76.0,072,05,01,  Durnido Para,31,67,23,27,8,40,31.6,46.0,16.7,00000
3.0,89.0,76.0,072,06,01,  Dalujhiri Para,21,75,13,36,8,39,21.9,26.5,17.0,00000
3.0,89.0,76.0,072,07,01,  Mankong Para,16,53,10,23,6,30,23.2,30.3,16.7,00000
3.0,89.0,76.0,072,08,01,  Roychhong/ Buri Para,2,69,2,35,0,34,2.8,5.4,0.0,00000
3.0,89.0,76.0,072,09,01,  Alekhong Para,16,103,13,51,3,52,13.4,20.3,5.5,00000
3.0,89.0,76.0,072,10,01,  Mandui Para,30,81,23,28,7,53,27.0,45.1,11.7,00000
3.0,89.0,76.0,072,11,01,  Murangu Muk Bazar,19,25,16,13,3,12,43.2,55.2,20.0,00000
3.0,89.0,76.0,072,12,01,  Patuai Para,10,68,7,33,3,35,12.8,17.5,7.9,00000
3.0,89.0,76.0,072,13,01,  Thumru Para,11,58,7,29,4,29,15.9,19.4,12.1,00000
3.0,89.0,76.0,072,14,01,  Manpong Para,5,64,4,31,1,33,7.2,11.4,2.9,00000
3.0,89.0,76.0,072,15,01,  Hamakri Para,27,56,26,37,1,19,32.5,41.3,5.0,00000
3.0,89.0,76.0,306,01,01,  Baraitala Para,12,156,9,85,3,71,7.1,9.6,4.1,00000
3.0,89.0,76.0,306,02,01,  Kadam Chhara Para,36,119,22,53,14,66,23.2,29.3,17.5,00000
3.0,89.0,76.0,306,03,01,  Merai Para,19,103,11,52,8,51,15.6,17.5,13.6,00000
3.0,89.0,76.0,306,04,01,  Betchhara Mukh Para,37,126,26,54,11,72,22.7,32.5,13.3,00000
3.0,89.0,76.0,306,05,01,  Natun Para,2,18,2,10,0,8,10.0,16.7,0.0,00000
3.0,89.0,76.0,306,06,01,  Headman Para,81,341,50,149,31,192,19.2,25.1,13.9,00000
3.0,89.0,76.0,306,07,01,  Dowlyon  Para,1,35,0,20,1,15,2.8,0.0,6.3,00000
3.0,89.0,76.0,306,08,01,  Langthang Para,12,49,8,22,4,27,19.7,26.7,12.9,00000
3.0,89.0,76.0,306,09,01,  Aung Salah Para,16,28,8,16,8,12,36.4,33.3,40.0,00000
3.0,89.0,76.0,306,10,01,  Chhang King Para,1,64,1,28,0,36,1.5,3.4,0.0,00000
3.0,89.0,76.0,306,11,01,  Jamini Para,16,149,15,59,1,90,9.7,20.3,1.1,00000
3.0,89.0,76.0,306,12,01,  Fakir Para,4,20,1,12,3,8,16.7,7.7,27.3,00000
3.0,89.0,76.0,306,13,01,  Mayfow Para-1,8,189,4,95,4,94,4.1,4.0,4.1,00000
3.0,89.0,76.0,306,14,01,  Khamar Para,2,7,2,3,0,4,22.2,40.0,0.0,00000
3.0,89.0,76.0,306,15,01,  Mayfow Para-2,3,55,3,27,0,28,5.2,10.0,0.0,00000
3.0,89.0,76.0,306,16,01,  Mayfow Para-3,14,132,10,61,4,71,9.6,14.1,5.3,00000
3.0,89.0,76.0,306,17,01,  Khamchong Mroung Para,1,12,1,5,0,7,7.7,16.7,0.0,00000
3.0,89.0,76.0,306,18,01,  Betchara Bazar,62,107,53,59,9,48,36.7,47.3,15.8,00000
3.0,89.0,76.0,612,01,01,  Kolamachang Para,2,46,1,22,1,24,4.2,4.3,4.0,00000
3.0,89.0,76.0,612,02,01,  Sundari Para,5,48,4,22,1,26,9.4,15.4,3.7,00000
3.0,89.0,76.0,612,04,01,  Gharao Mukh Para & Bazar,15,40,9,23,6,17,27.3,28.1,26.1,00000
3.0,89.0,76.0,612,05,01,  Mangu Para,22,65,14,27,8,38,25.3,34.1,17.4,00000
3.0,89.0,76.0,612,07,01,  Markin Para,0,47,0,22,0,25,0.0,0.0,0.0,00000
3.0,89.0,76.0,612,08,01,  Masani Para,36,232,28,113,8,119,13.4,19.9,6.3,00000
3.0,89.0,76.0,612,09,01,  Aung Tong,9,47,5,23,4,24,16.1,17.9,14.3,00000
3.0,89.0,76.0,994,01,01,  Tetulia Para,35,117,23,58,12,59,23.0,28.4,16.9,00000
3.0,89.0,76.0,994,02,01,  Danesh Para,316,444,174,301,142,143,41.6,36.6,49.8,00000
3.0,89.0,76.0,994,03,01,  Pakhongri Para,7,86,5,45,2,41,7.5,10.0,4.7,00000
3.0,89.0,76.0,994,04,01,  Paikhang Para,20,82,11,41,9,41,19.6,21.2,18.0,00000
3.0,89.0,76.0,994,05,01,  Monai Para,17,67,12,27,5,40,20.2,30.8,11.1,00000
3.0,89.0,76.0,994,06,01,  Naya Patangmukh Para,14,145,9,67,5,78,8.8,11.8,6.0,00000
3.0,89.0,76.0,994,07,01,  Chhinai Tripura Para,67,78,39,31,28,47,46.2,55.7,37.3,00000
3.0,89.0,76.0,994,08,01,  Talukdar Para,22,190,15,82,7,108,10.4,15.5,6.1,00000
3.0,89.0,76.0,994,09,01,  Bekhong Para Onaya Para,20,105,12,49,8,56,16.0,19.7,12.5,00000
3.0,89.0,76.0,994,10,01,  Tangpru Para & Khamar Para,51,216,27,111,24,105,19.1,19.6,18.6,00000
3.0,89.0,76.0,994,11,01,  Khansama Para,38,231,24,104,14,127,14.1,18.8,9.9,00000
3.0,89.0,76.0,994,12,01,  Headman Para,38,317,26,151,12,166,10.7,14.7,6.7,00000
3.0,89.0,76.0,994,13,01,  Lamogiri Para,4,58,2,24,2,34,6.5,7.7,5.6,00000
3.0,89.0,76.0,994,14,01,  Ratajiri Para,4,72,1,37,3,35,5.3,2.6,7.9,00000
3.0,89.0,76.0,994,15,01,  Tarachamuk Para,74,20,42,11,32,9,78.7,79.2,78.0,00000
3.0,89.0,76.0,994,16,01,  Rajar Khamar Para,41,146,36,82,5,64,21.9,30.5,7.2,00000
3.0,91.0,19.0,142,01,01,  Erapara,1,84,1,44,0,40,1.2,2.2,0.0,00000
3.0,91.0,19.0,142,02,01,  Sawang Para,0,28,0,13,0,15,0.0,0.0,0.0,00000
3.0,91.0,19.0,142,03,01,  Halafu Para,7,32,6,17,1,15,17.9,26.1,6.3,00000
3.0,91.0,19.0,142,04,01,  Mongri Para,10,50,4,24,6,26,16.7,14.3,18.8,00000
3.0,91.0,19.0,142,05,01,  Sefru Para,28,159,17,77,11,82,15.0,18.1,11.8,00000
3.0,91.0,19.0,142,06,01,  Kalai Para,11,79,9,41,2,38,12.2,18.0,5.0,00000
3.0,91.0,19.0,142,07,01,  Roy Mohan Para,30,67,20,28,10,39,30.9,41.7,20.4,00000
3.0,91.0,19.0,142,08,01,  Bharot Karbari Para,44,89,31,36,13,53,33.1,46.3,19.7,00000
3.0,91.0,19.0,284,01,01,  Laipung Para,24,105,13,54,11,51,18.6,19.4,17.7,00000
3.0,91.0,19.0,284,02,01,  Menrula Para,10,101,8,44,2,57,9.0,15.4,3.4,00000
3.0,91.0,19.0,284,03,01,  Palpara,22,130,15,65,7,65,14.5,18.8,9.7,00000
3.0,91.0,19.0,284,04,01,  Shing Song Para,1,53,1,26,0,27,1.9,3.7,0.0,00000
3.0,91.0,19.0,284,05,01,  Mongthong Para,11,106,9,49,2,57,9.4,15.5,3.4,00000
3.0,91.0,19.0,284,06,01,  Bashadon Para,22,19,17,6,5,13,53.7,73.9,27.8,00000
3.0,91.0,19.0,284,07,01,  Thangri Para,5,53,5,21,0,32,8.6,19.2,0.0,00000
3.0,91.0,19.0,284,08,01,  Onglai Para,27,66,19,22,8,44,29.0,46.3,15.4,00000
3.0,91.0,19.0,284,09,01,  Rensong Para,4,16,2,7,2,9,20.0,22.2,18.2,00000
3.0,91.0,19.0,284,10,01,  Ruitu Para,6,119,6,51,0,68,4.8,10.5,0.0,00000
3.0,91.0,19.0,284,11,01,  Menlong Para,3,34,3,16,0,18,8.1,15.8,0.0,00000
3.0,91.0,19.0,284,12,01,  Bagan Para,27,62,19,22,8,40,30.3,46.3,16.7,00000
3.0,91.0,19.0,284,13,01,  Chini Para,4,33,4,13,0,20,10.8,23.5,0.0,00000
3.0,91.0,19.0,284,14,01,  Niakka Para,3,25,2,11,1,14,10.7,15.4,6.7,00000
3.0,91.0,19.0,284,15,01,  Punarbashan Para,21,116,14,54,7,62,15.3,20.6,10.1,00000
3.0,91.0,19.0,284,16,01,  Galenga Bazar,60,30,54,18,6,12,66.7,75.0,33.3,00000
3.0,91.0,19.0,284,17,01,  Riamana Para,0,82,0,41,0,41,0.0,0.0,0.0,00000
3.0,91.0,19.0,355,01,01,  Gigon Para,12,47,9,18,3,29,20.3,33.3,9.4,00000
3.0,91.0,19.0,355,02,01,  Juytun Para,45,49,28,20,17,29,47.9,58.3,37.0,00000
3.0,91.0,19.0,355,03,01,  Eden Para,34,56,23,23,11,33,37.8,50.0,25.0,00000
3.0,91.0,19.0,355,04,01,  Thangaw Para,0,38,0,18,0,20,0.0,0.0,0.0,00000
3.0,91.0,19.0,355,05,01,  Ramdu Para,37,121,27,62,10,59,23.4,30.3,14.5,00000
3.0,91.0,19.0,355,06,01,  Kala Para,13,49,9,22,4,27,21.0,29.0,12.9,00000
3.0,91.0,19.0,355,07,01,  Maihui Para,6,120,3,60,3,60,4.8,4.8,4.8,00000
3.0,91.0,19.0,355,08,01,  Adika Para,37,56,25,25,12,31,39.8,50.0,27.9,00000
3.0,91.0,19.0,355,09,01,  Manglu Para,16,116,16,47,0,69,12.1,25.4,0.0,00000
3.0,91.0,19.0,355,10,01,  Mungaha Para,20,64,16,22,4,42,23.8,42.1,8.7,00000
3.0,91.0,19.0,355,11,01,  Natun Para,0,39,0,19,0,20,0.0,0.0,0.0,00000
3.0,91.0,19.0,710,01,01,  Khilai Para,0,26,0,14,0,12,0.0,0.0,0.0,00000
3.0,91.0,19.0,710,02,01,  Ruifa Para,7,148,6,78,1,70,4.5,7.1,1.4,00000
3.0,91.0,19.0,710,03,01,  Abupara,24,69,17,32,7,37,25.8,34.7,15.9,00000
3.0,91.0,19.0,710,04,01,  Sutui Para,0,31,0,14,0,17,0.0,0.0,0.0,00000
3.0,91.0,19.0,710,05,01,  Pantala Para,39,188,23,86,16,102,17.2,21.1,13.6,00000
3.0,91.0,19.0,710,06,01,  Rungtom Para,5,18,3,11,2,7,21.7,21.4,22.2,00000
3.0,91.0,19.0,710,07,01,  Kumra Para,9,47,6,20,3,27,16.1,23.1,10.0,00000
3.0,91.0,19.0,710,08,01,  Kenku Para,2,60,1,33,1,27,3.2,2.9,3.6,00000
3.0,91.0,19.0,710,09,01,  Lamba Para,1,59,0,25,1,34,1.7,0.0,2.9,00000
3.0,91.0,19.0,710,10,01,  Amai Para,9,52,7,28,2,24,14.8,20.0,7.7,00000
3.0,91.0,19.0,710,11,01,  Lancha Para,9,94,8,40,1,54,8.7,16.7,1.8,00000
3.0,91.0,19.0,710,12,01,  Menring Para,0,74,0,32,0,42,0.0,0.0,0.0,00000
3.0,91.0,19.0,710,13,01,  Ruma Roy Para,7,51,7,24,0,27,12.1,22.6,0.0,00000
3.0,91.0,19.0,710,14,01,  Shingpru Para,0,32,0,17,0,15,0.0,0.0,0.0,00000
3.0,91.0,19.0,710,15,01,  Menrau Para,3,37,3,20,0,17,7.5,13.0,0.0,00000
3.0,91.0,19.0,710,16,01,  Ruipiu Para,0,38,0,19,0,19,0.0,0.0,0.0,00000
3.0,91.0,19.0,710,17,01,  Namdvi Para,4,112,4,52,0,60,3.4,7.1,0.0,00000
3.0,91.0,19.0,710,18,01,  Valuk Para,0,47,0,24,0,23,0.0,0.0,0.0,00000
3.0,91.0,19.0,710,19,01,  Numlaipara,6,61,4,36,2,25,9.0,10.0,7.4,00000
3.0,91.0,19.0,710,20,01,  Bangkim Para,1,28,0,14,1,14,3.4,0.0,6.7,00000
3.0,91.0,19.0,710,21,01,  Empu Para,16,20,14,6,2,14,44.4,70.0,12.5,00000
3.0,91.0,38.0,071,01,01,  Sengum Para,8,111,4,49,4,62,6.7,7.5,6.1,00000
3.0,91.0,38.0,071,02,01,  Kaulungkhey Para,1,59,1,28,0,31,1.7,3.4,0.0,00000
3.0,91.0,38.0,071,03,01,  Chenagra Para,20,109,17,46,3,63,15.5,27.0,4.5,00000
3.0,91.0,38.0,071,04,01,  Palitan Para,13,91,12,39,1,52,12.5,23.5,1.9,00000
3.0,91.0,38.0,071,05,01,  Chainda Headman Para,45,189,26,91,19,98,19.2,22.2,16.2,00000
3.0,91.0,38.0,071,06,01,  Punar Bason Para,3,79,3,38,0,41,3.7,7.3,0.0,00000
3.0,91.0,38.0,213,01,01,  Sanagra Para,18,85,8,43,10,42,17.5,15.7,19.2,00000
3.0,91.0,38.0,213,02,01,  Pransha Para,13,201,8,96,5,105,6.1,7.7,4.5,00000
3.0,91.0,38.0,213,03,01,  Basatlang Para,53,112,27,47,26,65,32.1,36.5,28.6,00000
3.0,91.0,38.0,213,04,01,  Mualpi Bompara,2,54,2,25,0,29,3.6,7.4,0.0,00000
3.0,91.0,38.0,213,05,01,  Chandrang Para,119,96,77,34,42,62,55.3,69.4,40.4,00000
3.0,91.0,38.0,213,06,01,  Elem Para,12,28,8,12,4,16,30.0,40.0,20.0,00000
3.0,91.0,38.0,213,07,01,  Kaotai,20,77,14,30,6,47,20.6,31.8,11.3,00000
3.0,91.0,38.0,213,08,01,  Hapihil Para,60,44,32,24,28,20,57.7,57.1,58.3,00000
3.0,91.0,38.0,213,09,01,  Mulipimarma Para,7,132,5,63,2,69,5.0,7.4,2.8,00000
3.0,91.0,38.0,426,01,01,  Khamtang Para,51,58,33,25,18,33,46.8,56.9,35.3,00000
3.0,91.0,38.0,426,02,01,  Jurbarang Para,65,86,42,35,23,51,43.0,54.5,31.1,00000
3.0,91.0,38.0,426,03,01,  Chairagra Para,0,33,0,19,0,14,0.0,0.0,0.0,00000
3.0,91.0,38.0,426,04,01,  Arta Para,101,87,51,37,50,50,53.7,58.0,50.0,00000
3.0,91.0,38.0,426,05,01,  Uzani Para,16,68,9,36,7,32,19.0,20.0,17.9,00000
3.0,91.0,38.0,426,06,01,  Nutan Para,16,163,14,110,2,53,8.9,11.3,3.6,00000
3.0,91.0,38.0,426,08,01,  Debachhara Para,2,67,2,33,0,34,2.9,5.7,0.0,00000
3.0,91.0,38.0,426,09,01,  Zaropipara,2,29,1,15,1,14,6.5,6.3,6.7,00000
3.0,91.0,38.0,426,10,01,  Parua Para,12,94,8,50,4,44,11.3,13.8,8.3,00000
3.0,91.0,38.0,426,11,01,  Niankhiyan Para,36,283,20,145,16,138,11.3,12.1,10.4,00000
3.0,91.0,38.0,426,12,01,  Munnuyam Para,53,254,23,128,30,126,17.3,15.2,19.2,00000
3.0,91.0,38.0,426,13,01,  Ranin Para,107,94,70,43,37,51,53.2,61.9,42.0,00000
3.0,91.0,38.0,639,01,01,  Mangsaipru Para,3,69,0,34,3,35,4.2,0.0,7.9,00000
3.0,91.0,38.0,639,02,01,  Tammuk Para,10,151,8,72,2,79,6.2,10.0,2.5,00000
3.0,91.0,38.0,639,03,01,  Paindu Headman Para,20,177,15,97,5,80,10.2,13.4,5.9,00000
3.0,91.0,38.0,639,04,01,  Thoyaiba Para,0,75,0,36,0,39,0.0,0.0,0.0,00000
3.0,91.0,38.0,639,05,01,  Bagan Para,13,80,13,38,0,42,14.0,25.5,0.0,00000
3.0,91.0,38.0,639,06,01,  Gonga Para,2,54,1,27,1,27,3.6,3.6,3.6,00000
3.0,91.0,38.0,639,07,01,  Kopai Karbari Para,3,105,2,53,1,52,2.8,3.6,1.9,00000
3.0,91.0,38.0,639,08,01,  Muiyang Para,0,22,0,9,0,13,0.0,0.0,0.0,00000
3.0,91.0,38.0,639,09,01,  Kanon Para,34,30,20,13,14,17,53.1,60.6,45.2,00000
3.0,91.0,57.0,316,01,01,  Baktai Para,43,71,26,31,17,40,37.7,45.6,29.8,00000
3.0,91.0,57.0,316,02,01,  Darziling Para,18,22,12,12,6,10,45.0,50.0,37.5,00000
3.0,91.0,57.0,316,03,01,  Atiem Para,2,70,1,35,1,35,2.8,2.8,2.8,00000
3.0,91.0,57.0,316,04,01,  Hlaching Para,0,54,0,24,0,30,0.0,0.0,0.0,00000
3.0,91.0,57.0,316,05,01,  Rong Tang Para,3,76,3,33,0,43,3.8,8.3,0.0,00000
3.0,91.0,57.0,316,06,01,  Menron Para,4,102,3,45,1,57,3.8,6.3,1.7,00000
3.0,91.0,57.0,316,07,01,  Menpa Para,1,48,1,25,0,23,2.0,3.8,0.0,00000
3.0,91.0,57.0,316,08,01,  Jagotan Para,8,32,8,12,0,20,20.0,40.0,0.0,00000
3.0,91.0,57.0,316,09,01,  Fainongo Para,6,65,6,28,0,37,8.5,17.6,0.0,00000
3.0,91.0,57.0,316,10,01,  Suiong Para,0,34,0,16,0,18,0.0,0.0,0.0,00000
3.0,91.0,57.0,316,11,01,  Bashirang Para,31,121,19,56,12,65,20.4,25.3,15.6,00000
3.0,91.0,57.0,316,12,01,  Rangiha Para,15,68,10,29,5,39,18.1,25.6,11.4,00000
3.0,91.0,57.0,316,13,01,  Kista Para,12,81,7,36,5,45,12.9,16.3,10.0,00000
3.0,91.0,57.0,316,14,01,  Jonirang Para,12,60,6,25,6,35,16.7,19.4,14.6,00000
3.0,91.0,57.0,316,15,01,  Chini Para,0,38,0,19,0,19,0.0,0.0,0.0,00000
3.0,91.0,57.0,316,16,01,  Chinlock Para,9,100,8,42,1,58,8.3,16.0,1.7,00000
3.0,91.0,57.0,316,17,01,  Gobindra Para,5,26,4,14,1,12,16.1,22.2,7.7,00000
3.0,91.0,57.0,316,18,01,  Nishi Murang Para,2,84,1,41,1,43,2.3,2.4,2.3,00000
3.0,91.0,57.0,316,19,01,  Tilchandra Para,7,18,5,9,2,9,28.0,35.7,18.2,00000
3.0,91.0,57.0,316,20,01,  Danagari Para,9,43,6,14,3,29,17.3,30.0,9.4,00000
3.0,91.0,57.0,316,21,01,  Gadipai Para,28,99,19,49,9,50,22.0,27.9,15.3,00000
3.0,91.0,57.0,316,22,01,  Pashing Para,8,45,5,22,3,23,15.1,18.5,11.5,00000
3.0,91.0,57.0,316,23,01,  Bishai Para,5,37,3,17,2,20,11.9,15.0,9.1,00000
3.0,91.0,57.0,316,24,01,  Lengpu Para,0,39,0,18,0,21,0.0,0.0,0.0,00000
3.0,91.0,57.0,316,25,01,  Bathiram Para,10,45,6,22,4,23,18.2,21.4,14.8,00000
3.0,91.0,57.0,316,26,01,  Ananga Para,16,68,9,33,7,35,19.0,21.4,16.7,00000
3.0,91.0,57.0,316,27,01,  Khaleha Para,2,66,2,35,0,31,2.9,5.4,0.0,00000
3.0,91.0,57.0,316,28,01,  Mrangko Para,48,141,28,70,20,71,25.4,28.6,22.0,00000
3.0,91.0,57.0,316,29,01,  Lohopara,11,68,7,38,4,30,13.9,15.6,11.8,00000
3.0,91.0,57.0,852,01,01,  Sunsum Para,120,81,69,39,51,42,59.7,63.9,54.8,00000
3.0,91.0,57.0,852,02,01,  Nuntiar Para,134,109,79,51,55,58,55.1,60.8,48.7,00000
3.0,91.0,57.0,852,03,01,  Thaikang Para,23,109,16,48,7,61,17.4,25.0,10.3,00000
3.0,91.0,57.0,852,04,01,  Menpa Para,4,41,1,24,3,17,8.9,4.0,15.0,00000
3.0,91.0,57.0,852,05,01,  Kashipai Para,11,35,6,19,5,16,23.9,24.0,23.8,00000
3.0,91.0,57.0,852,06,01,  Tindanti Para,68,115,37,44,31,71,37.2,45.7,30.4,00000
3.0,91.0,57.0,852,07,01,  Slopi Para,60,106,34,55,26,51,36.1,38.2,33.8,00000
3.0,91.0,57.0,852,08,01,  Lengu Para,30,90,18,51,12,39,25.0,26.1,23.5,00000
3.0,91.0,57.0,852,09,01,  Chhaikheyoun Para,69,171,35,85,34,86,28.8,29.2,28.3,00000
3.0,91.0,57.0,852,10,01,  Tamlu Para,117,70,67,20,50,50,62.6,77.0,50.0,00000
3.0,91.0,57.0,852,11,01,  Dula Chan Para,45,147,33,67,12,80,23.4,33.0,13.0,00000
3.0,91.0,76.0,497,01,01,  Palika  Para,16,205,8,96,8,109,7.2,7.7,6.8,00000
3.0,91.0,76.0,497,02,01,  Tandhaziri  Para,3,99,3,51,0,48,2.9,5.6,0.0,00000
3.0,91.0,76.0,497,03,01,  Kraudang  Para,1,99,1,61,0,38,1.0,1.6,0.0,00000
3.0,91.0,76.0,497,04,01,  Arzun  Para,5,103,5,50,0,53,4.6,9.1,0.0,00000
3.0,91.0,76.0,497,05,01,  Malenggra  Para,19,91,14,53,5,38,17.3,20.9,11.6,00000
3.0,91.0,76.0,497,06,01,  Bashadew Para,7,82,4,44,3,38,7.9,8.3,7.3,00000
3.0,91.0,76.0,497,07,01,  Aungswe  Para,4,53,2,29,2,24,7.0,6.5,7.7,00000
3.0,91.0,76.0,497,08,01,  Najerat  Para,39,30,17,15,22,15,56.5,53.1,59.5,00000
3.0,91.0,76.0,497,09,01,  Mong Thoaishing Para,5,79,0,38,5,41,6.0,0.0,10.9,00000
3.0,91.0,76.0,497,10,01,  Chinlak  Para,7,69,3,38,4,31,9.2,7.3,11.4,00000
3.0,91.0,76.0,497,11,01,  Naitong Para,1,172,1,91,0,81,0.6,1.1,0.0,00000
3.0,91.0,76.0,497,12,01,  Samakhal  Para,29,186,18,91,11,95,13.5,16.5,10.4,00000
3.0,91.0,76.0,497,13,01,  Kaotai Para,0,40,0,19,0,21,0.0,0.0,0.0,00000
3.0,91.0,76.0,497,14,01,  Rijuk Para,5,53,3,24,2,29,8.6,11.1,6.5,00000
3.0,91.0,76.0,497,15,01,  Monlai Para,204,37,111,21,93,16,84.6,84.1,85.3,00000
3.0,91.0,76.0,497,16,01,  Thonthom Ziri Para,0,21,0,12,0,9,0.0,0.0,0.0,00000
3.0,91.0,76.0,497,17,01,  Mongyo Para,3,78,0,38,3,40,3.7,0.0,7.0,00000
3.0,91.0,76.0,497,18,01,  Mong Shanu Para,1,26,0,14,1,12,3.7,0.0,7.7,00000
3.0,91.0,76.0,497,19,01,  Kembuya Para,3,120,2,64,1,56,2.4,3.0,1.8,00000
3.0,91.0,76.0,497,20,01,  Nangle Para,11,72,6,34,5,38,13.3,15.0,11.6,00000
3.0,91.0,76.0,781,01,01,  Saifopara,28,82,18,35,10,47,25.5,34.0,17.5,00000
3.0,91.0,76.0,781,02,01,  Battalhem  Para,4,46,1,23,3,23,8.0,4.2,11.5,00000
3.0,91.0,76.0,781,03,01,  Poli Para,40,120,24,56,16,64,25.0,30.0,20.0,00000
3.0,91.0,76.0,781,04,01,  Betel Para,265,284,153,128,112,156,48.3,54.4,41.8,00000
3.0,91.0,76.0,781,05,01,  Jungre Para,1,48,0,23,1,25,2.0,0.0,3.8,00000
3.0,91.0,76.0,781,06,01,  Monagra  Para,0,13,0,7,0,6,0.0,0.0,0.0,00000
3.0,91.0,76.0,781,07,01,  Minziri  Para,65,118,45,38,20,80,35.5,54.2,20.0,00000
3.0,91.0,76.0,781,08,01,  Upazila Elaka  Head.Q.,86,61,68,41,18,20,58.5,62.4,47.4,00000
3.0,91.0,76.0,781,09,01,  Hatimatha  Para,42,72,29,39,13,33,36.8,42.6,28.3,00000
3.0,91.0,76.0,781,10,01,  Pailot Para,160,57,94,26,66,31,73.7,78.3,68.0,00000
3.0,91.0,76.0,781,11,01,  Jigon Para,63,28,36,10,27,18,69.2,78.3,60.0,00000
3.0,91.0,76.0,781,12,01,  Barua Para,42,180,24,102,18,78,18.9,19.0,18.8,00000
3.0,91.0,76.0,781,13,01,  Asrom Para,131,113,65,47,66,66,53.7,58.0,50.0,00000
3.0,91.0,76.0,781,14,01,  Cauncil Elaka,63,44,34,20,29,24,58.9,63.0,54.7,00000
3.0,91.0,76.0,781,15,01,  Muslim Para,116,77,64,36,52,41,60.1,64.0,55.9,00000
3.0,91.0,76.0,781,16,01,  Thana Para,194,118,156,75,38,43,62.2,67.5,46.9,00000
3.0,91.0,76.0,781,17,01,  Guna Para,155,72,78,37,77,35,68.3,67.8,68.8,00000
3.0,91.0,76.0,781,18,01,  Eden Para,95,41,49,16,46,25,69.9,75.4,64.8,00000
3.0,91.0,76.0,781,19,01,  Lon Ziri Para,48,38,30,17,18,21,55.8,63.8,46.2,00000
3.0,91.0,76.0,781,20,01,  Lairopi Para,116,46,65,16,51,30,71.6,80.2,63.0,00000
3.0,91.0,76.0,781,21,01,  Ruma Bazar East,101,83,69,38,32,45,54.9,64.5,41.6,00000
3.0,91.0,76.0,781,22,01,  Ruma Bazar West,125,83,110,68,15,15,60.1,61.8,50.0,00000
3.0,91.0,76.0,781,23,01,  Ruma Bazar North,188,17,155,11,33,6,91.7,93.4,84.6,00000
3.0,91.0,76.0,781,24,01,  Ruma Bazar South,112,68,73,25,39,43,62.2,74.5,47.6,00000
3.0,91.0,76.0,781,25,01,  College Area,44,30,26,14,18,16,59.5,65.0,52.9,00000
3.0,91.0,76.0,781,26,01,  Lebujiri Para,107,36,65,15,42,21,74.8,81.3,66.7,00000
3.0,91.0,76.0,781,27,01,  Chairagra Para,34,59,19,25,15,34,36.6,43.2,30.6,00000
3.0,91.0,76.0,781,28,01,  Selim Para,16,27,10,12,6,15,37.2,45.5,28.6,00000
3.0,91.0,76.0,781,29,01,  Eden Road Para,108,31,60,15,48,16,77.7,80.0,75.0,00000
3.0,91.0,76.0,781,30,01,  Borshi Para,1,40,1,18,0,22,2.4,5.3,0.0,00000
3.0,91.0,76.0,781,31,01,  Mongshadi,45,50,25,25,20,25,47.4,50.0,44.4,00000
3.0,91.0,76.0,781,32,01,  Merakfasha Para,0,29,0,16,0,13,0.0,0.0,0.0,00000
3.0,91.0,76.0,781,33,01,  Baygomoni Para,10,61,8,27,2,34,14.1,22.9,5.6,00000
3.0,91.0,76.0,781,34,01,  Abashik Elaka,173,69,92,35,81,34,71.5,72.4,70.4,00000
3.0,91.0,76.0,781,35,01,  Ring Tuipara,2,129,2,59,0,70,1.5,3.3,0.0,00000
3.0,91.0,76.0,781,36,01,  Baitunipara,17,56,10,27,7,29,23.3,27.0,19.4,00000
3.0,91.0,76.0,781,37,01,  Crangtong Para,0,65,0,31,0,34,0.0,0.0,0.0,00000
3.0,91.0,76.0,781,39,01,  Shadu Mokpara,1,54,1,25,0,29,1.8,3.8,0.0,00000
3.0,91.0,76.0,781,40,01,  Mongpo Para,5,52,3,27,2,25,8.8,10.0,7.4,00000
3.0,91.0,76.0,923,01,01,  Mendui Para,21,52,15,25,6,27,28.8,37.5,18.2,00000
3.0,91.0,76.0,923,02,01,  Menron Para,0,41,0,19,0,22,0.0,0.0,0.0,00000
3.0,91.0,76.0,923,03,01,  Angga Para,12,115,6,66,6,49,9.4,8.3,10.9,00000
3.0,91.0,76.0,923,04,01,  Saikot Para,0,94,0,45,0,49,0.0,0.0,0.0,00000
3.0,91.0,76.0,923,05,01,  Kulain Para,5,33,4,15,1,18,13.2,21.1,5.3,00000
3.0,91.0,76.0,923,06,01,  Litongshe Para,6,78,6,40,0,38,7.1,13.0,0.0,00000
3.0,91.0,76.0,923,07,01,  Mongthoyaichin Para,10,111,6,59,4,52,8.3,9.2,7.1,00000
3.0,91.0,76.0,923,08,01,  Enam Para,18,122,9,59,9,63,12.9,13.2,12.5,00000
3.0,91.0,76.0,923,09,01,  Rumana Para,44,81,26,38,18,43,35.2,40.6,29.5,00000
3.0,91.0,76.0,923,10,01,  Bagamuk Para,20,81,14,39,6,42,19.8,26.4,12.5,00000
3.0,91.0,76.0,923,11,01,  Bagalek Para,18,58,9,30,9,28,23.7,23.1,24.3,00000
3.0,91.0,76.0,923,12,01,  Ochiram Para,23,54,7,31,16,23,29.9,18.4,41.0,00000
3.0,91.0,76.0,923,13,01,  Rembuk Para,0,31,0,19,0,12,0.0,0.0,0.0,00000
3.0,91.0,76.0,923,14,01,  Mentuk Para,1,53,1,31,0,22,1.9,3.1,0.0,00000
3.0,91.0,76.0,923,15,01,  Luthise Para,2,45,1,20,1,25,4.3,4.8,3.8,00000
3.0,91.0,76.0,923,16,01,  Dharziling Para,21,48,16,23,5,25,30.4,41.0,16.7,00000
3.0,91.0,76.0,923,17,01,  Lalshom Thomg Para,8,20,6,9,2,11,28.6,40.0,15.4,00000
3.0,91.0,76.0,994,01,01,  Bottali Para,116,120,71,51,45,69,49.2,58.2,39.5,00000
3.0,91.0,76.0,994,02,01,  Amttali Para,15,64,9,33,6,31,19.0,21.4,16.2,00000
3.0,91.0,76.0,994,03,01,  Moyour Para,29,147,15,78,14,69,16.5,16.1,16.9,00000
3.0,91.0,76.0,994,04,01,  Mongshaiching Para,7,42,7,18,0,24,14.3,28.0,0.0,00000
3.0,91.0,76.0,994,05,01,  Nami Para,8,70,5,38,3,32,10.3,11.6,8.6,00000
3.0,91.0,76.0,994,06,01,  Thangnum Para,11,12,6,4,5,8,47.8,60.0,38.5,00000
3.0,91.0,76.0,994,07,01,  Ruma Char Upar Para,50,123,31,67,19,56,28.9,31.6,25.3,00000
3.0,91.0,76.0,994,08,01,  Rumachar Nicher Para,18,50,8,27,10,23,26.5,22.9,30.3,00000
3.0,91.0,76.0,994,09,01,  Wikuk Para,1,15,1,7,0,8,6.3,12.5,0.0,00000
3.0,91.0,76.0,994,10,01,  Kaikhyong Jhiri Para,17,124,15,85,2,39,12.1,15.0,4.9,00000
3.0,91.0,76.0,994,11,01,  Dulujiri Para,52,78,32,41,20,37,40.0,43.8,35.1,00000
3.0,91.0,76.0,994,12,01,  Rayal Para,41,23,35,13,6,10,64.1,72.9,37.5,00000
3.0,91.0,76.0,994,13,01,  Sengum Para,8,61,4,36,4,25,11.6,10.0,13.8,00000
13.8,3.0,91.0,076,998,02,*Army Garison (Reserved Area ,354,1,343,1,11,0,99.7,99.7,100.0,00000
3.0,95.0,19.0,633,01,01,  Nagandra Para,3,15,2,6,1,9,16.7,25.0,10.0,00000
3.0,95.0,19.0,633,02,01,  Balipara,271,239,157,107,114,132,53.1,59.5,46.3,00000
3.0,95.0,19.0,633,03,01,  Ghanolal Para,29,16,17,5,12,11,64.4,77.3,52.2,00000
3.0,95.0,19.0,633,04,01,  Pram Datta Para,29,62,17,29,12,33,31.9,37.0,26.7,00000
3.0,95.0,19.0,633,05,01,  Kachu  Para,30,229,18,110,12,119,11.6,14.1,9.2,00000
3.0,95.0,19.0,633,06,01,  Jane Rang Para,9,26,5,10,4,16,25.7,33.3,20.0,00000
3.0,95.0,19.0,633,07,01,  Soarang Para,10,33,7,17,3,16,23.3,29.2,15.8,00000
3.0,95.0,19.0,633,08,01,  Thannak Kome Para,4,31,1,14,3,17,11.4,6.7,15.0,00000
3.0,95.0,19.0,633,09,01,  Halirang Para,47,91,29,35,18,56,34.1,45.3,24.3,00000
3.0,95.0,19.0,633,10,01,  Ramani Para,40,78,21,36,19,42,33.9,36.8,31.1,00000
3.0,95.0,19.0,633,11,01,  Lagra Para,11,6,5,3,6,3,64.7,62.5,66.7,00000
3.0,95.0,19.0,633,12,01,  Hastarung Para,2,4,1,2,1,2,33.3,33.3,33.3,00000
3.0,95.0,19.0,814,01,01,  Chairman Para,61,65,40,22,21,43,48.4,64.5,32.8,00000
3.0,95.0,19.0,814,02,01,  Ailmara Para,107,171,72,78,35,93,38.5,48.0,27.3,00000
3.0,95.0,19.0,814,03,01,  Bhaghan  Para,51,89,26,40,25,49,36.4,39.4,33.8,00000
3.0,95.0,19.0,814,04,01,  Hindu Para,171,194,96,89,75,105,46.8,51.9,41.7,00000
3.0,95.0,19.0,814,05,01,  Bazar Area,354,96,278,74,76,22,78.7,79.0,77.6,00000
3.0,95.0,19.0,814,06,01,  Moni Para,22,112,14,55,8,57,16.4,20.3,12.3,00000
3.0,95.0,19.0,814,07,01,  Darsi Para,60,126,46,52,14,74,32.3,46.9,15.9,00000
3.0,95.0,19.0,814,08,01,  Naikhong Para,65,143,37,62,28,81,31.3,37.4,25.7,00000
3.0,95.0,19.0,814,09,01,  Sakoi  Para,17,87,16,39,1,48,16.3,29.1,2.0,00000
3.0,95.0,19.0,814,10,01,  Shilly Ziri Para,6,78,5,46,1,32,7.1,9.8,3.0,00000
3.0,95.0,19.0,814,11,01,  Dingtey Para,27,85,17,36,10,49,24.1,32.1,16.9,00000
3.0,95.0,19.0,814,12,01,  Krong Khong Para,100,196,57,105,43,91,33.8,35.2,32.1,00000
3.0,95.0,19.0,814,13,01,  Khonjoy Para,30,92,20,41,10,51,24.6,32.8,16.4,00000
3.0,95.0,19.0,814,14,01,  Naidari  Para,11,64,8,27,3,37,14.7,22.9,7.5,00000
3.0,95.0,19.0,814,15,01,  Thohla Ching Para,14,21,5,11,9,10,40.0,31.3,47.4,00000
3.0,95.0,19.0,814,16,01,  Shamario Para,26,95,18,39,8,56,21.5,31.6,12.5,00000
3.0,95.0,19.0,814,17,01,  Komla Bagan,80,127,55,52,25,75,38.6,51.4,25.0,00000
3.0,95.0,38.0,180,01,01,  Japaram Tripura Para,30,142,19,64,11,78,17.4,22.9,12.4,00000
3.0,95.0,38.0,180,02,01,  Anong Khumi Para,3,55,3,28,0,27,5.2,9.7,0.0,00000
3.0,95.0,38.0,180,03,01,  Paimong Marma Para,14,144,8,76,6,68,8.9,9.5,8.1,00000
3.0,95.0,38.0,180,04,01,  Khesha Thoi Para,20,332,17,167,3,165,5.7,9.2,1.8,00000
3.0,95.0,38.0,180,05,01,  Sing Ram Tripura Para,7,80,4,45,3,35,8.0,8.2,7.9,00000
3.0,95.0,38.0,180,06,01,  Sirnodra Moni Para,72,97,40,43,32,54,42.6,48.2,37.2,00000
3.0,95.0,38.0,180,07,01,  Jogha Chandra Para,2,8,2,2,0,6,20.0,50.0,0.0,00000
3.0,95.0,38.0,180,08,01,  Amajoy Para,2,21,2,9,0,12,8.7,18.2,0.0,00000
3.0,95.0,38.0,180,09,01,  Kamong Para,30,88,24,33,6,55,25.4,42.1,9.8,00000
3.0,95.0,38.0,180,10,01,  Punian Para,17,41,12,13,5,28,29.3,48.0,15.2,00000
3.0,95.0,38.0,180,11,01,  Bashia Para,28,86,18,35,10,51,24.6,34.0,16.4,00000
3.0,95.0,38.0,180,12,01,  Hanlirang Para,22,21,15,8,7,13,51.2,65.2,35.0,00000
3.0,95.0,38.0,452,01,01,  Dalian Bhom   Para,40,59,36,27,4,32,40.4,57.1,11.1,00000
3.0,95.0,38.0,452,02,01,  Alkrang Tripura Para,8,66,6,24,2,42,10.8,20.0,4.5,00000
3.0,95.0,38.0,452,03,01,  Keshom Tripura Para,9,31,7,12,2,19,22.5,36.8,9.5,00000
3.0,95.0,38.0,452,04,01,  Kraching Aung Marma Para,3,61,1,31,2,30,4.7,3.1,6.3,00000
3.0,95.0,38.0,452,05,01,  Khong Choymro Para,0,21,0,9,0,12,0.0,0.0,0.0,00000
3.0,95.0,38.0,452,06,01,  Rung Jan Mro Para,0,16,0,10,0,6,0.0,0.0,0.0,00000
3.0,95.0,38.0,452,07,01,  Kalo Tripura Para,7,45,6,24,1,21,13.5,20.0,4.5,00000
3.0,95.0,38.0,452,08,01,  Shoilaung Marma Para,0,10,0,6,0,4,0.0,0.0,0.0,00000
3.0,95.0,38.0,452,09,01,  Hamajoy Tripura Para,8,38,4,20,4,18,17.4,16.7,18.2,00000
3.0,95.0,38.0,452,10,01,  Haikay Mro Para,3,41,2,17,1,24,6.8,10.5,4.0,00000
3.0,95.0,38.0,452,11,01,  Ing Dhoi Mro Para,1,63,1,31,0,32,1.6,3.1,0.0,00000
3.0,95.0,38.0,452,12,01,  Alirang Tripura Para,0,27,0,13,0,14,0.0,0.0,0.0,00000
3.0,95.0,38.0,452,13,01,  Kaoching Marma Para,0,46,0,24,0,22,0.0,0.0,0.0,00000
3.0,95.0,38.0,452,14,01,  Chaihla Ue Marma Para,0,53,0,23,0,30,0.0,0.0,0.0,00000
3.0,95.0,38.0,452,15,01,  Aika Prue Marma Para,0,40,0,20,0,20,0.0,0.0,0.0,00000
3.0,95.0,38.0,452,16,01,  Shaihla Ching Marma Para,0,56,0,34,0,22,0.0,0.0,0.0,00000
3.0,95.0,38.0,452,17,01,  Kaobu Para,2,106,2,49,0,57,1.9,3.9,0.0,00000
3.0,95.0,38.0,452,18,01,  Adomong Para,4,147,3,72,1,75,2.6,4.0,1.3,00000
3.0,95.0,38.0,452,19,01,  Remakri Bazar Area Para,61,97,40,48,21,49,38.6,45.5,30.0,00000
3.0,95.0,38.0,452,20,01,  Mongma Marma Para,12,103,11,50,1,53,10.4,18.0,1.9,00000
3.0,95.0,38.0,452,21,01,  Mongkha Marma Para,0,27,0,14,0,13,0.0,0.0,0.0,00000
3.0,95.0,38.0,723,01,01,  Aunghta Khumi Para,1,25,1,12,0,13,3.8,7.7,0.0,00000
3.0,95.0,38.0,723,02,01,  Aunglay Khumi  Para,3,23,3,13,0,10,11.5,18.8,0.0,00000
3.0,95.0,38.0,723,03,01,  Adha Mro Para,5,46,3,23,2,23,9.8,11.5,8.0,00000
3.0,95.0,38.0,723,04,01,  Naykro Khumi Para,0,55,0,23,0,32,0.0,0.0,0.0,00000
3.0,95.0,38.0,723,05,01,  Chanaung Khumi Para,0,30,0,13,0,17,0.0,0.0,0.0,00000
3.0,95.0,38.0,723,06,01,  Ayek Khumi Para,1,89,1,46,0,43,1.1,2.1,0.0,00000
3.0,95.0,38.0,723,07,01,  Lushang Khumi Para,7,77,6,41,1,36,8.3,12.8,2.7,00000
3.0,95.0,38.0,723,08,01,  Mailoo Khumi Para,0,33,0,14,0,19,0.0,0.0,0.0,00000
3.0,95.0,38.0,723,09,01,  Hanachandra Tripura Para,16,34,8,15,8,19,32.0,34.8,29.6,00000
3.0,95.0,38.0,723,10,01,  Shakhol Ue Marma Para,20,89,11,41,9,48,18.3,21.2,15.8,00000
3.0,95.0,38.0,723,11,01,  Bileram Tripura Para,9,41,7,19,2,22,18.0,26.9,8.3,00000
3.0,95.0,38.0,723,12,01,  Hukum Khumi Para,4,65,1,29,3,36,5.8,3.3,7.7,00000
3.0,95.0,38.0,723,13,01,  Khoidhiaung Marma Para Nhuku,1,110,0,59,1,51,0.9,0.0,1.9,00000
3.0,95.0,38.0,723,14,01,  Raithan Khumi Para,1,25,1,11,0,14,3.8,8.3,0.0,00000
3.0,95.0,38.0,723,15,01,  Mong May Marma Para,10,144,9,70,1,74,6.5,11.4,1.3,00000
3.0,95.0,38.0,723,16,01,  Krahta Tong Marma Para,4,107,2,56,2,51,3.6,3.4,3.8,00000
3.0,95.0,38.0,723,17,01,  Bathoai Aung Marma Para,7,62,5,26,2,36,10.1,16.1,5.3,00000
3.0,95.0,38.0,723,18,01,  Aung Ging Mro Para,6,52,5,24,1,28,10.3,17.2,3.4,00000
3.0,95.0,38.0,723,19,01,  Paisha Khaong Para,35,157,21,75,14,82,18.2,21.9,14.6,00000
3.0,95.0,38.0,723,20,01,  Jhughiram Tripura Para,7,88,6,36,1,52,7.4,14.3,1.9,00000
3.0,95.0,38.0,723,21,01,  Pathoi Mro Para,3,129,2,62,1,67,2.3,3.1,1.5,00000
3.0,95.0,38.0,723,22,01,  Ching Choy  Mro Para,2,138,2,69,0,69,1.4,2.8,0.0,00000
3.0,95.0,38.0,723,23,01,  Usha Thoai Marma Para,2,56,1,27,1,29,3.4,3.6,3.3,00000
3.0,95.0,38.0,723,24,01,  Boro Madhak Bazar Area,5,34,2,17,3,17,12.8,10.5,15.0,00000
3.0,95.0,57.0,090,01,01,  Hana Ram Para,49,72,27,25,22,47,40.5,51.9,31.9,00000
3.0,95.0,57.0,090,02,01,  Nak Thoa Para,39,64,26,27,13,37,37.9,49.1,26.0,00000
3.0,95.0,57.0,090,03,01,  Moki Para,10,38,6,22,4,16,20.8,21.4,20.0,00000
3.0,95.0,57.0,090,04,01,  Aprue Mong Para,37,107,25,52,12,55,25.7,32.5,17.9,00000
3.0,95.0,57.0,090,05,01,  Mariam Para,180,22,119,5,61,17,89.1,96.0,78.2,00000
3.0,95.0,57.0,090,06,01,  Somiti Para,29,15,15,6,14,9,65.9,71.4,60.9,00000
3.0,95.0,57.0,090,07,01,  Chaiaung Para,41,44,31,16,10,28,48.2,66.0,26.3,00000
3.0,95.0,57.0,090,08,01,  Chaku Para,44,75,32,37,12,38,37.0,46.4,24.0,00000
3.0,95.0,57.0,090,09,01,  Robert Para,73,24,44,6,29,18,75.3,88.0,61.7,00000
3.0,95.0,57.0,090,10,01,  Bonak Para,74,33,39,16,35,17,69.2,70.9,67.3,00000
3.0,95.0,57.0,090,11,01,  Thinkkayh Para,107,74,48,37,59,37,59.1,56.5,61.5,00000
3.0,95.0,57.0,090,12,01,  Rahman Ali Para,71,27,41,9,30,18,72.4,82.0,62.5,00000
3.0,95.0,57.0,090,13,01,  Chandak Para,103,83,58,40,45,43,55.4,59.2,51.1,00000
3.0,95.0,57.0,090,14,01,  Manuaung Para,15,15,6,7,9,8,50.0,46.2,52.9,00000
3.0,95.0,57.0,090,15,01,  Shah Jahan Para,38,32,20,12,18,20,54.3,62.5,47.4,00000
3.0,95.0,57.0,090,16,01,  Kramin Para,3,43,1,24,2,19,6.5,4.0,9.5,00000
3.0,95.0,57.0,090,17,01,  Nilod Para,1,72,1,36,0,36,1.4,2.7,0.0,00000
3.0,95.0,57.0,090,18,01,  Chhami Para,10,84,7,39,3,45,10.6,15.2,6.3,00000
3.0,95.0,57.0,090,19,01,  Proyung Para,1,84,1,39,0,45,1.2,2.5,0.0,00000
3.0,95.0,57.0,090,20,01,  Chanting Para,1,59,0,31,1,28,1.7,0.0,3.4,00000
3.0,95.0,57.0,090,21,01,  Mankom Para,0,17,0,11,0,6,0.0,0.0,0.0,00000
3.0,95.0,57.0,090,22,01,  Shadu Joshef Para,33,21,22,8,11,13,61.1,73.3,45.8,00000
3.0,95.0,57.0,090,23,01,  Dong Roy Para,3,60,2,29,1,31,4.8,6.5,3.1,00000
3.0,95.0,57.0,090,24,01,  Tuktong Para,3,115,3,55,0,60,2.5,5.2,0.0,00000
3.0,95.0,57.0,090,25,01,  Thaiwai Para,4,140,2,60,2,80,2.8,3.2,2.4,00000
3.0,95.0,57.0,090,26,01,  Thanchi Bazar Para,350,239,267,157,83,82,59.4,63.0,50.3,00000
3.0,95.0,57.0,090,27,01,  Thana Bazar Area,231,74,165,42,66,32,75.7,79.7,67.3,00000
3.0,95.0,57.0,361,01,01,  Ching Chong Para,7,80,1,37,6,43,8.0,2.6,12.2,00000
3.0,95.0,57.0,361,02,01,  Hapro Para,4,121,3,60,1,61,3.2,4.8,1.6,00000
3.0,95.0,57.0,361,03,01,  Aungfa Para,2,83,2,42,0,41,2.4,4.5,0.0,00000
3.0,95.0,57.0,361,04,01,  Jhalu Para,27,51,19,25,8,26,34.6,43.2,23.5,00000
3.0,95.0,57.0,361,05,01,  Khemd Para,3,52,1,26,2,26,5.5,3.7,7.1,00000
3.0,95.0,57.0,361,06,01,  Niauai Para,0,89,0,41,0,48,0.0,0.0,0.0,00000
3.0,95.0,57.0,361,07,01,  Lang Rui Headman Para,12,176,12,81,0,95,6.4,12.9,0.0,00000
3.0,95.0,57.0,361,08,01,  Sharlar Para,35,37,20,17,15,20,48.6,54.1,42.9,00000
3.0,95.0,57.0,361,09,01,  Kaithong Para,13,88,10,42,3,46,12.9,19.2,6.1,00000
3.0,95.0,57.0,361,10,01,  Kungla Para,2,60,0,37,2,23,3.2,0.0,8.0,00000
3.0,95.0,57.0,361,11,01,  Parta Para,6,61,3,32,3,29,9.0,8.6,9.4,00000
3.0,95.0,57.0,361,12,01,  Nayacharan Para,17,84,10,43,7,41,16.8,18.9,14.6,00000
3.0,95.0,57.0,361,13,01,  Singthola Aungpi Para,48,89,31,53,17,36,35.0,36.9,32.1,00000
3.0,95.0,57.0,361,14,01,  Thangdoi Para,2,50,1,28,1,22,3.8,3.4,4.3,00000
3.0,95.0,57.0,904,01,03,  Naidheri Para,41,88,34,28,7,60,31.8,54.8,10.4,00000
3.0,95.0,57.0,904,02,03,  Rainong Para,0,22,0,11,0,11,0.0,0.0,0.0,00000
3.0,95.0,57.0,904,03,03,  Pakutui Para,1,42,1,24,0,18,2.3,4.0,0.0,00000
3.0,95.0,57.0,904,04,03,  Amtoli Para,16,60,11,27,5,33,21.1,28.9,13.2,00000
3.0,95.0,57.0,904,05,03,  Ushoi Mong Head Man Para,155,170,103,71,52,99,47.7,59.2,34.4,00000
3.0,95.0,57.0,904,06,03,  Narikal Para,23,128,15,66,8,62,15.2,18.5,11.4,00000
3.0,95.0,57.0,904,07,03,  Ampuo Para,19,96,15,46,4,50,16.5,24.6,7.4,00000
3.0,95.0,57.0,904,08,03,  Nia Buth Para,0,48,0,24,0,24,0.0,0.0,0.0,00000
3.0,95.0,57.0,904,09,03,  Chimbu  Para,6,85,4,49,2,36,6.6,7.5,5.3,00000
3.0,95.0,57.0,904,10,03,  Rohin Para,3,116,3,50,0,66,2.5,5.7,0.0,00000
3.0,95.0,57.0,904,11,03,  Bangkang Para,30,140,30,103,0,37,17.6,22.6,0.0,00000
3.0,95.0,57.0,904,12,03,  Ruimut Para,12,43,8,17,4,26,21.8,32.0,13.3,00000
3.0,95.0,57.0,904,13,03,  Prothoy Para,1,20,1,10,0,10,4.8,9.1,0.0,00000
3.0,95.0,57.0,904,14,03,  Nashu Para,3,19,3,11,0,8,13.6,21.4,0.0,00000
3.0,95.0,76.0,271,01,01,  Naisha Mong Para,14,62,11,29,3,33,18.4,27.5,8.3,00000
3.0,95.0,76.0,271,02,01,  Harishchandra,6,39,5,19,1,20,13.3,20.8,4.8,00000
3.0,95.0,76.0,271,03,01,  Handra Moni Para,4,39,4,18,0,21,9.3,18.2,0.0,00000
3.0,95.0,76.0,271,04,01,  Runjhon Para,28,112,17,50,11,62,20.0,25.4,15.1,00000
3.0,95.0,76.0,271,05,01,  Aung Thoai Prue Para,34,59,24,20,10,39,36.6,54.5,20.4,00000
3.0,95.0,76.0,271,06,01,  Tingdong Para,9,70,4,33,5,37,11.4,10.8,11.9,00000
3.0,95.0,76.0,271,07,01,  Tanglung Para,1,104,1,48,0,56,1.0,2.0,0.0,00000
3.0,95.0,76.0,271,08,01,  Maduk Para,10,21,8,8,2,13,32.3,50.0,13.3,00000
3.0,95.0,76.0,271,09,01,  Ching Thoai Aung H/M Para,60,89,45,27,15,62,40.3,62.5,19.5,00000
3.0,95.0,76.0,271,10,01,  Paingre Para,2,9,2,4,0,5,18.2,33.3,0.0,00000
3.0,95.0,76.0,271,11,01,  Maungprue Karbari Para,1,30,1,14,0,16,3.2,6.7,0.0,00000
3.0,95.0,76.0,271,12,01,  Kamasi Para,1,112,1,54,0,58,0.9,1.8,0.0,00000
3.0,95.0,76.0,271,13,01,  Sada Aung Para,7,34,5,17,2,17,17.1,22.7,10.5,00000
3.0,95.0,76.0,542,01,01,  Ramon Para,29,87,19,41,10,46,25.0,31.7,17.9,00000
3.0,95.0,76.0,542,02,01,  Sajhai Para,25,82,20,35,5,47,23.4,36.4,9.6,00000
3.0,95.0,76.0,542,03,01,  Aungshau Para,37,51,34,21,3,30,42.0,61.8,9.1,00000
3.0,95.0,76.0,542,04,01,  Aung Thoa Para,29,44,18,20,11,24,39.7,47.4,31.4,00000
3.0,95.0,76.0,542,05,01,  Jinnah Para,26,109,13,51,13,58,19.3,20.3,18.3,00000
3.0,95.0,76.0,542,06,01,  Paratho Para,23,90,15,42,8,48,20.4,26.3,14.3,00000
3.0,95.0,76.0,542,07,01,  Banko Para,0,113,0,57,0,56,0.0,0.0,0.0,00000
3.0,95.0,76.0,542,08,01,  Bashiha Para,27,32,18,14,9,18,45.8,56.3,33.3,00000
3.0,95.0,76.0,542,09,01,  Thuisha Para,21,56,16,24,5,32,27.3,40.0,13.5,00000
3.0,95.0,76.0,542,10,01,  Basuaung Para,8,32,4,14,4,18,20.0,22.2,18.2,00000
3.0,95.0,76.0,542,11,01,  Hajari Para,18,33,15,15,3,18,35.3,50.0,14.3,00000
3.0,95.0,76.0,994,01,01,  Thonga Karbari Para,18,49,12,23,6,26,26.9,34.3,18.8,00000
3.0,95.0,76.0,994,02,01,  Aung Somg Karbari Para,0,34,0,15,0,19,0.0,0.0,0.0,00000
3.0,95.0,76.0,994,03,01,  Niradun Para,4,128,3,62,1,66,3.0,4.6,1.5,00000
3.0,95.0,76.0,994,04,01,  Bushaug Para,3,75,2,36,1,39,3.8,5.3,2.5,00000
3.0,95.0,76.0,994,05,01,  Paukhumi Para,2,56,2,29,0,27,3.4,6.5,0.0,00000
3.0,95.0,76.0,994,06,01,  Pashau Para,1,62,0,32,1,30,1.6,0.0,3.2,00000
3.0,95.0,76.0,994,07,01,  Manglung Headman Para,0,31,0,13,0,18,0.0,0.0,0.0,00000
3.0,95.0,76.0,994,08,01,  Koaung Para,8,93,5,40,3,53,7.9,11.1,5.4,00000
3.0,95.0,76.0,994,09,01,  Amai Para,2,141,2,72,0,69,1.4,2.7,0.0,00000
3.0,95.0,76.0,994,10,01,  Menta Para,2,102,1,52,1,50,1.9,1.9,2.0,00000
3.0,95.0,76.0,994,11,01,  Kaikak Para,119,209,80,109,39,100,36.3,42.3,28.1,00000
3.0,95.0,76.0,994,12,01,  Aong Baching  Para,2,42,1,21,1,21,4.5,4.5,4.5,00000
3.0,95.0,76.0,994,13,01,  Chaithoaihla Para,1,71,0,33,1,38,1.4,0.0,2.6,00000
19.0,9.0,11.0,008,01,01,  Adda,3780,2295,1654,1098,2126,1197,62.2,60.1,64.0,00000
19.0,9.0,11.0,008,02,01,  Kadirpar,70,143,32,64,38,79,32.9,33.3,32.5,00000
19.0,9.0,11.0,008,03,01,  Shola Pukuria,37,113,17,48,20,65,24.7,26.2,23.5,00000
19.0,9.0,11.0,542,01,01,  Kharul,255,339,107,141,148,198,42.9,43.1,42.8,00000
19.0,9.0,11.0,542,02,01,  Hariavita,110,127,44,67,66,60,46.4,39.6,52.4,00000
19.0,9.0,11.0,547,01,01,  Khatla,498,313,197,142,301,171,61.4,58.1,63.8,00000
19.0,9.0,11.0,547,02,01,  Kandirpar,243,273,101,127,142,146,47.1,44.3,49.3,00000
19.0,9.0,12.0,383,01,01,  Ganak Khuli,420,404,219,199,201,205,51.0,52.4,49.5,00000
19.0,9.0,12.0,383,02,01,  Nowda,76,83,30,40,46,43,47.8,42.9,51.7,00000
19.0,9.0,12.0,383,03,01,  Rajnagar,160,232,61,109,99,123,40.8,35.9,44.6,00000
19.0,9.0,12.0,499,01,01,  Kakairtala,953,1003,392,466,561,537,48.7,45.7,51.1,00000
19.0,9.0,12.0,499,02,01,  Kathalia,113,128,55,59,58,69,46.9,48.2,45.7,00000
19.0,9.0,12.0,628,01,01,  Manoharpur,186,166,86,102,100,64,52.8,45.7,61.0,00000
19.0,9.0,12.0,628,02,01,  Noagaon,224,549,114,262,110,287,29.0,30.3,27.7,00000
19.0,9.0,12.0,749,01,01,  Perpeti,1756,995,804,481,952,514,63.8,62.6,64.9,00000
19.0,9.0,12.0,749,02,01,  Shaplola,106,24,44,9,62,15,81.5,83.0,80.5,00000
19.0,9.0,12.0,913,01,01,  Sonaimuri,870,253,426,132,444,121,77.5,76.3,78.6,00000
19.0,9.0,12.0,913,02,01,  Maish Pukuria,125,73,58,41,67,32,63.1,58.6,67.7,00000
19.0,9.0,18.0,017,01,01,  Aganagar,1759,1830,780,841,979,989,49.0,48.1,49.7,00000
19.0,9.0,18.0,017,02,01,  Mirzanagar,660,630,285,295,375,335,51.2,49.1,52.8,00000
19.0,9.0,18.0,086,01,01,  Bara Hatua,526,577,236,261,290,316,47.7,47.5,47.9,00000
19.0,9.0,18.0,086,02,01,  Gohalia,455,122,221,48,234,74,78.9,82.2,76.0,00000
19.0,9.0,18.0,086,03,01,  Chunarikhola,67,8,33,1,34,7,89.3,97.1,82.9,00000
19.0,9.0,18.0,400,01,01,  Gohinkhali,356,396,154,188,202,208,47.3,45.0,49.3,00000
19.0,9.0,18.0,400,02,01,  Batakhali,110,123,52,54,58,69,47.2,49.1,45.7,00000
19.0,9.0,18.0,430,01,01,  Jagadasar,720,663,324,306,396,357,52.1,51.4,52.6,00000
19.0,9.0,18.0,430,02,01,  Baraipur,1033,736,484,345,549,391,58.4,58.4,58.4,00000
19.0,9.0,18.0,430,03,01,  Sreepur,213,197,99,94,114,103,52.0,51.3,52.5,00000
19.0,9.0,18.0,430,04,01,  Atehora,292,204,140,94,152,110,58.9,59.8,58.0,00000
19.0,9.0,18.0,874,01,01,  Sarabati,1496,2176,642,1061,854,1115,40.7,37.7,43.4,00000
19.0,9.0,18.0,874,02,01,  Murabhazal,461,411,208,193,253,218,52.9,51.9,53.7,00000
19.0,9.0,25.0,030,01,01,  Amtali,89,189,38,93,51,96,32.0,29.0,34.7,00000
19.0,9.0,25.0,030,02,01,  Khatakpur,81,101,38,50,43,51,44.5,43.2,45.7,00000
19.0,9.0,25.0,969,01,01,  Uttar Lakshmipur,895,557,418,263,477,294,61.6,61.4,61.9,00000
19.0,9.0,25.0,969,02,01,  Taluk Para,485,553,232,279,253,274,46.7,45.4,48.0,00000
19.0,9.0,25.0,969,03,01,  Begartapur,328,374,151,191,177,183,46.7,44.2,49.2,00000
19.0,9.0,25.0,969,04,01,  Darganama,173,220,83,118,90,102,44.0,41.3,46.9,00000
19.0,9.0,44.0,064,01,01,  Bankara,438,639,161,311,277,328,40.7,34.1,45.8,00000
19.0,9.0,44.0,064,02,01,  Bara Nischintapur,174,220,57,133,117,87,44.2,30.0,57.4,00000
19.0,9.0,44.0,064,03,01,  Shola Pukuria,94,71,40,36,54,35,57.0,52.6,60.7,00000
19.0,9.0,44.0,297,01,01,  Danishwar,1262,885,558,425,704,460,58.8,56.8,60.5,00000
19.0,9.0,44.0,297,02,01,  Paiya Para,168,70,93,35,75,35,70.6,72.7,68.2,00000
19.0,9.0,44.0,396,01,01,  Ghoshpa,2353,1916,1047,928,1306,988,55.1,53.0,56.9,00000
19.0,9.0,44.0,396,02,01,  Kandi,46,16,20,8,26,8,74.2,71.4,76.5,00000
19.0,9.0,44.0,396,03,01,  Chalitatala,196,22,95,7,101,15,89.9,93.1,87.1,00000
19.0,9.0,44.0,396,04,01,  Chilunia,102,107,52,53,50,54,48.8,49.5,48.1,00000
19.0,9.0,44.0,396,05,01,  Medongi,96,51,47,21,49,30,65.3,69.1,62.0,00000
19.0,9.0,44.0,396,06,01,  Khataia,293,132,132,48,161,84,68.9,73.3,65.7,00000
19.0,9.0,44.0,456,01,01,  Jhapua,345,580,137,288,208,292,37.3,32.2,41.6,00000
19.0,9.0,44.0,456,02,01,  Chhota Kaiani,260,414,84,225,176,189,38.6,27.2,48.2,00000
19.0,9.0,44.0,633,01,01,  Muggaon,946,637,411,301,535,336,59.8,57.7,61.4,00000
19.0,9.0,44.0,633,02,01,  Shayalkhali,447,404,203,192,244,212,52.5,51.4,53.5,00000
19.0,9.0,44.0,633,03,01,  Chotra Pukuria,366,533,143,262,223,271,40.7,35.3,45.1,00000
19.0,9.0,44.0,633,04,01,  Bhauksar,2021,1279,923,606,1098,673,61.2,60.4,62.0,00000
19.0,9.0,44.0,865,01,01,  Sakpur,2469,2775,1045,1366,1424,1409,47.1,43.3,50.3,00000
19.0,9.0,44.0,865,02,01,  Boalia,70,328,38,147,32,181,17.6,20.5,15.0,00000
19.0,9.0,44.0,865,03,01,  Chhota Sakpur,366,96,196,38,170,58,79.2,83.8,74.6,00000
19.0,9.0,44.0,947,01,01,  Tarabaria,292,69,134,19,158,50,80.9,87.6,76.0,00000
19.0,9.0,44.0,947,02,01,  Ashwadia,192,110,96,54,96,56,63.6,64.0,63.2,00000
19.0,9.0,50.0,228,01,01,  Chitadda,786,1171,356,545,430,626,40.2,39.5,40.7,00000
19.0,9.0,50.0,228,02,01,  Baghmara,39,77,13,34,26,43,33.6,27.7,37.7,00000
19.0,9.0,50.0,228,03,01,  Makandapur,1076,1383,486,664,590,719,43.8,42.3,45.1,00000
19.0,9.0,50.0,228,04,01,  Batbari,576,905,235,409,341,496,38.9,36.5,40.7,00000
19.0,9.0,50.0,641,01,01,  Muriara,686,996,323,462,363,534,40.8,41.1,40.5,00000
19.0,9.0,50.0,641,02,01,  Bhangoa,712,489,331,217,381,272,59.3,60.4,58.3,00000
19.0,9.0,50.0,641,03,01,  Itakhola,86,179,36,83,50,96,32.5,30.3,34.2,00000
19.0,9.0,50.0,684,01,01,  Dakshin Odda,804,1244,368,570,436,674,39.3,39.2,39.3,00000
19.0,9.0,50.0,684,02,01,  Uttar Odda,721,924,321,438,400,486,43.8,42.3,45.1,00000
19.0,9.0,50.0,684,03,01,  Paduar Para,146,136,59,54,87,82,51.8,52.2,51.5,00000
19.0,9.0,50.0,684,04,01,  Noapara,373,600,142,260,231,340,38.3,35.3,40.5,00000
19.0,9.0,56.0,129,01,01,  Beolain,1090,994,515,434,575,560,52.3,54.3,50.7,00000
19.0,9.0,56.0,129,02,01,  Kandarpar,38,87,16,51,22,36,30.4,23.9,37.9,00000
19.0,9.0,56.0,193,01,01,  Chhota Barera,413,825,166,380,247,445,33.4,30.4,35.7,00000
19.0,9.0,56.0,193,02,01,  Jogimahai,194,253,76,118,118,135,43.4,39.2,46.6,00000
19.0,9.0,56.0,193,03,01,  Baria,80,77,36,36,44,41,51.0,50.0,51.8,00000
19.0,9.0,56.0,435,01,01,  Jalam,1344,1135,628,526,716,609,54.2,54.4,54.0,00000
19.0,9.0,56.0,435,02,01,  Hazarpar,357,296,193,144,164,152,54.7,57.3,51.9,00000
19.0,9.0,56.0,435,03,01,  Shail Char,324,504,139,242,185,262,39.1,36.5,41.4,00000
19.0,9.0,56.0,435,04,01,  Khalapar,408,516,184,226,224,290,44.2,44.9,43.6,00000
19.0,9.0,56.0,435,05,01,  Kanail,340,325,138,163,202,162,51.1,45.8,55.5,00000
19.0,9.0,56.0,435,06,01,  Noadda,522,628,224,269,298,359,45.4,45.4,45.4,00000
19.0,9.0,56.0,435,07,01,  Bil Pukuria,504,328,237,136,267,192,60.6,63.5,58.2,00000
19.0,9.0,56.0,435,08,01,  Medda,305,320,113,146,192,174,48.8,43.6,52.5,00000
19.0,9.0,56.0,904,01,01,  Singur,554,622,241,255,313,367,47.1,48.6,46.0,00000
19.0,9.0,56.0,904,02,01,  Suacho,71,45,33,23,38,22,61.2,58.9,63.3,00000
19.0,9.0,56.0,917,01,01,  Sosaia,787,571,347,276,440,295,58.0,55.7,59.9,00000
19.0,9.0,56.0,917,02,01,  Shola Pukuria,191,143,75,59,116,84,57.2,56.0,58.0,00000
19.0,9.0,56.0,917,03,01,  Jogi Pukuria,193,71,82,33,111,38,73.1,71.3,74.5,00000
19.0,9.0,63.0,004,01,01,  Adampur,484,874,218,432,266,442,35.6,33.5,37.6,00000
19.0,9.0,63.0,004,02,01,  Payalgucha,550,659,240,315,310,344,45.5,43.2,47.4,00000
19.0,9.0,63.0,004,03,01,  Derarpar,125,155,58,79,67,76,44.6,42.3,46.9,00000
19.0,9.0,63.0,043,01,01,  Arifpur,1483,1902,725,840,758,1062,43.8,46.3,41.6,00000
19.0,9.0,63.0,043,02,01,  Maksipur,564,950,270,422,294,528,37.3,39.0,35.8,00000
19.0,9.0,63.0,194,01,01,  Gopalnagar,1080,810,542,362,538,448,57.1,60.0,54.6,00000
19.0,9.0,63.0,194,02,01,  Katakhola,381,367,181,151,200,216,50.9,54.5,48.1,00000
19.0,9.0,63.0,646,01,01,  Nabipur,947,992,439,476,508,516,48.8,48.0,49.6,00000
19.0,9.0,63.0,646,02,01,  Dadishar,209,104,112,35,97,69,66.8,76.2,58.4,00000
19.0,9.0,63.0,646,03,01,  Karia,95,255,56,113,39,142,27.1,33.1,21.5,00000
19.0,9.0,63.0,663,01,01,  Narasinghpur,170,174,86,78,84,96,49.4,52.4,46.7,00000
19.0,9.0,63.0,663,02,01,  Banshtali,332,513,165,251,167,262,39.3,39.7,38.9,00000
19.0,9.0,63.0,663,03,01,  Alitala,467,488,229,240,238,248,48.9,48.8,49.0,00000
19.0,9.0,63.0,742,01,01,  Shahapur,452,392,209,187,243,205,53.6,52.8,54.2,00000
19.0,9.0,63.0,742,02,01,  Bagabari,343,191,131,99,212,92,64.2,57.0,69.7,00000
19.0,9.0,63.0,742,03,01,  Kemtali,999,190,484,76,515,114,84.0,86.4,81.9,00000
19.0,9.0,63.0,742,04,01,  Gogarpar,255,331,131,159,124,172,43.5,45.2,41.9,00000
19.0,9.0,63.0,742,05,01,  Hazi Para,123,78,51,36,72,42,61.2,58.6,63.2,00000
19.0,9.0,63.0,742,06,01,  Dewan Nagar,676,597,330,272,346,325,53.1,54.8,51.6,00000
19.0,9.0,63.0,796,01,01,  Purba Illashpur,963,949,450,445,513,504,50.4,50.3,50.4,00000
19.0,9.0,63.0,796,02,01,  Jalalpur,221,235,101,110,120,125,48.5,47.9,49.0,00000
19.0,9.0,63.0,796,03,01,  Khosbas,839,835,386,364,453,471,50.1,51.5,49.0,00000
19.0,9.0,63.0,973,01,01,  Uttar Narayanpur,348,754,161,339,187,415,31.6,32.2,31.1,00000
19.0,9.0,63.0,973,02,01,  Rahimpur,311,107,151,41,160,66,74.4,78.6,70.8,00000
19.0,9.0,63.0,973,03,01,  Noapara,197,198,81,86,116,112,49.9,48.5,50.9,00000
19.0,9.0,69.0,081,01,01,  Bara Haripur,1037,1486,483,695,554,791,41.1,41.0,41.2,00000
19.0,9.0,69.0,081,02,01,  Sriram Pur,208,409,73,206,135,203,33.7,26.2,39.9,00000
19.0,9.0,69.0,094,01,01,  Maheshpur,2796,1909,1289,856,1507,1053,59.4,60.1,58.9,00000
19.0,9.0,69.0,094,02,01,  Kalmuri,290,514,120,251,170,263,36.1,32.3,39.3,00000
19.0,9.0,69.0,094,03,01,  Badrarpar,130,312,66,144,64,168,29.4,31.4,27.6,00000
19.0,9.0,69.0,094,04,01,  Hossainpur,714,805,339,347,375,458,47.0,49.4,45.0,00000
19.0,9.0,69.0,094,05,01,  Jangalia,565,600,240,291,325,309,48.5,45.2,51.3,00000
19.0,9.0,69.0,572,01,01,  Mugji,1917,1815,846,869,1071,946,51.4,49.3,53.1,00000
19.0,9.0,69.0,572,02,01,  Rajamara,341,341,161,140,180,201,50.0,53.5,47.2,00000
19.0,9.0,75.0,159,01,01,  Bishnupur,952,437,445,215,507,222,68.5,67.4,69.5,00000
19.0,9.0,75.0,159,02,01,  Shola Pukuria,100,28,43,6,57,22,78.1,87.8,72.2,00000
19.0,9.0,75.0,697,01,01,  Para Baghmara,154,84,52,43,102,41,64.7,54.7,71.3,00000
19.0,9.0,75.0,697,02,01,  Islampur,135,92,52,44,83,48,59.5,54.2,63.4,00000
19.0,9.0,82.0,176,01,01,  Chandpur,1769,1186,793,495,976,691,59.9,61.6,58.5,00000
19.0,9.0,82.0,176,02,01,  Nalua,304,376,111,160,193,216,44.7,41.0,47.2,00000
19.0,9.0,82.0,241,01,01,  Badarpur,159,514,60,240,99,274,23.6,20.0,26.5,00000
19.0,9.0,82.0,241,02,01,  Sindhuria,199,171,96,66,103,105,53.8,59.3,49.5,00000
19.0,9.0,82.0,241,03,01,  Panch Para,141,231,62,107,79,124,37.9,36.7,38.9,00000
19.0,9.0,82.0,258,01,01,  Lakshmipur,428,559,217,255,211,304,43.4,46.0,41.0,00000
19.0,9.0,82.0,258,02,01,  Rahmatganj,214,162,105,87,109,75,56.9,54.7,59.2,00000
19.0,9.0,82.0,271,01,01,  Nischintapur,308,146,118,65,190,81,67.8,64.5,70.1,00000
19.0,9.0,82.0,271,02,01,  Shashurkhatha,60,139,27,71,33,68,30.2,27.6,32.7,00000
19.0,9.0,82.0,676,01,01,  Nayapara,385,454,170,189,215,265,45.9,47.4,44.8,00000
19.0,9.0,82.0,676,02,01,  Prasadpur,41,49,18,21,23,28,45.6,46.2,45.1,00000
19.0,9.0,82.0,753,01,01,  Perul,1437,535,643,236,794,299,72.9,73.2,72.6,00000
19.0,9.0,82.0,753,02,01,  Khajuria,223,90,96,41,127,49,71.2,70.1,72.2,00000
19.0,9.0,82.0,852,01,01,  Ratanpur,210,107,90,51,120,56,66.2,63.8,68.2,00000
19.0,9.0,82.0,852,02,01,  Noadda,104,171,44,73,60,98,37.8,37.6,38.0,00000
19.0,9.0,88.0,198,01,01,  Chhota Bhatua,335,191,159,93,176,98,63.7,63.1,64.2,00000
19.0,9.0,88.0,198,02,01,  Dari Bhatua,31,43,12,23,19,20,41.9,34.3,48.7,00000
19.0,9.0,88.0,331,01,01,  Dimdol,672,623,287,306,385,317,51.9,48.4,54.8,00000
19.0,9.0,88.0,331,02,01,  Dighali,235,289,89,127,146,162,44.8,41.2,47.4,00000
19.0,9.0,88.0,331,03,01,  Khondakar Hurua,93,122,44,53,49,69,43.3,45.4,41.5,00000
19.0,9.0,88.0,788,01,01,  Purab Gobindapur,209,198,81,94,128,104,51.4,46.3,55.2,00000
19.0,9.0,88.0,788,02,01,  Alokdia,99,76,39,35,60,41,56.6,52.7,59.4,00000
19.0,9.0,94.0,060,01,01,  Balua,566,800,197,387,369,413,41.4,33.7,47.2,00000
19.0,9.0,94.0,060,02,01,  Khairat Para,122,184,42,78,80,106,39.9,35.0,43.0,00000
19.0,9.0,94.0,060,03,01,  Shilmuri,285,551,124,236,161,315,34.1,34.4,33.8,00000
19.0,9.0,94.0,090,01,01,  Bara Lakshimpur,613,789,254,394,359,395,43.7,39.2,47.6,00000
19.0,9.0,94.0,090,02,01,  Joyag,880,618,372,287,508,331,58.7,56.4,60.5,00000
19.0,9.0,94.0,172,01,01,  Chandipur,251,320,91,161,160,159,44.0,36.1,50.2,00000
19.0,9.0,94.0,172,02,01,  Baycha Pukuria,55,68,20,36,35,32,44.7,35.7,52.2,00000
19.0,9.0,94.0,861,01,01,  Sailcho,410,283,179,117,231,166,59.2,60.5,58.2,00000
19.0,9.0,94.0,861,02,01,  Hugli,79,34,39,9,40,25,69.9,81.3,61.5,00000
19.0,9.0,94.0,934,01,01,  Sundar Doul,357,433,151,219,206,214,45.2,40.8,49.0,00000
19.0,9.0,94.0,934,02,01,  Rampur,232,238,90,119,142,119,49.4,43.1,54.4,00000
19.0,9.0,94.0,934,03,01,  Bakusar,90,122,32,58,58,64,42.5,35.6,47.5,00000
19.0,15.0,18.0,218,01,01,  Dagra Para,646,707,327,318,319,389,47.7,50.7,45.1,00000
19.0,15.0,18.0,218,02,01,  Kalpabash,1478,975,763,435,715,540,60.3,63.7,57.0,00000
19.0,15.0,18.0,656,01,01,  Nandi Para,587,400,298,187,289,213,59.5,61.4,57.6,00000
19.0,15.0,18.0,656,02,01,  Dhanya Daul,1668,1073,784,502,884,571,60.9,61.0,60.8,00000
19.0,15.0,30.0,388,01,01,  Dulalpur,2639,2238,1285,1026,1354,1212,54.1,55.6,52.8,00000
19.0,15.0,30.0,388,02,01,  Balina,1477,995,685,418,792,577,59.7,62.1,57.9,00000
19.0,15.0,44.0,238,01,01,  Chandla Parba,1747,2076,789,963,958,1113,45.7,45.0,46.3,00000
19.0,15.0,44.0,238,02,01,  Dakshin Chandla,1579,1029,755,469,824,560,60.5,61.7,59.5,00000
19.0,15.0,44.0,238,03,01,  Purba Chandla,1877,1353,897,602,980,751,58.1,59.8,56.6,00000
19.0,15.0,56.0,835,01,01,  Uttar Chandla,1177,1697,569,766,608,931,41.0,42.6,39.5,00000
19.0,15.0,56.0,835,02,01,  Barani,662,1029,321,482,341,547,39.1,40.0,38.4,00000
19.0,15.0,56.0,835,03,01,  Jamtali,714,1146,315,541,399,605,38.4,36.8,39.7,00000
19.0,15.0,82.0,830,01,01,  Sahebabad,3138,2938,1522,1403,1616,1535,51.6,52.0,51.3,00000
19.0,15.0,82.0,830,02,01,  Nagarpar,853,937,391,420,462,517,47.7,48.2,47.2,00000
19.0,15.0,88.0,298,01,01,  Deosh,498,594,237,286,261,308,45.6,45.3,45.9,00000
19.0,15.0,88.0,298,02,01,  Sajghar,767,698,354,316,413,382,52.4,52.8,51.9,00000
19.0,15.0,88.0,298,03,01,  Chubash,788,637,364,299,424,338,55.3,54.9,55.6,00000
19.0,15.0,88.0,616,01,01,  Dakshin Nagaish,3176,3040,1528,1489,1648,1551,51.1,50.6,51.5,00000
19.0,15.0,88.0,616,02,01,  Uttar Nagaish,206,349,102,172,104,177,37.1,37.2,37.0,00000
19.0,15.0,88.0,975,01,01,  Ramchandrapur,899,754,441,342,458,412,54.4,56.3,52.6,00000
19.0,15.0,88.0,975,02,01,  Ganganagar,451,655,229,329,222,326,40.8,41.0,40.5,00000
19.0,18.0,11.0,485,01,01,  Purba Khodaitali,241,198,108,87,133,111,54.9,55.4,54.5,00000
19.0,18.0,11.0,485,02,01,  Paschim Khodaitali,210,184,89,91,121,93,53.3,49.4,56.5,00000
19.0,18.0,11.0,492,01,01,  Gadanagar,231,64,104,29,127,35,78.3,78.2,78.4,00000
19.0,18.0,11.0,492,02,01,  Kodalia,424,343,209,163,215,180,55.3,56.2,54.4,00000
19.0,18.0,12.0,053,01,01,  Kusumpur,775,725,392,316,383,409,51.7,55.4,48.4,00000
19.0,18.0,12.0,053,02,01,  Dayarampur,626,310,320,127,306,183,66.9,71.6,62.6,00000
19.0,18.0,63.0,159,01,01,  Binandiar Char,290,287,150,168,140,119,50.3,47.2,54.1,00000
19.0,18.0,63.0,159,02,01,  Gandal,278,277,140,126,138,151,50.1,52.6,47.8,00000
19.0,18.0,63.0,159,03,01,  Jumur,692,432,352,210,340,222,61.6,62.6,60.5,00000
19.0,18.0,63.0,415,01,01,  Kachharitala,494,412,248,195,246,217,54.5,56.0,53.1,00000
19.0,18.0,63.0,415,02,01,  Ganaspur,387,152,203,64,184,88,71.8,76.0,67.6,00000
19.0,18.0,63.0,415,03,01,  Narpar,48,55,22,29,26,26,46.6,43.1,50.0,00000
19.0,18.0,63.0,637,01,01,  Namtala,843,724,412,338,431,386,53.8,54.9,52.8,00000
19.0,18.0,63.0,637,02,01,  Badua Para,705,260,346,115,359,145,73.1,75.1,71.2,00000
19.0,18.0,63.0,803,01,01,  Rampal,820,1012,393,507,427,505,44.8,43.7,45.8,00000
19.0,18.0,63.0,803,02,01,  Farizpur,2051,790,1057,366,994,424,72.2,74.3,70.1,00000
19.0,18.0,63.0,811,01,01,  Saha Daulatpur,2346,1986,1180,953,1166,1033,54.2,55.3,53.0,00000
19.0,18.0,63.0,811,02,01,  Gus Nagar,2911,752,1361,322,1550,430,79.5,80.9,78.3,00000
19.0,18.0,63.0,811,03,01,  Narayansar,1134,739,560,335,574,404,60.5,62.6,58.7,00000
19.0,18.0,63.0,811,04,01,  Karimabad,714,194,314,77,400,117,78.6,80.3,77.4,00000
19.0,18.0,69.0,294,01,01,  Dubair Char,686,752,353,394,333,358,47.7,47.3,48.2,00000
19.0,18.0,69.0,294,02,01,  Saha Dilerbagh,430,679,193,328,237,351,38.8,37.0,40.3,00000
19.0,18.0,69.0,294,03,01,  Changachha,998,791,522,372,476,419,55.8,58.4,53.2,00000
19.0,18.0,69.0,468,01,01,  Kedarpur,189,121,87,54,102,67,61.0,61.7,60.4,00000
19.0,18.0,69.0,468,02,01,  Halgaon,287,263,125,127,162,136,52.2,49.6,54.4,00000
19.0,18.0,69.0,468,03,01,  Panchkita,812,704,416,323,396,381,53.6,56.3,51.0,00000
19.0,18.0,69.0,468,04,01,  Rupti,355,302,171,146,184,156,54.0,53.9,54.1,00000
19.0,18.0,69.0,468,05,01,  Parihal Para,1356,1061,639,535,717,526,56.1,54.4,57.7,00000
19.0,18.0,69.0,497,01,01,  Korpai,2710,2752,1333,1318,1377,1434,49.6,50.3,49.0,00000
19.0,18.0,69.0,497,02,01,  Nayakamta,1101,487,538,206,563,281,69.3,72.3,66.7,00000
19.0,18.0,69.0,569,01,01,  Manghata,287,266,151,117,136,149,51.9,56.3,47.7,00000
19.0,18.0,69.0,569,02,01,  Loar Char,261,301,119,144,142,157,46.4,45.2,47.5,00000
19.0,18.0,69.0,608,01,01,  Mokam,610,546,312,257,298,289,52.8,54.8,50.8,00000
19.0,18.0,69.0,608,02,01,  Madhabpur,503,770,254,401,249,369,39.5,38.8,40.3,00000
19.0,18.0,69.0,652,01,01,  Nimsar,1134,775,604,409,530,366,59.4,59.6,59.2,00000
19.0,18.0,69.0,652,02,01,  Shyampur,176,156,75,66,101,90,53.0,53.2,52.9,00000
19.0,18.0,72.0,246,01,01,  Dakshin Shyampur,635,719,295,317,340,402,46.9,48.2,45.8,00000
19.0,18.0,72.0,246,02,01,  Baria,307,281,162,123,145,158,52.2,56.8,47.9,00000
19.0,27.0,13.0,236,01,01,  Chhayagharia,885,441,437,190,448,251,66.7,69.7,64.1,00000
19.0,27.0,13.0,236,02,01,  Tulatali,137,132,62,72,75,60,50.9,46.3,55.6,00000
19.0,27.0,13.0,315,01,01,  Dotala,1108,721,572,338,536,383,60.6,62.9,58.3,00000
19.0,27.0,13.0,315,02,01,  Gobindapur,284,262,140,123,144,139,52.0,53.2,50.9,00000
19.0,27.0,13.0,505,01,01,  Keran Khal,784,489,414,198,370,291,61.6,67.6,56.0,00000
19.0,27.0,13.0,505,02,01,  Nuritala,380,187,181,76,199,111,67.0,70.4,64.2,00000
19.0,27.0,13.0,505,03,01,  Korerpar,361,336,186,171,175,165,51.8,52.1,51.5,00000
19.0,27.0,13.0,789,01,01,  Purba Ambarpur,381,169,186,70,195,99,69.3,72.7,66.3,00000
19.0,27.0,13.0,789,02,01,  Dumuria,459,616,232,277,227,339,42.7,45.6,40.1,00000
19.0,27.0,13.0,789,03,01,  Kachua,169,85,76,34,93,51,66.5,69.1,64.6,00000
19.0,27.0,13.0,789,04,01,  Monderhat,209,143,103,66,106,77,59.4,60.9,57.9,00000
19.0,27.0,13.0,916,01,01,  Tegharia,906,842,424,361,482,481,51.8,54.0,50.1,00000
19.0,27.0,13.0,916,02,01,  Satbaria,406,189,210,75,196,114,68.2,73.7,63.2,00000
19.0,27.0,13.0,916,03,01,  Rameshwar,254,88,128,36,126,52,74.3,78.0,70.8,00000
19.0,27.0,13.0,931,01,01,  Thangaon,501,352,274,140,227,212,58.7,66.2,51.7,00000
19.0,27.0,13.0,931,02,01,  Bagmera,101,89,58,43,43,46,53.2,57.4,48.3,00000
19.0,27.0,13.0,931,03,01,  Nischintapur,108,53,59,19,49,34,67.1,75.6,59.0,00000
19.0,27.0,13.0,931,04,01,  Paschim Harikala,521,672,286,348,235,324,43.7,45.1,42.0,00000
19.0,27.0,15.0,102,01,01,  Bara Barera,1584,1567,739,749,845,818,50.3,49.7,50.8,00000
19.0,27.0,15.0,102,02,01,  Dobaria,517,599,230,274,287,325,46.3,45.6,46.9,00000
19.0,27.0,15.0,102,03,01,  Bherbhanga,202,251,84,108,118,143,44.6,43.8,45.2,00000
19.0,27.0,15.0,102,04,01,  Garamara,288,628,120,308,168,320,31.4,28.0,34.4,00000
19.0,27.0,15.0,102,05,01,  Ganipur,621,448,317,187,304,261,58.1,62.9,53.8,00000
19.0,27.0,15.0,102,06,01,  Joydebpur,528,376,277,156,251,220,58.4,64.0,53.3,00000
19.0,27.0,15.0,102,07,01,  Faridpur,276,264,124,140,152,124,51.1,47.0,55.1,00000
19.0,27.0,15.0,102,08,01,  Lonakanda,451,294,205,129,246,165,60.5,61.4,59.9,00000
19.0,27.0,15.0,102,09,01,  Goatmeher,117,51,55,19,62,32,69.6,74.3,66.0,00000
19.0,27.0,15.0,102,10,01,  Narasingpur,264,257,120,116,144,141,50.7,50.8,50.5,00000
19.0,27.0,15.0,229,01,01,  Chhatadda,541,402,262,171,279,231,57.4,60.5,54.7,00000
19.0,27.0,15.0,229,02,01,  Kazipara,295,578,121,253,174,325,33.8,32.4,34.9,00000
19.0,27.0,15.0,750,01,01,  Ramchandrapur,178,364,86,153,92,211,32.8,36.0,30.4,00000
19.0,27.0,15.0,750,02,01,  Tatera,502,536,237,226,265,310,48.4,51.2,46.1,00000
19.0,27.0,20.0,608,01,01,  Manipur,90,97,41,42,49,55,48.1,49.4,47.1,00000
19.0,27.0,20.0,608,02,01,  Paria,147,199,64,87,83,112,42.5,42.4,42.6,00000
19.0,27.0,20.0,679,01,01,  Nij Mahichal,2375,1949,1115,869,1260,1080,54.9,56.2,53.8,00000
19.0,27.0,20.0,679,02,01,  Noapara,289,248,125,122,164,126,53.8,50.6,56.6,00000
19.0,27.0,20.0,679,03,01,  Haraldar,304,317,137,154,167,163,49.0,47.1,50.6,00000
19.0,27.0,20.0,679,04,01,  Tulakura,59,65,24,29,35,36,47.6,45.3,49.3,00000
19.0,27.0,20.0,679,05,01,  Habatia Para,130,217,63,99,67,118,37.5,38.9,36.2,00000
19.0,27.0,20.0,679,06,01,  Lararpar,70,176,34,78,36,98,28.5,30.4,26.9,00000
19.0,27.0,20.0,679,07,01,  Jinia,88,132,42,54,46,78,40.0,43.8,37.1,00000
19.0,27.0,20.0,679,08,01,  Bagmara,108,206,51,108,57,98,34.4,32.1,36.8,00000
19.0,27.0,20.0,679,09,01,  Tatuia,136,87,56,37,80,50,61.0,60.2,61.5,00000
19.0,27.0,20.0,679,10,01,  Kaiarpar,178,98,88,49,90,49,64.5,64.2,64.7,00000
19.0,27.0,20.0,679,11,01,  Gabgachhia,272,148,141,69,131,79,64.8,67.1,62.4,00000
19.0,27.0,20.0,679,12,01,  Batabaria,344,241,170,107,174,134,58.8,61.4,56.5,00000
19.0,27.0,20.0,679,13,01,  Nischintapur,60,72,32,33,28,39,45.5,49.2,41.8,00000
19.0,27.0,20.0,679,14,01,  Jamira Para,778,486,396,216,382,270,61.6,64.7,58.6,00000
19.0,27.0,20.0,679,15,01,  Jor Pukuria,491,351,231,155,260,196,58.3,59.8,57.0,00000
19.0,27.0,20.0,679,16,01,  Chhenga Gachhia,79,25,40,4,39,21,76.0,90.9,65.0,00000
19.0,27.0,23.0,094,01,01,  Bara Karai,3153,2782,1438,1281,1715,1501,53.1,52.9,53.3,00000
19.0,27.0,23.0,094,02,01,  Languramuri,358,348,157,152,201,196,50.7,50.8,50.6,00000
19.0,27.0,23.0,094,03,01,  Naraso,379,74,177,34,202,40,83.7,83.9,83.5,00000
19.0,27.0,23.0,094,04,01,  Tegharia,243,122,129,61,114,61,66.6,67.9,65.1,00000
19.0,27.0,23.0,094,05,01,  Gayaria  (Labus),848,373,410,186,438,187,69.5,68.8,70.1,00000
19.0,27.0,23.0,434,01,01,  Kaduti,1406,615,699,225,707,390,69.6,75.6,64.4,00000
19.0,27.0,23.0,434,02,01,  Lanai,378,306,187,130,191,176,55.3,59.0,52.0,00000
19.0,27.0,31.0,307,01,01,  Dherera,1489,1610,638,774,851,836,48.0,45.2,50.4,00000
19.0,27.0,31.0,307,02,01,  Jatasar,448,337,199,145,249,192,57.1,57.8,56.5,00000
19.0,27.0,31.0,307,03,01,  Bhourpar,550,369,232,171,318,198,59.8,57.6,61.6,00000
19.0,27.0,31.0,307,04,01,  Nalua,88,234,49,117,39,117,27.3,29.5,25.0,00000
19.0,27.0,31.0,402,01,01,  Joyag,1452,2096,677,981,775,1115,40.9,40.8,41.0,00000
19.0,27.0,31.0,402,02,01,  Kandi,194,149,78,72,116,77,56.6,52.0,60.1,00000
19.0,27.0,31.0,402,03,01,  Noagaon,620,489,260,224,360,265,55.9,53.7,57.6,00000
19.0,27.0,31.0,734,01,01,  Paschim Lakshmipur,605,519,272,266,333,253,53.8,50.6,56.8,00000
19.0,27.0,31.0,734,02,01,  Purba Lakshmipur,373,324,132,170,241,154,53.5,43.7,61.0,00000
19.0,27.0,39.0,773,01,01,  Pihar,1256,1204,630,541,626,663,51.1,53.8,48.6,00000
19.0,27.0,39.0,773,02,01,  Pihar Gobindapur,204,225,103,113,101,112,47.6,47.7,47.4,00000
19.0,27.0,39.0,876,01,01,  Sreemantapur,1554,2261,663,1112,891,1149,40.7,37.4,43.7,00000
19.0,27.0,39.0,876,02,01,  Barkait,1508,1478,732,684,776,794,50.5,51.7,49.4,00000
19.0,27.0,39.0,876,03,01,  Shitalpur,269,251,118,111,151,140,51.7,51.5,51.9,00000
19.0,27.0,39.0,876,04,01,  Khirasar Mohanpur,414,579,178,281,236,298,41.7,38.8,44.2,00000
19.0,27.0,39.0,876,05,01,  Kismat Sreemantapur,338,480,149,220,189,260,41.3,40.4,42.1,00000
19.0,27.0,39.0,876,06,01,  Jurpuni,177,83,87,38,90,45,68.1,69.6,66.7,00000
19.0,27.0,39.0,876,07,01,  Tembulia,89,26,38,11,51,15,77.4,77.6,77.3,00000
19.0,27.0,39.0,876,08,01,  Mohanpur,509,892,219,419,290,473,36.3,34.3,38.0,00000
19.0,27.0,39.0,876,09,01,  Chandira,303,183,143,90,160,93,62.3,61.4,63.2,00000
19.0,27.0,47.0,244,01,01,  Madushair,42,577,16,270,26,307,6.8,5.6,7.8,00000
19.0,27.0,47.0,244,02,01,  Baniachang,923,752,420,322,503,430,55.1,56.6,53.9,00000
19.0,27.0,47.0,244,03,01,  Atbarpur,2023,2409,945,1142,1078,1267,45.6,45.3,46.0,00000
19.0,27.0,55.0,118,01,01,  Basantapur,1016,836,434,392,582,444,54.9,52.5,56.7,00000
19.0,27.0,55.0,118,02,01,  Bhuyan Para,307,510,110,234,197,276,37.6,32.0,41.6,00000
19.0,27.0,55.0,118,03,01,  Dharpar,119,85,65,37,54,48,58.3,63.7,52.9,00000
19.0,27.0,55.0,118,04,01,  Bhalar Char,69,158,35,81,34,77,30.4,30.2,30.6,00000
19.0,27.0,55.0,118,05,01,  Sonakandi,237,244,91,124,146,120,49.3,42.3,54.9,00000
19.0,27.0,55.0,355,01,01,  Gallai,1498,3042,703,1421,795,1621,33.0,33.1,32.9,00000
19.0,27.0,55.0,355,02,01,  Karia,154,200,84,91,70,109,43.5,48.0,39.1,00000
19.0,27.0,55.0,355,03,01,  Pachdhara,511,340,251,142,260,198,60.0,63.9,56.8,00000
19.0,27.0,55.0,355,04,01,  Khanaibari,66,159,29,87,37,72,29.3,25.0,33.9,00000
19.0,27.0,55.0,355,05,01,  Mirkala,519,539,276,244,243,295,49.1,53.1,45.2,00000
19.0,27.0,55.0,355,06,01,  Horin Chaturi,124,236,61,117,63,119,34.4,34.3,34.6,00000
19.0,27.0,55.0,513,01,01,  Kesara,949,1051,407,477,542,574,47.5,46.0,48.6,00000
19.0,27.0,55.0,513,02,01,  Jarunda (Jurpunda),380,532,175,279,205,253,41.7,38.5,44.8,00000
19.0,27.0,55.0,955,01,01,  Hossainpur,415,588,206,264,209,324,41.4,43.8,39.2,00000
19.0,27.0,55.0,955,02,01,  Bamuchail,406,302,189,155,217,147,57.3,54.9,59.6,00000
19.0,27.0,55.0,955,03,01,  Bamel) Bamuil,230,181,105,73,125,108,56.0,59.0,53.6,00000
19.0,27.0,55.0,955,04,01,  Padua,106,195,56,83,50,112,35.2,40.3,30.9,00000
19.0,27.0,71.0,047,01,01,  Bakhrabad,597,659,289,300,308,359,47.5,49.1,46.2,00000
19.0,27.0,71.0,047,02,01,  Mirganj,460,219,229,95,231,124,67.7,70.7,65.1,00000
19.0,27.0,71.0,497,01,01,  Kashimpur,531,675,257,326,274,349,44.0,44.1,44.0,00000
19.0,27.0,71.0,497,02,01,  Gobindapur,99,127,52,59,47,68,43.8,46.8,40.9,00000
19.0,27.0,71.0,497,03,01,  Ramarpar,232,220,104,102,128,118,51.3,50.5,52.0,00000
19.0,27.0,71.0,497,04,01,  Mamudpur,322,135,162,55,160,80,70.5,74.7,66.7,00000
19.0,27.0,71.0,663,01,01,  Nautala,2423,2221,1207,1034,1216,1187,52.2,53.9,50.6,00000
19.0,27.0,71.0,663,02,01,  Kamar Para,239,289,135,148,104,141,45.3,47.7,42.4,00000
19.0,27.0,71.0,663,03,01,  Alirtek,314,140,168,59,146,81,69.2,74.0,64.3,00000
19.0,27.0,71.0,663,04,01,  Noapara,144,237,55,118,89,119,37.8,31.8,42.8,00000
19.0,27.0,71.0,663,05,01,  Madhya (Bazar),415,185,215,94,200,91,69.2,69.6,68.7,00000
19.0,27.0,71.0,868,01,01,  Sonapur,577,471,290,233,287,238,55.1,55.4,54.7,00000
19.0,27.0,71.0,868,02,01,  Kalagaon,463,995,213,483,250,512,31.8,30.6,32.8,00000
19.0,27.0,79.0,410,01,01,  Jeruais,1128,656,511,294,617,362,63.2,63.5,63.0,00000
19.0,27.0,79.0,410,02,01,  Baranath,72,49,37,26,35,23,59.5,58.7,60.3,00000
19.0,27.0,79.0,481,01,01,  Kartala,689,613,355,288,334,325,52.9,55.2,50.7,00000
19.0,27.0,79.0,481,02,01,  Bakser,307,145,146,67,161,78,67.9,68.5,67.4,00000
19.0,27.0,79.0,592,01,01,  Maijkhara,968,1412,451,651,517,761,40.7,40.9,40.5,00000
19.0,27.0,79.0,592,02,01,  Chandiara,310,64,168,27,142,37,82.9,86.2,79.3,00000
19.0,27.0,79.0,592,03,01,  Sabnal,38,47,23,24,15,23,44.7,48.9,39.5,00000
19.0,27.0,79.0,592,04,01,  Titkot,163,279,73,125,90,154,36.9,36.9,36.9,00000
19.0,27.0,79.0,592,05,01,  Bherunia,174,108,72,48,102,60,61.7,60.0,63.0,00000
19.0,27.0,79.0,592,06,01,  Katalia,157,143,68,59,89,84,52.3,53.5,51.4,00000
19.0,27.0,79.0,615,01,01,  Mehar,1225,1502,565,668,660,834,44.9,45.8,44.2,00000
19.0,27.0,79.0,615,02,01,  Horina,496,274,252,122,244,152,64.4,67.4,61.6,00000
19.0,27.0,79.0,615,03,01,  Gazaria,287,288,133,113,154,175,49.9,54.1,46.8,00000
19.0,27.0,79.0,615,04,01,  Chhanbaria,161,47,77,24,84,23,77.4,76.2,78.5,00000
19.0,27.0,87.0,623,01,01,  Mohanpur,1677,1650,766,775,911,875,50.4,49.7,51.0,00000
19.0,27.0,87.0,623,02,01,  Nalpuni,140,295,64,136,76,159,32.2,32.0,32.3,00000
19.0,27.0,87.0,631,01,01,  Muradnagar,871,550,441,215,430,335,61.3,67.2,56.2,00000
19.0,27.0,87.0,631,02,01,  Rankhala,81,174,36,95,45,79,31.8,27.5,36.3,00000
19.0,27.0,94.0,205,01,01,  Krishnapur,735,845,321,399,414,446,46.5,44.6,48.1,00000
19.0,27.0,94.0,205,02,01,  Baraia,684,1639,326,815,358,824,29.4,28.6,30.3,00000
19.0,27.0,94.0,418,01,01,  Shaleka,634,1204,281,561,353,643,34.5,33.4,35.4,00000
19.0,27.0,94.0,418,02,01,  Bashakpur,1201,772,571,337,630,435,60.9,62.9,59.2,00000
19.0,27.0,94.0,418,03,01,  Pipuya,744,933,359,413,385,520,44.4,46.5,42.5,00000
19.0,27.0,94.0,418,04,01,  Binodmuri,12,78,2,40,10,38,13.3,4.8,20.8,00000
19.0,27.0,94.0,892,01,01,  Suhilpur,1152,1862,538,867,614,995,38.2,38.3,38.2,00000
19.0,27.0,94.0,892,02,01,  Alipur,165,272,69,129,96,143,37.8,34.8,40.2,00000
19.0,27.0,94.0,892,03,01,  Ranipur,155,273,69,126,86,147,36.2,35.4,36.9,00000
19.0,27.0,94.0,979,01,01,  Uttar Nurpur,244,537,116,269,128,268,31.2,30.1,32.3,00000
19.0,27.0,94.0,979,02,01,  Khob Baria,94,70,48,31,46,39,57.3,60.8,54.1,00000
19.0,31.0,19.0,320,01,01,  Dhulkara,344,202,162,100,182,102,63.0,61.8,64.1,00000
19.0,31.0,19.0,320,02,01,  Gopagram,154,91,65,46,89,45,62.9,58.6,66.4,00000
19.0,31.0,19.0,320,03,01,  Satgharia,114,59,56,24,58,35,65.9,70.0,62.4,00000
19.0,31.0,19.0,476,01,01,  Kabarua,311,221,143,93,168,128,58.5,60.6,56.8,00000
19.0,31.0,19.0,476,02,01,  Kandirpar,206,201,98,100,108,101,50.6,49.5,51.7,00000
19.0,31.0,19.0,762,01,01,  Patadda,265,229,123,127,142,102,53.6,49.2,58.2,00000
19.0,31.0,19.0,762,02,01,  Sonpur,135,65,65,27,70,38,67.5,70.7,64.8,00000
19.0,31.0,38.0,313,01,01,  Dharmapur,220,158,78,70,142,88,58.2,52.7,61.7,00000
19.0,31.0,38.0,313,02,01,  Babuchi,135,156,60,61,75,95,46.4,49.6,44.1,00000
19.0,31.0,38.0,676,01,01,  Morichatali,86,323,36,148,50,175,21.0,19.6,22.2,00000
19.0,31.0,38.0,676,02,01,  Sabek Para,104,324,42,163,62,161,24.3,20.5,27.8,00000
19.0,31.0,38.0,676,03,01,  Bir Chanda Nagar,49,257,18,161,31,96,16.0,10.1,24.4,00000
19.0,31.0,38.0,695,01,01,  Narayanpur,1246,872,546,396,700,476,58.8,58.0,59.5,00000
19.0,31.0,38.0,695,02,01,  Goragora,210,175,102,77,108,98,54.5,57.0,52.4,00000
19.0,31.0,38.0,717,01,01,  Noapara,353,676,178,308,175,368,34.3,36.6,32.2,00000
19.0,31.0,38.0,717,02,01,  Mudipara,172,126,89,58,83,68,57.7,60.5,55.0,00000
19.0,31.0,38.0,799,01,01,  Rajendrapur,231,224,158,112,73,112,50.8,58.5,39.5,00000
19.0,31.0,38.0,799,02,01,  Eashan Chandra Nagar,89,432,40,199,49,233,17.1,16.7,17.4,00000
19.0,31.0,38.0,989,01,01,  Babuchi,106,99,48,46,58,53,51.7,51.1,52.3,00000
19.0,31.0,38.0,989,02,01,  Said Pur,340,253,139,119,201,134,57.3,53.9,60.0,00000
19.0,31.0,47.0,263,01,01,  Dakshin Betiara,790,518,349,261,441,257,60.4,57.2,63.2,00000
19.0,31.0,47.0,263,02,01,  Kemtali,122,37,53,16,69,21,76.7,76.8,76.7,00000
19.0,31.0,47.0,553,01,01,  Kechkimura,416,619,178,281,238,338,40.2,38.8,41.3,00000
19.0,31.0,47.0,553,02,01,  Adarshagram,15,59,4,34,11,25,20.3,10.5,30.6,00000
19.0,31.0,52.0,050,01,01,  1st Badarpur,93,125,40,55,53,70,42.7,42.1,43.1,00000
19.0,31.0,52.0,050,02,01,  2nd Badarpur,350,764,158,356,192,408,31.4,30.7,32.0,00000
19.0,31.0,52.0,435,01,01,  Jammura,1103,350,547,133,556,217,75.9,80.4,71.9,00000
19.0,31.0,52.0,435,02,01,  Kalikrishna Nagar,258,173,117,61,141,112,59.9,65.7,55.7,00000
19.0,31.0,52.0,539,01,01,  Kashipur,222,194,104,100,118,94,53.4,51.0,55.7,00000
19.0,31.0,52.0,539,02,01,  Jagamohanpur,153,159,72,73,81,86,49.0,49.7,48.5,00000
19.0,31.0,52.0,838,01,01,  Mohammadpur,76,118,32,56,44,62,39.2,36.4,41.5,00000
19.0,31.0,52.0,838,02,01,  Samaspur,693,451,304,201,389,250,60.6,60.2,60.9,00000
19.0,31.0,61.0,082,01,01,  Uttar Balumuri,306,246,142,116,164,130,55.4,55.0,55.8,00000
19.0,31.0,61.0,082,02,01,  Dakshin Balumuri,360,109,176,46,184,63,76.8,79.3,74.5,00000
19.0,31.0,61.0,310,01,01,  Dharmapur,308,329,133,167,175,162,48.4,44.3,51.9,00000
19.0,31.0,61.0,310,02,01,  Gopalnagar,394,48,174,17,220,31,89.1,91.1,87.6,00000
19.0,31.0,61.0,467,01,01,  Joymangalpur,1688,1421,843,656,845,765,54.3,56.2,52.5,00000
19.0,31.0,61.0,467,02,01,  Chandinagar,136,87,61,44,75,43,61.0,58.1,63.6,00000
19.0,31.0,61.0,469,01,01,  Jugirkandi,743,645,321,295,422,350,53.5,52.1,54.7,00000
19.0,31.0,61.0,469,02,01,  Hossainpur,765,589,343,283,422,306,56.5,54.8,58.0,00000
19.0,31.0,61.0,469,03,01,  Mohadebpur,49,16,25,9,24,7,75.4,73.5,77.4,00000
19.0,31.0,61.0,615,01,01,  Lakshmipur,171,238,95,107,76,131,41.8,47.0,36.7,00000
19.0,31.0,61.0,615,02,01,  Manikantapur,101,109,60,39,41,70,48.1,60.6,36.9,00000
19.0,31.0,61.0,615,03,01,  Ballabhpur,74,203,37,96,37,107,26.7,27.8,25.7,00000
19.0,31.0,71.0,068,01,01,  Bailpur,442,581,178,353,264,228,43.2,33.5,53.7,00000
19.0,31.0,71.0,068,02,01,  Chhotakhil,304,131,138,52,166,79,69.9,72.6,67.8,00000
19.0,31.0,71.0,668,01,01,  Mestala,770,450,365,225,405,225,63.1,61.9,64.3,00000
19.0,31.0,71.0,668,02,01,  Munshirhat,308,104,147,44,161,60,74.8,77.0,72.9,00000
19.0,31.0,71.0,668,03,01,  Lakshmipur,289,326,140,146,149,180,47.0,49.0,45.3,00000
19.0,31.0,71.0,668,04,01,  Anandapur,234,178,91,89,143,89,56.8,50.6,61.6,00000
19.0,31.0,85.0,132,01,01,  Bijoypur,167,215,79,100,88,115,43.7,44.1,43.3,00000
19.0,31.0,85.0,132,02,01,  Noapara,194,120,80,62,114,58,61.8,56.3,66.3,00000
19.0,31.0,85.0,404,01,01,  Hazari Para,1523,1720,650,801,873,919,47.0,44.8,48.7,00000
19.0,31.0,85.0,404,02,01,  Halchow,189,308,79,138,110,170,38.0,36.4,39.3,00000
19.0,31.0,85.0,729,01,01,  Khamar Pushkarini,320,229,136,112,184,117,58.3,54.8,61.1,00000
19.0,31.0,85.0,729,02,01,  Padua,200,325,79,135,121,190,38.1,36.9,38.9,00000
19.0,31.0,95.0,177,01,01,  Uttar Pratappur,443,158,239,65,204,93,73.7,78.6,68.7,00000
19.0,31.0,95.0,177,02,01,  Dakshin Pratappur,859,679,474,343,385,336,55.9,58.0,53.4,00000
19.0,31.0,95.0,177,03,01,  Balhara,598,255,288,114,310,141,70.1,71.6,68.7,00000
19.0,31.0,95.0,187,01,01,  Chak Kalisha,176,80,93,37,83,43,68.8,71.5,65.9,00000
19.0,31.0,95.0,187,02,01,  Ujirpur,128,84,69,42,59,42,60.4,62.2,58.4,00000
19.0,31.0,95.0,187,03,01,  Purba Belchar Ujirpur,178,160,95,69,83,91,52.7,57.9,47.7,00000
19.0,31.0,95.0,398,01,01,  Koya,104,87,50,40,54,47,54.5,55.6,53.5,00000
19.0,31.0,95.0,398,02,01,  Bhatbari,495,327,210,125,285,202,60.2,62.7,58.5,00000
19.0,31.0,95.0,398,03,01,  Chak Lakshmipur,441,414,216,183,225,231,51.6,54.1,49.3,00000
19.0,31.0,95.0,781,01,01,  Purba Belghar,168,90,85,36,83,54,65.1,70.2,60.6,00000
19.0,31.0,95.0,781,02,01,  Batbari,109,63,44,29,65,34,63.4,60.3,65.7,00000
19.0,31.0,95.0,781,03,01,  Shibpur,122,55,62,22,60,33,68.9,73.8,64.5,00000
19.0,31.0,95.0,789,01,01,  Purba Kashipur,430,247,207,103,223,144,63.5,66.8,60.8,00000
19.0,31.0,95.0,789,02,01,  Suarkhil,517,277,266,134,251,143,65.1,66.5,63.7,00000
19.0,33.0,12.0,051,01,01,  Baghmara,455,671,208,335,247,336,40.4,38.3,42.4,00000
19.0,33.0,12.0,051,02,01,  Khil Para,133,245,55,127,78,118,35.2,30.2,39.8,00000
19.0,33.0,12.0,548,01,01,  Lolai,221,514,90,245,131,269,30.1,26.9,32.8,00000
19.0,33.0,12.0,548,02,01,  Noara,333,745,159,331,174,414,30.9,32.4,29.6,00000
19.0,33.0,12.0,548,03,01,  Batia Para,159,80,71,38,88,42,66.5,65.1,67.7,00000
19.0,33.0,12.0,548,04,01,  Uttar Manoharpur,558,454,265,207,293,247,55.1,56.1,54.3,00000
19.0,33.0,12.0,948,01,01,  Purba Askamta,224,239,102,92,122,147,48.4,52.6,45.4,00000
19.0,33.0,12.0,948,02,01,  Paschim Askamta,489,342,203,168,286,174,58.8,54.7,62.2,00000
19.0,33.0,12.0,952,01,01,  Purba Ashwathatala,280,628,130,323,150,305,30.8,28.7,33.0,00000
19.0,33.0,12.0,952,02,01,  Paschim Ashwathatala,720,630,415,332,305,298,53.3,55.6,50.6,00000
19.0,33.0,24.0,056,01,01,  Bara Dharmapur,1648,2188,832,1086,816,1102,43.0,43.4,42.5,00000
19.0,33.0,24.0,056,02,01,  Dharmapur,93,35,43,19,50,16,72.7,69.4,75.8,00000
19.0,33.0,24.0,056,03,01,  Durgapur,298,180,135,85,163,95,62.3,61.4,63.2,00000
19.0,33.0,24.0,056,04,01,  Ratanpur,556,508,240,290,316,218,52.3,45.3,59.2,00000
19.0,33.0,24.0,195,01,01,  Dakshin Bijoypur,498,272,271,126,227,146,64.7,68.3,60.9,00000
19.0,33.0,24.0,195,02,01,  Bhabanipur,164,76,69,42,95,34,68.3,62.2,73.6,00000
19.0,33.0,24.0,195,03,01,  Tenguria Para,135,84,78,31,57,53,61.6,71.6,51.8,00000
19.0,33.0,24.0,195,04,01,  Hareshpur,360,177,157,85,203,92,67.0,64.9,68.8,00000
19.0,33.0,24.0,195,05,01,  Gangkul,332,181,165,68,167,113,64.7,70.8,59.6,00000
19.0,33.0,24.0,465,01,01,  Jor Puskarni,396,159,197,73,199,86,71.4,73.0,69.8,00000
19.0,33.0,24.0,465,02,01,  Abdullahpur,215,215,102,99,113,116,50.0,50.7,49.3,00000
19.0,33.0,24.0,571,01,01,  Lolbari,503,451,240,218,263,233,52.7,52.4,53.0,00000
19.0,33.0,24.0,571,02,01,  Paranpur,413,246,199,112,214,134,62.7,64.0,61.5,00000
19.0,33.0,28.0,043,01,01,  Azabpur,387,934,179,459,208,475,29.3,28.1,30.5,00000
19.0,33.0,28.0,043,02,01,  Natpara,465,502,218,218,247,284,48.1,50.0,46.5,00000
19.0,33.0,28.0,043,03,01,  Betagaon,62,251,39,134,23,117,19.8,22.5,16.4,00000
19.0,33.0,28.0,043,04,01,  Juktikhola,158,191,77,91,81,100,45.3,45.8,44.8,00000
19.0,33.0,28.0,471,01,01,  Kalora,754,1088,320,519,434,569,40.9,38.1,43.3,00000
19.0,33.0,28.0,471,02,01,  Ashodia,224,161,107,78,117,83,58.2,57.8,58.5,00000
19.0,33.0,28.0,930,01,01,  Tulatali,324,302,152,143,172,159,51.8,51.5,52.0,00000
19.0,33.0,28.0,930,02,01,  Nischintapur,172,196,66,97,106,99,46.7,40.5,51.7,00000
19.0,33.0,28.0,932,01,01,  Belghar,1718,1703,807,816,911,887,50.2,49.7,50.7,00000
19.0,33.0,28.0,932,02,01,  Tulatali,427,240,194,108,233,132,64.0,64.2,63.8,00000
19.0,33.0,28.0,932,03,01,  Barin,90,67,34,23,56,44,57.3,59.6,56.0,00000
19.0,33.0,28.0,932,04,01,  Mantala,190,117,85,56,105,61,61.9,60.3,63.3,00000
19.0,33.0,28.0,932,05,01,  Bhairabpur,226,163,95,85,131,78,58.1,52.8,62.7,00000
19.0,33.0,31.0,159,01,01,  Bhuschi,499,963,196,464,303,499,34.1,29.7,37.8,00000
19.0,33.0,31.0,159,02,01,  Nurpur,131,203,53,100,78,103,39.2,34.6,43.1,00000
19.0,33.0,33.0,130,01,01,  Betua,104,90,52,40,52,50,53.6,56.5,51.0,00000
19.0,33.0,33.0,130,02,01,  Dapar,314,355,140,166,174,189,46.9,45.8,47.9,00000
19.0,33.0,33.0,310,01,01,  Uttar Dhanpur,355,507,166,235,189,272,41.2,41.4,41.0,00000
19.0,33.0,33.0,310,02,01,  Dakshin Dhanpur,375,303,177,147,198,156,55.3,54.6,55.9,00000
19.0,33.0,33.0,444,01,01,  Uttar Joykamta,601,1162,249,554,352,608,34.1,31.0,36.7,00000
19.0,33.0,33.0,444,02,01,  Dakshin Joykamta,186,202,87,98,99,104,47.9,47.0,48.8,00000
19.0,33.0,33.0,508,01,01,  Kismat Solanda,252,255,107,104,145,151,49.7,50.7,49.0,00000
19.0,33.0,33.0,508,02,01,  Purba Solanda,208,253,88,124,120,129,45.1,41.5,48.2,00000
19.0,33.0,35.0,368,01,01,  Ghosegaon,295,285,136,134,159,151,50.9,50.4,51.3,00000
19.0,33.0,35.0,368,02,01,  Ram Nagar,82,33,44,11,38,22,71.3,80.0,63.3,00000
19.0,33.0,35.0,564,01,03,  Jammura,260,706,95,385,165,321,26.9,19.8,34.0,00000
19.0,33.0,35.0,564,02,03,  Bhangamura,161,261,75,128,86,133,38.2,36.9,39.3,00000
19.0,33.0,35.0,564,03,03,  Dhanmura,92,316,49,162,43,154,22.5,23.2,21.8,00000
19.0,33.0,35.0,564,04,03,  Sreebidya,209,488,84,231,125,257,30.0,26.7,32.7,00000
19.0,33.0,35.0,564,05,03,  Rajarkhola,750,853,367,431,383,422,46.8,46.0,47.6,00000
19.0,33.0,35.0,564,06,03,  Paschim Kachar,267,336,102,162,165,174,44.3,38.6,48.7,00000
19.0,33.0,35.0,564,07,03,  Chowdhurykhola,279,561,108,274,171,287,33.2,28.3,37.3,00000
19.0,33.0,35.0,564,08,03,  Baisnabmura,13,3,8,1,5,2,81.3,88.9,71.4,00000
19.0,33.0,35.0,564,09,03,  Lalmati,469,695,218,339,251,356,40.3,39.1,41.4,00000
19.0,33.0,35.0,960,01,01,  Noapara,240,162,143,84,97,78,59.7,63.0,55.4,00000
19.0,33.0,35.0,960,02,01,  Uttar Bijoypur,422,391,191,187,231,204,51.9,50.5,53.1,00000
19.0,33.0,39.0,054,01,01,  Chikutia,247,91,131,31,116,60,73.1,80.9,65.9,00000
19.0,33.0,39.0,054,02,01,  Kodalia,354,610,151,293,203,317,36.7,34.0,39.0,00000
19.0,33.0,39.0,943,01,01,  Tungirpar,696,400,327,167,369,233,63.5,66.2,61.3,00000
19.0,33.0,39.0,943,02,01,  Uttar Tungirpar,321,395,148,202,173,193,44.8,42.3,47.3,00000
19.0,33.0,58.0,106,01,01,  Bhatera,323,101,155,38,168,63,76.2,80.3,72.7,00000
19.0,33.0,58.0,106,02,01,  Galiara,359,443,154,198,205,245,44.8,43.8,45.6,00000
19.0,33.0,58.0,291,01,01,  Dhanpur,87,142,44,76,43,66,38.0,36.7,39.4,00000
19.0,33.0,58.0,291,02,01,  Murapara,191,479,90,225,101,254,28.5,28.6,28.5,00000
19.0,33.0,58.0,323,01,01,  Dakshin Noapara,461,397,231,195,230,202,53.7,54.2,53.2,00000
19.0,33.0,58.0,323,02,01,  Rajmangalpur,58,55,27,30,31,25,51.3,47.4,55.4,00000
19.0,33.0,58.0,336,01,01,  Fultali,284,244,140,127,144,117,53.8,52.4,55.2,00000
19.0,33.0,58.0,336,02,01,  Rajapur,142,142,67,69,75,73,50.0,49.3,50.7,00000
19.0,33.0,58.0,755,01,01,  Khilpara,340,368,190,195,150,173,48.0,49.4,46.4,00000
19.0,33.0,58.0,755,02,01,  Balur Char,111,41,54,17,57,24,73.0,76.1,70.4,00000
19.0,33.0,58.0,755,03,01,  Bara Char,304,174,151,89,153,85,63.6,62.9,64.3,00000
19.0,33.0,58.0,755,04,01,  Meruali,130,355,55,183,75,172,26.8,23.1,30.4,00000
19.0,33.0,58.0,755,05,01,  Nagarkandi,82,49,41,20,41,29,62.6,67.2,58.6,00000
19.0,33.0,73.0,116,01,01,  Birahimpur,349,167,170,59,179,108,67.6,74.2,62.4,00000
19.0,33.0,73.0,116,02,01,  Kanuarmokh,86,62,52,27,34,35,58.1,65.8,49.3,00000
19.0,33.0,73.0,381,01,01,  Hasimpur,81,32,38,12,43,20,71.7,76.0,68.3,00000
19.0,33.0,73.0,381,02,01,  Tara Puskurni,146,201,59,97,87,104,42.1,37.8,45.5,00000
19.0,33.0,73.0,443,01,01,  Joynagar,222,255,104,115,118,140,46.5,47.5,45.7,00000
19.0,33.0,73.0,443,02,01,  Jagatrampur,110,104,55,46,55,58,51.4,54.5,48.7,00000
19.0,33.0,80.0,175,01,01,  Jorekaran,102,340,68,226,34,114,23.1,23.1,23.0,00000
19.0,33.0,80.0,175,02,01,  Kalikapur,122,66,57,28,65,38,64.9,67.1,63.1,00000
19.0,33.0,80.0,175,03,01,  King Ramchandrapur,132,65,72,19,60,46,67.0,79.1,56.6,00000
19.0,33.0,80.0,225,01,01,  Dakshin Pratappur,357,362,152,174,205,188,49.7,46.6,52.2,00000
19.0,33.0,80.0,225,02,01,  Sultanpur,186,203,109,69,77,134,47.8,61.2,36.5,00000
19.0,33.0,87.0,206,01,01,  Kamekua,205,160,90,71,115,89,56.2,55.9,56.4,00000
19.0,33.0,87.0,206,02,01,  Khil Para,269,99,138,48,131,51,73.1,74.2,72.0,00000
19.0,33.0,87.0,206,03,01,  Uttar Chhilania,813,817,339,402,474,415,49.9,45.7,53.3,00000
19.0,36.0,21.0,123,01,01,  Bhajra,770,1080,390,451,380,629,41.6,46.4,37.7,00000
19.0,36.0,21.0,123,02,01,  Baher Char,747,749,360,330,387,419,49.9,52.2,48.0,00000
19.0,36.0,21.0,300,01,01,  Natun Hasnabad,159,713,89,374,70,339,18.2,19.2,17.1,00000
19.0,36.0,21.0,300,02,01,  Char Charua,253,203,120,91,133,112,55.5,56.9,54.3,00000
19.0,36.0,21.0,462,01,01,  Kandergaon,181,310,76,147,105,163,36.9,34.1,39.2,00000
19.0,36.0,21.0,462,02,01,  Uttar Hasnabad,190,231,97,95,93,136,45.1,50.5,40.6,00000
19.0,36.0,21.0,462,03,01,  Purba Hasnabad,347,283,165,110,182,173,55.1,60.0,51.3,00000
19.0,36.0,21.0,462,04,01,  Dakshin Hasnabad,187,255,95,109,92,146,42.3,46.6,38.7,00000
19.0,36.0,21.0,462,05,01,  Paschim Hasnabad,323,452,178,220,145,232,41.7,44.7,38.5,00000
19.0,36.0,21.0,462,06,01,  Bitikandi,453,497,203,202,250,295,47.7,50.1,45.9,00000
19.0,36.0,25.0,149,01,01,  Khanerbari,252,277,132,119,120,158,47.6,52.6,43.2,00000
19.0,36.0,25.0,149,02,01,  Biteshwar,341,598,171,263,170,335,36.3,39.4,33.7,00000
19.0,36.0,25.0,149,03,01,  Tinpara,564,866,279,419,285,447,39.4,40.0,38.9,00000
19.0,36.0,25.0,149,04,01,  Birbagh Goali,555,971,267,453,288,518,36.4,37.1,35.7,00000
19.0,36.0,25.0,149,05,01,  Madla,280,291,133,120,147,171,49.0,52.6,46.2,00000
19.0,36.0,25.0,528,01,01,  Kalasadhardia,313,279,146,122,167,157,52.9,54.5,51.5,00000
19.0,36.0,25.0,528,02,01,  Patnekanda,52,22,22,11,30,11,70.3,66.7,73.2,00000
19.0,36.0,25.0,528,03,01,  Nayakandi,104,59,50,23,54,36,63.8,68.5,60.0,00000
19.0,36.0,25.0,728,01,01,  Noagaon,796,889,371,425,425,464,47.2,46.6,47.8,00000
19.0,36.0,25.0,728,02,01,  Barakota,352,546,184,247,168,299,39.2,42.7,36.0,00000
19.0,36.0,25.0,728,03,01,  Naowpara,60,101,31,45,29,56,37.3,40.8,34.1,00000
19.0,36.0,30.0,025,01,01,  Autbagh,562,801,268,373,294,428,41.2,41.8,40.7,00000
19.0,36.0,30.0,025,02,01,  Bhelanagar,616,686,293,278,323,408,47.3,51.3,44.2,00000
19.0,36.0,30.0,590,01,01,  Khoshkandi,639,1331,293,603,346,728,32.4,32.7,32.2,00000
19.0,36.0,30.0,590,02,01,  Kusiara,1054,864,498,407,556,457,55.0,55.0,54.9,00000
19.0,36.0,30.0,590,03,01,  Kalijug,300,278,141,126,159,152,51.9,52.8,51.1,00000
19.0,36.0,34.0,284,01,01,  Daulatpur,280,787,157,359,123,428,26.2,30.4,22.3,00000
19.0,36.0,34.0,284,02,01,  Kutubpur,108,185,57,96,51,89,36.9,37.3,36.4,00000
19.0,36.0,34.0,634,01,01,  Malikhil,892,1064,415,492,477,572,45.6,45.8,45.5,00000
19.0,36.0,34.0,634,02,01,  Malikhil Bakernagar,557,972,250,475,307,497,36.4,34.5,38.2,00000
19.0,36.0,34.0,794,01,01,  Purba Lakshmipur,1239,1142,620,532,619,610,52.0,53.8,50.4,00000
19.0,36.0,34.0,794,02,01,  Khilalpur,146,392,76,203,70,189,27.1,27.2,27.0,00000
19.0,36.0,34.0,801,01,01,  Basara,1114,884,553,373,561,511,55.8,59.7,52.3,00000
19.0,36.0,34.0,801,02,01,  Putia,421,312,228,136,193,176,57.4,62.6,52.3,00000
19.0,36.0,34.0,801,03,01,  Adampur,102,130,37,64,65,66,44.0,36.6,49.6,00000
19.0,36.0,34.0,801,04,01,  Daiabari,136,170,64,78,72,92,44.4,45.1,43.9,00000
19.0,36.0,34.0,911,01,01,  Tamta,1644,1533,855,709,789,824,51.7,54.7,48.9,00000
19.0,36.0,34.0,911,02,01,  Nayakandi,290,260,145,126,145,134,52.7,53.5,52.0,00000
19.0,36.0,38.0,532,01,01,  Kaluarkandi,1367,648,724,279,643,369,67.8,72.2,63.5,00000
19.0,36.0,38.0,532,02,01,  Nayakandi,76,51,34,27,42,24,59.8,55.7,63.6,00000
19.0,36.0,38.0,663,01,01,  Minardia,718,449,364,209,354,240,61.5,63.5,59.6,00000
19.0,36.0,38.0,663,02,01,  Housedia,497,281,267,121,230,160,63.9,68.8,59.0,00000
19.0,36.0,47.0,200,01,01,  Bhati Char Para,101,125,57,57,44,68,44.7,50.0,39.3,00000
19.0,36.0,47.0,200,02,01,  Char Chara Para,323,681,130,328,193,353,32.2,28.4,35.3,00000
19.0,36.0,47.0,492,01,01,  Hatkhola,57,180,23,89,34,91,24.1,20.5,27.2,00000
19.0,36.0,47.0,492,02,01,  Itakhola,596,400,303,183,293,217,59.8,62.3,57.5,00000
19.0,36.0,47.0,492,03,01,  Kalyanpur,102,222,37,104,65,118,31.5,26.2,35.5,00000
19.0,36.0,47.0,492,04,01,  Jinglatali,1782,2218,863,1016,919,1202,44.6,45.9,43.3,00000
19.0,36.0,47.0,830,01,01,  Raypur Bazar,15,5,11,2,4,3,75.0,84.6,57.1,00000
19.0,36.0,47.0,830,02,01,  Raypur,902,832,470,397,432,435,52.0,54.2,49.8,00000
19.0,36.0,47.0,830,03,01,  Bahar,4,35,3,12,1,23,10.3,20.0,4.2,00000
19.0,36.0,51.0,444,01,01,  Gauripur,958,559,487,244,471,315,63.2,66.6,59.9,00000
19.0,36.0,51.0,444,02,01,  Maitharkandi,649,311,366,162,283,149,67.6,69.3,65.5,00000
19.0,36.0,51.0,444,03,01,  Hat Chandina,744,525,352,248,392,277,58.6,58.7,58.6,00000
19.0,36.0,51.0,444,04,01,  Lakshmipur,352,676,185,359,167,317,34.2,34.0,34.5,00000
19.0,36.0,51.0,747,01,01,  Olan Para,566,613,279,264,287,349,48.0,51.4,45.1,00000
19.0,36.0,51.0,747,02,01,  Char Ramnagar,83,136,39,55,44,81,37.9,41.5,35.2,00000
19.0,36.0,51.0,747,03,01,  Ramnagar,361,471,162,196,199,275,43.4,45.3,42.0,00000
19.0,36.0,51.0,772,01,01,  Char Mahammada,744,535,349,216,395,319,58.2,61.8,55.3,00000
19.0,36.0,51.0,772,02,01,  Hareala,199,608,82,277,117,331,24.7,22.8,26.1,00000
19.0,36.0,51.0,772,03,01,  Dayea Para,634,600,327,273,307,327,51.4,54.5,48.4,00000
19.0,36.0,51.0,772,04,01,  Paschim Hogalia,424,600,208,276,216,324,41.4,43.0,40.0,00000
19.0,36.0,51.0,772,05,01,  Purba Hogalia,581,161,311,76,270,85,78.3,80.4,76.1,00000
19.0,36.0,51.0,772,06,01,  Sarkarpur,1209,1349,577,647,632,702,47.3,47.1,47.4,00000
19.0,36.0,51.0,772,07,01,  Pennai,2500,1643,1299,799,1201,844,60.3,61.9,58.7,00000
19.0,36.0,51.0,772,08,01,  Sulpa Pennai,962,685,513,373,449,312,58.4,57.9,59.0,00000
19.0,36.0,51.0,772,09,01,  Angawara,1250,521,680,254,570,267,70.6,72.8,68.1,00000
19.0,36.0,64.0,302,01,01,  Krishnapur,100,81,44,40,56,41,55.2,52.4,57.7,00000
19.0,36.0,64.0,302,02,01,  Uzarkhola,407,456,175,229,232,227,47.2,43.3,50.5,00000
19.0,36.0,73.0,649,01,01,  Uttar Mohammadpur,1246,1069,609,512,637,557,53.8,54.3,53.4,00000
19.0,36.0,73.0,649,02,01,  Dhakur Pukurpar,106,149,54,68,52,81,41.6,44.3,39.1,00000
19.0,36.0,73.0,649,03,01,  Dakshin Mohammadpur,1205,1259,583,596,622,663,48.9,49.4,48.4,00000
19.0,36.0,82.0,313,01,01,  Brahmandia,131,190,55,94,76,96,40.8,36.9,44.2,00000
19.0,36.0,82.0,313,05,01,  Sabahan,236,470,95,211,141,259,33.4,31.0,35.3,00000
19.0,36.0,82.0,313,06,01,  Maithardia,230,413,103,178,127,235,35.8,36.7,35.1,00000
19.0,36.0,82.0,313,07,01,  Mukundi,163,116,64,54,99,62,58.4,54.2,61.5,00000
19.0,36.0,82.0,313,08,01,  Sadardia,330,333,147,144,183,189,49.8,50.5,49.2,00000
19.0,36.0,82.0,313,09,01,  Kabi Chandradia,223,269,88,123,135,146,45.3,41.7,48.0,00000
19.0,36.0,82.0,313,10,01,  Ujhardia,18,31,9,13,9,18,36.7,40.9,33.3,00000
19.0,36.0,82.0,313,11,01,  Sambhurdia,323,405,154,182,169,223,44.4,45.8,43.1,00000
19.0,36.0,82.0,313,12,01,  Baishardia,64,73,27,33,37,40,46.7,45.0,48.1,00000
19.0,36.0,82.0,313,13,01,  Bhauria,204,261,87,117,117,144,43.9,42.6,44.8,00000
19.0,36.0,82.0,313,14,01,  Ketundi,570,613,251,280,319,333,48.2,47.3,48.9,00000
19.0,36.0,82.0,313,15,01,  Narandia,486,618,220,293,266,325,44.0,42.9,45.0,00000
19.0,36.0,82.0,313,16,01,  Rafardia,208,150,95,71,113,79,58.1,57.2,58.9,00000
19.0,36.0,82.0,313,17,01,  Manikdi,114,172,53,70,61,102,39.9,43.1,37.4,00000
19.0,36.0,82.0,313,18,01,  Paikar Char,126,144,49,70,77,74,46.7,41.2,51.0,00000
19.0,36.0,82.0,349,01,01,  Daulatpur,314,446,155,208,159,238,41.3,42.7,40.1,00000
19.0,36.0,82.0,349,02,01,  Denardia,99,88,44,34,55,54,52.9,56.4,50.5,00000
19.0,36.0,82.0,349,03,01,  Nayakandi,73,102,37,45,36,57,41.7,45.1,38.7,00000
19.0,36.0,82.0,349,04,01,  Chowdhury Para,159,109,80,45,79,64,59.3,64.0,55.2,00000
19.0,36.0,82.0,564,01,01,  Purba Kauadi,920,1020,442,437,478,583,47.4,50.3,45.1,00000
19.0,36.0,82.0,564,02,01,  Paschim Kauadi,790,922,354,421,436,501,46.1,45.7,46.5,00000
19.0,36.0,84.0,102,01,01,  Dakshin Baynagar,816,1513,364,749,452,764,35.0,32.7,37.2,00000
19.0,36.0,84.0,102,02,01,  Uttar Baynagar,414,304,178,128,236,176,57.7,58.2,57.3,00000
19.0,36.0,84.0,594,01,01,  Chapatali,409,570,201,251,208,319,41.8,44.5,39.5,00000
19.0,36.0,84.0,594,02,01,  Lakhatali,408,522,177,250,231,272,43.9,41.5,45.9,00000
19.0,36.0,84.0,594,03,01,  Hatkhola,94,92,47,46,47,46,50.5,50.5,50.5,00000
19.0,36.0,84.0,630,01,01,  Maligaon,1198,1223,554,552,644,671,49.5,50.1,49.0,00000
19.0,36.0,84.0,630,02,01,  Bhurburia,217,271,119,125,98,146,44.5,48.8,40.2,00000
19.0,36.0,85.0,061,01,01,  Banuakandi,327,389,165,192,162,197,45.7,46.2,45.1,00000
19.0,36.0,85.0,061,02,01,  Khalisha,436,317,226,159,210,158,57.9,58.7,57.1,00000
19.0,36.0,85.0,061,03,01,  Nayanagar,336,530,149,229,187,301,38.8,39.4,38.3,00000
19.0,36.0,85.0,061,04,01,  Saidkharkandi,587,639,298,306,289,333,47.9,49.3,46.5,00000
19.0,36.0,85.0,258,01,01,  Padua,584,815,322,359,262,456,41.7,47.3,36.5,00000
19.0,36.0,85.0,258,02,01,  Satani,115,93,65,46,50,47,55.3,58.6,51.5,00000
19.0,36.0,85.0,258,03,01,  Sadarkandi,404,431,197,209,207,222,48.4,48.5,48.3,00000
19.0,36.0,85.0,721,01,01,  Nischintapur,301,436,152,205,149,231,40.8,42.6,39.2,00000
19.0,36.0,85.0,721,02,01,  Manairkandi,278,64,153,29,125,35,81.3,84.1,78.1,00000
19.0,36.0,85.0,816,01,01,  Bhangar Char,152,190,80,92,72,98,44.4,46.5,42.4,00000
19.0,36.0,85.0,816,02,01,  Ramaitkandi,213,443,93,214,120,229,32.5,30.3,34.4,00000
19.0,36.0,85.0,816,03,01,  Faterkandi,134,169,61,98,73,71,44.2,38.4,50.7,00000
19.0,36.0,86.0,448,01,01,  Harina Bhabanipur,554,500,249,234,305,266,52.6,51.6,53.4,00000
19.0,36.0,86.0,448,02,01,  Harina Bazarkhola,607,378,339,155,268,223,61.6,68.6,54.6,00000
19.0,36.0,86.0,754,01,01,  Nalchak,413,359,216,175,197,184,53.5,55.2,51.7,00000
19.0,36.0,86.0,754,02,01,  Panchgachhia,366,424,194,209,172,215,46.3,48.1,44.4,00000
19.0,36.0,86.0,754,03,01,  Sreekantadia,402,358,203,152,199,206,52.9,57.2,49.1,00000
19.0,36.0,86.0,754,04,01,  Sethardia,236,185,95,84,141,101,56.1,53.1,58.3,00000
19.0,36.0,86.0,889,01,01,  Sreeroyer Char,608,414,328,180,280,234,59.5,64.6,54.5,00000
19.0,36.0,86.0,889,02,01,  Kirtankhola,82,197,49,104,33,93,29.4,32.0,26.2,00000
19.0,36.0,86.0,922,01,01,  Thetalia,416,306,224,132,192,174,57.6,62.9,52.5,00000
19.0,36.0,86.0,922,02,01,  Nayachar,375,265,186,111,189,154,58.6,62.6,55.1,00000
19.0,36.0,86.0,936,01,01,  Tulatali,949,726,471,324,478,402,56.7,59.2,54.3,00000
19.0,36.0,86.0,936,02,01,  Jafarabad,484,387,257,194,227,193,55.6,57.0,54.0,00000
19.0,36.0,90.0,466,01,01,  Ichhapura,1349,1019,620,468,729,551,57.0,57.0,57.0,00000
19.0,36.0,90.0,466,02,01,  Manikkandi,141,107,75,55,66,52,56.9,57.7,55.9,00000
19.0,36.0,90.0,852,01,01,  Satpara,854,1067,419,462,435,605,44.5,47.6,41.8,00000
19.0,36.0,90.0,852,02,01,  Sabebad,185,175,96,78,89,97,51.4,55.2,47.8,00000
19.0,36.0,90.0,852,03,01,  Shola Para,1056,1456,506,677,550,779,42.0,42.8,41.4,00000
19.0,36.0,90.0,892,01,01,  Sukipur,764,1097,381,496,383,601,41.1,43.4,38.9,00000
19.0,36.0,90.0,892,02,01,  Dakkhola,230,216,117,91,113,125,51.6,56.3,47.5,00000
19.0,36.0,90.0,892,03,01,  Shibpur,153,278,79,136,74,142,35.5,36.7,34.3,00000
19.0,36.0,94.0,266,01,01,  Chhota Mohammadpur,1269,1280,616,596,653,684,49.8,50.8,48.8,00000
19.0,36.0,94.0,266,02,01,  Chandgaon,1627,1227,944,646,683,581,57.0,59.4,54.0,00000
19.0,36.0,94.0,266,03,01,  Rajar Hat,94,119,49,59,45,60,44.1,45.4,42.9,00000
19.0,36.0,94.0,422,01,01,  Gayaspur,995,552,455,246,540,306,64.3,64.9,63.8,00000
19.0,36.0,94.0,422,02,01,  Mudafardi,349,225,165,103,184,122,60.8,61.6,60.1,00000
19.0,36.0,94.0,422,03,01,  Hamirdi,368,173,164,85,204,88,68.0,65.9,69.9,00000
19.0,36.0,94.0,576,01,01,  Chakamkhola,315,260,140,124,175,136,54.8,53.0,56.3,00000
19.0,36.0,94.0,576,02,01,  Thakuramir Dighi,110,106,43,56,67,50,50.9,43.4,57.3,00000
19.0,36.0,94.0,576,03,01,  Bara Goali,1008,987,510,444,498,543,50.5,53.5,47.8,00000
19.0,36.0,94.0,576,04,01,  Dari Goali,324,304,159,151,165,153,51.6,51.3,51.9,00000
19.0,36.0,94.0,896,01,01,  Sundalpur,1570,1312,761,583,809,729,54.5,56.6,52.6,00000
19.0,36.0,94.0,896,02,01,  Daspara,708,526,362,232,346,294,57.4,60.9,54.1,00000
19.0,40.0,17.0,162,01,01,  Baura,304,389,133,178,171,211,43.9,42.8,44.8,00000
19.0,40.0,17.0,162,02,01,  Gadisail,176,252,97,104,79,148,41.1,48.3,34.8,00000
19.0,40.0,17.0,289,01,01,  Chhotna,1414,1718,692,813,722,905,45.1,46.0,44.4,00000
19.0,40.0,17.0,289,02,01,  Himitsingh,153,105,65,44,88,61,59.3,59.6,59.1,00000
19.0,40.0,17.0,289,03,01,  Noapara,213,237,96,112,117,125,47.3,46.2,48.3,00000
19.0,40.0,17.0,677,01,01,  Mohanpur,1270,1738,622,774,648,964,42.2,44.6,40.2,00000
19.0,40.0,17.0,677,02,01,  Dhighir Pra,210,287,105,127,105,160,42.3,45.3,39.6,00000
19.0,40.0,17.0,931,01,01,  Taltala,773,864,370,394,403,470,47.2,48.4,46.2,00000
19.0,40.0,17.0,931,02,01,  Lalitasar,210,117,104,46,106,71,64.2,69.3,59.9,00000
19.0,40.0,23.0,691,01,01,  Nabiabad,2083,1288,1031,572,1052,716,61.8,64.3,59.5,00000
19.0,40.0,23.0,691,02,01,  Batarukurea,583,491,292,234,291,257,54.3,55.5,53.1,00000
19.0,40.0,23.0,776,01,01,  Premu,1235,1012,564,477,671,535,55.0,54.2,55.6,00000
19.0,40.0,23.0,776,02,01,  Braman Khara,1365,1047,670,485,695,562,56.6,58.0,55.3,00000
19.0,40.0,41.0,543,01,01,  Kalamuria,141,187,78,84,63,103,43.0,48.1,38.0,00000
19.0,40.0,41.0,543,02,01,  Chhachra Pukuria,737,614,337,257,400,357,54.6,56.7,52.8,00000
19.0,40.0,41.0,543,03,01,  Saber Pukurpar,166,374,72,158,94,216,30.7,31.3,30.3,00000
19.0,40.0,41.0,543,04,01,  Sultanpur,1107,1325,535,588,572,737,45.5,47.6,43.7,00000
19.0,40.0,41.0,543,05,01,  Ram Dighirpar,76,188,36,92,40,96,28.8,28.1,29.4,00000
19.0,40.0,41.0,613,01,01,  Kurchap,828,410,394,183,434,227,66.9,68.3,65.7,00000
19.0,40.0,41.0,613,02,01,  Inderpar,175,357,73,171,102,186,32.9,29.9,35.4,00000
19.0,40.0,41.0,839,01,01,  Sanarnagar,724,1048,357,488,367,560,40.9,42.2,39.6,00000
19.0,40.0,41.0,839,02,01,  Betua,256,298,134,122,122,176,46.2,52.3,40.9,00000
19.0,40.0,41.0,839,03,01,  Indarar Char,407,558,213,261,194,297,42.2,44.9,39.5,00000
19.0,40.0,47.0,522,01,01,  Joypur,931,491,433,187,498,304,65.5,69.8,62.1,00000
19.0,40.0,47.0,522,02,01,  Kamar Char,363,279,159,123,204,156,56.5,56.4,56.7,00000
19.0,40.0,47.0,522,03,01,  Barkanda,494,371,223,144,271,227,57.1,60.8,54.4,00000
19.0,40.0,47.0,550,01,01,  Kalikapur,532,267,261,139,271,128,66.6,65.3,67.9,00000
19.0,40.0,47.0,550,02,01,  Noapara,377,446,194,210,183,236,45.8,48.0,43.7,00000
19.0,40.0,47.0,818,01,01,  Saicha Para,1691,2237,824,1072,867,1165,43.0,43.5,42.7,00000
19.0,40.0,47.0,818,02,01,  Jaganathpur,459,610,239,277,220,333,42.9,46.3,39.8,00000
19.0,40.0,53.0,070,01,01,  Bakasar,520,676,242,302,278,374,43.5,44.5,42.6,00000
19.0,40.0,53.0,070,02,01,  Unjuti,740,456,395,183,345,273,61.9,68.3,55.8,00000
19.0,40.0,53.0,070,03,01,  Chasharpar,230,132,108,45,122,87,63.5,70.6,58.4,00000
19.0,40.0,53.0,268,01,01,  Chhepara,954,690,452,279,502,411,58.0,61.8,55.0,00000
19.0,40.0,53.0,268,02,01,  Dalahash,769,1177,353,484,416,693,39.5,42.2,37.5,00000
19.0,40.0,53.0,268,03,01,  Gazaria,635,880,315,383,320,497,41.9,45.1,39.2,00000
19.0,40.0,53.0,444,01,01,  Gunaighar (Part),2878,1626,1411,649,1467,977,63.9,68.5,60.0,00000
19.0,40.0,53.0,444,02,01,  Rampur,454,434,196,251,258,183,51.1,43.8,58.5,00000
19.0,40.0,59.0,733,01,01,  Padmakot,1079,1337,477,588,602,749,44.7,44.8,44.6,00000
19.0,40.0,59.0,733,02,01,  Ganeshpur,454,392,204,159,250,233,53.7,56.2,51.8,00000
19.0,40.0,59.0,959,01,01,  Ujanijora,877,711,401,297,476,414,55.2,57.4,53.5,00000
19.0,40.0,59.0,959,02,01,  Ujanikandi,217,424,102,166,115,258,33.9,38.1,30.8,00000
19.0,40.0,59.0,959,03,01,  Hapurkara,380,606,166,256,214,350,38.5,39.3,37.9,00000
19.0,40.0,65.0,155,01,01,  Barur,1460,1569,702,720,758,849,48.2,49.4,47.2,00000
19.0,40.0,65.0,155,02,01,  Biralla,701,415,342,168,359,247,62.8,67.1,59.2,00000
19.0,40.0,65.0,493,01,01,  Jafarganj,1027,1861,495,959,532,902,35.6,34.0,37.1,00000
19.0,40.0,65.0,493,02,01,  Ganganagar,530,936,264,452,266,484,36.2,36.9,35.5,00000
19.0,40.0,65.0,493,03,01,  Raghurampur,78,853,36,415,42,438,8.4,8.0,8.8,00000
19.0,40.0,71.0,642,01,01,  Magh Puskarini,504,451,268,195,236,256,52.8,57.9,48.0,00000
19.0,40.0,71.0,642,02,01,  Mohammadpur,2023,2118,965,929,1058,1189,48.9,51.0,47.1,00000
19.0,40.0,77.0,797,01,01,  Rajamehar,4489,3062,2163,1253,2326,1809,59.4,63.3,56.3,00000
19.0,40.0,77.0,797,02,01,  Gangchar,1304,276,691,104,613,172,82.5,86.9,78.1,00000
19.0,40.0,77.0,797,03,01,  Gangtiara,388,423,179,178,209,245,47.8,50.1,46.0,00000
19.0,40.0,77.0,797,04,01,  Chatuli,722,1068,352,498,370,570,40.3,41.4,39.4,00000
19.0,40.0,77.0,825,01,01,  Saidpur,463,626,225,271,238,355,42.5,45.4,40.1,00000
19.0,40.0,77.0,825,02,01,  Batura,338,219,146,86,192,133,60.7,62.9,59.1,00000
19.0,40.0,83.0,176,01,01,  Phultali,388,549,172,256,216,293,41.4,40.2,42.4,00000
19.0,40.0,83.0,176,02,01,  Itakhola,148,129,81,64,67,65,53.4,55.9,50.8,00000
19.0,40.0,83.0,176,03,01,  Burarpar,168,82,79,32,89,50,67.2,71.2,64.0,00000
19.0,40.0,83.0,176,04,01,  Tribidda,121,51,54,22,67,29,70.3,71.1,69.8,00000
19.0,40.0,83.0,176,05,01,  Kataksar,228,61,103,24,125,37,78.9,81.1,77.2,00000
19.0,40.0,83.0,176,06,01,  Bhani,1664,1332,853,557,811,775,55.5,60.5,51.1,00000
19.0,40.0,83.0,176,07,01,  Rampur,341,386,169,180,172,206,46.9,48.4,45.5,00000
19.0,40.0,83.0,176,08,01,  Andirpar,47,160,19,60,28,100,22.7,24.1,21.9,00000
19.0,40.0,83.0,917,01,01,  Surjyapur,1078,945,504,451,574,494,53.3,52.8,53.7,00000
19.0,40.0,83.0,917,02,01,  Khadghar,981,1176,507,493,474,683,45.5,50.7,41.0,00000
19.0,40.0,83.0,917,03,01,  Saharpar,472,646,238,292,234,354,42.2,44.9,39.8,00000
19.0,40.0,83.0,917,04,01,  Pachrangi,361,200,171,93,190,107,64.3,64.8,64.0,00000
19.0,40.0,83.0,917,05,01,  Radhanagar,200,327,85,166,115,161,38.0,33.9,41.7,00000
19.0,40.0,83.0,917,06,01,  Baraimura,199,157,88,71,111,86,55.9,55.3,56.3,00000
19.0,40.0,89.0,423,01,01,  Gopalnagar,2129,2416,985,1139,1144,1277,46.8,46.4,47.3,00000
19.0,40.0,89.0,423,02,01,  Rasulpur,2601,2705,1288,1281,1313,1424,49.0,50.1,48.0,00000
19.0,40.0,89.0,423,03,01,  Jinaia,688,777,299,359,389,418,47.0,45.4,48.2,00000
19.0,40.0,89.0,430,01,01,  Gopalpur,460,424,208,198,252,226,52.0,51.2,52.7,00000
19.0,40.0,89.0,430,02,01,  Binandapur,140,49,59,23,81,26,74.1,72.0,75.7,00000
19.0,40.0,89.0,430,03,01,  Hazratpur,177,136,90,75,87,61,56.5,54.5,58.8,00000
19.0,40.0,89.0,515,01,01,  Jibanpur,760,794,337,353,423,441,48.9,48.8,49.0,00000
19.0,40.0,89.0,515,02,01,  Noakandi,172,258,87,119,85,139,40.0,42.2,37.9,00000
19.0,40.0,95.0,007,01,01,  Abdullapur,348,340,156,144,192,196,50.6,52.0,49.5,00000
19.0,40.0,95.0,007,02,01,  Jinnatpur,100,413,54,182,46,231,19.5,22.9,16.6,00000
19.0,40.0,95.0,007,03,01,  Burirpar,823,1245,388,589,435,656,39.8,39.7,39.9,00000
19.0,40.0,95.0,705,01,01,  Narayanpur,643,525,277,229,366,296,55.1,54.7,55.3,00000
19.0,40.0,95.0,705,02,01,  Ramnagar,20,59,10,30,10,29,25.3,25.0,25.6,00000
19.0,40.0,95.0,903,01,01,  Subil,798,1724,367,778,431,946,31.6,32.1,31.3,00000
19.0,40.0,95.0,903,02,01,  Raghabpur,618,757,288,346,330,411,44.9,45.4,44.5,00000
19.0,40.0,95.0,973,01,01,  Wahedpur,1636,1876,783,804,853,1072,46.6,49.3,44.3,00000
19.0,40.0,95.0,973,02,01,  Shibnagar,1456,886,674,389,782,497,62.2,63.4,61.1,00000
19.0,40.0,95.0,973,03,01,  Masuabad,81,15,45,4,36,11,84.4,91.8,76.6,00000
19.0,40.0,95.0,973,04,01,  Noakandi,233,204,105,82,128,122,53.3,56.1,51.2,00000
19.0,40.0,95.0,973,05,01,  Hadipur,145,64,58,32,87,32,69.4,64.4,73.1,00000
19.0,40.0,95.0,973,06,01,  Rajapur,86,74,47,31,39,43,53.8,60.3,47.6,00000
19.0,40.0,95.0,973,07,01,  Sayedpur,155,153,81,70,74,83,50.3,53.6,47.1,00000
19.0,40.0,95.0,973,08,01,  Khalpar,59,24,27,8,32,16,71.1,77.1,66.7,00000
19.0,40.0,95.0,973,09,01,  Potiya Para,176,179,81,87,95,92,49.6,48.2,50.8,00000
19.0,54.0,15.0,031,01,01,  Asadpur,277,384,139,178,138,206,41.9,43.8,40.1,00000
19.0,54.0,15.0,031,02,01,  Munshikandi,212,243,101,95,111,148,46.6,51.5,42.9,00000
19.0,54.0,15.0,031,03,01,  Darikandi,203,241,88,95,115,146,45.7,48.1,44.1,00000
19.0,54.0,15.0,031,04,01,  Nayagaon,248,485,101,212,147,273,33.8,32.3,35.0,00000
19.0,54.0,15.0,031,05,01,  Chetpur,406,572,190,234,216,338,41.5,44.8,39.0,00000
19.0,54.0,15.0,296,01,01,  Char Kuria,337,496,149,223,188,273,40.5,40.1,40.8,00000
19.0,54.0,15.0,296,02,01,  Dayrakandi,156,323,70,145,86,178,32.6,32.6,32.6,00000
19.0,54.0,15.0,349,01,01,  Najarpur,226,300,114,127,112,173,43.0,47.3,39.3,00000
19.0,54.0,15.0,349,02,01,  Khoda Dadpur,716,1114,352,478,364,636,39.1,42.4,36.4,00000
19.0,54.0,15.0,349,03,01,  Ghaniar Char,1283,2300,611,1055,672,1245,35.8,36.7,35.1,00000
19.0,54.0,15.0,508,01,01,  Kalagachhia,541,902,231,383,310,519,37.5,37.6,37.4,00000
19.0,54.0,15.0,508,02,01,  Kriparampur,288,605,127,240,161,365,32.3,34.6,30.6,00000
19.0,54.0,15.0,508,03,01,  Krishnapur,425,722,183,317,242,405,37.1,36.6,37.4,00000
19.0,54.0,20.0,137,01,01,  Umdrabad,865,872,434,423,431,449,49.8,50.6,49.0,00000
19.0,54.0,20.0,137,02,01,  Krishnapur,384,721,184,332,200,389,34.8,35.7,34.0,00000
19.0,54.0,20.0,137,03,01,  Dari Bhasania,576,756,293,399,283,357,43.2,42.3,44.2,00000
19.0,54.0,20.0,137,04,01,  Biti Bhasania,264,258,116,108,148,150,50.6,51.8,49.7,00000
19.0,54.0,20.0,137,05,01,  Ishwarpur,28,171,15,98,13,73,14.1,13.3,15.1,00000
19.0,54.0,20.0,137,06,01,  Kazirgaon,84,385,48,205,36,180,17.9,19.0,16.7,00000
19.0,54.0,20.0,137,07,01,  Manadarkandi,288,219,171,105,117,114,56.8,62.0,50.6,00000
19.0,54.0,20.0,137,08,01,  Shibpur,431,568,218,276,213,292,43.1,44.1,42.2,00000
19.0,54.0,20.0,137,09,01,  Alampur,41,108,21,55,20,53,27.5,27.6,27.4,00000
19.0,54.0,20.0,709,01,01,  Nayakandi,239,316,135,135,104,181,43.1,50.0,36.5,00000
19.0,54.0,20.0,709,02,01,  Kashipur,842,1568,412,755,430,813,34.9,35.3,34.6,00000
19.0,54.0,20.0,709,03,01,  Joynagar,60,61,38,30,22,31,49.6,55.9,41.5,00000
19.0,54.0,20.0,709,04,01,  Mohanpur,151,230,74,99,77,131,39.6,42.8,37.0,00000
19.0,54.0,20.0,740,01,01,  Islampur,108,450,67,256,41,194,19.4,20.7,17.4,00000
19.0,54.0,20.0,740,02,01,  Gopalnagar,344,163,197,81,147,82,67.9,70.9,64.2,00000
19.0,54.0,20.0,740,03,01,  Titia,747,815,429,354,318,461,47.8,54.8,40.8,00000
19.0,54.0,20.0,740,04,01,  Raghunathpur,563,514,299,267,264,247,52.3,52.8,51.7,00000
19.0,54.0,20.0,889,01,01,  Tatuakandi,70,259,42,115,28,144,21.3,26.8,16.3,00000
19.0,54.0,20.0,889,02,01,  Dahargop,142,394,51,186,91,208,26.5,21.5,30.4,00000
19.0,54.0,20.0,889,03,01,  Kurarkandi,85,104,34,57,51,47,45.0,37.4,52.0,00000
19.0,54.0,20.0,889,04,01,  Madhabpur,282,628,149,329,133,299,31.0,31.2,30.8,00000
19.0,54.0,20.0,889,05,01,  Shyampur,438,563,228,238,210,325,43.8,48.9,39.3,00000
19.0,54.0,22.0,158,01,01,  Bhiti Kalamina,703,1446,345,660,358,786,32.7,34.3,31.3,00000
19.0,54.0,22.0,158,02,01,  Kawertek,18,26,11,15,7,11,40.9,42.3,38.9,00000
19.0,54.0,22.0,285,01,01,  Daulatpur,1319,1199,638,514,681,685,52.4,55.4,49.9,00000
19.0,54.0,22.0,285,02,01,  Araliakandi,155,631,66,313,89,318,19.7,17.4,21.9,00000
19.0,54.0,22.0,306,01,01,  Dulalpur,451,638,218,307,233,331,41.4,41.5,41.3,00000
19.0,54.0,22.0,306,02,01,  Pathalikandi Part-1 (Kashipur),146,312,58,148,88,164,31.9,28.2,34.9,00000
19.0,54.0,22.0,603,01,01,  Mangalerkandi,331,1180,177,524,154,656,21.9,25.2,19.0,00000
19.0,54.0,22.0,603,02,01,  Purbakandi,44,426,29,202,15,224,9.4,12.6,6.3,00000
19.0,54.0,22.0,603,03,01,  Chanderkandi,100,290,57,122,43,168,25.6,31.8,20.4,00000
19.0,54.0,22.0,793,01,01,  Saplezi,373,425,183,193,190,232,46.7,48.7,45.0,00000
19.0,54.0,22.0,793,02,01,  Chandipur,310,606,153,263,157,343,33.8,36.8,31.4,00000
19.0,54.0,25.0,021,01,01,  Ananthpur,581,814,329,387,252,427,41.6,45.9,37.1,00000
19.0,54.0,25.0,021,02,01,  Kandailhati,105,348,55,180,50,168,23.2,23.4,22.9,00000
19.0,54.0,25.0,476,01,01,  Joypur,569,787,281,353,288,434,42.0,44.3,39.9,00000
19.0,54.0,25.0,476,02,01,  Mirja Nagar,263,472,145,229,118,243,35.8,38.8,32.7,00000
19.0,54.0,25.0,730,01,01,  Purba Kashipur,428,488,229,240,199,248,46.7,48.8,44.5,00000
19.0,54.0,25.0,730,02,01,  Sreepur,1290,1337,744,670,546,667,49.1,52.6,45.0,00000
19.0,54.0,25.0,730,03,01,  Dorikandi,370,278,179,117,191,161,57.1,60.5,54.3,00000
19.0,54.0,25.0,730,04,01,  Pirijpur,34,145,18,74,16,71,19.0,19.6,18.4,00000
19.0,54.0,25.0,751,01,01,  Rajapur,383,733,189,322,194,411,34.3,37.0,32.1,00000
19.0,54.0,25.0,751,02,01,  Abdullahpur,259,259,138,128,121,131,50.0,51.9,48.0,00000
19.0,54.0,28.0,772,01,01,  Ramkrishnapur,948,647,460,271,488,376,59.4,62.9,56.5,00000
19.0,54.0,28.0,772,02,01,  Aralia,983,731,484,346,499,385,57.4,58.3,56.4,00000
19.0,54.0,28.0,772,03,01,  Akhandapur,506,325,235,163,271,162,60.9,59.0,62.6,00000
19.0,54.0,28.0,772,04,01,  Ramnagar,206,278,96,115,110,163,42.6,45.5,40.3,00000
19.0,54.0,28.0,772,05,01,  Sreenagar,483,628,214,281,269,347,43.5,43.2,43.7,00000
19.0,54.0,28.0,772,06,01,  Banshgari,77,352,35,164,42,188,17.9,17.6,18.3,00000
19.0,54.0,28.0,772,07,01,  Tatuakandi,295,773,134,357,161,416,27.6,27.3,27.9,00000
19.0,54.0,28.0,772,08,01,  Padua Rampur,58,134,24,59,34,75,30.2,28.9,31.2,00000
19.0,54.0,28.0,772,09,01,  Talimnagar,287,425,150,192,137,233,40.3,43.9,37.0,00000
19.0,54.0,28.0,772,10,01,  Chandpur,109,416,42,199,67,217,20.8,17.4,23.6,00000
19.0,54.0,28.0,952,01,01,  Chander Char,630,1083,324,520,306,563,36.8,38.4,35.2,00000
19.0,54.0,28.0,952,02,01,  Tatuar Char,302,493,144,235,158,258,38.0,38.0,38.0,00000
19.0,54.0,28.0,952,03,01,  Bak Sitarampur,447,913,194,403,253,510,32.9,32.5,33.2,00000
19.0,54.0,28.0,952,04,01,  Sitarampur,195,426,79,191,116,235,31.4,29.3,33.0,00000
19.0,54.0,28.0,952,05,01,  Paratali,289,462,128,199,161,263,38.5,39.1,38.0,00000
19.0,54.0,28.0,952,06,01,  Nayakandi,89,175,40,65,49,110,33.7,38.1,30.8,00000
19.0,54.0,28.0,952,07,01,  Sobharampur,767,484,371,177,396,307,61.3,67.7,56.3,00000
19.0,54.0,47.0,116,01,01,  Bhabanipur,58,106,32,41,26,65,35.4,43.8,28.6,00000
19.0,54.0,47.0,116,02,01,  Ghagotia,614,950,273,394,341,556,39.3,40.9,38.0,00000
19.0,54.0,47.0,116,03,01,  Dakshin Nala Dakshin,492,824,259,350,233,474,37.4,42.5,33.0,00000
19.0,54.0,47.0,116,04,01,  Madhabpur,263,975,112,430,151,545,21.2,20.7,21.7,00000
19.0,54.0,47.0,116,05,01,  Nurullapur,175,384,81,183,94,201,31.3,30.7,31.9,00000
19.0,54.0,47.0,116,06,01,  Faterkandi,137,322,60,132,77,190,29.8,31.3,28.8,00000
19.0,54.0,47.0,116,07,01,  Rampur,379,744,194,343,185,401,33.7,36.1,31.6,00000
19.0,54.0,47.0,116,08,01,  Sharifpur,145,235,72,91,73,144,38.2,44.2,33.6,00000
19.0,54.0,47.0,116,09,01,  Alipur,672,1364,272,627,400,737,33.0,30.3,35.2,00000
19.0,54.0,47.0,116,10,01,  Kuralikandi,208,703,97,327,111,376,22.8,22.9,22.8,00000
19.0,54.0,47.0,264,01,01,  Dari Char,607,1511,296,685,311,826,28.7,30.2,27.4,00000
19.0,54.0,47.0,264,02,01,  Chunar Char,211,770,113,410,98,360,21.5,21.6,21.4,00000
19.0,54.0,47.0,264,03,01,  Nayagaon,136,474,62,214,74,260,22.3,22.5,22.2,00000
19.0,54.0,50.0,624,01,01,  Mirsikari,680,585,418,256,262,329,53.8,62.0,44.3,00000
19.0,54.0,50.0,624,02,01,  Hujurkandi,312,397,161,182,151,215,44.0,46.9,41.3,00000
19.0,54.0,50.0,677,01,01,  Uttar Monipur,388,1033,206,498,182,535,27.3,29.3,25.4,00000
19.0,54.0,50.0,677,02,01,  Dakhin Monipur,627,2073,347,1016,280,1057,23.2,25.5,20.9,00000
19.0,54.0,50.0,677,03,01,  Faterkandi,366,567,187,261,179,306,39.2,41.7,36.9,00000
19.0,54.0,50.0,677,04,01,  Kalipur,204,547,113,261,91,286,27.2,30.2,24.1,00000
19.0,54.0,50.0,677,05,01,  Uttar Bar Garmora,505,1275,271,619,234,656,28.4,30.4,26.3,00000
19.0,54.0,50.0,677,06,01,  Dakhin Bar Garmora,272,404,152,199,120,205,40.2,43.3,36.9,00000
19.0,54.0,50.0,677,07,01,  Choto Garmora,752,740,424,340,328,400,50.4,55.5,45.1,00000
19.0,54.0,85.0,582,01,01,  Madhyakandi,282,378,177,169,105,209,42.7,51.2,33.4,00000
19.0,54.0,85.0,582,02,01,  Bhabanipur,414,781,264,379,150,402,34.6,41.1,27.2,00000
19.0,54.0,85.0,666,01,01,  Naya Char,205,276,111,134,94,142,42.6,45.3,39.8,00000
19.0,54.0,85.0,666,02,01,  Kalakandi,280,681,171,342,109,339,29.1,33.3,24.3,00000
19.0,54.0,85.0,677,01,01,  Purba Nilakhi,878,1117,499,582,379,535,44.0,46.2,41.5,00000
19.0,54.0,85.0,677,02,01,  Paschim Nilakhi,1342,1675,779,839,563,836,44.5,48.1,40.2,00000
19.0,54.0,85.0,677,03,01,  Lalbagh,115,189,65,94,50,95,37.8,40.9,34.5,00000
19.0,54.0,85.0,677,04,01,  Pirijpur,26,77,13,41,13,36,25.2,24.1,26.5,00000
19.0,54.0,85.0,677,05,01,  Miras,795,744,459,342,336,402,51.7,57.3,45.5,00000
19.0,54.0,85.0,677,06,01,  Champaknagar,214,415,130,195,84,220,34.0,40.0,27.6,00000
19.0,54.0,85.0,677,07,01,  Itabhara,698,1106,386,554,312,552,38.7,41.1,36.1,00000
19.0,54.0,85.0,677,08,01,  Babarkandi,596,668,320,327,276,341,47.2,49.5,44.7,00000
19.0,54.0,85.0,677,09,01,  Ulukandi,182,73,101,34,81,39,71.4,74.8,67.5,00000
19.0,54.0,85.0,677,10,01,  Ajodhanagar,310,394,164,206,146,188,44.0,44.3,43.7,00000
19.0,54.0,85.0,677,11,01,  Shyamnagar,154,375,92,201,62,174,29.1,31.4,26.3,00000
19.0,67.0,22.0,012,01,01,  Amratali,686,687,349,328,337,359,50.0,51.6,48.4,00000
19.0,67.0,22.0,012,02,01,  Char Para,116,120,58,70,58,50,49.2,45.3,53.7,00000
19.0,67.0,22.0,012,03,01,  Dutiar Dighirpar,785,351,396,171,389,180,69.1,69.8,68.4,00000
19.0,67.0,22.0,044,01,01,  Bara Atra,598,495,283,240,315,255,54.7,54.1,55.3,00000
19.0,67.0,22.0,044,02,01,  Chhota Atra,667,708,349,321,318,387,48.5,52.1,45.1,00000
19.0,67.0,22.0,240,01,01,  Dakshin Rasulpur,696,238,339,88,357,150,74.5,79.4,70.4,00000
19.0,67.0,22.0,240,02,01,  Lakshmipur,85,45,46,18,39,27,65.4,71.9,59.1,00000
19.0,67.0,22.0,400,01,01,  Icharpar,185,89,90,39,95,50,67.5,69.8,65.5,00000
19.0,67.0,22.0,400,02,01,  Bhubanghar,959,753,422,338,537,415,56.0,55.5,56.4,00000
19.0,67.0,22.0,400,03,01,  Krishnapur,224,155,96,71,128,84,59.1,57.5,60.4,00000
19.0,67.0,22.0,525,01,01,  Katanisar,277,217,116,94,161,123,56.1,55.2,56.7,00000
19.0,67.0,22.0,525,02,01,  Ramnagar,114,39,58,16,56,23,74.5,78.4,70.9,00000
19.0,67.0,22.0,525,03,01,  Maulvinagar,121,63,58,31,63,32,65.8,65.2,66.3,00000
19.0,67.0,22.0,774,01,01,  Raghurampur,355,253,172,105,183,148,58.4,62.1,55.3,00000
19.0,67.0,22.0,774,02,01,  Tailkupi,220,274,103,133,117,141,44.5,43.6,45.3,00000
19.0,67.0,22.0,806,01,01,  U.Rasulpur,1579,919,752,407,827,512,63.2,64.9,61.8,00000
19.0,67.0,22.0,806,02,01,  Zarianagar,234,172,105,66,129,106,57.6,61.4,54.9,00000
19.0,67.0,22.0,871,01,01,  Simpur,1325,813,615,389,710,424,62.0,61.3,62.6,00000
19.0,67.0,22.0,871,02,01,  Pandanagar,401,166,186,66,215,100,70.7,73.8,68.3,00000
19.0,67.0,22.0,873,01,01,  Baleshwar,407,308,208,136,199,172,56.9,60.5,53.6,00000
19.0,67.0,22.0,873,02,01,  Simra,530,183,229,84,301,99,74.3,73.2,75.3,00000
19.0,67.0,22.0,873,03,01,  Kalkharpar,160,103,63,53,97,50,60.8,54.3,66.0,00000
19.0,67.0,22.0,945,01,01,  Dhoghar,153,144,75,67,78,77,51.5,52.8,50.3,00000
19.0,67.0,22.0,945,02,01,  Chhotrakhil,396,142,207,68,189,74,73.6,75.3,71.9,00000
19.0,67.0,22.0,980,01,01,  Uttar Majhigachha,630,699,295,305,335,394,47.4,49.2,46.0,00000
19.0,67.0,22.0,980,02,01,  Piartali,140,232,66,98,74,134,37.6,40.2,35.6,00000
19.0,67.0,51.0,230,01,01,  Rajapur,597,268,284,126,313,142,69.0,69.3,68.8,00000
19.0,67.0,51.0,230,02,01,  Khetashar,812,434,419,215,393,219,65.2,66.1,64.2,00000
19.0,67.0,65.0,084,01,01,  Bara Para,2798,1314,1312,686,1486,628,68.0,65.7,70.3,00000
19.0,67.0,65.0,084,02,01,  Krishnapur,1186,1133,575,555,611,578,51.1,50.9,51.4,00000
19.0,67.0,65.0,084,03,01,  Durgapur,253,400,136,242,117,158,38.7,36.0,42.5,00000
19.0,67.0,65.0,150,01,01,  Chapapur,1819,870,978,481,841,389,67.6,67.0,68.4,00000
19.0,67.0,65.0,150,02,01,  Balutupa,892,740,449,341,443,399,54.7,56.8,52.6,00000
19.0,67.0,68.0,126,01,01,  Budhair,928,265,450,106,478,159,77.8,80.9,75.0,00000
19.0,67.0,68.0,126,02,01,  Olipur,924,339,448,158,476,181,73.2,73.9,72.5,00000
19.0,67.0,68.0,126,03,01,  Gopalshar,623,313,310,150,313,163,66.6,67.4,65.8,00000
19.0,67.0,68.0,269,01,01,  Dhainakhola,1750,1751,767,862,983,889,50.0,47.1,52.5,00000
19.0,67.0,68.0,269,02,01,  Belun Nagar,439,230,211,94,228,136,65.6,69.2,62.6,00000
19.0,67.0,68.0,269,03,01,  Chhangaon,212,163,94,69,118,94,56.5,57.7,55.7,00000
19.0,67.0,68.0,383,01,03,  Hatigara,615,454,268,207,347,247,57.5,56.4,58.4,00000
19.0,67.0,68.0,383,02,03,  Jangalia,395,335,175,157,220,178,54.1,52.7,55.3,00000
19.0,67.0,68.0,383,03,03,  Ujirpur,341,632,130,307,211,325,35.0,29.7,39.4,00000
19.0,67.0,68.0,482,01,01,  Kamalapur,1107,726,528,327,579,399,60.4,61.8,59.2,00000
19.0,67.0,68.0,482,02,01,  Chhamuarpar,184,292,91,166,93,126,38.7,35.4,42.5,00000
19.0,67.0,68.0,650,01,01,  Monshasan,1278,1111,613,502,665,609,53.5,55.0,52.2,00000
19.0,67.0,68.0,650,02,01,  Kamcr Bagh,303,505,127,248,176,257,37.5,33.9,40.6,00000
19.0,67.0,68.0,702,01,01,  Paschim Ballabhpur,1103,1722,452,819,651,903,39.0,35.6,41.9,00000
19.0,67.0,68.0,702,02,01,  Budnag,434,135,215,51,219,84,76.3,80.8,72.3,00000
19.0,67.0,68.0,710,01,01,  Jashpur,878,681,398,323,480,358,56.3,55.2,57.3,00000
19.0,67.0,68.0,710,02,01,  Kalir Bazar,132,255,79,133,53,122,34.1,37.3,30.3,00000
19.0,67.0,68.0,710,03,01,  Kumar Puskarini,453,491,208,249,245,242,48.0,45.5,50.3,00000
19.0,67.0,68.0,710,04,01,  Bakhrabad,328,449,146,204,182,245,42.2,41.7,42.6,00000
19.0,67.0,68.0,727,01,03,  Saktala,266,245,119,112,147,133,52.1,51.5,52.5,00000
19.0,67.0,68.0,727,02,03,  Dhanuais,321,292,143,136,178,156,52.4,51.3,53.3,00000
19.0,67.0,68.0,816,01,01,  Saidpur,2192,1133,1051,538,1141,595,65.9,66.1,65.7,00000
19.0,67.0,68.0,816,02,01,  Bejbari,284,460,136,252,148,208,38.2,35.1,41.6,00000
19.0,67.0,68.0,970,01,01,  Dighalgaon,432,253,204,118,228,135,63.1,63.4,62.8,00000
19.0,67.0,68.0,970,02,01,  Roycho,890,505,451,244,439,261,63.8,64.9,62.7,00000
19.0,67.0,68.0,986,01,01,  Uttar Lalmai Kachar,221,181,88,82,133,99,55.0,51.8,57.3,00000
19.0,67.0,68.0,986,02,01,  Dakshin Lalmaika Char,452,385,206,167,246,218,54.0,55.2,53.0,00000
19.0,67.0,90.0,064,01,01,  Kalikapur,484,439,228,202,256,237,52.4,53.0,51.9,00000
19.0,67.0,90.0,064,02,01,  Ramchandrapur,168,122,77,56,91,66,57.9,57.9,58.0,00000
19.0,67.0,90.0,079,01,01,  Barajala,101,208,59,95,42,113,32.7,38.3,27.1,00000
19.0,67.0,90.0,079,02,01,  Matinagar,195,368,89,172,106,196,34.6,34.1,35.1,00000
19.0,67.0,90.0,227,01,01,  Dakshin Rachia,62,49,31,18,31,31,55.9,63.3,50.0,00000
19.0,67.0,90.0,227,02,01,  Komalla,85,70,34,31,51,39,54.8,52.3,56.7,00000
19.0,67.0,90.0,227,03,01,  Pandanagar,78,58,31,29,47,29,57.4,51.7,61.8,00000
19.0,67.0,90.0,279,01,01,  Dhananjoy,147,171,69,84,78,87,46.2,45.1,47.3,00000
19.0,67.0,90.0,279,02,01,  Rungury,218,156,97,69,121,87,58.3,58.4,58.2,00000
19.0,67.0,90.0,306,01,01,  Dumaria Chandpur,4377,2555,2101,1253,2276,1302,63.1,62.6,63.6,00000
19.0,67.0,90.0,306,02,01,  Kismat Chandpur,742,233,348,124,394,109,76.1,73.7,78.3,00000
19.0,67.0,90.0,384,01,01,  Hankijala,301,397,155,197,146,200,43.1,44.0,42.2,00000
19.0,67.0,90.0,384,02,01,  Nischintapur,114,158,51,71,63,87,41.9,41.8,42.0,00000
19.0,67.0,94.0,014,01,03,  Nischintpur,1902,652,1012,322,890,330,74.5,75.9,73.0,00000
19.0,67.0,94.0,014,02,03,  Kachiatali,222,249,124,158,98,91,47.1,44.0,51.9,00000
19.0,67.0,94.0,014,03,03,  Amtali,1020,433,568,209,452,224,70.2,73.1,66.9,00000
19.0,67.0,94.0,029,01,03,  Badarpur,1352,931,665,468,687,463,59.2,58.7,59.7,00000
19.0,67.0,94.0,029,02,03,  Mura Para,435,701,208,378,227,323,38.3,35.5,41.3,00000
19.0,67.0,94.0,071,01,03,  Uttar Bar Adail,726,550,351,240,375,310,56.9,59.4,54.7,00000
19.0,67.0,94.0,071,02,03,  Dakshin Baradail,678,354,332,158,346,196,65.7,67.8,63.8,00000
19.0,67.0,94.0,371,01,03,  Gunanandi,2065,886,1026,360,1039,526,70.0,74.0,66.4,00000
19.0,67.0,94.0,371,02,03,  Sahebnagar,1654,634,838,292,816,342,72.3,74.2,70.5,00000
19.0,67.0,94.0,371,03,03,  Anandashar,405,209,186,93,219,116,66.0,66.7,65.4,00000
19.0,72.0,17.0,102,01,01,  Baraigon,716,251,437,103,279,148,74.0,80.9,65.3,00000
19.0,72.0,17.0,102,02,01,  Debipur,172,88,80,40,92,48,66.2,66.7,65.7,00000
19.0,72.0,17.0,132,01,01,  Guchakara,228,193,111,84,117,109,54.2,56.9,51.8,00000
19.0,72.0,17.0,132,02,01,  Sangurpur,331,333,133,145,198,188,49.8,47.8,51.3,00000
19.0,72.0,17.0,132,03,01,  Bhabak Para,1296,1439,558,670,738,769,47.4,45.4,49.0,00000
19.0,72.0,17.0,164,01,01,  Chhota Bijra,434,461,186,229,248,232,48.5,44.8,51.7,00000
19.0,72.0,17.0,164,02,01,  Bara Bijra,863,867,371,438,492,429,49.9,45.9,53.4,00000
19.0,72.0,17.0,164,03,01,  Faloua,297,323,117,152,180,171,47.9,43.5,51.3,00000
19.0,72.0,17.0,523,01,01,  Kotaisa,472,516,176,249,296,267,47.8,41.4,52.6,00000
19.0,72.0,17.0,523,02,01,  Parakandi,26,21,11,10,15,11,55.3,52.4,57.7,00000
19.0,72.0,35.0,086,01,01,  Satghar,394,526,154,251,240,275,42.8,38.0,46.6,00000
19.0,72.0,35.0,086,02,01,  Ichhapur,1560,1763,665,798,895,965,46.9,45.5,48.1,00000
19.0,72.0,52.0,324,01,01,  Dakshin Narpati,1365,932,630,449,735,483,59.4,58.4,60.3,00000
19.0,72.0,52.0,324,02,01,  Daspara,309,562,140,286,169,276,35.5,32.9,38.0,00000
19.0,72.0,52.0,324,03,01,  Shab Para,296,376,131,168,165,208,44.0,43.8,44.2,00000
19.0,72.0,52.0,324,04,01,  Uttar Narpati,794,838,350,404,444,434,48.7,46.4,50.6,00000
19.0,72.0,52.0,324,05,01,  Jogi Para,731,652,323,307,408,345,52.9,51.3,54.2,00000
19.0,72.0,52.0,324,06,01,  Sharifpur,187,324,74,148,113,176,36.6,33.3,39.1,00000
19.0,72.0,52.0,324,07,01,  Paisasi,350,310,157,146,193,164,53.0,51.8,54.1,00000
19.0,72.0,52.0,324,08,01,  Khilla Para,57,76,16,34,41,42,42.9,32.0,49.4,00000
19.0,72.0,52.0,324,09,01,  Gainar Dohura,211,187,111,81,100,106,53.0,57.8,48.5,00000
19.0,72.0,52.0,324,10,01,  Dighirpar,249,193,112,83,137,110,56.3,57.4,55.5,00000
19.0,72.0,52.0,324,11,01,  Tali Para,203,278,99,139,104,139,42.2,41.6,42.8,00000
19.0,72.0,52.0,324,12,01,  Kairpar,54,55,21,26,33,29,49.5,44.7,53.2,00000
19.0,72.0,52.0,324,13,01,  Dombaria,303,169,136,71,167,98,64.2,65.7,63.0,00000
19.0,72.0,52.0,324,14,01,  Noapara,85,117,37,60,48,57,42.1,38.1,45.7,00000
19.0,72.0,52.0,324,15,01,  Kuni Narpati,140,121,62,62,78,59,53.6,50.0,56.9,00000
19.0,72.0,52.0,324,16,01,  Daulat Para,144,158,65,80,79,78,47.7,44.8,50.3,00000
19.0,72.0,63.0,281,01,01,  Dakshin Noapara,412,177,193,71,219,106,69.9,73.1,67.4,00000
19.0,72.0,63.0,281,02,01,  Uttar Noapara,333,113,138,45,195,68,74.7,75.4,74.1,00000
19.0,72.0,63.0,453,01,01,  Kagaia,720,1389,285,632,435,757,34.1,31.1,36.5,00000
19.0,72.0,63.0,453,02,01,  Nakbatia,599,679,232,314,367,365,46.9,42.5,50.1,00000
19.0,72.0,63.0,631,01,01,  Mudafarganj,215,284,113,154,102,130,43.1,42.3,44.0,00000
19.0,72.0,63.0,631,02,01,  Nagar Para,640,658,306,344,334,314,49.3,47.1,51.5,00000
19.0,72.0,63.0,631,03,01,  Chiknia,1722,2211,748,1080,974,1131,43.8,40.9,46.3,00000
19.0,72.0,63.0,631,04,01,  Khata Para,226,218,115,96,111,122,50.9,54.5,47.6,00000
19.0,72.0,63.0,787,01,01,  Sree Anga,2501,2385,1085,1150,1416,1235,51.2,48.5,53.4,00000
19.0,72.0,63.0,787,02,01,  Hamirabagh,480,385,195,177,285,208,55.5,52.4,57.8,00000
19.0,72.0,77.0,136,01,01,  Bhakarda,862,838,388,412,474,426,50.7,48.5,52.7,00000
19.0,72.0,77.0,136,02,01,  Ray Pur,457,422,193,185,264,237,52.0,51.1,52.7,00000
19.0,72.0,77.0,414,01,01,  Iruain,1234,1947,545,935,689,1012,38.8,36.8,40.5,00000
19.0,72.0,77.0,414,02,01,  Tangirpar,344,801,156,386,188,415,30.0,28.8,31.2,00000
19.0,72.0,77.0,500,01,01,  Kemtali,633,578,313,272,320,306,52.3,53.5,51.1,00000
19.0,72.0,77.0,500,02,01,  Noapara,561,308,328,152,233,156,64.6,68.3,59.9,00000
19.0,72.0,77.0,636,01,01,  Nair Para,611,741,288,342,323,399,45.2,45.7,44.7,00000
19.0,72.0,77.0,636,02,01,  Changachal,303,555,119,268,184,287,35.3,30.7,39.1,00000
19.0,72.0,77.0,636,03,01,  Shola Puskarani,160,209,69,93,91,116,43.4,42.6,44.0,00000
19.0,72.0,77.0,636,04,01,  Nischintapur,66,40,31,21,35,19,62.3,59.6,64.8,00000
19.0,72.0,84.0,014,01,01,  Amduar,674,384,336,184,338,200,63.7,64.6,62.8,00000
19.0,72.0,84.0,014,02,01,  Naoti,781,1067,397,484,384,583,42.3,45.1,39.7,00000
19.0,72.0,84.0,901,01,01,  Ukhtala,615,779,338,371,277,408,44.1,47.7,40.4,00000
19.0,72.0,84.0,901,02,01,  Dambahar,417,371,222,176,195,195,52.9,55.8,50.0,00000
19.0,72.0,87.0,093,01,01,  Bara Rajapur,1593,1011,824,429,769,582,61.2,65.8,56.9,00000
19.0,72.0,87.0,093,02,01,  Paloin,702,577,311,282,391,295,54.9,52.4,57.0,00000
19.0,72.0,87.0,105,01,01,  Sherpur,63,196,27,92,36,104,24.3,22.7,25.7,00000
19.0,72.0,87.0,105,02,01,  Baraimuri,132,144,52,59,80,85,47.8,46.8,48.5,00000
19.0,72.0,87.0,182,01,01,  Chandana,694,237,324,86,370,151,74.5,79.0,71.0,00000
19.0,72.0,87.0,182,02,01,  Uttarda,1083,826,600,368,483,458,56.7,62.0,51.3,00000
19.0,72.0,87.0,182,03,01,  Kandirpar,130,64,79,28,51,36,67.0,73.8,58.6,00000
19.0,72.0,87.0,182,04,01,  Khil Para,852,689,370,348,482,341,55.3,51.5,58.6,00000
19.0,72.0,87.0,584,01,01,  Mamisar,296,182,145,77,151,105,61.9,65.3,59.0,00000
19.0,72.0,87.0,584,02,01,  Sholadana,64,169,30,82,34,87,27.5,26.8,28.1,00000
19.0,74.0,17.0,432,01,01,  Jaora East,1211,1147,509,536,702,611,51.4,48.7,53.5,00000
19.0,74.0,17.0,432,02,01,  Jaora West,1062,699,459,317,603,382,60.3,59.1,61.2,00000
19.0,74.0,17.0,478,01,01,  North Kanchi,1651,1089,727,494,924,595,60.3,59.5,60.8,00000
19.0,74.0,17.0,478,02,01,  South Kanchi,729,513,354,248,375,265,58.7,58.8,58.6,00000
19.0,74.0,17.0,478,03,01,  Chhota Kanchi,579,537,256,257,323,280,51.9,49.9,53.6,00000
19.0,74.0,45.0,753,01,01,  North Pamsaon,1238,989,573,481,665,508,55.6,54.4,56.7,00000
19.0,74.0,45.0,753,02,01,  South Pomgaon,502,621,204,268,298,353,44.7,43.2,45.8,00000
19.0,74.0,53.0,069,01,01,  Banduain,1385,436,657,192,728,244,76.1,77.4,74.9,00000
19.0,74.0,53.0,069,02,01,  Ullah Para,287,6,135,2,152,4,98.0,98.5,97.4,00000
19.0,74.0,53.0,069,03,01,  Panch Pukuria,301,39,149,15,152,24,88.5,90.9,86.4,00000
19.0,74.0,53.0,701,01,01,  Paschim Batabaria,872,412,418,189,454,223,67.9,68.9,67.1,00000
19.0,74.0,53.0,701,02,01,  Purba Batabaria,705,446,293,221,412,225,61.3,57.0,64.7,00000
19.0,74.0,59.0,541,01,01,  Lakshmanpur,1069,928,462,439,607,489,53.5,51.3,55.4,00000
19.0,74.0,59.0,541,02,01,  Jalkandi,359,180,184,75,175,105,66.6,71.0,62.5,00000
19.0,74.0,59.0,541,03,01,  Banughar,1021,470,432,222,589,248,68.5,66.1,70.4,00000
19.0,74.0,59.0,541,04,01,  Ramanandi,284,106,126,44,158,62,72.8,74.1,71.8,00000
19.0,74.0,59.0,604,01,01,  Maraha,1544,1279,622,569,922,710,54.7,52.2,56.5,00000
19.0,74.0,59.0,604,02,01,  Majhiakhali,157,269,68,138,89,131,36.9,33.0,40.5,00000
19.0,74.0,70.0,148,01,01,  Bhogai,3227,2836,1330,1302,1897,1534,53.2,50.5,55.3,00000
19.0,74.0,70.0,148,02,01,  Kandi,656,596,245,273,411,323,52.4,47.3,56.0,00000
19.0,74.0,70.0,168,01,01,  Ganipur,468,437,232,219,236,218,51.7,51.4,52.0,00000
19.0,74.0,70.0,168,02,01,  Binoyghar,1673,1821,701,852,972,969,47.9,45.1,50.1,00000
19.0,74.0,70.0,168,03,01,  Batachho,1173,409,515,182,658,227,74.1,73.9,74.4,00000
19.0,74.0,70.0,168,04,01,  Alocudia,105,135,41,70,64,65,43.8,36.9,49.6,00000
19.0,74.0,70.0,168,05,01,  Noapari,175,80,80,44,95,36,68.6,64.5,72.5,00000
19.0,74.0,82.0,145,01,01,  Bhaupur,2421,2028,1013,968,1408,1060,54.4,51.1,57.1,00000
19.0,74.0,82.0,145,02,01,  Moricha,379,95,165,35,214,60,80.0,82.5,78.1,00000
19.0,74.0,82.0,727,01,01,  Sahapur,985,740,406,335,579,405,57.1,54.8,58.8,00000
19.0,74.0,82.0,727,02,01,  Pachruhai,279,262,94,126,185,136,51.6,42.7,57.6,00000
19.0,74.0,82.0,727,03,01,  Aochia,143,125,56,51,87,74,53.4,52.3,54.0,00000
19.0,74.0,82.0,727,04,01,  Chodda Dohna,152,144,56,71,96,73,51.4,44.1,56.8,00000
19.0,74.0,82.0,849,01,01,  Shoroshpur,1296,1134,536,511,760,623,53.3,51.2,55.0,00000
19.0,74.0,82.0,849,02,01,  Kismat,109,187,49,79,60,108,36.8,38.3,35.7,00000
19.0,74.0,94.0,109,01,01,  Uttar Fenua,1048,284,485,135,563,149,78.7,78.2,79.1,00000
19.0,74.0,94.0,109,02,01,  Dakhin Fenua,1035,854,414,430,621,424,54.8,49.1,59.4,00000
19.0,74.0,94.0,109,03,01,  Barallah Uttar,1156,788,482,354,674,434,59.5,57.7,60.8,00000
19.0,74.0,94.0,109,04,01,  Ulupara,572,130,241,64,331,66,81.5,79.0,83.4,00000
19.0,74.0,94.0,109,05,01,  Koiar Par,286,111,116,51,170,60,72.0,69.5,73.9,00000
19.0,74.0,94.0,109,06,01,  Gozaria,34,120,9,56,25,64,22.1,13.8,28.1,00000
19.0,74.0,94.0,109,07,01,  Katuni Para,356,473,152,208,204,265,42.9,42.2,43.5,00000
19.0,74.0,94.0,109,08,01,  Hatimara Purba,1286,837,590,412,696,425,60.6,58.9,62.1,00000
19.0,74.0,94.0,109,09,01,  Hatimara Paschim,658,542,314,250,344,292,54.8,55.7,54.1,00000
19.0,74.0,94.0,109,10,01,  Ulupara Dakhin,435,428,199,176,236,252,50.4,53.1,48.4,00000
19.0,74.0,94.0,109,11,01,  Barallah Dakhin,307,250,115,100,192,150,55.1,53.5,56.1,00000
19.0,74.0,94.0,109,12,01,  Indry,554,225,259,94,295,131,71.1,73.4,69.2,00000
19.0,74.0,94.0,109,13,01,  Kowli Para,561,360,249,158,312,202,60.9,61.2,60.7,00000
19.0,74.0,94.0,109,14,01,  Jorpara,146,20,68,11,78,9,88.0,86.1,89.7,00000
19.0,74.0,94.0,948,01,01,  Uttar Hawla Uttar,730,705,290,328,440,377,50.9,46.9,53.9,00000
19.0,74.0,94.0,948,02,01,  Uttar Hawla Dakhin,1097,906,444,399,653,507,54.8,52.7,56.3,00000
19.0,74.0,94.0,948,03,01,  Hajra Muri,121,33,58,12,63,21,78.6,82.9,75.0,00000
19.0,75.0,12.0,065,01,01,  Dakshin Baorkhola,901,1225,439,574,462,651,42.4,43.3,41.5,00000
19.0,75.0,12.0,065,02,01,  Kashipur,42,133,22,60,20,73,24.0,26.8,21.5,00000
19.0,75.0,12.0,065,03,01,  Dari Mirzanagar,97,248,58,114,39,134,28.1,33.7,22.5,00000
19.0,75.0,12.0,065,04,01,  Ataullakandi,45,215,21,105,24,110,17.3,16.7,17.9,00000
19.0,75.0,12.0,065,05,01,  Dharmapur,57,139,31,76,26,63,29.1,29.0,29.2,00000
19.0,75.0,12.0,065,06,01,  Omrakandi,135,169,65,88,70,81,44.4,42.5,46.4,00000
19.0,75.0,12.0,065,07,01,  Bharatpur,111,244,47,103,64,141,31.3,31.3,31.2,00000
19.0,75.0,12.0,586,01,01,  Khirachak,198,493,99,225,99,268,28.7,30.6,27.0,00000
19.0,75.0,12.0,586,02,01,  Kashergaon,47,136,21,58,26,78,25.7,26.6,25.0,00000
19.0,75.0,12.0,703,01,01,  Farazikandi,122,72,67,39,55,33,62.9,63.2,62.5,00000
19.0,75.0,12.0,703,02,01,  Durgapur (Rampur),255,382,142,198,113,184,40.0,41.8,38.0,00000
19.0,75.0,12.0,703,03,01,  Barakandi,1577,1707,901,796,676,911,48.0,53.1,42.6,00000
19.0,75.0,12.0,703,04,01,  Kandergaon,467,484,260,225,207,259,49.1,53.6,44.4,00000
19.0,75.0,12.0,703,05,01,  Bakshikanda,249,650,145,335,104,315,27.7,30.2,24.8,00000
19.0,75.0,12.0,863,01,01,  Shibnagar,504,276,285,114,219,162,64.6,71.4,57.5,00000
19.0,75.0,12.0,863,02,01,  Algi,237,357,100,158,137,199,39.9,38.8,40.8,00000
19.0,75.0,12.0,863,03,01,  Char Narayanpur,52,89,32,43,20,46,36.9,42.7,30.3,00000
19.0,75.0,12.0,863,04,01,  Baidyanathpur,488,454,285,201,203,253,51.8,58.6,44.5,00000
19.0,75.0,12.0,863,05,01,  Changak Kandi,217,175,126,76,91,99,55.4,62.4,47.9,00000
19.0,75.0,12.0,863,06,01,  Uttar Bhorkhola,731,823,398,385,333,438,47.0,50.8,43.2,00000
19.0,75.0,19.0,815,01,01,  Chandanpur,1309,944,745,410,564,534,58.1,64.5,51.4,00000
19.0,75.0,19.0,815,02,01,  Bara Sapmara,395,474,204,203,191,271,45.5,50.1,41.3,00000
19.0,75.0,19.0,815,03,01,  Chhota Sapmara,214,373,120,182,94,191,36.5,39.7,33.0,00000
19.0,75.0,19.0,815,04,01,  Gopalnagar,135,296,73,146,62,150,31.3,33.3,29.2,00000
19.0,75.0,19.0,857,01,01,  Tulatali,486,1521,293,731,193,790,24.2,28.6,19.6,00000
19.0,75.0,19.0,857,02,01,  Shibnagar,923,795,514,358,409,437,53.7,58.9,48.3,00000
19.0,75.0,19.0,857,03,01,  Raghunathpur,274,618,149,305,125,313,30.7,32.8,28.5,00000
19.0,75.0,19.0,857,04,01,  Kacharikandi,451,514,247,256,204,258,46.7,49.1,44.2,00000
19.0,75.0,21.0,148,01,01,  Nalchar,394,909,206,437,188,472,30.2,32.0,28.5,00000
19.0,75.0,21.0,148,02,01,  Faraji Kandi,386,537,196,250,190,287,41.8,43.9,39.8,00000
19.0,75.0,21.0,825,01,01,  Maishar Char,628,591,359,293,269,298,51.5,55.1,47.4,00000
19.0,75.0,21.0,825,02,01,  Baraia Kandi,210,826,85,399,125,427,20.3,17.6,22.6,00000
19.0,75.0,21.0,857,01,01,  Titir Char,665,1488,378,730,287,758,30.9,34.1,27.5,00000
19.0,75.0,21.0,857,02,01,  Ramprasader Char,539,942,274,431,265,511,36.4,38.9,34.1,00000
19.0,75.0,43.0,054,01,01,  Alipur,149,84,79,41,70,43,63.9,65.8,61.9,00000
19.0,75.0,43.0,054,02,01,  Hizaltola,312,394,177,171,135,223,44.2,50.9,37.7,00000
19.0,75.0,43.0,054,03,01,  Dakshinkandi,641,824,335,375,306,449,43.8,47.2,40.5,00000
19.0,75.0,43.0,054,04,01,  Chaolaghat,139,99,62,42,77,57,58.4,59.6,57.5,00000
19.0,75.0,43.0,138,01,01,  Binodpur,199,365,111,191,88,174,35.3,36.8,33.6,00000
19.0,75.0,43.0,138,02,01,  Char Binodpur,55,256,35,137,20,119,17.7,20.3,14.4,00000
19.0,75.0,43.0,160,01,01,  Brahman Char,37,90,14,42,23,48,29.1,25.0,32.4,00000
19.0,75.0,43.0,160,02,01,  Balur Char,271,556,111,241,160,315,32.8,31.5,33.7,00000
19.0,75.0,43.0,160,03,01,  Noagaon,795,798,379,344,416,454,49.9,52.4,47.8,00000
19.0,75.0,43.0,160,04,01,  Char Noagaon,94,189,60,81,34,108,33.2,42.6,23.9,00000
19.0,75.0,43.0,229,01,03,  Char Pathalia,193,145,94,56,99,89,57.1,62.7,52.7,00000
19.0,75.0,43.0,229,02,03,  Mahaskhola,279,117,134,44,145,73,70.5,75.3,66.5,00000
19.0,75.0,43.0,229,03,03,  Ramnagar,719,653,399,301,320,352,52.4,57.0,47.6,00000
19.0,75.0,43.0,229,04,03,  Joynagar,340,770,182,373,158,397,30.6,32.8,28.5,00000
19.0,75.0,43.0,229,05,03,  Gobindapur,400,614,199,301,201,313,39.4,39.8,39.1,00000
19.0,75.0,43.0,229,06,03,  Hasnabad,473,495,240,226,233,269,48.9,51.5,46.4,00000
19.0,75.0,53.0,066,01,01,  Kandergaon,316,298,152,131,164,167,51.5,53.7,49.5,00000
19.0,75.0,53.0,066,02,01,  New Kandergaon,41,314,20,164,21,150,11.5,10.9,12.3,00000
19.0,75.0,53.0,758,01,01,  Mamudpur,527,351,259,151,268,200,60.0,63.2,57.3,00000
19.0,75.0,53.0,758,02,01,  Naya Mamud Pur,428,182,244,75,184,107,70.2,76.5,63.2,00000
19.0,75.0,53.0,870,01,01,  Dari Luter Char(I),622,488,309,207,313,281,56.0,59.9,52.7,00000
19.0,75.0,53.0,870,02,01,  Sekher Gaon,631,1049,307,482,324,567,37.6,38.9,36.4,00000
19.0,75.0,53.0,870,03,01,  Luter Char,743,629,375,297,368,332,54.2,55.8,52.6,00000
19.0,75.0,71.0,415,01,01,  Maniker Char,565,749,289,346,276,403,43.0,45.5,40.6,00000
19.0,75.0,71.0,415,02,01,  Sikir Goan,431,403,240,199,191,204,51.7,54.7,48.4,00000
19.0,75.0,71.0,415,03,01,  Mataber Kandi,204,285,113,139,91,146,41.7,44.8,38.4,00000
19.0,75.0,71.0,415,04,01,  Uttar Bausia,84,47,38,14,46,33,64.1,73.1,58.2,00000
19.0,75.0,71.0,415,05,01,  Purba Nayagaon,70,63,40,24,30,39,52.6,62.5,43.5,00000
19.0,75.0,71.0,415,06,01,  Bara Naya Gaon,352,399,183,183,169,216,46.9,50.0,43.9,00000
19.0,75.0,71.0,415,07,01,  Madhabpur,300,216,176,95,124,121,58.1,64.9,50.6,00000
19.0,75.0,71.0,415,08,01,  Ujan Char Nayagaon,118,82,75,34,43,48,59.0,68.8,47.3,00000
19.0,75.0,71.0,571,01,01,  Kashipur,387,220,216,97,171,123,63.8,69.0,58.2,00000
19.0,75.0,71.0,571,02,01,  Barahazari,436,387,244,177,192,210,53.0,58.0,47.8,00000
19.0,75.0,71.0,571,03,01,  Changa Kandi,241,345,153,175,88,170,41.1,46.6,34.1,00000
19.0,75.0,71.0,571,04,01,  Rajitpur,88,83,48,35,40,48,51.5,57.8,45.5,00000
19.0,75.0,71.0,571,05,01,  Karimabad,238,182,131,77,107,105,56.7,63.0,50.5,00000
19.0,75.0,71.0,571,06,01,  Lastimanika,189,107,112,47,77,60,63.9,70.4,56.2,00000
19.0,75.0,71.0,571,07,01,  Amirabad,561,528,313,263,248,265,51.5,54.3,48.3,00000
19.0,75.0,71.0,571,08,01,  Jalar Para,147,215,92,97,55,118,40.6,48.7,31.8,00000
19.0,75.0,71.0,571,09,01,  Ballaverkandi,312,208,178,92,134,116,60.0,65.9,53.6,00000
19.0,75.0,71.0,571,10,01,  Jalar Par Nayagaon,279,452,174,195,105,257,38.2,47.2,29.0,00000
19.0,75.0,95.0,074,01,01,  Batthali,216,269,117,147,99,122,44.5,44.3,44.8,00000
19.0,75.0,95.0,074,02,01,  Taltali,202,650,126,323,76,327,23.7,28.1,18.9,00000
19.0,75.0,95.0,074,03,01,  Mollahkandi,686,793,427,388,259,405,46.4,52.4,39.0,00000
19.0,75.0,95.0,561,01,01,  Ratanpur,268,359,166,163,102,196,42.7,50.5,34.2,00000
19.0,75.0,95.0,561,02,01,  Takhurkandi,352,51,189,29,163,22,87.3,86.7,88.1,00000
19.0,75.0,95.0,561,03,01,  Lakshmankhola,1690,1194,1027,523,663,671,58.6,66.3,49.7,00000
19.0,75.0,95.0,561,04,01,  Dullabdhi,211,361,116,176,95,185,36.9,39.7,33.9,00000
19.0,75.0,95.0,561,05,01,  Khatalia,144,160,80,68,64,92,47.4,54.1,41.0,00000
19.0,75.0,95.0,635,01,01,  Radhanagar,977,813,578,371,399,442,54.6,60.9,47.4,00000
19.0,75.0,95.0,635,02,01,  Mugar Char,948,1027,452,406,496,621,48.0,52.7,44.4,00000
19.0,81.0,10.0,039,01,01,  Bailghar,1710,1507,790,663,920,844,53.2,54.4,52.2,00000
19.0,81.0,10.0,039,02,01,  Rajabari,313,316,146,156,167,160,49.8,48.3,51.1,00000
19.0,81.0,10.0,325,01,01,  Gazipur,1779,1031,780,428,999,603,63.3,64.6,62.4,00000
19.0,81.0,10.0,325,02,01,  Jangal,298,186,136,80,162,106,61.6,63.0,60.4,00000
19.0,81.0,10.0,461,01,01,  Kashimpur,3893,1640,1824,714,2069,926,70.4,71.9,69.1,00000
19.0,81.0,10.0,461,02,01,  Bakhya,380,324,165,129,215,195,54.0,56.1,52.4,00000
19.0,81.0,10.0,585,01,01,  Metanghar,1779,1655,823,788,956,867,51.8,51.1,52.4,00000
19.0,81.0,10.0,585,02,01,  Ghorashal,262,443,111,204,151,239,37.2,35.2,38.7,00000
19.0,81.0,10.0,585,03,01,  Karaibari,1100,952,475,456,625,496,53.6,51.0,55.8,00000
19.0,81.0,10.0,585,04,01,  Kurerpar,827,778,368,338,459,440,51.5,52.1,51.1,00000
19.0,81.0,10.0,585,05,01,  Hosnabad,280,296,117,121,163,175,48.6,49.2,48.2,00000
19.0,81.0,10.0,585,06,01,  Pandughar,1031,995,438,410,593,585,50.9,51.7,50.3,00000
19.0,81.0,11.0,214,01,01,  Dalpa,2012,1495,935,667,1077,828,57.4,58.4,56.5,00000
19.0,81.0,11.0,214,02,01,  Deura,1429,2091,609,1007,820,1084,40.6,37.7,43.1,00000
19.0,81.0,11.0,214,03,01,  Fulghar,770,790,347,346,423,444,49.4,50.1,48.8,00000
19.0,81.0,11.0,344,01,01,  Haidarabad,1728,2106,828,914,900,1192,45.1,47.5,43.0,00000
19.0,81.0,11.0,344,02,01,  Sonarampur,734,225,383,99,351,126,76.5,79.5,73.6,00000
19.0,81.0,11.0,344,03,01,  Kaysar,165,290,63,143,102,147,36.3,30.6,41.0,00000
19.0,81.0,11.0,344,04,01,  Ganipur,310,208,140,92,170,116,59.8,60.3,59.4,00000
19.0,81.0,11.0,383,01,01,  Jadda,793,1191,374,538,419,653,40.0,41.0,39.1,00000
19.0,81.0,11.0,383,02,01,  Jangal,490,421,205,187,285,234,53.8,52.3,54.9,00000
19.0,81.0,13.0,240,01,01,  Shimanarpar,787,338,354,129,433,209,70.0,73.3,67.4,00000
19.0,81.0,13.0,240,02,01,  Daulatpur,1903,1243,874,513,1029,730,60.5,63.0,58.5,00000
19.0,81.0,13.0,240,03,01,  Jogirkhil,582,394,249,178,333,216,59.6,58.3,60.7,00000
19.0,81.0,13.0,682,01,01,  Benikhola,173,202,80,95,93,107,46.1,45.7,46.5,00000
19.0,81.0,13.0,682,02,01,  Bishnupur,506,734,214,340,292,394,40.8,38.6,42.6,00000
19.0,81.0,18.0,266,01,01,  Dhanapatikhola,1037,1399,526,658,511,741,42.6,44.4,40.8,00000
19.0,81.0,18.0,266,02,01,  Kalaraia,644,387,313,182,331,205,62.5,63.2,61.8,00000
19.0,81.0,18.0,526,01,01,  Kurakhal,1090,865,519,398,571,467,55.8,56.6,55.0,00000
19.0,81.0,18.0,526,02,01,  Kurundi,641,318,285,150,356,168,66.8,65.5,67.9,00000
19.0,81.0,18.0,858,01,01,  Kudalkata,385,412,175,184,210,228,48.3,48.7,47.9,00000
19.0,81.0,18.0,858,02,01,  Mirzapur,265,190,117,76,148,114,58.2,60.6,56.5,00000
19.0,81.0,18.0,858,03,01,  Noagaon,706,374,366,152,340,222,65.4,70.7,60.5,00000
19.0,81.0,18.0,858,04,01,  Kalipura,556,469,243,214,313,255,54.2,53.2,55.1,00000
19.0,81.0,18.0,858,05,01,  Panjir Par,303,165,153,75,150,90,64.7,67.1,62.5,00000
19.0,81.0,22.0,494,01,01,  Khapura,848,810,384,392,464,418,51.1,49.5,52.6,00000
19.0,81.0,22.0,494,02,01,  Ulumuira,458,157,201,74,257,83,74.5,73.1,75.6,00000
19.0,81.0,27.0,429,01,01,  Pukurpar,169,146,79,69,90,77,53.7,53.4,53.9,00000
19.0,81.0,27.0,429,02,01,  Ratan Nagar,36,192,18,92,18,100,15.8,16.4,15.3,00000
19.0,81.0,27.0,429,03,01,  Sobdulkanda,115,140,53,62,62,78,45.1,46.1,44.3,00000
19.0,81.0,27.0,429,04,01,  Dakshin Kajiatal,1996,1408,938,565,1058,843,58.6,62.4,55.7,00000
19.0,81.0,27.0,429,05,01,  Uttar Kajiatal,1307,1205,599,529,708,676,52.0,53.1,51.2,00000
19.0,81.0,27.0,734,01,01,  Palasuta,1012,1587,445,678,567,909,38.9,39.6,38.4,00000
19.0,81.0,27.0,734,02,01,  Nayakandi,112,421,50,172,62,249,21.0,22.5,19.9,00000
19.0,81.0,27.0,734,03,01,  Haterpar,33,93,14,45,19,48,26.2,23.7,28.4,00000
19.0,81.0,31.0,182,01,01,  Chhaliakandi,1846,2109,956,985,890,1124,46.7,49.3,44.2,00000
19.0,81.0,31.0,182,02,01,  Dakshin Chhaliakandi,296,436,112,190,184,246,40.4,37.1,42.8,00000
19.0,81.0,31.0,929,01,01,  Subilar Char,396,791,191,346,205,445,33.4,35.6,31.5,00000
19.0,81.0,31.0,929,02,01,  Chengatali,38,36,17,15,21,21,51.4,53.1,50.0,00000
19.0,81.0,31.0,929,03,01,  Balu Char,137,195,51,99,86,96,41.3,34.0,47.3,00000
19.0,81.0,31.0,929,04,01,  Sonkordi,22,61,5,24,17,37,26.5,17.2,31.5,00000
19.0,81.0,31.0,976,01,01,  Niamatkandi,722,1037,356,453,366,584,41.0,44.0,38.5,00000
19.0,81.0,31.0,976,02,01,  Uttar Ampal,324,517,142,207,182,310,38.5,40.7,37.0,00000
19.0,81.0,31.0,976,03,01,  Bagalkhala,154,324,81,149,73,175,32.2,35.2,29.4,00000
19.0,81.0,36.0,026,01,01,  Aralia,868,191,391,74,477,117,82.0,84.1,80.3,00000
19.0,81.0,36.0,026,02,01,  Ghaituli,601,364,295,161,306,203,62.3,64.7,60.1,00000
19.0,81.0,36.0,637,01,01,  Nahal,1292,439,607,212,685,227,74.6,74.1,75.1,00000
19.0,81.0,36.0,637,02,01,  Ramnagar,244,42,107,14,137,28,85.3,88.4,83.0,00000
19.0,81.0,36.0,760,01,01,  Paramtala,3356,2368,1621,1014,1735,1354,58.6,61.5,56.2,00000
19.0,81.0,36.0,760,02,01,  Brindarampur,88,58,44,18,44,40,60.3,71.0,52.4,00000
19.0,81.0,36.0,819,01,01,  Roytala,984,596,440,274,544,322,62.3,61.6,62.8,00000
19.0,81.0,36.0,819,02,01,  Bhagalpur,594,238,313,109,281,129,71.4,74.2,68.5,00000
19.0,81.0,36.0,851,01,01,  Siddheshwari,1186,1039,532,464,654,575,53.3,53.4,53.2,00000
19.0,81.0,36.0,851,02,01,  Noakhala,603,545,303,230,300,315,52.5,56.8,48.8,00000
19.0,81.0,40.0,084,01,01,  Baraiakuri,816,759,391,334,425,425,51.8,53.9,50.0,00000
19.0,81.0,40.0,084,02,01,  Darikandi,94,427,33,194,61,233,18.0,14.5,20.7,00000
19.0,81.0,40.0,084,03,01,  Kacharikandi,199,420,93,182,106,238,32.1,33.8,30.8,00000
19.0,81.0,40.0,221,01,01,  Uttar Darikandi,398,312,251,119,147,193,56.1,67.8,43.2,00000
19.0,81.0,40.0,221,02,01,  Daularampur,467,554,282,252,185,302,45.7,52.8,38.0,00000
19.0,81.0,40.0,474,01,01,  Keotgaon,621,746,339,359,282,387,45.4,48.6,42.2,00000
19.0,81.0,40.0,474,02,01,  Payab,1360,674,763,300,597,374,66.9,71.8,61.5,00000
19.0,81.0,40.0,474,03,01,  Sosounda,1423,2285,802,1110,621,1175,38.4,41.9,34.6,00000
19.0,81.0,40.0,474,04,01,  Nayakandi,556,845,268,414,288,431,39.7,39.3,40.1,00000
19.0,81.0,40.0,838,01,01,  Satmora,1146,1427,568,655,578,772,44.5,46.4,42.8,00000
19.0,81.0,40.0,838,02,01,  Ballabhdi,485,567,242,240,243,327,46.1,50.2,42.6,00000
19.0,81.0,45.0,403,01,01,  Jatrapur,2062,2322,980,994,1082,1328,47.0,49.6,44.9,00000
19.0,81.0,45.0,403,02,01,  Singaria,201,354,103,142,98,212,36.2,42.0,31.6,00000
19.0,81.0,45.0,598,01,01,  Mochagara,2156,2924,1025,1346,1131,1578,42.4,43.2,41.7,00000
19.0,81.0,45.0,598,02,01,  Kashipur,164,271,77,126,87,145,37.7,37.9,37.5,00000
19.0,81.0,45.0,598,03,01,  Dari Para,576,337,258,147,318,190,63.1,63.7,62.6,00000
19.0,81.0,45.0,675,01,01,  Bhabanipur,453,906,216,427,237,479,33.3,33.6,33.1,00000
19.0,81.0,45.0,675,02,01,  Silampur,385,487,178,211,207,276,44.2,45.8,42.9,00000
19.0,81.0,45.0,675,03,01,  Shola Pukuria,431,475,199,217,232,258,47.6,47.8,47.3,00000
19.0,81.0,45.0,675,04,01,  Silimpurer Kunda,259,129,131,54,128,75,66.8,70.8,63.1,00000
19.0,81.0,49.0,448,01,01,  Kamalla,2766,3515,1288,1526,1478,1989,44.0,45.8,42.6,00000
19.0,81.0,49.0,448,02,01,  Raznagar,323,692,146,314,177,378,31.8,31.7,31.9,00000
19.0,81.0,49.0,455,01,01,  Kamar Char,935,1597,423,698,512,899,36.9,37.7,36.3,00000
19.0,81.0,49.0,455,02,01,  Noagaon,663,962,313,431,350,531,40.8,42.1,39.7,00000
19.0,81.0,49.0,455,03,01,  Ashanpur,194,344,85,156,109,188,36.1,35.3,36.7,00000
19.0,81.0,49.0,455,04,01,  Neamatpur,666,1133,337,484,329,649,37.0,41.0,33.6,00000
19.0,81.0,54.0,078,01,01,  Uttar Alirchar,1066,1238,503,562,563,676,46.3,47.2,45.4,00000
19.0,81.0,54.0,078,02,01,  Dakshin Alirchar,478,433,228,160,250,273,52.5,58.8,47.8,00000
19.0,81.0,54.0,260,01,01,  Ramjanerkanda,182,131,72,54,110,77,58.1,57.1,58.8,00000
19.0,81.0,54.0,260,02,01,  Dhanirampur,1424,1170,714,509,710,661,54.9,58.4,51.8,00000
19.0,81.0,54.0,572,01,01,  Matkir Char,514,389,247,144,267,245,56.9,63.2,52.1,00000
19.0,81.0,54.0,572,02,01,  Rampur,188,438,85,188,103,250,30.0,31.1,29.2,00000
19.0,81.0,54.0,611,01,03,  Muradnagar,3363,2179,1651,948,1712,1231,60.7,63.5,58.2,00000
19.0,81.0,54.0,611,02,03,  Madda Nagara,477,827,219,397,258,430,36.6,35.6,37.5,00000
19.0,81.0,54.0,611,03,03,  Karimpur,783,936,387,418,396,518,45.5,48.1,43.3,00000
19.0,81.0,54.0,611,04,03,  Herarer Kanda,494,821,234,398,260,423,37.6,37.0,38.1,00000
19.0,81.0,54.0,611,05,03,  Dilalpur,909,1238,402,559,507,679,42.3,41.8,42.7,00000
19.0,81.0,54.0,611,06,03,  Yusubnagar,923,841,459,408,464,433,52.3,52.9,51.7,00000
19.0,81.0,54.0,630,01,01,  Nagerkandi,226,727,105,352,121,375,23.7,23.0,24.4,00000
19.0,81.0,54.0,630,02,01,  Damuria,243,583,120,272,123,311,29.4,30.6,28.3,00000
19.0,81.0,54.0,681,01,01,  Paschim Ghorashal,1244,1200,549,570,695,630,50.9,49.1,52.5,00000
19.0,81.0,54.0,681,02,01,  Khudra Ghorashal,17,32,13,15,4,17,34.7,46.4,19.0,00000
19.0,81.0,54.0,864,01,01,  Purba Sonaulla,310,525,134,225,176,300,37.1,37.3,37.0,00000
19.0,81.0,54.0,864,02,01,  Paschim Sonaulla,300,625,142,274,158,351,32.4,34.1,31.0,00000
19.0,81.0,54.0,864,03,01,  Karkatia,371,191,163,79,208,112,66.0,67.4,65.0,00000
19.0,81.0,54.0,942,01,01,  Imandikandi,124,192,57,93,67,99,39.2,38.0,40.4,00000
19.0,81.0,54.0,942,02,01,  Sureshwardi,53,175,29,82,24,93,23.2,26.1,20.5,00000
19.0,81.0,54.0,942,03,01,  Sonapur,558,1023,277,472,281,551,35.3,37.0,33.8,00000
19.0,81.0,54.0,942,04,01,  Manik Kandi,124,247,49,112,75,135,33.4,30.4,35.7,00000
19.0,81.0,58.0,056,01,01,  Bakharnagar,5005,5755,2444,2812,2561,2943,46.5,46.5,46.5,00000
19.0,81.0,58.0,056,02,01,  Gokulnagar,1278,1585,680,921,598,664,44.6,42.5,47.4,00000
19.0,81.0,63.0,520,01,01,  Kulubari,897,999,436,484,461,515,47.3,47.4,47.2,00000
19.0,81.0,63.0,520,02,01,  Padua,276,459,130,221,146,238,37.6,37.0,38.0,00000
19.0,81.0,63.0,694,01,03,  Nabipur,2103,1948,1029,934,1074,1014,51.9,52.4,51.4,00000
19.0,81.0,63.0,694,02,03,  Husentala,175,53,85,21,90,32,76.8,80.2,73.8,00000
19.0,81.0,63.0,694,03,03,  Nabipur Kanda,125,201,59,87,66,114,38.3,40.4,36.7,00000
19.0,81.0,63.0,799,01,03,  Rahimpur,1854,1630,929,789,925,841,53.2,54.1,52.4,00000
19.0,81.0,63.0,799,02,03,  Ramdani Mura,136,209,69,99,67,110,39.4,41.1,37.9,00000
19.0,81.0,63.0,799,03,03,  Chowdhury Kandi,105,179,48,78,57,101,37.0,38.1,36.1,00000
19.0,81.0,63.0,799,04,03,  Kismat Rahimpur,252,29,141,9,111,20,89.7,94.0,84.7,00000
19.0,81.0,63.0,799,05,03,  Nemaikandi,1365,458,687,188,678,270,74.9,78.5,71.5,00000
19.0,81.0,63.0,799,06,03,  Darikandi Rahimpur,261,135,131,58,130,77,65.9,69.3,62.8,00000
19.0,81.0,63.0,799,07,03,  Bahoramkanda,194,256,85,128,109,128,43.1,39.9,46.0,00000
19.0,81.0,63.0,799,08,03,  Sebanipur,487,640,276,389,211,251,43.2,41.5,45.7,00000
19.0,81.0,63.0,962,01,01,  Uttar Trish,1337,1063,674,496,663,567,55.7,57.6,53.9,00000
19.0,81.0,63.0,962,02,01,  Dakshin Trish,522,471,228,224,294,247,52.6,50.4,54.3,00000
19.0,81.0,63.0,962,03,01,  Paia Pathar,798,1446,437,780,361,666,35.6,35.9,35.2,00000
19.0,81.0,63.0,962,04,01,  Companigaon,800,302,462,161,338,141,72.6,74.2,70.6,00000
19.0,81.0,63.0,962,05,01,  Malishair,294,73,132,28,162,45,80.1,82.5,78.3,00000
19.0,81.0,67.0,110,01,01,  Bhiti Panch Pukharia,863,1286,392,561,471,725,40.2,41.1,39.4,00000
19.0,81.0,67.0,110,02,01,  Lakshmipur,298,628,136,294,162,334,32.2,31.6,32.7,00000
19.0,81.0,67.0,110,03,01,  Madhabpur,145,485,59,217,86,268,23.0,21.4,24.3,00000
19.0,81.0,67.0,110,04,01,  Fakir Para,83,95,32,45,51,50,46.6,41.6,50.5,00000
19.0,81.0,67.0,110,05,01,  Jalu Para,235,205,114,95,121,110,53.4,54.5,52.4,00000
19.0,81.0,67.0,728,01,01,  Paharpur,1943,1869,961,833,982,1036,51.0,53.6,48.7,00000
19.0,81.0,67.0,728,02,01,  Maja Para,183,47,80,15,103,32,79.6,84.2,76.3,00000
19.0,81.0,67.0,728,03,01,  Utrain,318,232,150,103,168,129,57.8,59.3,56.6,00000
19.0,81.0,67.0,728,04,01,  Dekrirpar,155,375,79,169,76,206,29.2,31.9,27.0,00000
19.0,81.0,67.0,728,05,01,  Kalamuria,129,256,58,114,71,142,33.5,33.7,33.3,00000
19.0,81.0,67.0,728,06,01,  Kurarpar,118,203,53,95,65,108,36.8,35.8,37.6,00000
19.0,81.0,67.0,728,07,01,  Baluachana,46,211,28,103,18,108,17.9,21.4,14.3,00000
19.0,81.0,67.0,936,01,01,  Suranandi,422,449,196,213,226,236,48.5,47.9,48.9,00000
19.0,81.0,67.0,936,02,01,  Sormakanda,617,590,315,280,302,310,51.1,52.9,49.3,00000
19.0,81.0,72.0,032,01,01,  Babuti Para,2205,2353,1025,1070,1180,1283,48.4,48.9,47.9,00000
19.0,81.0,72.0,032,02,01,  Boyeskhola,80,130,32,60,48,70,38.1,34.8,40.7,00000
19.0,81.0,72.0,032,03,01,  Telua Mainka,204,488,82,230,122,258,29.5,26.3,32.1,00000
19.0,81.0,72.0,032,04,01,  Natun Babuti Para,90,164,37,74,53,90,35.4,33.3,37.1,00000
19.0,81.0,72.0,032,05,01,  Naya Pushkurini,612,266,260,104,352,162,69.7,71.4,68.5,00000
19.0,81.0,72.0,208,01,01,  Daiara,906,727,421,287,485,440,55.5,59.5,52.4,00000
19.0,81.0,72.0,208,02,01,  Tepukuria,231,184,116,73,115,111,55.7,61.4,50.9,00000
19.0,81.0,72.0,533,01,01,  Lajair,1032,1047,506,477,526,570,49.6,51.5,48.0,00000
19.0,81.0,72.0,533,02,01,  Darani Para,730,693,370,296,360,397,51.3,55.6,47.6,00000
19.0,81.0,72.0,533,03,01,  Ashadnagar,153,341,68,163,85,178,31.0,29.4,32.3,00000
19.0,81.0,72.0,754,01,01,  Panti,426,517,201,211,225,306,45.2,48.8,42.4,00000
19.0,81.0,72.0,754,02,01,  Dhargaji,127,110,66,54,61,56,53.6,55.0,52.1,00000
19.0,81.0,72.0,806,01,01,  Rampur,260,453,157,231,103,222,36.5,40.5,31.7,00000
19.0,81.0,72.0,806,02,01,  Kaladumur,586,538,275,258,311,280,52.1,51.6,52.6,00000
19.0,81.0,76.0,500,01,01,  Khoshghar,1477,1970,672,946,805,1024,42.8,41.5,44.0,00000
19.0,81.0,76.0,500,02,01,  Joynagar,229,208,115,94,114,114,52.4,55.0,50.0,00000
19.0,81.0,81.0,357,01,01,  Hatas,1248,1166,585,521,663,645,51.7,52.9,50.7,00000
19.0,81.0,81.0,357,02,01,  Kadamtali,119,168,47,77,72,91,41.5,37.9,44.2,00000
19.0,81.0,81.0,357,03,01,  Khyakhali,382,311,164,145,218,166,55.1,53.1,56.8,00000
19.0,81.0,85.0,058,01,01,  Ramchandrapur Bazar,730,438,414,215,316,223,62.5,65.8,58.6,00000
19.0,81.0,85.0,058,02,01,  Alalerkandi,80,115,29,60,51,55,41.0,32.6,48.1,00000
19.0,81.0,85.0,058,03,01,  Sarerpar,81,399,35,198,46,201,16.9,15.0,18.6,00000
19.0,81.0,85.0,058,04,01,  Aminnagar,375,532,193,260,182,272,41.3,42.6,40.1,00000
19.0,81.0,85.0,058,05,01,  Uttar Bakhrabad,783,646,473,291,310,355,54.8,61.9,46.6,00000
19.0,81.0,85.0,058,06,01,  Dakshin Bakhrabad,1199,720,673,339,526,381,62.5,66.5,58.0,00000
19.0,81.0,85.0,058,07,01,  Khane Para,409,400,221,186,188,214,50.6,54.3,46.8,00000
19.0,81.0,85.0,058,08,01,  Sonakandi,106,218,49,99,57,119,32.7,33.1,32.4,00000
19.0,81.0,85.0,058,09,01,  Temoria,282,431,130,249,152,182,39.6,34.3,45.5,00000
19.0,81.0,85.0,058,10,01,  Mahutikanda,58,457,21,218,37,239,11.3,8.8,13.4,00000
19.0,81.0,85.0,058,11,01,  Sahebnagar,277,792,127,413,150,379,25.9,23.5,28.4,00000
19.0,81.0,85.0,058,12,01,  Ramchandrapur,681,885,325,430,356,455,43.5,43.0,43.9,00000
19.0,81.0,85.0,058,13,01,  Kanthaliakandi,637,468,313,186,324,282,57.6,62.7,53.5,00000
19.0,81.0,90.0,290,01,01,  Teguria,34,100,14,53,20,47,25.4,20.9,29.9,00000
19.0,81.0,90.0,290,02,01,  Paschim Dighaldi,128,346,55,167,73,179,27.0,24.8,29.0,00000
19.0,81.0,90.0,290,03,01,  Dighaldi,347,405,162,178,185,227,46.1,47.6,44.9,00000
19.0,81.0,90.0,409,01,01,  Baher Char,571,1379,278,623,293,756,29.3,30.9,27.9,00000
19.0,81.0,90.0,409,02,01,  Darikandi,214,336,93,159,121,177,38.9,36.9,40.6,00000
19.0,81.0,90.0,409,03,01,  Joynagar,143,344,67,163,76,181,29.4,29.1,29.6,00000
19.0,81.0,90.0,409,04,01,  Kamalkandi,69,377,37,181,32,196,15.5,17.0,14.0,00000
19.0,81.0,90.0,409,05,01,  Jasamantapur,186,374,94,182,92,192,33.2,34.1,32.4,00000
19.0,81.0,90.0,409,06,01,  Kacharikandi,222,392,113,165,109,227,36.2,40.6,32.4,00000
19.0,81.0,90.0,409,07,01,  Pathaliakandi,39,61,24,24,15,37,39.0,50.0,28.8,00000
19.0,81.0,90.0,409,08,01,  Dhanerkandi,136,196,59,106,77,90,41.0,35.8,46.1,00000
19.0,81.0,90.0,409,09,01,  Uttarkandi,115,278,55,127,60,151,29.3,30.2,28.4,00000
19.0,81.0,90.0,565,01,01,  Kayjuri,298,427,144,179,154,248,41.1,44.6,38.3,00000
19.0,81.0,90.0,565,02,01,  Mustafapur,354,1133,177,546,177,587,23.8,24.5,23.2,00000
19.0,81.0,90.0,565,03,01,  Bahadurpur,63,279,32,126,31,153,18.4,20.3,16.8,00000
19.0,81.0,91.0,045,01,01,  Baira,1363,1125,597,451,766,674,54.8,57.0,53.2,00000
19.0,81.0,91.0,045,02,01,  Alinagar,102,183,49,86,53,97,35.8,36.3,35.3,00000
19.0,81.0,91.0,045,03,01,  Lalpur,106,80,52,34,54,46,57.0,60.5,54.0,00000
19.0,81.0,91.0,149,01,01,  Chainpur,675,1717,318,749,357,968,28.2,29.8,26.9,00000
19.0,81.0,91.0,149,02,01,  Sonarampur,205,376,105,184,100,192,35.3,36.3,34.2,00000
19.0,81.0,91.0,539,01,01,  Majur,338,143,156,56,182,87,70.3,73.6,67.7,00000
19.0,81.0,91.0,539,02,01,  Bara Pukuria,208,88,85,40,123,48,70.3,68.0,71.9,00000
19.0,81.0,91.0,592,01,01,  Purba Ghorasal,173,269,80,112,93,157,39.1,41.7,37.2,00000
19.0,81.0,91.0,592,02,01,  Jamalpur,118,214,60,90,58,124,35.5,40.0,31.9,00000
19.0,81.0,91.0,649,01,01,  Tanki,1718,2537,769,1131,949,1406,40.4,40.5,40.3,00000
19.0,81.0,91.0,649,02,01,  Kamalpur,121,131,46,60,75,71,48.0,43.4,51.4,00000
19.0,81.0,94.0,123,01,01,  Bhutail,1070,964,484,440,586,524,52.6,52.4,52.8,00000
19.0,81.0,94.0,123,02,01,  Manoharabad,63,95,25,43,38,52,39.9,36.8,42.2,00000
19.0,81.0,94.0,156,01,01,  Chandanail,1141,1492,525,657,616,835,43.3,44.4,42.5,00000
19.0,81.0,94.0,156,02,01,  Sahebnagar,610,458,272,194,338,264,57.1,58.4,56.1,00000
19.0,81.0,94.0,169,01,01,  Charibaria,331,500,149,231,182,269,39.8,39.2,40.4,00000
19.0,81.0,94.0,169,02,01,  Isapur,43,74,23,36,20,38,36.8,39.0,34.5,00000
19.0,81.0,94.0,773,01,01,  Piparia,475,445,207,190,268,255,51.6,52.1,51.2,00000
19.0,81.0,94.0,773,02,01,  Piparia Kanda,463,364,234,160,229,204,56.0,59.4,52.9,00000
19.0,81.0,94.0,825,01,01,  Roachala,1502,2670,654,1215,848,1455,36.0,35.0,36.8,00000
19.0,81.0,94.0,825,02,01,  Shahagodha,919,842,455,374,464,468,52.2,54.9,49.8,00000
19.0,81.0,94.0,825,03,01,  Shaldhore,104,171,47,71,57,100,37.8,39.8,36.3,00000
19.0,81.0,94.0,825,04,01,  Bariachara,210,850,91,364,119,486,19.8,20.0,19.7,00000
19.0,81.0,94.0,832,01,01,  Salpa,304,724,150,360,154,364,29.6,29.4,29.7,00000
19.0,81.0,94.0,832,02,01,  Alipur,110,249,53,137,57,112,30.6,27.9,33.7,00000
19.0,81.0,94.0,916,01,01,  Sreekail,1197,623,625,254,572,369,65.8,71.1,60.8,00000
19.0,81.0,94.0,916,02,01,  Sonakunda,1047,982,504,475,543,507,51.6,51.5,51.7,00000
19.0,81.0,94.0,916,03,01,  Rajnagar,149,197,61,82,88,115,43.1,42.7,43.3,00000
19.0,87.0,11.0,274,01,01,  Merkot,1347,1788,619,802,728,986,43.0,43.6,42.5,00000
19.0,87.0,11.0,274,02,01,  Ludua,589,264,269,118,320,146,69.1,69.5,68.7,00000
19.0,87.0,11.0,926,01,01,  S.Tuguria,623,762,295,374,328,388,45.0,44.1,45.8,00000
19.0,87.0,11.0,926,02,01,  B.Tuguria,449,382,176,182,273,200,54.0,49.2,57.7,00000
19.0,87.0,17.0,073,01,01,  Uttar Dakshin Bangodda,1589,1539,751,738,838,801,50.8,50.4,51.1,00000
19.0,87.0,17.0,073,02,01,  Nimuri,293,115,148,58,145,57,71.8,71.8,71.8,00000
19.0,87.0,17.0,073,03,01,  Angalkhor,236,455,101,219,135,236,34.2,31.6,36.4,00000
19.0,87.0,17.0,449,01,01,  Uttar Dakshin Kadba,548,312,247,138,301,174,63.7,64.2,63.4,00000
19.0,87.0,17.0,449,02,01,  Noapara,310,149,135,67,175,82,67.5,66.8,68.1,00000
19.0,87.0,17.0,449,03,01,  Kadba,588,432,279,202,309,230,57.6,58.0,57.3,00000
19.0,87.0,17.0,806,01,01,  Purba Nurpur,733,306,315,120,418,186,70.5,72.4,69.2,00000
19.0,87.0,17.0,806,02,01,  Sonaberi,196,339,79,161,117,178,36.6,32.9,39.7,00000
19.0,87.0,34.0,044,01,01,  Atgram,1226,984,565,429,661,555,55.5,56.8,54.4,00000
19.0,87.0,34.0,044,02,01,  Dariatgaon,341,312,154,160,187,152,52.2,49.0,55.2,00000
19.0,87.0,34.0,044,03,01,  Manikganj,170,160,67,68,103,92,51.5,49.6,52.8,00000
19.0,87.0,34.0,044,04,01,  Kakirpar,147,229,57,90,90,139,39.1,38.8,39.3,00000
19.0,87.0,34.0,101,01,01,  Barakali,515,460,221,201,294,259,52.8,52.4,53.2,00000
19.0,87.0,34.0,101,02,01,  Gondapur,227,75,91,27,136,48,75.2,77.1,73.9,00000
19.0,87.0,34.0,101,03,01,  Kadamtali,146,188,50,85,96,103,43.7,37.0,48.2,00000
19.0,87.0,34.0,103,01,01,  Boura,496,333,240,131,256,202,59.8,64.7,55.9,00000
19.0,87.0,34.0,103,02,01,  Bakshaganj,159,66,87,30,72,36,70.7,74.4,66.7,00000
19.0,87.0,34.0,103,03,01,  Chonua,163,187,80,75,83,112,46.6,51.6,42.6,00000
19.0,87.0,34.0,103,04,01,  Tetaia,314,269,159,126,155,143,53.9,55.8,52.0,00000
19.0,87.0,34.0,103,05,01,  Banabaria,165,213,76,160,89,53,43.7,32.2,62.7,00000
19.0,87.0,34.0,265,01,01,  Chandpur,459,547,195,219,264,328,45.6,47.1,44.6,00000
19.0,87.0,34.0,265,02,01,  Tegerpar,161,265,60,113,101,152,37.8,34.7,39.9,00000
19.0,87.0,34.0,269,01,01,  Dakshin Manaipur,876,654,363,265,513,389,57.3,57.8,56.9,00000
19.0,87.0,34.0,269,02,01,  Malongchar,376,352,178,168,198,184,51.6,51.4,51.8,00000
19.0,87.0,34.0,269,03,01,  Bash Denga,153,98,77,44,76,54,61.0,63.6,58.5,00000
19.0,87.0,43.0,216,01,01,  Char Jamurail,232,111,105,50,127,61,67.6,67.7,67.6,00000
19.0,87.0,43.0,216,02,01,  Labaitoba,64,39,30,18,34,21,62.1,62.5,61.8,00000
19.0,87.0,43.0,226,01,01,  Chawkari,988,765,387,348,601,417,56.4,52.7,59.0,00000
19.0,87.0,43.0,226,02,01,  Japanandi,222,138,98,62,124,76,61.7,61.3,62.0,00000
19.0,87.0,43.0,383,01,01,  Gormura,208,170,85,82,123,88,55.0,50.9,58.3,00000
19.0,87.0,43.0,383,02,01,  Bara Barulla,70,73,23,32,47,41,49.0,41.8,53.4,00000
19.0,87.0,43.0,672,01,01,  Mogra,437,705,195,340,242,365,38.3,36.4,39.9,00000
19.0,87.0,43.0,672,02,01,  Chhota Baralia,174,208,63,99,111,109,45.5,38.9,50.5,00000
19.0,87.0,43.0,881,01,01,  Sihar,418,483,187,204,231,279,46.4,47.8,45.3,00000
19.0,87.0,43.0,881,02,01,  Putijala,257,371,97,173,160,198,40.9,35.9,44.7,00000
19.0,87.0,43.0,881,03,01,  Mantali,204,132,111,77,93,55,60.7,59.0,62.8,00000
19.0,87.0,51.0,084,01,01,  Bam Batabaria,230,279,70,120,160,159,45.2,36.8,50.2,00000
19.0,87.0,51.0,084,02,01,  Hajir Bam,484,284,192,137,292,147,63.0,58.4,66.5,00000
19.0,87.0,51.0,084,03,01,  Kajir Bam,317,203,122,89,195,114,61.0,57.8,63.1,00000
19.0,87.0,51.0,084,04,01,  Antir Bam,34,25,10,9,24,16,57.6,52.6,60.0,00000
19.0,87.0,51.0,084,05,01,  Bagaia,46,38,15,13,31,25,54.8,53.6,55.4,00000
19.0,87.0,51.0,084,06,01,  Majumdar Para,267,283,104,134,163,149,48.5,43.7,52.2,00000
19.0,87.0,51.0,084,07,01,  Bhuiyen Para,261,75,115,18,146,57,77.7,86.5,71.9,00000
19.0,87.0,51.0,160,01,01,  Bholakot,508,589,222,283,286,306,46.3,44.0,48.3,00000
19.0,87.0,51.0,160,02,01,  Chanderpar,122,204,48,105,74,99,37.4,31.4,42.8,00000
19.0,87.0,51.0,291,01,01,  Daulkhar,1025,794,479,350,546,444,56.3,57.8,55.2,00000
19.0,87.0,51.0,291,02,01,  Biharkandi,106,265,47,126,59,139,28.6,27.2,29.8,00000
19.0,87.0,51.0,291,03,01,  Aytpara,454,583,224,266,230,317,43.8,45.7,42.0,00000
19.0,87.0,51.0,291,04,01,  Khil Para,372,346,167,145,205,201,51.8,53.5,50.5,00000
19.0,87.0,51.0,291,05,01,  Sonachaka,257,210,118,92,139,118,55.0,56.2,54.1,00000
19.0,87.0,51.0,291,06,01,  Kekaiya,414,195,211,91,203,104,68.0,69.9,66.1,00000
19.0,87.0,51.0,291,07,01,  Daulkhar Naracho,203,128,103,60,100,68,61.3,63.2,59.5,00000
19.0,87.0,51.0,291,08,01,  Maidarkua Naracho,154,86,71,39,83,47,64.2,64.5,63.8,00000
19.0,87.0,51.0,297,01,01,  Holakua,87,70,39,29,48,41,55.4,57.4,53.9,00000
19.0,87.0,51.0,297,02,01,  Deobhandar,694,778,292,340,402,438,47.1,46.2,47.9,00000
19.0,87.0,51.0,297,03,01,  Beatola,167,203,64,87,103,116,45.1,42.4,47.0,00000
19.0,87.0,51.0,465,01,01,  Jiniara,385,550,156,249,229,301,41.2,38.5,43.2,00000
19.0,87.0,51.0,465,02,01,  Bashuthai,414,361,154,147,260,214,53.4,51.2,54.9,00000
19.0,87.0,51.0,465,03,01,  Maharpar,121,340,44,171,77,169,26.2,20.5,31.3,00000
19.0,87.0,51.0,465,04,01,  Jiniara Naracho,340,282,144,119,196,163,54.7,54.8,54.6,00000
19.0,87.0,51.0,523,01,01,  Dakshin Kandal,608,287,239,126,369,161,67.9,65.5,69.6,00000
19.0,87.0,51.0,523,02,01,  Uttar Kandal,1220,1458,509,763,711,695,45.6,40.0,50.6,00000
19.0,87.0,51.0,541,01,01,  Paschim Kashipur,1429,1265,594,582,835,683,53.0,50.5,55.0,00000
19.0,87.0,51.0,541,02,01,  Purba Kashipur,768,831,299,408,469,423,48.0,42.3,52.6,00000
19.0,87.0,51.0,629,01,01,  Machhimpur,333,376,105,191,228,185,47.0,35.5,55.2,00000
19.0,87.0,51.0,629,02,01,  Ullakhali,193,150,73,61,120,89,56.3,54.5,57.4,00000
19.0,87.0,51.0,733,01,01,  Paikot,464,665,185,301,279,364,41.1,38.1,43.4,00000
19.0,87.0,51.0,733,02,01,  Chugara,85,164,27,79,58,85,34.1,25.5,40.6,00000
19.0,87.0,51.0,733,03,01,  Paikot Satabaria,47,141,12,66,35,75,25.0,15.4,31.8,00000
19.0,87.0,51.0,733,04,01,  Chilania,100,158,34,77,66,81,38.8,30.6,44.9,00000
19.0,87.0,60.0,365,01,01,  Goharua,927,694,378,298,549,396,57.2,55.9,58.1,00000
19.0,87.0,60.0,365,02,01,  Manik Mura,284,200,136,93,148,107,58.7,59.4,58.0,00000
19.0,87.0,60.0,387,01,01,  Hangara,507,445,217,197,290,248,53.3,52.4,53.9,00000
19.0,87.0,60.0,387,02,01,  Padua,216,105,87,39,129,66,67.3,69.0,66.2,00000
19.0,87.0,60.0,484,01,01,  Karpati,679,497,292,236,387,261,57.7,55.3,59.7,00000
19.0,87.0,60.0,484,02,01,  Duaria,302,378,121,166,181,212,44.4,42.2,46.1,00000
19.0,87.0,60.0,593,01,01,  Mandra,733,708,277,324,456,384,50.9,46.1,54.3,00000
19.0,87.0,60.0,593,02,01,  Ashirpar,401,319,151,153,250,166,55.7,49.7,60.1,00000
19.0,87.0,60.0,690,01,01,  Paschim Noapara,847,761,352,345,495,416,52.7,50.5,54.3,00000
19.0,87.0,60.0,690,02,01,  Ialia,209,191,84,85,125,106,52.3,49.7,54.1,00000
19.0,87.0,80.0,792,01,01,  Daulatpur,611,382,276,167,335,215,61.5,62.3,60.9,00000
19.0,87.0,80.0,792,02,01,  Motuia,318,129,141,58,177,71,71.1,70.9,71.4,00000
19.0,87.0,80.0,894,01,01,  Sreephalia,518,369,227,179,291,190,58.4,55.9,60.5,00000
19.0,87.0,80.0,894,02,01,  Kuia,265,66,116,27,149,39,80.1,81.1,79.3,00000
19.0,87.0,80.0,989,01,01,  Saktali,1024,1023,505,468,519,555,50.0,51.9,48.3,00000
19.0,87.0,80.0,989,02,01,  Mogua,284,544,134,246,150,298,34.3,35.3,33.5,00000
19.0,87.0,80.0,989,03,01,  Bara Fulgaon,118,345,56,158,62,187,25.5,26.2,24.9,00000
19.0,87.0,80.0,989,04,01,  Chand Puduia,133,187,67,87,66,100,41.6,43.5,39.8,00000
19.0,87.0,80.0,989,05,01,  Chatiari,301,170,155,79,146,91,63.9,66.2,61.6,00000
19.0,87.0,80.0,989,06,01,  Rudra Choma,444,46,227,20,217,26,90.6,91.9,89.3,00000
19.0,87.0,80.0,989,07,01,  Assdia,285,315,130,154,155,161,47.5,45.8,49.1,00000
19.0,87.0,86.0,193,01,01,  Chanderbagh,129,135,56,69,73,66,48.9,44.8,52.5,00000
19.0,87.0,86.0,193,02,01,  Pipadya,625,369,273,166,352,203,62.9,62.2,63.4,00000
19.0,87.0,86.0,193,03,01,  Bekamalia,361,229,160,109,201,120,61.2,59.5,62.6,00000
19.0,87.0,86.0,461,01,01,  Basanda,782,1003,281,461,501,542,43.8,37.9,48.0,00000
19.0,87.0,86.0,461,02,01,  Bara Mantali,630,517,269,242,361,275,54.9,52.6,56.8,00000
19.0,87.0,86.0,461,03,01,  Chhota Mantali,153,92,71,42,82,50,62.4,62.8,62.1,00000
19.0,87.0,86.0,611,01,01,  Lakshmi Padua,420,530,148,249,272,281,44.2,37.3,49.2,00000
19.0,87.0,86.0,611,02,01,  Dargah,275,89,114,35,161,54,75.5,76.5,74.9,00000
19.0,87.0,86.0,611,03,01,  Chupuya,311,293,135,134,176,159,51.5,50.2,52.5,00000
19.0,87.0,86.0,637,01,01,  Uttar Mahini,740,1219,326,662,414,557,37.8,33.0,42.6,00000
19.0,87.0,86.0,637,02,01,  Dakshin Mahini,599,944,243,450,356,494,38.8,35.1,41.9,00000
19.0,87.0,86.0,637,03,01,  Khilla Para,211,83,98,35,113,48,71.8,73.7,70.2,00000
19.0,87.0,86.0,637,04,01,  Kukurikhil,521,590,211,266,310,324,46.9,44.2,48.9,00000
19.0,87.0,86.0,637,05,01,  Chagari Para,407,296,168,132,239,164,57.9,56.0,59.3,00000
19.0,87.0,94.0,271,01,01,  Uttar Satbaria,1230,805,520,365,710,440,60.4,58.8,61.7,00000
19.0,87.0,94.0,271,02,01,  Dakshin Satbaria,1024,629,470,272,554,357,61.9,63.3,60.8,00000
19.0,87.0,94.0,271,03,01,  Purba Satbaria,647,694,278,323,369,371,48.2,46.3,49.9,00000
19.0,87.0,94.0,271,04,01,  Naiyara,378,278,171,141,207,137,57.6,54.8,60.2,00000
19.0,87.0,94.0,271,05,01,  Sajanpur,164,129,69,48,95,81,56.0,59.0,54.0,00000
19.0,94.0,10.0,273,01,01,  Dakshin Akalia,479,499,229,217,250,282,49.0,51.3,47.0,00000
19.0,94.0,10.0,273,02,01,  Madhay Akalia,315,454,143,224,172,230,41.0,39.0,42.8,00000
19.0,94.0,10.0,513,01,01,  Kalai Gobindapur,1278,1529,640,765,638,764,45.5,45.6,45.5,00000
19.0,94.0,10.0,513,02,01,  Ulukandi,833,824,378,372,455,452,50.3,50.4,50.2,00000
19.0,94.0,10.0,513,03,01,  Panchgachha,527,163,271,75,256,88,76.4,78.3,74.4,00000
19.0,94.0,10.0,783,01,01,  Uttar Balarampur,503,914,237,390,266,524,35.5,37.8,33.7,00000
19.0,94.0,10.0,783,02,01,  Dakshin Balarampur,1020,1390,468,630,552,760,42.3,42.6,42.1,00000
19.0,94.0,10.0,885,01,01,  Uttar Sreenarayankandi,277,587,142,268,135,319,32.1,34.6,29.7,00000
19.0,94.0,10.0,885,02,01,  Dakshin Sreenarayankandi,353,199,189,74,164,125,63.9,71.9,56.7,00000
19.0,94.0,10.0,954,01,01,  Uttar Durgapur,163,281,82,140,81,141,36.7,36.9,36.5,00000
19.0,94.0,10.0,954,02,01,  Dakshin Durgapur,285,279,153,127,132,152,50.5,54.6,46.5,00000
19.0,94.0,17.0,495,01,01,  Harairkandi,444,484,201,197,243,287,47.8,50.5,45.8,00000
19.0,94.0,17.0,495,02,01,  Porakandi,448,689,212,305,236,384,39.4,41.0,38.1,00000
19.0,94.0,17.0,495,03,01,  Bhitikandi,100,208,39,78,61,130,32.5,33.3,31.9,00000
19.0,94.0,17.0,495,04,01,  Ghoskandi,124,512,54,239,70,273,19.5,18.4,20.4,00000
19.0,94.0,17.0,495,05,01,  Alinagar,445,379,201,162,244,217,54.0,55.4,52.9,00000
19.0,94.0,17.0,495,06,01,  Ratanpur,482,440,210,199,272,241,52.3,51.3,53.0,00000
19.0,94.0,17.0,495,07,01,  Haripur,357,296,152,122,205,174,54.7,55.5,54.1,00000
19.0,94.0,17.0,495,08,01,  Uttar Daskandi,157,210,71,96,86,114,42.8,42.5,43.0,00000
19.0,94.0,17.0,495,09,01,  Darikandi,528,469,228,202,300,267,53.0,53.0,52.9,00000
19.0,94.0,17.0,495,10,01,  Kalipur,282,529,105,232,177,297,34.8,31.2,37.3,00000
19.0,94.0,17.0,495,11,01,  Shambhupur,64,341,31,162,33,179,15.8,16.1,15.6,00000
19.0,94.0,17.0,495,12,01,  Durgapur,56,229,20,95,36,134,19.6,17.4,21.2,00000
19.0,94.0,17.0,495,13,01,  Manik Kandi,962,864,433,396,529,468,52.7,52.2,53.1,00000
19.0,94.0,17.0,495,14,01,  Dularampur,756,896,360,391,396,505,45.8,47.9,44.0,00000
19.0,94.0,17.0,495,15,01,  Haidankandi,305,436,156,187,149,249,41.2,45.5,37.4,00000
19.0,94.0,17.0,495,16,01,  Jagatpur,279,210,116,84,163,126,57.1,58.0,56.4,00000
19.0,94.0,17.0,495,17,01,  Dhaksin Dash Kandi,147,297,69,122,78,175,33.1,36.1,30.8,00000
19.0,94.0,17.0,612,01,01,  Kadamtali,958,1554,429,648,529,906,38.1,39.8,36.9,00000
19.0,94.0,17.0,612,02,01,  Narayanpur,305,932,153,412,152,520,24.7,27.1,22.6,00000
19.0,94.0,17.0,805,01,01,  Raghunathpur Satani,324,714,175,368,149,346,31.2,32.2,30.1,00000
19.0,94.0,17.0,805,02,01,  Kashipur,342,666,141,301,201,365,33.9,31.9,35.5,00000
19.0,94.0,35.0,094,01,01,  Batakandi,679,281,352,129,327,152,70.7,73.2,68.3,00000
19.0,94.0,35.0,094,02,01,  Amirabad,196,305,95,136,101,169,39.1,41.1,37.4,00000
19.0,94.0,35.0,473,01,01,  Jatrabari,82,442,45,222,37,220,15.6,16.9,14.4,00000
19.0,94.0,35.0,473,02,01,  Bhati Para,492,934,248,455,244,479,34.5,35.3,33.7,00000
19.0,94.0,35.0,473,03,01,  Tulakandi,212,204,99,85,113,119,51.0,53.8,48.7,00000
19.0,94.0,35.0,473,04,01,  Dasani Para (1),365,569,174,240,191,329,39.1,42.0,36.7,00000
19.0,94.0,35.0,473,05,01,  Gobindapur,319,617,143,289,176,328,34.1,33.1,34.9,00000
19.0,94.0,35.0,473,06,01,  Jagatpur,330,343,161,160,169,183,49.0,50.2,48.0,00000
19.0,94.0,35.0,473,07,01,  Dasani Para (2),533,545,256,229,277,316,49.4,52.8,46.7,00000
19.0,94.0,35.0,473,08,01,  Chandpur,165,600,90,284,75,316,21.6,24.1,19.2,00000
19.0,94.0,35.0,473,09,01,  Masimpur,732,586,409,277,323,309,55.5,59.6,51.1,00000
19.0,94.0,35.0,473,10,01,  Sagarfana,509,902,249,395,260,507,36.1,38.7,33.9,00000
19.0,94.0,35.0,473,11,01,  Sagarfana Tulakandi,96,274,37,126,59,148,25.9,22.7,28.5,00000
19.0,94.0,35.0,473,12,01,  Omarpur,434,388,248,189,186,199,52.8,56.8,48.3,00000
19.0,94.0,35.0,473,13,01,  Keshabpur,781,836,349,377,432,459,48.3,48.1,48.5,00000
19.0,94.0,35.0,473,14,01,  Daburbhanga,145,198,75,77,70,121,42.3,49.3,36.6,00000
19.0,94.0,35.0,473,15,01,  Taguria Para,430,303,202,144,228,159,58.7,58.4,58.9,00000
19.0,94.0,35.0,473,16,01,  Kanainagar,687,648,337,289,350,359,51.5,53.8,49.4,00000
19.0,94.0,35.0,473,17,01,  Roypur,152,366,72,183,80,183,29.3,28.2,30.4,00000
19.0,94.0,35.0,473,18,01,  Kairpur,29,52,13,31,16,21,35.8,29.5,43.2,00000
19.0,94.0,45.0,440,01,01,  Gopalpur,1573,1681,772,728,801,953,48.3,51.5,45.7,00000
19.0,94.0,45.0,440,02,01,  Jiar Kandi Pachim,968,509,507,230,461,279,65.5,68.8,62.3,00000
19.0,94.0,45.0,440,03,01,  Jiar Kandi Purba,1090,927,527,415,563,512,54.0,55.9,52.4,00000
19.0,94.0,45.0,440,04,01,  Dari Kandi,1251,1290,591,588,660,702,49.2,50.1,48.5,00000
19.0,94.0,45.0,440,05,01,  Sola Kandi,1309,1208,608,549,701,659,52.0,52.5,51.5,00000
19.0,94.0,45.0,440,06,01,  Noagaon,636,683,347,335,289,348,48.2,50.9,45.4,00000
19.0,94.0,62.0,495,01,01,  Kala Kandi,483,808,238,357,245,451,37.4,40.0,35.2,00000
19.0,94.0,62.0,495,02,01,  Afjaler Kandi,149,367,84,156,65,211,28.9,35.0,23.6,00000
19.0,94.0,62.0,495,03,01,  Uttar Manik Nagar,148,243,73,99,75,144,37.9,42.4,34.2,00000
19.0,94.0,62.0,495,04,01,  Dakhin Manik Nagar,164,337,75,151,89,186,32.7,33.2,32.4,00000
19.0,94.0,62.0,495,05,01,  Khane Bari,115,57,50,23,65,34,66.9,68.5,65.7,00000
19.0,94.0,62.0,495,06,01,  Kala Chand Kandi,537,555,298,248,239,307,49.2,54.6,43.8,00000
19.0,94.0,62.0,612,01,01,  Machhimpur,1177,2033,561,956,616,1077,36.7,37.0,36.4,00000
19.0,94.0,62.0,612,02,01,  Dari Machhimpur,581,1162,264,548,317,614,33.3,32.5,34.0,00000
19.0,94.0,67.0,692,01,01,  Nalchar Isabpur,164,121,83,53,81,68,57.5,61.0,54.4,00000
19.0,94.0,67.0,692,02,01,  Isabpur,502,546,238,258,264,288,47.9,48.0,47.8,00000
19.0,94.0,67.0,812,01,01,  Rajapur,712,597,307,257,405,340,54.4,54.4,54.4,00000
19.0,94.0,67.0,812,02,01,  Char Rajapur,352,278,168,124,184,154,55.9,57.5,54.4,00000
19.0,94.0,67.0,929,01,01,  Titaia Rampur,140,129,74,50,66,79,52.0,59.7,45.5,00000
19.0,94.0,67.0,929,02,01,  Akla Rampur,485,777,234,356,251,421,38.4,39.7,37.4,00000
19.0,94.0,69.0,652,01,01,  Matapi,903,1751,382,818,521,933,34.0,31.8,35.8,00000
19.0,94.0,69.0,652,02,01,  Shibpur,594,612,276,284,318,328,49.3,49.3,49.2,00000
19.0,94.0,77.0,976,01,01,  Khalilabad,782,1517,393,702,389,815,34.0,35.9,32.3,00000
19.0,94.0,77.0,976,02,01,  Dakhin Narayandia(Pubapar),585,1099,275,489,310,610,34.7,36.0,33.7,00000
19.0,94.0,77.0,976,03,01,  Dakhin Narayandia(Pachimpar),745,827,348,374,397,453,47.4,48.2,46.7,00000
19.0,94.0,77.0,976,04,01,  Nayachar,45,464,27,220,18,244,8.8,10.9,6.9,00000
19.0,94.0,77.0,976,05,01,  Asmania,214,339,107,153,107,186,38.7,41.2,36.5,00000
19.0,94.0,77.0,976,06,01,  Baluakandi,494,771,228,368,266,403,39.1,38.3,39.8,00000
19.0,94.0,77.0,976,07,01,  Tulakandi,630,692,306,314,324,378,47.7,49.4,46.2,00000
19.0,94.0,77.0,976,08,01,  Tariakandi,172,557,71,245,101,312,23.6,22.5,24.5,00000
19.0,94.0,77.0,976,09,01,  Sonakandi,276,726,123,314,153,412,27.5,28.1,27.1,00000
19.0,94.0,77.0,976,10,01,  Nayakandi,458,689,208,319,250,370,39.9,39.5,40.3,00000
19.0,94.0,77.0,976,11,01,  Dukhaikandi,190,728,76,309,114,419,20.7,19.7,21.4,00000
19.0,94.0,85.0,222,01,01,  Char Kumaria,477,419,212,168,265,251,53.2,55.8,51.4,00000
19.0,94.0,85.0,222,02,01,  Barkaunia,347,438,141,190,206,248,44.2,42.6,45.4,00000
19.0,94.0,85.0,397,01,01,  Durlabhdi,135,304,69,153,66,151,30.8,31.1,30.4,00000
19.0,94.0,85.0,397,02,01,  Roypur,152,190,80,82,72,108,44.4,49.4,40.0,00000
19.0,94.0,85.0,736,01,01,  Nayakandi,280,399,132,159,148,240,41.2,45.4,38.1,00000
19.0,94.0,85.0,736,02,01,  Tatuakandi,139,167,78,78,61,89,45.4,50.0,40.7,00000
19.0,94.0,85.0,845,01,01,  Saraswatir Char (I),173,238,72,92,101,146,42.1,43.9,40.9,00000
19.0,94.0,85.0,845,02,01,  Saraaswatir Char(2),267,454,132,210,135,244,37.0,38.6,35.6,00000
19.0,94.0,85.0,951,01,01,  Uttar Akalia,437,593,198,283,239,310,42.4,41.2,43.5,00000
19.0,94.0,85.0,951,02,01,  Rambhadra,275,430,139,206,136,224,39.0,40.3,37.8,00000
19.0,94.0,85.0,969,01,01,  Uttar Krishnapur,239,327,109,149,130,178,42.2,42.2,42.2,00000
19.0,94.0,85.0,969,02,01,  Faridpur,311,398,151,155,160,243,43.9,49.3,39.7,00000
19.0,94.0,85.0,969,03,01,  Alampur,78,119,38,55,40,64,39.6,40.9,38.5,00000
19.0,94.0,85.0,969,04,01,  Mangalkandi,366,505,179,214,187,291,42.0,45.5,39.1,00000
19.0,94.0,85.0,969,05,01,  Raypur,77,103,32,40,45,63,42.8,44.4,41.7,00000
19.0,94.0,85.0,984,01,01,  Satani (1),333,163,160,73,173,90,67.1,68.7,65.8,00000
19.0,94.0,85.0,984,02,01,  Satani(2),345,571,160,252,185,319,37.7,38.8,36.7,00000
12.0,2.0,19.0,068,01,01,  Anandapur,141,212,65,99,76,113,39.9,39.6,40.2,00000
12.0,2.0,19.0,068,02,01,  Hapania,75,132,38,65,37,67,36.2,36.9,35.6,00000
12.0,2.0,19.0,804,01,01,  Nurpur,625,619,324,277,301,342,50.2,53.9,46.8,00000
12.0,2.0,19.0,804,02,01,  Nurpur Lamarbari,232,250,100,113,132,137,48.1,46.9,49.1,00000
12.0,2.0,57.0,387,01,01,  Golkhar,1783,1492,834,717,949,775,54.4,53.8,55.0,00000
12.0,2.0,57.0,387,02,01,  Madhupur,49,157,25,79,24,78,23.8,24.0,23.5,00000
12.0,2.0,57.0,877,01,01,  Ruti,898,1579,380,758,518,821,36.3,33.4,38.7,00000
12.0,2.0,57.0,877,02,01,  Nurpur,912,924,374,412,538,512,49.7,47.6,51.2,00000
12.0,2.0,57.0,991,01,01,  Tulatali,308,241,134,103,174,138,56.1,56.5,55.8,00000
12.0,2.0,57.0,991,02,01,  Idilpur,184,269,79,140,105,129,40.6,36.1,44.9,00000
12.0,2.0,76.0,422,01,01,  Uttar Dharmanagar,151,211,57,109,94,102,41.7,34.3,48.0,00000
12.0,2.0,76.0,422,02,01,  Sikarmura,196,306,77,148,119,158,39.0,34.2,43.0,00000
12.0,2.0,76.0,422,03,01,  Bara Tanki,563,193,280,89,283,104,74.5,75.9,73.1,00000
12.0,2.0,76.0,422,04,01,  Chhota Tanki,132,68,63,30,69,38,66.0,67.7,64.5,00000
12.0,2.0,76.0,422,05,01,  Bagaimura,19,40,8,23,11,17,32.2,25.8,39.3,00000
12.0,2.0,76.0,422,06,01,  Atka Para,13,43,5,25,8,18,23.2,16.7,30.8,00000
12.0,2.0,76.0,477,01,01,  Fatehpur,708,389,337,169,371,220,64.5,66.6,62.8,00000
12.0,2.0,76.0,477,02,01,  Bekinagar,113,38,54,14,59,24,74.8,79.4,71.1,00000
12.0,2.0,76.0,722,01,01,  Majhigachha,210,219,103,101,107,118,49.0,50.5,47.6,00000
12.0,2.0,76.0,722,02,01,  Katamura,19,27,12,13,7,14,41.3,48.0,33.3,00000
12.0,2.0,76.0,736,01,01,  Maniand,1743,2199,884,1016,859,1183,44.2,46.5,42.1,00000
12.0,2.0,76.0,736,02,01,  Girishnagar,151,221,55,118,96,103,40.6,31.8,48.2,00000
12.0,2.0,76.0,736,03,01,  Tan Mandail,571,567,248,262,323,305,50.2,48.6,51.4,00000
12.0,2.0,76.0,910,01,01,  Shibnagar,210,481,112,224,98,257,30.4,33.3,27.6,00000
12.0,2.0,76.0,910,02,01,  Baher Belabar,24,59,17,27,7,32,28.9,38.6,17.9,00000
12.0,2.0,85.0,245,01,01,  Senarabadi,211,149,99,75,112,74,58.6,56.9,60.2,00000
12.0,2.0,85.0,245,02,01,  Ramnagar,70,25,38,14,32,11,73.7,73.1,74.4,00000
12.0,2.0,85.0,245,03,01,  Senarabadi Checkpost,32,0,29,0,3,0,100.0,100.0,100.0,00000
12.0,2.0,85.0,313,01,01,  Char Narayanpur,239,261,106,132,133,129,47.8,44.5,50.8,00000
12.0,2.0,85.0,313,02,01,  Durjoynagar,250,310,120,159,130,151,44.6,43.0,46.3,00000
12.0,2.0,85.0,372,01,01,  Ganganagar,324,212,174,91,150,121,60.4,65.7,55.4,00000
12.0,2.0,85.0,372,02,01,  Gangasagar Dighirpar,238,180,123,92,115,88,56.9,57.2,56.7,00000
12.0,2.0,85.0,372,03,01,  Jangal,238,550,97,290,141,260,30.2,25.1,35.2,00000
12.0,2.0,85.0,749,01,01,  Mogra,1203,1132,583,546,620,586,51.5,51.6,51.4,00000
12.0,2.0,85.0,749,02,01,  Ganga Bhanga,174,347,83,164,91,183,33.4,33.6,33.2,00000
12.0,2.0,85.0,790,01,01,  Nowapara,140,112,71,58,69,54,55.6,55.0,56.1,00000
12.0,2.0,85.0,790,02,01,  Tanua Para,118,144,49,58,69,86,45.0,45.8,44.5,00000
12.0,2.0,85.0,926,01,01,  Kusumbari,83,208,31,101,52,107,28.5,23.5,32.7,00000
12.0,2.0,85.0,926,02,01,  Tulabari,106,237,39,113,67,124,30.9,25.7,35.1,00000
12.0,2.0,90.0,081,01,01,  Anwarpur,414,171,205,73,209,98,70.8,73.7,68.1,00000
12.0,2.0,90.0,081,02,01,  Kalyanpur,424,99,211,40,213,59,81.1,84.1,78.3,00000
12.0,2.0,90.0,081,03,01,  Chandpur,692,425,307,194,385,231,62.0,61.3,62.5,00000
12.0,2.0,90.0,081,04,01,  Azampur,688,807,308,396,380,411,46.0,43.8,48.0,00000
12.0,4.0,14.0,153,01,01,  Banshgari,1333,2270,641,987,692,1283,37.0,39.4,35.0,00000
12.0,4.0,14.0,153,02,01,  Padmapur,367,758,175,334,192,424,32.6,34.4,31.2,00000
12.0,4.0,14.0,433,01,01,  Dasania,285,807,150,403,135,404,26.1,27.1,25.0,00000
12.0,4.0,14.0,433,02,01,  Ayubpur,1024,2190,488,928,536,1262,31.9,34.5,29.8,00000
12.0,4.0,14.0,637,01,01,  Kanainagar,722,1199,386,529,336,670,37.6,42.2,33.4,00000
12.0,4.0,14.0,637,02,01,  Nagarir Char,603,997,292,424,311,573,37.7,40.8,35.2,00000
12.0,4.0,14.0,637,03,01,  Karikandi,187,628,87,290,100,338,22.9,23.1,22.8,00000
12.0,4.0,14.0,637,04,01,  Khasnagar,156,873,76,379,80,494,15.2,16.7,13.9,00000
12.0,4.0,23.0,395,01,01,  Natun Kadamtali,377,393,187,159,190,234,49.0,54.0,44.8,00000
12.0,4.0,23.0,395,02,01,  Shutkikandi,180,358,93,166,87,192,33.5,35.9,31.2,00000
12.0,4.0,23.0,395,03,01,  Kadamtali (Old),1506,2476,755,1077,751,1399,37.8,41.2,34.9,00000
12.0,4.0,23.0,395,04,01,  Daria Daulat,2255,3865,1041,1724,1214,2141,36.8,37.6,36.2,00000
12.0,4.0,23.0,395,05,01,  Tatuakandi,175,432,86,203,89,229,28.8,29.8,28.0,00000
12.0,4.0,30.0,816,01,01,  Pahariakandi,1192,2987,554,1287,638,1700,28.5,30.1,27.3,00000
12.0,4.0,30.0,816,02,01,  Barakandi,96,317,42,144,54,173,23.2,22.6,23.8,00000
12.0,4.0,30.0,816,03,01,  Munshinagar,172,240,78,108,94,132,41.7,41.9,41.6,00000
12.0,4.0,30.0,994,01,01,  Kalakandi,172,741,73,326,99,415,18.8,18.3,19.3,00000
12.0,4.0,30.0,994,02,01,  Hizlakandi,450,747,194,312,256,435,37.6,38.3,37.0,00000
12.0,4.0,36.0,471,01,01,  Fatehpur,569,950,250,403,319,547,37.5,38.3,36.8,00000
12.0,4.0,36.0,471,02,01,  Sharifpur,332,541,154,231,178,310,38.0,40.0,36.5,00000
12.0,4.0,36.0,727,01,01,  Domrakandi,809,897,374,384,435,513,47.4,49.3,45.9,00000
12.0,4.0,36.0,727,02,01,  Madhyanagar,1029,1030,496,442,533,588,50.0,52.9,47.5,00000
12.0,4.0,45.0,880,01,01,  Rupasdi Dakshinpara,2657,3085,1207,1300,1450,1785,46.3,48.1,44.8,00000
12.0,4.0,45.0,880,02,01,  Khaorpur,210,313,97,134,113,179,40.2,42.0,38.7,00000
12.0,4.0,54.0,242,01,01,  Char Manikpur,891,2106,504,957,387,1149,29.7,34.5,25.2,00000
12.0,4.0,54.0,242,02,01,  Ulkandi,333,935,166,402,167,533,26.3,29.2,23.9,00000
12.0,4.0,54.0,242,03,01,  Mayarampur,447,1934,229,890,218,1044,18.8,20.5,17.3,00000
12.0,4.0,59.0,408,01,01,  Darikandi,585,1021,274,448,311,573,36.4,38.0,35.2,00000
12.0,4.0,59.0,408,02,01,  Imamnagar,813,578,367,240,446,338,58.4,60.5,56.9,00000
12.0,4.0,59.0,408,03,01,  Gokulnagar,583,551,276,248,307,303,51.4,52.7,50.3,00000
12.0,4.0,59.0,408,04,01,  Gopalnagar,281,163,135,65,146,98,63.3,67.5,59.8,00000
12.0,4.0,59.0,408,05,01,  Darigaon,438,451,183,204,255,247,49.3,47.3,50.8,00000
12.0,4.0,59.0,408,06,01,  Madhya Darikandi,1003,1064,436,463,567,601,48.5,48.5,48.5,00000
12.0,4.0,59.0,676,01,01,  Khalla,1205,1474,574,666,631,808,45.0,46.3,43.8,00000
12.0,4.0,59.0,676,02,01,  Krishnanagar,131,199,73,82,58,117,39.7,47.1,33.1,00000
12.0,4.0,68.0,841,01,01,  Purbahati,954,1255,449,600,505,655,43.2,42.8,43.5,00000
12.0,4.0,68.0,841,02,01,  Purbakandi,600,819,287,349,313,470,42.3,45.1,40.0,00000
12.0,4.0,68.0,841,03,01,  Char Lahania,710,1267,329,586,381,681,35.9,36.0,35.9,00000
12.0,4.0,68.0,841,04,01,  Kolakandi,421,660,196,306,225,354,38.9,39.0,38.9,00000
12.0,4.0,68.0,841,05,01,  Tilakkandi,39,354,20,207,19,147,9.9,8.8,11.4,00000
12.0,4.0,68.0,841,06,01,  Gaoraltali,356,379,162,189,194,190,48.4,46.2,50.5,00000
12.0,4.0,68.0,841,07,01,  Nijkandi Roypura,511,1057,225,495,286,562,32.6,31.3,33.7,00000
12.0,4.0,77.0,701,01,01,  Krishnanagar,425,790,197,331,228,459,35.0,37.3,33.2,00000
12.0,4.0,77.0,701,02,01,  Natunhati,90,273,48,113,42,160,24.8,29.8,20.8,00000
12.0,4.0,77.0,701,03,01,  Sekharkandi,482,828,225,366,257,462,36.8,38.1,35.7,00000
12.0,4.0,77.0,701,04,01,  Budairkandi,1305,2325,609,1068,696,1257,36.0,36.3,35.6,00000
12.0,4.0,77.0,701,05,01,  Sarishar Char,27,63,16,23,11,40,30.0,41.0,21.6,00000
12.0,4.0,81.0,178,01,01,  Bhurbhuria,1558,2610,726,1157,832,1453,37.4,38.6,36.4,00000
12.0,4.0,81.0,178,02,01,  Ganganagar,153,337,64,152,89,185,31.2,29.6,32.5,00000
12.0,4.0,81.0,809,01,01,  Salimabad,1240,2219,575,998,665,1221,35.8,36.6,35.3,00000
12.0,4.0,81.0,809,02,01,  Satbila,529,952,238,397,291,555,35.7,37.5,34.4,00000
12.0,4.0,81.0,809,03,01,  Kamalpur,390,387,201,141,189,246,50.2,58.8,43.4,00000
12.0,4.0,81.0,809,04,01,  Saheb Nagar,538,684,278,278,260,406,44.0,50.0,39.0,00000
12.0,4.0,83.0,255,01,01,  Shantipur,479,2580,267,1219,212,1361,15.7,18.0,13.5,00000
12.0,4.0,83.0,255,02,01,  Char Marichakandi,475,1309,223,619,252,690,26.6,26.5,26.8,00000
12.0,4.0,83.0,255,03,01,  Kanainagar,428,1713,214,785,214,928,20.0,21.4,18.7,00000
12.0,4.0,83.0,446,01,01,  Dularampur,780,1723,367,822,413,901,31.2,30.9,31.4,00000
12.0,4.0,83.0,446,02,01,  Ichhapur,198,917,110,434,88,483,17.8,20.2,15.4,00000
12.0,4.0,83.0,918,01,01,  Faraziakandi,240,465,121,209,119,256,34.0,36.7,31.7,00000
12.0,4.0,83.0,918,02,01,  Sonarampur,1517,2780,773,1282,744,1498,35.3,37.6,33.2,00000
12.0,4.0,83.0,918,03,01,  Natun Dularampur,54,288,31,138,23,150,15.8,18.3,13.3,00000
12.0,4.0,88.0,191,01,01,  Bishnurampur,1079,1426,491,581,588,845,43.1,45.8,41.0,00000
12.0,4.0,88.0,191,02,01,  Harinagar,48,374,32,174,16,200,11.4,15.5,7.4,00000
12.0,4.0,94.0,140,01,03,  Banchharampur,2193,2784,1119,1326,1074,1458,44.1,45.8,42.4,00000
12.0,4.0,94.0,140,02,03,  Dari Banchharampur,1199,1634,562,766,637,868,42.3,42.3,42.3,00000
12.0,4.0,94.0,140,03,03,  Safirkandi,279,378,126,156,153,222,42.5,44.7,40.8,00000
12.0,4.0,94.0,331,01,01,  Alipur,237,185,111,84,126,101,56.2,56.9,55.5,00000
12.0,4.0,94.0,331,02,01,  Manikhali,175,321,93,134,82,187,35.3,41.0,30.5,00000
12.0,4.0,94.0,331,03,01,  Panchampur,252,201,127,86,125,115,55.6,59.6,52.1,00000
12.0,4.0,94.0,331,04,01,  Khuskandi,836,1603,414,675,422,928,34.3,38.0,31.3,00000
12.0,4.0,94.0,331,05,01,  Dhariar Char,79,205,40,88,39,117,27.8,31.3,25.0,00000
12.0,4.0,94.0,331,06,01,  Bhabanathpur,417,441,189,173,228,268,48.6,52.2,46.0,00000
12.0,4.0,94.0,331,07,01,  Talikandi,27,64,11,27,16,37,29.7,28.9,30.2,00000
12.0,4.0,94.0,331,08,01,  Durgapur,276,389,136,155,140,234,41.5,46.7,37.4,00000
12.0,7.0,28.0,103,01,01,  Merasani,434,760,226,354,208,406,36.3,39.0,33.9,00000
12.0,7.0,28.0,103,02,01,  Taltala,144,133,72,56,72,77,52.0,56.3,48.3,00000
12.0,7.0,28.0,216,01,01,  Birpasha,710,1466,322,649,388,817,32.6,33.2,32.2,00000
12.0,7.0,28.0,216,02,01,  Fatehpur,143,478,65,236,78,242,23.0,21.6,24.4,00000
12.0,7.0,28.0,216,03,01,  Gachhtala,268,439,131,191,137,248,37.9,40.7,35.6,00000
12.0,7.0,32.0,244,01,01,  Chandura,1460,1952,756,902,704,1050,42.8,45.6,40.1,00000
12.0,7.0,32.0,244,02,01,  Atka Para,150,203,85,104,65,99,42.5,45.0,39.6,00000
12.0,7.0,32.0,244,03,01,  Jagatpur,107,113,64,40,43,73,48.6,61.5,37.1,00000
12.0,7.0,32.0,244,04,01,  Ibrahimpur,466,1447,214,721,252,726,24.4,22.9,25.8,00000
12.0,7.0,32.0,244,05,01,  Shyampur,68,153,40,105,28,48,30.8,27.6,36.8,00000
12.0,7.0,32.0,244,06,01,  Manikpur,156,359,81,227,75,132,30.3,26.3,36.2,00000
12.0,7.0,32.0,244,07,01,  Jalalpur,768,1503,331,725,437,778,33.8,31.3,36.0,00000
12.0,7.0,32.0,244,08,01,  Saputia,13,197,6,100,7,97,6.2,5.7,6.7,00000
12.0,7.0,32.0,308,01,01,  Chhota Kalisima,567,1158,284,542,283,616,32.9,34.4,31.5,00000
12.0,7.0,32.0,308,02,01,  Bhati Kalisima,164,445,83,246,81,199,26.9,25.2,28.9,00000
12.0,7.0,32.0,851,01,01,  Rampur,171,408,96,207,75,201,29.5,31.7,27.2,00000
12.0,7.0,32.0,851,02,01,  Mirpur,280,335,134,143,146,192,45.5,48.4,43.2,00000
12.0,7.0,36.0,078,01,01,  Balarampur,29,592,16,291,13,301,4.7,5.2,4.1,00000
12.0,7.0,36.0,078,02,01,  Najirbari,556,908,258,461,298,447,38.0,35.9,40.0,00000
12.0,7.0,36.0,206,01,01,  Solamura,40,135,15,70,25,65,22.9,17.6,27.8,00000
12.0,7.0,36.0,206,02,01,  Sadullabari,24,228,6,109,18,119,9.5,5.2,13.1,00000
12.0,7.0,36.0,206,03,01,  Baramura,5,14,2,10,3,4,26.3,16.7,42.9,00000
12.0,7.0,36.0,206,04,01,  Kalyanmuri,27,51,15,25,12,26,34.6,37.5,31.6,00000
12.0,7.0,36.0,206,05,01,  Morailmura,19,88,9,53,10,35,17.8,14.5,22.2,00000
12.0,7.0,36.0,206,06,01,  Roshnakandi,38,155,10,85,28,70,19.7,10.5,28.6,00000
12.0,7.0,36.0,206,07,01,  Ranginbari,85,330,32,166,53,164,20.5,16.2,24.4,00000
12.0,7.0,36.0,262,01,01,  Dakshin Rajabari,92,637,38,331,54,306,12.6,10.3,15.0,00000
12.0,7.0,36.0,262,02,01,  Dakshin Pelunpur,10,99,4,54,6,45,9.2,6.9,11.8,00000
12.0,7.0,36.0,360,01,01,  Jamalpur,19,121,11,58,8,63,13.6,15.9,11.3,00000
12.0,7.0,36.0,360,02,01,  Pukurpar,45,169,22,92,23,77,21.0,19.3,23.0,00000
12.0,7.0,36.0,360,03,01,  Bairaghihati,8,105,3,60,5,45,7.1,4.8,10.0,00000
12.0,7.0,36.0,360,04,01,  Gachuliahati,4,59,0,32,4,27,6.3,0.0,12.9,00000
12.0,7.0,36.0,634,01,01,  Alakpur,55,192,27,96,28,96,22.3,22.0,22.6,00000
12.0,7.0,36.0,634,02,01,  Amanpur,29,189,14,82,15,107,13.3,14.6,12.3,00000
12.0,7.0,36.0,634,03,01,  Rakhalmuri,17,113,7,57,10,56,13.1,10.9,15.2,00000
12.0,7.0,36.0,634,04,01,  Uttar Felunpur,4,34,1,17,3,17,10.5,5.6,15.0,00000
12.0,7.0,36.0,634,05,01,  Char Khola,41,149,18,62,23,87,21.6,22.5,20.9,00000
12.0,7.0,36.0,643,01,01,  Mamudpur,231,580,128,259,103,321,28.5,33.1,24.3,00000
12.0,7.0,36.0,643,02,01,  Gobindapur,136,443,82,201,54,242,23.5,29.0,18.2,00000
12.0,7.0,43.0,375,01,01,  Fatehpur,509,472,246,221,263,251,51.9,52.7,51.2,00000
12.0,7.0,43.0,375,02,01,  Rajapur,50,70,25,36,25,34,41.7,41.0,42.4,00000
12.0,7.0,43.0,393,01,01,  Garargaon,296,330,144,194,152,136,47.3,42.6,52.8,00000
12.0,7.0,43.0,393,02,01,  Tan Garargaon,191,252,92,126,99,126,43.1,42.2,44.0,00000
12.0,7.0,52.0,521,01,01,  Kashimnagar,1907,2221,918,1076,989,1145,46.2,46.0,46.3,00000
12.0,7.0,52.0,521,02,01,  Nalgaria,569,949,246,457,323,492,37.5,35.0,39.6,00000
12.0,7.0,52.0,927,01,01,  Madhya Para,256,185,123,86,133,99,58.0,58.9,57.3,00000
12.0,7.0,52.0,927,02,01,  Otaria Para,784,564,394,269,390,295,58.2,59.4,56.9,00000
12.0,7.0,52.0,927,03,01,  Singerbil,212,153,104,75,108,78,58.1,58.1,58.1,00000
12.0,7.0,52.0,927,04,01,  Singerbil Bazar,304,376,167,172,137,204,44.7,49.3,40.2,00000
12.0,7.0,52.0,927,05,01,  Shibnagar,202,280,121,149,81,131,41.9,44.8,38.2,00000
12.0,7.0,56.0,064,01,01,  Baghdia,517,1147,258,543,259,604,31.1,32.2,30.0,00000
12.0,7.0,56.0,064,02,01,  Kaicha Para,11,61,5,25,6,36,15.3,16.7,14.3,00000
12.0,7.0,56.0,088,01,01,  Bara Chal,254,308,121,134,133,174,45.2,47.5,43.3,00000
12.0,7.0,56.0,088,02,01,  Shishaura,66,55,31,25,35,30,54.5,55.4,53.8,00000
12.0,7.0,56.0,106,01,01,  Paik Para,1446,2104,685,951,761,1153,40.7,41.9,39.8,00000
12.0,7.0,56.0,106,02,01,  Bishnu Pur,25,119,10,50,15,69,17.4,16.7,17.9,00000
12.0,7.0,56.0,454,01,01,  Jalalpur,174,527,84,230,90,297,24.8,26.8,23.3,00000
12.0,7.0,56.0,454,02,01,  Nayahati,145,246,86,110,59,136,37.1,43.9,30.3,00000
12.0,7.0,66.0,183,01,01,  Bhiti Daudpur,1222,1077,577,534,645,543,53.2,51.9,54.3,00000
12.0,7.0,66.0,183,02,01,  Madhaberbagh,486,357,222,169,264,188,57.7,56.8,58.4,00000
12.0,7.0,66.0,384,01,01,  Ganeshpur,60,40,27,17,33,23,60.0,61.4,58.9,00000
12.0,7.0,66.0,384,02,01,  Bhatir Para,80,195,37,93,43,102,29.1,28.5,29.7,00000
12.0,7.0,66.0,457,01,01,  Jalilpur,97,88,53,42,44,46,52.4,55.8,48.9,00000
12.0,7.0,66.0,457,02,01,  Madhupur Char Para,65,83,39,44,26,39,43.9,47.0,40.0,00000
12.0,7.0,66.0,799,01,01,  Dariapur,1049,1317,484,592,565,725,44.3,45.0,43.8,00000
12.0,7.0,66.0,799,02,01,  Jhojantamura,54,139,20,66,34,73,28.0,23.3,31.8,00000
12.0,7.0,66.0,799,03,01,  Botagbari,201,247,94,119,107,128,44.9,44.1,45.5,00000
12.0,7.0,66.0,860,01,01,  Sahadebpur,623,195,327,87,296,108,76.2,79.0,73.3,00000
12.0,7.0,66.0,860,02,01,  Daulatpur,37,84,20,38,17,46,30.6,34.5,27.0,00000
12.0,7.0,72.0,115,01,01,  Jagannathpur,345,209,164,102,181,107,62.3,61.7,62.8,00000
12.0,7.0,72.0,115,02,01,  Noagaon,767,671,370,345,397,326,53.3,51.7,54.9,00000
12.0,7.0,72.0,115,03,01,  Sreepur,356,517,173,253,183,264,40.8,40.6,40.9,00000
12.0,7.0,72.0,500,01,01,  Kalyanpur,75,395,42,183,33,212,16.0,18.7,13.5,00000
12.0,7.0,72.0,500,02,01,  Atka Para,124,783,62,406,62,377,13.7,13.2,14.1,00000
12.0,7.0,72.0,717,01,01,  Sahapur,11,389,3,213,8,176,2.8,1.4,4.3,00000
12.0,7.0,72.0,717,02,01,  Parenga,29,270,15,135,14,135,9.7,10.0,9.4,00000
12.0,7.0,72.0,717,03,01,  Naharmura,27,345,12,182,15,163,7.3,6.2,8.4,00000
12.0,7.0,72.0,717,04,01,  Chowarakhola,5,270,2,136,3,134,1.8,1.4,2.2,00000
12.0,7.0,72.0,775,01,01,  Pattan,382,237,177,123,205,114,61.7,59.0,64.3,00000
12.0,7.0,72.0,775,02,01,  Tanmanipur,342,411,162,191,180,220,45.4,45.9,45.0,00000
12.0,7.0,72.0,775,03,01,  Tetuia,145,193,64,99,81,94,42.9,39.3,46.3,00000
12.0,7.0,72.0,775,04,01,  Bara Pukurpar,540,1219,270,628,270,591,30.7,30.1,31.4,00000
12.0,7.0,72.0,775,05,01,  Lakshmimura,563,1259,276,647,287,612,30.9,29.9,31.9,00000
12.0,7.0,91.0,491,01,01,  Kaitara,405,176,189,67,216,109,69.7,73.8,66.5,00000
12.0,7.0,91.0,491,02,01,  Fulbaria,175,98,75,48,100,50,64.1,61.0,66.7,00000
12.0,7.0,91.0,662,01,03,  Mirzapur,833,473,455,201,378,272,63.8,69.4,58.2,00000
12.0,7.0,91.0,662,02,03,  Payrabari,56,40,32,19,24,21,58.3,62.7,53.3,00000
12.0,7.0,91.0,662,03,03,  Kalyanpur,14,19,5,8,9,11,42.4,38.5,45.0,00000
12.0,7.0,91.0,976,01,01,  Tulatala,105,126,55,56,50,70,45.5,49.5,41.7,00000
12.0,7.0,96.0,317,01,01,  Dakshin Bishnupur,1629,1023,793,441,836,582,61.4,64.3,59.0,00000
12.0,7.0,96.0,317,02,01,  Aulabad,193,386,83,200,110,186,33.3,29.3,37.2,00000
12.0,7.0,96.0,317,03,01,  Dulalpur,315,277,151,143,164,134,53.2,51.4,55.0,00000
12.0,7.0,96.0,494,01,01,  Purba Kalachhara,512,719,243,347,269,372,41.6,41.2,42.0,00000
12.0,7.0,96.0,494,02,01,  Paschim Kalachhara,634,591,315,273,319,318,51.8,53.6,50.1,00000
12.0,13.0,48.0,433,01,01,  Bara Haran,1198,2197,521,1170,677,1027,35.3,30.8,39.7,00000
12.0,13.0,48.0,433,02,01,  Chhota Haran,798,989,358,507,440,482,44.7,41.4,47.7,00000
12.0,13.0,48.0,781,01,01,  Payag,794,940,385,457,409,483,45.8,45.7,45.9,00000
12.0,13.0,48.0,781,02,01,  Gachhtala,398,778,137,403,261,375,33.8,25.4,41.0,00000
12.0,13.0,50.0,405,01,03,  Uttar Ghatura,1861,1632,933,810,928,822,53.3,53.5,53.0,00000
12.0,13.0,50.0,405,02,03,  Dakshin Ghatura,2188,2073,1116,1029,1072,1044,51.3,52.0,50.7,00000
12.0,13.0,50.0,405,03,03,  Gopinathpur,248,340,103,177,145,163,42.2,36.8,47.1,00000
12.0,13.0,50.0,552,01,01,  Dakshin Kendubaria,335,276,149,137,186,139,54.8,52.1,57.2,00000
12.0,13.0,50.0,552,02,01,  Uttar Kendubaria,367,347,188,147,179,200,51.4,56.1,47.2,00000
12.0,13.0,50.0,909,01,01,  Haria,342,627,176,281,166,346,35.3,38.5,32.4,00000
12.0,13.0,50.0,909,02,01,  Kalamuri,281,766,126,385,155,381,26.8,24.7,28.9,00000
12.0,13.0,50.0,909,03,01,  Uttar Shuhilpur,1148,1815,579,864,569,951,38.7,40.1,37.4,00000
12.0,13.0,50.0,909,04,01,  Hindu Para,1829,1828,930,888,899,940,50.0,51.2,48.9,00000
12.0,13.0,50.0,909,05,01,  Parulia Para,267,357,137,162,130,195,42.8,45.8,40.0,00000
12.0,13.0,50.0,909,06,01,  Tale Para,369,812,167,393,202,419,31.2,29.8,32.5,00000
12.0,13.0,50.0,909,07,01,  Mahij Para,458,553,224,297,234,256,45.3,43.0,47.8,00000
12.0,13.0,50.0,909,08,01,  Pathan Para,332,369,155,184,177,185,47.4,45.7,48.9,00000
12.0,13.0,50.0,909,09,01,  Alampara,283,208,132,97,151,111,57.6,57.6,57.6,00000
12.0,13.0,50.0,909,10,01,  Naobari,479,264,241,117,238,147,64.5,67.3,61.8,00000
12.0,13.0,50.0,909,11,01,  Mirhati,459,651,226,338,233,313,41.4,40.1,42.7,00000
12.0,13.0,50.0,909,12,01,  Nada Para,120,271,47,154,73,117,30.7,23.4,38.4,00000
12.0,13.0,50.0,909,13,01,  Sutarmura,352,397,151,200,201,197,47.0,43.0,50.5,00000
12.0,13.0,50.0,909,14,01,  Khola Para,364,230,211,92,153,138,61.3,69.6,52.6,00000
12.0,13.0,50.0,909,15,01,  Talukdarbari,131,41,58,19,73,22,76.2,75.3,76.8,00000
12.0,13.0,61.0,012,01,01,  Bara Bakail,888,909,436,463,452,446,49.4,48.5,50.3,00000
12.0,13.0,61.0,012,02,01,  Anandapur,236,838,129,439,107,399,22.0,22.7,21.1,00000
12.0,13.0,61.0,012,03,01,  Shampur,217,279,100,134,117,145,43.8,42.7,44.7,00000
12.0,13.0,61.0,280,01,01,  Chhota Bakail,430,659,199,304,231,355,39.5,39.6,39.4,00000
12.0,13.0,61.0,280,02,01,  Makdampur,150,198,79,84,71,114,43.1,48.5,38.4,00000
12.0,13.0,61.0,280,03,01,  Chand Pur,236,248,129,112,107,136,48.8,53.5,44.0,00000
12.0,13.0,61.0,344,01,01,  Chandpur,64,237,43,106,21,131,21.3,28.9,13.8,00000
12.0,13.0,61.0,344,02,01,  Darma,982,2061,496,1028,486,1033,32.3,32.5,32.0,00000
12.0,13.0,61.0,628,01,01,  Fatehpur,84,537,41,215,43,322,13.5,16.0,11.8,00000
12.0,13.0,61.0,628,02,01,  Maind,2738,3407,1260,1603,1478,1804,44.6,44.0,45.0,00000
12.0,13.0,83.0,982,01,01,  Ulcha Para,1873,2243,865,1108,1008,1135,45.5,43.8,47.0,00000
12.0,13.0,83.0,982,02,01,  Jatrabari,367,658,183,339,184,319,35.8,35.1,36.6,00000
12.0,13.0,86.0,283,01,01,  Alakpur,752,997,386,532,366,465,43.0,42.0,44.0,00000
12.0,13.0,86.0,283,02,01,  Birampur,1413,1497,717,794,696,703,48.6,47.5,49.7,00000
12.0,13.0,86.0,283,03,01,  Damchail,618,684,336,374,282,310,47.5,47.3,47.6,00000
12.0,13.0,86.0,283,04,01,  Adampur,421,856,221,463,200,393,33.0,32.3,33.7,00000
12.0,13.0,86.0,283,05,01,  Rajakha,471,909,245,478,226,431,34.1,33.9,34.4,00000
12.0,13.0,88.0,112,01,01,  Tangarpar,363,163,191,80,172,83,69.0,70.5,67.5,00000
12.0,13.0,88.0,112,02,01,  Jhokarpar,332,94,157,39,175,55,77.9,80.1,76.1,00000
12.0,13.0,88.0,112,03,01,  Dakshin Sultanpur,1387,1322,622,643,765,679,51.2,49.2,53.0,00000
12.0,13.0,88.0,112,04,01,  Uttar Sultanpur,2371,1604,1155,768,1216,836,59.6,60.1,59.3,00000
12.0,13.0,88.0,112,05,01,  Dakshin Jangal,593,614,307,330,286,284,49.1,48.2,50.2,00000
12.0,13.0,88.0,112,06,01,  Uttar Jangal,418,743,197,384,221,359,36.0,33.9,38.1,00000
12.0,13.0,88.0,112,07,01,  Shahapur,675,471,295,227,380,244,58.9,56.5,60.9,00000
12.0,13.0,88.0,112,08,01,  Mahiuddinnagar,790,509,338,251,452,258,60.8,57.4,63.7,00000
12.0,13.0,88.0,112,09,01,  Rajkrishnapur,104,238,50,108,54,130,30.4,31.6,29.3,00000
12.0,13.0,88.0,112,10,01,  Sitashar,294,131,145,53,149,78,69.2,73.2,65.6,00000
12.0,13.0,88.0,112,11,01,  Halkata,249,222,106,91,143,131,52.9,53.8,52.2,00000
12.0,13.0,88.0,210,01,01,  Birampur,1695,2031,776,1020,919,1011,45.5,43.2,47.6,00000
12.0,13.0,88.0,210,02,01,  Ishan Nagar,144,278,58,130,86,148,34.1,30.9,36.8,00000
12.0,13.0,93.0,152,01,01,  Behair,1219,1221,624,609,595,612,50.0,50.6,49.3,00000
12.0,13.0,93.0,152,02,01,  Tale Para,246,247,128,128,118,119,49.9,50.0,49.8,00000
12.0,13.0,93.0,152,03,01,  Noapara,199,272,104,139,95,133,42.3,42.8,41.7,00000
12.0,33.0,14.0,415,01,01,  Jagadishpur,96,265,47,127,49,138,26.6,27.0,26.2,00000
12.0,33.0,14.0,415,02,01,  Kharashar,213,282,80,127,133,155,43.0,38.6,46.2,00000
12.0,33.0,14.0,933,01,03,  Sonarampur,4009,2729,2175,1315,1834,1414,59.5,62.3,56.5,00000
12.0,33.0,14.0,933,02,03,  Ashuganj,3183,2167,1832,1127,1351,1040,59.5,61.9,56.5,00000
12.0,33.0,14.0,933,03,03,  Char Sonarampur,329,923,173,455,156,468,26.3,27.5,25.0,00000
12.0,33.0,42.0,146,01,01,  Bayek,667,813,310,391,357,422,45.1,44.2,45.8,00000
12.0,33.0,42.0,146,02,01,  Lama Bayek,751,962,336,432,415,530,43.8,43.8,43.9,00000
12.0,33.0,77.0,866,01,01,  Sharifpur,1728,1941,769,848,959,1093,47.1,47.6,46.7,00000
12.0,33.0,77.0,866,02,01,  Tangi Para,447,299,190,135,257,164,59.9,58.5,61.0,00000
12.0,33.0,77.0,866,03,01,  Lama Sharifpur,296,235,144,115,152,120,55.7,55.6,55.9,00000
12.0,33.0,77.0,866,04,01,  Khola Para,1449,1574,636,699,813,875,47.9,47.6,48.2,00000
12.0,33.0,83.0,967,01,01,  Baraban,229,274,114,136,115,138,45.5,45.6,45.5,00000
12.0,33.0,83.0,967,02,01,  Jharakhala,631,609,276,263,355,346,50.9,51.2,50.6,00000
12.0,33.0,83.0,967,03,01,  Purba Tarua,559,570,210,239,349,331,49.5,46.8,51.3,00000
12.0,33.0,83.0,967,04,01,  Saluk Para,218,70,97,32,121,38,75.7,75.2,76.1,00000
12.0,33.0,83.0,967,05,01,  Tarua,2115,1550,970,738,1145,812,57.7,56.8,58.5,00000
12.0,63.0,31.0,258,01,01,  Charua,1157,1005,531,447,626,558,53.5,54.3,52.9,00000
12.0,63.0,31.0,258,02,01,  Konaghata,726,899,331,417,395,482,44.7,44.3,45.0,00000
12.0,63.0,31.0,403,01,01,  Gaurangala,427,224,195,95,232,129,65.6,67.2,64.3,00000
12.0,63.0,31.0,403,02,01,  Sastapur,109,102,50,54,59,48,51.7,48.1,55.1,00000
12.0,63.0,31.0,403,03,01,  Mirjapur,80,51,35,26,45,25,61.1,57.4,64.3,00000
12.0,63.0,31.0,403,04,01,  Badalia,122,93,52,42,70,51,56.7,55.3,57.9,00000
12.0,63.0,31.0,536,01,01,  Kashirampur,267,388,130,196,137,192,40.8,39.9,41.6,00000
12.0,63.0,31.0,536,02,01,  Dhopakhala,185,265,85,136,100,129,41.1,38.5,43.7,00000
12.0,63.0,31.0,536,03,01,  Naya Para,105,299,40,141,65,158,26.0,22.1,29.1,00000
12.0,63.0,31.0,552,01,01,  Khadla,659,500,294,218,365,282,56.9,57.4,56.4,00000
12.0,63.0,31.0,552,02,01,  Beltali,328,500,148,244,180,256,39.6,37.8,41.3,00000
12.0,63.0,31.0,736,01,01,  Nandan Nagar (Madla),863,974,438,436,425,538,47.0,50.1,44.1,00000
12.0,63.0,31.0,736,02,01,  Gopinagar,532,810,260,363,272,447,39.6,41.7,37.8,00000
12.0,63.0,31.0,748,01,01,  Nayanpur,562,613,296,289,266,324,47.8,50.6,45.1,00000
12.0,63.0,31.0,748,02,01,  Dhanrajpur,163,134,89,69,74,65,54.9,56.3,53.2,00000
12.0,63.0,31.0,748,03,01,  Kandar Para,189,451,90,198,99,253,29.5,31.3,28.1,00000
12.0,63.0,31.0,871,01,01,  Sagartala,225,248,107,118,118,130,47.6,47.6,47.6,00000
12.0,63.0,31.0,871,02,01,  Bara Bayek,112,35,56,12,56,23,76.2,82.4,70.9,00000
12.0,63.0,37.0,195,01,01,  Chak Chandrapur,1306,853,598,377,708,476,60.5,61.3,59.8,00000
12.0,63.0,37.0,195,02,01,  Noapara,146,138,73,71,73,67,51.4,50.7,52.1,00000
12.0,63.0,37.0,223,01,01,  Chandrapur,136,345,81,153,55,192,28.3,34.6,22.3,00000
12.0,63.0,37.0,223,02,01,  Bhora Jangal,241,329,117,138,124,191,42.3,45.9,39.4,00000
12.0,63.0,37.0,420,01,01,  Noapara,303,335,135,140,168,195,47.5,49.1,46.3,00000
12.0,63.0,50.0,211,01,01,  Chandidar,349,82,160,33,189,49,81.0,82.9,79.4,00000
12.0,63.0,50.0,211,02,01,  Mrijatpur,107,32,51,12,56,20,77.0,81.0,73.7,00000
12.0,63.0,50.0,211,03,01,  Alampur,115,59,60,26,55,33,66.1,69.8,62.5,00000
12.0,63.0,50.0,211,04,01,  Hariaibaha,286,207,132,101,154,106,58.0,56.7,59.2,00000
12.0,63.0,50.0,211,05,01,  Noagaon,416,262,226,140,190,122,61.4,61.7,60.9,00000
12.0,63.0,50.0,301,01,01,  Dajanagar,978,776,479,378,499,398,55.8,55.9,55.6,00000
12.0,63.0,50.0,301,02,01,  Royermura,228,248,112,132,116,116,47.9,45.9,50.0,00000
12.0,63.0,50.0,301,03,01,  Goshaipur,172,35,90,15,82,20,83.1,85.7,80.4,00000
12.0,63.0,50.0,344,01,01,  Bishnauri,515,502,258,234,257,268,50.6,52.4,49.0,00000
12.0,63.0,50.0,344,02,01,  Ganakmura,81,143,33,76,48,67,36.2,30.3,41.7,00000
12.0,63.0,50.0,344,03,01,  Kashipur,177,165,93,77,84,88,51.8,54.7,48.8,00000
12.0,63.0,50.0,344,04,01,  Baratuta,369,497,181,233,188,264,42.6,43.7,41.6,00000
12.0,63.0,50.0,356,01,01,  Fatehpur,498,186,240,80,258,106,72.8,75.0,70.9,00000
12.0,63.0,50.0,356,02,01,  Bahadurpur,64,115,22,60,42,55,35.8,26.8,43.3,00000
12.0,63.0,50.0,356,03,01,  Rajnagar,170,147,72,73,98,74,53.6,49.7,57.0,00000
12.0,63.0,50.0,662,01,01,  Madhupur,311,101,143,38,168,63,75.5,79.0,72.7,00000
12.0,63.0,50.0,662,02,01,  Manikmuri,146,148,62,72,84,76,49.7,46.3,52.5,00000
12.0,63.0,50.0,853,01,01,  Rampur,407,753,189,347,218,406,35.1,35.3,34.9,00000
12.0,63.0,50.0,853,02,01,  Ramnagar,101,142,55,72,46,70,41.6,43.3,39.7,00000
12.0,63.0,50.0,853,03,01,  Sutarmura,305,534,147,238,158,296,36.4,38.2,34.8,00000
12.0,63.0,50.0,853,04,01,  Dighirpar,21,44,11,23,10,21,32.3,32.4,32.3,00000
12.0,63.0,50.0,853,05,01,  Kaziatala,119,127,73,64,46,63,48.4,53.3,42.2,00000
12.0,63.0,50.0,853,06,01,  Saidpur,172,364,89,168,83,196,32.1,34.6,29.7,00000
12.0,63.0,56.0,446,01,01,  Jajishar,1004,1136,504,507,500,629,46.9,49.9,44.3,00000
12.0,63.0,56.0,446,02,01,  Ganganagar,131,435,54,222,77,213,23.1,19.6,26.6,00000
12.0,63.0,56.0,528,01,01,  Jikra,133,125,60,58,73,67,51.6,50.8,52.1,00000
12.0,63.0,56.0,528,02,01,  Kalinagar,70,80,42,37,28,43,46.7,53.2,39.4,00000
12.0,63.0,56.0,528,03,01,  Jagannathpur,164,310,78,147,86,163,34.6,34.7,34.5,00000
12.0,63.0,56.0,528,04,01,  Girishnagar,202,278,96,132,106,146,42.1,42.1,42.1,00000
12.0,63.0,56.0,528,05,01,  Mainpur,1435,2041,692,922,743,1119,41.3,42.9,39.9,00000
12.0,63.0,56.0,685,01,01,  Mandabagh,1074,1085,493,494,581,591,49.7,49.9,49.6,00000
12.0,63.0,56.0,685,02,01,  Noapara,80,239,41,99,39,140,25.1,29.3,21.8,00000
12.0,63.0,56.0,721,01,01,  Omarpur,52,72,24,32,28,40,41.9,42.9,41.2,00000
12.0,63.0,56.0,721,02,01,  Kalta,396,286,202,127,194,159,58.1,61.4,55.0,00000
12.0,63.0,56.0,721,03,01,  Nakahura,105,88,51,32,54,56,54.4,61.4,49.1,00000
12.0,63.0,56.0,721,04,01,  Khurisher,72,57,34,29,38,28,55.8,54.0,57.6,00000
12.0,63.0,56.0,865,01,01,  Routhkhola,426,26,197,15,229,11,94.2,92.9,95.4,00000
12.0,63.0,56.0,865,02,01,  Ramkhola,161,25,72,15,89,10,86.6,82.8,89.9,00000
12.0,63.0,63.0,501,01,01,  Kaliara,179,309,75,164,104,145,36.7,31.4,41.8,00000
12.0,63.0,63.0,501,02,01,  Mir Pukurpar,208,140,87,57,121,83,59.8,60.4,59.3,00000
12.0,63.0,63.0,716,01,01,  Mirtala,1053,1076,473,509,580,567,49.5,48.2,50.6,00000
12.0,63.0,63.0,716,02,01,  Bilghar,228,107,117,49,111,58,68.1,70.5,65.7,00000
12.0,63.0,65.0,560,01,01,  Golasar,369,266,161,125,208,141,58.1,56.3,59.6,00000
12.0,63.0,65.0,560,02,01,  Sonargaon,782,572,377,263,405,309,57.8,58.9,56.7,00000
12.0,63.0,65.0,560,03,01,  Kherera,2462,1373,1123,654,1339,719,64.2,63.2,65.1,00000
12.0,63.0,65.0,560,04,01,  Ganesh Pukurpar,197,219,92,101,105,118,47.4,47.7,47.1,00000
12.0,63.0,65.0,560,05,01,  Radhanagar,262,245,136,120,126,125,51.7,53.1,50.2,00000
12.0,63.0,65.0,560,06,01,  Damsar,559,385,254,197,305,188,59.2,56.3,61.9,00000
12.0,63.0,65.0,560,07,01,  Gazaria,247,181,113,69,134,112,57.7,62.1,54.5,00000
12.0,63.0,69.0,454,01,01,  Pukurpar,126,278,71,133,55,145,31.2,34.8,27.5,00000
12.0,63.0,69.0,454,02,01,  Jajiara,1141,1126,536,560,605,566,50.3,48.9,51.7,00000
12.0,63.0,69.0,454,03,01,  Gunsagar,391,558,189,281,202,277,41.2,40.2,42.2,00000
12.0,63.0,69.0,646,01,01,  Taranagar,144,188,74,94,70,94,43.4,44.0,42.7,00000
12.0,63.0,69.0,646,02,01,  Shantipur,188,147,89,73,99,74,56.1,54.9,57.2,00000
12.0,63.0,69.0,646,03,01,  Atkha Para,171,266,78,143,93,123,39.1,35.3,43.1,00000
12.0,63.0,69.0,646,04,01,  Krishna Nagar,58,107,32,86,26,21,35.2,27.1,55.3,00000
12.0,63.0,69.0,646,05,01,  Kailasnagar,52,70,25,29,27,41,42.6,46.3,39.7,00000
12.0,63.0,69.0,646,06,01,  Lesiara,2083,2158,938,1044,1145,1114,49.1,47.3,50.7,00000
12.0,63.0,69.0,646,07,01,  Ganganagar,381,491,173,228,208,263,43.7,43.1,44.2,00000
12.0,63.0,69.0,646,08,01,  Bhairabnagar,425,589,218,272,207,317,41.9,44.5,39.5,00000
12.0,63.0,69.0,646,09,01,  Maniknagar,166,204,77,112,89,92,44.9,40.7,49.2,00000
12.0,63.0,69.0,646,10,01,  Sharatnagar,320,233,159,102,161,131,57.9,60.9,55.1,00000
12.0,63.0,69.0,646,11,01,  Gauripur,377,548,135,259,242,289,40.8,34.3,45.6,00000
12.0,63.0,69.0,646,12,01,  Baisar,453,281,195,121,258,160,61.7,61.7,61.7,00000
12.0,63.0,69.0,646,13,01,  Kashinagar,112,103,48,45,64,58,52.1,51.6,52.5,00000
12.0,63.0,69.0,646,14,01,  Chandinagar,52,34,22,18,30,16,60.5,55.0,65.2,00000
12.0,63.0,69.0,665,01,01,  Bilghar,467,509,205,234,262,275,47.8,46.7,48.8,00000
12.0,63.0,69.0,665,02,01,  Rampura,240,398,110,198,130,200,37.6,35.7,39.4,00000
12.0,63.0,69.0,665,03,01,  Maijkhar,1259,1384,575,641,684,743,47.6,47.3,47.9,00000
12.0,63.0,82.0,254,01,01,  Chhabpur,673,982,294,460,379,522,40.7,39.0,42.1,00000
12.0,63.0,82.0,254,02,01,  Tilarpar,268,212,125,99,143,113,55.8,55.8,55.9,00000
12.0,63.0,82.0,568,01,01,  Kheora,1190,1402,508,655,682,747,45.9,43.7,47.7,00000
12.0,63.0,82.0,568,02,01,  Purkuil,465,374,204,190,261,184,55.4,51.8,58.7,00000
12.0,63.0,82.0,568,03,01,  Baherhata,308,409,129,168,179,241,43.0,43.4,42.6,00000
12.0,63.0,82.0,568,04,01,  Bamutia,220,104,97,47,123,57,67.9,67.4,68.3,00000
12.0,63.0,82.0,928,01,01,  Simrail,3712,4063,1561,1942,2151,2121,47.7,44.6,50.4,00000
12.0,63.0,82.0,928,02,01,  Esan Nagar,361,561,150,276,211,285,39.2,35.2,42.5,00000
12.0,63.0,94.0,035,01,01,  Amkhar,109,159,50,73,59,86,40.7,40.7,40.7,00000
12.0,63.0,94.0,035,02,01,  Pukurpar,132,326,46,160,86,166,28.8,22.3,34.1,00000
12.0,63.0,94.0,289,01,01,  Debirghar,167,646,78,288,89,358,20.5,21.3,19.9,00000
12.0,63.0,94.0,289,02,01,  Shyamnagar,212,326,90,179,122,147,39.4,33.5,45.4,00000
12.0,85.0,12.0,464,01,01,  Dharabhanga,968,1264,454,568,514,696,43.4,44.4,42.5,00000
12.0,85.0,12.0,464,02,01,  Moktarampur,906,1397,408,642,498,755,39.3,38.9,39.7,00000
12.0,85.0,12.0,464,03,01,  Nurjahanpur,624,815,253,367,371,448,43.4,40.8,45.3,00000
12.0,85.0,12.0,464,04,01,  Barikandi,1726,1901,822,834,904,1067,47.6,49.6,45.9,00000
12.0,85.0,12.0,464,05,01,  Dolaiganj,138,337,61,176,77,161,29.1,25.7,32.4,00000
12.0,85.0,12.0,464,06,01,  Sonabalua,135,379,56,184,79,195,26.3,23.3,28.8,00000
12.0,85.0,13.0,150,01,01,  Biddyakut,2872,4844,1329,2308,1543,2536,37.2,36.5,37.8,00000
12.0,85.0,13.0,150,02,01,  Salimnagar,392,688,143,337,249,351,36.3,29.8,41.5,00000
12.0,85.0,13.0,699,01,01,  Manipur,578,1124,258,543,320,581,34.0,32.2,35.5,00000
12.0,85.0,13.0,699,02,01,  Rajapur,157,289,71,147,86,142,35.2,32.6,37.7,00000
12.0,85.0,13.0,699,03,01,  Bhayralnagar,608,1503,241,732,367,771,28.8,24.8,32.2,00000
12.0,85.0,18.0,156,01,01,  Tilokia,189,443,76,207,113,236,29.9,26.9,32.4,00000
12.0,85.0,18.0,156,02,01,  Kishorepur,327,1179,116,536,211,643,21.7,17.8,24.7,00000
12.0,85.0,27.0,446,01,01,  Ibrahimpur,3752,3734,1737,1679,2015,2055,50.1,50.8,49.5,00000
12.0,85.0,27.0,446,02,01,  Basidpur,326,78,159,39,167,39,80.7,80.3,81.1,00000
12.0,85.0,27.0,446,03,01,  Kalipur,194,624,89,297,105,327,23.7,23.1,24.3,00000
12.0,85.0,27.0,446,04,01,  Jafarpur,1129,415,510,178,619,237,73.1,74.1,72.3,00000
12.0,85.0,27.0,446,05,01,  Shyampur,88,71,36,31,52,40,55.3,53.7,56.5,00000
12.0,85.0,27.0,446,06,01,  Kazimabad,214,397,94,191,120,206,35.0,33.0,36.8,00000
12.0,85.0,36.0,078,01,01,  Balibari,536,361,226,142,310,219,59.8,61.4,58.6,00000
12.0,85.0,36.0,078,02,01,  Pandabnagar,66,56,26,25,40,31,54.1,51.0,56.3,00000
12.0,85.0,36.0,440,01,01,  Hurua,835,1081,380,511,455,570,43.6,42.6,44.4,00000
12.0,85.0,36.0,440,02,01,  Nilnagar,31,375,13,172,18,203,7.6,7.0,8.1,00000
12.0,85.0,36.0,970,01,01,  Bangora,2338,2168,1082,990,1256,1178,51.9,52.2,51.6,00000
12.0,85.0,36.0,970,02,01,  Asrafpur,29,11,16,2,13,9,72.5,88.9,59.1,00000
12.0,85.0,36.0,970,03,01,  Char Para,229,440,108,228,121,212,34.2,32.1,36.3,00000
12.0,85.0,45.0,596,01,01,  Purba Krishnanagar,829,1263,399,628,430,635,39.6,38.9,40.4,00000
12.0,85.0,45.0,596,02,01,  Paschim Krishnanagar,848,1230,371,561,477,669,40.8,39.8,41.6,00000
12.0,85.0,45.0,988,01,01,  Sathgorhati,595,985,260,458,335,527,37.7,36.2,38.9,00000
12.0,85.0,45.0,988,02,01,  Hajirhati,637,1683,277,756,360,927,27.5,26.8,28.0,00000
12.0,85.0,47.0,012,01,01,  Ahammadpur,2004,1817,906,838,1098,979,52.4,51.9,52.9,00000
12.0,85.0,47.0,012,02,01,  Tanchara,373,267,180,125,193,142,58.3,59.0,57.6,00000
12.0,85.0,47.0,633,01,01,  Laur,982,780,499,347,483,433,55.7,59.0,52.7,00000
12.0,85.0,47.0,633,02,01,  Fatehpur,996,832,451,361,545,471,54.5,55.5,53.6,00000
12.0,85.0,47.0,633,03,01,  Barikhola,1494,1220,695,529,799,691,55.0,56.8,53.6,00000
12.0,85.0,47.0,633,04,01,  Basaruk,1736,1318,722,606,1014,712,56.8,54.4,58.7,00000
12.0,85.0,47.0,633,05,01,  Radhanagar,75,355,34,180,41,175,17.4,15.9,19.0,00000
12.0,85.0,58.0,223,01,01,  Charilam,779,627,344,280,435,347,55.4,55.1,55.6,00000
12.0,85.0,58.0,223,02,01,  Bhandushar,174,310,78,157,96,153,36.0,33.2,38.6,00000
12.0,85.0,60.0,217,01,01,  Char Napang,738,2494,383,1166,355,1328,22.8,24.7,21.1,00000
12.0,85.0,60.0,217,02,01,  Daskandi,32,377,13,181,19,196,7.8,6.7,8.8,00000
12.0,85.0,60.0,367,01,01,  Fatehpur,520,608,230,286,290,322,46.1,44.6,47.4,00000
12.0,85.0,60.0,367,02,01,  Narasingpur,434,645,171,300,263,345,40.2,36.3,43.3,00000
12.0,85.0,60.0,729,01,01,  Napang,865,1471,418,696,447,775,37.0,37.5,36.6,00000
12.0,85.0,60.0,729,02,01,  Dari Napang,232,698,114,331,118,367,24.9,25.6,24.3,00000
12.0,85.0,62.0,687,01,01,  Mohalla,1024,1664,427,759,597,905,38.1,36.0,39.7,00000
12.0,85.0,62.0,687,02,01,  Dupakandi,188,774,78,363,110,411,19.5,17.7,21.1,00000
12.0,85.0,72.0,289,01,01,  Damla,145,186,66,81,79,105,43.8,44.9,42.9,00000
12.0,85.0,72.0,289,02,01,  Golpukuria,196,302,85,124,111,178,39.4,40.7,38.4,00000
12.0,85.0,75.0,108,01,01,  Salimaganj,347,242,181,114,166,128,58.9,61.4,56.5,00000
12.0,85.0,75.0,108,02,01,  Rajnagar,210,308,122,144,88,164,40.5,45.9,34.9,00000
12.0,85.0,75.0,108,03,01,  Barail,2237,1975,1019,888,1218,1087,53.1,53.4,52.8,00000
12.0,85.0,75.0,108,04,01,  Barail Kaibarta Para,197,373,94,188,103,185,34.6,33.3,35.8,00000
12.0,85.0,81.0,410,01,01,  Gonsaipur,978,895,441,424,537,471,52.2,51.0,53.3,00000
12.0,85.0,81.0,410,02,01,  Meratali,399,871,174,394,225,477,31.4,30.6,32.1,00000
12.0,85.0,83.0,241,01,01,  Chelikhola,588,85,270,23,318,62,87.4,92.2,83.7,00000
12.0,85.0,83.0,241,02,01,  Jagannathpur,460,644,223,269,237,375,41.7,45.3,38.7,00000
12.0,85.0,83.0,271,01,01,  Chouria,927,1121,384,482,543,639,45.3,44.3,45.9,00000
12.0,85.0,83.0,271,02,01,  Uttar Pandabnagar,40,49,18,22,22,27,44.9,45.0,44.9,00000
12.0,85.0,83.0,452,01,01,  Ichhapura,335,194,172,75,163,119,63.3,69.6,57.8,00000
12.0,85.0,83.0,452,02,01,  Isanagar,144,107,63,46,81,61,57.4,57.8,57.0,00000
12.0,85.0,83.0,880,01,01,  Satmura,1467,1952,650,882,817,1070,42.9,42.4,43.3,00000
12.0,85.0,83.0,880,02,01,  Madhabpur,49,148,25,53,24,95,24.9,32.1,20.2,00000
12.0,85.0,83.0,904,01,01,  Bara Sikanika,160,152,76,71,84,81,51.3,51.7,50.9,00000
12.0,85.0,83.0,904,02,01,  Bhatar Pukur,189,200,79,90,110,110,48.6,46.7,50.0,00000
12.0,85.0,83.0,904,03,01,  Padmanagar,61,83,28,41,33,42,42.4,40.6,44.0,00000
12.0,85.0,83.0,904,04,01,  Chhota Sikanika,453,387,216,169,237,218,53.9,56.1,52.1,00000
12.0,85.0,83.0,904,05,01,  Kajella,489,804,221,365,268,439,37.8,37.7,37.9,00000
12.0,85.0,86.0,898,01,01,  Shibpur,1074,1599,530,748,544,851,40.2,41.5,39.0,00000
12.0,85.0,86.0,898,02,01,  Islampur,297,285,134,136,163,149,51.0,49.6,52.2,00000
12.0,85.0,86.0,898,03,01,  Atiara,325,344,145,160,180,184,48.6,47.5,49.5,00000
12.0,85.0,88.0,717,01,01,  Nasirabad,1058,2008,515,979,543,1029,34.5,34.5,34.5,00000
12.0,85.0,88.0,717,02,01,  Sahebnagar,485,1157,215,542,270,615,29.5,28.4,30.5,00000
12.0,85.0,88.0,717,03,01,  Char Maniknagar,56,96,26,62,30,34,36.8,29.5,46.9,00000
12.0,85.0,90.0,416,01,01,  Gopalpur,2664,2373,1209,1072,1455,1301,52.9,53.0,52.8,00000
12.0,85.0,90.0,416,02,01,  Ayitala,246,609,104,294,142,315,28.8,26.1,31.1,00000
12.0,85.0,90.0,416,03,01,  Sadekpur,127,239,63,119,64,120,34.7,34.6,34.8,00000
12.0,85.0,90.0,416,04,01,  Riazatpur,437,684,196,312,241,372,39.0,38.6,39.3,00000
12.0,85.0,90.0,934,01,01,  Sreerampur,2699,3574,1179,1613,1520,1961,43.0,42.2,43.7,00000
12.0,85.0,90.0,934,02,01,  Dari Sreerampur,857,959,384,405,473,554,47.2,48.7,46.1,00000
12.0,90.0,14.0,258,01,01,  Burishwar,916,2627,451,1279,465,1348,25.9,26.1,25.6,00000
12.0,90.0,14.0,258,02,01,  Chand Para,97,499,54,255,43,244,16.3,17.5,15.0,00000
12.0,90.0,14.0,258,03,01,  Ganganagar,305,300,138,131,167,169,50.4,51.3,49.7,00000
12.0,90.0,17.0,139,01,01,  Baruichira,250,535,141,267,109,268,31.8,34.6,28.9,00000
12.0,90.0,17.0,139,02,01,  Durgapur,347,725,184,373,163,352,32.4,33.0,31.7,00000
12.0,90.0,17.0,238,01,01,  Bholakot,1715,3570,928,1707,787,1863,32.5,35.2,29.7,00000
12.0,90.0,17.0,238,02,01,  Kandi,725,1378,389,653,336,725,34.5,37.3,31.7,00000
12.0,90.0,17.0,238,03,01,  Kandi Para,247,513,139,237,108,276,32.5,37.0,28.1,00000
12.0,90.0,29.0,547,01,01,  Chatalpar,1855,1417,1025,650,830,767,56.7,61.2,52.0,00000
12.0,90.0,29.0,547,02,01,  Bilerpar,311,373,175,196,136,177,45.5,47.2,43.5,00000
12.0,90.0,29.0,656,01,01,  Katalkandi,2108,2096,1089,1004,1019,1092,50.1,52.0,48.3,00000
12.0,90.0,29.0,656,02,01,  Niazpur,150,310,69,146,81,164,32.6,32.1,33.1,00000
12.0,90.0,29.0,855,01,01,  Patair,490,2140,259,1086,231,1054,18.6,19.3,18.0,00000
12.0,90.0,29.0,855,02,01,  Ratanpur,851,1168,461,565,390,603,42.1,44.9,39.3,00000
12.0,90.0,29.0,855,03,01,  Mankuta,396,584,219,295,177,289,40.4,42.6,38.0,00000
12.0,90.0,36.0,388,01,01,  Dhar Mandal,3037,7734,1534,3724,1503,4010,28.2,29.2,27.3,00000
12.0,90.0,36.0,388,02,01,  Ganna,70,410,39,193,31,217,14.6,16.8,12.5,00000
12.0,90.0,36.0,388,03,01,  Deorath,51,515,25,255,26,260,9.0,8.9,9.1,00000
12.0,90.0,43.0,427,01,01,  Rasulpur,34,361,16,182,18,179,8.6,8.1,9.1,00000
12.0,90.0,43.0,427,02,01,  Fandauk,2483,4170,1229,1935,1254,2235,37.3,38.8,35.9,00000
12.0,90.0,43.0,427,03,01,  Rajnagar,158,400,89,180,69,220,28.3,33.1,23.9,00000
12.0,90.0,51.0,328,01,01,  Dakshindia,376,618,192,292,184,326,37.8,39.7,36.1,00000
12.0,90.0,51.0,328,02,01,  Simerkandi,92,368,55,181,37,187,20.0,23.3,16.5,00000
12.0,90.0,51.0,328,03,01,  Lalurtuk,322,703,164,373,158,330,31.4,30.5,32.4,00000
12.0,90.0,51.0,616,01,01,  Maijkhola,545,735,271,352,274,383,42.6,43.5,41.7,00000
12.0,90.0,51.0,616,02,01,  Kadamtali,483,620,287,267,196,353,43.8,51.8,35.7,00000
12.0,90.0,51.0,616,03,01,  Sonatala,192,795,101,390,91,405,19.5,20.6,18.3,00000
12.0,90.0,51.0,616,04,01,  Jhamarbali,280,322,142,162,138,160,46.5,46.7,46.3,00000
12.0,90.0,51.0,835,01,01,  Noagaon,538,736,286,343,252,393,42.2,45.5,39.1,00000
12.0,90.0,51.0,835,02,01,  Rajnagar,32,191,12,104,20,87,14.3,10.3,18.7,00000
12.0,90.0,51.0,835,03,01,  Pialapur,45,123,23,63,22,60,26.8,26.7,26.8,00000
12.0,90.0,58.0,915,01,01,  Suchiura,471,402,218,211,253,191,54.0,50.8,57.0,00000
12.0,90.0,58.0,915,02,01,  Chairkuri,344,624,166,283,178,341,35.5,37.0,34.3,00000
12.0,90.0,73.0,089,01,01,  Rustampur,256,696,103,344,153,352,26.9,23.0,30.3,00000
12.0,90.0,73.0,089,02,01,  Bara Haripur,2005,4429,976,2054,1029,2375,31.2,32.2,30.2,00000
12.0,90.0,87.0,766,01,03,  Nasirnagar,3732,2550,1869,1179,1863,1371,59.4,61.3,57.6,00000
12.0,90.0,87.0,766,02,03,  Anandapur,111,283,52,140,59,143,28.2,27.1,29.2,00000
12.0,90.0,87.0,766,03,03,  Kamargaon,211,604,93,245,118,359,25.9,27.5,24.7,00000
12.0,90.0,87.0,776,01,03,  Nasirpur,1380,1496,676,696,704,800,48.0,49.3,46.8,00000
12.0,90.0,87.0,776,02,03,  Tekanagar,335,754,173,353,162,401,30.8,32.9,28.8,00000
12.0,90.0,87.0,776,03,03,  Manoharpur,185,459,100,229,85,230,28.7,30.4,27.0,00000
12.0,90.0,94.0,646,01,01,  Chander Para,908,1977,436,953,472,1024,31.5,31.4,31.6,00000
12.0,90.0,94.0,646,02,01,  Koarpur,410,717,233,333,177,384,36.4,41.2,31.6,00000
12.0,90.0,94.0,646,03,01,  Bara Dhalia,140,380,70,178,70,202,26.9,28.2,25.7,00000
12.0,90.0,94.0,646,04,01,  Shyampur,603,628,311,300,292,328,49.0,50.9,47.1,00000
12.0,90.0,94.0,646,05,01,  Kifatnagar,66,426,28,209,38,217,13.4,11.8,14.9,00000
12.0,90.0,94.0,646,06,01,  Kadamtala,170,420,104,209,66,211,28.8,33.2,23.8,00000
12.0,90.0,94.0,985,01,01,  Purbabagh,1416,2040,674,907,742,1133,41.0,42.6,39.6,00000
12.0,90.0,94.0,985,02,01,  Makbulpur,268,236,141,108,127,128,53.2,56.6,49.8,00000
12.0,94.0,13.0,052,01,01,  Aorail,1281,1265,665,605,616,660,50.3,52.4,48.3,00000
12.0,94.0,13.0,052,02,01,  Joynagar,198,228,100,113,98,115,46.5,46.9,46.0,00000
12.0,94.0,13.0,065,01,01,  Bade Aorail,1286,837,661,382,625,455,60.6,63.4,57.9,00000
12.0,94.0,13.0,065,02,01,  Aorail Bazar,320,51,193,23,127,28,86.3,89.4,81.9,00000
12.0,94.0,13.0,379,01,01,  Dubajail,1679,2629,859,1245,820,1384,39.0,40.8,37.2,00000
12.0,94.0,13.0,379,02,01,  Rajapur,1416,2684,756,1278,660,1406,34.5,37.2,31.9,00000
12.0,94.0,13.0,772,01,01,  Ranidia,2693,1865,1417,880,1276,985,59.1,61.7,56.4,00000
12.0,94.0,13.0,772,02,01,  Banertek,259,193,149,96,110,97,57.3,60.8,53.1,00000
12.0,94.0,19.0,039,01,01,  Deobari,320,326,167,166,153,160,49.5,50.2,48.9,00000
12.0,94.0,19.0,039,02,01,  Natunhat,561,1033,285,491,276,542,35.2,36.7,33.7,00000
12.0,94.0,19.0,039,03,01,  Narsinghpur,501,1324,224,602,277,722,27.5,27.1,27.7,00000
12.0,94.0,19.0,288,01,01,  Chunta,2014,3273,934,1419,1080,1854,38.1,39.7,36.8,00000
12.0,94.0,19.0,288,02,01,  Bara Ballah,164,972,91,408,73,564,14.4,18.2,11.5,00000
12.0,94.0,19.0,628,01,01,  Lopara,1077,1749,488,754,589,995,38.1,39.3,37.2,00000
12.0,94.0,19.0,628,02,01,  Ranguri Para,281,465,139,205,142,260,37.7,40.4,35.3,00000
12.0,94.0,28.0,510,01,01,  Galania,835,1254,381,554,454,700,40.0,40.7,39.3,00000
12.0,94.0,28.0,510,02,01,  Kasarpar,110,147,53,63,57,84,42.8,45.7,40.4,00000
12.0,94.0,28.0,510,03,01,  Chanpur,375,981,180,384,195,597,27.7,31.9,24.6,00000
12.0,94.0,28.0,510,04,01,  Sahapur,47,480,30,223,17,257,8.9,11.9,6.2,00000
12.0,94.0,28.0,510,05,01,  Dharma Thirta,390,1032,189,458,201,574,27.4,29.2,25.9,00000
12.0,94.0,28.0,510,06,01,  Shiddeshwari,104,448,35,201,69,247,18.8,14.8,21.8,00000
12.0,94.0,28.0,510,07,01,  Suriar Pukurpar,74,91,38,42,36,49,44.8,47.5,42.4,00000
12.0,94.0,28.0,510,08,01,  Gunara,20,130,9,55,11,75,13.3,14.1,12.8,00000
12.0,94.0,28.0,510,09,01,  Kabitara,63,233,34,102,29,131,21.3,25.0,18.1,00000
12.0,94.0,28.0,510,10,01,  Bepari Para,414,618,219,328,195,290,40.1,40.0,40.2,00000
12.0,94.0,28.0,510,11,01,  Kalikachchha Aonsho(Ghoshpara),342,283,176,122,166,161,54.7,59.1,50.8,00000
12.0,94.0,28.0,510,12,01,  Chakshar,562,1045,261,500,301,545,35.0,34.3,35.6,00000
12.0,94.0,28.0,510,13,01,  Paschim Kalikachchha G.C,5045,4510,2519,2106,2526,2404,52.8,54.5,51.2,00000
12.0,94.0,28.0,510,14,01,  Mulbarga,303,345,169,172,134,173,46.8,49.6,43.6,00000
12.0,94.0,28.0,510,15,01,  Bishutara,637,966,319,371,318,595,39.7,46.2,34.8,00000
12.0,94.0,38.0,706,01,01,  Noagaon,2003,3517,945,1622,1058,1895,36.3,36.8,35.8,00000
12.0,94.0,38.0,706,02,01,  Joynagar,30,69,18,24,12,45,30.3,42.9,21.1,00000
12.0,94.0,38.0,706,03,01,  Batara,18,101,6,50,12,51,15.1,10.7,19.0,00000
12.0,94.0,38.0,706,04,01,  Chowraguda,206,278,99,131,107,147,42.6,43.0,42.1,00000
12.0,94.0,38.0,706,05,01,  Char Ullahati,249,234,129,105,120,129,51.6,55.1,48.2,00000
12.0,94.0,38.0,706,06,01,  Guchchhagram,13,115,5,61,8,54,10.2,7.6,12.9,00000
12.0,94.0,38.0,706,07,01,  Chandpur,108,336,55,196,53,140,24.3,21.9,27.5,00000
12.0,94.0,38.0,955,01,01,  Teorkona,236,340,137,166,99,174,41.0,45.2,36.3,00000
12.0,94.0,38.0,955,02,01,  Nadda Para,16,378,8,190,8,188,4.1,4.0,4.1,00000
12.0,94.0,47.0,759,01,01,  Paramanandapur,1276,2516,704,1246,572,1270,33.6,36.1,31.1,00000
12.0,94.0,47.0,759,02,01,  Baraichara,704,1370,373,650,331,720,33.9,36.5,31.5,00000
12.0,94.0,47.0,759,03,01,  Shaitbaria,104,440,46,209,58,231,19.1,18.0,20.1,00000
12.0,94.0,47.0,759,04,01,  Haripur,345,264,194,109,151,155,56.7,64.0,49.3,00000
12.0,94.0,76.0,458,01,03,  Bara Gunara,295,535,173,221,122,314,35.5,43.9,28.0,00000
12.0,94.0,76.0,458,02,03,  Chhota Gunara,197,267,95,102,102,165,42.5,48.2,38.2,00000
12.0,94.0,76.0,837,01,03,  Jilukdar Para,248,262,111,120,137,142,48.6,48.1,49.1,00000
12.0,94.0,76.0,837,02,03,  Nij Saril,1194,851,527,383,667,468,58.4,57.9,58.8,00000
12.0,94.0,76.0,837,03,03,  Nath Para,292,286,143,142,149,144,50.5,50.2,50.9,00000
12.0,94.0,76.0,837,04,03,  Alinagar,360,223,169,100,191,123,61.7,62.8,60.8,00000
12.0,94.0,76.0,837,05,03,  Sreedobha,86,207,40,96,46,111,29.4,29.4,29.3,00000
12.0,94.0,76.0,837,06,03,  Darji Para,277,473,149,229,128,244,36.9,39.4,34.4,00000
12.0,94.0,76.0,837,07,03,  Jurasar,205,259,88,120,117,139,44.2,42.3,45.7,00000
12.0,94.0,76.0,837,08,03,  Kutta Para,3070,2838,1506,1348,1564,1490,52.0,52.8,51.2,00000
12.0,94.0,76.0,837,09,03,  Uttar Paschim Bepari Para,315,780,168,374,147,406,28.8,31.0,26.6,00000
12.0,94.0,76.0,837,10,03,  Lata Baiddya Para,264,49,124,23,140,26,84.3,84.4,84.3,00000
12.0,94.0,76.0,837,11,03,  Bodda Para,1033,1278,503,593,530,685,44.7,45.9,43.6,00000
12.0,94.0,76.0,837,12,03,  Saha Para,312,44,153,19,159,25,87.6,89.0,86.4,00000
12.0,94.0,76.0,837,13,03,  Pathan Para,252,334,117,167,135,167,43.0,41.2,44.7,00000
12.0,94.0,76.0,837,14,03,  Uchalia Para,2330,1116,1145,472,1185,644,67.6,70.8,64.8,00000
12.0,94.0,76.0,837,15,03,  Banik Para,417,97,194,35,223,62,81.1,84.7,78.2,00000
12.0,94.0,76.0,837,16,03,  Habli Para,199,99,100,44,99,55,66.8,69.4,64.3,00000
12.0,94.0,76.0,837,17,03,  Dakshin Arifiel,392,707,174,323,218,384,35.7,35.0,36.2,00000
12.0,94.0,76.0,837,18,03,  Kachari Para,343,210,173,86,170,124,62.0,66.8,57.8,00000
12.0,94.0,76.0,837,19,03,  Dewan Habli,253,30,130,14,123,16,89.4,90.3,88.5,00000
12.0,94.0,76.0,837,20,03,  Mogaltula,643,473,316,207,327,266,57.6,60.4,55.1,00000
12.0,94.0,76.0,837,21,03,  Halua Para,262,433,119,210,143,223,37.7,36.2,39.1,00000
12.0,94.0,76.0,837,22,03,  Natun Habli,593,675,284,311,309,364,46.8,47.7,45.9,00000
12.0,94.0,76.0,837,23,03,  Garer Par,310,275,146,113,164,162,53.0,56.4,50.3,00000
12.0,94.0,76.0,837,24,03,  Paschimpara,522,752,270,352,252,400,41.0,43.4,38.7,00000
12.0,94.0,76.0,837,25,03,  Uttarpara,192,261,95,132,97,129,42.4,41.9,42.9,00000
12.0,94.0,76.0,837,26,03,  Fakir Para,311,276,150,143,161,133,53.0,51.2,54.8,00000
12.0,94.0,76.0,837,27,03,  Noahati,370,537,184,263,186,274,40.8,41.2,40.4,00000
12.0,94.0,76.0,837,28,03,  Dakshinpara,137,215,60,99,77,116,38.9,37.7,39.9,00000
12.0,94.0,76.0,837,29,03,  Jagur Para,87,140,38,59,49,81,38.3,39.2,37.7,00000
12.0,94.0,76.0,837,30,03,  Chhota Dewan Para,399,650,191,316,208,334,38.0,37.7,38.4,00000
12.0,94.0,76.0,837,31,03,  Mira Para,202,107,97,38,105,69,65.4,71.9,60.3,00000
12.0,94.0,76.0,837,32,03,  Purba Hafijtola,250,294,105,132,145,162,46.0,44.3,47.2,00000
12.0,94.0,76.0,837,33,03,  Brahman Para,164,283,70,132,94,151,36.7,34.7,38.4,00000
12.0,94.0,76.0,837,34,03,  Uttar Arifiel,322,476,149,219,173,257,40.4,40.5,40.2,00000
12.0,94.0,76.0,837,35,03,  Chandmani Para,353,171,173,71,180,100,67.4,70.9,64.3,00000
12.0,94.0,76.0,837,36,03,  Jahangir Para,147,142,62,66,85,76,50.9,48.4,52.8,00000
12.0,94.0,76.0,837,37,03,  Bara Dewan Para,543,114,234,43,309,71,82.6,84.5,81.3,00000
12.0,94.0,76.0,837,38,03,  Gagultala,38,45,13,21,25,24,45.8,38.2,51.0,00000
12.0,94.0,76.0,837,39,03,  Bagasutha,70,62,32,27,38,35,53.0,54.2,52.1,00000
12.0,94.0,76.0,837,40,03,  Paschim Hafiz Tola,408,339,171,162,237,177,54.6,51.4,57.2,00000
12.0,94.0,85.0,104,01,01,  Bara Dhitpur,2335,2153,1200,1108,1135,1045,52.0,52.0,52.1,00000
12.0,94.0,85.0,104,02,01,  Bishamara,222,1025,103,517,119,508,17.8,16.6,19.0,00000
12.0,94.0,94.0,811,01,01,  Sakhaiti,1478,3036,770,1469,708,1567,32.7,34.4,31.1,00000
12.0,94.0,94.0,811,02,01,  Diobaria,370,1151,167,580,203,571,24.3,22.4,26.2,00000
51.0,43.0,13.0,281,01,01,  Radapur,1326,877,592,453,734,424,60.2,56.7,63.4,00000
51.0,43.0,13.0,281,02,01,  Dulakandi,496,234,209,110,287,124,67.9,65.5,69.8,00000
51.0,43.0,13.0,350,01,01,  Gaurinagar,771,412,348,195,423,217,65.2,64.1,66.1,00000
51.0,43.0,13.0,350,02,01,  Adilpur,605,624,282,287,323,337,49.2,49.6,48.9,00000
51.0,43.0,14.0,060,01,01,  Balashpur,856,675,344,318,512,357,55.9,52.0,58.9,00000
51.0,43.0,14.0,060,02,01,  Ramnagar,537,330,180,163,357,167,61.9,52.5,68.1,00000
51.0,43.0,14.0,134,01,01,  Birahimpur,1266,581,472,284,794,297,68.5,62.4,72.8,00000
51.0,43.0,14.0,134,02,01,  Rukanpur,998,260,428,112,570,148,79.3,79.3,79.4,00000
51.0,43.0,15.0,181,01,01,  Paschim Char Mansa,1860,3843,866,1904,994,1939,32.6,31.3,33.9,00000
51.0,43.0,15.0,181,02,01,  Char Mansa(Part),1355,2582,628,1320,727,1262,34.4,32.2,36.6,00000
51.0,43.0,23.0,190,01,01,  Char Ali Hasan,1058,2754,601,1390,457,1364,27.8,30.2,25.1,00000
51.0,43.0,23.0,190,02,01,  Charramani Mohan,264,2111,138,1066,126,1045,11.1,11.5,10.8,00000
51.0,43.0,23.0,190,03,01,  Madhya Charramani Mohan,1101,5237,615,2693,486,2544,17.4,18.6,16.0,00000
51.0,43.0,23.0,190,04,01,  Purba Char Ramani Mohan,219,2202,120,1107,99,1095,9.0,9.8,8.3,00000
51.0,43.0,23.0,190,05,01,  Uttar Char Ramani Mohan,1246,5063,672,2584,574,2479,19.7,20.6,18.8,00000
51.0,43.0,75.0,977,01,01,  Uttar Hamchadi,5266,2549,2273,1126,2993,1423,67.4,66.9,67.8,00000
51.0,43.0,75.0,977,02,01,  Kafilatali,1978,538,973,221,1005,317,78.6,81.5,76.0,00000
51.0,43.0,75.0,977,03,01,  Muktarampur,439,92,207,45,232,47,82.7,82.1,83.2,00000
51.0,43.0,75.0,977,04,01,  Charerkandi,339,84,146,45,193,39,80.1,76.4,83.2,00000
51.0,43.0,80.0,302,01,01,  Dilsadpur,520,319,232,140,288,179,62.0,62.4,61.7,00000
51.0,43.0,80.0,302,02,01,  Kalaidpur,301,173,132,82,169,91,63.5,61.7,65.0,00000
51.0,43.0,80.0,605,01,01,  Uttar Makaradhwaj,216,148,89,68,127,80,59.3,56.7,61.4,00000
51.0,43.0,80.0,605,02,01,  Madhya Makaradhwaj,366,472,137,238,229,234,43.7,36.5,49.5,00000
51.0,43.0,80.0,605,03,01,  Dakshin Makaradhwaj,669,704,292,324,377,380,48.7,47.4,49.8,00000
51.0,43.0,80.0,605,04,01,  Ahaladinagar,334,211,147,102,187,109,61.3,59.0,63.2,00000
51.0,43.0,80.0,605,05,01,  Bishnunagar,590,152,232,62,358,90,79.5,78.9,79.9,00000
51.0,43.0,80.0,605,06,01,  Saydabad,243,109,111,44,132,65,69.0,71.6,67.0,00000
51.0,43.0,80.0,718,01,01,  Char Parbatinagar,943,573,455,270,488,303,62.2,62.8,61.7,00000
51.0,43.0,80.0,718,02,01,  Gaybapur,159,161,66,61,93,100,49.7,52.0,48.2,00000
51.0,43.0,80.0,718,03,01,  Kajalipur,505,187,227,84,278,103,73.0,73.0,73.0,00000
51.0,43.0,80.0,718,04,01,  Uttar Krishnapur,275,71,125,34,150,37,79.5,78.6,80.2,00000
51.0,43.0,80.0,718,05,01,  Babupur,447,317,207,153,240,164,58.5,57.5,59.4,00000
51.0,43.0,80.0,718,06,01,  Awganpur,212,65,97,27,115,38,76.5,78.2,75.2,00000
51.0,43.0,80.0,718,07,01,  Krishnapur,243,152,104,69,139,83,61.5,60.1,62.6,00000
51.0,43.0,80.0,718,08,01,  Masim Nagar,319,95,152,34,167,61,77.1,81.7,73.2,00000
51.0,43.0,80.0,718,09,01,  Khilbaysa,319,71,128,25,191,46,81.8,83.7,80.6,00000
51.0,43.0,80.0,718,10,01,  Parbatinagar,337,77,155,26,182,51,81.4,85.6,78.1,00000
51.0,43.0,87.0,181,01,01,  Purba Char Mansa (North),778,1117,390,521,388,596,41.1,42.8,39.4,00000
51.0,43.0,87.0,181,02,01,  Purba Char Mansa (South),571,1662,265,818,306,844,25.6,24.5,26.6,00000
51.0,43.0,90.0,237,01,01,  Nandanpur,3483,1998,1563,901,1920,1097,63.5,63.4,63.6,00000
51.0,43.0,90.0,237,02,01,  Gangapur,2476,1567,1080,704,1396,863,61.2,60.5,61.8,00000
51.0,43.0,90.0,237,03,01,  Dakshin Hamchadi,988,427,443,182,545,245,69.8,70.9,69.0,00000
51.0,58.0,35.0,223,01,01,  Uttar Bolasiakandi,216,90,113,44,103,46,70.6,72.0,69.1,00000
51.0,58.0,35.0,223,02,01,  Gazikandi (Loduea),637,536,287,238,350,298,54.3,54.7,54.0,00000
51.0,58.0,35.0,223,03,01,  Dewankandi,836,445,405,191,431,254,65.3,68.0,62.9,00000
51.0,58.0,35.0,223,04,01,  Barakandi,384,327,163,143,221,184,54.0,53.3,54.6,00000
51.0,58.0,35.0,223,05,01,  Haldarkandi,334,434,135,193,199,241,43.5,41.2,45.2,00000
51.0,58.0,35.0,223,06,01,  Uttar Dalikandi,598,1031,298,498,300,533,36.7,37.4,36.0,00000
51.0,58.0,35.0,223,07,01,  Purba Char Bangshi,981,1565,462,742,519,823,38.5,38.4,38.7,00000
51.0,58.0,35.0,223,08,01,  Paschim Kachiakhali,366,946,172,439,194,507,27.9,28.2,27.7,00000
51.0,58.0,35.0,223,09,01,  Purba Kchiakhali,500,727,227,326,273,401,40.7,41.0,40.5,00000
51.0,58.0,35.0,223,10,01,  Purba Bangshi(Mirdhakandi),434,456,199,227,235,229,48.8,46.7,50.6,00000
51.0,58.0,35.0,223,11,01,  Purba Khasherhat Dobakan,412,184,187,90,225,94,69.1,67.5,70.5,00000
51.0,58.0,35.0,223,12,01,  Paschim Ilishakandi,487,797,231,402,256,395,37.9,36.5,39.3,00000
51.0,58.0,35.0,223,13,01,  Dakshin Naia Para Ghaserha,257,814,117,378,140,436,24.0,23.6,24.3,00000
51.0,58.0,35.0,223,14,01,  Hilar Char,237,566,107,275,130,291,29.5,28.0,30.9,00000
51.0,58.0,35.0,223,15,01,  Kuchiamora,774,2073,324,1028,450,1045,27.2,24.0,30.1,00000
51.0,58.0,35.0,223,16,01,  Amtalipara,214,614,99,295,115,319,25.8,25.1,26.5,00000
51.0,58.0,35.0,223,17,01,  Dakshin Char Bangshi,747,1384,366,665,381,719,35.1,35.5,34.6,00000
51.0,58.0,35.0,223,18,01,  Baburhat Sikdarkandi,237,241,109,125,128,116,49.6,46.6,52.5,00000
51.0,58.0,35.0,548,01,01,  Majhikandi,72,304,25,138,47,166,19.1,15.3,22.1,00000
51.0,58.0,35.0,548,02,01,  Machuakandi,204,313,83,146,121,167,39.5,36.2,42.0,00000
51.0,58.0,35.0,548,03,01,  Gazikandi,224,699,94,334,130,365,24.3,22.0,26.3,00000
51.0,58.0,35.0,548,04,01,  Induria,340,942,129,452,211,490,26.5,22.2,30.1,00000
51.0,58.0,38.0,243,01,01,  U.Char Lakshmi Mridha Kandi,333,577,172,272,161,305,36.6,38.7,34.5,00000
51.0,58.0,38.0,243,02,01,  Michirjang,292,652,143,334,149,318,30.9,30.0,31.9,00000
51.0,58.0,38.0,243,03,01,  Talukdarkandi,343,480,178,226,165,254,41.7,44.1,39.4,00000
51.0,58.0,38.0,243,04,01,  Chabid Beparirkandi,699,966,316,478,383,488,42.0,39.8,44.0,00000
51.0,58.0,38.0,243,05,01,  Akhankandi,307,602,145,291,162,311,33.8,33.3,34.2,00000
51.0,58.0,38.0,243,06,01,  Majhikandi,139,336,66,171,73,165,29.3,27.8,30.7,00000
51.0,58.0,38.0,243,07,01,  Khalifakandi,163,392,82,180,81,212,29.4,31.3,27.6,00000
51.0,58.0,38.0,243,08,01,  Purba Katakhali Khal Laksh,910,1416,444,691,466,725,39.1,39.1,39.1,00000
51.0,58.0,38.0,243,09,01,  Dakshin & Kachia,95,289,52,140,43,149,24.7,27.1,22.4,00000
51.0,58.0,38.0,243,10,01,  Mazir Gaon,155,321,70,159,85,162,32.6,30.6,34.4,00000
51.0,58.0,38.0,609,01,01,  Wikka Kandi,831,1515,419,724,412,791,35.4,36.7,34.2,00000
51.0,58.0,38.0,609,02,01,  Osman Bepari Kandi,477,1706,218,871,259,835,21.9,20.0,23.7,00000
51.0,58.0,38.0,609,03,01,  Sekh Para,543,1485,271,796,272,689,26.8,25.4,28.3,00000
51.0,58.0,38.0,609,04,01,  Wapda Para,341,760,168,375,173,385,31.0,30.9,31.0,00000
51.0,58.0,38.0,609,05,01,  Haldar Kandi,562,916,294,468,268,448,38.0,38.6,37.4,00000
51.0,58.0,38.0,609,06,01,  Mirdha Kandi,467,511,241,250,226,261,47.8,49.1,46.4,00000
51.0,58.0,38.0,609,07,01,  Natun Kachir Char,134,1611,91,832,43,779,7.7,9.9,5.2,00000
51.0,65.0,13.0,196,01,01,  Chandpur,418,495,182,251,236,244,45.8,42.0,49.2,00000
51.0,65.0,13.0,196,02,01,  Paitpur,616,544,261,259,355,285,53.1,50.2,55.5,00000
51.0,65.0,13.0,196,03,01,  Hano Biyas,1080,813,489,371,591,442,57.1,56.9,57.2,00000
51.0,65.0,13.0,790,01,01,  Purba Bhadur,399,252,188,118,211,134,61.3,61.4,61.2,00000
51.0,65.0,13.0,790,02,01,  Madhya Bhadur,1161,1184,489,551,672,633,49.5,47.0,51.5,00000
51.0,65.0,14.0,349,01,01,  Hasimpur,416,200,178,81,238,119,67.5,68.7,66.7,00000
51.0,65.0,14.0,349,02,01,  Kandirpar,475,240,208,107,267,133,66.4,66.0,66.8,00000
51.0,65.0,14.0,545,01,01,  Mamudpur,829,374,354,196,475,178,68.9,64.4,72.7,00000
51.0,65.0,14.0,545,02,01,  Maij Para,645,233,256,117,389,116,73.5,68.6,77.0,00000
51.0,65.0,14.0,545,03,01,  Herapur,664,429,265,186,399,243,60.8,58.8,62.1,00000
51.0,65.0,14.0,545,04,01,  Gustarpar,188,112,77,51,111,61,62.7,60.2,64.5,00000
51.0,65.0,23.0,192,01,01,  Uttar Chandipur,706,719,309,322,397,397,49.5,49.0,50.0,00000
51.0,65.0,23.0,192,02,01,  Dakshin Chandipur,1175,587,550,252,625,335,66.7,68.6,65.1,00000
51.0,65.0,23.0,192,03,01,  Purba Chandipur,2106,1076,965,516,1141,560,66.2,65.2,67.1,00000
51.0,65.0,23.0,192,04,01,  Paschim Chandipur,1817,988,830,433,987,555,64.8,65.7,64.0,00000
51.0,65.0,33.0,228,01,01,  Madhya Darbeshpur,1099,742,438,322,661,420,59.7,57.6,61.1,00000
51.0,65.0,33.0,228,02,01,  Uttar Darbeshpur,1604,698,707,311,897,387,69.7,69.4,69.9,00000
51.0,65.0,33.0,228,03,01,  Purba Darbeshpur,791,547,321,258,470,289,59.1,55.4,61.9,00000
51.0,65.0,33.0,228,04,01,  Dakshin Darbeshpur,994,499,437,214,557,285,66.6,67.1,66.2,00000
51.0,65.0,42.0,168,01,01,  Pachmbigha,1866,1379,816,642,1050,737,57.5,56.0,58.8,00000
51.0,65.0,42.0,168,02,01,  Purba Bigha,2316,1119,961,484,1355,635,67.4,66.5,68.1,00000
51.0,65.0,57.0,425,01,01,  Uttar Kalikapur,1384,246,589,98,795,148,84.9,85.7,84.3,00000
51.0,65.0,57.0,425,02,01,  Dakshin Kalikapur,814,216,361,85,453,131,79.0,80.9,77.6,00000
51.0,73.0,13.0,069,01,03,  Bara Kheri,3833,4816,2005,2317,1828,2499,44.3,46.4,42.2,00000
51.0,73.0,13.0,069,02,03,  Raghunathpur,1947,2270,1023,1077,924,1193,46.2,48.7,43.6,00000
51.0,73.0,23.0,138,01,03,  Ashal Para,2025,2165,1061,1106,964,1059,48.3,49.0,47.7,00000
51.0,73.0,23.0,138,02,03,  Lambakhali,413,292,218,164,195,128,58.6,57.1,60.4,00000
51.0,73.0,23.0,138,03,03,  Sabagram,1855,2560,912,1290,943,1270,42.0,41.4,42.6,00000
51.0,73.0,23.0,138,04,03,  Madya Alexander,1869,2534,962,1184,907,1350,42.4,44.8,40.2,00000
51.0,73.0,23.0,138,05,03,  Char Daktar,1219,1352,613,652,606,700,47.4,48.5,46.4,00000
51.0,73.0,23.0,190,01,01,  Paschim Balur Char,3911,5887,1833,2890,2078,2997,39.9,38.8,40.9,00000
51.0,73.0,23.0,190,02,01,  Dakshin Balur Char,1847,3435,905,1709,942,1726,35.0,34.6,35.3,00000
51.0,73.0,31.0,161,01,01,  Char Algi,2880,2647,1408,1288,1472,1359,52.1,52.2,52.0,00000
51.0,73.0,31.0,161,02,01,  Char Takabi,1328,1008,656,472,672,536,56.8,58.2,55.6,00000
51.0,73.0,65.0,462,01,01,  Madhya Char Kalakopa,1523,4752,686,2092,837,2660,24.3,24.7,23.9,00000
51.0,73.0,65.0,462,02,01,  Purba Kalakopa,1325,2478,631,1192,694,1286,34.8,34.6,35.1,00000
51.0,73.0,87.0,578,01,01,  Uttar Char Mehar,1804,1922,852,962,952,960,48.4,47.0,49.8,00000
51.0,73.0,87.0,578,02,01,  Madhya Char Mehar,1304,1303,599,614,705,689,50.0,49.4,50.6,00000
51.0,73.0,87.0,578,03,01,  Dakshin Purba Char Mehar,1247,1412,623,673,624,739,46.9,48.1,45.8,00000
51.0,73.0,87.0,671,01,01,  Uttar Char Ramiz,1724,1586,808,740,916,846,52.1,52.2,52.0,00000
51.0,73.0,87.0,671,02,01,  Madhya Char Ramiz,1075,2060,513,964,562,1096,34.3,34.7,33.9,00000
51.0,73.0,87.0,671,03,01,  Dakshin Purba Char Ramiz,1221,1970,601,918,620,1052,38.3,39.6,37.1,00000
46.0,43.0,15.0,066,01,01,  Shachindra Karbari Para,110,249,73,119,37,130,30.6,38.0,22.2,00000
46.0,43.0,15.0,066,02,01,  Roka Chandra Karbari Para,238,321,142,156,96,165,42.6,47.7,36.8,00000
46.0,43.0,15.0,066,03,01,  Kandara Kr. Para,130,255,85,116,45,139,33.8,42.3,24.5,00000
46.0,43.0,15.0,066,04,01,  Nutan Ch. Karbari Para,155,290,98,115,57,175,34.8,46.0,24.6,00000
46.0,43.0,15.0,066,05,01,  Rabi Ch.Karbari Para,105,217,73,102,32,115,32.6,41.7,21.8,00000
46.0,43.0,15.0,066,06,01,  Shadep Karbari Para,284,170,155,66,129,104,62.6,70.1,55.4,00000
46.0,43.0,15.0,066,07,01,  Maghya Karbari Para,601,172,336,55,265,117,77.7,85.9,69.4,00000
46.0,43.0,15.0,066,08,01,  Babuchhara Bazar,555,321,295,161,260,160,63.4,64.7,61.9,00000
46.0,43.0,15.0,066,09,01,  Dhadan Karbari Para,552,394,332,161,220,233,58.4,67.3,48.6,00000
46.0,43.0,15.0,066,10,01,  Army Camp (Sub. Zone),89,46,52,16,37,30,65.9,76.5,55.2,00000
46.0,43.0,15.0,198,01,01,  Bagan Kumer Karbari Para,65,118,40,52,25,66,35.5,43.5,27.5,00000
46.0,43.0,15.0,198,02,01,  Gandi Kumear  Kr Para,9,84,8,32,1,52,9.7,20.0,1.9,00000
46.0,43.0,15.0,265,01,01,  Bangalican Karbari Para,30,62,21,29,9,33,32.6,42.0,21.4,00000
46.0,43.0,15.0,265,02,01,  Jogas Chandra Karbari Karba,59,162,38,73,21,89,26.7,34.2,19.1,00000
46.0,43.0,15.0,331,01,01,  Ashini Karbari Para,31,65,26,26,5,39,32.3,50.0,11.4,00000
46.0,43.0,15.0,331,02,01,  Shadu Chandra Karbari Para,17,70,9,34,8,36,19.5,20.9,18.2,00000
46.0,43.0,15.0,331,03,01,  Bouddadhan Karbari Para,8,49,5,20,3,29,14.0,20.0,9.4,00000
46.0,43.0,15.0,331,04,01,  Shyamacharan Karbari Para,142,203,107,91,35,112,41.2,54.0,23.8,00000
46.0,43.0,15.0,331,05,01,  Shadan Chandra Karbari Para,18,63,12,31,6,32,22.2,27.9,15.8,00000
46.0,43.0,15.0,331,06,01,  Chandra Mohan Karbari Para,37,120,29,52,8,68,23.6,35.8,10.5,00000
46.0,43.0,15.0,331,07,01,  Punnyo Joy Karbari Para,20,130,15,66,5,64,13.3,18.5,7.2,00000
46.0,43.0,15.0,397,01,01,  Rupadhan Karbari Para,20,199,16,100,4,99,9.1,13.8,3.9,00000
46.0,43.0,15.0,397,02,01,  Dirandaralal Headman Para,29,185,17,93,12,92,13.6,15.5,11.5,00000
46.0,43.0,15.0,397,03,01,  Kalendra Karbari Para,66,151,45,74,21,77,30.4,37.8,21.4,00000
46.0,43.0,15.0,397,04,01,  Punyo Sen Karbari Para,45,186,33,89,12,97,19.5,27.0,11.0,00000
46.0,43.0,15.0,397,05,01,  Binodkumer Karbaripara (Salu,43,82,26,31,17,51,34.4,45.6,25.0,00000
46.0,43.0,15.0,530,01,01,  Ganjoti Karbari Para,82,125,58,51,24,74,39.6,53.2,24.5,00000
46.0,43.0,15.0,530,02,01,  Bangalichan Karbari Para,38,84,31,37,7,47,31.1,45.6,13.0,00000
46.0,43.0,15.0,530,03,01,  Nandalal Karbari Para,103,124,78,56,25,68,45.4,58.2,26.9,00000
46.0,43.0,15.0,530,04,01,  Nila Ranjan Karbari Para,51,140,33,65,18,75,26.7,33.7,19.4,00000
46.0,43.0,15.0,729,01,01,  Akkashai Karbari Para,28,89,23,38,5,51,23.9,37.7,8.9,00000
46.0,43.0,15.0,729,02,01,  Aralia Mohazan Para,19,146,15,67,4,79,11.5,18.3,4.8,00000
46.0,43.0,15.0,729,03,01,  Gowgadon K.R.Para,104,120,96,45,8,75,46.4,68.1,9.6,00000
46.0,43.0,15.0,862,01,01,  Biddya Kumer Karbari Para,2,33,2,17,0,16,5.7,10.5,0.0,00000
46.0,43.0,15.0,862,02,01,  Kamsing Karbari Para,10,87,8,44,2,43,10.3,15.4,4.4,00000
46.0,43.0,15.0,862,03,01,  Badan Kumer Karbari Para,28,81,17,35,11,46,25.7,32.7,19.3,00000
46.0,43.0,15.0,862,04,01,  Nunchhari D.P.Para,200,292,113,112,87,180,40.7,50.2,32.6,00000
46.0,43.0,15.0,862,05,01,  Sawdhuri Para,159,202,89,92,70,110,44.0,49.2,38.9,00000
46.0,43.0,15.0,862,06,01,  Katu Chandra Karbari Para,149,137,85,53,64,84,52.1,61.6,43.2,00000
46.0,43.0,15.0,862,07,01,  Endara Mani Karbari Para,70,71,43,28,27,43,49.6,60.6,38.6,00000
46.0,43.0,15.0,862,08,01,  Sadan Kumer Karbari Para,16,40,11,22,5,18,28.6,33.3,21.7,00000
46.0,43.0,15.0,862,09,01,  Torit Kanti Karbari Para,59,178,38,84,21,94,24.9,31.1,18.3,00000
46.0,43.0,15.0,862,10,01,  Sura Sen Member Para,94,149,59,66,35,83,38.7,47.2,29.7,00000
46.0,43.0,15.0,970,01,01,  Dewan Para,37,314,34,163,3,151,10.5,17.3,1.9,00000
46.0,43.0,15.0,970,02,01,  Dharas Chandra Karbari Para,22,197,18,99,4,98,10.0,15.4,3.9,00000
46.0,43.0,15.0,970,03,01,  Usha Ram Karbari Para,9,91,7,43,2,48,9.0,14.0,4.0,00000
46.0,43.0,31.0,165,01,03,  Koraytali Para,22,13,13,4,9,9,62.9,76.5,50.0,00000
46.0,43.0,31.0,165,02,03,  3-No Jotha Khamer Para,75,149,54,56,21,93,33.5,49.1,18.4,00000
46.0,43.0,31.0,165,03,03,  Chandara Joy Master Para,237,253,122,116,115,137,48.4,51.3,45.6,00000
46.0,43.0,31.0,165,04,03,  Chitto Mamber Para,118,121,73,49,45,72,49.4,59.8,38.5,00000
46.0,43.0,31.0,165,05,03,  Buddha Para,137,211,94,88,43,123,39.4,51.6,25.9,00000
46.0,43.0,31.0,165,06,03,  Bira Bahu Kr.Para,64,48,34,21,30,27,57.1,61.8,52.6,00000
46.0,43.0,31.0,165,07,03,  Taidu Chara Para,6,87,6,42,0,45,6.5,12.5,0.0,00000
46.0,43.0,31.0,165,08,03,  Mayappha Para,15,48,10,19,5,29,23.8,34.5,14.7,00000
46.0,43.0,31.0,165,09,03,  2-No Jotha Khamer,102,104,58,45,44,59,49.5,56.3,42.7,00000
46.0,43.0,31.0,165,10,03,  Tula Para (Hattoya),155,146,91,58,64,88,51.5,61.1,42.1,00000
46.0,43.0,31.0,165,11,03,  Nila Barankr Para,312,108,169,44,143,64,74.3,79.3,69.1,00000
46.0,43.0,31.0,165,12,03,  Thana Bazar Area,530,165,321,85,209,80,76.3,79.1,72.3,00000
46.0,43.0,31.0,165,13,03,  Pomang Para,97,226,61,101,36,125,30.0,37.7,22.4,00000
46.0,43.0,31.0,165,14,03,  Chappa Para,115,129,61,55,54,74,47.1,52.6,42.2,00000
46.0,43.0,31.0,165,15,03,  Purna Kumer Kr. Para (Adikri),44,51,27,20,17,31,46.3,57.4,35.4,00000
46.0,43.0,31.0,165,16,03,  Rajandara Kr. Para,141,180,90,89,51,91,43.9,50.3,35.9,00000
46.0,43.0,31.0,165,17,03,  Bagirath Para,61,66,35,30,26,36,48.0,53.8,41.9,00000
46.0,43.0,31.0,165,18,03,  Pashim Thana Para,1242,686,671,314,571,372,64.4,68.1,60.6,00000
46.0,43.0,31.0,165,19,03,  Daskin Thana Para College Tila,575,103,287,39,288,64,84.8,88.0,81.8,00000
46.0,43.0,31.0,165,20,03,  1-No Jotha Khamer,77,116,46,54,31,62,39.9,46.0,33.3,00000
46.0,43.0,31.0,165,21,03,  Jamtali,414,285,208,143,206,142,59.2,59.3,59.2,00000
46.0,43.0,31.0,165,22,03,  Eslam Sibir & Anshar Camp,374,141,295,63,79,78,72.6,82.4,50.3,00000
46.0,43.0,31.0,165,23,03,  Headman Para,65,150,39,69,26,81,30.2,36.1,24.3,00000
46.0,43.0,31.0,165,24,03,  Sudir Mambar Para,440,261,235,119,205,142,62.8,66.4,59.1,00000
46.0,43.0,31.0,165,25,03,  Pashim Kataltali (Bazar),787,539,469,269,318,270,59.4,63.6,54.1,00000
46.0,43.0,31.0,165,26,03,  Boalkhali Puran Bazar,426,171,263,72,163,99,71.4,78.5,62.2,00000
46.0,43.0,31.0,165,27,03,  Purba Kataltali Bazar,310,95,165,50,145,45,76.5,76.7,76.3,00000
46.0,43.0,31.0,165,28,03,  Babu Para (Basanta Kr.Para),290,113,149,52,141,61,72.0,74.1,69.8,00000
46.0,43.0,31.0,165,29,03,  Thana Sadar Area,1108,256,597,95,511,161,81.2,86.3,76.0,00000
46.0,43.0,31.0,663,01,01,  Ramratan Karbari Para,102,161,84,66,18,95,38.8,56.0,15.9,00000
46.0,43.0,31.0,663,02,01,  4-No Jotha Kamar,44,246,29,125,15,121,15.2,18.8,11.0,00000
46.0,43.0,31.0,663,03,01,  Katarung Chara,218,190,120,80,98,110,53.4,60.0,47.1,00000
46.0,43.0,31.0,663,04,01,  Battali Para,130,82,71,33,59,49,61.3,68.3,54.6,00000
46.0,43.0,31.0,663,05,01,  Tevang Chhara,195,255,131,103,64,152,43.3,56.0,29.6,00000
46.0,43.0,31.0,663,06,01,  3-No Jotha Kamer,37,191,24,91,13,100,16.2,20.9,11.5,00000
46.0,43.0,31.0,663,07,01,  Nila Ratan Karbari Para,57,172,38,82,19,90,24.9,31.7,17.4,00000
46.0,43.0,31.0,663,08,01,  2-No Jotha Kamer,54,167,35,76,19,91,24.4,31.5,17.3,00000
46.0,43.0,31.0,663,09,01,  Uttar Noka Chara,167,139,100,49,67,90,54.6,67.1,42.7,00000
46.0,43.0,31.0,663,10,01,  Dakhin Noka Chara,67,93,42,39,25,54,41.9,51.9,31.6,00000
46.0,43.0,31.0,663,11,01,  Chandra Monan Karbari Para,107,46,58,15,49,31,69.9,79.5,61.3,00000
46.0,43.0,31.0,663,12,01,  Chadak Chara,64,97,45,46,19,51,39.8,49.5,27.1,00000
46.0,43.0,31.0,663,13,01,  Ranghi Para,70,74,43,29,27,45,48.6,59.7,37.5,00000
46.0,43.0,31.0,663,14,01,  1-No Jotha Kamer,81,179,49,76,32,103,31.2,39.2,23.7,00000
46.0,43.0,31.0,663,15,01,  Surja Mohan Master Para,85,184,51,74,34,110,31.6,40.8,23.6,00000
46.0,43.0,31.0,663,16,01,  Babru Bahan Headman Para,27,132,16,64,11,68,17.0,20.0,13.9,00000
46.0,43.0,31.0,663,17,01,  Karaitali Para,24,13,11,5,13,8,64.9,68.8,61.9,00000
46.0,43.0,31.0,663,18,01,  Shriti Bijoy Karbari Para,25,129,23,55,2,74,16.2,29.5,2.6,00000
46.0,43.0,47.0,464,01,01,  Tarakamohan Karbari Para,92,179,57,81,35,98,33.9,41.3,26.3,00000
46.0,43.0,47.0,464,02,01,  Madu Mangal Karbari Para,62,149,47,64,15,85,29.4,42.3,15.0,00000
46.0,43.0,47.0,464,03,01,  Ratan Manik Karbari Para,111,262,76,104,35,158,29.8,42.2,18.1,00000
46.0,43.0,47.0,464,04,01,  Hangutya Karbari Para,222,352,142,150,80,202,38.7,48.6,28.4,00000
46.0,43.0,47.0,464,05,01,  Jatna Kumer Karbari Para,172,139,98,55,74,84,55.3,64.1,46.8,00000
46.0,43.0,47.0,464,06,01,  Gobinda Karbari Para,238,251,155,106,83,145,48.7,59.4,36.4,00000
46.0,43.0,47.0,464,07,01,  Jamani Mohan Karbari Para,140,82,79,28,61,54,63.1,73.8,53.0,00000
46.0,43.0,47.0,464,08,01,  Hangsha Joy Para,361,291,205,127,156,164,55.4,61.7,48.8,00000
46.0,43.0,47.0,464,09,01,  Udal Bagan,365,578,220,273,145,305,38.7,44.6,32.2,00000
46.0,43.0,47.0,464,10,01,  Chandara Mohan Karbari Para,205,98,117,28,88,70,67.7,80.7,55.7,00000
46.0,43.0,47.0,464,11,01,  Ram Chandra Karbari Para,125,111,68,44,57,67,53.0,60.7,46.0,00000
46.0,43.0,47.0,464,12,01,  Pukur Ghat,393,537,221,240,172,297,42.3,47.9,36.7,00000
46.0,43.0,47.0,464,13,01,  Bara Dham (Uttar),524,224,278,88,246,136,70.1,76.0,64.4,00000
46.0,43.0,47.0,464,14,01,  Sudir Charmen Para(Bardadakkin,189,152,114,57,75,95,55.4,66.7,44.1,00000
46.0,43.0,47.0,464,15,01,  Prabhat Master Para,94,33,49,9,45,24,74.0,84.5,65.2,00000
46.0,43.0,47.0,464,16,01,  Promod Master Para,141,43,71,13,70,30,76.6,84.5,70.0,00000
46.0,43.0,47.0,464,17,01,  Headman Para,223,246,129,91,94,155,47.5,58.6,37.8,00000
46.0,43.0,47.0,464,18,01,  Tukka Karbari Para,127,83,74,31,53,52,60.5,70.5,50.5,00000
46.0,43.0,47.0,464,19,01,  Shanti Ranjan Karbari Para,151,201,97,77,54,124,42.9,55.7,30.3,00000
46.0,43.0,47.0,464,20,01,  Babbru Kumer Ka.Para (Sankola),244,504,135,223,109,281,32.6,37.7,27.9,00000
46.0,43.0,47.0,464,21,01,  Shatyo Jit Karbari Para,69,101,38,42,31,59,40.6,47.5,34.4,00000
46.0,43.0,47.0,464,22,01,  Rashik Mohan Karbari Para,88,121,57,56,31,65,42.1,50.4,32.3,00000
46.0,43.0,47.0,464,23,01,  Fani Vushan Karbari Para,85,174,50,81,35,93,32.8,38.2,27.3,00000
46.0,43.0,47.0,464,24,01,  Punyashur Karbari Para,118,164,70,75,48,89,41.8,48.3,35.0,00000
46.0,43.0,47.0,464,25,01,  Chandara Kumer Karbari Para,42,115,31,49,11,66,26.8,38.8,14.3,00000
46.0,43.0,47.0,464,26,01,  Akkhai Muni Karbari Para,65,151,35,68,30,83,30.1,34.0,26.5,00000
46.0,43.0,47.0,464,27,01,  Dilchan Karbari Para,27,122,19,53,8,69,18.1,26.4,10.4,00000
46.0,43.0,47.0,464,28,01,  Tebirya Chara Para,30,68,17,31,13,37,30.6,35.4,26.0,00000
46.0,43.0,47.0,464,29,01,  Hangsha Dash Karbari Para,51,114,37,42,14,72,30.9,46.8,16.3,00000
46.0,43.0,47.0,464,30,01,  Khula Mani Karbari Para,167,222,117,95,50,127,42.9,55.2,28.2,00000
46.0,43.0,47.0,464,31,01,  Nandyas Sar Karbari Para,154,105,88,39,66,66,59.5,69.3,50.0,00000
46.0,43.0,47.0,464,32,01,  Krepa Nanda Karbari Para,198,176,129,72,69,104,52.9,64.2,39.9,00000
46.0,43.0,63.0,396,01,01,  Rana Sova Kr.Para(Dha Karbari,45,69,30,34,15,35,39.5,46.9,30.0,00000
46.0,43.0,63.0,396,02,01,  Jambura Para,72,149,43,66,29,83,32.6,39.4,25.9,00000
46.0,43.0,63.0,396,03,01,  Kripa Ranjan Kr.Para,18,30,15,12,3,18,37.5,55.6,14.3,00000
46.0,43.0,63.0,396,04,01,  Nalkata (1+2),41,54,20,25,21,29,43.2,44.4,42.0,00000
46.0,43.0,63.0,396,05,01,  Natun Para,6,13,4,5,2,8,31.6,44.4,20.0,00000
46.0,43.0,63.0,396,06,01,  Sukna Chari,40,69,25,31,15,38,36.7,44.6,28.3,00000
46.0,43.0,63.0,396,07,01,  Sukna Bashdaba Adam,16,18,9,8,7,10,47.1,52.9,41.2,00000
46.0,43.0,63.0,396,08,01,  Rajab Chara,86,85,57,25,29,60,50.3,69.5,32.6,00000
46.0,43.0,63.0,396,09,01,  Kajatali Para,20,22,12,10,8,12,47.6,54.5,40.0,00000
46.0,43.0,63.0,396,10,01,  Durgha Karbari Para(Shimul Tal,157,97,94,34,63,63,61.8,73.4,50.0,00000
46.0,43.0,63.0,396,11,01,  Joykumer Karbari Para,310,194,162,87,148,107,61.5,65.1,58.0,00000
46.0,43.0,63.0,396,12,01,  Jora Brege(Kinachan),88,252,68,113,20,139,25.9,37.6,12.6,00000
46.0,43.0,63.0,396,13,01,  Cantonment Area,296,2,275,1,21,1,99.3,99.6,95.5,00000
46.0,43.0,63.0,396,14,01,  Headman Para (Ali Nagar),337,261,184,111,153,150,56.4,62.4,50.5,00000
46.0,43.0,63.0,396,15,01,  Muslim Para,929,829,488,411,441,418,52.8,54.3,51.3,00000
46.0,43.0,63.0,396,16,01,  Uttar Hasinchan Pur,149,428,74,229,75,199,25.8,24.4,27.4,00000
46.0,43.0,63.0,396,17,01,  Daskin Hasinchan Pur,514,366,293,148,221,218,58.4,66.4,50.3,00000
46.0,43.0,63.0,928,01,01,  Jamini Mohan Karbari Para,67,55,43,21,24,34,54.9,67.2,41.4,00000
46.0,43.0,63.0,928,02,01,  Vadamuni Karbari Para,8,134,7,61,1,73,5.6,10.3,1.4,00000
46.0,43.0,63.0,928,03,01,  Dasara Para,64,32,31,15,33,17,66.7,67.4,66.0,00000
46.0,43.0,63.0,928,04,01,  Karipa Pur,429,490,234,215,195,275,46.7,52.1,41.5,00000
46.0,43.0,63.0,928,05,01,  Beria Karbari Para,43,67,28,32,15,35,39.1,46.7,30.0,00000
46.0,43.0,63.0,928,06,01,  Rasha Muni Karbari Para,123,157,72,71,51,86,43.9,50.3,37.2,00000
46.0,43.0,63.0,928,07,01,  Uttar Shantipur,403,225,227,72,176,153,64.2,75.9,53.5,00000
46.0,43.0,63.0,928,08,01,  Dakshin Shantipur(West),375,158,226,54,149,104,70.4,80.7,58.9,00000
46.0,43.0,63.0,928,09,01,  Milonpur,1025,1284,555,600,470,684,44.4,48.1,40.7,00000
46.0,43.0,63.0,928,10,01,  Kabakhali Bazar Area,240,250,137,131,103,119,49.0,51.1,46.4,00000
46.0,43.0,63.0,994,01,01,  Khalkhul Para,143,125,81,49,62,76,53.4,62.3,44.9,00000
46.0,43.0,63.0,994,02,01,  Rabati Karbari Para,55,63,35,25,20,38,46.6,58.3,34.5,00000
46.0,43.0,63.0,994,03,01,  Kajari Mohan Karbari Para,14,104,11,49,3,55,11.9,18.3,5.2,00000
46.0,43.0,63.0,994,04,01,  Pankhaiya Para(Tarabanya),261,311,159,132,102,179,45.6,54.6,36.3,00000
46.0,43.0,63.0,994,05,01,  Lalmohan Karbari Para(N),10,25,7,9,3,16,28.6,43.8,15.8,00000
46.0,43.0,63.0,994,06,01,  Daluchhari,123,247,85,104,38,143,33.2,45.0,21.0,00000
46.0,43.0,63.0,994,07,01,  Guschagram (Pagajay Char),24,68,14,29,10,39,26.1,32.6,20.4,00000
46.0,43.0,79.0,085,01,01,  Haja Para,72,223,53,92,19,131,24.4,36.6,12.7,00000
46.0,43.0,79.0,085,02,01,  Taidu Chara,56,132,37,53,19,79,29.8,41.1,19.4,00000
46.0,43.0,79.0,085,03,01,  Mayapha Para,46,179,25,75,21,104,20.4,25.0,16.8,00000
46.0,43.0,79.0,085,04,01,  Shadhan Mani Para,38,53,19,25,19,28,41.8,43.2,40.4,00000
46.0,43.0,79.0,085,05,01,  Jamtali Bangali Para,430,426,251,184,179,242,50.2,57.7,42.5,00000
46.0,43.0,79.0,085,06,01,  Vairapha Para (Kumud Headmen),84,124,53,51,31,73,40.4,51.0,29.8,00000
46.0,43.0,79.0,085,07,01,  Kalidash Karbari Para,46,178,26,84,20,94,20.5,23.6,17.5,00000
46.0,43.0,79.0,085,08,01,  Milan Karbari Para,67,131,37,63,30,68,33.8,37.0,30.6,00000
46.0,43.0,79.0,085,09,01,  Tapan Karbari Para,115,187,67,78,48,109,38.1,46.2,30.6,00000
46.0,43.0,79.0,085,10,01,  Rati Chandra Karbari Para,21,160,16,73,5,87,11.6,18.0,5.4,00000
46.0,43.0,79.0,085,11,01,  Jalbanda (Jay Ram Karbari),92,372,50,176,42,196,19.8,22.1,17.6,00000
46.0,43.0,79.0,085,12,01,  Lamba Chara (Nirmhlkr),54,162,38,73,16,89,25.0,34.2,15.2,00000
46.0,43.0,79.0,085,13,01,  Gul Chari,175,474,112,225,63,249,27.0,33.2,20.2,00000
46.0,43.0,79.0,085,14,01,  Tara Charan Karbari Para,100,138,52,59,48,79,42.0,46.8,37.8,00000
46.0,43.0,79.0,085,15,01,  Daskin Rasik Nagar,615,899,349,423,266,476,40.6,45.2,35.8,00000
46.0,43.0,79.0,085,16,01,  Uttar Rasiknagar & Arm Pol.Cam,418,404,228,197,190,207,50.9,53.6,47.9,00000
46.0,43.0,79.0,085,17,01,  Bara Merung & Ansar Camp.,968,868,571,427,397,441,52.7,57.2,47.4,00000
46.0,43.0,79.0,085,18,01,  Bacha Marang,279,441,144,206,135,235,38.8,41.1,36.5,00000
46.0,43.0,79.0,085,19,01,  Batchari (Bivuti Karbari),744,810,432,372,312,438,47.9,53.7,41.6,00000
46.0,43.0,79.0,085,20,01,  Balchari Kalachan Mohajan Para,618,922,351,437,267,485,40.1,44.5,35.5,00000
46.0,43.0,79.0,085,21,01,  Madya Boalkhali,695,783,376,354,319,429,47.0,51.5,42.6,00000
46.0,43.0,79.0,085,22,01,  Shanti Lakkhipur (Gopal)Mamber,296,460,166,188,130,272,39.2,46.9,32.3,00000
46.0,43.0,79.0,085,23,01,  Ratanmohan Karbari Para,159,124,110,56,49,68,56.2,66.3,41.9,00000
46.0,43.0,79.0,085,24,01,  Bisnu Karbari Para,173,206,94,85,79,121,45.6,52.5,39.5,00000
46.0,43.0,79.0,085,25,01,  Bindu Barua Para,115,97,67,38,48,59,54.2,63.8,44.9,00000
46.0,43.0,79.0,085,26,01,  Headmen Para (Sudir Para),172,342,103,154,69,188,33.5,40.1,26.8,00000
46.0,43.0,79.0,085,27,01,  Maddya Betchari,366,369,195,180,171,189,49.8,52.0,47.5,00000
46.0,43.0,79.0,215,01,01,  Pagajya Chari,34,74,26,32,8,42,31.5,44.8,16.0,00000
46.0,43.0,79.0,215,02,01,  Babanya Karbari Para,174,331,108,135,66,196,34.5,44.4,25.2,00000
46.0,43.0,79.0,215,03,01,  Anggoda Master Para (H.Men Utt,60,76,36,33,24,43,44.1,52.2,35.8,00000
46.0,43.0,79.0,215,04,01,  Headmen Para Dakin,378,578,211,297,167,281,39.5,41.5,37.3,00000
46.0,43.0,79.0,215,05,01,  Joyanto Bikash Para,60,92,38,41,22,51,39.5,48.1,30.1,00000
46.0,43.0,79.0,215,06,01,  Pradip Chandra Karbari Para,1,15,1,6,0,9,6.3,14.3,0.0,00000
46.0,43.0,79.0,240,01,01,  Bipin Karbari Para(Bazar Area),1416,857,790,361,626,496,62.3,68.6,55.8,00000
46.0,43.0,79.0,240,02,01,  Bara Fera (Shaban Pur),639,499,356,221,283,278,56.2,61.7,50.4,00000
46.0,43.0,79.0,240,03,01,  Purna Chandra Karbari Para,46,79,29,36,17,43,36.8,44.6,28.3,00000
46.0,43.0,79.0,240,04,01,  Nirmal Chandra Karbari Para,99,106,59,48,40,58,48.3,55.1,40.8,00000
46.0,43.0,79.0,240,05,01,  Buban Mohan Karbari Para,56,115,39,51,17,64,32.7,43.3,21.0,00000
46.0,43.0,79.0,240,06,01,  Ranya Para,7,41,7,16,0,25,14.6,30.4,0.0,00000
46.0,43.0,79.0,240,07,01,  Guna Dhar Karbari Para,146,341,101,158,45,183,30.0,39.0,19.7,00000
46.0,43.0,79.0,240,08,01,  Buta Chara,19,79,14,30,5,49,19.4,31.8,9.3,00000
46.0,43.0,79.0,240,09,01,  Birendara Karbari Para,10,55,7,22,3,33,15.4,24.1,8.3,00000
46.0,43.0,79.0,240,10,01,  Shibanga Karbari Para,17,133,11,68,6,65,11.3,13.9,8.5,00000
46.0,43.0,79.0,240,11,01,  Khirendra Karbari Para,38,76,32,32,6,44,33.3,50.0,12.0,00000
46.0,43.0,79.0,240,12,01,  Shorajoy Karbari Para,87,306,51,146,36,160,22.1,25.9,18.4,00000
46.0,43.0,79.0,240,13,01,  Kina Chan Karbari Para,71,152,43,65,28,87,31.8,39.8,24.3,00000
46.0,43.0,79.0,240,14,01,  Fulchan Karbari Para,543,511,310,239,233,272,51.5,56.5,46.1,00000
46.0,43.0,79.0,240,15,01,  Susil Headmen Para,108,97,73,32,35,65,52.7,69.5,35.0,00000
46.0,43.0,79.0,240,16,01,  Murati Mohan Karbari Para,30,80,21,36,9,44,27.3,36.8,17.0,00000
46.0,43.0,79.0,240,17,01,  Angla Mohajan Para,45,82,30,37,15,45,35.4,44.8,25.0,00000
46.0,43.0,79.0,240,18,01,  Lakme Bikash Kr.Para,13,31,11,10,2,21,29.5,52.4,8.7,00000
46.0,43.0,79.0,490,01,01,  Hangrima Chara(Biran Drolal)Kp,36,154,25,70,11,84,18.9,26.3,11.6,00000
46.0,43.0,79.0,490,02,01,  Dhanyama Chara(Biprokanti K.P),43,85,39,39,4,46,33.6,50.0,8.0,00000
46.0,43.0,79.0,490,03,01,  Ktara Pur Para,71,152,45,69,26,83,31.8,39.5,23.9,00000
46.0,43.0,79.0,490,04,01,  Bajapada Chara,54,188,42,80,12,108,22.3,34.4,10.0,00000
46.0,43.0,79.0,490,05,01,  Panchari,162,403,88,230,74,173,28.7,27.7,30.0,00000
46.0,43.0,79.0,490,06,01,  Chahaba Chara,34,67,21,36,13,31,33.7,36.8,29.5,00000
46.0,43.0,79.0,490,07,01,  Badalchhari,6,146,4,71,2,75,3.9,5.3,2.6,00000
46.0,43.0,79.0,490,08,01,  Swodagi Chara,9,67,7,33,2,34,11.8,17.5,5.6,00000
46.0,43.0,79.0,490,09,01,  Pravat Karbari Para,13,90,7,47,6,43,12.6,13.0,12.2,00000
46.0,43.0,79.0,945,01,01,  Rasulpur,87,111,52,52,35,59,43.9,50.0,37.2,00000
46.0,43.0,79.0,945,02,01,  Ranjanmoni Karbari Par,145,380,93,173,52,207,27.6,35.0,20.1,00000
46.0,43.0,79.0,945,03,01,  Joyanta Karbari Para,40,40,28,13,12,27,50.0,68.3,30.8,00000
46.0,43.0,79.0,945,04,01,  Nagajya Karbari Para,72,169,45,73,27,96,29.9,38.1,22.0,00000
46.0,43.0,79.0,945,05,01,  Indra Joy Karbari Para,71,125,40,56,31,69,36.2,41.7,31.0,00000
46.0,43.0,79.0,945,06,01,  Pagla Mohajan Para,23,108,19,49,4,59,17.6,27.9,6.3,00000
46.0,43.0,79.0,945,07,01,  Nala Karbari Para,14,36,8,19,6,17,28.0,29.6,26.1,00000
46.0,43.0,79.0,945,08,01,  Dina Nath Karbari Para,21,250,15,121,6,129,7.7,11.0,4.4,00000
46.0,43.0,79.0,945,09,01,  Daya Mohan Karbari Para,54,121,33,55,21,66,30.9,37.5,24.1,00000
46.0,43.0,79.0,945,10,01,  Kabalo Karbari Para,14,15,10,8,4,7,48.3,55.6,36.4,00000
46.0,43.0,79.0,945,11,01,  Upendra Karbari Para,53,89,36,33,17,56,37.3,52.2,23.3,00000
46.0,43.0,79.0,945,12,01,  Shuk Shanti Karbari Para,122,259,74,118,48,141,32.0,38.5,25.4,00000
46.0,43.0,79.0,945,13,01,  Provat Karbari Para,91,133,45,71,46,62,40.6,38.8,42.6,00000
46.0,43.0,79.0,945,14,01,  John Karbari Para,77,100,40,49,37,51,43.5,44.9,42.0,00000
46.0,43.0,79.0,945,15,01,  Nirod Mohan Karbari Para,61,97,39,44,22,53,38.6,47.0,29.3,00000
46.0,43.0,79.0,945,16,01,  Rong Kumar Karbari Para,28,49,12,25,16,24,36.4,32.4,40.0,00000
46.0,43.0,79.0,945,17,01,  Kamal Krishna Karbari Para,86,54,50,24,36,30,61.4,67.6,54.5,00000
46.0,43.0,79.0,945,18,01,  Surendra Karbari Para,45,66,26,28,19,38,40.5,48.1,33.3,00000
46.0,43.0,79.0,945,19,01,  Bichitara Karbari Para,109,99,58,46,51,53,52.4,55.8,49.0,00000
46.0,43.0,79.0,945,20,01,  Joy Kumer Karbari Para,125,234,84,107,41,127,34.8,44.0,24.4,00000
46.0,43.0,79.0,945,21,01,  Sarno Kumer Karbari Para,117,119,76,48,41,71,49.6,61.3,36.6,00000
46.0,43.0,79.0,945,22,01,  Dakin Rengkajya,233,228,128,101,105,127,50.5,55.9,45.3,00000
46.0,43.0,79.0,945,23,01,  Fariya Karbari Para,142,83,86,36,56,47,63.1,70.5,54.4,00000
46.0,43.0,79.0,945,24,01,  Natun Chandra Karbari Para,80,194,53,91,27,103,29.2,36.8,20.8,00000
46.0,43.0,79.0,945,25,01,  Manik Chandra Karbari Para,60,187,40,86,20,101,24.3,31.7,16.5,00000
46.0,43.0,79.0,945,26,01,  Headmen Para,149,86,84,37,65,49,63.4,69.4,57.0,00000
84.7,46.0,49.0,002,998,02,*Cantonment Area     ,1426,76,1233,40,193,36,94.9,96.9,84.3,00000
46.0,49.0,15.0,153,01,01,  Nabakumar Para,4,83,3,43,1,40,4.6,6.5,2.4,00000
46.0,49.0,15.0,153,02,01,  Almani Para,12,151,12,75,0,76,7.4,13.8,0.0,00000
46.0,49.0,15.0,153,03,01,  Rabidhan Para,21,182,12,95,9,87,10.3,11.2,9.4,00000
46.0,49.0,15.0,153,04,01,  Bara Raitaisa,43,73,26,25,17,48,37.1,51.0,26.2,00000
46.0,49.0,15.0,153,05,01,  Chhota Raitaisa,18,36,8,20,10,16,33.3,28.6,38.5,00000
46.0,49.0,15.0,153,06,01,  Lamba Para,44,50,21,17,23,33,46.8,55.3,41.1,00000
46.0,49.0,15.0,153,07,01,  No-10 Prakalpagram,74,179,44,74,30,105,29.2,37.3,22.2,00000
46.0,49.0,15.0,153,08,01,  Noya Para,91,132,58,59,33,73,40.8,49.6,31.1,00000
46.0,49.0,15.0,153,09,01,  Shib Mondir Noya Para,8,91,7,47,1,44,8.1,13.0,2.2,00000
46.0,49.0,15.0,153,10,01,  Shaim Bari Para,1,48,1,22,0,26,2.0,4.3,0.0,00000
46.0,49.0,15.0,153,11,01,  Headmand Para,81,98,38,45,43,53,45.3,45.8,44.8,00000
46.0,49.0,15.0,153,12,01,  Ivorth Pakujya Chhari,47,58,22,28,25,30,44.8,44.0,45.5,00000
46.0,49.0,15.0,153,13,01,  South Pakujya Chhari,189,62,97,33,92,29,75.3,74.6,76.0,00000
46.0,49.0,15.0,153,14,01,  Garjan Tila,40,106,25,47,15,59,27.4,34.7,20.3,00000
46.0,49.0,15.0,153,15,01,  Bil Para,51,43,30,16,21,27,54.3,65.2,43.8,00000
46.0,49.0,15.0,153,16,01,  Naksatali,56,39,30,18,26,21,58.9,62.5,55.3,00000
46.0,49.0,15.0,153,17,01,  Mrasanai Para,190,273,112,119,78,154,41.0,48.5,33.6,00000
46.0,49.0,15.0,153,18,01,  No-9  Prakalpa,44,167,27,84,17,83,20.9,24.3,17.0,00000
46.0,49.0,15.0,153,19,01,  No-3 Prakalpa Gram,13,38,9,16,4,22,25.5,36.0,15.4,00000
46.0,49.0,15.0,153,20,01,  No-8 Prakalpa,50,187,24,82,26,105,21.1,22.6,19.8,00000
46.0,49.0,15.0,153,21,01,  Dandrakarbari Para,7,143,4,73,3,70,4.7,5.2,4.1,00000
46.0,49.0,15.0,153,22,01,  No-3 New Bagan,17,58,9,30,8,28,22.7,23.1,22.2,00000
46.0,49.0,15.0,153,23,01,  No-4 New Bagan,57,158,33,78,24,80,26.5,29.7,23.1,00000
46.0,49.0,15.0,153,24,01,  Sudhanya Para,4,195,4,92,0,103,2.0,4.2,0.0,00000
46.0,49.0,15.0,153,25,01,  North Muslim Para,93,84,47,43,46,41,52.5,52.2,52.9,00000
46.0,49.0,15.0,153,26,01,  South Muslim Para,226,102,124,43,102,59,68.9,74.3,63.4,00000
46.0,49.0,15.0,153,27,01,  West Muslim Para,125,94,63,38,62,56,57.1,62.4,52.5,00000
46.0,49.0,15.0,153,28,01,  Balar Para,81,102,52,54,29,48,44.3,49.1,37.7,00000
46.0,49.0,15.0,153,29,01,  Baisnab Para,64,26,40,10,24,16,71.1,80.0,60.0,00000
46.0,49.0,15.0,153,30,01,  Purba Muslim Para,146,112,75,58,71,54,56.6,56.4,56.8,00000
46.0,49.0,15.0,153,31,01,  Shantigram,77,54,40,21,37,33,58.8,65.6,52.9,00000
46.0,49.0,15.0,153,32,01,  Dewan Para,201,197,119,85,82,112,50.5,58.3,42.3,00000
46.0,49.0,15.0,153,33,01,  Forestila Tila,71,32,34,15,37,17,68.9,69.4,68.5,00000
46.0,49.0,15.0,153,34,01,  Shikandar Para,65,127,33,62,32,65,33.9,34.7,33.0,00000
46.0,49.0,15.0,153,35,01,  Ratanjoy Para,149,84,79,35,70,49,63.9,69.3,58.8,00000
46.0,49.0,15.0,153,36,01,  Munigram Para,132,67,73,26,59,41,66.3,73.7,59.0,00000
46.0,49.0,15.0,153,37,01,  Madan Mohan Para,25,6,14,1,11,5,80.6,93.3,68.8,00000
46.0,49.0,15.0,153,38,01,  Chitta Ranjan Para,34,36,21,12,13,24,48.6,63.6,35.1,00000
46.0,49.0,15.0,153,39,01,  Shib Mondir Para,13,36,8,14,5,22,26.5,36.4,18.5,00000
46.0,49.0,15.0,153,40,01,  Dhoran Charja Para,41,35,24,14,17,21,53.9,63.2,44.7,00000
46.0,49.0,15.0,153,41,01,  Rabijoy Para,132,145,75,58,57,87,47.7,56.4,39.6,00000
46.0,49.0,15.0,153,42,01,  Ranjan Mani Para,62,100,33,37,29,63,38.3,47.1,31.5,00000
46.0,49.0,15.0,153,43,01,  Akkhi Moni Para,44,22,31,7,13,15,66.7,81.6,46.4,00000
46.0,49.0,15.0,153,44,01,  Chhotanala,146,79,79,26,67,53,64.9,75.2,55.8,00000
46.0,49.0,15.0,153,45,01,  Kuki Chhara,136,127,80,56,56,71,51.7,58.8,44.1,00000
46.0,49.0,15.0,153,46,01,  Prati Bandi Para,37,59,20,27,17,32,38.5,42.6,34.7,00000
46.0,49.0,15.0,153,47,01,  Purna Bijoy Karbari Para,36,41,21,15,15,26,46.8,58.3,36.6,00000
46.0,49.0,15.0,153,49,01,  No-1 Prakalpa Gram (New),54,126,28,51,26,75,30.0,35.4,25.7,00000
46.0,49.0,15.0,153,50,01,  Harigana Para,13,227,10,112,3,115,5.4,8.2,2.5,00000
46.0,49.0,15.0,153,51,01,  No-7 Joutha Khamar,136,87,80,32,56,55,61.0,71.4,50.5,00000
46.0,49.0,15.0,153,52,01,  No-7 Joutha Prakalpa,82,134,51,56,31,78,38.0,47.7,28.4,00000
46.0,49.0,15.0,153,53,01,  No-5 Joutha Khamar,90,169,49,83,41,86,34.7,37.1,32.3,00000
46.0,49.0,15.0,153,54,01,  No-4 Joutha Khamar,79,189,48,90,31,99,29.5,34.8,23.8,00000
46.0,49.0,15.0,153,55,01,  No-3 Prakalpa,83,148,48,67,35,81,35.9,41.7,30.2,00000
46.0,49.0,15.0,153,56,01,  Sajek Para,18,108,10,54,8,54,14.3,15.6,12.9,00000
46.0,49.0,15.0,153,57,01,  Magendra Para,15,162,12,74,3,88,8.5,14.0,3.3,00000
46.0,49.0,15.0,153,58,01,  No-2 Prakalpa Bhan Para,55,80,37,36,18,44,40.7,50.7,29.0,00000
46.0,49.0,15.0,535,01,01,  Amrita Para,149,267,87,124,62,143,35.8,41.2,30.2,00000
46.0,49.0,15.0,535,02,01,  Kumar Dhan Para,160,317,103,140,57,177,33.5,42.4,24.4,00000
46.0,49.0,15.0,535,03,01,  Sadhu Para,18,33,14,11,4,22,35.3,56.0,15.4,00000
46.0,49.0,15.0,535,04,01,  Kajalla Para,102,34,70,12,32,22,75.0,85.4,59.3,00000
46.0,49.0,15.0,535,05,01,  Baura Para,157,64,77,20,80,44,71.0,79.4,64.5,00000
46.0,49.0,15.0,535,06,01,  Mantri Para,80,86,47,24,33,62,48.2,66.2,34.7,00000
46.0,49.0,15.0,535,07,01,  No-2 Prakalpagram,170,207,102,83,68,124,45.1,55.1,35.4,00000
46.0,49.0,15.0,535,08,01,  No-2 Prakalpa,63,98,37,47,26,51,39.1,44.0,33.8,00000
46.0,49.0,15.0,535,09,01,  Noaya Para-1,79,114,47,52,32,62,40.9,47.5,34.0,00000
46.0,49.0,15.0,535,10,01,  Krisna Mohan Para,50,93,33,37,17,56,35.0,47.1,23.3,00000
46.0,49.0,15.0,535,11,01,  Kalaban Para,43,95,31,45,12,50,31.2,40.8,19.4,00000
46.0,49.0,15.0,535,12,01,  Chhotapara,28,168,16,74,12,94,14.3,17.8,11.3,00000
46.0,49.0,15.0,535,13,01,  Tai Kolla Hadeak Para,18,132,14,63,4,69,12.0,18.2,5.5,00000
46.0,49.0,15.0,535,14,01,  Amla Hadeak Para,32,131,20,55,12,76,19.6,26.7,13.6,00000
46.0,49.0,15.0,535,15,01,  Rasta Hadeak Para,19,82,13,35,6,47,18.8,27.1,11.3,00000
46.0,49.0,15.0,535,16,01,  Kaya Para,46,123,33,56,13,67,27.2,37.1,16.3,00000
46.0,49.0,15.0,535,17,01,  Bara Para,41,259,30,116,11,143,13.7,20.5,7.1,00000
46.0,49.0,15.0,535,18,01,  Bijachandra Para,6,129,4,68,2,61,4.4,5.6,3.2,00000
46.0,49.0,15.0,535,19,01,  Simana Para,19,113,11,51,8,62,14.4,17.7,11.4,00000
46.0,49.0,15.0,535,20,01,  Noaya Para-2,30,210,19,98,11,112,12.5,16.2,8.9,00000
46.0,49.0,15.0,765,01,01,  Ranyabari,12,102,9,47,3,55,10.5,16.1,5.2,00000
46.0,49.0,15.0,765,02,01,  Chhota Bari,42,156,30,65,12,91,21.2,31.6,11.7,00000
46.0,49.0,15.0,765,03,01,  Companipara,37,100,23,45,14,55,27.0,33.8,20.3,00000
46.0,49.0,15.0,765,04,01,  North Nal Chhara,143,213,97,90,46,123,40.2,51.9,27.2,00000
46.0,49.0,15.0,765,05,01,  Haridayal Para,85,81,42,38,43,43,51.2,52.5,50.0,00000
46.0,49.0,15.0,765,06,01,  Wayakaf Para,72,137,41,61,31,76,34.4,40.2,29.0,00000
46.0,49.0,15.0,765,07,01,  Surendra Para,101,283,59,130,42,153,26.3,31.2,21.5,00000
46.0,49.0,15.0,765,08,01,  Headmanpara,40,48,19,17,21,31,45.5,52.8,40.4,00000
46.0,49.0,15.0,765,09,01,  Gajendara Karbari Para,37,80,24,44,13,36,31.6,35.3,26.5,00000
46.0,49.0,15.0,765,10,01,  Purnamohan Karbari Para,30,41,20,14,10,27,42.3,58.8,27.0,00000
46.0,49.0,15.0,765,11,01,  Deaba Ranjan Para,39,48,19,23,20,25,44.8,45.2,44.4,00000
46.0,49.0,15.0,765,12,01,  Nirmal Para,79,165,51,70,28,95,32.4,42.1,22.8,00000
46.0,49.0,15.0,765,13,01,  Afruchi Para,51,55,32,24,19,31,48.1,57.1,38.0,00000
46.0,49.0,15.0,765,14,01,  Shimana Para,15,44,9,26,6,18,25.4,25.7,25.0,00000
46.0,49.0,25.0,612,01,03,  Uttar Ganjapara,823,722,446,338,377,384,53.3,56.9,49.5,00000
46.0,49.0,25.0,612,02,03,  Dakshin Ganjapara,673,757,385,381,288,376,47.1,50.3,43.4,00000
46.0,49.0,25.0,612,03,03,  Balpaya Adam,210,56,127,22,83,34,78.9,85.2,70.9,00000
46.0,49.0,25.0,612,04,03,  Bangalkati Para,125,73,74,32,51,41,63.1,69.8,55.4,00000
46.0,49.0,25.0,612,05,03,  Mahal Chhara,81,53,41,24,40,29,60.4,63.1,58.0,00000
46.0,49.0,25.0,612,06,03,  Shila Chhara Rubar Bagan,106,16,80,8,26,8,86.9,90.9,76.5,00000
46.0,49.0,25.0,612,07,03,  Bijoy Karbari Para,227,146,139,49,88,97,60.9,73.9,47.6,00000
46.0,49.0,25.0,612,08,03,  Headman Para,137,98,82,36,55,62,58.3,69.5,47.0,00000
46.0,49.0,25.0,612,09,03,  Kongprue Para,50,43,34,34,16,9,53.8,50.0,64.0,00000
46.0,49.0,25.0,612,10,03,  Lilit Para,140,73,82,23,58,50,65.7,78.1,53.7,00000
46.0,49.0,25.0,612,11,03,  Golabari Tripura Para,271,168,150,59,121,109,61.7,71.8,52.6,00000
46.0,49.0,25.0,612,12,03,  Golabari Marma Para,171,70,94,25,77,45,71.0,79.0,63.1,00000
46.0,49.0,25.0,612,13,03,  Satbhaiya Para,200,362,104,172,96,190,35.6,37.7,33.6,00000
46.0,49.0,25.0,612,14,03,  Joutha Khamar,189,280,118,121,71,159,40.3,49.4,30.9,00000
46.0,49.0,25.0,612,15,03,  Bara Para,200,375,130,159,70,216,34.8,45.0,24.5,00000
46.0,49.0,25.0,612,16,03,  Harinath Para,196,135,121,58,75,77,59.2,67.6,49.3,00000
46.0,49.0,25.0,612,17,03,  Ranga Pani Chhara,114,123,75,51,39,72,48.1,59.5,35.1,00000
46.0,49.0,25.0,612,18,03,  Nutan Para,46,81,32,33,14,48,36.2,49.2,22.6,00000
46.0,49.0,25.0,612,19,03,  Natha Para,12,100,5,51,7,49,10.7,8.9,12.5,00000
46.0,49.0,25.0,612,20,03,  Tanyama Chhara,33,89,18,45,15,44,27.0,28.6,25.4,00000
46.0,49.0,25.0,612,21,03,  Falgun Chhandra Para,16,28,7,12,9,16,36.4,36.8,36.0,00000
46.0,49.0,25.0,612,22,03,  Gayama Hut,69,105,52,52,17,53,39.7,50.0,24.3,00000
46.0,49.0,25.0,612,23,03,  Juropani Chhara,37,46,20,21,17,25,44.6,48.8,40.5,00000
46.0,49.0,25.0,612,24,03,  Bagra Chhara,167,125,94,47,73,78,57.2,66.7,48.3,00000
46.0,49.0,25.0,612,25,03,  Usai Para,31,126,22,63,9,63,19.7,25.9,12.5,00000
46.0,49.0,25.0,612,26,03,  Chhoto Khagra Chhari,11,102,5,54,6,48,9.7,8.5,11.1,00000
46.0,49.0,25.0,612,27,03,  Taibaglai Para,121,114,77,37,44,77,51.5,67.5,36.4,00000
46.0,49.0,25.0,612,28,03,  Jirak Para,8,81,6,35,2,46,9.0,14.6,4.2,00000
46.0,49.0,25.0,612,29,03,  Hemapara,20,81,15,38,5,43,19.8,28.3,10.4,00000
46.0,49.0,47.0,229,01,01,  Kamalchhari Mukh,538,225,297,85,241,140,70.5,77.7,63.3,00000
46.0,49.0,47.0,229,02,01,  Bhuachhari Marma Para,125,64,60,30,65,34,66.1,66.7,65.7,00000
46.0,49.0,47.0,229,03,01,  Lohaman Para,28,24,19,8,9,16,53.8,70.4,36.0,00000
46.0,49.0,47.0,229,04,01,  Akshoy Chhara,33,125,26,62,7,63,20.9,29.5,10.0,00000
46.0,49.0,47.0,229,05,01,  Chhakra Chhara,60,38,40,12,20,26,61.2,76.9,43.5,00000
46.0,49.0,47.0,229,06,01,  Bhowa Chhari Nuton Para,68,93,36,44,32,49,42.2,45.0,39.5,00000
46.0,49.0,47.0,229,07,01,  Ratna Mani Para,58,102,35,42,23,60,36.3,45.5,27.7,00000
46.0,49.0,47.0,229,08,01,  Betchhari Christian Para,279,16,143,3,136,13,94.6,97.9,91.3,00000
46.0,49.0,47.0,229,09,01,  Barnal(Noya)Par,25,53,16,21,9,32,32.1,43.2,22.0,00000
46.0,49.0,47.0,229,10,01,  Betchhari Madhya Para,73,84,44,33,29,51,46.5,57.1,36.3,00000
46.0,49.0,47.0,229,11,01,  Bhuachhari Ghuchhagram(Part)N.,732,736,408,327,324,409,49.9,55.5,44.2,00000
46.0,49.0,47.0,229,12,01,  Bhuachhari Ghuchhagram(Part)S.,264,471,163,209,101,262,35.9,43.8,27.8,00000
46.0,49.0,47.0,229,13,01,  Bhua Chhari Mukh Para,93,75,57,36,36,39,55.4,61.3,48.0,00000
46.0,49.0,47.0,229,14,01,  Betchhari Mukh Para,121,116,67,46,54,70,51.1,59.3,43.5,00000
46.0,49.0,47.0,306,01,01,  Old Headman Para,179,101,113,46,66,55,63.9,71.1,54.5,00000
46.0,49.0,47.0,306,02,01,  Monghlaprue Para,15,20,6,10,9,10,42.9,37.5,47.4,00000
46.0,49.0,47.0,306,03,01,  Datkuopa (Purba Gamaridal,191,88,115,39,76,49,68.5,74.7,60.8,00000
46.0,49.0,47.0,306,04,01,  Madhya Kutuk Chhari,64,85,44,39,20,46,43.0,53.0,30.3,00000
46.0,49.0,47.0,306,05,01,  Edmara Chhara/Para,43,25,27,10,16,15,63.2,73.0,51.6,00000
46.0,49.0,47.0,306,06,01,  Tinkiching (Rangapani Chhara),41,63,24,28,17,35,39.4,46.2,32.7,00000
46.0,49.0,47.0,306,07,01,  Baidya Para,31,35,21,13,10,22,47.0,61.8,31.3,00000
46.0,49.0,47.0,306,08,01,  Uglasing Para,43,67,27,26,16,41,39.1,50.9,28.1,00000
46.0,49.0,47.0,306,09,01,  Datkupya Bangali Para,153,371,74,174,79,197,29.2,29.8,28.6,00000
46.0,49.0,47.0,306,10,01,  Kalibindu Karbari Para,65,73,39,31,26,42,47.1,55.7,38.2,00000
46.0,49.0,47.0,688,01,01,  Betchhari Mukh Para,96,56,58,26,38,30,63.2,69.0,55.9,00000
46.0,49.0,47.0,688,02,01,  Betchhari Joynta Para,163,44,102,23,61,21,78.7,81.6,74.4,00000
46.0,49.0,47.0,688,03,01,  Bichitala Marma Para,343,220,193,92,150,128,60.9,67.7,54.0,00000
46.0,49.0,47.0,688,04,01,  Itchhari Mukh Para,157,91,95,36,62,55,63.3,72.5,53.0,00000
46.0,49.0,47.0,688,05,01,  Itchhari Maddhaya Para,116,82,59,34,57,48,58.6,63.4,54.3,00000
46.0,49.0,47.0,688,06,01,  Itchhari Bhitar Para,193,194,97,80,96,114,49.9,54.8,45.7,00000
46.0,49.0,47.0,688,07,01,  Bet Chhari Christian Para,126,170,77,64,49,106,42.6,54.6,31.6,00000
46.0,49.0,47.0,688,08,01,  Itchhari Akand Karbari Para,72,76,41,25,31,51,48.6,62.1,37.8,00000
46.0,49.0,47.0,841,01,01,  Uper Perachhara,443,371,242,176,201,195,54.4,57.9,50.8,00000
46.0,49.0,47.0,841,02,01,  Khyon Dong Para,166,47,91,15,75,32,77.9,85.8,70.1,00000
46.0,49.0,47.0,841,03,01,  Kamal Chhari Headman Para,92,134,53,58,39,76,40.7,47.7,33.9,00000
46.0,49.0,47.0,841,04,01,  Mangal Chan Para,150,87,87,31,63,56,63.3,73.7,52.9,00000
46.0,49.0,47.0,841,05,01,  Madhu Para,22,43,13,22,9,21,33.8,37.1,30.0,00000
46.0,49.0,47.0,841,06,01,  Jaduram Para,57,46,36,16,21,30,55.3,69.2,41.2,00000
46.0,49.0,47.0,841,07,01,  Rowasaya Para,149,123,88,51,61,72,54.8,63.3,45.9,00000
46.0,49.0,47.0,841,08,01,  Thana Chandra Para(Jt. Khamar),85,132,51,67,34,65,39.2,43.2,34.3,00000
46.0,49.0,47.0,841,09,01,  Pilot Para,184,114,102,92,82,22,61.7,52.6,78.8,00000
46.0,49.0,47.0,841,10,01,  Daya Mohan Para,191,36,97,12,94,24,84.1,89.0,79.7,00000
46.0,49.0,47.0,841,11,01,  Amtali,81,42,44,14,37,28,65.9,75.9,56.9,00000
46.0,49.0,47.0,841,12,01,  Joutha Khamar Para,45,55,21,24,24,31,45.0,46.7,43.6,00000
46.0,49.0,63.0,382,01,01,  Pukur Para,89,17,52,3,37,14,84.0,94.5,72.5,00000
46.0,49.0,63.0,382,02,01,  Char Para,69,14,38,2,31,12,83.1,95.0,72.1,00000
46.0,49.0,63.0,382,03,01,  Kala Para,54,36,34,13,20,23,60.0,72.3,46.5,00000
46.0,49.0,63.0,382,04,01,  Dhalya Tali Para,35,82,17,38,18,44,29.9,30.9,29.0,00000
46.0,49.0,63.0,459,01,01,  Akya Doctor Para,71,53,41,18,30,35,57.3,69.5,46.2,00000
46.0,49.0,63.0,459,02,01,  Rajani Dewani Para,129,69,73,28,56,41,65.2,72.3,57.7,00000
46.0,49.0,63.0,459,03,01,  Sajek Para,43,16,24,8,19,8,72.9,75.0,70.4,00000
46.0,49.0,63.0,459,04,01,  Jatindra Taliukdar Para,134,62,75,26,59,36,68.4,74.3,62.1,00000
46.0,49.0,63.0,459,05,01,  Noapara,26,36,12,16,14,20,41.9,42.9,41.2,00000
46.0,49.0,63.0,459,06,01,  Rajkumar Para(No-2Gargajyach),86,55,49,22,37,33,61.0,69.0,52.9,00000
46.0,49.0,63.0,459,07,01,  Joymani Para(Nirod B.Para),51,31,26,11,25,20,62.2,70.3,55.6,00000
46.0,49.0,63.0,459,08,01,  Fanindra Master Para,47,47,23,25,24,22,50.0,47.9,52.2,00000
46.0,49.0,63.0,459,09,01,  Gamaridhala Headman Para,256,136,140,48,116,88,65.3,74.5,56.9,00000
46.0,49.0,63.0,459,10,01,  Pediapara,86,43,45,20,41,23,66.7,69.2,64.1,00000
46.0,49.0,63.0,459,11,01,  Magistrate Para,119,79,58,32,61,47,60.1,64.4,56.5,00000
46.0,49.0,63.0,459,12,01,  Gamaridhala Bangali Para,160,352,97,184,63,168,31.3,34.5,27.3,00000
46.0,49.0,63.0,918,01,01,  Dakshin Thakurchhara,169,55,101,18,68,37,75.4,84.9,64.8,00000
46.0,49.0,63.0,918,02,01,  Tongi Chhara,104,39,59,11,45,28,72.7,84.3,61.6,00000
46.0,49.0,63.0,918,03,01,  Champa Ghat,222,258,125,127,97,131,46.3,49.6,42.5,00000
46.0,49.0,63.0,918,04,01,  Kyajari Para(Ghat Para),60,30,32,8,28,22,66.7,80.0,56.0,00000
46.0,49.0,63.0,918,05,01,  Akbari,103,70,56,32,47,38,59.5,63.6,55.3,00000
46.0,49.0,63.0,918,06,01,  Sudaung Para(A.K. Para),55,129,27,60,28,69,29.9,31.0,28.9,00000
46.0,49.0,63.0,918,07,01,  Master Para,21,59,10,28,11,31,26.3,26.3,26.2,00000
46.0,49.0,63.0,918,08,01,  Punarbasan Para,48,38,25,18,23,20,55.8,58.1,53.5,00000
46.0,49.0,63.0,918,09,01,  Niyong Karbari Para,106,66,55,31,51,35,61.6,64.0,59.3,00000
46.0,49.0,63.0,918,10,01,  Angya Karbari Para(Rimra Para),71,44,41,19,30,25,61.7,68.3,54.5,00000
46.0,49.0,63.0,918,11,01,  Gidi Para,141,305,85,145,56,160,31.6,37.0,25.9,00000
46.0,49.0,63.0,918,12,01,  No.-1Prakalpa Gram,127,130,72,62,55,68,49.4,53.7,44.7,00000
46.0,49.0,63.0,918,13,01,  Bichi Tala (Bhuban Para),62,158,37,77,25,81,28.2,32.5,23.6,00000
46.0,49.0,63.0,918,14,01,  Surendra Para,76,36,45,13,31,23,67.9,77.6,57.4,00000
46.0,49.0,63.0,918,15,01,  No.-3.Prokalpa Gram,76,191,42,83,34,108,28.5,33.6,23.9,00000
46.0,49.0,63.0,918,16,01,  Head Man Para,46,163,34,66,12,97,22.0,34.0,11.0,00000
46.0,49.0,63.0,918,17,01,  Thali Para,92,194,65,88,27,106,32.2,42.5,20.3,00000
46.0,49.0,63.0,918,18,01,  Tali Bahadur Para,18,38,11,20,7,18,32.1,35.5,28.0,00000
46.0,49.0,63.0,918,19,01,  Pukur Para,27,90,21,39,6,51,23.1,35.0,10.5,00000
46.0,49.0,63.0,918,20,01,  Satiram Para,14,56,10,28,4,28,20.0,26.3,12.5,00000
46.0,49.0,63.0,918,21,01,  No.-2. Prokalpa Gram,86,142,54,70,32,72,37.7,43.5,30.8,00000
46.0,49.0,63.0,918,22,01,  Bhola Para(Aniruddha Para),38,47,22,20,16,27,44.7,52.4,37.2,00000
46.0,49.0,63.0,918,23,01,  Romesh Para,82,103,46,46,36,57,44.3,50.0,38.7,00000
46.0,49.0,63.0,918,24,01,  Kongchai Para,161,104,93,40,68,64,60.8,69.9,51.5,00000
46.0,49.0,63.0,918,25,01,  Nunchari Bangalipara,68,65,44,31,24,34,51.1,58.7,41.4,00000
46.0,49.0,63.0,918,26,01,  Mongram Para,115,79,71,35,44,44,59.3,67.0,50.0,00000
46.0,49.0,75.0,076,01,03,  Bangalkati Para,39,92,19,49,20,43,29.8,27.9,31.7,00000
46.0,49.0,75.0,076,02,03,  Natun Para,3,29,3,15,0,14,9.4,16.7,0.0,00000
46.0,49.0,75.0,076,03,03,  Shankho Mohan Para,6,30,4,14,2,16,16.7,22.2,11.1,00000
46.0,49.0,75.0,076,04,03,  Beltali Para,149,147,105,54,44,93,50.3,66.0,32.1,00000
46.0,49.0,75.0,076,05,03,  Khamar Para Jotho Khamar,157,114,97,34,60,80,57.9,74.0,42.9,00000
46.0,49.0,75.0,076,06,03,  Paltanjoy Para,135,179,77,83,58,96,43.0,48.1,37.7,00000
46.0,49.0,75.0,076,07,03,  Larma Parara,104,91,67,35,37,56,53.3,65.7,39.8,00000
46.0,49.0,75.0,076,08,03,  Chela Chhara,367,309,212,131,155,178,54.3,61.8,46.5,00000
46.0,49.0,75.0,076,09,03,  Achi Para,11,41,6,20,5,21,21.2,23.1,19.2,00000
46.0,49.0,75.0,076,10,03,  Kaptala,9,66,6,28,3,38,12.0,17.6,7.3,00000
46.0,49.0,75.0,076,11,03,  Volanath Para,18,40,11,18,7,22,31.0,37.9,24.1,00000
46.0,49.0,75.0,994,01,03,  Singinala,110,84,58,36,52,48,56.7,61.7,52.0,00000
46.0,49.0,75.0,994,02,03,  No-12 Joutha Khamar,107,139,61,60,46,79,43.5,50.4,36.8,00000
46.0,49.0,75.0,994,03,03,  Nil Kanta Para,368,422,209,175,159,247,46.6,54.4,39.2,00000
46.0,49.0,75.0,994,04,03,  Jubaraj Para,376,155,184,64,192,91,70.8,74.2,67.8,00000
46.0,49.0,75.0,994,05,03,  Head Man Para,461,312,272,144,189,168,59.6,65.4,52.9,00000
46.0,49.0,75.0,994,06,03,  No.-1 Prokalpa Gram,88,165,47,77,41,88,34.8,37.9,31.8,00000
46.0,49.0,75.0,994,07,03,  No.-11Prokalpa Gram,83,138,51,62,32,76,37.6,45.1,29.6,00000
46.0,49.0,75.0,994,08,03,  Bagra Para,129,82,68,38,61,44,61.1,64.2,58.1,00000
46.0,49.0,75.0,994,09,03,  Gulokana Para,63,113,39,50,24,63,35.8,43.8,27.6,00000
46.0,49.0,75.0,994,10,03,  Dayaram Para,91,115,43,51,48,64,44.2,45.7,42.9,00000
46.0,49.0,75.0,994,11,03,  Palukya Para,43,145,27,69,16,76,22.9,28.1,17.4,00000
46.0,49.0,75.0,994,12,03,  Pratap Para,133,110,72,43,61,67,54.7,62.6,47.7,00000
46.0,49.0,75.0,994,13,03,  Agriculture Research,251,61,143,21,108,40,80.4,87.2,73.0,00000
46.0,49.0,75.0,994,14,03,  Tarani Para,6,19,4,7,2,12,24.0,36.4,14.3,00000
46.0,49.0,75.0,994,15,03,  Nutan Para,61,105,28,54,33,51,36.7,34.1,39.3,00000
46.0,49.0,75.0,994,16,03,  Writer Para,232,121,128,53,104,68,65.7,70.7,60.5,00000
46.0,49.0,75.0,994,17,03,  Mongprue Para,34,46,23,15,11,31,42.5,60.5,26.2,00000
46.0,49.0,75.0,994,18,03,  No-4 Joutha Khamar,50,105,28,44,22,61,32.3,38.9,26.5,00000
46.0,49.0,75.0,994,19,03,  No-5 Joutha Khamar,55,60,44,29,11,31,47.8,60.3,26.2,00000
46.0,49.0,75.0,994,20,03,  Kamini Para,51,95,22,48,29,47,34.9,31.4,38.2,00000
46.0,49.0,75.0,994,21,03,  No-13 Joutha Khamar,59,203,37,89,22,114,22.5,29.4,16.2,00000
46.0,49.0,75.0,994,22,03,  Kalapani Chhara,56,126,31,61,25,65,30.8,33.7,27.8,00000
46.0,49.0,75.0,994,23,03,  Chandra Kumar Para,70,106,52,36,18,70,39.8,59.1,20.5,00000
46.0,49.0,75.0,994,24,03,  Kalya Para,63,82,46,35,17,47,43.4,56.8,26.6,00000
46.0,49.0,75.0,994,25,03,  Maiti Para,26,50,18,20,8,30,34.2,47.4,21.1,00000
46.0,49.0,75.0,994,26,03,  9 Mile Bara Gram,69,112,43,54,26,58,38.1,44.3,31.0,00000
46.0,49.0,75.0,994,27,03,  8 Mile Joutha Khamar,116,101,70,38,46,63,53.5,64.8,42.2,00000
46.0,49.0,75.0,994,28,03,  7 Mile Jouth Khamar,99,146,68,58,31,88,40.4,54.0,26.1,00000
46.0,49.0,75.0,994,29,03,  Chhato Gashban,132,187,75,85,57,102,41.4,46.9,35.8,00000
46.0,61.0,23.0,125,01,01,  Kutubchhari Marma Para,29,129,18,63,11,66,18.4,22.2,14.3,00000
46.0,61.0,23.0,125,02,01,  Labhochhari Marma Para,72,125,48,47,24,78,36.5,50.5,23.5,00000
46.0,61.0,23.0,125,03,01,  Kutubchhari Chakma Para,34,142,21,66,13,76,19.3,24.1,14.6,00000
46.0,61.0,23.0,125,04,01,  Batthali Para,26,103,19,47,7,56,20.2,28.8,11.1,00000
46.0,61.0,23.0,125,05,01,  Shilachhari Marma Para,66,116,38,48,28,68,36.3,44.2,29.2,00000
46.0,61.0,23.0,125,06,01,  Binajuri Para,95,335,68,148,27,187,22.1,31.5,12.6,00000
46.0,61.0,23.0,125,07,01,  Narainnachhari Para,34,126,24,57,10,69,21.3,29.6,12.7,00000
46.0,61.0,23.0,125,08,01,  Baghchhari Para,61,105,38,48,23,57,36.7,44.2,28.8,00000
46.0,61.0,23.0,125,09,01,  Barmachhari Mukh Para,53,109,40,48,13,61,32.7,45.5,17.6,00000
46.0,61.0,23.0,125,10,01,  Baidya Para,50,159,25,77,25,82,23.9,24.5,23.4,00000
46.0,61.0,23.0,125,11,01,  Barmachhari Para,69,175,49,79,20,96,28.3,38.3,17.2,00000
46.0,61.0,23.0,125,12,01,  Guichhari Para,16,34,10,14,6,20,32.0,41.7,23.1,00000
46.0,61.0,23.0,125,13,01,  Naiakata Para,23,54,16,24,7,30,29.9,40.0,18.9,00000
46.0,61.0,23.0,620,01,01,  Ultachhari,17,57,11,27,6,30,23.0,28.9,16.7,00000
46.0,61.0,23.0,620,02,01,  Marmachari Para,18,30,14,12,4,18,37.5,53.8,18.2,00000
46.0,61.0,23.0,620,03,01,  Keretkata,53,103,34,45,19,58,34.0,43.0,24.7,00000
46.0,61.0,23.0,620,04,01,  Pekkua Para,81,138,58,57,23,81,37.0,50.4,22.1,00000
46.0,61.0,23.0,620,05,01,  Baratila Para,13,60,7,31,6,29,17.8,18.4,17.1,00000
46.0,61.0,23.0,744,01,01,  Bara Lelang,76,305,45,140,31,165,19.9,24.3,15.8,00000
46.0,61.0,23.0,744,02,01,  Nutan Para,1,72,1,36,0,36,1.4,2.7,0.0,00000
46.0,61.0,23.0,744,03,01,  Batthali Para,24,113,13,47,11,66,17.5,21.7,14.3,00000
46.0,61.0,23.0,744,04,01,  Naraylachhari,1,23,0,12,1,11,4.2,0.0,8.3,00000
46.0,61.0,23.0,744,05,01,  Guichhari,17,94,10,49,7,45,15.3,16.9,13.5,00000
46.0,61.0,23.0,744,06,01,  Dakshin Suknachhari,43,70,28,30,15,40,38.1,48.3,27.3,00000
46.0,61.0,23.0,744,07,01,  Madhya Suknachhari,53,89,36,38,17,51,37.3,48.6,25.0,00000
46.0,61.0,23.0,744,08,01,  Uttar Suknachhari,57,100,34,50,23,50,36.3,40.5,31.5,00000
46.0,61.0,23.0,744,09,01,  Fatri Haja Chhari Para,1,31,1,15,0,16,3.1,6.3,0.0,00000
46.0,61.0,23.0,744,10,01,  Futra Tripura Para,8,79,6,39,2,40,9.2,13.3,4.8,00000
46.0,61.0,23.0,744,11,01,  Kula Chhari Up Para,13,100,10,47,3,53,11.5,17.5,5.4,00000
46.0,61.0,23.0,930,01,01,  Bali Chhari,37,123,25,58,12,65,23.1,30.1,15.6,00000
46.0,61.0,23.0,930,02,01,  Kandap Para,100,205,58,92,42,113,32.8,38.7,27.1,00000
46.0,61.0,23.0,930,03,01,  Purba Hultra,26,31,15,13,11,18,45.6,53.6,37.9,00000
46.0,61.0,23.0,930,04,01,  Futtachhari,29,67,22,32,7,35,30.2,40.7,16.7,00000
46.0,61.0,23.0,930,05,01,  Ultachhari,11,45,10,22,1,23,19.6,31.3,4.2,00000
46.0,61.0,23.0,930,06,01,  Nawkatachhari,10,29,9,12,1,17,25.6,42.9,5.6,00000
46.0,61.0,23.0,930,07,01,  Kalabania,32,60,24,25,8,35,34.8,49.0,18.6,00000
46.0,61.0,23.0,930,08,01,  Muktachhari,48,49,28,24,20,25,49.5,53.8,44.4,00000
46.0,61.0,23.0,930,09,01,  Dewan Para,13,59,9,28,4,31,18.1,24.3,11.4,00000
46.0,61.0,23.0,930,10,01,  Batoya Para,48,33,29,17,19,16,59.3,63.0,54.3,00000
46.0,61.0,23.0,930,11,01,  Tripura Chhari Para,15,38,7,20,8,18,28.3,25.9,30.8,00000
46.0,61.0,23.0,930,12,01,  Dadongachhari Para,43,32,21,17,22,15,57.3,55.3,59.5,00000
46.0,61.0,47.0,062,01,01,  Hazachhari (Master),103,96,67,38,36,58,51.8,63.8,38.3,00000
46.0,61.0,47.0,062,02,01,  Tezendra Karbari Para,16,80,14,36,2,44,16.7,28.0,4.3,00000
46.0,61.0,47.0,062,03,01,  Dighalchhari Para,12,40,8,20,4,20,23.1,28.6,16.7,00000
46.0,61.0,47.0,062,04,01,  Dewan Para,97,134,60,60,37,74,42.0,50.0,33.3,00000
46.0,61.0,47.0,062,05,01,  Batta Para,12,84,7,43,5,41,12.5,14.0,10.9,00000
46.0,61.0,47.0,251,01,01,  Indrajoy Karbari Para,2,87,2,44,0,43,2.2,4.3,0.0,00000
46.0,61.0,47.0,251,02,01,  Karuna Mohan Para,19,199,13,100,6,99,8.7,11.5,5.7,00000
46.0,61.0,47.0,251,03,01,  Headman Para,47,134,37,63,10,71,26.0,37.0,12.3,00000
46.0,61.0,47.0,251,04,01,  Jormani Para,11,128,11,59,0,69,7.9,15.7,0.0,00000
46.0,61.0,47.0,251,05,01,  Madhya Adampara,20,185,16,89,4,96,9.8,15.2,4.0,00000
46.0,61.0,47.0,251,06,01,  Dasar Para,2,36,1,19,1,17,5.3,5.0,5.6,00000
46.0,61.0,47.0,251,07,01,  Tullya Karbari Para,25,137,20,63,5,74,15.4,24.1,6.3,00000
46.0,61.0,47.0,372,01,01,  Magrachhari,27,137,15,64,12,73,16.5,19.0,14.1,00000
46.0,61.0,47.0,372,02,01,  Dullyatali,125,204,83,96,42,108,38.0,46.4,28.0,00000
46.0,61.0,47.0,372,03,01,  Enji Karbari Para,46,82,27,39,19,43,35.9,40.9,30.6,00000
46.0,61.0,47.0,372,04,01,  Nabhanga Para,43,44,30,17,13,27,49.4,63.8,32.5,00000
46.0,61.0,47.0,372,05,01,  Purba Chaillyatali,29,165,20,86,9,79,14.9,18.9,10.2,00000
46.0,61.0,47.0,372,06,01,  Dunga Para,49,183,31,97,18,86,21.1,24.2,17.3,00000
46.0,61.0,47.0,372,07,01,  Paschim Chillyatali,54,139,32,63,22,76,28.0,33.7,22.4,00000
46.0,61.0,47.0,372,08,01,  Arjun Para,52,134,38,62,14,72,28.0,38.0,16.3,00000
46.0,61.0,47.0,434,01,01,  Goba Para,21,74,9,36,12,38,22.1,20.0,24.0,00000
46.0,61.0,47.0,434,02,01,  Bardhona Para,62,149,38,72,24,77,29.4,34.5,23.8,00000
46.0,61.0,47.0,434,03,01,  Guru Bukka,26,97,16,47,10,50,21.1,25.4,16.7,00000
46.0,61.0,47.0,434,04,01,  Batgas Para/Mamber Para,48,67,35,26,13,41,41.7,57.4,24.1,00000
46.0,61.0,47.0,434,05,01,  Kaylash Mohajon Para,96,113,54,52,42,61,45.9,50.9,40.8,00000
46.0,61.0,47.0,434,06,01,  Headman Para,76,241,51,116,25,125,24.0,30.5,16.7,00000
46.0,61.0,47.0,434,07,01,  Tepura Chhari Para,26,72,16,31,10,41,26.5,34.0,19.6,00000
46.0,61.0,47.0,496,01,01,  Mezer Para,139,106,76,43,63,63,56.7,63.9,50.0,00000
46.0,61.0,47.0,496,02,01,  Hazachhari,61,93,35,37,26,56,39.6,48.6,31.7,00000
46.0,61.0,47.0,496,03,01,  Rain Namachhara Para,35,159,22,76,13,83,18.0,22.4,13.5,00000
46.0,61.0,47.0,496,04,01,  Nabhanga Para,28,31,12,13,16,18,47.5,48.0,47.1,00000
46.0,61.0,47.0,496,05,01,  Magaichhari Para,116,109,68,44,48,65,51.6,60.7,42.5,00000
46.0,61.0,47.0,496,06,01,  Kalapani Para,20,75,13,32,7,43,21.1,28.9,14.0,00000
46.0,61.0,47.0,496,07,01,  Magaichhari Guchchhagram,305,360,159,159,146,201,45.9,50.0,42.1,00000
46.0,61.0,47.0,496,08,01,  Natun Para,69,107,37,51,32,56,39.2,42.0,36.4,00000
46.0,61.0,71.0,188,01,01,  Chhota Dhrung Mukh,4,20,3,10,1,10,16.7,23.1,9.1,00000
46.0,61.0,71.0,188,02,01,  Hazachhari,74,103,49,49,25,54,41.8,50.0,31.6,00000
46.0,61.0,71.0,188,03,01,  Shilachhari,111,180,73,71,38,109,38.1,50.7,25.9,00000
46.0,61.0,71.0,188,04,01,  Tongtula Para,31,71,23,33,8,38,30.4,41.1,17.4,00000
46.0,61.0,71.0,188,05,01,  Tripurachhari,0,7,0,2,0,5,0.0,0.0,0.0,00000
46.0,61.0,71.0,188,06,01,  Thaila Para,27,80,17,31,10,49,25.2,35.4,16.9,00000
46.0,61.0,71.0,188,07,01,  Marmachhari,11,24,6,10,5,14,31.4,37.5,26.3,00000
46.0,61.0,71.0,188,08,01,  Suknachhari Mukh Para,1,6,1,3,0,3,14.3,25.0,0.0,00000
46.0,61.0,71.0,188,09,01,  Gargarichhari Para,32,92,23,41,9,51,25.8,35.9,15.0,00000
46.0,61.0,71.0,310,01,01,  Chhota Dhrung Mukh,18,76,13,34,5,42,19.1,27.7,10.6,00000
46.0,61.0,71.0,310,02,01,  Tofazzal Hossain Para,22,53,12,29,10,24,29.3,29.3,29.4,00000
46.0,61.0,71.0,310,03,01,  Mitingachhari Para,21,52,14,24,7,28,28.8,36.8,20.0,00000
46.0,61.0,71.0,310,04,01,  Bidhan Karbari Para,142,188,89,70,53,118,43.0,56.0,31.0,00000
46.0,61.0,71.0,310,05,01,  Dudhia Para,57,76,41,26,16,50,42.9,61.2,24.2,00000
46.0,61.0,71.0,310,06,01,  Haluddya Para,19,53,15,18,4,35,26.4,45.5,10.3,00000
46.0,61.0,71.0,310,07,01,  Raktachhari Para,53,118,33,48,20,70,31.0,40.7,22.2,00000
46.0,61.0,71.0,310,08,01,  Dayamohon Karbari Para,186,378,117,166,69,212,33.0,41.3,24.6,00000
46.0,61.0,71.0,310,09,01,  Gabha Marma,77,122,54,44,23,78,38.7,55.1,22.8,00000
46.0,61.0,71.0,310,10,01,  Badi Mohan Karbari Para,46,33,33,7,13,26,58.2,82.5,33.3,00000
46.0,61.0,71.0,310,11,01,  Jatindra Karbari Para,99,272,70,123,29,149,26.7,36.3,16.3,00000
46.0,61.0,71.0,310,12,01,  Bamchangee Para,38,68,29,31,9,37,35.8,48.3,19.6,00000
46.0,61.0,71.0,558,01,01,  Kalapani Para,33,75,21,41,12,34,30.6,33.9,26.1,00000
46.0,61.0,71.0,558,02,01,  Mahishkata Para,78,111,47,48,31,63,41.3,49.5,33.0,00000
46.0,61.0,71.0,558,03,01,  Mezer Para,82,116,43,53,39,63,41.4,44.8,38.2,00000
46.0,61.0,71.0,558,04,01,  Hatichhara Para,60,102,36,46,24,56,37.0,43.9,30.0,00000
46.0,61.0,71.0,558,05,01,  Bazar Para (1),169,81,111,41,58,40,67.6,73.0,59.2,00000
46.0,61.0,71.0,558,06,01,  Manuram Karbari Para,170,118,109,50,61,68,59.0,68.6,47.3,00000
46.0,61.0,71.0,558,07,01,  Banarkata Mukh Para,30,76,17,34,13,42,28.3,33.3,23.6,00000
46.0,61.0,71.0,558,08,01,  Duduria Para,14,69,9,36,5,33,16.9,20.0,13.2,00000
46.0,61.0,71.0,615,01,03,  Upazilla Para,427,95,261,47,166,48,81.8,84.7,77.6,00000
46.0,61.0,71.0,615,02,03,  Lakshmichhari Guchchhagram &Az,505,131,360,58,145,73,79.4,86.1,66.5,00000
46.0,61.0,71.0,615,03,03,  Bijoy Karbari Para,13,59,11,31,2,28,18.1,26.2,6.7,00000
46.0,61.0,71.0,615,04,03,  Golachhari,8,29,5,12,3,17,21.6,29.4,15.0,00000
46.0,61.0,71.0,615,05,03,  Beltali,132,79,68,39,64,40,62.6,63.6,61.5,00000
46.0,61.0,71.0,615,06,03,  Banarkata Headman,39,91,29,47,10,44,30.0,38.2,18.5,00000
46.0,61.0,71.0,615,07,03,  Banarkata Mukh,43,103,31,46,12,57,29.5,40.3,17.4,00000
46.0,61.0,71.0,615,08,03,  Bangmara Para,13,55,8,29,5,26,19.1,21.6,16.1,00000
46.0,61.0,71.0,806,01,01,  Maramchhari Mukh,65,110,36,43,29,67,37.1,45.6,30.2,00000
46.0,61.0,71.0,806,02,01,  Mura Para,9,70,9,32,0,38,11.4,22.0,0.0,00000
46.0,61.0,71.0,806,03,01,  Pangu Para,21,75,14,37,7,38,21.9,27.5,15.6,00000
46.0,61.0,71.0,806,04,01,  Balakka Para,49,114,37,48,12,66,30.1,43.5,15.4,00000
46.0,61.0,71.0,806,05,01,  Dhaluchhari,19,65,13,26,6,39,22.6,33.3,13.3,00000
46.0,61.0,71.0,868,01,01,  D.P.Para,142,248,67,103,75,145,36.4,39.4,34.1,00000
46.0,61.0,71.0,868,02,01,  Bainna Chholapara,112,197,78,83,34,114,36.2,48.4,23.0,00000
46.0,61.0,71.0,868,03,01,  Guia Para,7,5,6,2,1,3,58.3,75.0,25.0,00000
46.0,61.0,71.0,868,04,01,  Samur Para,52,76,31,37,21,39,40.6,45.6,35.0,00000
46.0,61.0,71.0,868,05,01,  Chakma Para,9,105,7,57,2,48,7.9,10.9,4.0,00000
46.0,61.0,71.0,868,06,01,  Damer Shawtal Para,49,79,41,30,8,49,38.3,57.7,14.0,00000
46.0,61.0,71.0,868,07,01,  Kalapani Para,29,65,15,36,14,29,30.9,29.4,32.6,00000
46.0,61.0,71.0,868,08,01,  Mahishkata Para,59,62,32,28,27,34,48.8,53.3,44.3,00000
46.0,61.0,71.0,868,09,01,  Mongla Para,131,206,88,82,43,124,38.9,51.8,25.7,00000
46.0,61.0,71.0,868,10,01,  Mayurkhil Guchchhagram,405,272,226,120,179,152,59.8,65.3,54.1,00000
46.0,61.0,71.0,868,11,01,  Bipin Para,4,42,3,23,1,19,8.7,11.5,5.0,00000
46.0,61.0,71.0,992,01,01,  Dasar Para,5,81,5,43,0,38,5.8,10.4,0.0,00000
46.0,61.0,71.0,992,02,01,  Jatra Mohan Para,11,38,7,24,4,14,22.4,22.6,22.2,00000
46.0,61.0,71.0,992,03,01,  Hatichhara Para,3,54,2,25,1,29,5.3,7.4,3.3,00000
46.0,61.0,71.0,992,04,01,  Indra Sukna Chari,6,45,4,21,2,24,11.8,16.0,7.7,00000
46.0,61.0,71.0,992,05,01,  Shukna Char Dewan Para,34,198,27,86,7,112,14.7,23.9,5.9,00000
46.0,65.0,15.0,382,01,01,  Kayangghat,209,202,119,93,90,109,50.9,56.1,45.2,00000
46.0,65.0,15.0,382,02,01,  Dabapata Para,79,123,44,57,35,66,39.1,43.6,34.7,00000
46.0,65.0,15.0,382,03,01,  Ranga Pangchhara,181,96,115,38,66,58,65.3,75.2,53.2,00000
46.0,65.0,15.0,382,04,01,  Kalabanana Para,71,139,48,75,23,64,33.8,39.0,26.4,00000
46.0,65.0,15.0,382,05,01,  Hajachhara,81,65,48,31,33,34,55.5,60.8,49.3,00000
46.0,65.0,15.0,382,06,01,  Satgaria Para,164,106,89,43,75,63,60.7,67.4,54.3,00000
46.0,65.0,15.0,382,07,01,  Karalla Chari Muk,196,279,125,127,71,152,41.3,49.6,31.8,00000
46.0,65.0,15.0,382,08,01,  Sharat Kumar Member Para,100,93,58,32,42,61,51.8,64.4,40.8,00000
46.0,65.0,15.0,382,09,01,  Karalla Chari Vitor Para/Headm,129,175,79,75,50,100,42.4,51.3,33.3,00000
46.0,65.0,15.0,382,10,01,  Jaduganala,146,279,82,136,64,143,34.4,37.6,30.9,00000
46.0,65.0,15.0,382,11,01,  Purba Manikchari,109,95,51,45,58,50,53.4,53.1,53.7,00000
46.0,65.0,15.0,382,13,01,  Ultachari Madha Para,99,142,66,64,33,78,41.1,50.8,29.7,00000
46.0,65.0,15.0,382,14,01,  Golak Para,59,153,37,80,22,73,27.8,31.6,23.2,00000
46.0,65.0,15.0,382,15,01,  Kayangghat Guchchhagram,310,540,177,254,133,286,36.5,41.1,31.7,00000
46.0,65.0,15.0,382,16,01,  Dela Para,34,80,23,33,11,47,29.8,41.1,19.0,00000
46.0,65.0,15.0,382,17,01,  Lambba Para,54,72,35,26,19,46,42.9,57.4,29.2,00000
46.0,65.0,15.0,382,18,01,  Ultachari Bihar Para,82,81,53,42,29,39,50.3,55.8,42.6,00000
46.0,65.0,15.0,382,19,01,  Shatgar Para,21,117,19,50,2,67,15.2,27.5,2.9,00000
46.0,65.0,15.0,994,01,01,  Dhindra Headman Para,79,107,42,53,37,54,42.5,44.2,40.7,00000
46.0,65.0,15.0,994,02,01,  Chairman Para,97,56,48,25,49,31,63.4,65.8,61.3,00000
46.0,65.0,15.0,994,03,01,  Bakunta Para,163,254,104,135,59,119,39.1,43.5,33.1,00000
46.0,65.0,15.0,994,04,01,  Kalapouna Para,22,44,12,19,10,25,33.3,38.7,28.6,00000
46.0,65.0,15.0,994,05,01,  Subal Krista Para & (R.K.P),67,142,45,65,22,77,32.1,40.9,22.2,00000
46.0,65.0,15.0,994,06,01,  Marbari Para,27,69,19,29,8,40,28.1,39.6,16.7,00000
46.0,65.0,15.0,994,07,01,  Noya Para,3,33,1,16,2,17,8.3,5.9,10.5,00000
46.0,65.0,15.0,994,08,01,  Lamba Para,28,109,23,40,5,69,20.4,36.5,6.8,00000
46.0,65.0,15.0,994,09,01,  Ultachari Bihar Para,37,38,20,17,17,21,49.3,54.1,44.7,00000
46.0,65.0,15.0,994,10,01,  Dadkauppa Mogpara/Modhya,4,46,2,25,2,21,8.0,7.4,8.7,00000
46.0,65.0,15.0,994,11,01,  Ultachari Modha Para,76,63,43,27,33,36,54.7,61.4,47.8,00000
46.0,65.0,15.0,994,12,01,  Golack Para,56,67,35,30,21,37,45.5,53.8,36.2,00000
46.0,65.0,31.0,076,01,01,  Roaza Para,28,136,19,61,9,75,17.1,23.8,10.7,00000
46.0,65.0,31.0,076,02,01,  Headman Para,211,517,112,243,99,274,29.0,31.5,26.5,00000
46.0,65.0,31.0,076,03,01,  Chongrachari Much,37,73,24,35,13,38,33.6,40.7,25.5,00000
46.0,65.0,31.0,076,04,01,  Neronjan Para,93,120,51,56,42,64,43.7,47.7,39.6,00000
46.0,65.0,31.0,076,05,01,  Chitta Kumar Karbari Para,94,87,58,35,36,52,51.9,62.4,40.9,00000
46.0,65.0,31.0,076,06,01,  Hatdopa Para,48,114,27,53,21,61,29.6,33.8,25.6,00000
46.0,65.0,31.0,076,07,01,  Mahajan Para,125,220,69,107,56,113,36.2,39.2,33.1,00000
46.0,65.0,31.0,076,08,01,  Changrachhari Guchchhagram,424,663,237,333,187,330,39.0,41.6,36.2,00000
46.0,65.0,31.0,076,09,01,  Shanti Nagar,60,251,27,126,33,125,19.3,17.6,20.9,00000
46.0,65.0,31.0,076,10,01,  Adarsha Para,36,102,18,51,18,51,26.1,26.1,26.1,00000
46.0,65.0,31.0,076,11,01,  Khirise Chandra Para,21,61,13,33,8,28,25.6,28.3,22.2,00000
46.0,65.0,31.0,229,01,01,  Rajranjan Para,97,98,60,36,37,62,49.7,62.5,37.4,00000
46.0,65.0,31.0,229,02,01,  Bhuyar Tek,80,83,47,37,33,46,49.1,56.0,41.8,00000
46.0,65.0,31.0,229,03,01,  Durpar Joyanal,19,29,12,12,7,17,39.6,50.0,29.2,00000
46.0,65.0,31.0,229,04,01,  Durpar Joyanal Poshim Para,80,118,41,57,39,61,40.4,41.8,39.0,00000
46.0,65.0,31.0,229,05,01,  Gada Chhara,6,24,4,11,2,13,20.0,26.7,13.3,00000
46.0,65.0,31.0,459,01,01,  Mahendra Para/Bimal,36,69,18,35,18,34,34.3,34.0,34.6,00000
46.0,65.0,31.0,459,02,01,  Hemanta Para,52,70,35,32,17,38,42.6,52.2,30.9,00000
46.0,65.0,31.0,459,03,01,  Hemaranjan Para,82,99,50,46,32,53,45.3,52.1,37.6,00000
46.0,65.0,31.0,459,04,01,  Basanta Para,42,118,25,62,17,56,26.3,28.7,23.3,00000
46.0,65.0,31.0,459,05,01,  Joysingh Para,40,23,22,10,18,13,63.5,68.8,58.1,00000
46.0,65.0,31.0,459,06,01,  Headman Para,183,121,106,49,77,72,60.2,68.4,51.7,00000
46.0,65.0,31.0,841,01,03,  Baje Chara,23,32,11,13,12,19,41.8,45.8,38.7,00000
46.0,65.0,31.0,841,02,03,  Haza Chara,53,61,28,26,25,35,46.5,51.9,41.7,00000
46.0,65.0,31.0,841,03,03,  Chakma Para,12,64,9,31,3,33,15.8,22.5,8.3,00000
46.0,65.0,31.0,841,04,03,  Dumani Ghat,72,180,44,89,28,91,28.6,33.1,23.5,00000
46.0,65.0,31.0,841,05,03,  Durchari,50,64,32,25,18,39,43.9,56.1,31.6,00000
46.0,65.0,31.0,841,06,03,  Narayan Karbari Para,69,107,41,44,28,63,39.2,48.2,30.8,00000
46.0,65.0,31.0,841,07,03,  Zautha Khamar Para,28,49,17,20,11,29,36.4,45.9,27.5,00000
46.0,65.0,31.0,841,08,03,  Mura Para,96,162,59,67,37,95,37.2,46.8,28.0,00000
46.0,65.0,31.0,841,09,03,  Babu Para,218,161,102,63,116,98,57.5,61.8,54.2,00000
46.0,65.0,31.0,841,10,03,  Lohed Baran Para,78,40,55,12,23,28,66.1,82.1,45.1,00000
46.0,65.0,31.0,841,11,03,  24-Mile,52,69,32,34,20,35,43.0,48.5,36.4,00000
46.0,65.0,31.0,841,12,03,  Thali Para,218,278,127,123,91,155,44.0,50.8,37.0,00000
46.0,65.0,31.0,841,13,03,  A.P.Bn,810,32,661,14,149,18,96.2,97.9,89.2,00000
46.0,65.0,31.0,841,14,03,  Comilla Tila,117,79,55,45,62,34,59.7,55.0,64.6,00000
46.0,65.0,31.0,841,15,03,  Depalo Chairman Para,273,172,146,69,127,103,61.3,67.9,55.2,00000
46.0,65.0,31.0,841,16,03,  18-Paribar,52,33,25,12,27,21,61.2,67.6,56.3,00000
46.0,65.0,31.0,841,17,03,  Shapan Dr.Para,82,86,53,40,29,46,48.8,57.0,38.7,00000
46.0,65.0,31.0,841,18,03,  Manik Doctor Para,58,20,36,3,22,17,74.4,92.3,56.4,00000
46.0,65.0,31.0,841,19,03,  Natun Para,139,336,71,160,68,176,29.3,30.7,27.9,00000
46.0,65.0,31.0,841,20,03,  Mohammadpur,163,116,95,52,68,64,58.4,64.6,51.5,00000
46.0,65.0,31.0,841,21,03,  T & T Para/Zone(Reserve Area),343,241,269,119,74,122,58.7,69.3,37.8,00000
46.0,65.0,31.0,841,22,03,  Milanpur,155,88,86,39,69,49,63.8,68.8,58.5,00000
46.0,65.0,31.0,841,23,03,  Bazar Para,390,93,234,46,156,47,80.7,83.6,76.8,00000
46.0,65.0,31.0,841,24,03,  Borowa Para,81,27,44,11,37,16,75.0,80.0,69.8,00000
46.0,65.0,31.0,841,25,03,  Tila Para,330,39,166,15,164,24,89.4,91.7,87.2,00000
46.0,65.0,31.0,841,26,03,  Ulapro Chairman Para,61,10,37,2,24,8,85.9,94.9,75.0,00000
46.0,65.0,31.0,841,27,03,  Ramesu Karbari Para,123,14,69,3,54,11,89.8,95.8,83.1,00000
46.0,65.0,31.0,841,28,03,  Ajit Master Para,135,20,68,8,67,12,87.1,89.5,84.8,00000
46.0,65.0,31.0,841,29,03,  Sylheti Para,223,177,139,76,84,101,55.8,64.7,45.4,00000
46.0,65.0,31.0,841,30,03,  Chittragong Para,148,65,76,30,72,35,69.5,71.7,67.3,00000
46.0,65.0,31.0,841,31,03,  Khamar Para,36,52,23,22,13,30,40.9,51.1,30.2,00000
46.0,65.0,31.0,841,32,03,  Thana Para,71,9,45,3,26,6,88.8,93.8,81.3,00000
46.0,65.0,31.0,841,33,03,  Dulal Chow. Para,61,28,31,16,30,12,68.5,66.0,71.4,00000
46.0,65.0,31.0,841,34,03,  Pahartali,256,112,145,44,111,68,69.6,76.7,62.0,00000
46.0,65.0,31.0,841,35,03,  Shawmill Para,67,11,34,2,33,9,85.9,94.4,78.6,00000
46.0,65.0,31.0,841,36,03,  Mahalchari/Narssary Para,165,73,93,35,72,38,69.3,72.7,65.5,00000
46.0,65.0,31.0,841,37,03,  Hospital Area,85,25,48,11,37,14,77.3,81.4,72.5,00000
46.0,65.0,31.0,841,38,03,  Murapara Zauth Khamer,42,152,24,65,18,87,21.6,27.0,17.1,00000
46.0,65.0,47.0,535,01,01,  L0ngdukia Para,1,102,1,51,0,51,1.0,1.9,0.0,00000
46.0,65.0,47.0,535,02,01,  Posshim Kayangghat,120,106,74,41,46,65,53.1,64.3,41.4,00000
46.0,65.0,47.0,535,03,01,  Shapro K. Para.,93,22,49,9,44,13,80.9,84.5,77.2,00000
46.0,65.0,47.0,535,04,01,  Rabichandra Karbari Para,73,33,46,9,27,24,68.9,83.6,52.9,00000
46.0,65.0,47.0,535,05,01,  Paysha Mohajan Para,50,77,29,37,21,40,39.4,43.9,34.4,00000
46.0,65.0,47.0,535,06,01,  Chairman Para,55,35,33,8,22,27,61.1,80.5,44.9,00000
46.0,65.0,47.0,535,07,01,  Pata Pur,47,43,23,19,24,24,52.2,54.8,50.0,00000
46.0,65.0,47.0,535,08,01,  Kating Tila,116,187,62,98,54,89,38.3,38.8,37.8,00000
46.0,65.0,47.0,535,09,01,  Bardanala Para,250,532,143,236,107,296,32.0,37.7,26.6,00000
46.0,65.0,47.0,535,10,01,  Modha Lamu Chari Guchchha Gram,143,221,81,88,62,133,39.3,47.9,31.8,00000
46.0,65.0,47.0,535,11,01,  Zamtra Nath K- Para,98,78,55,33,43,45,55.7,62.5,48.9,00000
46.0,65.0,47.0,535,12,01,  Pakujachhari Guchchhagram,124,296,71,151,53,145,29.5,32.0,26.8,00000
46.0,65.0,47.0,535,13,01,  Lemuchari Vitor Para,93,120,62,49,31,71,43.7,55.9,30.4,00000
46.0,65.0,47.0,535,14,01,  Lemuchari East Para,131,116,77,35,54,81,53.0,68.8,40.0,00000
46.0,65.0,47.0,535,15,01,  Deppachari Para,7,63,4,31,3,32,10.0,11.4,8.6,00000
46.0,65.0,47.0,535,16,01,  Jamtala-C-Para,33,83,17,36,16,47,28.4,32.1,25.4,00000
46.0,65.0,47.0,535,17,01,  Gangamachara,43,69,23,32,20,37,38.4,41.8,35.1,00000
46.0,65.0,47.0,535,18,01,  Kalabaniya Chara,13,28,8,12,5,16,31.7,40.0,23.8,00000
46.0,65.0,47.0,535,19,01,  Rashedhan T.Para,13,187,6,91,7,96,6.5,6.2,6.8,00000
46.0,65.0,47.0,535,20,01,  Golak Para,45,125,30,64,15,61,26.5,31.9,19.7,00000
46.0,65.0,47.0,535,21,01,  Bala Ram K.P.Para,47,86,31,38,16,48,35.3,44.9,25.0,00000
46.0,65.0,47.0,535,22,01,  Joysen Para (South),128,214,61,98,67,116,37.4,38.4,36.6,00000
46.0,65.0,47.0,535,23,01,  Joysen Muslim Para,360,313,207,148,153,165,53.5,58.3,48.1,00000
46.0,65.0,47.0,535,24,01,  Ahathau Para,55,64,36,30,19,34,46.2,54.5,35.8,00000
46.0,65.0,47.0,612,01,01,  Hajachhara,4,96,4,44,0,52,4.0,8.3,0.0,00000
46.0,65.0,47.0,612,02,01,  Narandri K Para,10,57,4,18,6,39,14.9,18.2,13.3,00000
46.0,65.0,47.0,612,03,01,  Paindhaya Sing Para,27,68,16,34,11,34,28.4,32.0,24.4,00000
46.0,65.0,47.0,612,04,01,  Joysen Para,45,105,24,45,21,60,30.0,34.8,25.9,00000
46.0,65.0,47.0,612,05,01,  Badi Khola,6,57,3,29,3,28,9.5,9.4,9.7,00000
46.0,65.0,47.0,612,06,01,  Sathi Para,12,61,11,25,1,36,16.4,30.6,2.7,00000
46.0,65.0,47.0,612,07,01,  Balram Para,51,123,28,52,23,71,29.3,35.0,24.5,00000
46.0,65.0,47.0,612,08,01,  Bali Para,89,171,61,86,28,85,34.2,41.5,24.8,00000
46.0,65.0,47.0,612,09,01,  Lamba Chari,13,56,9,27,4,29,18.8,25.0,12.1,00000
46.0,65.0,47.0,612,10,01,  Chowdhury Para,161,186,88,80,73,106,46.4,52.4,40.8,00000
46.0,65.0,47.0,612,11,01,  Khirood Karbari Para,59,67,36,31,23,36,46.8,53.7,39.0,00000
46.0,65.0,47.0,612,12,01,  Nunchhari Guchchhagram,464,430,239,214,225,216,51.9,52.8,51.0,00000
46.0,65.0,47.0,612,13,01,  Maischhari Guchchhagram,256,220,124,111,132,109,53.8,52.8,54.8,00000
46.0,65.0,47.0,612,14,01,  Zautho Khamer Noapara,118,91,62,37,56,54,56.5,62.6,50.9,00000
46.0,65.0,47.0,612,15,01,  Rabi Chandra K. Para,67,42,41,17,26,25,61.5,70.7,51.0,00000
46.0,65.0,47.0,612,16,01,  Madabsing Para (Tituli Para),16,56,11,25,5,31,22.2,30.6,13.9,00000
46.0,65.0,47.0,612,17,01,  Pasu Karbari Para,133,47,94,18,39,29,73.9,83.9,57.4,00000
46.0,65.0,47.0,612,18,01,  Bazar Para,300,81,174,44,126,37,78.7,79.8,77.3,00000
46.0,65.0,63.0,688,01,01,  Haza Chara,74,125,45,64,29,61,37.2,41.3,32.2,00000
46.0,65.0,63.0,688,02,01,  Karallachhari,247,155,148,64,99,91,61.4,69.8,52.1,00000
46.0,65.0,63.0,688,03,01,  Madhya Adam Para,59,106,36,46,23,60,35.8,43.9,27.7,00000
46.0,65.0,63.0,688,04,01,  Shalban,29,94,18,46,11,48,23.6,28.1,18.6,00000
46.0,65.0,63.0,688,05,01,  Manartek Para,394,282,226,109,168,173,58.3,67.5,49.3,00000
46.0,65.0,63.0,688,06,01,  Mahamuni Para,376,270,209,117,167,153,58.2,64.1,52.2,00000
46.0,65.0,63.0,688,07,01,  Headman Para,279,192,153,85,126,107,59.2,64.3,54.1,00000
46.0,65.0,63.0,688,08,01,  Khangsha Para,171,218,89,97,82,121,44.0,47.8,40.4,00000
46.0,65.0,63.0,688,09,01,  Harika Para,28,78,14,42,14,36,26.4,25.0,28.0,00000
46.0,65.0,63.0,688,10,01,  Khullang Para,197,157,108,69,89,88,55.6,61.0,50.3,00000
46.0,65.0,63.0,688,11,01,  Digal Chari,36,123,24,55,12,68,22.6,30.4,15.0,00000
46.0,65.0,63.0,688,12,01,  Adupa Para,58,95,32,41,26,54,37.9,43.8,32.5,00000
46.0,65.0,63.0,688,13,01,  Khammer Para,29,52,19,22,10,30,35.8,46.3,25.0,00000
46.0,65.0,63.0,688,14,01,  Kala Banna Chara,10,36,7,18,3,18,21.7,28.0,14.3,00000
46.0,65.0,63.0,688,15,01,  Baghmara,146,159,89,69,57,90,47.9,56.3,38.8,00000
46.0,65.0,63.0,688,16,01,  Dhanpata Para,101,99,58,45,43,54,50.5,56.3,44.3,00000
46.0,65.0,63.0,688,17,01,  Edwkul Chara,49,119,28,59,21,60,29.2,32.2,25.9,00000
46.0,65.0,63.0,688,18,01,  Khularam Para,196,267,113,120,83,147,42.3,48.5,36.1,00000
46.0,65.0,63.0,688,19,01,  Ranga Pani Chara,27,34,17,18,10,16,44.3,48.6,38.5,00000
46.0,65.0,63.0,688,20,01,  Kaptai Para,184,139,104,62,80,77,57.0,62.7,51.0,00000
46.0,65.0,63.0,688,21,01,  Meshine Para,38,32,19,12,19,20,54.3,61.3,48.7,00000
46.0,65.0,63.0,688,22,01,  Longdukka Para,19,66,9,39,10,27,22.4,18.8,27.0,00000
46.0,65.0,63.0,688,23,01,  Laba Para,21,87,14,40,7,47,19.4,25.9,13.0,00000
46.0,65.0,63.0,688,24,01,  Dewan Chhara,43,39,25,18,18,21,52.4,58.1,46.2,00000
46.0,65.0,63.0,688,25,01,  Mog Chhara,14,35,10,18,4,17,28.6,35.7,19.0,00000
46.0,65.0,79.0,153,01,01,  Chhota Pilak Para,14,93,9,46,5,47,13.1,16.4,9.6,00000
46.0,65.0,79.0,153,02,01,  Singha Para,20,106,13,46,7,60,15.9,22.0,10.4,00000
46.0,65.0,79.0,153,03,01,  Mohazan Para,42,108,30,45,12,63,28.0,40.0,16.0,00000
46.0,65.0,79.0,153,04,01,  Bazar Para,68,78,56,40,12,38,46.6,58.3,24.0,00000
46.0,65.0,79.0,153,05,01,  Chakma Bhita,27,88,19,39,8,49,23.5,32.8,14.0,00000
46.0,65.0,79.0,153,06,01,  Bagan Bari,21,122,10,62,11,60,14.7,13.9,15.5,00000
46.0,65.0,79.0,153,07,01,  Dhurong Para,65,172,38,78,27,94,27.4,32.8,22.3,00000
46.0,65.0,79.0,153,08,01,  Chairman Para,57,128,36,60,21,68,30.8,37.5,23.6,00000
46.0,65.0,79.0,153,09,01,  Chowdhury Para/Dabel Chari,54,108,34,53,20,55,33.3,39.1,26.7,00000
46.0,65.0,79.0,153,10,01,  Baroy Chari Para,38,169,23,78,15,91,18.4,22.8,14.2,00000
46.0,65.0,79.0,153,11,01,  Nagabhi Para,22,66,13,30,9,36,25.0,30.2,20.0,00000
46.0,65.0,79.0,153,12,01,  Bash Para,42,107,25,42,17,65,28.2,37.3,20.7,00000
46.0,65.0,79.0,153,13,01,  Mona Chari Para,11,143,6,70,5,73,7.1,7.9,6.4,00000
46.0,65.0,79.0,306,01,01,  Gouichhari,40,194,22,100,18,94,17.1,18.0,16.1,00000
46.0,65.0,79.0,306,02,01,  Bazar Para,19,72,11,35,8,37,20.9,23.9,17.8,00000
46.0,65.0,79.0,306,03,01,  Garia Para,54,169,35,71,19,98,24.2,33.0,16.2,00000
46.0,65.0,79.0,306,04,01,  Akbari Para,15,151,12,80,3,71,9.0,13.0,4.1,00000
46.0,65.0,79.0,306,05,01,  Kalachari Para,10,76,6,36,4,40,11.6,14.3,9.1,00000
46.0,65.0,79.0,306,06,01,  Chongrachari Para,22,116,17,54,5,62,15.9,23.9,7.5,00000
46.0,65.0,79.0,306,07,01,  Mesu Para,13,157,10,75,3,82,7.6,11.8,3.5,00000
46.0,65.0,79.0,306,08,01,  Lambachari Para,6,32,6,16,0,16,15.8,27.3,0.0,00000
46.0,65.0,79.0,765,01,01,  Bazar Para,223,218,132,106,91,112,50.6,55.5,44.8,00000
46.0,65.0,79.0,765,02,01,  Mura Para,37,110,22,51,15,59,25.2,30.1,20.3,00000
46.0,65.0,79.0,765,03,01,  Camp Para,185,32,178,13,7,19,85.3,93.2,26.9,00000
46.0,65.0,79.0,765,04,01,  Monajoy Karbari Para,80,259,53,121,27,138,23.6,30.5,16.4,00000
46.0,65.0,79.0,765,05,01,  Sukanta Mahajan Para,62,90,36,42,26,48,40.8,46.2,35.1,00000
46.0,65.0,79.0,765,06,01,  Thanda Chari,34,91,24,38,10,53,27.2,38.7,15.9,00000
46.0,65.0,79.0,765,07,01,  Royaza Para,37,95,23,45,14,50,28.0,33.8,21.9,00000
46.0,65.0,79.0,765,08,01,  Sindhukchhari Guchchhagram,89,128,53,52,36,76,41.0,50.5,32.1,00000
46.0,65.0,79.0,765,09,01,  Ratei Mahajan Para,52,44,37,13,15,31,54.2,74.0,32.6,00000
46.0,65.0,79.0,765,10,01,  Natun Para,56,153,32,70,24,83,26.8,31.4,22.4,00000
46.0,65.0,79.0,765,11,01,  Jaganath Para,45,72,21,39,24,33,38.5,35.0,42.1,00000
46.0,65.0,79.0,765,12,01,  Pangkhe Mura,12,152,7,66,5,86,7.3,9.6,5.5,00000
46.0,65.0,79.0,765,13,01,  Sindukchari Mukpara,14,50,7,22,7,28,21.9,24.1,20.0,00000
46.0,65.0,79.0,765,14,01,  Natun Mura Para,40,147,27,69,13,78,21.4,28.1,14.3,00000
46.0,65.0,79.0,765,15,01,  Chota Mura Para,15,95,9,48,6,47,13.6,15.8,11.3,00000
46.0,65.0,79.0,765,16,01,  Nackraipara,55,63,29,25,26,38,46.6,53.7,40.6,00000
46.0,65.0,79.0,918,01,01,  Tandukchhari,18,141,12,69,6,72,11.3,14.8,7.7,00000
46.0,65.0,79.0,918,02,01,  Badal Ghat,139,375,94,178,45,197,27.0,34.6,18.6,00000
46.0,67.0,19.0,058,01,01,  Headman Para,161,212,100,83,61,129,43.2,54.6,32.1,00000
46.0,67.0,19.0,058,02,01,  Jamineraga,65,156,43,71,22,85,29.4,37.7,20.6,00000
46.0,67.0,19.0,058,03,01,  Batnatali Guchchhagram,206,265,96,123,110,142,43.7,43.8,43.7,00000
46.0,67.0,19.0,058,04,01,  Batnatali Bazar,145,113,86,52,59,61,56.2,62.3,49.2,00000
46.0,67.0,19.0,058,05,01,  Dhakaiya Sibir,190,267,101,113,89,154,41.6,47.2,36.6,00000
46.0,67.0,19.0,058,06,01,  Kanak Para,10,49,3,27,7,22,16.9,10.0,24.1,00000
46.0,67.0,19.0,058,07,01,  Hindu Para,59,230,33,100,26,130,20.4,24.8,16.7,00000
46.0,67.0,19.0,058,08,01,  Pajampru Para,41,80,21,37,20,43,33.9,36.2,31.7,00000
46.0,67.0,19.0,058,09,01,  Patiram Para,39,88,20,37,19,51,30.7,35.1,27.1,00000
46.0,67.0,19.0,058,10,01,  Sadhu Para,46,58,27,27,19,31,44.2,50.0,38.0,00000
46.0,67.0,19.0,058,11,01,  Baragram Para,70,134,32,59,38,75,34.3,35.2,33.6,00000
46.0,67.0,19.0,058,12,01,  Badon Karbari Para,12,49,7,25,5,24,19.7,21.9,17.2,00000
46.0,67.0,19.0,221,01,01,  Lipa Para,13,97,7,49,6,48,11.8,12.5,11.1,00000
46.0,67.0,19.0,221,02,01,  Noa Para,15,86,8,44,7,42,14.9,15.4,14.3,00000
46.0,67.0,19.0,221,03,01,  Tabla Para,7,106,4,53,3,53,6.2,7.0,5.4,00000
46.0,67.0,19.0,221,04,01,  Headman Para,49,147,25,72,24,75,25.0,25.8,24.2,00000
46.0,67.0,19.0,221,05,01,  Hatitila Para,19,67,10,28,9,39,22.1,26.3,18.8,00000
46.0,67.0,19.0,221,06,01,  Muslim Para,42,80,23,36,19,44,34.4,39.0,30.2,00000
46.0,67.0,19.0,221,07,01,  Baikhala Para,5,21,5,8,0,13,19.2,38.5,0.0,00000
46.0,67.0,19.0,276,01,01,  Headman Para,50,105,28,43,22,62,32.3,39.4,26.2,00000
46.0,67.0,19.0,276,02,01,  Budang Para,102,307,57,155,45,152,24.9,26.9,22.8,00000
46.0,67.0,19.0,276,03,01,  Mongri Karbari Para,21,67,11,32,10,35,23.9,25.6,22.2,00000
46.0,67.0,19.0,276,04,01,  Tripura Para,22,126,11,62,11,64,14.9,15.1,14.7,00000
46.0,67.0,19.0,276,05,01,  Kailla Moran Para,97,93,52,36,45,57,51.1,59.1,44.1,00000
46.0,67.0,19.0,276,06,01,  Hindu Para,117,127,67,57,50,70,48.0,54.0,41.7,00000
46.0,67.0,19.0,331,01,01,  Gorkhana,60,157,35,77,25,80,27.6,31.3,23.8,00000
46.0,67.0,19.0,331,02,01,  Tula Bil,163,320,82,187,81,133,33.7,30.5,37.9,00000
46.0,67.0,19.0,331,03,01,  Bara Bil,52,193,27,100,25,93,21.2,21.3,21.2,00000
46.0,67.0,19.0,331,04,01,  Banchharam Para,195,361,89,196,106,165,35.1,31.2,39.1,00000
46.0,67.0,19.0,331,05,01,  Pnna Bil,252,240,112,116,140,124,51.2,49.1,53.0,00000
46.0,67.0,19.0,331,06,01,  Uttar Para,223,239,121,115,102,124,48.3,51.3,45.1,00000
46.0,67.0,19.0,331,07,01,  Dainchhari Madha Para,240,217,128,96,112,121,52.5,57.1,48.1,00000
46.0,67.0,19.0,331,08,01,  Budhang Para,136,250,73,123,63,127,35.2,37.2,33.2,00000
46.0,67.0,19.0,331,09,01,  Dakshin Para,290,184,165,92,125,92,61.2,64.2,57.6,00000
46.0,67.0,19.0,331,10,01,  Etalang Para,27,15,12,6,15,9,64.3,66.7,62.5,00000
46.0,67.0,19.0,386,01,01,  Gariatila Para,29,60,16,30,13,30,32.6,34.8,30.2,00000
46.0,67.0,19.0,386,02,01,  Kibang Para,26,141,19,67,7,74,15.6,22.1,8.6,00000
46.0,67.0,19.0,386,03,01,  Thali Para,34,113,22,43,12,70,23.1,33.8,14.6,00000
46.0,67.0,19.0,386,04,01,  Fuju Para,84,126,41,56,43,70,40.0,42.3,38.1,00000
46.0,67.0,19.0,386,05,01,  Dakhin Muslim Para,147,209,75,107,72,102,41.3,41.2,41.4,00000
46.0,67.0,19.0,386,06,01,  Headman Para,132,310,80,150,52,160,29.9,34.8,24.5,00000
46.0,67.0,19.0,386,07,01,  Batkhala Para,48,83,23,44,25,39,36.6,34.3,39.1,00000
46.0,67.0,19.0,386,08,01,  Hatimuratila,26,47,15,24,11,23,35.6,38.5,32.4,00000
46.0,67.0,42.0,426,01,01,  Bhangamura,56,73,30,34,26,39,43.4,46.9,40.0,00000
46.0,67.0,42.0,426,02,01,  Namar Headman Para,66,217,33,105,33,112,23.3,23.9,22.8,00000
46.0,67.0,42.0,426,03,01,  Upor Headman Para,224,195,122,92,102,103,53.5,57.0,49.8,00000
46.0,67.0,42.0,426,04,01,  Muslim Para,111,206,49,95,62,111,35.0,34.0,35.8,00000
46.0,67.0,42.0,426,05,01,  Fakirtila,120,156,65,71,55,85,43.5,47.8,39.3,00000
46.0,67.0,42.0,426,06,01,  Muni Para,118,192,60,80,58,112,38.1,42.9,34.1,00000
46.0,67.0,42.0,426,07,01,  Amtali Para,73,121,39,52,34,69,37.6,42.9,33.0,00000
46.0,67.0,42.0,426,08,01,  Gudatali Para (Ramchandra Para,42,66,19,32,23,34,38.9,37.3,40.4,00000
46.0,67.0,42.0,426,09,01,  Selchhari Para,108,125,55,57,53,68,46.4,49.1,43.8,00000
46.0,67.0,42.0,426,10,01,  Nunabil Para,28,111,13,47,15,64,20.1,21.7,19.0,00000
46.0,67.0,42.0,426,11,01,  Uttar Sapmara Para,72,64,42,20,30,44,52.9,67.7,40.5,00000
46.0,67.0,42.0,426,12,01,  Pakka Tila Para,61,93,32,41,29,52,39.6,43.8,35.8,00000
46.0,67.0,42.0,426,13,01,  Ruaza Para,175,238,96,105,79,133,42.4,47.8,37.3,00000
46.0,67.0,42.0,426,14,01,  Madam Sapmara,68,162,29,81,39,81,29.6,26.4,32.5,00000
46.0,67.0,42.0,426,15,01,  Dakshin Sapmara,267,231,154,92,113,139,53.6,62.6,44.8,00000
46.0,67.0,42.0,426,16,01,  Purba Garomchari,153,265,84,118,69,147,36.6,41.6,31.9,00000
46.0,67.0,42.0,426,17,01,  Uttar Garitana,407,489,240,219,167,270,45.4,52.3,38.2,00000
46.0,67.0,42.0,426,18,01,  Dakshin Garitana,238,381,139,171,99,210,38.4,44.8,32.0,00000
46.0,67.0,42.0,426,19,01,  Dakshin Garomchhari,88,114,40,63,48,51,43.6,38.8,48.5,00000
46.0,67.0,42.0,426,20,01,  Uttar Garomchhari,51,83,37,34,14,49,38.1,52.1,22.2,00000
46.0,67.0,42.0,426,21,01,  Madham Garitana,39,98,24,51,15,47,28.5,32.0,24.2,00000
46.0,67.0,42.0,552,01,01,  Master Para,35,49,23,26,12,23,41.7,46.9,34.3,00000
46.0,67.0,42.0,552,02,01,  Headman Para,87,163,55,88,32,75,34.8,38.5,29.9,00000
46.0,67.0,42.0,552,03,01,  Asalong Para,36,168,30,75,6,93,17.6,28.6,6.1,00000
46.0,67.0,42.0,552,04,01,  Guja Chhara Para,15,82,5,45,10,37,15.5,10.0,21.3,00000
46.0,67.0,42.0,552,05,01,  Morakailla Para,14,108,8,58,6,50,11.5,12.1,10.7,00000
46.0,67.0,42.0,552,06,01,  Gilatali Para,80,126,48,65,32,61,38.8,42.5,34.4,00000
46.0,67.0,42.0,552,07,01,  Gash Field Para,151,178,89,90,62,88,45.9,49.7,41.3,00000
46.0,67.0,42.0,552,08,01,  Ranga Pani Para,20,101,13,46,7,55,16.5,22.0,11.3,00000
46.0,67.0,42.0,552,09,01,  Bazar Para,56,72,33,33,23,39,43.8,50.0,37.1,00000
46.0,67.0,42.0,552,10,01,  Nowa Para,36,102,18,50,18,52,26.1,26.5,25.7,00000
46.0,67.0,42.0,552,11,01,  Muslim Para,93,242,53,116,40,126,27.8,31.4,24.1,00000
46.0,67.0,42.0,552,12,01,  Gonja Para,38,88,21,41,17,47,30.2,33.9,26.6,00000
46.0,67.0,42.0,552,13,01,  Rowsan Ali Para,39,107,14,52,25,55,26.7,21.2,31.3,00000
46.0,67.0,42.0,552,14,01,  Kharichara Para,60,198,32,91,28,107,23.3,26.0,20.7,00000
46.0,67.0,42.0,552,15,01,  School Para,54,190,32,95,22,95,22.1,25.2,18.8,00000
46.0,67.0,63.0,758,01,03,  Osman Palli,196,207,108,101,88,106,48.6,51.7,45.4,00000
46.0,67.0,63.0,758,02,03,  Depu Para,50,118,24,57,26,61,29.8,29.6,29.9,00000
46.0,67.0,63.0,758,03,03,  Gabamara Para,372,457,180,227,192,230,44.9,44.2,45.5,00000
46.0,67.0,63.0,758,04,03,  Manochhari Para,13,65,7,29,6,36,16.7,19.4,14.3,00000
46.0,67.0,63.0,758,05,03,  Uttar Fakirnala Para,62,111,37,54,25,57,35.8,40.7,30.5,00000
46.0,67.0,63.0,758,06,03,  Dakshin Fakirnala Para,80,134,54,59,26,75,37.4,47.8,25.7,00000
46.0,67.0,63.0,758,07,03,  Remma Para,17,103,8,42,9,61,14.2,16.0,12.9,00000
46.0,67.0,63.0,758,08,03,  Oyak Chhari Para,35,144,20,74,15,70,19.6,21.3,17.6,00000
46.0,67.0,63.0,758,09,03,  Bakri Chhari Para,20,50,13,21,7,29,28.6,38.2,19.4,00000
46.0,67.0,63.0,758,10,03,  Dakshin Hapchari Para,38,181,26,76,12,105,17.4,25.5,10.3,00000
46.0,67.0,63.0,758,11,03,  Gacha Bil Gucha Gram,1023,1175,521,539,502,636,46.5,49.2,44.1,00000
46.0,67.0,63.0,758,12,03,  Mora Dulu Para,61,272,36,130,25,142,18.3,21.7,15.0,00000
46.0,67.0,63.0,758,13,03,  Eyatalang Para,135,343,61,171,74,172,28.2,26.3,30.1,00000
46.0,67.0,63.0,758,14,03,  Mourkhil Para,296,224,165,104,131,120,56.9,61.3,52.2,00000
46.0,67.0,63.0,758,15,03,  Chaukaka Bil Para,43,166,25,74,18,92,20.6,25.3,16.4,00000
46.0,67.0,63.0,758,16,03,  Lapaindang Para,19,61,10,27,9,34,23.8,27.0,20.9,00000
46.0,67.0,63.0,758,17,03,  Gaindang Para,13,138,8,66,5,72,8.6,10.8,6.5,00000
46.0,67.0,63.0,758,18,03,  Nath Para,140,79,78,28,62,51,63.9,73.6,54.9,00000
46.0,67.0,63.0,758,19,03,  Upozila Sadar,750,218,419,105,331,113,77.5,80.0,74.5,00000
46.0,67.0,63.0,758,20,03,  Manik Chari Bazar,471,164,307,89,164,75,74.2,77.5,68.6,00000
46.0,67.0,63.0,758,21,03,  Panna Bil,150,218,71,103,79,115,40.8,40.8,40.7,00000
46.0,67.0,63.0,758,22,03,  Muslim Para,774,321,481,189,293,132,70.7,71.8,68.9,00000
46.0,67.0,63.0,758,23,03,  Mali Para,105,70,64,36,41,34,60.0,64.0,54.7,00000
46.0,67.0,63.0,758,24,03,  Manik Chari Guchagram,537,649,269,292,268,357,45.3,48.0,42.9,00000
46.0,67.0,63.0,758,25,03,  Molongi Para,134,164,81,67,53,97,45.0,54.7,35.3,00000
46.0,67.0,63.0,758,26,03,  Lamuya Para,220,462,119,214,101,248,32.3,35.7,28.9,00000
46.0,67.0,63.0,758,27,03,  Mohamoni Para,654,615,347,323,307,292,51.5,51.8,51.3,00000
46.0,67.0,63.0,758,28,03,  Hazi Para,323,97,155,41,168,56,76.9,79.1,75.0,00000
46.0,67.0,63.0,758,29,03,  Khadong Para,37,137,25,63,12,74,21.3,28.4,14.0,00000
46.0,67.0,63.0,758,30,03,  Durchari Para,20,168,10,87,10,81,10.6,10.3,11.0,00000
46.0,67.0,63.0,758,31,03,  Bagan Para,18,9,11,1,7,8,66.7,91.7,46.7,00000
46.0,67.0,63.0,758,32,03,  Uttar Nath Para,97,112,54,52,43,60,46.4,50.9,41.7,00000
46.0,67.0,63.0,758,33,03,  Raj Para,111,30,67,13,44,17,78.7,83.8,72.1,00000
46.0,67.0,63.0,758,34,03,  Uttar Raj Para,348,151,180,73,168,78,69.7,71.1,68.3,00000
46.0,67.0,63.0,758,35,03,  Eksatta Para,883,1175,420,556,463,619,42.9,43.0,42.8,00000
46.0,67.0,63.0,758,36,03,  Master Para,108,101,57,45,51,56,51.7,55.9,47.7,00000
46.0,67.0,63.0,758,37,03,  Gacha Bil Chowdhury Para,71,78,34,35,37,43,47.7,49.3,46.3,00000
46.0,67.0,63.0,758,38,03,  Manadan Para,13,41,12,21,1,20,24.1,36.4,4.8,00000
46.0,67.0,63.0,758,39,03,  Manikchhari Army Sub Zone,44,0,44,0,0,0,100.0,100.0,0.0,00000
46.0,67.0,63.0,758,40,03,  Gacha Bil Ansar Batalion Camp,66,0,66,0,0,0,100.0,100.0,0.0,00000
46.0,67.0,87.0,568,01,01,  Madha Kumari Para,55,155,29,74,26,81,26.2,28.2,24.3,00000
46.0,67.0,87.0,568,02,01,  Uttar Kumari Para,33,137,16,70,17,67,19.4,18.6,20.2,00000
46.0,67.0,87.0,568,03,01,  Challar Char Para,6,93,5,49,1,44,6.1,9.3,2.2,00000
46.0,67.0,87.0,568,04,01,  Dakshin Kumari Para,16,87,7,36,9,51,15.5,16.3,15.0,00000
46.0,67.0,87.0,710,01,01,  Daba Tali Para,21,225,15,105,6,120,8.5,12.5,4.8,00000
46.0,67.0,87.0,710,02,01,  Chakma Para,5,98,5,69,0,29,4.9,6.8,0.0,00000
46.0,67.0,87.0,710,03,01,  Headman Para,28,20,15,9,13,11,58.3,62.5,54.2,00000
46.0,67.0,87.0,710,04,01,  Bhulachula Para,17,88,8,44,9,44,16.2,15.4,17.0,00000
46.0,67.0,87.0,758,01,03,  Chenguya Chara Para,382,765,221,346,161,419,33.3,39.0,27.8,00000
46.0,67.0,87.0,758,02,03,  Sil Chari Para,29,55,15,26,14,29,34.5,36.6,32.6,00000
46.0,67.0,87.0,758,03,03,  Ashadtali Para,69,91,32,33,37,58,43.1,49.2,38.9,00000
46.0,67.0,87.0,758,04,03,  Dash Bil Para,44,126,23,53,21,73,25.9,30.3,22.3,00000
46.0,67.0,87.0,758,05,03,  Uttar Gudatali Para,61,184,33,88,28,96,24.9,27.3,22.6,00000
46.0,67.0,87.0,758,06,03,  Dakshingudatali Para,61,138,25,65,36,73,30.7,27.8,33.0,00000
46.0,67.0,87.0,758,07,03,  Tintahari Guchhagram,369,616,186,257,183,359,37.5,42.0,33.8,00000
46.0,67.0,87.0,758,08,03,  Rainga Para,175,293,96,145,79,148,37.4,39.8,34.8,00000
46.0,67.0,87.0,758,09,03,  Master Para,87,151,32,85,55,66,36.6,27.4,45.5,00000
46.0,67.0,87.0,758,10,03,  Dolu Uttar Muslim Para,160,154,77,75,83,79,51.0,50.7,51.2,00000
46.0,67.0,87.0,758,11,03,  Dolu Dakshin Muslim Para,109,217,49,99,60,118,33.4,33.1,33.7,00000
46.0,67.0,87.0,758,12,03,  Buthai Chari Para,162,444,94,209,68,235,26.7,31.0,22.4,00000
46.0,67.0,87.0,758,13,03,  Barabulu D.P.Para,172,363,87,152,85,211,32.1,36.4,28.7,00000
46.0,67.0,87.0,758,14,03,  Depua Para,79,360,38,167,41,193,18.0,18.5,17.5,00000
46.0,67.0,87.0,758,15,03,  Namar Tintahari Para,167,293,84,136,83,157,36.3,38.2,34.6,00000
46.0,67.0,87.0,758,16,03,  Bara Bil,157,302,86,146,71,156,34.2,37.1,31.3,00000
46.0,67.0,87.0,758,17,03,  Gorkhana,68,77,38,30,30,47,46.9,55.9,39.0,00000
46.0,67.0,87.0,758,18,03,  Chowdhury Para,335,441,163,220,172,221,43.2,42.6,43.8,00000
46.0,67.0,87.0,758,19,03,  Maidha Tintahari Para,176,266,93,150,83,116,39.8,38.3,41.7,00000
46.0,67.0,87.0,758,20,03,  Purba Tintahari Para,428,461,214,231,214,230,48.1,48.1,48.2,00000
46.0,67.0,87.0,758,21,03,  Chairman Para,223,169,124,81,99,88,56.9,60.5,52.9,00000
46.0,67.0,87.0,758,22,03,  Tintahari Bazar Para,196,158,105,69,91,89,55.4,60.3,50.6,00000
46.0,67.0,87.0,758,23,03,  Lamuya Para,87,78,48,33,39,45,52.7,59.3,46.4,00000
46.0,67.0,87.0,758,24,03,  Khantamara Para,27,61,10,31,17,30,30.7,24.4,36.2,00000
46.0,67.0,87.0,758,25,03,  Hindu Para,51,38,22,14,29,24,57.3,61.1,54.7,00000
46.0,67.0,87.0,758,26,03,  Conjuri Para,135,137,67,53,68,84,49.6,55.8,44.7,00000
46.0,67.0,87.0,758,27,03,  Tinthari Ansar Batalion Camp,103,0,101,0,2,0,100.0,100.0,100.0,00000
46.0,67.0,87.0,758,28,03,  Tula Bil Para,25,106,13,50,12,56,19.1,20.6,17.6,00000
46.0,67.0,87.0,947,01,01,  Durchari Para,41,188,28,83,13,105,17.9,25.2,11.0,00000
46.0,67.0,87.0,947,02,01,  Rangapani Para,109,389,70,192,39,197,21.9,26.7,16.5,00000
46.0,67.0,87.0,947,03,01,  Daijja Para,26,115,15,56,11,59,18.4,21.1,15.7,00000
46.0,67.0,87.0,947,04,01,  Adarsha Gram Para,18,171,13,83,5,88,9.5,13.5,5.4,00000
46.0,67.0,87.0,947,05,01,  Lamuya Para,38,90,22,40,16,50,29.7,35.5,24.2,00000
46.0,70.0,13.0,180,01,01,  Jalil Member Para,109,232,54,109,55,123,32.0,33.1,30.9,00000
46.0,70.0,13.0,180,02,01,  Karaila Chari Para,156,168,98,90,58,78,48.1,52.1,42.6,00000
46.0,70.0,13.0,180,03,01,  Karaila Chari Bazar Para,146,76,75,32,71,44,65.8,70.1,61.7,00000
46.0,70.0,13.0,180,04,01,  Rashid Master Para,249,287,129,127,120,160,46.5,50.4,42.9,00000
46.0,70.0,13.0,180,05,01,  Odud Member Para,115,105,61,41,54,64,52.3,59.8,45.8,00000
46.0,70.0,13.0,180,06,01,  Jafar Para,58,136,24,68,34,68,29.9,26.1,33.3,00000
46.0,70.0,13.0,180,07,01,  Headman Para,210,209,103,97,107,112,50.1,51.5,48.9,00000
46.0,70.0,13.0,180,08,01,  Upa Shing Para,63,125,42,60,21,65,33.5,41.2,24.4,00000
46.0,70.0,13.0,180,09,01,  Ramchira Bazar,186,122,100,58,86,64,60.4,63.3,57.3,00000
46.0,70.0,13.0,180,10,01,  Ther Sarder Para,132,133,74,62,58,71,49.8,54.4,45.0,00000
46.0,70.0,13.0,180,11,01,  Abbas Sarder Para,155,244,81,113,74,131,38.8,41.8,36.1,00000
46.0,70.0,13.0,180,12,01,  Dewan Para,286,221,157,105,129,116,56.4,59.9,52.7,00000
46.0,70.0,13.0,180,13,01,  Jalil Para,82,330,32,162,50,168,19.9,16.5,22.9,00000
46.0,70.0,13.0,180,14,01,  Chodda Gram Para,187,220,90,101,97,119,45.9,47.1,44.9,00000
46.0,70.0,13.0,316,01,01,  Narikal Para,21,91,14,42,7,49,18.8,25.0,12.5,00000
46.0,70.0,13.0,316,02,01,  Komolla Bagan,8,46,6,23,2,23,14.8,20.7,8.0,00000
46.0,70.0,13.0,316,03,01,  Apurna Mohajan Bara Para,50,249,40,111,10,138,16.7,26.5,6.8,00000
46.0,70.0,13.0,316,04,01,  Bisha Ram Karbari Para,54,141,30,66,24,75,27.7,31.3,24.2,00000
46.0,70.0,13.0,316,05,01,  Moida Chara Para,68,118,44,55,24,63,36.6,44.4,27.6,00000
46.0,70.0,13.0,316,06,01,  Mohonta Headman Para,68,165,49,68,19,97,29.2,41.9,16.4,00000
46.0,70.0,13.0,316,07,01,  Kamini Mohan Karbari Para,75,189,49,81,26,108,28.4,37.7,19.4,00000
46.0,70.0,13.0,316,08,01,  Sorbo Sidee Para,31,147,22,73,9,74,17.4,23.2,10.8,00000
46.0,70.0,13.0,316,09,01,  Sodori Para,20,40,12,20,8,20,33.3,37.5,28.6,00000
46.0,70.0,13.0,316,10,01,  Kolpa Para,40,58,21,28,19,30,40.8,42.9,38.8,00000
46.0,70.0,13.0,316,11,01,  Raja Para,50,125,33,57,17,68,28.6,36.7,20.0,00000
46.0,70.0,13.0,316,12,01,  Chandra Ban Para,10,25,5,12,5,13,28.6,29.4,27.8,00000
46.0,70.0,13.0,316,13,01,  Birasi Mura,29,65,16,35,13,30,30.9,31.4,30.2,00000
46.0,70.0,17.0,395,01,01,  Writer Para,104,150,55,74,49,76,40.9,42.6,39.2,00000
46.0,70.0,17.0,395,02,01,  Kashem Member Para,67,88,33,39,34,49,43.2,45.8,41.0,00000
46.0,70.0,17.0,395,03,01,  Modu Karbai Para/Pyeaprue K.P,31,24,25,10,6,14,56.4,71.4,30.0,00000
46.0,70.0,17.0,395,04,01,  Natun Para,28,57,18,27,10,30,32.9,40.0,25.0,00000
46.0,70.0,17.0,395,05,01,  Board Office Bazar Para,116,111,57,54,59,57,51.1,51.4,50.9,00000
46.0,70.0,17.0,395,06,01,  Fazal Member Para,24,96,11,47,13,49,20.0,19.0,21.0,00000
46.0,70.0,17.0,395,07,01,  Kadamtali Chakma Para,80,91,47,36,33,55,46.8,56.6,37.5,00000
46.0,70.0,17.0,395,08,01,  Taila Para,114,207,64,102,50,105,35.5,38.6,32.3,00000
46.0,70.0,17.0,395,09,01,  Garjan Tila Marma Para,27,54,14,25,13,29,33.3,35.9,31.0,00000
46.0,70.0,17.0,395,10,01,  Ibrahim Meah Para,64,144,31,74,33,70,30.8,29.5,32.0,00000
46.0,70.0,17.0,395,11,01,  Moulavi Para,48,93,24,41,24,52,34.0,36.9,31.6,00000
46.0,70.0,17.0,395,12,01,  Adisha Para,23,76,11,35,12,41,23.2,23.9,22.6,00000
46.0,70.0,17.0,395,13,01,  New Muslom Para,124,94,73,35,51,59,56.9,67.6,46.4,00000
46.0,70.0,17.0,395,14,01,  Karim Master Para,124,470,60,235,64,235,20.9,20.3,21.4,00000
46.0,70.0,17.0,395,15,01,  Hori Soran Para,17,57,8,26,9,31,23.0,23.5,22.5,00000
46.0,70.0,17.0,395,16,01,  Minnot Ali Sordar Para,68,133,42,63,26,70,33.8,40.0,27.1,00000
46.0,70.0,17.0,395,17,01,  Onontro Karbari Para,13,88,11,44,2,44,12.9,20.0,4.3,00000
46.0,70.0,17.0,395,18,01,  Butta Para,107,171,49,90,58,81,38.5,35.3,41.7,00000
46.0,70.0,17.0,395,19,01,  Paran Kumar Para,8,54,3,32,5,22,12.9,8.6,18.5,00000
46.0,70.0,17.0,395,20,01,  Master Para,165,116,91,54,74,62,58.7,62.8,54.4,00000
46.0,70.0,17.0,395,21,01,  Idresh Miah Para,75,179,36,82,39,97,29.5,30.5,28.7,00000
46.0,70.0,17.0,395,22,01,  Badu Member Para,50,90,23,43,27,47,35.7,34.8,36.5,00000
46.0,70.0,17.0,395,23,01,  Alek Chairman Para,77,97,34,42,43,55,44.3,44.7,43.9,00000
46.0,70.0,17.0,395,24,01,  Habib Member Para,53,142,30,62,23,80,27.2,32.6,22.3,00000
46.0,70.0,17.0,395,25,01,  Badu Miah Para,83,181,50,87,33,94,31.4,36.5,26.0,00000
46.0,70.0,17.0,925,01,01,  Kataki Headman Para,48,76,31,29,17,47,38.7,51.7,26.6,00000
46.0,70.0,17.0,925,02,01,  Ruhul Amion Para,17,37,5,20,12,17,31.5,20.0,41.4,00000
46.0,70.0,17.0,925,03,01,  Lal Kumar Para,43,91,23,46,20,45,32.1,33.3,30.8,00000
46.0,70.0,17.0,925,04,01,  Thoyung Headman Para,27,34,15,20,12,14,44.3,42.9,46.2,00000
46.0,70.0,17.0,925,05,01,  Tilkumar Para,52,30,29,11,23,19,63.4,72.5,54.8,00000
46.0,70.0,17.0,925,06,01,  Ala Uddion Member Para,139,191,73,111,66,80,42.1,39.7,45.2,00000
46.0,70.0,17.0,925,07,01,  Ali Akbar Chairman Para,49,83,26,43,23,40,37.1,37.7,36.5,00000
46.0,70.0,17.0,925,08,01,  Showdagar Para,33,186,18,96,15,90,15.1,15.8,14.3,00000
46.0,70.0,17.0,925,09,01,  Dak Bangla Bazar,145,49,86,25,59,24,74.7,77.5,71.1,00000
46.0,70.0,17.0,925,10,01,  Earni Marma Para,64,63,29,30,35,33,50.4,49.2,51.5,00000
46.0,70.0,17.0,925,11,01,  Islampr,26,148,12,74,14,74,14.9,14.0,15.9,00000
46.0,70.0,17.0,925,12,01,  Abdul Member Para,53,134,28,62,25,72,28.3,31.1,25.8,00000
46.0,70.0,17.0,925,13,01,  Bachchu Member Para,35,104,21,45,14,59,25.2,31.8,19.2,00000
46.0,70.0,17.0,925,14,01,  Bora Para Gram,62,117,39,54,23,63,34.6,41.9,26.7,00000
46.0,70.0,17.0,925,15,01,  Amin Sardar Para,41,97,25,45,16,52,29.7,35.7,23.5,00000
46.0,70.0,17.0,925,16,01,  Gyanra Sara Para,39,85,19,39,20,46,31.5,32.8,30.3,00000
46.0,70.0,17.0,925,17,01,  Tailafung Bara Para,16,79,5,39,11,40,16.8,11.4,21.6,00000
46.0,70.0,17.0,925,18,01,  Bokim Member Para,37,31,20,9,17,22,54.4,69.0,43.6,00000
46.0,70.0,17.0,925,19,01,  Jamini Para,32,79,17,38,15,41,28.8,30.9,26.8,00000
46.0,70.0,17.0,925,20,01,  Jamini Para B.D.R.  Batalion G,274,8,263,5,11,3,97.2,98.1,78.6,00000
46.0,70.0,17.0,925,21,01,  Hindupara,93,37,56,14,37,23,71.5,80.0,61.7,00000
46.0,70.0,17.0,925,22,01,  Heladula Para,39,130,26,56,13,74,23.1,31.7,14.9,00000
46.0,70.0,23.0,090,01,01,  Baracha Kerbari Para,56,103,33,50,23,53,35.2,39.8,30.3,00000
46.0,70.0,23.0,090,02,01,  Bazar Para,243,363,151,172,92,191,40.1,46.7,32.5,00000
46.0,70.0,23.0,090,03,01,  Dharmaram Para,73,58,41,26,32,32,55.7,61.2,50.0,00000
46.0,70.0,23.0,090,04,01,  Hatandra Para,142,145,61,71,81,74,49.5,46.2,52.3,00000
46.0,70.0,23.0,090,05,01,  Mag Para,45,20,23,9,22,11,69.2,71.9,66.7,00000
46.0,70.0,23.0,090,06,01,  New Ajodhya,170,246,82,109,88,137,40.9,42.9,39.1,00000
46.0,70.0,23.0,090,07,01,  Lalit Karbari Para,149,367,79,163,70,204,28.9,32.6,25.5,00000
46.0,70.0,23.0,407,01,01,  Uttarpara,283,130,135,49,148,81,68.5,73.4,64.6,00000
46.0,70.0,23.0,407,02,01,  Bazar Para,71,156,37,73,34,83,31.3,33.6,29.1,00000
46.0,70.0,23.0,407,03,01,  Dakbangla Badankumar Para,103,150,48,69,55,81,40.7,41.0,40.4,00000
46.0,70.0,23.0,407,04,01,  Maidha/Shamaj Member Para,97,132,53,61,44,71,42.4,46.5,38.3,00000
46.0,70.0,23.0,407,05,01,  Ohid Member Para,150,125,85,50,65,75,54.5,63.0,46.4,00000
46.0,70.0,23.0,407,06,01,  Shuba Rangan Headman Para,203,273,100,129,103,144,42.6,43.7,41.7,00000
46.0,70.0,23.0,407,07,01,  Nurul Islam Compani Para,151,240,75,104,76,136,38.6,41.9,35.8,00000
46.0,70.0,23.0,407,08,01,  Master Para,159,120,87,52,72,68,57.0,62.6,51.4,00000
46.0,70.0,23.0,407,09,01,  Sornoker Tila,148,200,81,80,67,120,42.5,50.3,35.8,00000
46.0,70.0,23.0,407,10,01,  Panjabi Tila,82,133,41,61,41,72,38.1,40.2,36.3,00000
46.0,70.0,23.0,497,01,01,  Kameni Para,48,186,27,86,21,100,20.5,23.9,17.4,00000
46.0,70.0,23.0,497,02,01,  Jagatjoti Headman Para,112,290,66,141,46,149,27.9,31.9,23.6,00000
46.0,70.0,23.0,497,03,01,  Dewan Para,38,158,25,75,13,83,19.4,25.0,13.5,00000
46.0,70.0,23.0,497,04,01,  Shinga Para,3,33,2,16,1,17,8.3,11.1,5.6,00000
46.0,70.0,23.0,497,05,01,  Khada Para,6,148,5,71,1,77,3.9,6.6,1.3,00000
46.0,70.0,23.0,768,01,01,  Ambagan,203,315,109,132,94,183,39.2,45.2,33.9,00000
46.0,70.0,23.0,768,02,01,  Amin Chairman Para,162,80,85,33,77,47,66.9,72.0,62.1,00000
46.0,70.0,23.0,768,03,01,  Manu Member Para,141,106,71,47,70,59,57.1,60.2,54.3,00000
46.0,70.0,23.0,768,04,01,  D.P.Para,173,177,85,84,88,93,49.4,50.3,48.6,00000
46.0,70.0,23.0,768,05,01,  Bazar Para/Khaleq Leader Para,254,110,126,48,128,62,69.8,72.4,67.4,00000
46.0,70.0,23.0,768,06,01,  Kala Miah Leader Para,107,108,56,43,51,65,49.8,56.6,44.0,00000
46.0,70.0,23.0,768,07,01,  Bangali Para,155,458,82,221,73,237,25.3,27.1,23.5,00000
46.0,70.0,23.0,768,08,01,  Ganga Mohan Para,92,137,64,52,28,85,40.2,55.2,24.8,00000
46.0,70.0,23.0,768,09,01,  Upendra Headman Para,39,88,25,38,14,50,30.7,39.7,21.9,00000
46.0,70.0,23.0,768,10,01,  Rabi Shunder Para,91,94,57,37,34,57,49.2,60.6,37.4,00000
46.0,70.0,23.0,768,11,01,  Hari Dhan Marma Para,66,157,35,95,31,62,29.6,26.9,33.3,00000
46.0,70.0,23.0,768,12,01,  Khar Chandra Karbari Para,85,83,54,38,31,45,50.6,58.7,40.8,00000
46.0,70.0,23.0,768,13,01,  Khadachara Phalaspur B.D.R.Bhq,239,20,198,8,41,12,92.3,96.1,77.4,00000
46.0,70.0,23.0,768,14,01,  Dhakaya Para,148,130,76,54,72,76,53.2,58.5,48.6,00000
46.0,70.0,23.0,768,15,01,  Weazed Member Para,84,87,45,38,39,49,49.1,54.2,44.3,00000
46.0,70.0,35.0,271,01,01,  No-2 Bailla Chari Ruber Pr.Gr.,76,110,43,50,33,60,40.9,46.2,35.5,00000
46.0,70.0,35.0,271,02,01,  Bailla Chari Ruber Pro. Gram,55,124,34,53,21,71,30.7,39.1,22.8,00000
46.0,70.0,35.0,271,03,01,  Sadu Para,15,11,9,0,6,11,57.7,100.0,35.3,00000
46.0,70.0,35.0,271,04,01,  Chailapro Karbari Para,54,48,31,14,23,34,52.9,68.9,40.4,00000
46.0,70.0,35.0,271,05,01,  School Para,50,67,32,31,18,36,42.7,50.8,33.3,00000
46.0,70.0,35.0,271,06,01,  Prokrita Ranjon Para,19,40,12,19,7,21,32.2,38.7,25.0,00000
46.0,70.0,35.0,271,07,01,  Gaibinsa Para,7,28,5,16,2,12,20.0,23.8,14.3,00000
46.0,70.0,35.0,271,08,01,  Dolia Para,16,23,10,8,6,15,41.0,55.6,28.6,00000
46.0,70.0,35.0,271,09,01,  Chan Khala Para,42,57,29,25,13,32,42.4,53.7,28.9,00000
46.0,70.0,35.0,271,10,01,  Myrong Para,49,96,29,40,20,56,33.8,42.0,26.3,00000
46.0,70.0,35.0,271,11,01,  Arbari Para,76,102,61,44,15,58,42.7,58.1,20.5,00000
46.0,70.0,35.0,271,12,01,  Naryan Para,52,40,30,16,22,24,56.5,65.2,47.8,00000
46.0,70.0,35.0,271,13,01,  Jori Chandra Para,34,159,20,125,14,34,17.6,13.8,29.2,00000
46.0,70.0,35.0,271,14,01,  No-3.Bailla Chari Ruber Pr.Gr.,68,109,35,46,33,63,38.4,43.2,34.4,00000
46.0,70.0,35.0,271,15,01,  Jammia Punur Bashan,18,88,9,42,9,46,17.0,17.6,16.4,00000
46.0,70.0,35.0,452,01,01,  Rabindra Karbari Para,31,52,21,25,10,27,37.3,45.7,27.0,00000
46.0,70.0,35.0,452,02,01,  Kamindra Karbari Para,35,68,17,30,18,38,34.0,36.2,32.1,00000
46.0,70.0,35.0,452,03,01,  Anu Mia Para,71,86,38,38,33,48,45.2,50.0,40.7,00000
46.0,70.0,35.0,452,04,01,  Thali Para,27,36,19,14,8,22,42.9,57.6,26.7,00000
46.0,70.0,35.0,452,05,01,  Indramani Para,41,255,28,121,13,134,13.9,18.8,8.8,00000
46.0,70.0,35.0,678,01,01,  Khanti Chandra Para,36,158,21,82,15,76,18.6,20.4,16.5,00000
46.0,70.0,35.0,678,02,01,  Bokta Para,31,81,21,42,10,39,27.7,33.3,20.4,00000
46.0,70.0,35.0,678,03,01,  Tarachand Para,7,126,6,63,1,63,5.3,8.7,1.6,00000
46.0,70.0,35.0,678,04,01,  Budhung Para,225,177,121,88,104,89,56.0,57.9,53.9,00000
46.0,70.0,35.0,678,05,01,  Purba Jautha Khamar,10,72,6,31,4,41,12.2,16.2,8.9,00000
46.0,70.0,35.0,678,06,01,  Paschim Jautha Khamar,61,125,26,63,35,62,32.8,29.2,36.1,00000
46.0,70.0,35.0,678,07,01,  Kabutar Chhara,55,175,30,90,25,85,23.9,25.0,22.7,00000
46.0,70.0,35.0,678,08,01,  Lundhakhya Para,301,312,164,146,137,166,49.1,52.9,45.2,00000
46.0,70.0,35.0,678,09,01,  Dewan Para,194,417,118,182,76,235,31.8,39.3,24.4,00000
46.0,70.0,35.0,678,10,01,  Headman Para,64,137,47,56,17,81,31.8,45.6,17.3,00000
46.0,70.0,35.0,678,11,01,  D.P. Para,151,240,90,101,61,139,38.6,47.1,30.5,00000
46.0,70.0,35.0,678,12,01,  Kamrong Para,1,82,1,44,0,38,1.2,2.2,0.0,00000
46.0,70.0,35.0,678,13,01,  Kumujja Karbari Para,37,52,19,19,18,33,41.6,50.0,35.3,00000
46.0,70.0,35.0,678,14,01,  Kala Para,2,47,1,22,1,25,4.1,4.3,3.8,00000
46.0,70.0,35.0,678,15,01,  Mohainna Karbari Para,63,60,58,28,5,32,51.2,67.4,13.5,00000
46.0,70.0,35.0,678,16,01,  Muslim Para,138,228,73,103,65,125,37.7,41.5,34.2,00000
46.0,70.0,35.0,678,17,01,  Lafong Para/Daktar Tila,515,308,278,134,237,174,62.6,67.5,57.7,00000
46.0,70.0,35.0,678,18,01,  Master Para,176,75,83,40,93,35,70.1,67.5,72.7,00000
46.0,70.0,35.0,678,19,01,  Jamader Para,92,76,52,30,40,46,54.8,63.4,46.5,00000
46.0,70.0,35.0,678,20,01,  Guimara Bazar Para,578,329,348,180,230,149,63.7,65.9,60.7,00000
46.0,70.0,35.0,678,21,01,  Dargiling Tila,402,146,214,64,188,82,73.4,77.0,69.6,00000
46.0,70.0,35.0,678,22,01,  Haja Chara/Ranu Chara,209,212,99,103,110,109,49.6,49.0,50.2,00000
46.0,70.0,35.0,678,23,01,  Baro Thali Para,82,215,45,94,37,121,27.6,32.4,23.4,00000
46.0,70.0,35.0,949,01,01,  Reserve Chandra Para,14,6,6,2,8,4,70.0,75.0,66.7,00000
46.0,70.0,35.0,949,02,01,  Rupai Ram Headman Para,33,16,17,7,16,9,67.3,70.8,64.0,00000
46.0,70.0,35.0,949,03,01,  Master Para,46,77,25,37,21,40,37.4,40.3,34.4,00000
46.0,70.0,35.0,949,04,01,  Niang Shing Para,12,29,7,14,5,15,29.3,33.3,25.0,00000
46.0,70.0,35.0,949,05,01,  Taimatai Rubber Prj.1,79,180,53,91,26,89,30.5,36.8,22.6,00000
46.0,70.0,35.0,949,06,01,  Taimatai Rubber Prj.2,47,208,24,104,23,104,18.4,18.8,18.1,00000
46.0,70.0,35.0,949,07,01,  Taimatai Rubber Prj.3,47,123,29,55,18,68,27.6,34.5,20.9,00000
46.0,70.0,35.0,949,08,01,  Pancha Master Para,14,11,8,2,6,9,56.0,80.0,40.0,00000
46.0,70.0,35.0,949,09,01,  Gonga/Dewan Para,93,218,58,97,35,121,29.9,37.4,22.4,00000
46.0,70.0,35.0,949,10,01,  Chowdhyry Para,44,110,24,45,20,65,28.6,34.8,23.5,00000
46.0,70.0,35.0,949,11,01,  Dhaniram Para,21,203,16,96,5,107,9.4,14.3,4.5,00000
46.0,70.0,35.0,949,12,01,  Noa Para,13,33,8,12,5,21,28.3,40.0,19.2,00000
46.0,70.0,35.0,949,13,01,  Kamrong Para,20,65,12,33,8,32,23.5,26.7,20.0,00000
46.0,70.0,35.0,949,14,01,  Bong Kumaer Para,0,36,0,17,0,19,0.0,0.0,0.0,00000
46.0,70.0,35.0,949,15,01,  Ramani Para,0,82,0,43,0,39,0.0,0.0,0.0,00000
46.0,70.0,35.0,949,16,01,  Taimatai Para,10,126,9,66,1,60,7.4,12.0,1.6,00000
46.0,70.0,35.0,949,17,01,  Natun Purindra Para,8,58,6,27,2,31,12.1,18.2,6.1,00000
46.0,70.0,35.0,949,18,01,  Sati Para,0,23,0,14,0,9,0.0,0.0,0.0,00000
46.0,70.0,35.0,949,19,01,  Mohainna Karbari Para,30,107,20,47,10,60,21.9,29.9,14.3,00000
46.0,70.0,35.0,949,20,01,  Kala Para,16,46,9,22,7,24,25.8,29.0,22.6,00000
46.0,70.0,35.0,949,21,01,  Jai Kumer Member Para,20,41,14,20,6,21,32.8,41.2,22.2,00000
46.0,70.0,35.0,949,22,01,  Khagra Para,28,58,19,25,9,33,32.6,43.2,21.4,00000
46.0,70.0,35.0,949,23,01,  Guimara Para,7,62,4,33,3,29,10.1,10.8,9.4,00000
46.0,70.0,47.0,226,01,01,  Rajendra Para,11,68,8,36,3,32,13.9,18.2,8.6,00000
46.0,70.0,47.0,226,02,01,  Paban Kumar Para,23,121,15,61,8,60,16.0,19.7,11.8,00000
46.0,70.0,47.0,226,03,01,  Dhan Kumar Para,40,59,30,25,10,34,40.4,54.5,22.7,00000
46.0,70.0,47.0,226,05,01,  Bomang Karai Para,9,74,7,40,2,34,10.8,14.9,5.6,00000
46.0,70.0,47.0,361,01,01,  Udhai Kumar Para,11,62,7,26,4,36,15.1,21.2,10.0,00000
46.0,70.0,47.0,361,02,01,  Kalindra Rangan Para,12,116,9,57,3,59,9.4,13.6,4.8,00000
46.0,70.0,47.0,361,03,01,  Gala Moni Para,53,108,31,53,22,55,32.9,36.9,28.6,00000
46.0,70.0,47.0,361,04,01,  Lolindra Para,38,160,26,77,12,83,19.2,25.2,12.6,00000
46.0,70.0,47.0,361,05,01,  Shampreti Para,88,158,52,69,36,89,35.8,43.0,28.8,00000
46.0,70.0,47.0,361,06,01,  Nur Islam Para,227,192,121,90,106,102,54.2,57.3,51.0,00000
46.0,70.0,47.0,361,07,01,  Abukha Member Para,49,128,19,60,30,68,27.7,24.1,30.6,00000
46.0,70.0,47.0,361,08,01,  Mamtaz Sarder Para,45,64,24,30,21,34,41.3,44.4,38.2,00000
46.0,70.0,47.0,361,09,01,  Mohan Gazi Para,18,84,9,37,9,47,17.6,19.6,16.1,00000
46.0,70.0,47.0,361,10,01,  Monuf Munshi Para,64,119,32,66,32,53,35.0,32.7,37.6,00000
46.0,70.0,47.0,361,11,01,  Jatindra Para,27,48,13,22,14,26,36.0,37.1,35.0,00000
46.0,70.0,47.0,361,12,01,  Zharlal Headman Para,43,40,23,15,20,25,51.8,60.5,44.4,00000
46.0,70.0,47.0,633,01,01,  Bhadur Para,188,290,104,144,84,146,39.3,41.9,36.5,00000
46.0,70.0,47.0,633,02,01,  Malek Master Para,298,230,146,98,152,132,56.4,59.8,53.5,00000
46.0,70.0,47.0,633,03,01,  Mana Member Para,181,314,88,143,93,171,36.6,38.1,35.2,00000
46.0,70.0,47.0,633,04,01,  Samsu Sardar Para,124,228,56,112,68,116,35.2,33.3,37.0,00000
46.0,70.0,47.0,633,05,01,  Haita Ali & Bhaigadon M.Para,315,251,168,106,147,145,55.7,61.3,50.3,00000
46.0,70.0,47.0,633,06,01,  Ali Ahamed Master/M.S.Para,200,375,97,180,103,195,34.8,35.0,34.6,00000
46.0,70.0,47.0,633,07,01,  Asmat Ali Sarder Para,247,279,125,122,122,157,47.0,50.6,43.7,00000
46.0,70.0,47.0,723,01,01,  Majumder Para,143,102,69,53,74,49,58.4,56.6,60.2,00000
46.0,70.0,47.0,723,02,01,  Nur Islam Member Para,74,107,43,50,31,57,40.9,46.2,35.2,00000
46.0,70.0,47.0,723,03,01,  Bazar Para,177,143,98,60,79,83,55.3,62.0,48.8,00000
46.0,70.0,47.0,723,04,01,  Uttar Shanti Para,64,276,41,126,23,150,18.8,24.6,13.3,00000
46.0,70.0,47.0,723,05,01,  Monsur Contractor Para,141,151,84,53,57,98,48.3,61.3,36.8,00000
46.0,70.0,47.0,723,06,01,  Kalapani Para,85,94,60,33,25,61,47.5,64.5,29.1,00000
46.0,70.0,47.0,723,07,01,  Muslim Mamber Para,143,266,89,120,54,146,35.0,42.6,27.0,00000
46.0,70.0,47.0,723,08,01,  Hazi Para,106,122,49,56,57,66,46.5,46.7,46.3,00000
46.0,70.0,47.0,723,09,01,  Brendra Kesor Para,107,86,56,33,51,53,55.4,62.9,49.0,00000
46.0,70.0,47.0,723,10,01,  Mahabub Member Para,108,135,54,67,54,68,44.4,44.6,44.3,00000
46.0,70.0,47.0,723,11,01,  Chairman Para,189,82,110,39,79,43,69.7,73.8,64.8,00000
46.0,70.0,47.0,723,12,01,  Alim Riter Para,195,175,103,72,92,103,52.7,58.9,47.2,00000
46.0,70.0,47.0,723,13,01,  Bali Chandra Para,99,203,46,91,53,112,32.8,33.6,32.1,00000
46.0,70.0,47.0,814,01,01,  Tharini Para,9,38,7,15,2,23,19.1,31.8,8.0,00000
46.0,70.0,47.0,814,02,01,  Matindra Headman Para,34,33,21,12,13,21,50.7,63.6,38.2,00000
46.0,70.0,47.0,814,03,01,  Gokulmani Para,30,92,17,43,13,49,24.6,28.3,21.0,00000
46.0,70.0,47.0,814,04,01,  Keshab Mohazan Para,58,186,39,83,19,103,23.8,32.0,15.6,00000
46.0,70.0,47.0,814,05,01,  Kesco Chara,16,68,10,32,6,36,19.0,23.8,14.3,00000
46.0,70.0,59.0,045,01,01,  Jari Chandra Para,36,99,23,44,13,55,26.7,34.3,19.1,00000
46.0,70.0,59.0,045,02,01,  Jatin Para,21,48,13,24,8,24,30.4,35.1,25.0,00000
46.0,70.0,59.0,045,03,01,  Dina Bandhu Para,18,54,14,23,4,31,25.0,37.8,11.4,00000
46.0,70.0,59.0,045,04,01,  Garjan Tila,17,63,13,32,4,31,21.3,28.9,11.4,00000
46.0,70.0,59.0,045,05,01,  Majra Para,9,57,8,28,1,29,13.6,22.2,3.3,00000
46.0,70.0,59.0,045,06,01,  Dhami Para,27,151,17,66,10,85,15.2,20.5,10.5,00000
46.0,70.0,59.0,045,07,01,  Haja Chara,11,61,3,29,8,32,15.3,9.4,20.0,00000
46.0,70.0,59.0,045,08,01,  Abhya Para,14,88,12,48,2,40,13.7,20.0,4.8,00000
46.0,70.0,59.0,045,09,01,  Shak Sree Para,16,75,11,35,5,40,17.6,23.9,11.1,00000
46.0,70.0,59.0,045,10,01,  Saraban Chandra Para,22,85,11,40,11,45,20.6,21.6,19.6,00000
46.0,70.0,59.0,045,11,01,  Nilanga Headman Para,45,125,31,66,14,59,26.5,32.0,19.2,00000
46.0,70.0,59.0,045,12,01,  Ropai Sing Para,35,33,21,15,14,18,51.5,58.3,43.8,00000
46.0,70.0,59.0,045,13,01,  Taisha Katang Karbari Para,13,104,9,48,4,56,11.1,15.8,6.7,00000
46.0,70.0,59.0,045,14,01,  Thong Thung Para,12,38,6,20,6,18,24.0,23.1,25.0,00000
46.0,70.0,59.0,135,01,01,  Bang Mara,236,149,152,55,84,94,61.3,73.4,47.2,00000
46.0,70.0,59.0,135,02,01,  Dul Chari,61,47,36,17,25,30,56.5,67.9,45.5,00000
46.0,70.0,59.0,135,03,01,  Shap Mara,56,54,35,17,21,37,50.9,67.3,36.2,00000
46.0,70.0,59.0,135,04,01,  Ram Dayal Para,18,61,12,32,6,29,22.8,27.3,17.1,00000
46.0,70.0,59.0,135,05,01,  Jammia Puner Bashan,229,175,155,71,74,104,56.7,68.6,41.6,00000
46.0,70.0,59.0,135,06,01,  Pran Ranjan Para,15,30,12,12,3,18,33.3,50.0,14.3,00000
46.0,70.0,59.0,135,08,01,  Isa Chara Muslim Para,254,263,162,117,92,146,49.1,58.1,38.7,00000
46.0,70.0,59.0,135,09,01,  Isa Chara,28,62,13,30,15,32,31.1,30.2,31.9,00000
46.0,70.0,59.0,135,10,01,  Khalu Kumer Para,34,53,22,22,12,31,39.1,50.0,27.9,00000
46.0,70.0,59.0,135,11,01,  Chatta Kar Para,34,60,18,25,16,35,36.2,41.9,31.4,00000
46.0,70.0,59.0,135,12,01,  Asutus Karbari Para,31,27,19,12,12,15,53.4,61.3,44.4,00000
46.0,70.0,59.0,542,01,01,  Daia Headman Para,48,63,29,23,19,40,43.2,55.8,32.2,00000
46.0,70.0,59.0,542,02,01,  Tapta Master Para,72,58,40,19,32,39,55.4,67.8,45.1,00000
46.0,70.0,59.0,542,03,01,  Hari Punna Karbari Para,45,113,31,48,14,65,28.5,39.2,17.7,00000
46.0,70.0,59.0,542,04,01,  Haya Chandra Para,7,12,5,6,2,6,36.8,45.5,25.0,00000
46.0,70.0,59.0,542,05,01,  Dharani Mohan Karbari Para,30,88,20,37,10,51,25.4,35.1,16.4,00000
46.0,70.0,59.0,542,06,01,  Rabi Chandra Para,3,27,3,11,0,16,10.0,21.4,0.0,00000
46.0,70.0,59.0,542,07,01,  Khathali Para,14,67,11,32,3,35,17.3,25.6,7.9,00000
46.0,70.0,59.0,542,08,01,  Digandra Karbari Para,12,27,7,9,5,18,30.8,43.8,21.7,00000
46.0,70.0,59.0,542,09,01,  Chandra Phunna Karbari Para,41,115,26,47,15,68,26.3,35.6,18.1,00000
46.0,70.0,59.0,542,10,01,  Birandra Karbari Para,37,157,22,69,15,88,19.1,24.2,14.6,00000
46.0,70.0,59.0,542,11,01,  Boktha Para,40,95,27,41,13,54,29.6,39.7,19.4,00000
46.0,70.0,59.0,542,12,01,  Karala Sen Para,18,43,13,20,5,23,29.5,39.4,17.9,00000
46.0,70.0,59.0,587,01,01,  Bazandra Para,100,392,68,180,32,212,20.3,27.4,13.1,00000
46.0,70.0,59.0,587,02,01,  Lamba Chara,11,82,9,39,2,43,11.8,18.8,4.4,00000
46.0,70.0,59.0,904,01,01,  Rhydai Membar Para,112,144,57,65,55,79,43.8,46.7,41.0,00000
46.0,70.0,59.0,904,02,01,  Kapa Para,37,83,24,31,13,52,30.8,43.6,20.0,00000
46.0,70.0,59.0,904,03,01,  Ramanonda Headman Para,119,153,77,61,42,92,43.8,55.8,31.3,00000
46.0,70.0,59.0,904,04,01,  Naryan Sean Karbari Para,41,54,27,22,14,32,43.2,55.1,30.4,00000
46.0,70.0,59.0,904,05,01,  Khada Para,8,37,5,14,3,23,17.8,26.3,11.5,00000
46.0,70.0,59.0,904,06,01,  Taikatang Para,15,15,12,4,3,11,50.0,75.0,21.4,00000
46.0,70.0,59.0,904,07,01,  Hacuk Para,13,40,7,16,6,24,24.5,30.4,20.0,00000
46.0,70.0,59.0,904,08,01,  Herandra Lal Karbari Para,29,114,21,52,8,62,20.3,28.8,11.4,00000
46.0,70.0,59.0,904,09,01,  Thi Pai Para,33,42,20,19,13,23,44.0,51.3,36.1,00000
46.0,70.0,59.0,904,10,01,  Barai Chandra Karbari Para,3,39,0,18,3,21,7.1,0.0,12.5,00000
46.0,70.0,59.0,904,11,01,  Kamal Charon Karbari Para,42,71,28,25,14,46,37.2,52.8,23.3,00000
46.0,70.0,59.0,994,01,01,  Laksmi Chara,26,166,26,77,0,89,13.5,25.2,0.0,00000
46.0,70.0,59.0,994,02,01,  Jamini Chara,1,108,1,56,0,52,0.9,1.8,0.0,00000
46.0,70.0,59.0,994,03,01,  Cichok Para,75,96,61,35,14,61,43.9,63.5,18.7,00000
46.0,70.0,59.0,994,04,01,  Sadia Para,8,109,7,56,1,53,6.8,11.1,1.9,00000
46.0,70.0,59.0,994,05,01,  Denti Ram Para,13,109,8,62,5,47,10.7,11.4,9.6,00000
46.0,70.0,59.0,994,06,01,  Thang Thung Para,36,129,23,60,13,69,21.8,27.7,15.9,00000
46.0,70.0,59.0,994,07,01,  Nara Chandra Karbari Para,16,29,7,14,9,15,35.6,33.3,37.5,00000
46.0,70.0,59.0,994,08,01,  No-4 Rubber Bagan,26,138,12,71,14,67,15.9,14.5,17.3,00000
46.0,70.0,59.0,994,09,01,  No-3 Rubber Bagan,15,51,10,20,5,31,22.7,33.3,13.9,00000
46.0,70.0,59.0,994,10,01,  Tai Kumba Para,38,71,16,28,22,43,34.9,36.4,33.8,00000
46.0,70.0,59.0,994,11,01,  Bill Para,24,40,15,18,9,22,37.5,45.5,29.0,00000
46.0,70.0,59.0,994,12,01,  Bazar Chowdhury Para,102,105,50,43,52,62,49.3,53.8,45.6,00000
46.0,70.0,59.0,994,13,01,  Saday Para,5,45,3,24,2,21,10.0,11.1,8.7,00000
46.0,70.0,59.0,994,14,01,  Abhya Muk/Doniram Para,31,166,21,76,10,90,15.7,21.6,10.0,00000
46.0,70.0,59.0,994,15,01,  Gokul Para,36,140,28,66,8,74,20.5,29.8,9.8,00000
46.0,70.0,59.0,994,16,01,  Munshe Para,26,62,15,29,11,33,29.5,34.1,25.0,00000
46.0,70.0,59.0,994,17,01,  Chilock Para,13,37,9,16,4,21,26.0,36.0,16.0,00000
46.0,70.0,59.0,994,18,01,  No-2 Rubber Bagan,29,134,23,58,6,76,17.8,28.4,7.3,00000
46.0,70.0,59.0,994,19,01,  No-1 Rubber Bagan,54,133,25,58,29,75,28.9,30.1,27.9,00000
46.0,70.0,59.0,994,20,01,  Gogan Chandra Karbari Para,50,84,33,37,17,47,37.3,47.1,26.6,00000
46.0,70.0,59.0,994,21,01,  Headman Para,101,62,68,26,33,36,62.0,72.3,47.8,00000
46.0,70.0,59.0,994,22,01,  D.P. Para,37,50,24,17,13,33,42.5,58.5,28.3,00000
46.0,70.0,59.0,994,23,01,  Rangkong Para,77,176,53,80,24,96,30.4,39.8,20.0,00000
46.0,70.0,59.0,994,24,01,  Chakra Para,17,16,11,8,6,8,51.5,57.9,42.9,00000
46.0,70.0,76.0,380,01,01,  Muslim Para(Bara Bil),200,400,111,199,89,201,33.3,35.8,30.7,00000
46.0,70.0,76.0,380,02,01,  Kala Miah Sardar Para,140,200,78,98,62,102,41.2,44.3,37.8,00000
46.0,70.0,76.0,380,03,01,  Moll Para,201,281,100,138,101,143,41.7,42.0,41.4,00000
46.0,70.0,76.0,380,04,01,  Comilla Tila,246,171,125,70,121,101,59.0,64.1,54.5,00000
46.0,70.0,76.0,380,05,01,  Sheru Sordar Para,225,311,121,160,104,151,42.0,43.1,40.8,00000
46.0,70.0,76.0,380,06,01,  Dewan Para,711,756,406,330,305,426,48.5,55.2,41.7,00000
46.0,70.0,76.0,380,07,01,  Ramzan Member Para,287,394,156,185,131,209,42.1,45.7,38.5,00000
46.0,70.0,76.0,380,08,01,  Adhasha Gram/Bazar Para,169,268,76,121,93,147,38.7,38.6,38.8,00000
46.0,70.0,76.0,380,09,01,  Liesa Para,157,292,104,131,53,161,35.0,44.3,24.8,00000
46.0,70.0,76.0,380,10,01,  Tazul Islam Sarder Para,91,277,60,129,31,148,24.7,31.7,17.3,00000
46.0,70.0,76.0,380,11,01,  Sorker Para,228,444,121,202,107,242,33.9,37.5,30.7,00000
46.0,70.0,76.0,380,12,01,  Dan Miah Para/Taher Sarderpara,246,194,131,102,115,92,55.9,56.2,55.6,00000
46.0,70.0,76.0,380,13,01,  Raja Mongol/Gourango Para,132,287,68,132,64,155,31.5,34.0,29.2,00000
46.0,70.0,76.0,380,14,01,  Mamtaz Sarder Para,177,332,74,167,103,165,34.8,30.7,38.4,00000
46.0,70.0,76.0,380,15,01,  Aslam Doctor Para,138,225,64,103,74,122,38.0,38.3,37.8,00000
46.0,70.0,76.0,380,16,01,  Abdul Karim Sardar Para,168,253,84,119,84,134,39.9,41.4,38.5,00000
46.0,70.0,76.0,380,17,01,  Madrasa Para,186,249,93,100,93,149,42.8,48.2,38.4,00000
46.0,70.0,76.0,380,18,01,  Hazi Para,169,200,98,86,71,114,45.8,53.3,38.4,00000
46.0,70.0,76.0,380,19,01,  Mohamadpur Para,85,212,45,107,40,105,28.6,29.6,27.6,00000
46.0,70.0,76.0,380,20,01,  Shawdagar Para,91,211,46,107,45,104,30.1,30.1,30.2,00000
46.0,70.0,76.0,380,21,01,  Sukna Chari,481,682,259,317,222,365,41.4,45.0,37.8,00000
46.0,70.0,76.0,380,22,01,  Talukder Para,241,270,130,121,111,149,47.2,51.8,42.7,00000
46.0,70.0,76.0,380,23,01,  Tula Tali,422,432,234,197,188,235,49.4,54.3,44.4,00000
46.0,70.0,76.0,380,24,01,  Ram Babur Daba,239,201,130,89,109,112,54.3,59.4,49.3,00000
46.0,70.0,76.0,980,01,01,  Master Para/Mong.Karbari Para,292,266,165,105,127,161,52.3,61.1,44.1,00000
46.0,70.0,76.0,980,02,01,  Moktab Para/Hasna Taz Para,343,281,180,127,163,154,55.0,58.6,51.4,00000
46.0,70.0,76.0,980,03,01,  Bhuyan Para/Hazi Para,201,222,114,91,87,131,47.5,55.6,39.9,00000
46.0,70.0,76.0,980,04,01,  Bilat Miah Sarder Para/Bong Pa,331,364,172,156,159,208,47.6,52.4,43.3,00000
46.0,70.0,83.0,200,01,01,  Boga Para,76,113,49,45,27,68,40.2,52.1,28.4,00000
46.0,70.0,83.0,200,02,01,  Milon Para,53,172,35,76,18,96,23.6,31.5,15.8,00000
46.0,70.0,83.0,200,03,01,  Manudas Member Para,100,134,79,54,21,80,42.7,59.4,20.8,00000
46.0,70.0,83.0,200,04,01,  Bisho Member Para,90,77,68,34,22,43,53.9,66.7,33.8,00000
46.0,70.0,83.0,200,05,01,  Marma Para,72,156,38,64,34,92,31.6,37.3,27.0,00000
46.0,70.0,83.0,200,06,01,  Momtaz Sordar Para,63,54,31,17,32,37,53.8,64.6,46.4,00000
46.0,70.0,83.0,200,07,01,  Ali Azam Sarder Para,82,102,41,44,41,58,44.6,48.2,41.4,00000
46.0,70.0,83.0,200,08,01,  Asu Sordar Para,129,108,66,48,63,60,54.4,57.9,51.2,00000
46.0,70.0,83.0,200,09,01,  Shahid Sarder Para,81,86,35,42,46,44,48.5,45.5,51.1,00000
46.0,70.0,83.0,200,10,01,  Abu Taher Sordar Para,118,138,58,57,60,81,46.1,50.4,42.6,00000
46.0,70.0,83.0,200,11,01,  Islam Pur,128,108,65,47,63,61,54.2,58.0,50.8,00000
46.0,70.0,83.0,200,12,01,  Barak Leadar Para,132,162,71,73,61,89,44.9,49.3,40.7,00000
46.0,70.0,83.0,200,13,01,  Karam Ali Sordar Para,39,74,23,29,16,45,34.5,44.2,26.2,00000
46.0,70.0,83.0,200,14,01,  Hadayet Ullah Sarder Para,122,108,61,49,61,59,53.0,55.5,50.8,00000
46.0,70.0,83.0,200,15,01,  Habil Mamber Para,145,185,77,90,68,95,43.9,46.1,41.7,00000
46.0,70.0,83.0,200,16,01,  Shaheb Ali Sarder Para,193,158,95,68,98,90,55.0,58.3,52.1,00000
46.0,70.0,83.0,200,17,01,  Ali Sordar Para,31,121,17,54,14,67,20.4,23.9,17.3,00000
46.0,70.0,83.0,200,18,01,  Sobhan Sordar Para,34,125,19,58,15,67,21.4,24.7,18.3,00000
46.0,70.0,83.0,200,19,01,  Kishno Dyal Sordar Para,17,33,10,14,7,19,34.0,41.7,26.9,00000
46.0,70.0,83.0,200,20,01,  Sharbesh Para,54,115,38,50,16,65,32.0,43.2,19.8,00000
46.0,70.0,83.0,965,01,01,  Bandor Sing Para,107,87,98,44,9,43,55.2,69.0,17.3,00000
46.0,70.0,83.0,965,02,01,  Budong Para,67,146,43,67,24,79,31.5,39.1,23.3,00000
46.0,70.0,83.0,965,03,01,  Batty Tila,14,64,10,22,4,42,17.9,31.3,8.7,00000
46.0,70.0,83.0,965,04,01,  Eidon Para,105,253,50,113,55,140,29.3,30.7,28.2,00000
46.0,70.0,83.0,965,05,01,  Monzil Sordar Para,127,256,69,123,58,133,33.2,35.9,30.4,00000
46.0,70.0,83.0,965,06,01,  Bot Tal,96,133,43,54,53,79,41.9,44.3,40.2,00000
46.0,70.0,83.0,965,07,01,  Amior Sarder Para,205,303,113,136,92,167,40.4,45.4,35.5,00000
46.0,70.0,83.0,965,08,01,  Maizpara Junabali Sarder Para,80,131,46,59,34,72,37.9,43.8,32.1,00000
46.0,70.0,83.0,965,09,01,  Bazar Tilla,97,126,53,46,44,80,43.5,53.5,35.5,00000
46.0,70.0,83.0,965,10,01,  Momin Sordar Para,110,212,52,107,58,105,34.2,32.7,35.6,00000
46.0,70.0,83.0,965,11,01,  Joynal Sordar Para,55,125,27,57,28,68,30.6,32.1,29.2,00000
46.0,70.0,83.0,965,12,01,  Qutib Uddin Para,121,280,60,129,61,151,30.2,31.7,28.8,00000
46.0,70.0,83.0,965,13,01,  Youb Sordar Para,176,289,99,139,77,150,37.8,41.6,33.9,00000
46.0,70.0,83.0,965,14,01,  Forid Sordar Para,196,128,106,52,90,76,60.5,67.1,54.2,00000
46.0,70.0,83.0,965,15,01,  Kashem Sardar Para,239,226,127,96,112,130,51.4,57.0,46.3,00000
46.0,70.0,83.0,965,16,01,  Tikka Boshon Karbari Para,36,100,24,51,12,49,26.5,32.0,19.7,00000
46.0,70.0,83.0,965,17,01,  Profullo Ronzon Tripura,17,116,11,55,6,61,12.8,16.7,9.0,00000
46.0,70.0,83.0,965,18,01,  Kala Mia Sordar Para,163,92,93,42,70,50,63.9,68.9,58.3,00000
46.0,70.0,83.0,965,19,01,  Bagmara Ali Azzam Sordar Para,130,101,72,37,58,64,56.3,66.1,47.5,00000
46.0,70.0,83.0,965,20,01,  Soltan Sordar Para,120,213,67,104,53,109,36.0,39.2,32.7,00000
46.0,70.0,83.0,965,21,01,  Muslim Para,78,63,45,27,33,36,55.3,62.5,47.8,00000
46.0,70.0,83.0,965,22,01,  Ansar Sordar Para,144,173,74,73,70,100,45.4,50.3,41.2,00000
46.0,70.0,83.0,965,23,01,  Abu Hanif Member Para,316,181,175,82,141,99,63.6,68.1,58.8,00000
46.0,70.0,83.0,965,24,01,  Tongo Mohazon Para,110,78,76,31,34,47,58.5,71.0,42.0,00000
46.0,70.0,83.0,965,25,01,  Shodila Rongon Headman Para,121,395,91,174,30,221,23.4,34.3,12.0,00000
46.0,77.0,19.0,382,01,01,  Durgamuni Para,152,292,106,130,46,162,34.2,44.9,22.1,00000
46.0,77.0,19.0,382,02,01,  Amarendra Para,82,100,52,39,30,61,45.1,57.1,33.0,00000
46.0,77.0,19.0,382,03,01,  Karap Chandra Para,82,127,48,55,34,72,39.2,46.6,32.1,00000
46.0,77.0,19.0,382,04,01,  Subal Chandra Para,31,67,21,33,10,34,31.6,38.9,22.7,00000
46.0,77.0,19.0,382,05,01,  Anga Para,60,90,44,41,16,49,40.0,51.8,24.6,00000
46.0,77.0,19.0,382,06,01,  Ratnasen Para,40,82,22,39,18,43,32.8,36.1,29.5,00000
46.0,77.0,19.0,382,07,01,  Budharam Para,95,197,53,88,42,109,32.5,37.6,27.8,00000
46.0,77.0,19.0,382,08,01,  Matuli Para,14,28,7,9,7,19,33.3,43.8,26.9,00000
46.0,77.0,19.0,382,09,01,  Laksrami Para,45,52,23,23,22,29,46.4,50.0,43.1,00000
46.0,77.0,19.0,382,10,01,  Natun Para,4,31,4,15,0,16,11.4,21.1,0.0,00000
46.0,77.0,19.0,382,11,01,  Jetendra Para,221,148,131,56,90,92,59.9,70.1,49.5,00000
46.0,77.0,19.0,382,12,01,  Lendiya Para,72,62,43,20,29,42,53.7,68.3,40.8,00000
46.0,77.0,19.0,382,13,01,  Dhanya Chandra Para,203,247,126,109,77,138,45.1,53.6,35.8,00000
46.0,77.0,19.0,382,14,01,  Madhumangal Para,90,139,51,64,39,75,39.3,44.3,34.2,00000
46.0,77.0,19.0,382,15,01,  Kinadhan Baidya Para,128,264,70,108,58,156,32.7,39.3,27.1,00000
46.0,77.0,19.0,382,16,01,  Chadra Karbari Para,208,174,118,80,90,94,54.5,59.6,48.9,00000
46.0,77.0,19.0,382,17,01,  Shurjya Mohan Para,113,68,74,21,39,47,62.4,77.9,45.3,00000
46.0,77.0,19.0,382,18,01,  Rajmohan Para,13,4,7,1,6,3,76.5,87.5,66.7,00000
46.0,77.0,19.0,382,19,01,  Karuna Mohan Para,39,31,23,6,16,25,55.7,79.3,39.0,00000
46.0,77.0,19.0,382,20,01,  Nilamoni Para,138,165,76,74,62,91,45.5,50.7,40.5,00000
46.0,77.0,19.0,382,21,01,  Braja Mahan Para,92,117,53,55,39,62,44.0,49.1,38.6,00000
46.0,77.0,19.0,382,22,01,  Lambu Para,69,97,54,35,15,62,41.6,60.7,19.5,00000
46.0,77.0,19.0,382,23,01,  Kharga Para,118,210,84,87,34,123,36.0,49.1,21.7,00000
46.0,77.0,19.0,382,24,01,  Jagat Mohan Para,117,285,78,139,39,146,29.1,35.9,21.1,00000
46.0,77.0,19.0,382,25,01,  Pettuya Para,46,80,29,35,17,45,36.5,45.3,27.4,00000
46.0,77.0,19.0,382,26,01,  Kina Moni Para,9,63,6,30,3,33,12.5,16.7,8.3,00000
46.0,77.0,19.0,382,27,01,  Mangal Dhan Para,37,76,22,37,15,39,32.7,37.3,27.8,00000
46.0,77.0,19.0,382,28,01,  Jagat Sen Para,53,155,31,68,22,87,25.5,31.3,20.2,00000
46.0,77.0,19.0,382,29,01,  Jubananasha Para,112,308,67,144,45,164,26.7,31.8,21.5,00000
46.0,77.0,19.0,382,30,01,  Shamvu Ray Para,55,265,35,118,20,147,17.2,22.9,12.0,00000
46.0,77.0,19.0,382,31,01,  Pusta Ray Para,30,172,27,88,3,84,14.9,23.5,3.4,00000
46.0,77.0,19.0,382,32,01,  Thakki Ray Para,10,88,7,40,3,48,10.2,14.9,5.9,00000
46.0,77.0,19.0,382,33,01,  Ramani Para,4,90,2,41,2,49,4.3,4.7,3.9,00000
46.0,77.0,38.0,535,01,01,  Kangchari Para,198,341,120,153,78,188,36.7,44.0,29.3,00000
46.0,77.0,38.0,535,02,01,  Bamvu Para,135,203,88,86,47,117,39.9,50.6,28.7,00000
46.0,77.0,38.0,535,03,01,  Kathal Muni Para,20,288,12,141,8,147,6.5,7.8,5.2,00000
46.0,77.0,38.0,535,04,01,  Anakka Chara,66,153,42,75,24,78,30.1,35.9,23.5,00000
46.0,77.0,38.0,535,05,01,  Chuta Bari,33,66,23,27,10,39,33.3,46.0,20.4,00000
46.0,77.0,38.0,535,06,01,  Khealadhula Para,40,155,23,68,17,87,20.5,25.3,16.3,00000
46.0,77.0,38.0,535,07,01,  Chingchapara,22,181,12,90,10,91,10.8,11.8,9.9,00000
46.0,77.0,38.0,870,01,01,  Kanaray Para,2,135,2,74,0,61,1.5,2.6,0.0,00000
46.0,77.0,38.0,870,02,01,  Durchari Para,49,132,27,73,22,59,27.1,27.0,27.2,00000
46.0,77.0,38.0,870,03,01,  Ramshing Para,108,111,71,39,37,72,49.3,64.5,33.9,00000
46.0,77.0,38.0,870,04,01,  Khamar Para,17,14,12,8,5,6,54.8,60.0,45.5,00000
46.0,77.0,38.0,870,05,01,  Gangaram Para,24,131,20,62,4,69,15.5,24.4,5.5,00000
46.0,77.0,38.0,870,06,01,  Santi Ranjan Para,32,60,19,31,13,29,34.8,38.0,31.0,00000
46.0,77.0,38.0,870,07,01,  Madhu Para,29,203,21,92,8,111,12.5,18.6,6.7,00000
46.0,77.0,38.0,870,08,01,  Pradip Para,120,153,80,60,40,93,44.0,57.1,30.1,00000
46.0,77.0,38.0,870,09,01,  Kistamuhan Para,19,38,11,20,8,18,33.3,35.5,30.8,00000
46.0,77.0,38.0,870,10,01,  Ramdash Para,23,24,14,9,9,15,48.9,60.9,37.5,00000
46.0,77.0,38.0,870,11,01,  Bali Para,21,187,13,95,8,92,10.1,12.0,8.0,00000
46.0,77.0,38.0,870,12,01,  Jamindhan Para,52,97,32,49,20,48,34.9,39.5,29.4,00000
46.0,77.0,38.0,870,13,01,  Lila Muhan Para,176,117,94,43,82,74,60.1,68.6,52.6,00000
46.0,77.0,38.0,870,14,01,  Candranath Para,123,124,68,48,55,76,49.8,58.6,42.0,00000
46.0,77.0,38.0,870,15,01,  Nabin Chandra Para,186,122,102,45,84,77,60.4,69.4,52.2,00000
46.0,77.0,38.0,870,16,01,  Principal Para,61,12,27,6,34,6,83.6,81.8,85.0,00000
46.0,77.0,38.0,870,17,01,  Uttar Nalkata,138,189,79,113,59,76,42.2,41.1,43.7,00000
46.0,77.0,38.0,870,18,01,  Daskin Nalkata,90,147,47,70,43,77,38.0,40.2,35.8,00000
46.0,77.0,38.0,870,19,01,  Purba Nalkata,65,107,44,54,21,53,37.8,44.9,28.4,00000
46.0,77.0,38.0,870,20,01,  Ugyajai Para,99,114,57,54,42,60,46.5,51.4,41.2,00000
46.0,77.0,38.0,870,21,01,  Nabin Chan Para,248,171,151,62,97,109,59.2,70.9,47.1,00000
46.0,77.0,38.0,870,22,01,  Harishadan Para,26,45,17,18,9,27,36.6,48.6,25.0,00000
46.0,77.0,38.0,870,23,01,  Head Man Para,30,47,16,17,14,30,39.0,48.5,31.8,00000
46.0,77.0,38.0,870,24,01,  Dhukhiram Para,21,31,11,15,10,16,40.4,42.3,38.5,00000
46.0,77.0,38.0,870,25,01,  Porabari,14,92,9,43,5,49,13.2,17.3,9.3,00000
46.0,77.0,38.0,870,26,01,  Suknachari Para/Lalitmohan Par,73,170,49,77,24,93,30.0,38.9,20.5,00000
46.0,77.0,38.0,870,27,01,  Karigar Para,84,207,56,85,28,122,28.9,39.7,18.7,00000
46.0,77.0,38.0,870,28,01,  Rejamoni Para,15,44,10,19,5,25,25.4,34.5,16.7,00000
46.0,77.0,38.0,870,29,01,  Pulinpur,155,62,86,26,69,36,71.4,76.8,65.7,00000
46.0,77.0,57.0,153,01,01,  Patikumar Para,7,141,5,74,2,67,4.7,6.3,2.9,00000
46.0,77.0,57.0,153,02,01,  Mudhuram Karbari Para,0,12,0,6,0,6,0.0,0.0,0.0,00000
46.0,77.0,57.0,153,03,01,  Ramtonu Para,18,200,16,100,2,100,8.3,13.8,2.0,00000
46.0,77.0,57.0,153,04,01,  Yadhuk Chara,16,17,10,6,6,11,48.5,62.5,35.3,00000
46.0,77.0,57.0,153,05,01,  Benga Para,31,161,20,76,11,85,16.1,20.8,11.5,00000
46.0,77.0,57.0,153,06,01,  Bhudha Moni Para,7,6,5,0,2,6,53.8,100.0,25.0,00000
46.0,77.0,57.0,153,07,01,  Shindu Kumar Para,4,14,3,7,1,7,22.2,30.0,12.5,00000
46.0,77.0,57.0,153,08,01,  Bidya Mohan Para,6,94,5,46,1,48,6.0,9.8,2.0,00000
46.0,77.0,57.0,153,09,01,  Riyang Chara Para,21,62,11,31,10,31,25.3,26.2,24.4,00000
46.0,77.0,57.0,153,10,01,  Kashi Para,3,68,3,33,0,35,4.2,8.3,0.0,00000
46.0,77.0,57.0,153,11,01,  Alendra Para,31,98,21,50,10,48,24.0,29.6,17.2,00000
46.0,77.0,57.0,153,12,01,  Ganja Para,16,77,11,43,5,34,17.2,20.4,12.8,00000
46.0,77.0,57.0,153,13,01,  Fatema Nagar,322,357,173,158,149,199,47.4,52.3,42.8,00000
46.0,77.0,57.0,153,14,01,  Niladhan Para,16,66,10,30,6,36,19.5,25.0,14.3,00000
46.0,77.0,57.0,153,15,01,  Takkhupeda Para,34,36,23,12,11,24,48.6,65.7,31.4,00000
46.0,77.0,57.0,153,16,01,  Harigopal Para,34,88,20,40,14,48,27.9,33.3,22.6,00000
46.0,77.0,57.0,153,17,01,  Jotha Khamar Para,13,33,6,13,7,20,28.3,31.6,25.9,00000
46.0,77.0,57.0,153,18,01,  Shaotal Para,19,36,10,14,9,22,34.5,41.7,29.0,00000
46.0,77.0,57.0,153,19,01,  Pradip Para,21,60,14,27,7,33,25.9,34.1,17.5,00000
46.0,77.0,57.0,153,20,01,  Chitta Ranjan Para,31,51,16,22,15,29,37.8,42.1,34.1,00000
46.0,77.0,57.0,153,21,01,  Birendra Karbari Para,84,154,44,70,40,84,35.3,38.6,32.3,00000
46.0,77.0,57.0,153,22,01,  Pachim Madan Karbari Para,34,60,19,25,15,35,36.2,43.2,30.0,00000
46.0,77.0,57.0,612,01,01,  Chankhola Para,45,104,28,46,17,58,30.2,37.8,22.7,00000
46.0,77.0,57.0,612,02,01,  Ghilatuli Para,38,97,25,40,13,57,28.1,38.5,18.6,00000
46.0,77.0,57.0,612,03,01,  Shimana Para,81,106,61,47,20,59,43.3,56.5,25.3,00000
46.0,77.0,57.0,612,04,01,  Hatimara Para,53,108,28,53,25,55,32.9,34.6,31.3,00000
46.0,77.0,57.0,612,05,01,  Madhuranjanj Para,33,61,22,30,11,31,35.1,42.3,26.2,00000
46.0,77.0,57.0,612,06,01,  Harubil Para,128,235,77,103,51,132,35.3,42.8,27.9,00000
46.0,77.0,57.0,612,07,01,  Rupsen Para,89,211,65,94,24,117,29.7,40.9,17.0,00000
46.0,77.0,57.0,612,08,01,  Dhuduk Chara,273,407,164,172,109,235,40.1,48.8,31.7,00000
46.0,77.0,57.0,612,09,01,  Nandhan Para,36,12,34,4,2,8,75.0,89.5,20.0,00000
46.0,77.0,57.0,612,10,01,  Sneha Mohan Para,9,67,6,35,3,32,11.8,14.6,8.6,00000
46.0,77.0,57.0,612,11,01,  Kharga Para,9,29,8,12,1,17,23.7,40.0,5.6,00000
46.0,77.0,57.0,612,12,01,  Prem Kumar Para,6,80,5,39,1,41,7.0,11.4,2.4,00000
46.0,77.0,57.0,612,13,01,  Rabidhan Para,47,148,34,67,13,81,24.1,33.7,13.8,00000
46.0,77.0,57.0,612,14,01,  Shukhamani Para,29,53,21,22,8,31,35.4,48.8,20.5,00000
46.0,77.0,57.0,612,15,01,  Varat Barsa Para,191,105,110,43,81,62,64.5,71.9,56.6,00000
46.0,77.0,57.0,612,16,01,  Ananda Mohan Para,229,266,128,107,101,159,46.3,54.5,38.8,00000
46.0,77.0,57.0,612,17,01,  Babura Para,192,110,111,38,81,72,63.6,74.5,52.9,00000
46.0,77.0,57.0,612,18,01,  Logang Muslim Para,452,292,241,136,211,156,60.8,63.9,57.5,00000
46.0,77.0,57.0,612,19,01,  Logang Bazar Para,330,134,176,45,154,89,71.1,79.6,63.4,00000
46.0,77.0,57.0,612,20,01,  Brihat Chandra Para,113,192,67,73,46,119,37.0,47.9,27.9,00000
46.0,77.0,57.0,612,21,01,  Krishna Karbari Para,1,36,0,18,1,18,2.7,0.0,5.3,00000
46.0,77.0,57.0,612,22,01,  Shuchendra Karbari Para,45,96,27,39,18,57,31.9,40.9,24.0,00000
46.0,77.0,57.0,612,23,01,  Chikan Chan Para,67,174,37,81,30,93,27.8,31.4,24.4,00000
46.0,77.0,57.0,612,24,01,  Shachi Karbari Para,20,44,13,21,7,23,31.3,38.2,23.3,00000
46.0,77.0,57.0,612,25,01,  Kharga Karbari Para,4,42,4,23,0,19,8.7,14.8,0.0,00000
46.0,77.0,57.0,612,26,01,  Ramtank Para,15,16,11,6,4,10,48.4,64.7,28.6,00000
46.0,77.0,57.0,612,27,01,  Rajendra Para,69,70,36,30,33,40,49.6,54.5,45.2,00000
46.0,77.0,57.0,612,28,01,  Abinash Para,127,88,71,40,56,48,59.1,64.0,53.8,00000
46.0,77.0,57.0,612,29,01,  Pahar Chan Para,78,88,47,34,31,54,47.0,58.0,36.5,00000
46.0,77.0,57.0,612,30,01,  Jotish Para,84,71,41,36,43,35,54.2,53.2,55.1,00000
46.0,77.0,57.0,612,31,01,  Muni Karbari Para,66,117,40,51,26,66,36.1,44.0,28.3,00000
46.0,77.0,57.0,612,32,01,  Ranjan Para,24,41,12,18,12,23,36.9,40.0,34.3,00000
46.0,77.0,57.0,612,33,01,  Mudhu Ram Para,72,63,44,30,28,33,53.3,59.5,45.9,00000
46.0,77.0,57.0,612,34,01,  Anli Para,68,117,40,57,28,60,36.8,41.2,31.8,00000
46.0,77.0,57.0,612,35,01,  Pravu Moni Para,66,119,41,50,25,69,35.7,45.1,26.6,00000
46.0,77.0,57.0,612,36,01,  Nihar Bindu Para,16,9,9,3,7,6,64.0,75.0,53.8,00000
46.0,77.0,76.0,765,01,03,  Kistamuni Para,33,168,33,81,0,87,16.4,28.9,0.0,00000
46.0,77.0,76.0,765,02,03,  Buddha Para,11,145,7,70,4,75,7.1,9.1,5.1,00000
46.0,77.0,76.0,765,03,03,  Takkhi Ray Para,12,103,10,46,2,57,10.4,17.9,3.4,00000
46.0,77.0,76.0,765,04,03,  Ramani Para,4,32,4,13,0,19,11.1,23.5,0.0,00000
46.0,77.0,76.0,765,05,03,  Batya Para,42,120,31,55,11,65,25.9,36.0,14.5,00000
46.0,77.0,76.0,765,06,03,  Degal Chari Para,0,47,0,24,0,23,0.0,0.0,0.0,00000
46.0,77.0,76.0,765,07,03,  Bira Kumar Para,18,51,12,26,6,25,26.1,31.6,19.4,00000
46.0,77.0,76.0,765,08,03,  Rajkumar Para,23,57,16,24,7,33,28.8,40.0,17.5,00000
46.0,77.0,76.0,765,09,03,  Tapita Para,67,158,43,68,24,90,29.8,38.7,21.1,00000
46.0,77.0,76.0,765,10,03,  Baishawk Kumar Para,24,40,21,22,3,18,37.5,48.8,14.3,00000
46.0,77.0,76.0,765,11,03,  Devendra Para,109,203,62,97,47,106,34.9,39.0,30.7,00000
46.0,77.0,76.0,765,12,03,  Rakhi Muni Para,5,52,4,24,1,28,8.8,14.3,3.4,00000
46.0,77.0,76.0,765,13,03,  Dhighiray Para,9,66,5,30,4,36,12.0,14.3,10.0,00000
46.0,77.0,76.0,765,14,03,  Udayshangkar Para,131,224,84,102,47,122,36.9,45.2,27.8,00000
46.0,77.0,76.0,765,15,03,  Haladar Para,60,137,41,58,19,79,30.5,41.4,19.4,00000
46.0,77.0,76.0,765,16,03,  Deva Mitra Para,23,26,15,8,8,18,46.9,65.2,30.8,00000
46.0,77.0,76.0,765,17,03,  Punna Chan Para,28,28,15,11,13,17,50.0,57.7,43.3,00000
46.0,77.0,76.0,765,18,03,  Jogeshar Para,134,180,84,77,50,103,42.7,52.2,32.7,00000
46.0,77.0,76.0,765,19,03,  Pujgang Para,38,38,26,14,12,24,50.0,65.0,33.3,00000
46.0,77.0,76.0,765,20,03,  Ali Charan Para,102,170,61,73,41,97,37.5,45.5,29.7,00000
46.0,77.0,76.0,765,21,03,  Binachan Para,92,58,51,23,41,35,61.3,68.9,53.9,00000
46.0,77.0,76.0,765,22,03,  Khinachan Para,96,175,56,84,40,91,35.4,40.0,30.5,00000
46.0,77.0,76.0,765,23,03,  Khanungo Para,102,197,58,89,44,108,34.1,39.5,28.9,00000
46.0,77.0,76.0,765,24,03,  Islampur,240,203,130,81,110,122,54.2,61.6,47.4,00000
46.0,77.0,76.0,765,25,03,  Mohammadpur,545,503,259,222,286,281,52.0,53.8,50.4,00000
46.0,77.0,76.0,765,26,03,  Madan Karbari Para,39,18,24,7,15,11,68.4,77.4,57.7,00000
46.0,77.0,76.0,765,27,03,  Jota Khamar,42,124,21,59,21,65,25.3,26.3,24.4,00000
46.0,77.0,76.0,765,28,03,  Army Zone,58,0,58,0,0,0,100.0,100.0,0.0,00000
46.0,77.0,76.0,765,29,03,  Upazila Sadar,135,26,96,9,39,17,83.9,91.4,69.6,00000
46.0,77.0,76.0,765,30,03,  Muslim Para Polic Station,240,154,130,71,110,83,60.9,64.7,57.0,00000
46.0,77.0,76.0,765,31,03,  Saotal Para,311,214,158,102,153,112,59.2,60.8,57.7,00000
46.0,77.0,76.0,765,32,03,  Coloni Para,348,149,173,70,175,79,70.0,71.2,68.9,00000
46.0,77.0,76.0,765,33,03,  Bazar Para,634,202,399,93,235,109,75.8,81.1,68.3,00000
46.0,77.0,76.0,765,34,03,  T & T Para,555,283,294,120,261,163,66.2,71.0,61.6,00000
46.0,77.0,76.0,765,35,03,  Damdama,763,788,418,368,345,420,49.2,53.2,45.1,00000
46.0,77.0,76.0,765,36,03,  Kalanal Para,201,345,114,163,87,182,36.8,41.2,32.3,00000
46.0,77.0,76.0,765,37,03,  Shantila Para,174,252,91,117,83,135,40.8,43.8,38.1,00000
46.0,77.0,76.0,765,38,03,  Hashan Nagar,159,438,92,191,67,247,26.6,32.5,21.3,00000
46.0,77.0,76.0,765,39,03,  Talukdar Para,389,242,195,117,194,125,61.6,62.5,60.8,00000
46.0,77.0,76.0,765,40,03,  Nakul Master Para,99,70,63,31,36,39,58.6,67.0,48.0,00000
46.0,77.0,76.0,765,41,03,  Kola Bagan Para,260,77,140,33,120,44,77.2,80.9,73.2,00000
46.0,77.0,76.0,765,42,03,  Aditripura Para,308,202,176,86,132,116,60.4,67.2,53.2,00000
46.0,77.0,76.0,765,43,03,  Kamini Member Para,73,24,42,14,31,10,75.3,75.0,75.6,00000
46.0,77.0,76.0,765,44,03,  Bdr Zone,351,3,301,0,50,3,99.2,100.0,94.3,00000
46.0,77.0,76.0,765,45,03,  Achimahajan Para,157,58,82,23,75,35,73.0,78.1,68.2,00000
46.0,77.0,76.0,765,46,03,  Jatish Para,45,33,22,15,23,18,57.7,59.5,56.1,00000
46.0,77.0,76.0,765,47,03,  Chowdari Para,137,160,74,63,63,97,46.1,54.0,39.4,00000
46.0,77.0,76.0,765,48,03,  Failat Farm,420,280,228,127,192,153,60.0,64.2,55.7,00000
46.0,77.0,76.0,765,49,03,  Satyadan Para,132,69,67,26,65,43,65.7,72.0,60.2,00000
46.0,77.0,76.0,765,50,03,  Larma Para (Monju Adam),238,93,115,32,123,61,71.9,78.2,66.8,00000
46.0,77.0,76.0,765,51,03,  Kripa Charan Para,62,57,37,24,25,33,52.1,60.7,43.1,00000
46.0,77.0,76.0,765,52,03,  Rabishing Para,74,91,39,47,35,44,44.8,45.3,44.3,00000
46.0,77.0,76.0,765,53,03,  Ayubali Member Para,96,162,45,84,51,78,37.2,34.9,39.5,00000
46.0,77.0,76.0,765,54,03,  Madumangal Para,130,184,66,77,64,107,41.4,46.2,37.4,00000
46.0,77.0,76.0,765,55,03,  Jotimoy Para,201,172,113,80,88,92,53.9,58.5,48.9,00000
46.0,77.0,76.0,765,56,03,  Vakta Para,33,75,19,32,14,43,30.6,37.3,24.6,00000
46.0,77.0,76.0,765,57,03,  Gagan Chandra Para,132,329,82,137,50,192,28.6,37.4,20.7,00000
46.0,77.0,76.0,765,58,03,  Abani Para,157,229,104,92,53,137,40.7,53.1,27.9,00000
46.0,77.0,76.0,765,59,03,  Khamar Para,8,18,5,12,3,6,30.8,29.4,33.3,00000
46.0,77.0,76.0,765,60,03,  Shuresh Chandra Para,54,50,32,21,22,29,51.9,60.4,43.1,00000
46.0,77.0,76.0,765,61,03,  Nabin Chandra Para,66,126,40,57,26,69,34.4,41.2,27.4,00000
46.0,77.0,76.0,765,63,03,  Ramshing Para,4,19,3,10,1,9,17.4,23.1,10.0,00000
46.0,77.0,76.0,765,64,03,  Napita Para,184,503,113,244,71,259,26.8,31.7,21.5,00000
46.0,77.0,76.0,765,65,03,  Ratna Muni Para,53,91,33,41,20,50,36.8,44.6,28.6,00000
46.0,77.0,76.0,765,66,03,  Akkhaya Para,166,216,106,85,60,131,43.5,55.5,31.4,00000
46.0,77.0,76.0,765,67,03,  Jayanta Para,18,21,11,10,7,11,46.2,52.4,38.9,00000
46.0,77.0,89.0,459,01,01,  Gunadar Para,76,129,43,54,33,75,37.1,44.3,30.6,00000
46.0,77.0,89.0,459,02,01,  Nalinda Para,66,40,33,17,33,23,62.3,66.0,58.9,00000
46.0,77.0,89.0,459,03,01,  Padman,55,207,47,85,8,122,21.0,35.6,6.2,00000
46.0,77.0,89.0,459,04,01,  Baura Para,231,235,129,104,102,131,49.6,55.4,43.8,00000
46.0,77.0,89.0,459,05,01,  Ugalchari,118,177,74,80,44,97,40.0,48.1,31.2,00000
46.0,77.0,89.0,459,06,01,  Jhagurnala,108,262,59,131,49,131,29.2,31.1,27.2,00000
46.0,77.0,89.0,459,07,01,  Dakkhin Shantipur,349,270,218,116,131,154,56.4,65.3,46.0,00000
46.0,77.0,89.0,459,08,01,  Uttor Shantipur,133,107,75,42,58,65,55.4,64.1,47.2,00000
46.0,77.0,89.0,459,09,01,  Suta Karma Para,90,164,51,78,39,86,35.4,39.5,31.2,00000
46.0,77.0,89.0,459,10,01,  Manikkha Para,76,116,35,57,41,59,39.6,38.0,41.0,00000
46.0,77.0,89.0,459,11,01,  Jeya Nagar,456,936,224,439,232,497,32.8,33.8,31.8,00000
46.0,77.0,89.0,459,12,01,  Omar Pur,122,333,74,154,48,179,26.8,32.5,21.1,00000
46.0,77.0,89.0,459,13,01,  Maddha Nagar,230,429,125,182,105,247,34.9,40.7,29.8,00000
46.0,77.0,89.0,459,14,01,  Ali Nagar,90,199,40,90,50,109,31.1,30.8,31.4,00000
46.0,77.0,89.0,459,15,01,  Muslim Nagar,72,148,40,73,32,75,32.7,35.4,29.9,00000
46.0,77.0,89.0,459,16,01,  Rasul Nagar,52,63,36,25,16,38,45.2,59.0,29.6,00000
46.0,77.0,89.0,459,17,01,  Ulta Chari,313,271,180,106,133,165,53.6,62.9,44.6,00000
46.0,77.0,89.0,459,18,01,  Sharat Chandra Para,0,36,0,19,0,17,0.0,0.0,0.0,00000
46.0,77.0,89.0,459,19,01,  Rahindra Para,13,85,8,42,5,43,13.3,16.0,10.4,00000
46.0,77.0,89.0,459,20,01,  Prapulla Para,17,100,15,45,2,55,14.5,25.0,3.5,00000
46.0,77.0,89.0,459,21,01,  Subal Chandra Para,25,131,19,62,6,69,16.0,23.5,8.0,00000
46.0,77.0,89.0,459,22,01,  Payangtila,83,131,57,52,26,79,38.8,52.3,24.8,00000
46.0,77.0,89.0,459,23,01,  Nabaratna Para,24,117,16,61,8,56,17.0,20.8,12.5,00000
46.0,77.0,89.0,459,24,01,  Maratila,59,252,37,116,22,136,19.0,24.2,13.9,00000
46.0,77.0,89.0,459,25,01,  Mulla Para,630,923,321,423,309,500,40.6,43.1,38.2,00000
46.0,77.0,89.0,459,26,01,  Rachgng Karbari Para,32,76,16,36,16,40,29.6,30.8,28.6,00000
46.0,80.0,38.0,110,01,01,  Pagartila/Armi B.Gard,480,107,389,45,91,62,81.8,89.6,59.5,00000
46.0,80.0,38.0,110,02,01,  Amtali Para,364,271,204,134,160,137,57.3,60.4,53.9,00000
46.0,80.0,38.0,110,03,01,  Chainguli Para,75,148,49,67,26,81,33.6,42.2,24.3,00000
46.0,80.0,38.0,110,04,01,  Haji Para,222,248,121,124,101,124,47.2,49.4,44.9,00000
46.0,80.0,38.0,110,05,01,  Natun Bara Pilak,1042,1034,537,499,505,535,50.2,51.8,48.6,00000
46.0,80.0,38.0,110,06,01,  Chankhola Para,9,50,6,19,3,31,15.3,24.0,8.8,00000
46.0,80.0,38.0,110,07,01,  Rioung Morong Para,80,61,60,21,20,40,56.7,74.1,33.3,00000
46.0,80.0,38.0,110,08,01,  Shekhong Para,63,62,41,25,22,37,50.4,62.1,37.3,00000
46.0,80.0,38.0,110,09,01,  Chingda Moni Para,28,33,18,15,10,18,45.9,54.5,35.7,00000
46.0,80.0,38.0,110,10,01,  Pothachara Chakma Para,30,79,20,44,10,35,27.5,31.3,22.2,00000
46.0,80.0,38.0,110,11,01,  Thobok Para,31,58,21,23,10,35,34.8,47.7,22.2,00000
46.0,80.0,38.0,110,12,01,  Baisnab Para,27,73,17,33,10,40,27.0,34.0,20.0,00000
46.0,80.0,38.0,165,01,01,  Changuli Para,83,339,49,156,34,183,19.7,23.9,15.7,00000
46.0,80.0,38.0,165,02,01,  Kukichhara Para,65,327,43,153,22,174,16.6,21.9,11.2,00000
46.0,80.0,38.0,165,03,01,  Baraitali Para,70,172,44,72,26,100,28.9,37.9,20.6,00000
46.0,80.0,38.0,165,04,01,  Probes Chakma Para,17,92,15,41,2,51,15.6,26.8,3.8,00000
46.0,80.0,38.0,165,05,01,  Subol Chandra Para,6,45,6,22,0,23,11.8,21.4,0.0,00000
46.0,80.0,38.0,165,06,01,  Moniram Tripura Para,8,46,6,16,2,30,14.8,27.3,6.3,00000
46.0,80.0,38.0,165,07,01,  Taidong Chakma Para,13,137,8,60,5,77,8.7,11.8,6.1,00000
46.0,80.0,38.0,497,01,01,  Kalapani Chakma/Marma Para,83,237,46,105,37,132,25.9,30.5,21.9,00000
46.0,80.0,38.0,497,02,01,  Kalapani Banggali Para,186,239,85,115,101,124,43.8,42.5,44.9,00000
46.0,80.0,38.0,497,03,01,  Pathachhara Para,63,222,36,109,27,113,22.1,24.8,19.3,00000
46.0,80.0,38.0,497,04,01,  Pathachhara Chakma Para,124,89,73,36,51,53,58.2,67.0,49.0,00000
46.0,80.0,38.0,497,05,01,  Raung Marong Para,37,120,19,63,18,57,23.6,23.2,24.0,00000
46.0,80.0,38.0,497,06,01,  Remra Para,44,258,25,138,19,120,14.6,15.3,13.7,00000
46.0,80.0,38.0,497,07,01,  Chota Pilak Para,1,36,0,18,1,18,2.7,0.0,5.3,00000
46.0,80.0,38.0,497,08,01,  Choto Hapchari Para,59,340,42,159,17,181,14.8,20.9,8.6,00000
46.0,80.0,38.0,497,09,01,  Jalia Para,794,748,425,357,369,391,51.5,54.3,48.6,00000
46.0,80.0,38.0,497,10,01,  Hatimura Para,457,509,235,242,222,267,47.3,49.3,45.4,00000
46.0,80.0,38.0,497,11,01,  Woakchari Para,35,240,20,113,15,127,12.7,15.0,10.6,00000
46.0,80.0,38.0,497,12,01,  Choto Kalapani Marma Para,75,242,46,113,29,129,23.7,28.9,18.4,00000
46.0,80.0,38.0,497,13,01,  Hapchhari Para,112,160,55,88,57,72,41.2,38.5,44.2,00000
46.0,80.0,38.0,608,01,01,  Headman Para,66,46,36,16,30,30,58.9,69.2,50.0,00000
46.0,80.0,38.0,608,02,01,  Natun Para,203,198,124,77,79,121,50.6,61.7,39.5,00000
46.0,80.0,38.0,608,03,01,  Mangtukarbari Para,33,44,17,19,16,25,42.9,47.2,39.0,00000
46.0,80.0,38.0,608,04,01,  Haji Para,133,105,68,45,65,60,55.9,60.2,52.0,00000
46.0,80.0,38.0,608,05,01,  Baraitali Chirman Para,160,333,77,168,83,165,32.5,31.4,33.5,00000
46.0,80.0,38.0,608,06,01,  Nakkya Para,3,99,0,50,3,49,2.9,0.0,5.8,00000
46.0,80.0,38.0,608,07,01,  Boidda Para,10,90,4,46,6,44,10.0,8.0,12.0,00000
46.0,80.0,38.0,608,08,01,  Lobra Para,112,106,60,47,52,59,51.4,56.1,46.8,00000
46.0,80.0,38.0,608,09,01,  Thoangri Karbari Para,100,80,60,35,40,45,55.6,63.2,47.1,00000
46.0,80.0,38.0,608,10,01,  Kumuza Para,7,2,3,0,4,2,77.8,100.0,66.7,00000
46.0,80.0,38.0,608,11,01,  Marma Bady Para,16,99,10,58,6,41,13.9,14.7,12.8,00000
46.0,80.0,38.0,608,12,01,  Battoli Para,88,144,48,63,40,81,37.9,43.2,33.1,00000
46.0,80.0,38.0,773,01,01,  Nakrei Para,83,108,57,43,26,65,43.5,57.0,28.6,00000
46.0,80.0,38.0,773,02,01,  Subal Chandra Para,5,81,4,42,1,39,5.8,8.7,2.5,00000
46.0,80.0,38.0,773,03,01,  Bara Thali Para (Baija),28,70,17,30,11,40,28.6,36.2,21.6,00000
46.0,80.0,38.0,773,04,01,  Shinduk Chari Mukpara,45,205,31,102,14,103,18.0,23.3,12.0,00000
46.0,80.0,38.0,773,05,01,  Probes Chandra Para,24,46,16,26,8,20,34.3,38.1,28.6,00000
46.0,80.0,38.0,773,06,01,  Rampru Para,18,98,15,48,3,50,15.5,23.8,5.7,00000
46.0,80.0,38.0,993,01,01,  Chankhola Para,60,208,37,95,23,113,22.4,28.0,16.9,00000
46.0,80.0,38.0,993,02,01,  Chhota Pilak Para,6,40,5,18,1,22,13.0,21.7,4.3,00000
46.0,80.0,38.0,993,03,01,  Taikarma Marma Para,77,326,50,165,27,161,19.1,23.3,14.4,00000
46.0,80.0,38.0,993,04,01,  Rajendra Member Para,59,190,43,89,16,101,23.7,32.6,13.7,00000
46.0,80.0,38.0,993,05,01,  Baraitali Para,115,140,59,70,56,70,45.1,45.7,44.4,00000
46.0,80.0,38.0,993,06,01,  Taikarma Bangali Para,185,105,96,42,89,63,63.8,69.6,58.6,00000
46.0,80.0,38.0,993,07,01,  Ferkumar Para,12,132,9,61,3,71,8.3,12.9,4.1,00000
46.0,80.0,38.0,993,08,01,  Sonaram Karbari Para,53,89,29,48,24,41,37.3,37.7,36.9,00000
46.0,80.0,38.0,993,09,01,  Souludang Para,8,94,3,44,5,50,7.8,6.4,9.1,00000
46.0,80.0,57.0,663,01,01,  Dattaram Para,260,435,139,197,121,238,37.4,41.4,33.7,00000
46.0,80.0,57.0,663,02,01,  Taichakma Para,130,281,88,120,42,161,31.6,42.3,20.7,00000
46.0,80.0,57.0,663,03,01,  Pagla Para,106,214,59,97,47,117,33.1,37.8,28.7,00000
46.0,80.0,57.0,663,04,01,  Pailla Banga Para,66,314,37,148,29,166,17.4,20.0,14.9,00000
46.0,80.0,57.0,663,05,01,  Mahabubnagar,230,348,118,158,112,190,39.8,42.8,37.1,00000
46.0,80.0,57.0,663,06,01,  Belchhari Para,131,219,77,106,54,113,37.4,42.1,32.3,00000
46.0,80.0,57.0,663,07,01,  Salda Para,91,173,57,81,34,92,34.5,41.3,27.0,00000
46.0,80.0,57.0,663,08,01,  Goza Para,82,223,51,96,31,127,26.9,34.7,19.6,00000
46.0,80.0,57.0,663,09,01,  Balukhali,198,320,109,161,89,159,38.2,40.4,35.9,00000
46.0,80.0,57.0,663,10,01,  Sonar Khil,75,217,48,103,27,114,25.7,31.8,19.1,00000
46.0,80.0,57.0,663,11,01,  Nowa Para,89,323,61,141,28,182,21.6,30.2,13.3,00000
46.0,80.0,57.0,663,12,01,  Goyea Para,63,255,36,129,27,126,19.8,21.8,17.6,00000
46.0,80.0,57.0,663,13,01,  Compru Para,13,74,11,38,2,36,14.9,22.4,5.3,00000
46.0,80.0,57.0,663,14,01,  Kalapani Para,21,119,16,55,5,64,15.0,22.5,7.2,00000
46.0,80.0,57.0,663,15,01,  Kumari Para,24,118,14,51,10,67,16.9,21.5,13.0,00000
46.0,80.0,57.0,663,16,01,  Notun Taichakma Para,64,130,41,57,23,73,33.0,41.8,24.0,00000
46.0,80.0,57.0,663,17,01,  Saydong Para,59,160,23,73,36,87,26.9,24.0,29.3,00000
46.0,80.0,57.0,663,18,01,  Thali Para,33,180,20,77,13,103,15.5,20.6,11.2,00000
46.0,80.0,57.0,663,19,01,  Dhaka Colony,70,46,33,22,37,24,60.3,60.0,60.7,00000
46.0,80.0,57.0,829,01,01,  Kalabari,32,98,22,39,10,59,24.6,36.1,14.5,00000
46.0,80.0,57.0,829,02,01,  Jamani Chandra Para Para (S.R.,28,59,17,26,11,33,32.2,39.5,25.0,00000
46.0,80.0,57.0,829,03,01,  Pathachhara,289,411,161,193,128,218,41.3,45.5,37.0,00000
46.0,80.0,57.0,829,04,01,  Rasul Par/Nakapa Pul,406,597,219,260,187,337,40.5,45.7,35.7,00000
46.0,80.0,57.0,829,05,01,  Talmoni Para,130,142,78,65,52,77,47.8,54.5,40.3,00000
46.0,80.0,57.0,829,06,01,  Puratan Nakapa,64,204,38,101,26,103,23.9,27.3,20.2,00000
46.0,80.0,57.0,829,07,01,  Jorichandra Para,30,118,22,49,8,69,20.3,31.0,10.4,00000
46.0,80.0,57.0,829,08,01,  Jotindra Bdr Para,45,111,28,41,17,70,28.8,40.6,19.5,00000
46.0,80.0,57.0,829,09,01,  Manik Chandra Para,69,132,44,50,25,82,34.3,46.8,23.4,00000
46.0,80.0,57.0,829,10,01,  Boudhadon Karbari Para,29,97,22,41,7,56,23.0,34.9,11.1,00000
46.0,80.0,57.0,994,01,01,  Temaram Headman Para,64,183,42,80,22,103,25.9,34.4,17.6,00000
46.0,80.0,57.0,994,02,01,  Thalibari,277,312,149,147,128,165,47.0,50.3,43.7,00000
46.0,80.0,57.0,994,03,01,  Ausshini Para,13,21,10,7,3,14,38.2,58.8,17.6,00000
46.0,80.0,57.0,994,04,01,  Reday Moni Para,28,50,23,20,5,30,35.9,53.5,14.3,00000
46.0,80.0,57.0,994,05,01,  Nabodip Karbari Para,17,64,11,25,6,39,21.0,30.6,13.3,00000
46.0,80.0,57.0,994,06,01,  Chato Pilak Para,15,41,10,17,5,24,26.8,37.0,17.2,00000
46.0,80.0,76.0,442,01,01,  Jorjori Para,13,42,6,23,7,19,23.6,20.7,26.9,00000
46.0,80.0,76.0,442,02,01,  Kanta Para,4,73,2,37,2,36,5.2,5.1,5.3,00000
46.0,80.0,76.0,442,03,01,  Daktar Para,44,124,31,57,13,67,26.2,35.2,16.3,00000
46.0,80.0,76.0,442,04,01,  Taikatang Para,34,91,18,48,16,43,27.2,27.3,27.1,00000
46.0,80.0,76.0,442,05,01,  Hajaroshia Para,13,62,6,30,7,32,17.3,16.7,17.9,00000
46.0,80.0,76.0,442,06,01,  Kanta Muk Para,22,58,14,23,8,35,27.5,37.8,18.6,00000
46.0,80.0,76.0,718,01,03,  Muslim Para,18,24,10,15,8,9,42.9,40.0,47.1,00000
46.0,80.0,76.0,718,02,03,  Kalapro Para,8,40,6,17,2,23,16.7,26.1,8.0,00000
46.0,80.0,76.0,718,03,03,  Baidya Para,125,137,87,58,38,79,47.7,60.0,32.5,00000
46.0,80.0,76.0,718,04,03,  Kashi  Bari,35,33,30,14,5,19,51.5,68.2,20.8,00000
46.0,80.0,76.0,718,05,03,  Chin Chori Para,39,59,22,26,17,33,39.8,45.8,34.0,00000
46.0,80.0,76.0,718,06,03,  Angla Para,25,60,17,26,8,34,29.4,39.5,19.0,00000
46.0,80.0,76.0,718,07,03,  Pilak Para,6,32,2,16,4,16,15.8,11.1,20.0,00000
46.0,80.0,76.0,718,08,03,  Chotokhada Jowtho Khamar,30,105,17,48,13,57,22.2,26.2,18.6,00000
46.0,80.0,76.0,718,09,03,  Baltoli Para,5,30,3,15,2,15,14.3,16.7,11.8,00000
46.0,80.0,76.0,718,10,03,  Lachari Para,157,171,117,79,40,92,47.9,59.7,30.3,00000
46.0,80.0,76.0,718,11,03,  Angto Para,32,136,12,65,20,71,19.0,15.6,22.0,00000
46.0,80.0,76.0,718,12,03,  Uzai Chawdri Para,26,56,15,20,11,36,31.7,42.9,23.4,00000
46.0,80.0,76.0,718,13,03,  Bora Khada,14,22,12,9,2,13,38.9,57.1,13.3,00000
46.0,80.0,76.0,884,01,03,  Chand Para,12,40,9,17,3,23,23.1,34.6,11.5,00000
46.0,80.0,76.0,884,02,03,  Jautha Khamar,43,256,24,123,19,133,14.4,16.3,12.5,00000
46.0,80.0,76.0,884,03,03,  Hatirkhada,128,182,80,91,48,91,41.3,46.8,34.5,00000
46.0,80.0,76.0,884,04,03,  Khagra Bil,259,196,139,86,120,110,56.9,61.8,52.2,00000
46.0,80.0,76.0,884,05,03,  Lalchhari Para,272,540,156,264,116,276,33.5,37.1,29.6,00000
46.0,80.0,76.0,884,06,03,  Waifa Para,261,379,149,181,112,198,40.8,45.2,36.1,00000
46.0,80.0,76.0,884,07,03,  Bali Para,709,816,368,402,341,414,46.5,47.8,45.2,00000
46.0,80.0,76.0,884,08,03,  Nur Pur,63,109,33,56,30,53,36.6,37.1,36.1,00000
46.0,80.0,76.0,884,09,03,  Taichala Para,28,32,15,14,13,18,46.7,51.7,41.9,00000
46.0,80.0,76.0,884,10,03,  School Tila,58,111,26,59,32,52,34.3,30.6,38.1,00000
46.0,80.0,76.0,884,11,03,  Kazi Para,70,69,46,24,24,45,50.4,65.7,34.8,00000
46.0,80.0,76.0,884,12,03,  Nowa Para,62,159,30,75,32,84,28.1,28.6,27.6,00000
46.0,80.0,76.0,884,13,03,  Bas Para,29,35,16,17,13,18,45.3,48.5,41.9,00000
46.0,80.0,76.0,884,14,03,  Lamku Para,563,949,279,433,284,516,37.2,39.2,35.5,00000
46.0,80.0,76.0,884,15,03,  Soniaga Para,162,525,99,249,63,276,23.6,28.4,18.6,00000
46.0,80.0,76.0,884,16,03,  Thana Chandra Para,129,284,65,133,64,151,31.2,32.8,29.8,00000
46.0,80.0,76.0,884,17,03,  Rupaichhari,75,151,45,71,30,80,33.2,38.8,27.3,00000
46.0,80.0,76.0,884,18,03,  Taracan Para,19,103,10,54,9,49,15.6,15.6,15.5,00000
46.0,80.0,76.0,884,19,03,  B0ta Chandra Para,20,83,16,33,4,50,19.4,32.7,7.4,00000
46.0,80.0,76.0,884,20,03,  Naziram Para,21,111,19,45,2,66,15.9,29.7,2.9,00000
46.0,80.0,76.0,884,21,03,  Tokania Para,5,14,4,7,1,7,26.3,36.4,12.5,00000
46.0,80.0,76.0,884,22,03,  Nobbai Acor,20,60,7,28,13,32,25.0,20.0,28.9,00000
46.0,80.0,76.0,884,23,03,  Dhaka Colony,70,70,44,34,26,36,50.0,56.4,41.9,00000
22.0,16.0,10.0,015,01,01,  Badarkhali No.1,1687,2961,879,1548,808,1413,36.3,36.2,36.4,00000
22.0,16.0,10.0,015,02,01,  Badarkhali No.2,3403,4995,1651,2530,1752,2465,40.5,39.5,41.5,00000
22.0,16.0,10.0,015,03,01,  Badarkhali No.3,5138,7287,2522,3783,2616,3504,41.4,40.0,42.7,00000
22.0,16.0,12.0,061,01,01,  Painasha Bil,533,697,256,345,277,352,43.3,42.6,44.0,00000
22.0,16.0,12.0,061,02,01,  Bomokhola,375,235,189,108,186,127,61.5,63.6,59.4,00000
22.0,16.0,12.0,061,03,01,  Pukuria Khala,192,362,99,178,93,184,34.7,35.7,33.6,00000
22.0,16.0,12.0,061,04,01,  Fadukhola,320,342,180,170,140,172,48.3,51.4,44.9,00000
22.0,16.0,12.0,061,05,01,  Nandir Bil,188,345,104,167,84,178,35.3,38.4,32.1,00000
22.0,16.0,12.0,183,01,01,  Maiz Para,840,584,462,276,378,308,59.0,62.6,55.1,00000
22.0,16.0,12.0,183,02,01,  Purba Para,366,482,182,217,184,265,43.2,45.6,41.0,00000
22.0,16.0,12.0,183,03,01,  Pachim Para,714,361,360,177,354,184,66.4,67.0,65.8,00000
22.0,16.0,16.0,091,01,01,  Hindu Para,879,523,501,228,378,295,62.7,68.7,56.2,00000
22.0,16.0,16.0,091,02,01,  Katakhali,303,171,161,79,142,92,63.9,67.1,60.7,00000
22.0,16.0,16.0,091,03,01,  Rasulabad,438,473,220,234,218,239,48.1,48.5,47.7,00000
22.0,16.0,16.0,091,04,01,  Dingakata,611,931,309,506,302,425,39.6,37.9,41.5,00000
22.0,16.0,16.0,091,05,01,  Maiz Para,1261,1401,624,725,637,676,47.4,46.3,48.5,00000
22.0,16.0,16.0,091,06,01,  Kharati Para,1914,1351,980,629,934,722,58.6,60.9,56.4,00000
22.0,16.0,16.0,091,07,01,  Baniachhara,818,957,427,489,391,468,46.1,46.6,45.5,00000
22.0,16.0,16.0,091,08,01,  Fateh Ali Sikdar Para,582,409,300,200,282,209,58.7,60.0,57.4,00000
22.0,16.0,16.0,091,09,01,  Napit Para,220,225,107,121,113,104,49.4,46.9,52.1,00000
22.0,16.0,16.0,091,10,01,  Chhararkul,1063,459,591,208,472,251,69.8,74.0,65.3,00000
22.0,16.0,16.0,091,11,01,  Chander Baperbari,946,720,499,365,447,355,56.8,57.8,55.7,00000
22.0,16.0,16.0,091,12,01,  Sikdar Para,894,637,470,307,424,330,58.4,60.5,56.2,00000
22.0,16.0,16.0,719,01,01,  Bibirkhil,1570,1808,832,947,738,861,46.5,46.8,46.2,00000
22.0,16.0,16.0,719,02,01,  Gobindapur,1722,2072,927,1060,795,1012,45.4,46.7,44.0,00000
22.0,16.0,16.0,719,03,01,  Hapalia Kata,1674,1822,905,934,769,888,47.9,49.2,46.4,00000
22.0,16.0,22.0,137,01,01,  Khanjanir Ghona,265,630,117,306,148,324,29.6,27.7,31.4,00000
22.0,16.0,22.0,137,02,01,  Chhai Number Para,292,833,147,413,145,420,26.0,26.3,25.7,00000
22.0,16.0,22.0,137,03,01,  Konayer Jumpara,197,345,93,168,104,177,36.3,35.6,37.0,00000
22.0,16.0,22.0,137,04,01,  Mobin Para,336,640,165,322,171,318,34.4,33.9,35.0,00000
22.0,16.0,22.0,168,01,01,  Krishanpur,352,759,167,382,185,377,31.7,30.4,32.9,00000
22.0,16.0,22.0,168,02,01,  Noapara,519,518,263,264,256,254,50.0,49.9,50.2,00000
22.0,16.0,22.0,168,03,01,  Dakshin Bahaddarkata,837,975,412,492,425,483,46.2,45.6,46.8,00000
22.0,16.0,22.0,168,04,01,  Uttar Bahaddarkata,1128,2102,567,1058,561,1044,34.9,34.9,35.0,00000
22.0,16.0,22.0,168,05,01,  Puchhala Para,328,654,143,339,185,315,33.4,29.7,37.0,00000
22.0,16.0,22.0,168,06,01,  Haci Sikdar Para,178,382,83,195,95,187,31.8,29.9,33.7,00000
22.0,16.0,22.0,168,07,01,  Paharia Para,881,1370,444,666,437,704,39.1,40.0,38.3,00000
22.0,16.0,22.0,168,08,01,  Bethuarkul,665,903,326,447,339,456,42.4,42.2,42.6,00000
22.0,16.0,27.0,734,01,01,  Palakata,1325,1339,654,718,671,621,49.7,47.7,51.9,00000
22.0,16.0,27.0,734,02,01,  Buri Pukur,1686,1207,815,609,871,598,58.3,57.2,59.3,00000
22.0,16.0,27.0,734,03,01,  Sadagarghona,1399,2075,659,1099,740,976,40.3,37.5,43.1,00000
22.0,16.0,31.0,260,01,01,  Hatalia Para,291,588,113,298,178,290,33.1,27.5,38.0,00000
22.0,16.0,31.0,260,02,01,  Shokri Tekka Para,489,1234,253,636,236,598,28.4,28.5,28.3,00000
22.0,16.0,31.0,260,03,01,  Jamider Para,510,635,248,301,262,334,44.5,45.2,44.0,00000
22.0,16.0,31.0,260,04,01,  Muchar Para,327,101,169,45,158,56,76.4,79.0,73.8,00000
22.0,16.0,31.0,260,05,01,  Noapara,171,486,79,231,92,255,26.0,25.5,26.5,00000
22.0,16.0,31.0,260,06,01,  Bazar Para,201,578,91,282,110,296,25.8,24.4,27.1,00000
22.0,16.0,31.0,260,07,01,  Ammer Dera,353,750,169,369,184,381,32.0,31.4,32.6,00000
22.0,16.0,31.0,260,08,01,  Khas Para,400,651,175,331,225,320,38.1,34.6,41.3,00000
22.0,16.0,31.0,260,09,01,  Daskhali Para,145,295,68,151,77,144,33.0,31.1,34.8,00000
22.0,16.0,31.0,260,10,01,  Gandi Para,474,473,209,222,265,251,50.1,48.5,51.4,00000
22.0,16.0,31.0,260,11,01,  Techapara,491,345,248,157,243,188,58.7,61.2,56.4,00000
22.0,16.0,33.0,030,01,01,  Rangmahal,3220,3511,1578,1702,1642,1809,47.8,48.1,47.6,00000
22.0,16.0,33.0,030,02,01,  Mogchhara Jum,693,201,381,67,312,134,77.5,85.0,70.0,00000
22.0,16.0,33.0,030,03,01,  Bagachari,143,150,75,74,68,76,48.8,50.3,47.2,00000
22.0,16.0,33.0,290,01,01,  Domkhali,1576,3659,770,1815,806,1844,30.1,29.8,30.4,00000
22.0,16.0,33.0,290,02,01,  Katakhali,1039,570,529,300,510,270,64.6,63.8,65.4,00000
22.0,16.0,33.0,290,03,01,  Ulobonia,1180,1360,579,745,601,615,46.5,43.7,49.4,00000
22.0,16.0,33.0,290,04,01,  Uttarpara,901,530,497,275,404,255,63.0,64.4,61.3,00000
22.0,16.0,33.0,290,05,01,  Maiz Para,1160,433,577,195,583,238,72.8,74.7,71.0,00000
22.0,16.0,33.0,290,06,01,  Balur Char,305,279,155,141,150,138,52.2,52.4,52.1,00000
22.0,16.0,33.0,290,07,01,  Sholoisha,593,415,308,219,285,196,58.8,58.4,59.3,00000
22.0,16.0,33.0,290,08,01,  Bairagir Khal,1086,861,546,427,540,434,55.8,56.1,55.4,00000
22.0,16.0,33.0,290,09,01,  Dakshin Hindu Para,231,287,129,148,102,139,44.6,46.6,42.3,00000
22.0,16.0,33.0,290,10,01,  Naya Para,714,873,341,453,373,420,45.0,42.9,47.0,00000
22.0,16.0,33.0,290,11,01,  Mouluvi Kata,125,173,51,94,74,79,41.9,35.2,48.4,00000
22.0,16.0,33.0,704,01,01,  Pagalir Bil,328,241,186,106,142,135,57.6,63.7,51.3,00000
22.0,16.0,33.0,704,02,01,  Bilager Para,462,447,247,205,215,242,50.8,54.6,47.0,00000
22.0,16.0,33.0,704,03,01,  Ali Barjum/Konapara,192,195,99,100,93,95,49.6,49.7,49.5,00000
22.0,16.0,33.0,887,01,01,  Sagirshahkata,1361,1923,681,966,680,957,41.4,41.3,41.5,00000
22.0,16.0,33.0,887,02,01,  Chabagan,1589,1263,848,616,741,647,55.7,57.9,53.4,00000
22.0,16.0,33.0,887,03,01,  Malumghat,520,400,272,189,248,211,56.5,59.0,54.0,00000
22.0,16.0,39.0,795,01,01,  Eidmoni Ghona,1458,2274,764,1195,694,1079,39.1,39.0,39.1,00000
22.0,16.0,39.0,795,02,01,  K.Amiajir Para,557,462,281,244,276,218,54.7,53.5,55.9,00000
22.0,16.0,39.0,795,03,01,  Sikdar Para,1283,1308,680,663,603,645,49.5,50.6,48.3,00000
22.0,16.0,39.0,795,04,01,  Char Para,758,1123,384,559,374,564,40.3,40.7,39.9,00000
22.0,16.0,39.0,795,05,01,  Kalagazi Sikdar Para,478,466,233,233,245,233,50.6,50.0,51.3,00000
22.0,16.0,39.0,795,06,01,  Maiz Para,592,1286,288,682,304,604,31.5,29.7,33.5,00000
22.0,16.0,39.0,795,07,01,  Bamon Para,419,474,222,255,197,219,46.9,46.5,47.4,00000
22.0,16.0,39.0,795,08,01,  Olar Baper Para,570,477,319,278,251,199,54.4,53.4,55.8,00000
22.0,16.0,39.0,795,09,01,  Anis Para,419,651,202,344,217,307,39.2,37.0,41.4,00000
22.0,16.0,39.0,795,10,01,  Kabir Baper Para,163,262,87,126,76,136,38.4,40.8,35.8,00000
22.0,16.0,39.0,795,11,01,  Sekandar Para,602,1046,301,572,301,474,36.5,34.5,38.8,00000
22.0,16.0,39.0,795,12,01,  Sahebkhar Para,352,375,184,196,168,179,48.4,48.4,48.4,00000
22.0,16.0,39.0,795,13,01,  Masua Para,38,403,28,202,10,201,8.6,12.2,4.7,00000
22.0,16.0,39.0,795,14,01,  Mafiar Baper Para,187,355,90,168,97,187,34.5,34.9,34.2,00000
22.0,16.0,39.0,795,15,01,  Fazarer Rohama Sikdar Para,655,710,352,372,303,338,48.0,48.6,47.3,00000
22.0,16.0,39.0,795,16,01,  Baniar Char,319,656,166,350,153,306,32.7,32.2,33.3,00000
22.0,16.0,39.0,795,17,01,  Burir Para,240,496,120,282,120,214,32.6,29.9,35.9,00000
22.0,16.0,39.0,795,18,01,  Naya Para,467,598,239,298,228,300,43.8,44.5,43.2,00000
22.0,16.0,50.0,382,01,01,  Pahartali,653,481,339,226,314,255,57.6,60.0,55.2,00000
22.0,16.0,50.0,382,02,01,  Katakhali,227,214,128,108,99,106,51.5,54.2,48.3,00000
22.0,16.0,50.0,382,03,01,  Mogpara,404,335,189,110,215,225,54.7,63.2,48.9,00000
22.0,16.0,50.0,382,04,01,  Naoapara,1001,1024,494,476,507,548,49.4,50.9,48.1,00000
22.0,16.0,50.0,382,05,01,  Mohajan Para,75,286,33,136,42,150,20.8,19.5,21.9,00000
22.0,16.0,50.0,382,06,01,  Kala Sikdar Para,429,547,210,263,219,284,44.0,44.4,43.5,00000
22.0,16.0,50.0,382,07,01,  Sikdar Para,199,232,87,106,112,126,46.2,45.1,47.1,00000
22.0,16.0,50.0,382,08,01,  Ghodar Para,482,281,239,118,243,163,63.2,66.9,59.9,00000
22.0,16.0,50.0,382,09,01,  Kulal Para,185,115,90,42,95,73,61.7,68.2,56.5,00000
22.0,16.0,50.0,382,10,01,  Bazar Para,142,149,77,76,65,73,48.8,50.3,47.1,00000
22.0,16.0,50.0,382,11,01,  Bagir Para,372,145,188,69,184,76,72.0,73.2,70.8,00000
22.0,16.0,50.0,382,12,01,  Nuna Charipara,1357,1834,738,872,619,962,42.5,45.8,39.2,00000
22.0,16.0,50.0,382,13,01,  Paharchanda,796,889,377,436,419,453,47.2,46.4,48.1,00000
22.0,16.0,50.0,382,14,01,  Palpara,767,811,386,385,381,426,48.6,50.1,47.2,00000
22.0,16.0,50.0,382,15,01,  Jamidar Para,407,179,184,76,223,103,69.5,70.8,68.4,00000
22.0,16.0,50.0,382,16,01,  Paschim Barua Para,324,1039,160,519,164,520,23.8,23.6,24.0,00000
22.0,16.0,50.0,382,17,01,  Mochan Sikdar Para,278,152,142,69,136,83,64.7,67.3,62.1,00000
22.0,16.0,50.0,382,18,01,  Station Para,50,44,27,20,23,24,53.2,57.4,48.9,00000
22.0,16.0,50.0,382,19,01,  Darpara,461,279,210,120,251,159,62.3,63.6,61.2,00000
22.0,16.0,50.0,382,20,01,  Nath Para,171,192,95,77,76,115,47.1,55.2,39.8,00000
22.0,16.0,50.0,382,21,01,  Purba Killar Para,207,438,101,195,106,243,32.1,34.1,30.4,00000
22.0,16.0,50.0,382,22,01,  Brindabankhil,418,717,227,339,191,378,36.8,40.1,33.6,00000
22.0,16.0,50.0,382,23,01,  Karam Muhuri,216,212,107,96,109,116,50.5,52.7,48.4,00000
22.0,16.0,50.0,382,24,01,  Shabanghata,221,110,115,43,106,67,66.8,72.8,61.3,00000
22.0,16.0,50.0,382,25,01,  Uttar Baruapara,158,353,83,174,75,179,30.9,32.3,29.5,00000
22.0,16.0,50.0,872,01,01,  Vilaizar Para,1073,1502,571,748,502,754,41.7,43.3,40.0,00000
22.0,16.0,50.0,872,02,01,  Goyalmara,405,532,234,306,171,226,43.2,43.3,43.1,00000
22.0,16.0,50.0,872,03,01,  Tailar Bil,15,40,7,18,8,22,27.3,28.0,26.7,00000
22.0,16.0,50.0,872,04,01,  Katiali,147,321,74,159,73,162,31.4,31.8,31.1,00000
22.0,16.0,50.0,872,05,01,  Korbaniagona,1935,2743,952,1325,983,1418,41.4,41.8,40.9,00000
22.0,16.0,50.0,872,06,01,  Gainakata,364,887,176,482,188,405,29.1,26.7,31.7,00000
22.0,16.0,50.0,872,07,01,  Tirtali,27,14,13,8,14,6,65.9,61.9,70.0,00000
22.0,16.0,50.0,872,08,01,  Kalatali,260,986,138,497,122,489,20.9,21.7,20.0,00000
22.0,16.0,55.0,443,01,01,  Maij Kakara,1485,1957,762,1027,723,930,43.1,42.6,43.7,00000
22.0,16.0,55.0,443,02,01,  Proper Kakara,2308,1049,1163,496,1145,553,68.8,70.1,67.4,00000
22.0,16.0,55.0,443,03,01,  Dakshin Kakara,1525,1828,713,911,812,917,45.5,43.9,47.0,00000
22.0,16.0,55.0,443,04,01,  Saker Mohammed Char,1343,1805,655,910,688,895,42.7,41.9,43.5,00000
22.0,16.0,61.0,428,01,01,  Kaiar Bil,1318,1669,639,822,679,847,44.1,43.7,44.5,00000
22.0,16.0,61.0,428,02,01,  Difkul,348,399,178,184,170,215,46.6,49.2,44.2,00000
22.0,16.0,61.0,428,03,01,  Chualia Para,524,351,274,168,250,183,59.9,62.0,57.7,00000
22.0,16.0,61.0,428,04,01,  Hamudullah Sikdar Para,426,145,211,68,215,77,74.6,75.6,73.6,00000
22.0,16.0,61.0,428,05,01,  Barainar Char,371,577,162,271,209,306,39.1,37.4,40.6,00000
22.0,16.0,61.0,428,06,01,  Baniarkum,595,380,299,184,296,196,61.0,61.9,60.2,00000
22.0,16.0,61.0,428,07,01,  Islamnagar,614,1303,319,655,295,648,32.0,32.8,31.3,00000
22.0,16.0,61.0,428,08,01,  Shantinagar,235,245,117,122,118,123,49.0,49.0,49.0,00000
22.0,16.0,61.0,489,01,01,  Uttar Khilchhadak,367,886,161,483,206,403,29.3,25.0,33.8,00000
22.0,16.0,61.0,489,02,01,  Dakshin Khilchhadak,633,941,304,484,329,457,40.2,38.6,41.9,00000
22.0,16.0,61.0,520,01,01,  Khojakhali,413,786,186,386,227,400,34.4,32.5,36.2,00000
22.0,16.0,61.0,520,02,01,  Hasimerkata,648,891,303,430,345,461,42.1,41.3,42.8,00000
22.0,16.0,67.0,045,01,01,  Uttar Bahaltali,11,61,10,58,1,3,15.3,14.7,25.0,00000
22.0,16.0,67.0,045,02,01,  Dakshin Bahaltali,0,22,0,12,0,10,0.0,0.0,0.0,00000
22.0,16.0,67.0,336,01,01,  Kachikata,231,262,108,136,123,126,46.9,44.3,49.4,00000
22.0,16.0,67.0,336,02,01,  Mederghat (Muhurighona),3,41,2,36,1,5,6.8,5.3,16.7,00000
22.0,16.0,67.0,336,03,01,  Garur Lotapara,185,119,97,67,88,52,60.9,59.1,62.9,00000
22.0,16.0,67.0,336,04,01,  Kattalia Para,299,450,133,239,166,211,39.9,35.8,44.0,00000
22.0,16.0,67.0,336,05,01,  Paschim Naya Para,283,245,152,111,131,134,53.6,57.8,49.4,00000
22.0,16.0,67.0,336,06,01,  Purba Naya Para,989,739,518,360,471,379,57.2,59.0,55.4,00000
22.0,16.0,67.0,336,07,01,  Bashkatia,212,135,107,64,105,71,61.1,62.6,59.7,00000
22.0,16.0,67.0,336,08,01,  Shia Para,483,427,214,187,269,240,53.1,53.4,52.8,00000
22.0,16.0,67.0,336,09,01,  Jonakata,119,205,67,104,52,101,36.7,39.2,34.0,00000
22.0,16.0,67.0,397,01,01,  Jangal Khutakhali,627,1233,310,653,317,580,33.7,32.2,35.3,00000
22.0,16.0,67.0,397,02,01,  Kala Para,36,135,15,64,21,71,21.1,19.0,22.8,00000
22.0,16.0,67.0,535,01,01,  Uttar Khuntakhali,419,284,210,134,209,150,59.6,61.0,58.2,00000
22.0,16.0,67.0,535,02,01,  Bakum Para,494,740,251,377,243,363,40.0,40.0,40.1,00000
22.0,16.0,67.0,535,03,01,  Nolbonia,441,1025,201,518,240,507,30.1,28.0,32.1,00000
22.0,16.0,67.0,535,04,01,  Gorjantali,1067,1324,535,672,532,652,44.6,44.3,44.9,00000
22.0,16.0,67.0,535,05,01,  Forest Office Para,311,260,167,108,144,152,54.5,60.7,48.6,00000
22.0,16.0,67.0,535,06,01,  Joynagar Para,122,231,61,119,61,112,34.6,33.9,35.3,00000
22.0,16.0,67.0,535,07,01,  Purba Khutakhali,614,265,359,130,255,135,69.9,73.4,65.4,00000
22.0,16.0,67.0,535,08,01,  Khutakhali Bazar,109,47,90,45,19,2,69.9,66.7,90.5,00000
22.0,16.0,67.0,535,09,01,  Dakshin Khutakhali,814,339,332,144,482,195,70.6,69.7,71.2,00000
22.0,16.0,67.0,535,10,01,  Madhya Khutakhali,674,462,377,270,297,192,59.3,58.3,60.7,00000
22.0,16.0,67.0,535,11,01,  Saguni Bagicha,516,948,248,477,268,471,35.2,34.2,36.3,00000
22.0,16.0,67.0,535,12,01,  Horidor Kala,235,260,117,120,118,140,47.5,49.4,45.7,00000
22.0,16.0,67.0,642,01,01,  Uttar Medakachhapia,1005,2146,502,1103,503,1043,31.9,31.3,32.5,00000
22.0,16.0,67.0,642,02,01,  Dakshin Medakachhapia,1332,1509,661,772,671,737,46.9,46.1,47.7,00000
22.0,16.0,67.0,642,03,01,  Paglirbil,255,373,115,189,140,184,40.6,37.8,43.2,00000
22.0,16.0,67.0,642,04,01,  Taliaghona,132,271,53,154,79,117,32.8,25.6,40.3,00000
22.0,16.0,67.0,642,05,01,  Hajipara,282,204,139,101,143,103,58.0,57.9,58.1,00000
22.0,16.0,67.0,642,06,01,  School Pahar,478,182,230,70,248,112,72.4,76.7,68.9,00000
22.0,16.0,69.0,566,01,01,  Chhara Para,109,332,51,154,58,178,24.7,24.9,24.6,00000
22.0,16.0,69.0,566,02,01,  Mahishmaradia Para,822,1730,375,782,447,948,32.2,32.4,32.0,00000
22.0,16.0,69.0,566,03,01,  Kutubdia Para,372,1062,160,490,212,572,25.9,24.6,27.0,00000
22.0,16.0,69.0,566,04,01,  Lotabanna Para,731,982,335,474,396,508,42.7,41.4,43.8,00000
22.0,16.0,69.0,566,05,01,  Sikdar Para,199,850,70,402,129,448,19.0,14.8,22.4,00000
22.0,16.0,69.0,566,06,01,  Abdul Hakim Bepari Para,328,1031,133,514,195,517,24.1,20.6,27.4,00000
22.0,16.0,69.0,566,07,01,  Marangghona,851,919,397,434,454,485,48.1,47.8,48.3,00000
22.0,16.0,69.0,566,08,01,  Purita Khali,619,1365,288,641,331,724,31.2,31.0,31.4,00000
22.0,16.0,69.0,566,09,01,  Jangli Kata,704,961,319,412,385,549,42.3,43.6,41.2,00000
22.0,16.0,80.0,750,01,01,  Koral Khali,905,1145,479,611,426,534,44.1,43.9,44.4,00000
22.0,16.0,80.0,750,02,01,  Guranna Kata Para,575,406,303,216,272,190,58.6,58.4,58.9,00000
22.0,16.0,80.0,795,01,01,  Abdur Zabber Sikder Para,184,234,80,130,104,104,44.0,38.1,50.0,00000
22.0,16.0,80.0,795,02,01,  Keskasir Para,276,254,115,138,161,116,52.1,45.5,58.1,00000
22.0,16.0,80.0,795,03,01,  Farir Tora,323,233,155,119,168,114,58.1,56.6,59.6,00000
22.0,16.0,80.0,795,04,01,  Saharbil,817,786,399,399,418,387,51.0,50.0,51.9,00000
22.0,16.0,87.0,949,01,01,  Surajpur,699,647,348,326,351,321,51.9,51.6,52.2,00000
22.0,16.0,87.0,949,02,01,  Bamonkata,299,568,137,286,162,282,34.5,32.4,36.5,00000
22.0,16.0,87.0,949,03,01,  Kair Bil Para,177,183,87,91,90,92,49.2,48.9,49.5,00000
22.0,16.0,87.0,949,04,01,  Naya Para,113,370,52,172,61,198,23.4,23.2,23.6,00000
22.0,16.0,87.0,949,05,01,  Mogpara Bil,433,548,214,297,219,251,44.1,41.9,46.6,00000
22.0,16.0,87.0,949,06,01,  Bilijar Para,281,668,133,347,148,321,29.6,27.7,31.6,00000
22.0,16.0,94.0,750,01,01,  Purba Darbeshkata,1563,1213,779,593,784,620,56.3,56.8,55.8,00000
22.0,16.0,94.0,750,02,01,  Paschim Darbeshkata,1039,1047,513,506,526,541,49.8,50.3,49.3,00000
22.0,16.0,94.0,750,03,01,  Choarfari,1134,1287,564,692,570,595,46.8,44.9,48.9,00000
22.0,24.0,20.0,052,01,01,  Sabek Para,251,649,127,320,124,329,27.9,28.4,27.4,00000
22.0,24.0,20.0,052,02,01,  Dakshinpara,370,268,179,136,191,132,58.0,56.8,59.1,00000
22.0,24.0,20.0,052,03,01,  Paschimpara,1083,918,534,471,549,447,54.1,53.1,55.1,00000
22.0,24.0,20.0,052,04,01,  Karim Sikdar Para,549,513,308,229,241,284,51.7,57.4,45.9,00000
22.0,24.0,20.0,052,05,01,  Mura Para,174,351,87,193,87,158,33.1,31.1,35.5,00000
22.0,24.0,20.0,052,06,01,  Baiddar Mura,330,275,154,161,176,114,54.5,48.9,60.7,00000
22.0,24.0,20.0,052,07,01,  Chainga Mura (Bharua Khali),187,264,82,141,105,123,41.5,36.8,46.1,00000
22.0,24.0,20.0,052,08,01,  Hajir Para,128,284,64,139,64,145,31.1,31.5,30.6,00000
22.0,24.0,20.0,052,09,01,  Chander Para,239,218,118,117,121,101,52.3,50.2,54.5,00000
22.0,24.0,20.0,052,10,01,  Mazer Para,116,81,51,45,65,36,58.9,53.1,64.4,00000
22.0,24.0,20.0,052,11,01,  Chowchala Mura,742,730,392,368,350,362,50.4,51.6,49.2,00000
22.0,24.0,20.0,052,12,01,  Bania Para,939,873,480,418,459,455,51.8,53.5,50.2,00000
22.0,24.0,20.0,052,13,01,  Ghonar Para,637,1109,294,556,343,553,36.5,34.6,38.3,00000
22.0,24.0,20.0,052,14,01,  Bara Chowdhury Para,630,778,317,390,313,388,44.7,44.8,44.7,00000
22.0,24.0,20.0,052,15,01,  Nonamia Para,532,513,246,284,286,229,50.9,46.4,55.5,00000
22.0,24.0,20.0,052,16,01,  Ultakhali (Guccha Gram),831,1384,431,697,400,687,37.5,38.2,36.8,00000
22.0,24.0,20.0,052,17,01,  Chhota Chowdhury Para,293,287,146,148,147,139,50.5,49.7,51.4,00000
22.0,24.0,20.0,052,18,01,  Natun Para,242,223,127,97,115,126,52.0,56.7,47.7,00000
22.0,24.0,22.0,209,01,01,  Dakshinpara,1211,3388,627,1713,584,1675,26.3,26.8,25.9,00000
22.0,24.0,22.0,209,02,01,  Mogpara,966,1095,498,438,468,657,46.9,53.2,41.6,00000
22.0,24.0,22.0,209,03,01,  Napit Para,284,157,157,63,127,94,64.4,71.4,57.5,00000
22.0,24.0,22.0,209,04,01,  Paschimpara,897,1379,466,653,431,726,39.4,41.6,37.3,00000
22.0,24.0,22.0,209,05,01,  Konapara,142,301,68,150,74,151,32.1,31.2,32.9,00000
22.0,24.0,22.0,209,06,01,  Maizpara,771,1234,360,632,411,602,38.5,36.3,40.6,00000
22.0,24.0,22.0,209,07,01,  Haidar Para,290,548,130,251,160,297,34.6,34.1,35.0,00000
22.0,24.0,22.0,209,08,01,  Sikdar Para,318,347,146,168,172,179,47.8,46.5,49.0,00000
22.0,24.0,22.0,209,09,01,  Khamar Para,1359,939,826,499,533,440,59.1,62.3,54.8,00000
22.0,24.0,22.0,209,10,01,  Uttarpara,581,386,308,175,273,211,60.1,63.8,56.4,00000
22.0,24.0,22.0,209,11,01,  Kalu Fakir Para,616,800,290,406,326,394,43.5,41.7,45.3,00000
22.0,24.0,22.0,209,12,01,  Bonik Para,72,161,46,84,26,77,30.9,35.4,25.2,00000
22.0,24.0,22.0,209,13,01,  Natun Mahal,1070,1346,494,666,576,680,44.3,42.6,45.9,00000
22.0,24.0,22.0,209,14,01,  Khankar Khil,838,1193,380,610,458,583,41.3,38.4,44.0,00000
22.0,24.0,22.0,209,15,01,  Ghona Para,191,474,104,228,87,246,28.7,31.3,26.1,00000
22.0,24.0,35.0,104,01,01,  Bhomariaghona(East-Maddayam),1177,969,618,474,559,495,54.8,56.6,53.0,00000
22.0,24.0,35.0,104,02,01,  Chowdhury Para,321,176,170,79,151,97,64.6,68.3,60.9,00000
22.0,24.0,35.0,104,03,01,  Kulala Para(Sia Para),113,359,63,166,50,193,23.9,27.5,20.6,00000
22.0,24.0,35.0,104,04,01,  Mondal Para,412,598,220,290,192,308,40.8,43.1,38.4,00000
22.0,24.0,35.0,104,06,01,  Uttar Baditala,263,288,122,133,141,155,47.7,47.8,47.6,00000
22.0,24.0,35.0,471,01,03,  Maiz Para (NortMaddaySouth),3859,2018,2028,927,1831,1091,65.7,68.6,62.7,00000
22.0,24.0,35.0,471,02,03,  Jaigir Para (Khonker Para),1662,846,931,386,731,460,66.3,70.7,61.4,00000
22.0,24.0,35.0,471,03,03,  Kania Chara,330,215,175,88,155,127,60.6,66.5,55.0,00000
22.0,24.0,35.0,471,04,03,  Pal Para,822,149,446,73,376,76,84.7,85.9,83.2,00000
22.0,24.0,35.0,471,05,03,  Darga Para (Siapara ),1180,1791,600,906,580,885,39.7,39.8,39.6,00000
22.0,24.0,35.0,471,06,03,  Badia Tala (Hasina Para),209,680,106,343,103,337,23.5,23.6,23.4,00000
22.0,24.0,35.0,733,01,01,  Satghoria Para(Lal S.Para),286,380,128,186,158,194,42.9,40.8,44.9,00000
22.0,24.0,35.0,733,02,01,  Meherghona,1037,998,519,468,518,530,51.0,52.6,49.4,00000
22.0,24.0,35.0,733,03,01,  Chandar Ghona,575,607,269,292,306,315,48.6,48.0,49.3,00000
22.0,24.0,35.0,733,04,01,  Uttar Kalirchara (Siapara),291,917,121,467,170,450,24.1,20.6,27.4,00000
22.0,24.0,35.0,733,05,01,  Maddayam Kalirchara(B.Para),212,390,97,199,115,191,35.2,32.8,37.6,00000
22.0,24.0,35.0,733,06,01,  Kalirchhara,479,831,254,408,225,423,36.6,38.4,34.7,00000
22.0,24.0,35.0,733,07,01,  Machhua Khali (Mura Para),27,48,16,29,11,19,36.0,35.6,36.7,00000
22.0,24.0,38.0,785,01,01,  Baskata,572,801,285,409,287,392,41.7,41.1,42.3,00000
22.0,24.0,38.0,785,02,01,  Uttar Napit Khali,990,1189,500,607,490,582,45.4,45.2,45.7,00000
22.0,24.0,38.0,785,03,01,  Madhya Napitkhali(Madanaba),1119,2251,551,1130,568,1121,33.2,32.8,33.6,00000
22.0,24.0,38.0,785,04,01,  Purba Napit Khali(Villagarpar),1051,2283,530,1194,521,1089,31.5,30.7,32.4,00000
22.0,24.0,38.0,785,05,01,  Baman Kata(EastWest),1174,1513,593,745,581,768,43.7,44.3,43.1,00000
22.0,24.0,38.0,785,06,01,  Dormer Sora,913,820,505,440,408,380,52.7,53.4,51.8,00000
22.0,24.0,38.0,785,07,01,  Khangona,715,463,372,247,343,216,60.7,60.1,61.4,00000
22.0,24.0,42.0,157,01,01,  Boalkhali(East),241,451,115,235,126,216,34.8,32.9,36.8,00000
22.0,24.0,42.0,157,02,01,  Boalkhali (North),359,731,173,375,186,356,32.9,31.6,34.3,00000
22.0,24.0,42.0,157,03,01,  Santipur (Mucha Para),103,334,58,179,45,155,23.6,24.5,22.5,00000
22.0,24.0,42.0,157,04,01,  Boalkhali(Islampur),169,488,77,246,92,242,25.7,23.8,27.5,00000
22.0,24.0,42.0,471,01,03,  Satjola Kata (North-South),780,674,372,328,408,346,53.6,53.1,54.1,00000
22.0,24.0,42.0,471,02,03,  Pashia Khali(Nor-Madda-South),1191,1029,578,525,613,504,53.6,52.4,54.9,00000
22.0,24.0,42.0,471,03,03,  Tek Para,839,777,416,389,423,388,51.9,51.7,52.2,00000
22.0,24.0,42.0,471,04,03,  Bera Para,146,134,76,60,70,74,52.1,55.9,48.6,00000
22.0,24.0,42.0,471,05,03,  Hidupara,802,482,409,232,393,250,62.5,63.8,61.1,00000
22.0,24.0,42.0,471,06,03,  Para Kahar,94,145,49,67,45,78,39.3,42.2,36.6,00000
22.0,24.0,42.0,471,07,03,  Sikdar Para,560,213,279,97,281,116,72.4,74.2,70.8,00000
22.0,24.0,42.0,471,08,03,  Lara Bag,177,235,79,122,98,113,43.0,39.3,46.4,00000
22.0,24.0,42.0,471,09,03,  Char Para,162,316,71,173,91,143,33.9,29.1,38.9,00000
22.0,24.0,42.0,471,10,03,  Yousferf Khil,1150,1013,550,494,600,519,53.2,52.7,53.6,00000
22.0,24.0,42.0,471,11,03,  Hari Pur,485,294,253,149,232,145,62.3,62.9,61.5,00000
22.0,24.0,42.0,471,12,03,  Khodai Bari,1621,2133,830,1073,791,1060,43.2,43.6,42.7,00000
22.0,24.0,42.0,471,13,03,  Waheder Para,559,1919,276,1043,283,876,22.6,20.9,24.4,00000
22.0,24.0,45.0,471,01,03,  Farazi Para,654,733,377,386,277,347,47.2,49.4,44.4,00000
22.0,24.0,45.0,471,02,03,  Khamar Para,291,174,139,83,152,91,62.6,62.6,62.6,00000
22.0,24.0,45.0,471,03,03,  Miazi Para(Kona Para),420,735,192,363,228,372,36.4,34.6,38.0,00000
22.0,24.0,45.0,471,04,03,  Bahar Chara,537,909,276,452,261,457,37.1,37.9,36.4,00000
22.0,24.0,45.0,471,05,03,  Mohon Villa,322,596,143,292,179,304,35.1,32.9,37.1,00000
22.0,24.0,45.0,471,06,03,  Edrishpur (Battali Para),187,101,90,44,97,57,64.9,67.2,63.0,00000
22.0,24.0,45.0,471,07,03,  Pala Kata(North-South),1554,955,796,439,758,516,61.9,64.5,59.5,00000
22.0,24.0,45.0,471,08,03,  Dakhin Larabag,826,1153,392,589,434,564,41.7,40.0,43.5,00000
22.0,24.0,45.0,471,09,03,  Char Para,154,208,78,109,76,99,42.5,41.7,43.4,00000
22.0,24.0,45.0,471,10,03,  Machua Para,151,292,85,138,66,154,34.1,38.1,30.0,00000
22.0,24.0,45.0,471,11,03,  Hindu Para (Shati Para),305,306,154,155,151,151,49.9,49.8,50.0,00000
22.0,24.0,45.0,471,12,03,  Talipara (Bazar Para),1019,1326,547,698,472,628,43.5,43.9,42.9,00000
22.0,24.0,47.0,523,01,01,  Chander Para,885,748,520,391,365,357,54.2,57.1,50.6,00000
22.0,24.0,47.0,523,02,01,  Lar Para(EastWest),2824,2986,1505,1432,1319,1554,48.6,51.2,45.9,00000
22.0,24.0,47.0,523,03,01,  U.Hazi Para,636,250,348,101,288,149,71.8,77.5,65.9,00000
22.0,24.0,47.0,523,04,01,  Mohuri Para,3569,3248,2130,1537,1439,1711,52.4,58.1,45.7,00000
22.0,24.0,47.0,523,05,01,  D.Hazipara D.Dikul,1479,1234,770,604,709,630,54.5,56.0,52.9,00000
22.0,24.0,47.0,523,06,01,  Jahana Ghona(NorthSouth),1161,1300,591,635,570,665,47.2,48.2,46.2,00000
22.0,24.0,47.0,523,07,01,  Bohor Chora Sukna Chori,513,1309,272,652,241,657,28.2,29.4,26.8,00000
22.0,24.0,47.0,628,01,01,  Paschim Khurulia,2145,1325,1132,624,1013,701,61.8,64.5,59.1,00000
22.0,24.0,47.0,628,02,01,  Madhyam Khurulia,2370,2031,945,815,1425,1216,53.9,53.7,54.0,00000
22.0,24.0,47.0,628,03,01,  Purba Khurulia,2682,1932,1396,873,1286,1059,58.1,61.5,54.8,00000
22.0,24.0,59.0,680,01,01,  Pecharghona,605,739,251,375,354,364,45.0,40.1,49.3,00000
22.0,24.0,59.0,680,02,01,  Dail Para,1202,2343,585,1195,617,1148,33.9,32.9,35.0,00000
22.0,24.0,59.0,680,03,01,  Rastar Para,621,900,321,444,300,456,40.8,42.0,39.7,00000
22.0,24.0,59.0,680,04,01,  Shampanghat (Ruhullardail),399,565,201,280,198,285,41.4,41.8,41.0,00000
22.0,24.0,59.0,680,05,01,  Monu Para,566,319,392,206,174,113,64.0,65.6,60.6,00000
22.0,24.0,59.0,680,06,01,  Fakir Para,1537,1358,766,676,771,682,53.1,53.1,53.1,00000
22.0,24.0,59.0,680,07,01,  Uttar Mamun Para,1154,889,608,431,546,458,56.5,58.5,54.4,00000
22.0,24.0,59.0,680,08,01,  Palpara,502,474,272,237,230,237,51.4,53.4,49.3,00000
22.0,24.0,59.0,680,09,01,  Kulal Para,1045,1539,525,791,520,748,40.4,39.9,41.0,00000
22.0,24.0,59.0,680,10,01,  Dakshin Mamun Para,1032,1840,506,948,526,892,35.9,34.8,37.1,00000
22.0,24.0,59.0,680,11,01,  Hat Kulal Para,280,262,137,136,143,126,51.7,50.2,53.2,00000
22.0,24.0,59.0,680,12,01,  Jalia Para,893,1637,537,1225,356,412,35.3,30.5,46.4,00000
22.0,24.0,59.0,680,13,01,  Hindu Para,1975,3586,1011,1763,964,1823,35.5,36.4,34.6,00000
22.0,24.0,59.0,680,14,01,  Panchayet Para,1112,1222,582,608,530,614,47.6,48.9,46.3,00000
22.0,24.0,59.0,942,01,01,  Box Alipara (Gunar Para),452,768,211,380,241,388,37.0,35.7,38.3,00000
22.0,24.0,59.0,942,02,01,  Dril Para,111,247,48,133,63,114,31.0,26.5,35.6,00000
22.0,24.0,59.0,942,03,01,  Sikdar Para (Halandar Para),540,716,262,395,278,321,43.0,39.9,46.4,00000
22.0,24.0,59.0,942,04,01,  Falu Fakir Para,320,418,162,212,158,206,43.4,43.3,43.4,00000
22.0,24.0,71.0,837,01,01,  Ghular Para,214,332,123,163,91,169,39.2,43.0,35.0,00000
22.0,24.0,71.0,837,02,01,  Mochhania Para,1091,1172,558,553,533,619,48.2,50.2,46.3,00000
22.0,24.0,71.0,837,03,01,  Machhuakhali,667,1015,318,499,349,516,39.7,38.9,40.3,00000
22.0,24.0,71.0,837,04,01,  Maiz Para,239,380,117,194,122,186,38.6,37.6,39.6,00000
22.0,24.0,71.0,837,05,01,  Naya Para,992,1184,471,638,521,546,45.6,42.5,48.8,00000
22.0,24.0,71.0,837,06,01,  Chhankola,1934,3478,954,1717,980,1761,35.7,35.7,35.8,00000
22.0,24.0,71.0,837,07,01,  Jhumchhari,1249,1792,642,892,607,900,41.1,41.9,40.3,00000
22.0,24.0,71.0,837,08,01,  Parania Para,645,1343,289,671,356,672,32.4,30.1,34.6,00000
22.0,24.0,71.0,837,09,01,  Dhawnkhali,759,1175,382,542,377,633,39.2,41.3,37.3,00000
22.0,24.0,71.0,837,10,01,  Kattalia Mura,533,1288,274,667,259,621,29.3,29.1,29.4,00000
22.0,24.0,71.0,837,11,01,  Ghat Kulia Para,309,599,149,319,160,280,34.0,31.8,36.4,00000
22.0,24.0,71.0,837,12,01,  Dikpara,829,750,412,361,417,389,52.5,53.3,51.7,00000
22.0,24.0,71.0,837,13,01,  Patuli,1061,975,551,475,510,500,52.1,53.7,50.5,00000
22.0,24.0,83.0,366,01,01,  Purba Gomatali,541,636,248,348,293,288,46.0,41.6,50.4,00000
22.0,24.0,83.0,366,02,01,  Paschim Gomatali,789,1130,367,615,422,515,41.1,37.4,45.0,00000
22.0,24.0,83.0,366,03,01,  Refuge Ghona (Badarkhalipara),299,157,150,83,149,74,65.6,64.4,66.8,00000
22.0,24.0,83.0,366,04,01,  Ghaita Khali (Chiat Khali),290,420,150,224,140,196,40.8,40.1,41.7,00000
22.0,24.0,83.0,366,05,01,  Baradilla Para,131,280,56,161,75,119,31.9,25.8,38.7,00000
22.0,24.0,83.0,418,01,01,  East Ichhakhali,308,333,133,179,175,154,48.0,42.6,53.2,00000
22.0,24.0,83.0,418,02,01,  Maddyam Ichhakhali,140,180,59,83,81,97,43.8,41.5,45.5,00000
22.0,24.0,83.0,418,03,01,  Paschim Ichhakhali,296,583,136,301,160,282,33.7,31.1,36.2,00000
22.0,24.0,83.0,890,01,01,  Purba Pokkhali(Sikderpara),974,1035,500,482,474,553,48.5,50.9,46.2,00000
22.0,24.0,83.0,890,02,01,  Paschim Pokkhali,1076,1587,504,823,572,764,40.4,38.0,42.8,00000
22.0,24.0,83.0,890,03,01,  Madhya Pokkhali,1259,1511,645,756,614,755,45.5,46.0,44.9,00000
22.0,24.0,83.0,890,04,01,  Nykangdia,1448,1842,705,904,743,938,44.0,43.8,44.2,00000
22.0,45.0,13.0,110,01,01,  C.H. Para,1460,2023,768,969,692,1054,41.9,44.2,39.6,00000
22.0,45.0,13.0,110,02,01,  Nasiyar Para,758,1307,390,653,368,654,36.7,37.4,36.0,00000
22.0,45.0,13.0,110,03,01,  Haidar Para,427,1042,213,514,214,528,29.1,29.3,28.8,00000
22.0,45.0,13.0,110,04,01,  Fati Ali Sikder Para,907,1159,475,581,432,578,43.9,45.0,42.8,00000
22.0,45.0,13.0,110,05,01,  Sandiep Para,761,775,397,358,364,417,49.5,52.6,46.6,00000
22.0,45.0,13.0,110,06,01,  Anisar Para,1622,1925,869,928,753,997,45.7,48.4,43.0,00000
22.0,45.0,13.0,110,07,01,  East Tablor Char,622,1443,326,730,296,713,30.1,30.9,29.3,00000
22.0,45.0,13.0,110,08,01,  West Tablor Char,560,1238,294,638,266,600,31.1,31.5,30.7,00000
22.0,45.0,27.0,221,01,03,  Uttar Bara Goph,992,1251,515,629,477,622,44.2,45.0,43.4,00000
22.0,45.0,27.0,221,02,03,  Madbar Para,905,1665,474,829,431,836,35.2,36.4,34.0,00000
22.0,45.0,27.0,221,03,03,  Romai Para,706,854,352,417,354,437,45.3,45.8,44.8,00000
22.0,45.0,27.0,221,04,03,  Azam Khali,605,1936,334,994,271,942,23.8,25.2,22.3,00000
22.0,45.0,27.0,221,05,03,  Mogdal,1461,1723,791,851,670,872,45.9,48.2,43.5,00000
22.0,45.0,27.0,221,06,03,  Muraliya,1032,1356,537,679,495,677,43.2,44.2,42.2,00000
22.0,45.0,27.0,221,07,03,  Goldar Para,445,1925,250,977,195,948,18.8,20.4,17.1,00000
22.0,45.0,27.0,221,08,03,  Monohar Khali,798,1402,430,720,368,682,36.3,37.4,35.0,00000
22.0,45.0,27.0,221,09,03,  Sayed Para,1042,972,563,512,479,460,51.7,52.4,51.0,00000
22.0,45.0,40.0,442,01,01,  Kalachan Para,628,1170,302,600,326,570,34.9,33.5,36.4,00000
22.0,45.0,40.0,442,02,01,  West Ali Faker Deal,565,937,282,459,283,478,37.6,38.1,37.2,00000
22.0,45.0,40.0,442,03,01,  East Ali Faker Deal,277,1300,129,633,148,667,17.6,16.9,18.2,00000
22.0,45.0,40.0,442,04,01,  Mosarof Para,221,1213,129,626,92,587,15.4,17.1,13.5,00000
22.0,45.0,40.0,442,05,01,  Haider Ali Meazr Para,564,1329,304,668,260,661,29.8,31.3,28.2,00000
22.0,45.0,40.0,442,06,01,  Shikder Para,500,949,269,517,231,432,34.5,34.2,34.8,00000
22.0,45.0,40.0,442,07,01,  Dhurung Kacha,399,811,205,407,194,404,33.0,33.5,32.4,00000
22.0,45.0,40.0,442,08,01,  Musear Para,388,818,207,425,181,393,32.2,32.8,31.5,00000
22.0,45.0,40.0,442,09,01,  Nourar Para,662,1101,344,569,318,532,37.5,37.7,37.4,00000
22.0,45.0,54.0,552,01,01,  Binda Para,423,670,215,321,208,349,38.7,40.1,37.3,00000
22.0,45.0,54.0,552,02,01,  Mati Bapar Para,267,1033,129,512,138,521,20.5,20.1,20.9,00000
22.0,45.0,54.0,552,03,01,  Mogzinna Para,161,779,81,360,80,419,17.1,18.4,16.0,00000
22.0,45.0,54.0,552,04,01,  Hazimafjal,294,1315,158,678,136,637,18.3,18.9,17.6,00000
22.0,45.0,54.0,552,05,01,  Mizir Para,137,754,79,371,58,383,15.4,17.6,13.2,00000
22.0,45.0,54.0,552,06,01,  Kolshaghona,193,800,77,408,116,392,19.4,15.9,22.8,00000
22.0,45.0,54.0,552,07,01,  Paran Sikder Para,210,1143,102,623,108,520,15.5,14.1,17.2,00000
22.0,45.0,54.0,552,08,01,  Gila-Charu,330,991,182,482,148,509,25.0,27.4,22.5,00000
22.0,45.0,54.0,552,09,01,  Malamchar,277,814,156,423,121,391,25.4,26.9,23.6,00000
22.0,45.0,67.0,773,01,01,  Akber Ali Sikder Para,723,733,423,367,300,366,49.7,53.5,45.0,00000
22.0,45.0,67.0,773,02,01,  Mounshe Miazer Para,995,1365,527,727,468,638,42.2,42.0,42.3,00000
22.0,45.0,67.0,773,03,01,  Payre Kata,633,1049,312,513,321,536,37.6,37.8,37.5,00000
22.0,45.0,67.0,773,04,01,  Hazarea Para,433,1160,233,594,200,566,27.2,28.2,26.1,00000
22.0,45.0,67.0,773,05,01,  Mazer Para,769,880,396,440,373,440,46.6,47.4,45.9,00000
22.0,45.0,67.0,773,06,01,  Gaine Kata,1005,1053,502,540,503,513,48.8,48.2,49.5,00000
22.0,45.0,67.0,773,07,01,  Habib Hazer Para,764,793,401,398,363,395,49.1,50.2,47.9,00000
22.0,45.0,67.0,773,08,01,  Shazer Para,655,994,326,525,329,469,39.7,38.3,41.2,00000
22.0,45.0,67.0,773,09,01,  Shiddek Hazer Para,438,849,216,469,222,380,34.0,31.5,36.9,00000
22.0,45.0,81.0,994,01,01,  Farezar Para,807,1664,426,844,381,820,32.7,33.5,31.7,00000
22.0,45.0,81.0,994,02,01,  Chullar Para,860,1570,437,796,423,774,35.4,35.4,35.3,00000
22.0,45.0,81.0,994,03,01,  Akber Boyler Para,571,1623,291,835,280,788,26.0,25.8,26.2,00000
22.0,45.0,81.0,994,04,01,  Joyezer Para,446,1470,238,727,208,743,23.3,24.7,21.9,00000
22.0,45.0,81.0,994,05,01,  Soturuddin N.Para,924,1880,482,986,442,894,33.0,32.8,33.1,00000
22.0,45.0,81.0,994,06,01,  Bakkhile,596,2050,328,989,268,1061,22.5,24.9,20.2,00000
22.0,45.0,81.0,994,07,01,  Kalamer Para,653,1622,320,815,333,807,28.7,28.2,29.2,00000
22.0,45.0,81.0,994,08,01,  Fourar Para,656,1535,324,766,332,769,29.9,29.7,30.2,00000
22.0,45.0,81.0,994,09,01,  Talea Kata,826,1847,434,925,392,922,30.9,31.9,29.8,00000
22.0,49.0,11.0,064,01,01,  Sugriapara,230,393,109,209,121,184,36.9,34.3,39.7,00000
22.0,49.0,11.0,064,02,01,  Fakirakata,242,711,109,386,133,325,25.4,22.0,29.0,00000
22.0,49.0,11.0,064,03,01,  Bara Dail,618,2144,328,1130,290,1014,22.4,22.5,22.2,00000
22.0,49.0,11.0,064,04,01,  Majher Dail,471,918,249,473,222,445,33.9,34.5,33.3,00000
22.0,49.0,11.0,064,05,01,  Munshir Dail,1072,3038,511,1575,561,1463,26.1,24.5,27.7,00000
22.0,49.0,11.0,064,06,01,  Magariakata,390,860,198,471,192,389,31.2,29.6,33.0,00000
22.0,49.0,11.0,064,07,01,  Mahara Para,405,556,211,288,194,268,42.1,42.3,42.0,00000
22.0,49.0,11.0,064,08,01,  Monu Para,231,296,145,171,86,125,43.8,45.9,40.8,00000
22.0,49.0,11.0,064,09,01,  Gulgulia Para,79,373,47,200,32,173,17.5,19.0,15.6,00000
22.0,49.0,11.0,064,10,01,  Debinga Para,521,1768,263,922,258,846,22.8,22.2,23.4,00000
22.0,49.0,11.0,064,11,01,  Sipahi Para,118,428,64,225,54,203,21.6,22.1,21.0,00000
22.0,49.0,11.0,064,12,01,  Hindu Para,804,882,424,437,380,445,47.7,49.2,46.1,00000
22.0,49.0,11.0,064,13,01,  Gorsthan Para,76,154,31,82,45,72,33.0,27.4,38.5,00000
22.0,49.0,11.0,064,14,01,  Kulalpara,667,1455,361,709,306,746,31.4,33.7,29.1,00000
22.0,49.0,11.0,064,15,01,  Nij Taluk Para,280,456,146,243,134,213,38.0,37.5,38.6,00000
22.0,49.0,11.0,064,16,01,  Satgharia Para,374,837,195,428,179,409,30.9,31.3,30.4,00000
22.0,49.0,11.0,064,17,01,  Miazir Para,1160,1504,600,815,560,689,43.5,42.4,44.8,00000
22.0,49.0,11.0,064,18,01,  Muhuri Dail,213,360,115,179,98,181,37.2,39.1,35.1,00000
22.0,49.0,11.0,064,19,01,  Maduar Dail,276,725,139,380,137,345,27.6,26.8,28.4,00000
22.0,49.0,11.0,224,01,01,  Purba Fakiraghona,1332,2293,660,1197,672,1096,36.7,35.5,38.0,00000
22.0,49.0,11.0,224,02,01,  Paschim Fakiraghona,1044,1458,562,778,482,680,41.7,41.9,41.5,00000
22.0,49.0,18.0,096,01,01,  Bashirakhola,243,1542,120,804,123,738,13.6,13.0,14.3,00000
22.0,49.0,18.0,096,02,01,  Chhota Maheskhali,530,1530,261,798,269,732,25.7,24.6,26.9,00000
22.0,49.0,18.0,096,03,01,  Umania Para,58,529,31,280,27,249,9.9,10.0,9.8,00000
22.0,49.0,18.0,096,04,01,  Assakder Ghona,431,1636,228,884,203,752,20.9,20.5,21.3,00000
22.0,49.0,18.0,096,05,01,  Himchari,95,433,59,232,36,201,18.0,20.3,15.2,00000
22.0,49.0,18.0,096,06,01,  Ahamadier Kata,221,791,124,404,97,387,21.8,23.5,20.0,00000
22.0,49.0,18.0,096,07,01,  Mudirchhara,46,486,27,272,19,214,8.6,9.0,8.2,00000
22.0,49.0,18.0,962,01,01,  Thakurtala,682,1658,400,826,282,832,29.1,32.6,25.3,00000
22.0,49.0,18.0,962,02,01,  Teli Para,316,740,187,376,129,364,29.9,33.2,26.2,00000
22.0,49.0,18.0,962,03,01,  Dail Para,357,696,192,344,165,352,33.9,35.8,31.9,00000
22.0,49.0,23.0,160,01,01,  Sapmaradhil,362,1571,155,814,207,757,18.7,16.0,21.5,00000
22.0,49.0,23.0,160,02,01,  Panditerdhil,176,373,80,211,96,162,32.1,27.5,37.2,00000
22.0,49.0,23.0,160,03,01,  Begunbania,156,345,70,197,86,148,31.1,26.2,36.8,00000
22.0,49.0,23.0,160,04,01,  Napiter Para,123,162,64,92,59,70,43.2,41.0,45.7,00000
22.0,49.0,23.0,160,05,01,  Sutaria Para,867,1851,430,1020,437,831,31.9,29.7,34.5,00000
22.0,49.0,23.0,160,06,01,  Saraitala,177,494,89,266,88,228,26.4,25.1,27.8,00000
22.0,49.0,23.0,160,07,01,  Hamidkhali,238,240,110,138,128,102,49.8,44.4,55.7,00000
22.0,49.0,23.0,160,08,01,  Panirchhara,114,202,55,106,59,96,36.1,34.2,38.1,00000
22.0,49.0,23.0,160,09,01,  Dakshin Mohiraghona,87,109,43,59,44,50,44.4,42.2,46.8,00000
22.0,49.0,23.0,160,10,01,  Sikdar Para,95,180,49,98,46,82,34.5,33.3,35.9,00000
22.0,49.0,23.0,160,11,01,  Uttar Mohiraghona,315,559,164,295,151,264,36.0,35.7,36.4,00000
22.0,49.0,23.0,160,12,01,  Bonjamira,128,388,67,200,61,188,24.8,25.1,24.5,00000
22.0,49.0,23.0,160,13,01,  Nasir Mohammaddhil,154,324,83,159,71,165,32.2,34.3,30.1,00000
22.0,49.0,23.0,160,14,01,  Dakshin Sutaria,334,365,177,199,157,166,47.8,47.1,48.6,00000
22.0,49.0,47.0,353,01,01,  Daillaghona,226,615,117,280,109,335,26.9,29.5,24.5,00000
22.0,49.0,47.0,353,02,01,  Chankhola Para,1045,1487,530,786,515,701,41.3,40.3,42.4,00000
22.0,49.0,47.0,353,03,01,  Uttar Purbakul Hariarchhara,316,939,157,475,159,464,25.2,24.8,25.5,00000
22.0,49.0,47.0,353,04,01,  Uttar Paschimkul Hariarchhara,1023,1276,515,654,508,622,44.5,44.1,45.0,00000
22.0,49.0,47.0,353,05,01,  Pahartali Para,253,400,111,219,142,181,38.7,33.6,44.0,00000
22.0,49.0,47.0,417,01,01,  Kalaghagir Para,776,1389,383,738,393,651,35.8,34.2,37.6,00000
22.0,49.0,47.0,417,02,01,  Khorshar Para,655,1040,332,526,323,514,38.6,38.7,38.6,00000
22.0,49.0,47.0,417,03,01,  Padma Pukur Hindu Para,299,511,158,259,141,252,36.9,37.9,35.9,00000
22.0,49.0,47.0,417,04,01,  Hamidur Rahman Para,214,1207,96,654,118,553,15.1,12.8,17.6,00000
22.0,49.0,47.0,417,05,01,  Puichhara Muslim Para,448,602,230,300,218,302,42.7,43.4,41.9,00000
22.0,49.0,47.0,417,06,01,  Puichhara Hindu Para,512,1257,276,633,236,624,28.9,30.4,27.4,00000
22.0,49.0,47.0,417,07,01,  Jalla Para,322,649,168,347,154,302,33.2,32.6,33.8,00000
22.0,49.0,47.0,417,08,01,  Baniakata,415,872,210,462,205,410,32.2,31.3,33.3,00000
22.0,49.0,47.0,417,09,01,  Majher Para,337,925,154,492,183,433,26.7,23.8,29.7,00000
22.0,49.0,47.0,417,10,01,  Barachhara Muslim Para,273,608,114,305,159,303,31.0,27.2,34.4,00000
22.0,49.0,47.0,417,11,01,  Barachhara Hindu Para,201,846,102,452,99,394,19.2,18.4,20.1,00000
22.0,49.0,47.0,417,12,01,  Kaindala Para,198,251,93,130,105,121,44.1,41.7,46.5,00000
22.0,49.0,47.0,417,13,01,  Rajuarghona,699,2698,333,1428,366,1270,20.6,18.9,22.4,00000
22.0,49.0,47.0,417,14,01,  Uttarkul Keruntali Hindupara,185,275,93,140,92,135,40.2,39.9,40.5,00000
22.0,49.0,47.0,834,01,01,  Dakshinkul Keruntali Hindupara,295,672,162,342,133,330,30.5,32.1,28.7,00000
22.0,49.0,47.0,834,02,01,  Aydhya Mollah Para,111,126,64,53,47,73,46.8,54.7,39.2,00000
22.0,49.0,47.0,834,03,01,  Naya Para,406,1559,200,806,206,753,20.7,19.9,21.5,00000
22.0,49.0,47.0,834,04,01,  Kalaliakata,596,1868,304,981,292,887,24.2,23.7,24.8,00000
22.0,49.0,47.0,834,05,01,  Uttar Dhalgata Para,466,1181,214,597,252,584,28.3,26.4,30.1,00000
22.0,49.0,47.0,834,06,01,  Dakshin Dhalgata Para,700,1353,322,722,378,631,34.1,30.8,37.5,00000
22.0,49.0,47.0,834,07,01,  Panirchhara,750,1997,381,1067,369,930,27.3,26.3,28.4,00000
22.0,49.0,47.0,834,08,01,  Baraghar Para,504,1825,229,1005,275,820,21.6,18.6,25.1,00000
22.0,49.0,47.0,834,09,01,  Jairkata,189,635,100,331,89,304,22.9,23.2,22.6,00000
22.0,49.0,59.0,449,01,01,  Younuskhali,363,722,178,368,185,354,33.5,32.6,34.3,00000
22.0,49.0,59.0,449,02,01,  Maiz Para,762,997,382,504,380,493,43.3,43.1,43.5,00000
22.0,49.0,59.0,513,01,01,  Marakkaghona,370,823,176,440,194,383,31.0,28.6,33.6,00000
22.0,49.0,59.0,513,02,01,  Golachiba,162,326,91,160,71,166,33.2,36.3,30.0,00000
22.0,49.0,59.0,513,03,01,  Pahartali,422,911,192,494,230,417,31.7,28.0,35.5,00000
22.0,49.0,59.0,513,04,01,  Uttar Jhapua,429,1166,192,631,237,535,26.9,23.3,30.7,00000
22.0,49.0,59.0,513,05,01,  Dakshin Jhapa,699,1413,353,762,346,651,33.1,31.7,34.7,00000
22.0,49.0,59.0,513,06,01,  Satghar Para,279,472,152,232,127,240,37.2,39.6,34.6,00000
22.0,49.0,59.0,513,07,01,  Dakshin Chikni Para,634,967,352,490,282,477,39.6,41.8,37.2,00000
22.0,49.0,59.0,545,01,01,  Ghona Para,318,719,161,374,157,345,30.7,30.1,31.3,00000
22.0,49.0,59.0,545,02,01,  Naya Para,831,1746,405,942,426,804,32.2,30.1,34.6,00000
22.0,49.0,59.0,545,03,01,  Bazar Para,373,93,207,43,166,50,80.0,82.8,76.9,00000
22.0,49.0,59.0,545,04,01,  Kahar Para,219,267,123,141,96,126,45.1,46.6,43.2,00000
22.0,49.0,59.0,545,05,01,  Fakira Ghona,334,1156,169,639,165,517,22.4,20.9,24.2,00000
22.0,49.0,59.0,545,06,01,  Madhukhali Para,797,957,426,521,371,436,45.4,45.0,46.0,00000
22.0,49.0,59.0,545,07,01,  Fakirer Jumpara,361,753,207,390,154,363,32.4,34.7,29.8,00000
22.0,49.0,59.0,545,08,01,  Mohammad Shahghona,843,1356,427,713,416,643,38.3,37.5,39.3,00000
22.0,49.0,59.0,545,09,01,  Samiraghona,423,585,227,307,196,278,42.0,42.5,41.4,00000
22.0,49.0,59.0,545,10,01,  Nunachhari Para,767,2117,371,1111,396,1006,26.6,25.0,28.2,00000
22.0,49.0,59.0,545,11,01,  Andharghona,1221,3838,590,2009,631,1829,24.1,22.7,25.7,00000
22.0,49.0,59.0,545,12,01,  Mirzir Para,311,861,147,465,164,396,26.5,24.0,29.3,00000
22.0,49.0,59.0,545,13,01,  Daillaghona,235,593,111,295,124,298,28.4,27.3,29.4,00000
22.0,49.0,59.0,994,01,01,  Afzallar Para,99,176,41,96,58,80,36.0,29.9,42.0,00000
22.0,49.0,59.0,994,02,01,  Akbar Hazir Para,124,254,61,132,63,122,32.8,31.6,34.1,00000
22.0,49.0,59.0,994,03,01,  Majher Para,225,570,106,293,119,277,28.3,26.6,30.1,00000
22.0,49.0,59.0,994,04,01,  Barua Para,282,659,132,333,150,326,30.0,28.4,31.5,00000
22.0,49.0,59.0,994,05,01,  Dargahghona Para,707,836,365,440,342,396,45.8,45.3,46.3,00000
22.0,49.0,59.0,994,06,01,  Chaliatali,247,867,106,454,141,413,22.2,18.9,25.5,00000
22.0,49.0,59.0,994,07,01,  Manhajir Para,415,552,230,274,185,278,42.9,45.6,40.0,00000
22.0,49.0,71.0,706,01,01,  Baniakata,30,723,15,361,15,362,4.0,4.0,4.0,00000
22.0,49.0,71.0,706,02,01,  Bandi Sikdar Para,86,542,37,288,49,254,13.7,11.4,16.2,00000
22.0,49.0,71.0,706,03,01,  Paschim Sikdar Para,1390,2430,641,1257,749,1173,36.4,33.8,39.0,00000
22.0,49.0,71.0,706,04,01,  Purba Sikdar Para,584,1321,273,683,311,638,30.7,28.6,32.8,00000
22.0,49.0,71.0,706,05,01,  Naya Para,218,455,111,241,107,214,32.4,31.5,33.3,00000
22.0,49.0,71.0,706,06,01,  Razghat,1397,3719,652,1950,745,1769,27.3,25.1,29.6,00000
22.0,49.0,71.0,706,07,01,  Lailaghona,170,701,79,364,91,337,19.5,17.8,21.3,00000
22.0,49.0,71.0,706,08,01,  Dhupir Para,197,195,116,94,81,101,50.3,55.2,44.5,00000
22.0,49.0,71.0,706,09,01,  Napit Para,90,112,45,63,45,49,44.6,41.7,47.9,00000
22.0,49.0,71.0,706,10,01,  Balir Para,179,391,82,195,97,196,31.4,29.6,33.1,00000
22.0,49.0,71.0,706,11,01,  Miazi Para,345,1293,161,655,184,638,21.1,19.7,22.4,00000
22.0,49.0,71.0,706,12,01,  Tita Majhir Para,971,2496,490,1297,481,1199,28.0,27.4,28.6,00000
22.0,49.0,71.0,706,13,01,  Fuljan Mora,232,377,109,182,123,195,38.1,37.5,38.7,00000
22.0,49.0,71.0,706,14,01,  Maiz Para,931,2143,437,1073,494,1070,30.3,28.9,31.6,00000
22.0,49.0,71.0,706,15,01,  Mazer Dail,434,1073,211,530,223,543,28.8,28.5,29.1,00000
22.0,49.0,71.0,706,16,01,  Songha Miazir Para,248,987,121,497,127,490,20.1,19.6,20.6,00000
22.0,49.0,71.0,706,17,01,  Mogdail,934,2253,458,1154,476,1099,29.3,28.4,30.2,00000
22.0,49.0,71.0,706,18,01,  Sardar Para,279,1018,139,524,140,494,21.5,21.0,22.1,00000
22.0,49.0,71.0,706,19,01,  Sairer Dail,889,2597,372,1352,517,1245,25.5,21.6,29.3,00000
22.0,49.0,71.0,706,20,01,  Satgar Para,190,599,99,310,91,289,24.1,24.2,23.9,00000
22.0,49.0,71.0,706,21,01,  Monhazir Para,185,570,74,309,111,261,24.5,19.3,29.8,00000
22.0,49.0,83.0,738,01,01,  Budhar Para,459,1085,235,542,224,543,29.7,30.2,29.2,00000
22.0,49.0,83.0,738,02,01,  Ghona Para,162,544,82,273,80,271,22.9,23.1,22.8,00000
22.0,49.0,83.0,738,03,01,  Kusiyar Para,419,580,228,279,191,301,41.9,45.0,38.8,00000
22.0,49.0,83.0,770,01,01,  Sadekerkata,407,1038,200,544,207,494,28.2,26.9,29.5,00000
22.0,49.0,83.0,770,02,01,  Murung Ghona,140,734,71,379,69,355,16.0,15.8,16.3,00000
22.0,49.0,83.0,770,03,01,  Baria Para,200,1050,95,520,105,530,16.0,15.4,16.5,00000
22.0,49.0,83.0,770,04,01,  Kaidabad,288,950,143,498,145,452,23.3,22.3,24.3,00000
22.0,49.0,83.0,898,01,01,  Saitmara,842,1726,393,881,449,845,32.8,30.8,34.7,00000
22.0,49.0,83.0,898,02,01,  J.M.Ghat,852,2288,412,1154,440,1134,27.1,26.3,28.0,00000
22.0,49.0,83.0,898,03,01,  Maulvirkata,170,526,83,275,87,251,24.4,23.2,25.7,00000
22.0,49.0,83.0,898,04,01,  Satghar Para,441,936,236,472,205,464,32.0,33.3,30.6,00000
22.0,49.0,83.0,898,05,01,  Jamirchhari,140,547,66,271,74,276,20.4,19.6,21.1,00000
22.0,49.0,83.0,898,06,01,  Bariachhari,236,464,123,251,113,213,33.7,32.9,34.7,00000
22.0,49.0,83.0,898,07,01,  Ghona Para,320,889,165,456,155,433,26.5,26.6,26.4,00000
22.0,49.0,83.0,898,08,01,  Paschimpara,447,1947,238,980,209,967,18.7,19.5,17.8,00000
22.0,49.0,83.0,898,09,01,  Mithachhari,362,897,173,455,189,442,28.8,27.5,30.0,00000
22.0,49.0,83.0,898,10,01,  Jaidaghona,362,824,194,415,168,409,30.5,31.9,29.1,00000
22.0,49.0,83.0,898,11,01,  Saker Mohd.Kata,108,253,56,122,52,131,29.9,31.5,28.4,00000
22.0,49.0,83.0,898,12,01,  Monipur Gram,151,492,83,249,68,243,23.5,25.0,21.9,00000
22.0,56.0,11.0,076,01,01,  Bara Bakia,908,1065,490,509,418,556,46.0,49.0,42.9,00000
22.0,56.0,11.0,076,02,01,  Bharuakhali,207,359,100,174,107,185,36.6,36.5,36.6,00000
22.0,56.0,11.0,076,03,01,  Paharia Para,1091,1465,561,700,530,765,42.7,44.5,40.9,00000
22.0,56.0,11.0,076,04,01,  Bodha Majirghona,593,568,311,290,282,278,51.1,51.7,50.4,00000
22.0,56.0,11.0,076,05,01,  Noakhali,355,826,182,403,173,423,30.1,31.1,29.0,00000
22.0,56.0,11.0,076,06,01,  Nayakata,360,408,158,172,202,236,46.9,47.9,46.1,00000
22.0,56.0,11.0,076,07,01,  Kutub Para,195,547,101,270,94,277,26.3,27.2,25.3,00000
22.0,56.0,11.0,076,08,01,  Shabjiban Para,836,1077,446,515,390,562,43.7,46.4,41.0,00000
22.0,56.0,11.0,076,09,01,  Baryakata,471,547,207,249,264,298,46.3,45.4,47.0,00000
22.0,56.0,11.0,076,10,01,  Kadimakali,336,459,176,194,160,265,42.3,47.6,37.6,00000
22.0,56.0,11.0,076,11,01,  Annargha Para,130,286,71,135,59,151,31.3,34.5,28.1,00000
22.0,56.0,11.0,076,12,01,  Jaliakata,338,942,160,473,178,469,26.4,25.3,27.5,00000
22.0,56.0,11.0,076,13,01,  Bogakopagona,321,161,169,77,152,84,66.6,68.7,64.4,00000
22.0,56.0,55.0,474,01,01,  Fakiar Para,101,435,53,230,48,205,18.8,18.7,19.0,00000
22.0,56.0,55.0,474,02,01,  Dakshin Natunghona,173,826,85,451,88,375,17.3,15.9,19.0,00000
22.0,56.0,55.0,994,01,01,  Paschim Ujantia,304,2283,151,1199,153,1084,11.8,11.2,12.4,00000
22.0,56.0,55.0,994,02,01,  Purba Ujantia,554,1312,290,629,264,683,29.7,31.6,27.9,00000
22.0,56.0,55.0,994,03,01,  Ferasinga,102,950,53,516,49,434,9.7,9.3,10.1,00000
22.0,56.0,55.0,994,04,01,  Beluer Para,215,995,94,496,121,499,17.8,15.9,19.5,00000
22.0,56.0,55.0,994,05,01,  Sutachora,301,1023,159,484,142,539,22.7,24.7,20.9,00000
22.0,56.0,55.0,994,06,01,  Sutachora Natunghona,413,1334,195,682,218,652,23.6,22.2,25.1,00000
22.0,56.0,78.0,612,01,01,  Saratghona,352,986,166,508,186,478,26.3,24.6,28.0,00000
22.0,56.0,78.0,612,02,01,  Puran Bohadar Para,247,599,128,322,119,277,29.2,28.4,30.1,00000
22.0,56.0,78.0,612,03,01,  Karlia Para,186,191,87,98,99,93,49.3,47.0,51.6,00000
22.0,56.0,78.0,612,04,01,  Bazar Para,148,586,62,291,86,295,20.2,17.6,22.6,00000
22.0,56.0,78.0,612,05,01,  Bainnaghona,149,503,79,265,70,238,22.9,23.0,22.7,00000
22.0,56.0,78.0,612,06,01,  Dariakhali,51,157,32,80,19,77,24.5,28.6,19.8,00000
22.0,56.0,78.0,612,07,01,  Motkabhanga,195,707,83,372,112,335,21.6,18.2,25.1,00000
22.0,56.0,78.0,612,08,01,  Dardarighona,61,211,26,109,35,102,22.4,19.3,25.5,00000
22.0,56.0,78.0,612,09,01,  Magghona,655,273,312,140,343,133,70.6,69.0,72.1,00000
22.0,56.0,78.0,612,10,01,  Muhari Para,296,412,124,218,172,194,41.8,36.3,47.0,00000
22.0,56.0,78.0,612,11,01,  Kodailladia,170,241,76,124,94,117,41.4,38.0,44.5,00000
22.0,56.0,78.0,612,12,01,  Purbakul Rangikhali,303,669,137,341,166,328,31.2,28.7,33.6,00000
22.0,56.0,78.0,612,13,01,  Raiter Para,174,322,87,162,87,160,35.1,34.9,35.2,00000
22.0,56.0,78.0,612,14,01,  Majhir Para,435,424,212,195,223,229,50.6,52.1,49.3,00000
22.0,56.0,78.0,612,15,01,  Nuinar Para,159,208,72,111,87,97,43.3,39.3,47.3,00000
22.0,56.0,78.0,612,16,01,  Paschimkul,227,748,113,372,114,376,23.3,23.3,23.3,00000
22.0,56.0,78.0,612,17,01,  Haji Maulvipara,57,158,21,85,36,73,26.5,19.8,33.0,00000
22.0,56.0,78.0,612,18,01,  Sikdar Para,164,67,69,29,95,38,71.0,70.4,71.4,00000
22.0,56.0,78.0,612,19,01,  Satghar Para,167,351,75,164,92,187,32.2,31.4,33.0,00000
22.0,56.0,78.0,612,20,01,  Morichadia,190,530,81,273,109,257,26.4,22.9,29.8,00000
22.0,56.0,78.0,612,21,01,  Moulvipara,107,184,44,93,63,91,36.8,32.1,40.9,00000
22.0,56.0,78.0,612,22,01,  Bedar Billapara,187,463,81,244,106,219,28.8,24.9,32.6,00000
22.0,56.0,78.0,612,23,01,  Shurdakhali,148,385,62,203,86,182,27.8,23.4,32.1,00000
22.0,56.0,78.0,612,24,01,  Kalar Para,175,530,74,284,101,246,24.8,20.7,29.1,00000
22.0,56.0,78.0,612,25,01,  Uttar Natunghona,144,387,64,210,80,177,27.1,23.4,31.1,00000
22.0,56.0,78.0,612,26,01,  Kakpara,261,721,119,372,142,349,26.6,24.2,28.9,00000
22.0,56.0,78.0,612,27,01,  Cherang Ghona,92,272,49,137,43,135,25.3,26.3,24.2,00000
22.0,56.0,78.0,612,28,01,  Napitadia,90,395,38,208,52,187,18.6,15.4,21.8,00000
22.0,56.0,78.0,612,29,01,  Mollah Para,75,284,44,152,31,132,20.9,22.4,19.0,00000
22.0,56.0,83.0,658,01,01,  Uttar Mehernama,630,1099,284,521,346,578,36.4,35.3,37.4,00000
22.0,56.0,83.0,658,02,01,  Nandir Para,1101,1874,560,905,541,969,37.0,38.2,35.8,00000
22.0,56.0,83.0,658,03,01,  Bazar Para (A),397,736,204,373,193,363,35.0,35.4,34.7,00000
22.0,56.0,83.0,658,04,01,  Murar Para,349,921,173,471,176,450,27.5,26.9,28.1,00000
22.0,56.0,83.0,658,05,01,  Balir Para,128,390,50,198,78,192,24.7,20.2,28.9,00000
22.0,56.0,83.0,658,06,01,  Charia Bhanga,607,962,304,468,303,494,38.7,39.4,38.0,00000
22.0,56.0,83.0,658,07,01,  Andhakali,581,954,263,468,318,486,37.9,36.0,39.6,00000
22.0,56.0,83.0,658,08,01,  Alakdia,138,246,74,121,64,125,35.9,37.9,33.9,00000
22.0,56.0,83.0,658,09,01,  Purba Mehernama,646,1167,336,600,310,567,35.6,35.9,35.3,00000
22.0,56.0,83.0,765,01,03,  Purba Goakhali,594,762,310,359,284,403,43.8,46.3,41.3,00000
22.0,56.0,83.0,765,02,03,  Siradia (Para),276,785,134,387,142,398,26.0,25.7,26.3,00000
22.0,56.0,83.0,765,03,03,  Battali Para,459,696,235,357,224,339,39.7,39.7,39.8,00000
22.0,56.0,83.0,765,04,03,  B.Chowkidar Para,216,345,96,164,120,181,38.5,36.9,39.9,00000
22.0,56.0,83.0,765,05,03,  Mitha Bepari Para,340,315,172,157,168,158,51.9,52.3,51.5,00000
22.0,56.0,83.0,765,06,03,  Matbar Para,353,633,168,302,185,331,35.8,35.7,35.9,00000
22.0,56.0,83.0,765,07,03,  Boaliaghona,384,509,208,254,176,255,43.0,45.0,40.8,00000
22.0,56.0,83.0,765,08,03,  Purba Bamakhali,512,532,259,280,253,252,49.0,48.1,50.1,00000
22.0,56.0,83.0,765,09,03,  Jaliakhali,284,496,156,234,128,262,36.4,40.0,32.8,00000
22.0,56.0,83.0,765,10,03,  Mogkata,205,680,97,343,108,337,23.2,22.0,24.3,00000
22.0,56.0,83.0,765,11,03,  Miah Para,709,483,375,249,334,234,59.5,60.1,58.8,00000
22.0,56.0,83.0,765,12,03,  Paschim Bamakhali,546,1078,264,520,282,558,33.6,33.7,33.6,00000
22.0,56.0,83.0,765,13,03,  Sikdar Para,503,280,259,133,244,147,64.2,66.1,62.4,00000
22.0,56.0,83.0,765,14,03,  Harina Para,474,480,236,245,238,235,49.7,49.1,50.3,00000
22.0,56.0,83.0,765,15,03,  Sutag Beparipara,230,268,101,123,129,145,46.2,45.1,47.1,00000
22.0,56.0,83.0,765,16,03,  Moulvi Para,94,247,52,123,42,124,27.6,29.7,25.3,00000
22.0,56.0,83.0,765,17,03,  Sakhar Khilghona,945,1065,495,601,450,464,47.0,45.2,49.2,00000
22.0,56.0,83.0,765,18,03,  Sarkari Ghona,373,867,168,420,205,447,30.1,28.6,31.4,00000
22.0,56.0,83.0,765,19,03,  Sabekgundi,530,1086,240,522,290,564,32.8,31.5,34.0,00000
22.0,56.0,83.0,765,20,03,  Anwar Ali Matbar Para,699,971,337,471,362,500,41.9,41.7,42.0,00000
22.0,56.0,83.0,765,21,03,  Bilhasura,32,346,20,172,12,174,8.5,10.4,6.5,00000
22.0,56.0,83.0,765,22,03,  Bangla Para,51,326,22,178,29,148,13.5,11.0,16.4,00000
22.0,56.0,83.0,765,23,03,  Tekpara,234,494,109,258,125,236,32.1,29.7,34.6,00000
22.0,56.0,83.0,765,24,03,  Maiadia,97,542,51,269,46,273,15.2,15.9,14.4,00000
22.0,56.0,89.0,826,01,01,  Miah Para,695,466,391,223,304,243,59.9,63.7,55.6,00000
22.0,56.0,89.0,826,02,01,  Hajir Para,265,340,149,184,116,156,43.8,44.7,42.6,00000
22.0,56.0,89.0,826,03,01,  Matbar Para,626,1249,296,650,330,599,33.4,31.3,35.5,00000
22.0,56.0,89.0,826,04,01,  Chaklader Para,182,234,94,112,88,122,43.8,45.6,41.9,00000
22.0,56.0,89.0,826,05,01,  Diljan Para,133,91,60,48,73,43,59.4,55.6,62.9,00000
22.0,56.0,89.0,826,06,01,  Sundari Para,886,1358,447,667,439,691,39.5,40.1,38.8,00000
22.0,56.0,89.0,826,07,01,  Sikdar Para,240,691,107,366,133,325,25.8,22.6,29.0,00000
22.0,56.0,89.0,826,08,01,  Roy Baper Para,572,619,299,324,273,295,48.0,48.0,48.1,00000
22.0,56.0,89.0,826,09,01,  Laljan Para,305,441,148,234,157,207,40.9,38.7,43.1,00000
22.0,56.0,89.0,826,10,01,  Rabbat Ali Para,291,386,147,192,144,194,43.0,43.4,42.6,00000
22.0,56.0,89.0,826,11,01,  Bamula Para,624,781,328,360,296,421,44.4,47.7,41.3,00000
22.0,56.0,89.0,826,12,01,  Palakata,508,416,257,203,251,213,55.0,55.9,54.1,00000
22.0,56.0,89.0,826,13,01,  Amila Para,273,318,138,157,135,161,46.2,46.8,45.6,00000
22.0,56.0,89.0,826,14,01,  Moulvi Para,196,342,108,175,88,167,36.4,38.2,34.5,00000
22.0,56.0,89.0,826,15,01,  Kanchan Para,106,177,64,83,42,94,37.5,43.5,30.9,00000
22.0,56.0,89.0,826,16,01,  Dasherghona,290,380,143,188,147,192,43.3,43.2,43.4,00000
22.0,56.0,89.0,826,17,01,  Naya Para,186,1127,76,551,110,576,14.2,12.1,16.0,00000
22.0,56.0,89.0,826,18,01,  Badiuddin Para,488,1239,247,644,241,595,28.3,27.7,28.8,00000
22.0,56.0,89.0,826,19,01,  Majhir Para,185,309,95,137,90,172,37.4,40.9,34.4,00000
22.0,56.0,89.0,826,20,01,  Bakshiaghona,347,1322,193,653,154,669,20.8,22.8,18.7,00000
22.0,56.0,89.0,826,21,01,  Thekhghona,274,435,126,201,148,234,38.6,38.5,38.7,00000
22.0,56.0,93.0,076,01,01,  Kachari Mura,1294,979,645,470,649,509,56.9,57.8,56.0,00000
22.0,56.0,93.0,076,02,01,  Purba Barba Khali,269,692,108,328,161,364,28.0,24.8,30.7,00000
22.0,56.0,93.0,918,01,01,  Purba Shilkhali,1732,2321,926,1128,806,1193,42.7,45.1,40.3,00000
22.0,56.0,93.0,918,02,01,  Paschim Shilkhali,374,725,183,344,191,381,34.0,34.7,33.4,00000
22.0,56.0,93.0,918,03,01,  Hajirghona,526,375,258,197,268,178,58.4,56.7,60.1,00000
22.0,56.0,93.0,918,04,01,  Munshimura,930,416,472,182,458,234,69.1,72.2,66.2,00000
22.0,56.0,93.0,918,05,01,  Jarul Bania,1342,923,726,411,616,512,59.2,63.9,54.6,00000
22.0,56.0,96.0,122,01,01,  Battali,487,2361,261,1125,226,1236,17.1,18.8,15.5,00000
22.0,56.0,96.0,122,02,01,  Malgara,79,499,43,244,36,255,13.7,15.0,12.4,00000
22.0,56.0,96.0,122,03,01,  Jumpara,89,383,48,188,41,195,18.9,20.3,17.4,00000
22.0,56.0,96.0,933,01,01,  Sonaichhari,1209,1793,669,938,540,855,40.3,41.6,38.7,00000
22.0,56.0,96.0,933,02,01,  Hirabania,818,1343,455,655,363,688,37.9,41.0,34.5,00000
22.0,56.0,96.0,933,03,01,  Dhoniakata,438,918,239,476,199,442,32.3,33.4,31.0,00000
22.0,56.0,96.0,933,04,01,  Miazirghona,477,778,280,446,197,332,38.0,38.6,37.2,00000
22.0,56.0,96.0,964,01,01,  Purba Taitong,555,3006,279,1456,276,1550,15.6,16.1,15.1,00000
22.0,56.0,96.0,964,02,01,  Paschim Taitong,569,709,274,318,295,391,44.5,46.3,43.0,00000
22.0,56.0,96.0,964,03,01,  Napitkhali,658,1442,324,703,334,739,31.3,31.5,31.1,00000
22.0,56.0,96.0,964,04,01,  Godhakata,318,1283,154,613,164,670,19.9,20.1,19.7,00000
22.0,56.0,96.0,964,05,01,  Jaliar Char,293,480,155,223,138,257,37.9,41.0,34.9,00000
22.0,56.0,96.0,964,06,01,  Madhukhali,127,771,65,369,62,402,14.1,15.0,13.4,00000
22.0,56.0,96.0,964,07,01,  Soniakata,314,1077,164,562,150,515,22.6,22.6,22.6,00000
22.0,66.0,15.0,229,01,03,  Dakshin Dwip,581,570,308,269,273,301,50.5,53.4,47.6,00000
22.0,66.0,15.0,229,02,03,  Purba Dwip,208,262,103,115,105,147,44.3,47.2,41.7,00000
22.0,66.0,15.0,229,03,03,  Officer Char (Sikder Para),1398,1096,784,522,614,574,56.1,60.0,51.7,00000
22.0,66.0,15.0,229,04,03,  Lambari Para,1019,824,534,405,485,419,55.3,56.9,53.7,00000
22.0,66.0,15.0,229,05,03,  Hajarikul (Sipahir Para),884,469,503,212,381,257,65.3,70.3,59.7,00000
22.0,66.0,15.0,229,06,03,  Mondal Para,1881,866,999,380,882,486,68.5,72.4,64.5,00000
22.0,66.0,15.0,229,07,03,  Uttar Fatekharkul,1423,3004,759,1571,664,1433,32.1,32.6,31.7,00000
22.0,66.0,15.0,714,01,03,  Purba Merangloa,1307,1384,653,671,654,713,48.6,49.3,47.8,00000
22.0,66.0,15.0,714,02,03,  Madhya Merangloa,1852,1251,1015,556,837,695,59.7,64.6,54.6,00000
22.0,66.0,15.0,714,03,03,  Paschim Merangloa,1201,1332,623,690,578,642,47.4,47.4,47.4,00000
22.0,66.0,19.0,255,01,01,  Barabil,875,1551,452,758,423,793,36.1,37.4,34.8,00000
22.0,66.0,19.0,255,02,01,  Thongerkata,690,1108,346,548,344,560,38.4,38.7,38.1,00000
22.0,66.0,19.0,255,03,01,  Thimchhari,452,859,227,428,225,431,34.5,34.7,34.3,00000
22.0,66.0,19.0,255,04,01,  Jumchhari,419,1157,204,544,215,613,26.6,27.3,26.0,00000
22.0,66.0,19.0,255,05,01,  Juish Para,197,1323,96,660,101,663,13.0,12.7,13.2,00000
22.0,66.0,19.0,255,06,01,  Miajir Kata,604,1432,271,730,333,702,29.7,27.1,32.2,00000
22.0,66.0,19.0,255,07,01,  Boangerkhil,1894,2316,905,1160,989,1156,45.0,43.8,46.1,00000
22.0,66.0,19.0,255,08,01,  Kajorbil,227,497,111,230,116,267,31.4,32.6,30.3,00000
22.0,66.0,19.0,459,01,01,  Paschim Barabill,127,606,68,285,59,321,17.3,19.3,15.5,00000
22.0,66.0,19.0,459,02,01,  Paschim Jumchhari,147,281,72,149,75,132,34.3,32.6,36.2,00000
22.0,66.0,19.0,459,03,01,  Uttar Kajorbil,43,247,16,136,27,111,14.8,10.5,19.6,00000
22.0,66.0,19.0,790,01,01,  Paschim Garjania,45,217,15,111,30,106,17.2,11.9,22.1,00000
22.0,66.0,19.0,790,02,01,  Chowdhury Khamar,52,145,25,60,27,85,26.4,29.4,24.1,00000
22.0,66.0,28.0,331,01,01,  Sikdar Para,768,1462,394,680,374,782,34.4,36.7,32.4,00000
22.0,66.0,28.0,331,02,01,  Hasnakata,1105,2430,545,1204,560,1226,31.3,31.2,31.4,00000
22.0,66.0,28.0,331,03,01,  Idgar,940,974,500,469,440,505,49.1,51.6,46.6,00000
22.0,66.0,28.0,331,04,01,  Barabil,412,1285,200,635,212,650,24.3,24.0,24.6,00000
22.0,66.0,28.0,331,05,01,  Kodaliakata,533,1137,274,541,259,596,31.9,33.6,30.3,00000
22.0,66.0,28.0,331,06,01,  Panossyaghona,758,1176,384,581,374,595,39.2,39.8,38.6,00000
22.0,66.0,47.0,076,01,01,  Fakrikata+B.D.R Camp,939,907,539,471,400,436,50.9,53.4,47.8,00000
22.0,66.0,47.0,076,02,01,  Moulvirkata,600,1328,315,679,285,649,31.1,31.7,30.5,00000
22.0,66.0,47.0,076,03,01,  Chhota Hajir Para Jungchhari,1053,1512,545,740,508,772,41.1,42.4,39.7,00000
22.0,66.0,47.0,076,04,01,  Bara Jungchhari,805,1738,399,879,406,859,31.7,31.2,32.1,00000
22.0,66.0,47.0,076,05,01,  Shahairgarchar,317,938,148,480,169,458,25.3,23.6,27.0,00000
22.0,66.0,47.0,076,06,01,  Balo Bashar Dakterkata,158,587,78,297,80,290,21.2,20.8,21.6,00000
22.0,66.0,47.0,561,01,01,  Kachhapia Gillatoly,381,1625,190,809,191,816,19.0,19.0,19.0,00000
22.0,66.0,47.0,561,02,01,  Titar Para,822,1821,400,913,422,908,31.1,30.5,31.7,00000
22.0,66.0,47.0,561,03,01,  Douchhari,526,1212,252,600,274,612,30.3,29.6,30.9,00000
22.0,66.0,47.0,561,04,01,  Chhota Sukhmunia Jungchhara,475,946,230,483,245,463,33.4,32.3,34.6,00000
22.0,66.0,47.0,561,05,01,  Jumchharigram,435,777,203,388,232,389,35.9,34.3,37.4,00000
22.0,66.0,47.0,561,06,01,  Sukmunia,422,1122,217,556,205,566,27.3,28.1,26.6,00000
22.0,66.0,47.0,561,07,01,  Balobasha (Part),273,202,146,89,127,113,57.5,62.1,52.9,00000
22.0,66.0,76.0,841,01,01,  Rajarkul Nasirkul,1030,2288,501,1152,529,1136,31.0,30.3,31.8,00000
22.0,66.0,76.0,841,02,01,  Madhyam Rajarkul,1762,4008,885,1992,877,2016,30.5,30.8,30.3,00000
22.0,66.0,76.0,841,03,01,  Purba Rajarkul,2035,1698,1383,790,652,908,54.5,63.6,41.8,00000
22.0,66.0,76.0,841,04,01,  Paschim Rajarkul,1286,2431,663,1164,623,1267,34.6,36.3,33.0,00000
22.0,66.0,85.0,025,01,01,  Char Para,216,474,101,242,115,232,31.3,29.4,33.1,00000
22.0,66.0,85.0,025,02,01,  Umruchar,218,183,112,90,106,93,54.4,55.4,53.3,00000
22.0,66.0,85.0,025,03,01,  Chhader Para,241,219,122,98,119,121,52.4,55.5,49.6,00000
22.0,66.0,85.0,025,04,01,  Khaim Mairghona,712,996,367,501,345,495,41.7,42.3,41.1,00000
22.0,66.0,85.0,025,05,01,  Khondakar Para,442,825,218,428,224,397,34.9,33.7,36.1,00000
22.0,66.0,85.0,025,06,01,  Arekul (Charerkul),138,276,70,138,68,138,33.3,33.7,33.0,00000
22.0,66.0,85.0,025,07,01,  Ghonar Para,167,447,89,210,78,237,27.2,29.8,24.8,00000
22.0,66.0,85.0,102,01,01,  Ghaitang Para,148,225,73,115,75,110,39.7,38.8,40.5,00000
22.0,66.0,85.0,102,02,01,  Char Para,69,377,23,196,46,181,15.5,10.5,20.3,00000
22.0,66.0,85.0,102,03,01,  Sikdar Para,141,365,61,184,80,181,27.9,24.9,30.7,00000
22.0,66.0,85.0,102,04,01,  Charerkul,411,938,216,477,195,461,30.5,31.2,29.7,00000
22.0,66.0,85.0,102,05,01,  Kala Khondhakar Para,168,441,93,222,75,219,27.6,29.5,25.5,00000
22.0,66.0,85.0,102,06,01,  Tetoia Para,211,253,103,124,108,129,45.5,45.4,45.6,00000
22.0,66.0,85.0,102,07,01,  Barua Para,210,431,100,229,110,202,32.8,30.4,35.3,00000
22.0,66.0,85.0,102,08,01,  Mogpara,148,269,71,132,77,137,35.5,35.0,36.0,00000
22.0,66.0,85.0,102,09,01,  Panerchhara,496,1228,270,618,226,610,28.8,30.4,27.0,00000
22.0,66.0,85.0,102,10,01,  Bali Para,106,417,52,220,54,197,20.3,19.1,21.5,00000
22.0,66.0,85.0,102,11,01,  Dakshin Mithachhari,258,310,135,164,123,146,45.4,45.2,45.7,00000
22.0,66.0,85.0,102,12,01,  Fakirmura,215,625,100,316,115,309,25.6,24.0,27.1,00000
22.0,66.0,85.0,102,13,01,  Samitir Para,229,418,107,230,122,188,35.4,31.8,39.4,00000
22.0,66.0,85.0,969,01,01,  Paschim Umkhali,499,793,267,427,232,366,38.6,38.5,38.8,00000
22.0,66.0,85.0,969,02,01,  Kazipara,419,450,190,222,229,228,48.2,46.1,50.1,00000
22.0,66.0,85.0,969,03,01,  Azimuddin Para,188,282,95,145,93,137,40.0,39.6,40.4,00000
22.0,66.0,85.0,969,04,01,  Paschim Dhar Para,271,264,146,149,125,115,50.7,49.5,52.1,00000
22.0,66.0,85.0,969,05,01,  Jhunu Matbarer Para,215,402,103,210,112,192,34.8,32.9,36.8,00000
22.0,66.0,85.0,969,06,01,  Purba Dhar Para,227,139,110,61,117,78,62.0,64.3,60.0,00000
22.0,66.0,85.0,969,07,01,  Matur Baper Para,373,335,186,177,187,158,52.7,51.2,54.2,00000
22.0,66.0,85.0,969,08,01,  Karaliachhara,181,872,77,467,104,405,17.2,14.2,20.4,00000
22.0,66.0,85.0,969,09,01,  Matabaria Para(Abubakar Para),238,169,123,83,115,86,58.5,59.7,57.2,00000
22.0,90.0,15.0,082,01,01,  Hajam Para,389,1295,224,630,165,665,23.1,26.2,19.9,00000
22.0,90.0,15.0,082,02,01,  Mathabhanga,443,928,216,455,227,473,32.3,32.2,32.4,00000
22.0,90.0,15.0,082,03,01,  Bara Dail,175,689,87,331,88,358,20.3,20.8,19.7,00000
22.0,90.0,15.0,082,04,01,  Kachapia,35,536,21,266,14,270,6.1,7.3,4.9,00000
22.0,90.0,15.0,082,05,01,  Noakhali,524,2705,269,1311,255,1394,16.2,17.0,15.5,00000
22.0,90.0,15.0,082,06,01,  Marish Bania,30,90,18,39,12,51,25.0,31.6,19.0,00000
22.0,90.0,15.0,746,01,01,  Uttar Shilkhali,731,2896,386,1444,345,1452,20.2,21.1,19.2,00000
22.0,90.0,15.0,746,02,01,  Shamlapur,1450,3714,797,1748,653,1966,28.1,31.3,24.9,00000
22.0,90.0,15.0,746,03,01,  Jahajpura,645,2123,320,1082,325,1041,23.3,22.8,23.8,00000
22.0,90.0,15.0,746,04,01,  Halbania,112,500,54,235,58,265,18.3,18.7,18.0,00000
22.0,90.0,15.0,746,05,01,  Dakshin Shilkhali,438,1515,241,744,197,771,22.4,24.5,20.4,00000
22.0,90.0,31.0,165,01,01,  Naikhangkhali,921,2245,490,1047,431,1198,29.1,31.9,26.5,00000
22.0,90.0,31.0,165,02,01,  Hoabrang,136,721,76,349,60,372,15.9,17.9,13.9,00000
22.0,90.0,31.0,165,03,01,  Pankhali,924,2019,486,906,438,1113,31.4,34.9,28.2,00000
22.0,90.0,31.0,165,04,01,  Sikdar Para,1758,2854,938,1387,820,1467,38.1,40.3,35.9,00000
22.0,90.0,31.0,165,05,01,  Lechuaprang,170,710,83,350,87,360,19.3,19.2,19.5,00000
22.0,90.0,31.0,165,06,01,  Ulochamari,316,1511,161,715,155,796,17.3,18.4,16.3,00000
22.0,90.0,31.0,165,07,01,  Nhilla Mogpara,196,84,90,33,106,51,70.0,73.2,67.5,00000
22.0,90.0,31.0,165,08,01,  Nhilla Bazar (Bazar Para),312,563,181,286,131,277,35.7,38.8,32.1,00000
22.0,90.0,31.0,165,09,01,  Fullerdail,830,957,419,464,411,493,46.4,47.5,45.5,00000
22.0,90.0,31.0,165,10,01,  Nath Murapara,382,1116,216,542,166,574,25.5,28.5,22.4,00000
22.0,90.0,31.0,165,11,01,  Kona Para,142,341,76,155,66,186,29.4,32.9,26.2,00000
22.0,90.0,31.0,165,12,01,  Chowdhury Para,151,320,86,147,65,173,32.1,36.9,27.3,00000
22.0,90.0,31.0,165,13,01,  Purba Rangikhali,389,987,210,473,179,514,28.3,30.7,25.8,00000
22.0,90.0,31.0,165,14,01,  Paschim Rangikhali,252,1407,105,664,147,743,15.2,13.7,16.5,00000
22.0,90.0,31.0,165,15,01,  Jumma Para,163,535,102,258,61,277,23.4,28.3,18.0,00000
22.0,90.0,31.0,165,16,01,  Alikhali,306,1522,152,721,154,801,16.7,17.4,16.1,00000
22.0,90.0,31.0,165,17,01,  Puchinga Para,320,1534,172,785,148,749,17.3,18.0,16.5,00000
22.0,90.0,31.0,165,18,01,  Leda Para,446,1312,271,712,175,600,25.4,27.6,22.6,00000
22.0,90.0,31.0,165,19,01,  Muchani Para,308,620,166,297,142,323,33.2,35.9,30.5,00000
22.0,90.0,31.0,165,20,01,  Naya Para,311,608,168,295,143,313,33.8,36.3,31.4,00000
22.0,90.0,31.0,165,21,01,  Jadimura,401,1087,234,512,167,575,26.9,31.4,22.5,00000
22.0,90.0,31.0,165,22,01,  Dumdumia,294,410,191,168,103,242,41.8,53.2,29.9,00000
22.0,90.0,31.0,165,23,01,  Huakya Para,217,627,104,321,113,306,25.7,24.5,27.0,00000
22.0,90.0,31.0,280,01,01,  Marichaghona,103,425,46,212,57,213,19.5,17.8,21.1,00000
22.0,90.0,31.0,280,02,01,  Rojarghona,175,587,69,287,106,300,23.0,19.4,26.1,00000
22.0,90.0,31.0,280,03,01,  Ali Akbar Para,587,1234,303,589,284,645,32.2,34.0,30.6,00000
22.0,90.0,39.0,995,01,01,  Purba Para,80,604,54,303,26,301,11.7,15.1,8.0,00000
22.0,90.0,39.0,995,02,01,  Deil Para,41,524,28,262,13,262,7.3,9.7,4.7,00000
22.0,90.0,39.0,995,03,01,  Uttar Para,137,436,91,199,46,237,23.9,31.4,16.3,00000
22.0,90.0,39.0,995,04,01,  Paschim Para,111,326,77,156,34,170,25.4,33.0,16.7,00000
22.0,90.0,39.0,995,05,01,  Zinzira,27,96,16,45,11,51,22.0,26.2,17.7,00000
22.0,90.0,39.0,995,06,01,  Konar Para,303,450,189,201,114,249,40.2,48.5,31.4,00000
22.0,90.0,39.0,995,07,01,  Nazrul Para,59,494,48,236,11,258,10.7,16.9,4.1,00000
22.0,90.0,39.0,995,08,01,  Dakhin Para,82,667,66,325,16,342,10.9,16.9,4.5,00000
22.0,90.0,39.0,995,09,01,  Majer Para,114,580,70,284,44,296,16.4,19.8,12.9,00000
22.0,90.0,47.0,580,01,01,  Baharchhara,94,390,58,187,36,203,19.4,23.7,15.1,00000
22.0,90.0,47.0,580,02,01,  Chanduli Para,260,710,131,360,129,350,26.8,26.7,26.9,00000
22.0,90.0,47.0,580,03,01,  Uttar Nayapara,65,217,42,105,23,112,23.0,28.6,17.0,00000
22.0,90.0,47.0,580,04,01,  Kyurabuja Para,158,700,90,333,68,367,18.4,21.3,15.6,00000
22.0,90.0,47.0,580,05,01,  Fathe Ali Para,37,217,22,104,15,113,14.6,17.5,11.7,00000
22.0,90.0,47.0,580,06,01,  Hariakhali,335,1448,178,708,157,740,18.8,20.1,17.5,00000
22.0,90.0,47.0,580,07,01,  Hadurchhara,75,349,49,161,26,188,17.7,23.3,12.1,00000
22.0,90.0,47.0,580,08,01,  Mundar Dail,487,1596,252,744,235,852,23.4,25.3,21.6,00000
22.0,90.0,47.0,580,09,01,  Mondal Para,442,969,275,463,167,506,31.3,37.3,24.8,00000
22.0,90.0,47.0,580,10,01,  Sikdar Para,337,833,183,400,154,433,28.8,31.4,26.2,00000
22.0,90.0,47.0,580,11,01,  Mogpara,82,221,44,94,38,127,27.1,31.9,23.0,00000
22.0,90.0,47.0,580,12,01,  Panchhari Para,406,709,225,335,181,374,36.4,40.2,32.6,00000
22.0,90.0,47.0,580,13,01,  Benga Para,64,152,39,72,25,80,29.6,35.1,23.8,00000
22.0,90.0,47.0,580,14,01,  Acharbania,264,539,158,247,106,292,32.9,39.0,26.6,00000
22.0,90.0,47.0,580,15,01,  Lezir Para,113,349,73,162,40,187,24.5,31.1,17.6,00000
22.0,90.0,47.0,580,16,01,  Koanchhari Para,218,722,126,310,92,412,23.2,28.9,18.3,00000
22.0,90.0,47.0,580,17,01,  Deguliar Bil,202,538,124,238,78,300,27.3,34.3,20.6,00000
22.0,90.0,47.0,580,18,01,  Dailpara,35,476,22,231,13,245,6.8,8.7,5.0,00000
22.0,90.0,47.0,580,19,01,  Dakshin Nayapara,292,1382,191,677,101,705,17.4,22.0,12.5,00000
22.0,90.0,47.0,580,20,01,  Puran Para,175,1162,105,531,70,631,13.1,16.5,10.0,00000
22.0,90.0,47.0,580,21,01,  Katabania,291,1018,160,496,131,522,22.2,24.4,20.1,00000
22.0,90.0,47.0,580,22,01,  Kachubania,377,1370,210,682,167,688,21.6,23.5,19.5,00000
22.0,90.0,47.0,580,23,01,  Lafarghona,181,871,124,423,57,448,17.2,22.7,11.3,00000
22.0,90.0,47.0,580,24,01,  Zinnah Para,128,457,73,223,55,234,21.9,24.7,19.0,00000
22.0,90.0,47.0,580,25,01,  Pendal Para,136,268,70,121,66,147,33.7,36.6,31.0,00000
22.0,90.0,47.0,580,26,01,  Alirdeil Para,119,943,65,463,54,480,11.2,12.3,10.1,00000
22.0,90.0,47.0,580,27,01,  Kurer Mukh,49,345,28,159,21,186,12.4,15.0,10.1,00000
22.0,90.0,47.0,580,28,01,  Guchha Gram,137,459,79,218,58,241,23.0,26.6,19.4,00000
22.0,90.0,47.0,580,29,01,  Rullher Depa,55,186,32,86,23,100,22.8,27.1,18.7,00000
22.0,90.0,47.0,580,30,01,  Karachi Para,127,187,74,83,53,104,40.4,47.1,33.8,00000
22.0,90.0,47.0,580,31,01,  Khairtipara,94,230,54,111,40,119,29.0,32.7,25.2,00000
22.0,90.0,47.0,663,01,01,  Mistry Para,214,1871,128,870,86,1001,10.3,12.8,7.9,00000
22.0,90.0,47.0,663,02,01,  Purba Uttar Para,222,751,123,353,99,398,22.8,25.8,19.9,00000
22.0,90.0,47.0,663,03,01,  Golapara,20,432,17,226,3,206,4.4,7.0,1.4,00000
22.0,90.0,47.0,663,04,01,  Dakshinpara,159,2001,104,950,55,1051,7.4,9.9,5.0,00000
22.0,90.0,47.0,663,05,01,  Hajir Para,47,506,33,208,14,298,8.5,13.7,4.5,00000
22.0,90.0,47.0,663,06,01,  Paschim Uttar Para,202,1273,137,597,65,676,13.7,18.7,8.8,00000
22.0,90.0,47.0,663,07,01,  Bazar Para,326,1290,201,584,125,706,20.2,25.6,15.0,00000
22.0,90.0,47.0,663,08,01,  Kona Para,46,1008,23,494,23,514,4.4,4.4,4.3,00000
22.0,90.0,47.0,663,09,01,  Paschim Para,12,751,9,349,3,402,1.6,2.5,0.7,00000
22.0,90.0,47.0,663,10,01,  Majher Para,82,1809,47,845,35,964,4.3,5.3,3.5,00000
22.0,90.0,47.0,663,11,01,  Jalia Para,80,1435,60,683,20,752,5.3,8.1,2.6,00000
22.0,90.0,47.0,663,12,01,  Kampu Para,90,1040,68,499,22,541,8.0,12.0,3.9,00000
22.0,90.0,47.0,663,13,01,  Majer Dail,92,713,47,321,45,392,11.4,12.8,10.3,00000
22.0,90.0,47.0,663,14,01,  Dangor Para,86,1262,51,645,35,617,6.4,7.3,5.4,00000
22.0,90.0,47.0,663,15,01,  Dail Para,92,750,60,387,32,363,10.9,13.4,8.1,00000
22.0,90.0,47.0,663,16,01,  Karachi Para,73,443,51,206,22,237,14.1,19.8,8.5,00000
22.0,90.0,47.0,663,17,01,  Jalia Gota,30,596,19,286,11,310,4.8,6.2,3.4,00000
22.0,90.0,63.0,248,01,01,  Razarchhara,456,1496,228,721,228,775,23.4,24.0,22.7,00000
22.0,90.0,63.0,248,02,01,  Habibchhara,280,1200,137,588,143,612,18.9,18.9,18.9,00000
22.0,90.0,63.0,248,03,01,  Mitta Panirchhara,233,484,111,241,122,243,32.5,31.5,33.4,00000
22.0,90.0,63.0,248,04,01,  Dargachhara,275,269,124,119,151,150,50.6,51.0,50.2,00000
22.0,90.0,63.0,248,05,01,  Tulatali,209,307,115,147,94,160,40.5,43.9,37.0,00000
22.0,90.0,63.0,248,06,01,  Lambori,577,1423,330,687,247,736,28.9,32.4,25.1,00000
22.0,90.0,63.0,248,07,01,  Hatiarghona,254,822,124,419,130,403,23.6,22.8,24.4,00000
22.0,90.0,63.0,248,08,01,  Lengurbil,808,1278,455,627,353,651,38.7,42.1,35.2,00000
22.0,90.0,63.0,248,09,01,  Jahalia Para,170,843,97,412,73,431,16.8,19.1,14.5,00000
22.0,90.0,63.0,414,01,01,  Teknaf R.F.,724,1952,342,965,382,987,27.1,26.2,27.9,00000
22.0,90.0,63.0,414,02,01,  Natun Para,112,302,68,143,44,159,27.1,32.2,21.7,00000
22.0,90.0,63.0,414,03,01,  Kerantali,87,560,41,288,46,272,13.4,12.5,14.5,00000
22.0,90.0,63.0,414,04,01,  Baraitali,56,483,30,247,26,236,10.4,10.8,9.9,00000
22.0,90.0,63.0,414,05,01,  Gomtali,213,580,128,282,85,298,26.9,31.2,22.2,00000
22.0,90.0,63.0,829,01,03,  Natun Pallan Para,1333,1469,789,665,544,804,47.6,54.3,40.4,00000
22.0,90.0,63.0,829,02,03,  Shilbania Para(Part),349,753,200,349,149,404,31.7,36.4,26.9,00000
22.0,90.0,63.0,829,03,03,  Goder Bil,845,2806,455,1282,390,1524,23.1,26.2,20.4,00000
22.0,90.0,63.0,829,04,03,  Dail Para (Part),1167,1277,669,558,498,719,47.7,54.5,40.9,00000
22.0,90.0,63.0,829,05,03,  Mohish Khalia Para,1197,1620,655,768,542,852,42.5,46.0,38.9,00000
22.0,90.0,63.0,829,06,03,  Khonkar Para,181,841,127,419,54,422,17.7,23.3,11.3,00000
22.0,90.0,63.0,829,07,03,  Kachubunia,167,848,100,391,67,457,16.5,20.4,12.8,00000
22.0,90.0,63.0,829,08,03,  Hankar Para (Part),135,187,79,89,56,98,41.9,47.0,36.4,00000
22.0,90.0,63.0,829,09,03,  Moulvi Para,363,755,203,348,160,407,32.5,36.8,28.2,00000
22.0,90.0,63.0,829,10,03,  Nazir Para,586,843,324,404,262,439,41.0,44.5,37.4,00000
22.0,90.0,63.0,829,11,03,  Chhota Habib Para,419,1213,260,588,159,625,25.7,30.7,20.3,00000
22.0,90.0,63.0,829,12,03,  Bara Habib Para,329,749,190,365,139,384,30.5,34.2,26.6,00000
22.0,90.0,63.0,829,13,03,  Hajam Para,154,456,87,214,67,242,25.2,28.9,21.7,00000
22.0,90.0,79.0,331,01,01,  Unsiprang,363,691,178,338,185,353,34.4,34.5,34.4,00000
22.0,90.0,79.0,331,02,01,  Kutubdia Para,332,730,144,367,188,363,31.3,28.2,34.1,00000
22.0,90.0,79.0,331,03,01,  Karachi Para,98,182,47,98,51,84,35.0,32.4,37.8,00000
22.0,90.0,79.0,331,04,01,  Naya Para,521,1421,231,652,290,769,26.8,26.2,27.4,00000
22.0,90.0,79.0,331,05,01,  Jimangkhali,1046,2847,539,1360,507,1487,26.9,28.4,25.4,00000
22.0,90.0,79.0,331,06,01,  Satgharia Para,846,2453,457,1185,389,1268,25.6,27.8,23.5,00000
22.0,90.0,79.0,331,07,01,  Mahishakhalia Para,900,2339,446,1100,454,1239,27.8,28.8,26.8,00000
22.0,90.0,79.0,331,08,01,  Rojarghona,68,245,32,124,36,121,21.7,20.5,22.9,00000
22.0,90.0,79.0,331,09,01,  Nasor Para,255,770,149,363,106,407,24.9,29.1,20.7,00000
22.0,90.0,79.0,331,10,01,  Kharang Khali,114,163,59,70,55,93,41.2,45.7,37.2,00000
22.0,90.0,79.0,331,11,01,  Komkania Para,148,759,87,358,61,401,16.3,19.6,13.2,00000
22.0,90.0,79.0,331,12,01,  Kanjer Para,1282,3022,653,1514,629,1508,29.8,30.1,29.4,00000
22.0,90.0,79.0,912,01,01,  Keruntali,362,736,167,359,195,377,33.0,31.7,34.1,00000
22.0,90.0,79.0,912,02,01,  Ghilatali,235,567,120,274,115,293,29.3,30.5,28.2,00000
22.0,90.0,79.0,912,03,01,  Katakhali,657,2080,390,994,267,1086,24.0,28.2,19.7,00000
22.0,90.0,79.0,912,04,01,  Balukhali,382,1413,187,732,195,681,21.3,20.3,22.3,00000
22.0,90.0,79.0,912,05,01,  Uhulubania,503,517,268,236,235,281,49.3,53.2,45.5,00000
22.0,90.0,79.0,912,06,01,  Daingakara,445,879,235,482,210,397,33.6,32.8,34.6,00000
22.0,90.0,79.0,912,07,01,  Harikhola,55,413,40,174,15,239,11.8,18.7,5.9,00000
22.0,90.0,79.0,912,08,01,  Laturikhola,146,441,68,214,78,227,24.9,24.1,25.6,00000
22.0,90.0,79.0,912,09,01,  Whykong,855,1079,455,520,400,559,44.2,46.7,41.7,00000
22.0,90.0,79.0,912,10,01,  Lambabil,857,2101,454,1029,403,1072,29.0,30.6,27.3,00000
22.0,90.0,79.0,912,11,01,  Amtali,268,646,165,291,103,355,29.3,36.2,22.5,00000
22.0,90.0,79.0,912,12,01,  Raikong,171,1256,88,644,83,612,12.0,12.0,11.9,00000
22.0,90.0,79.0,912,13,01,  Lambaghona,17,408,11,194,6,214,4.0,5.4,2.7,00000
22.0,94.0,15.0,076,01,01,  Haldia Palong,838,1772,433,830,405,942,32.1,34.3,30.1,00000
22.0,94.0,15.0,076,02,01,  Paschim Haldia,891,2274,456,1119,435,1155,28.2,29.0,27.4,00000
22.0,94.0,15.0,076,03,01,  Hkewuachhari,877,2145,453,1021,424,1124,29.0,30.7,27.4,00000
22.0,94.0,15.0,382,01,01,  Paglir Bil,896,2032,437,973,459,1059,30.6,31.0,30.2,00000
22.0,94.0,15.0,382,02,01,  Uttar Bara Bil,713,2996,381,1479,332,1517,19.2,20.5,18.0,00000
22.0,94.0,15.0,382,03,01,  Patabari,696,1813,376,870,320,943,27.7,30.2,25.3,00000
22.0,94.0,15.0,765,01,01,  Rumkha Palong,1600,2460,876,1180,724,1280,39.4,42.6,36.1,00000
22.0,94.0,15.0,765,02,01,  Mahajan Para,963,2173,467,1082,496,1091,30.7,30.1,31.3,00000
22.0,94.0,15.0,765,03,01,  Sabek Rumkha,1228,1399,639,666,589,733,46.7,49.0,44.6,00000
22.0,94.0,15.0,765,04,01,  Rumkha Bara Bil,1566,2209,771,1100,795,1109,41.5,41.2,41.8,00000
22.0,94.0,31.0,153,01,01,  Inani,1405,3022,755,1486,650,1536,31.7,33.7,29.7,00000
22.0,94.0,31.0,153,02,01,  Nidania,1390,2110,863,1022,527,1088,39.7,45.8,32.6,00000
22.0,94.0,31.0,153,03,01,  Mohd.Shafrir Bil,817,1790,488,856,329,934,31.3,36.3,26.0,00000
22.0,94.0,31.0,153,04,01,  Imamer Dail,552,2275,346,1124,206,1151,19.5,23.5,15.2,00000
22.0,94.0,31.0,153,05,01,  Mankhali,1558,4944,820,2360,738,2584,24.0,25.8,22.2,00000
22.0,94.0,31.0,229,01,01,  Jalia Palong (Sonychari),1729,2849,896,1389,833,1460,37.8,39.2,36.3,00000
22.0,94.0,31.0,229,02,01,  Pannyasia,1846,3163,967,1565,879,1598,36.9,38.2,35.5,00000
22.0,94.0,31.0,229,03,01,  Sonar Para,2374,3134,1527,1547,847,1587,43.1,49.7,34.8,00000
22.0,94.0,31.0,229,04,01,  Uttar Nidania,845,1453,504,729,341,724,36.8,40.9,32.0,00000
22.0,94.0,47.0,535,01,01,  Tutur Bil,1270,2897,647,1430,623,1467,30.5,31.2,29.8,00000
22.0,94.0,47.0,535,02,01,  Khairati,1439,4108,732,2029,707,2079,25.9,26.5,25.4,00000
22.0,94.0,47.0,535,03,01,  Madhya Raja Palong,898,1012,493,499,405,513,47.0,49.7,44.1,00000
22.0,94.0,47.0,535,04,01,  Dakshin Pukuria,553,550,314,280,239,270,50.1,52.9,47.0,00000
22.0,94.0,47.0,535,05,01,  Uttar Pukuria,1033,1802,535,903,498,899,36.4,37.2,35.6,00000
22.0,94.0,47.0,841,01,03,  Haji Para,1501,1615,795,779,706,836,48.2,50.5,45.8,00000
22.0,94.0,47.0,841,02,03,  Sikdar Bil,2413,3511,1265,1754,1148,1757,40.7,41.9,39.5,00000
22.0,94.0,47.0,841,03,03,  Gilatali,998,525,550,237,448,288,65.5,69.9,60.9,00000
22.0,94.0,47.0,841,04,03,  Falia Para,1871,3518,987,1775,884,1743,34.7,35.7,33.7,00000
22.0,94.0,47.0,841,05,03,  Purba Dighalia,704,968,339,488,365,480,42.1,41.0,43.2,00000
22.0,94.0,47.0,841,06,03,  Madhya Paschim Dighalia,783,1031,399,491,384,540,43.2,44.8,41.6,00000
22.0,94.0,47.0,841,07,03,  Dail Para,757,2082,367,1015,390,1067,26.7,26.6,26.8,00000
22.0,94.0,47.0,918,01,01,  Dargah Bil,829,1674,410,779,419,895,33.1,34.5,31.9,00000
22.0,94.0,47.0,918,02,01,  Lambaghona,486,1217,237,621,249,596,28.5,27.6,29.5,00000
22.0,94.0,47.0,918,03,01,  Kutu Palong,1420,2516,688,1231,732,1285,36.1,35.9,36.3,00000
22.0,94.0,63.0,612,01,01,  Ratna Palong,4597,2922,2396,1337,2201,1585,61.1,64.2,58.1,00000
22.0,94.0,63.0,612,02,01,  Chakbaita,1038,1717,515,818,523,899,37.7,38.6,36.8,00000
22.0,94.0,63.0,612,03,01,  Bhalukia,2479,3571,1254,1704,1225,1867,41.0,42.4,39.6,00000
22.0,94.0,63.0,612,04,01,  Goyalmara,717,1009,366,495,351,514,41.5,42.5,40.6,00000
22.0,94.0,63.0,612,05,01,  Karaibunia,126,410,59,208,67,202,23.5,22.1,24.9,00000
22.0,94.0,79.0,459,01,01,  Palong Khali,1070,2078,516,1048,554,1030,34.0,33.0,35.0,00000
22.0,94.0,79.0,459,02,01,  Nalbania,366,1189,168,579,198,610,23.5,22.5,24.5,00000
22.0,94.0,79.0,459,03,01,  Paschim Farir Bil,642,1401,341,687,301,714,31.4,33.2,29.7,00000
22.0,94.0,79.0,459,04,01,  Purba Farir Bil,1084,1134,556,587,528,547,48.9,48.6,49.1,00000
22.0,94.0,79.0,459,05,01,  Anjuman,490,1043,250,496,240,547,32.0,33.5,30.5,00000
22.0,94.0,79.0,459,06,01,  Rahmater Bil,626,1320,323,628,303,692,32.2,34.0,30.5,00000
22.0,94.0,79.0,459,07,01,  Thaingkhali,1349,2589,672,1304,677,1285,34.3,34.0,34.5,00000
22.0,94.0,79.0,459,08,01,  Tej Nimarkhola,274,1095,129,567,145,528,20.0,18.5,21.5,00000
22.0,94.0,79.0,459,09,01,  Dhamankhali,414,302,243,128,171,174,57.8,65.5,49.6,00000
22.0,94.0,79.0,688,01,01,  Mocharkhola,155,515,62,268,93,247,23.1,18.8,27.4,00000
22.0,94.0,79.0,688,02,01,  Telkhola,236,2424,151,1206,85,1218,8.9,11.1,6.5,00000
22.0,94.0,79.0,994,01,01,  Ukhiarghat,336,180,190,91,146,89,65.1,67.6,62.1,00000
22.0,94.0,79.0,994,02,01,  Paschim Balukhali,676,697,351,323,325,374,49.2,52.1,46.5,00000
22.0,94.0,79.0,994,03,01,  Purba Balukhali,1111,974,552,471,559,503,53.3,54.0,52.6,00000
15.0,4.0,19.0,053,01,01,  Dakshin Bandar,1390,1400,829,635,561,765,49.8,56.6,42.3,00000
15.0,4.0,19.0,053,02,01,  Uttar Bandar,3223,2086,1786,959,1437,1127,60.7,65.1,56.0,00000
42.0,15.0,6.0,002,998,02,Cantonment (Part),687,21,537,8,150,13,97.0,98.5,92.0,00000
15.0,8.0,12.0,207,01,01,  Chechuria,2588,2222,1271,1067,1317,1155,53.8,54.4,53.3,00000
15.0,8.0,12.0,207,02,01,  Ghana Para,425,1036,196,496,229,540,29.1,28.3,29.8,00000
15.0,8.0,50.0,027,01,01,  Addarkhil,214,668,109,285,105,383,24.3,27.7,21.5,00000
15.0,8.0,50.0,027,02,01,  Hajir Para,335,589,150,260,185,329,36.3,36.6,36.0,00000
15.0,8.0,50.0,027,03,01,  Mundiri Para,254,374,111,175,143,199,40.4,38.8,41.8,00000
15.0,8.0,50.0,027,04,01,  Pukchailla Para,151,403,56,166,95,237,27.3,25.2,28.6,00000
15.0,8.0,50.0,027,05,01,  Baghmara,477,980,197,405,280,575,32.7,32.7,32.7,00000
15.0,8.0,50.0,110,01,01,  Talukdar Para,374,638,189,280,185,358,37.0,40.3,34.1,00000
15.0,8.0,50.0,110,02,01,  Haijjar Para,321,702,154,346,167,356,31.4,30.8,31.9,00000
15.0,8.0,50.0,331,01,01,  Purba Jeleypara,99,328,51,138,48,190,23.2,27.0,20.2,00000
15.0,8.0,50.0,331,02,01,  Paschim Muslimpara,106,443,54,188,52,255,19.3,22.3,16.9,00000
15.0,8.0,50.0,566,01,01,  Bimajir Para,142,318,54,149,88,169,30.9,26.6,34.2,00000
15.0,8.0,50.0,566,02,01,  Khalifa Para,311,489,152,204,159,285,38.9,42.7,35.8,00000
15.0,8.0,50.0,566,03,01,  Goajar Para,427,476,204,218,223,258,47.3,48.3,46.4,00000
15.0,8.0,50.0,566,04,01,  Ghona Para,314,739,163,369,151,370,29.8,30.6,29.0,00000
15.0,8.0,50.0,566,05,01,  Katharia,641,856,328,394,313,462,42.8,45.4,40.4,00000
15.0,8.0,50.0,566,06,01,  Dhila Para,410,1659,195,774,215,885,19.8,20.1,19.5,00000
15.0,8.0,50.0,704,01,01,  Goljani Para,142,341,47,143,95,198,29.4,24.7,32.4,00000
15.0,8.0,50.0,704,02,01,  Madhya Manik Pathan,103,402,49,200,54,202,20.4,19.7,21.1,00000
15.0,8.0,50.0,704,03,01,  Mohammad Amirpara,292,411,134,185,158,226,41.5,42.0,41.1,00000
15.0,12.0,17.0,029,01,01,  Ahla,2269,1529,1089,708,1180,821,59.7,60.6,59.0,00000
15.0,12.0,17.0,029,02,01,  Uttar Bhurshi,1944,1294,998,592,946,702,60.0,62.8,57.4,00000
15.0,12.0,19.0,409,01,01,  Dharala,2862,2177,1401,1024,1461,1153,56.8,57.8,55.9,00000
15.0,12.0,19.0,409,02,01,  Kanungo Para,237,100,120,70,117,30,70.3,63.2,79.6,00000
15.0,12.0,66.0,965,01,01,  Saroatali,2345,1624,1120,761,1225,863,59.1,59.5,58.7,00000
15.0,12.0,66.0,965,02,01,  Sandandi,549,406,278,154,271,252,57.5,64.4,51.8,00000
15.0,18.0,28.0,066,01,01,  Barama,304,153,146,63,158,90,66.5,69.9,63.7,00000
15.0,18.0,28.0,066,02,01,  Char Barama,1255,1103,664,573,591,530,53.2,53.7,52.7,00000
15.0,18.0,28.0,928,01,01,  Sobandi,920,317,477,136,443,181,74.4,77.8,71.0,00000
15.0,18.0,28.0,928,02,01,  Rawlibagh,353,319,195,176,158,143,52.5,52.6,52.5,00000
15.0,18.0,47.0,154,01,01,  Chagachar,1763,1919,920,939,843,980,47.9,49.5,46.2,00000
15.0,18.0,47.0,154,02,01,  Dakshin Chagachar,1875,1593,863,737,1012,856,54.1,53.9,54.2,00000
15.0,18.0,47.0,353,01,01,  Dohazari,4059,4596,2272,2380,1787,2216,46.9,48.8,44.6,00000
15.0,18.0,47.0,353,02,01,  Purba Dohazari,2756,1406,1395,669,1361,737,66.2,67.6,64.9,00000
15.0,18.0,66.0,574,01,01,  Uttar Hashimpur,2748,4115,1378,2074,1370,2041,40.0,39.9,40.2,00000
15.0,18.0,66.0,574,02,01,  Madhya Hashimpur,1784,1247,868,583,916,664,58.9,59.8,58.0,00000
15.0,18.0,66.0,574,03,01,  Dakshin Hashimpur,3531,3230,1787,1636,1744,1594,52.2,52.2,52.2,00000
15.0,18.0,76.0,972,01,01,  Kulalpara,915,1060,492,559,423,501,46.3,46.8,45.8,00000
15.0,18.0,76.0,972,02,01,  Nagarpara,2050,1364,1129,679,921,685,60.0,62.4,57.3,00000
15.0,33.0,13.0,379,01,01,  Uttar Chikonchhara,232,207,125,80,107,127,52.8,61.0,45.7,00000
15.0,33.0,13.0,379,02,01,  Chikonchhara,623,928,304,459,319,469,40.2,39.8,40.5,00000
15.0,33.0,13.0,379,03,01,  Lalmai,544,587,272,267,272,320,48.1,50.5,45.9,00000
15.0,33.0,13.0,379,04,01,  Hatirkheda,148,364,74,184,74,180,28.9,28.7,29.1,00000
15.0,33.0,13.0,379,05,01,  Islampur,568,595,285,263,283,332,48.8,52.0,46.0,00000
15.0,33.0,13.0,379,06,01,  Gazariadhum,1933,2185,984,982,949,1203,46.9,50.1,44.1,00000
15.0,33.0,13.0,553,01,01,  Andharmanik,307,318,145,146,162,172,49.1,49.8,48.5,00000
15.0,33.0,13.0,553,02,01,  Andharmanik Chabagan,163,274,108,126,55,148,37.3,46.2,27.1,00000
15.0,33.0,13.0,830,01,01,  Jatirchar,131,300,75,145,56,155,30.4,34.1,26.5,00000
15.0,33.0,13.0,830,02,01,  Ramgar Chabagan,515,1348,320,629,195,719,27.6,33.7,21.3,00000
15.0,33.0,13.0,830,03,01,  Puran Ramgar,888,512,493,217,395,295,63.4,69.4,57.2,00000
15.0,33.0,13.0,830,04,01,  Bolipara,407,297,190,128,217,169,57.8,59.7,56.2,00000
15.0,33.0,13.0,830,05,01,  Chikonia,260,402,135,160,125,242,39.3,45.8,34.1,00000
15.0,33.0,13.0,830,06,01,  Alampur,506,347,224,162,282,185,59.3,58.0,60.4,00000
15.0,33.0,13.0,830,07,01,  Master Para,167,148,78,51,89,97,53.0,60.5,47.8,00000
15.0,33.0,13.0,830,08,01,  Nabinagar,404,333,197,152,207,181,54.8,56.4,53.4,00000
15.0,33.0,13.0,830,09,01,  Dactar Para,184,181,92,72,92,109,50.4,56.1,45.8,00000
15.0,33.0,13.0,830,10,01,  Gardpara,274,87,135,39,139,48,75.9,77.6,74.3,00000
15.0,33.0,13.0,830,11,01,  Barabil,279,275,130,123,149,152,50.4,51.4,49.5,00000
15.0,33.0,13.0,830,12,01,  Hatirkheda,221,167,105,73,116,94,57.0,59.0,55.2,00000
15.0,33.0,13.0,830,13,01,  Paschim Puran Ramgar,577,321,319,146,258,175,64.3,68.6,59.6,00000
15.0,33.0,13.0,841,01,01,  Office Tila,98,534,57,264,41,270,15.5,17.8,13.2,00000
15.0,33.0,13.0,841,02,01,  Hatirdhur,768,1009,397,473,371,536,43.2,45.6,40.9,00000
15.0,33.0,13.0,841,03,01,  Noydolang,103,348,45,176,58,172,22.8,20.4,25.2,00000
15.0,33.0,13.0,841,04,01,  Chhota Dolong,156,260,79,124,77,136,37.5,38.9,36.2,00000
15.0,33.0,13.0,841,05,01,  Jalonti,296,316,161,131,135,185,48.4,55.1,42.2,00000
15.0,33.0,13.0,841,06,01,  Dakshin Panua,415,839,194,428,221,411,33.1,31.2,35.0,00000
15.0,33.0,13.0,841,07,01,  Rasulpur,324,374,155,186,169,188,46.4,45.5,47.3,00000
15.0,33.0,13.0,841,08,01,  Harfatali,217,258,119,121,98,137,45.7,49.6,41.7,00000
15.0,33.0,13.0,841,09,01,  Udayar Pathar,366,650,168,308,198,342,36.0,35.3,36.7,00000
15.0,33.0,13.0,841,10,01,  Uttar Panua,145,295,81,137,64,158,33.0,37.2,28.8,00000
15.0,33.0,13.0,841,11,01,  Madhya Panua,309,274,144,130,165,144,53.0,52.6,53.4,00000
15.0,33.0,13.0,841,12,01,  Rahmatpur,114,390,41,206,73,184,22.6,16.6,28.4,00000
15.0,33.0,13.0,841,13,01,  Haludia,1782,1503,887,670,895,833,54.2,57.0,51.8,00000
15.0,33.0,13.0,841,14,01,  Matinagar,593,692,309,300,284,392,46.1,50.7,42.0,00000
15.0,33.0,23.0,194,01,01,  Dantmara,107,289,54,126,53,163,27.0,30.0,24.5,00000
15.0,33.0,23.0,194,02,01,  Heakhow,978,895,517,445,461,450,52.2,53.7,50.6,00000
15.0,33.0,23.0,194,03,01,  Duliachhari,937,1017,490,496,447,521,48.0,49.7,46.2,00000
15.0,33.0,23.0,194,04,01,  Rabar Bagan,231,585,126,277,105,308,28.3,31.3,25.4,00000
15.0,33.0,23.0,194,05,01,  Chalaugan,428,733,205,369,223,364,36.9,35.7,38.0,00000
15.0,33.0,23.0,194,06,01,  Islampur,276,443,148,224,128,219,38.4,39.8,36.9,00000
15.0,33.0,23.0,194,07,01,  Nichinta,928,1149,465,562,463,587,44.7,45.3,44.1,00000
15.0,33.0,23.0,194,08,01,  Kanchona,280,1180,147,563,133,617,19.2,20.7,17.7,00000
15.0,33.0,23.0,326,01,01,  Fakirgram,493,732,221,340,272,392,40.2,39.4,41.0,00000
15.0,33.0,23.0,326,02,01,  Munshirgram,608,842,321,397,287,445,41.9,44.7,39.2,00000
15.0,33.0,23.0,326,03,01,  Mohajangram,293,452,137,206,156,246,39.3,39.9,38.8,00000
15.0,33.0,23.0,326,04,01,  Agla Kazigram,568,852,257,385,311,467,40.0,40.0,40.0,00000
15.0,33.0,23.0,326,05,01,  Ultapithegram,270,257,129,119,141,138,51.2,52.0,50.5,00000
15.0,33.0,23.0,841,01,01,  Balutila,348,135,200,68,148,67,72.0,74.6,68.8,00000
15.0,33.0,23.0,841,02,01,  Fulchhari,367,419,185,200,182,219,46.7,48.1,45.4,00000
15.0,33.0,23.0,841,03,01,  Heakhow Bazar,601,498,313,235,288,263,54.7,57.1,52.3,00000
15.0,33.0,23.0,841,04,01,  Subonchhari,211,406,98,194,113,212,34.2,33.6,34.8,00000
15.0,33.0,23.0,841,05,01,  Kalakim,227,137,117,56,110,81,62.4,67.6,57.6,00000
15.0,33.0,23.0,841,06,01,  Ghilatali,290,417,161,204,129,213,41.0,44.1,37.7,00000
15.0,33.0,23.0,841,07,01,  Bangla Para,838,1007,422,496,416,511,45.4,46.0,44.9,00000
15.0,33.0,23.0,841,08,01,  Purba Sonai,166,312,74,142,92,170,34.7,34.3,35.1,00000
15.0,33.0,23.0,841,09,01,  Paschim Sonai,225,237,111,112,114,125,48.7,49.8,47.7,00000
15.0,33.0,23.0,841,10,01,  Uttar Morakoyla,174,286,82,134,92,152,37.8,38.0,37.7,00000
15.0,33.0,23.0,841,11,01,  Domdonia,152,278,80,137,72,141,35.3,36.9,33.8,00000
15.0,33.0,23.0,841,12,01,  Dakshin Morakoyla,86,147,42,69,44,78,36.9,37.8,36.1,00000
15.0,33.0,23.0,841,13,01,  Kanchanar Holy,419,1043,214,519,205,524,28.7,29.2,28.1,00000
15.0,33.0,23.0,841,14,01,  Ziltali,129,377,76,189,53,188,25.5,28.7,22.0,00000
15.0,33.0,23.0,841,15,01,  Shabad Mahamgram,212,227,87,101,125,126,48.3,46.3,49.8,00000
15.0,33.0,23.0,841,16,01,  Corlia,186,342,82,161,104,181,35.2,33.7,36.5,00000
15.0,33.0,23.0,923,01,01,  Uttar Tarakon,282,211,138,100,144,111,57.2,58.0,56.5,00000
15.0,33.0,23.0,923,02,01,  Dakshin Tarakon,477,631,240,293,237,338,43.1,45.0,41.2,00000
15.0,33.0,23.0,923,03,01,  Chhota Bitua,502,238,227,123,275,115,67.8,64.9,70.5,00000
15.0,33.0,23.0,923,04,01,  Bara Bitua,377,592,178,276,199,316,38.9,39.2,38.6,00000
15.0,33.0,23.0,923,05,01,  Choramoni,107,369,53,176,54,193,22.5,23.1,21.9,00000
15.0,33.0,23.0,943,01,01,  Uttar Baramasia,707,814,342,411,365,403,46.5,45.4,47.5,00000
15.0,33.0,23.0,943,02,01,  Sadinagar,264,249,128,109,136,140,51.5,54.0,49.3,00000
15.0,33.0,23.0,943,03,01,  Dakshin Baratuly,80,384,44,195,36,189,17.2,18.4,16.0,00000
15.0,33.0,23.0,943,04,01,  Uttar Baratuly,61,373,30,198,31,175,14.1,13.2,15.0,00000
15.0,33.0,23.0,943,05,01,  Balukhali,666,894,310,455,356,439,42.7,40.5,44.8,00000
15.0,33.0,23.0,943,06,01,  Rotnapur,650,482,295,216,355,266,57.4,57.7,57.2,00000
15.0,33.0,23.0,943,07,01,  Khunkar Para,356,239,187,95,169,144,59.8,66.3,54.0,00000
15.0,33.0,38.0,779,01,01,  Purba Dhurung,2148,1388,1276,659,872,729,60.7,65.9,54.5,00000
15.0,33.0,38.0,779,02,01,  Babunagar,1621,634,871,312,750,322,71.9,73.6,70.0,00000
15.0,33.0,38.0,779,03,01,  Imamnagar,1074,462,583,211,491,251,69.9,73.4,66.2,00000
15.0,33.0,42.0,317,01,01,  Sujanagar,568,196,317,72,251,124,74.3,81.5,66.9,00000
15.0,33.0,42.0,317,02,01,  Khairati Para,379,243,154,120,225,123,60.9,56.2,64.7,00000
15.0,33.0,42.0,317,03,01,  Harwalchhari,1273,1355,627,649,646,706,48.4,49.1,47.8,00000
15.0,33.0,42.0,317,04,01,  Rangapani,650,1035,383,494,267,541,38.6,43.7,33.0,00000
15.0,33.0,42.0,317,05,01,  Lambabil,509,396,279,213,230,183,56.2,56.7,55.7,00000
15.0,33.0,42.0,317,06,01,  Fakir Para,260,137,117,57,143,80,65.5,67.2,64.1,00000
15.0,33.0,42.0,317,07,01,  Dharpara,451,474,230,217,221,257,48.8,51.5,46.2,00000
15.0,33.0,42.0,317,08,01,  Barua Para,119,430,81,195,38,235,21.7,29.3,13.9,00000
15.0,33.0,42.0,656,01,01,  Paschim Andharmanik,767,1033,443,461,324,572,42.6,49.0,36.2,00000
15.0,33.0,42.0,656,02,01,  Pinpinia,126,372,59,186,67,186,25.3,24.1,26.5,00000
15.0,33.0,42.0,656,03,01,  Tripura Para,123,400,80,190,43,210,23.5,29.6,17.0,00000
15.0,33.0,42.0,656,04,01,  Barabil,101,150,66,77,35,73,40.2,46.2,32.4,00000
15.0,33.0,42.0,718,01,01,  Patialchhari,271,639,125,299,146,340,29.8,29.5,30.0,00000
15.0,33.0,42.0,718,02,01,  Natunbagan,109,575,69,252,40,323,15.9,21.5,11.0,00000
15.0,33.0,42.0,800,01,01,  Palpara,393,514,185,241,208,273,43.3,43.4,43.2,00000
15.0,33.0,42.0,800,02,01,  Khamari Para,289,384,155,180,134,204,42.9,46.3,39.6,00000
15.0,33.0,42.0,800,03,01,  Mansa Para,705,636,334,285,371,351,52.6,54.0,51.4,00000
15.0,33.0,42.0,800,04,01,  Maizpara,255,208,132,83,123,125,55.1,61.4,49.6,00000
15.0,33.0,42.0,800,05,01,  Noaghar Para,412,495,168,241,244,254,45.4,41.1,49.0,00000
15.0,33.0,42.0,800,06,01,  Fatikchhari,325,115,175,55,150,60,73.9,76.1,71.4,00000
15.0,33.0,57.0,451,01,01,  Lelang,2259,1917,984,886,1275,1031,54.1,52.6,55.3,00000
15.0,33.0,57.0,451,02,01,  Shannagar,3250,1883,1495,832,1755,1051,63.3,64.2,62.5,00000
15.0,33.0,66.0,061,01,01,  Badurkhil,63,957,27,459,36,498,6.2,5.6,6.7,00000
15.0,33.0,66.0,061,02,01,  Anandapur,78,261,48,135,30,126,23.0,26.2,19.2,00000
15.0,33.0,66.0,102,01,01,  Chandpur,1292,2020,642,975,650,1045,39.0,39.7,38.3,00000
15.0,33.0,66.0,102,02,01,  Dhallah,146,346,72,171,74,175,29.7,29.6,29.7,00000
15.0,33.0,66.0,102,03,01,  Ghara Bhangaha,273,333,145,150,128,183,45.0,49.2,41.2,00000
15.0,33.0,66.0,102,04,01,  Bini Mizirkhil,184,370,86,177,98,193,33.2,32.7,33.7,00000
15.0,33.0,66.0,102,05,01,  Harinmara,175,460,96,210,79,250,27.6,31.4,24.0,00000
15.0,33.0,66.0,102,06,01,  Dhamarkhil,335,788,194,364,141,424,29.8,34.8,25.0,00000
15.0,33.0,66.0,348,01,01,  Dakshin Idilpur,1308,2267,597,1044,711,1223,36.6,36.4,36.8,00000
15.0,33.0,66.0,348,02,01,  Uttar Idilpur,325,614,149,306,176,308,34.6,32.7,36.4,00000
15.0,33.0,66.0,728,01,01,  Pilkhana,73,417,41,210,32,207,14.9,16.3,13.4,00000
15.0,33.0,66.0,728,02,01,  Sapmara,65,387,27,183,38,204,14.4,12.9,15.7,00000
15.0,33.0,71.0,174,01,01,  Dalu,116,956,54,519,62,437,10.8,9.4,12.4,00000
15.0,33.0,71.0,174,02,01,  Daluaralia,173,683,107,402,66,281,20.2,21.0,19.0,00000
15.0,33.0,71.0,974,01,01,  Uttar Paindang,1085,1778,571,888,514,890,37.9,39.1,36.6,00000
15.0,33.0,71.0,974,02,01,  Barajali,884,1176,390,546,494,630,42.9,41.7,44.0,00000
15.0,33.0,90.0,615,01,01,  Uttar Nischintapur,2682,1599,1341,746,1341,853,62.6,64.3,61.1,00000
15.0,33.0,90.0,615,02,01,  Dakshin Nischintapur,1111,515,526,221,585,294,68.3,70.4,66.6,00000
15.0,33.0,90.0,615,03,01,  Madhya Nischintapur,2000,649,969,293,1031,356,75.5,76.8,74.3,00000
15.0,33.0,90.0,769,01,01,  Purba Dhalai,1164,826,580,358,584,468,58.5,61.8,55.5,00000
15.0,33.0,90.0,769,02,01,  Sadeknagar,3032,1453,1383,642,1649,811,67.6,68.3,67.0,00000
15.0,33.0,95.0,112,01,01,  Chhota Chhilania,550,420,238,190,312,230,56.7,55.6,57.6,00000
15.0,33.0,95.0,112,02,01,  Azimpur,2140,1747,964,812,1176,935,55.1,54.3,55.7,00000
15.0,33.0,95.0,112,03,01,  Aychin Nagar,630,333,292,124,338,209,65.4,70.2,61.8,00000
15.0,33.0,95.0,112,04,01,  Bara Chhilania,1453,1117,671,512,782,605,56.5,56.7,56.4,00000
15.0,33.0,95.0,112,05,01,  Sadeknagar,574,463,284,241,290,222,55.4,54.1,56.6,00000
15.0,33.0,95.0,164,01,01,  Paschim Sundarpur,1134,1431,512,685,622,746,44.2,42.8,45.5,00000
15.0,33.0,95.0,164,02,01,  Dakshin Sundarpur,1322,1016,619,442,703,574,56.5,58.3,55.1,00000
15.0,37.0,17.0,175,01,01,  Chikandandi,14037,6192,7152,2855,6885,3337,69.4,71.5,67.4,00000
15.0,37.0,17.0,175,02,01,  Uttar Fateyabad,1946,1057,975,492,971,565,64.8,66.5,63.2,00000
15.0,37.0,17.0,175,03,01,  Fateyabad,2401,1284,1171,650,1230,634,65.2,64.3,66.0,00000
15.0,37.0,53.0,312,01,01,  Sadernagar,1803,1123,812,512,991,611,61.6,61.3,61.9,00000
15.0,37.0,53.0,312,02,01,  Gumanmardan,4221,2279,1910,955,2311,1324,64.9,66.7,63.6,00000
15.0,37.0,53.0,312,03,01,  Balukhali,894,513,404,225,490,288,63.5,64.2,63.0,00000
15.0,37.0,59.0,273,01,03,  Fatika,16543,5928,9753,2959,6790,2969,73.6,76.7,69.6,00000
15.0,37.0,59.0,273,02,01,  Mirarkhil,2125,2215,1086,1086,1039,1129,49.0,50.0,47.9,00000
15.0,37.0,59.0,273,03,01,  Mohammadpur,1509,983,705,445,804,538,60.6,61.3,59.9,00000
15.0,37.0,59.0,604,01,01,  Alampur,2256,2039,1090,1019,1166,1020,52.5,51.7,53.3,00000
15.0,37.0,59.0,604,02,01,  Chandrapur,1047,483,511,226,536,257,68.4,69.3,67.6,00000
15.0,37.0,59.0,604,03,01,  Gurchagram,456,1139,312,585,144,554,28.6,34.8,20.6,00000
15.0,37.0,65.0,663,01,01,  Uttarmekhal,2476,1254,1325,552,1151,702,66.4,70.6,62.1,00000
15.0,37.0,65.0,663,02,01,  Purbamekhal,4707,643,3336,311,1371,332,88.0,91.5,80.5,00000
15.0,37.0,65.0,663,03,01,  Dkhinmekhal,2410,931,1139,409,1271,522,72.1,73.6,70.9,00000
15.0,37.0,65.0,663,04,01,  Paschimmekhal,5109,2843,2621,1378,2488,1465,64.2,65.5,62.9,00000
15.0,47.0,32.0,695,01,01,  Narischa,430,600,185,304,245,296,41.7,37.8,45.3,00000
15.0,47.0,32.0,695,02,01,  Barua Para,164,213,90,86,74,127,43.5,51.1,36.8,00000
15.0,47.0,62.0,589,01,03,  Uttar Lohagara,7292,4134,3926,2078,3366,2056,63.8,65.4,62.1,00000
15.0,47.0,62.0,589,02,03,  Dakshin Lohagara,8103,6027,4049,3043,4054,2984,57.3,57.1,57.6,00000
15.0,47.0,73.0,722,01,01,  Uttar Padua,7886,7524,3774,3528,4112,3996,51.2,51.7,50.7,00000
15.0,47.0,73.0,722,02,01,  Dakshin Padua,5900,5748,2896,2824,3004,2924,50.7,50.6,50.7,00000
15.0,53.0,24.0,270,01,01,  Purba Durgapur,3001,2847,1414,1352,1587,1495,51.3,51.1,51.5,00000
15.0,53.0,24.0,270,02,01,  Uttar Durgapur,1916,1207,882,512,1034,695,61.4,63.3,59.8,00000
15.0,53.0,24.0,334,01,01,  Gopalpur,1052,491,514,222,538,269,68.2,69.8,66.7,00000
15.0,53.0,24.0,334,02,01,  Muraripur,323,76,157,36,166,40,81.0,81.3,80.6,00000
15.0,53.0,24.0,371,01,01,  Shikerpur,318,117,150,49,168,68,73.1,75.4,71.2,00000
15.0,53.0,24.0,371,02,01,  Hariharpur,531,188,258,83,273,105,73.9,75.7,72.2,00000
15.0,53.0,27.0,492,01,01,  Kurua,1693,1584,811,682,882,902,51.7,54.3,49.4,00000
15.0,53.0,27.0,492,02,01,  Damdama,549,275,252,121,297,154,66.6,67.6,65.9,00000
15.0,53.0,27.0,492,03,01,  Nawabpur,221,215,100,92,121,123,50.7,52.1,49.6,00000
15.0,53.0,27.0,492,04,01,  Kachua,261,260,135,109,126,151,50.1,55.3,45.5,00000
15.0,53.0,27.0,492,05,01,  Tarakatia,48,39,21,18,27,21,55.2,53.8,56.3,00000
15.0,53.0,27.0,492,06,01,  Mahalanka,311,107,158,41,153,66,74.4,79.4,69.9,00000
15.0,53.0,29.0,660,01,01,  Dakshin Bhuiyangram,635,630,256,264,379,366,50.2,49.2,50.9,00000
15.0,53.0,29.0,660,02,01,  Lubda Khaligram,1140,966,493,398,647,568,54.1,55.3,53.3,00000
15.0,53.0,29.0,660,03,01,  Chunimizirtek,877,1325,379,637,498,688,39.8,37.3,42.0,00000
15.0,53.0,29.0,660,04,01,  Islampur,443,588,220,240,223,348,43.0,47.8,39.1,00000
15.0,53.0,29.0,660,05,01,  Baddargram,228,221,99,93,129,128,50.8,51.6,50.2,00000
15.0,53.0,29.0,771,01,01,  Purba Ichhakhali,555,860,209,387,346,473,39.2,35.1,42.2,00000
15.0,53.0,29.0,771,02,01,  Char Sarat,1050,2074,595,987,455,1087,33.6,37.6,29.5,00000
15.0,53.0,29.0,976,01,01,  Joynagar,735,554,395,250,340,304,57.0,61.2,52.8,00000
15.0,53.0,29.0,976,02,01,  Uttar Bhuiyangram,416,303,200,125,216,178,57.9,61.5,54.8,00000
15.0,53.0,29.0,976,03,01,  Matullagona,291,152,139,60,152,92,65.7,69.8,62.3,00000
15.0,53.0,29.0,976,04,01,  Munshigram,278,124,123,51,155,73,69.2,70.7,68.0,00000
15.0,53.0,29.0,976,05,01,  Deokhali,289,287,110,114,179,173,50.2,49.1,50.9,00000
15.0,53.0,29.0,976,06,01,  Sahebdinagar,948,973,414,434,534,539,49.3,48.8,49.8,00000
15.0,53.0,29.0,976,07,01,  Jamadargram,806,696,342,282,464,414,53.7,54.8,52.8,00000
15.0,53.0,29.0,976,08,01,  Dakshin Kazigram,195,364,81,186,114,178,34.9,30.3,39.0,00000
15.0,53.0,29.0,976,09,01,  Uttar Kazigram,334,296,128,124,206,172,53.0,50.8,54.5,00000
15.0,53.0,29.0,976,10,01,  Hasnabad,393,492,159,214,234,278,44.4,42.6,45.7,00000
15.0,53.0,29.0,976,11,01,  Mizigram,377,335,176,145,201,190,52.9,54.8,51.4,00000
15.0,53.0,29.0,976,12,01,  Nandigram,657,459,300,189,357,270,58.9,61.3,56.9,00000
15.0,53.0,29.0,976,13,01,  Habizgram,580,537,281,229,299,308,51.9,55.1,49.3,00000
15.0,53.0,35.0,864,01,01,  Kalapani,384,410,216,187,168,223,48.4,53.6,43.0,00000
15.0,53.0,35.0,864,02,01,  Kayla,170,262,98,126,72,136,39.4,43.8,34.6,00000
15.0,53.0,35.0,864,03,01,  Paschim Sonai,463,851,252,400,211,451,35.2,38.7,31.9,00000
15.0,53.0,35.0,864,04,01,  Mogpathar,60,94,30,38,30,56,39.0,44.1,34.9,00000
15.0,53.0,35.0,864,05,01,  Guza,73,340,48,174,25,166,17.7,21.6,13.1,00000
15.0,53.0,35.0,864,06,01,  Hukkabhanga,301,584,165,283,136,301,34.0,36.8,31.1,00000
15.0,53.0,35.0,864,07,01,  Badachari,98,460,49,223,49,237,17.6,18.0,17.1,00000
15.0,53.0,41.0,381,01,01,  Idilpur,192,222,68,104,124,118,46.4,39.5,51.2,00000
15.0,53.0,41.0,381,02,01,  Goatali,315,267,145,123,170,144,54.1,54.1,54.1,00000
15.0,53.0,41.0,948,01,01,  Temuhani,775,638,383,294,392,344,54.8,56.6,53.3,00000
15.0,53.0,41.0,948,02,01,  Muradpur,785,453,360,188,425,265,63.4,65.7,61.6,00000
15.0,53.0,41.0,948,03,01,  Tetuiya,1128,402,544,144,584,258,73.7,79.1,69.4,00000
15.0,53.0,47.0,497,01,01,  Paschim Gobania,359,571,179,260,180,311,38.6,40.8,36.7,00000
15.0,53.0,47.0,497,02,01,  Penapuni,220,260,104,108,116,152,45.8,49.1,43.3,00000
15.0,53.0,47.0,497,03,01,  Purbo Gobania,10,101,5,59,5,42,9.0,7.8,10.6,00000
15.0,53.0,47.0,734,01,01,  Paschim Polmogra,778,429,370,188,408,241,64.5,66.3,62.9,00000
15.0,53.0,47.0,734,02,01,  Purba Polmogra,63,22,33,9,30,13,74.1,78.6,69.8,00000
15.0,53.0,47.0,786,01,01,  Uttar Ambaria,681,955,328,455,353,500,41.6,41.9,41.4,00000
15.0,53.0,47.0,786,02,01,  Dakshin Ambaria,536,521,233,215,303,306,50.7,52.0,49.8,00000
15.0,53.0,47.0,809,01,01,  Nichinga,166,203,75,89,91,114,45.0,45.7,44.4,00000
15.0,53.0,47.0,809,02,01,  Niztaluk,561,574,284,250,277,324,49.4,53.2,46.1,00000
15.0,53.0,47.0,809,03,01,  Machpara,93,54,38,17,55,37,63.3,69.1,59.8,00000
15.0,53.0,47.0,809,04,01,  Poudabaj Noduara,291,334,144,162,147,172,46.6,47.1,46.1,00000
15.0,53.0,47.0,809,05,01,  Mosjidia,1608,890,736,365,872,525,64.4,66.8,62.4,00000
15.0,53.0,47.0,809,06,01,  Chagalkaiya,155,182,68,89,87,93,46.0,43.3,48.3,00000
15.0,53.0,47.0,809,07,01,  Purba Pal Mogra,632,884,325,428,307,456,41.7,43.2,40.2,00000
15.0,53.0,47.0,809,08,01,  Tripura Para,6,148,3,73,3,75,3.9,3.9,3.8,00000
15.0,53.0,53.0,698,01,01,  Madhya Mayani,1761,1083,824,425,937,658,61.9,66.0,58.7,00000
15.0,53.0,53.0,698,02,01,  Baruapara,659,1040,347,449,312,591,38.8,43.6,34.6,00000
15.0,53.0,53.0,698,03,01,  Maltola,353,291,158,128,195,163,54.8,55.2,54.5,00000
15.0,53.0,53.0,698,04,01,  Paschim Mayamgona,854,621,400,277,454,344,57.9,59.1,56.9,00000
15.0,53.0,53.0,698,05,01,  Paschim Mayani,1677,612,780,218,897,394,73.3,78.2,69.5,00000
15.0,53.0,53.0,698,06,01,  Muhuripara,422,241,191,91,231,150,63.7,67.7,60.6,00000
15.0,53.0,53.0,813,01,01,  Manu Bhuiyan Para,653,390,333,187,320,203,62.6,64.0,61.2,00000
15.0,53.0,53.0,813,02,01,  Purba Mayani,1428,981,679,439,749,542,59.3,60.7,58.0,00000
15.0,53.0,53.0,813,03,01,  Saidali,1461,1034,739,481,722,553,58.6,60.6,56.6,00000
15.0,53.0,59.0,548,01,01,  Mithachhara,861,280,426,92,435,188,75.5,82.2,69.8,00000
15.0,53.0,59.0,548,02,01,  Mandarbaria,486,297,234,108,252,189,62.1,68.4,57.1,00000
15.0,53.0,59.0,585,01,01,  Motbaria,839,703,409,325,430,378,54.4,55.7,53.2,00000
15.0,53.0,59.0,585,02,01,  Joarpuni,230,143,113,59,117,84,61.7,65.7,58.2,00000
15.0,53.0,59.0,585,03,01,  Amantola,753,202,406,65,347,137,78.8,86.2,71.7,00000
15.0,53.0,59.0,790,01,03,  Uttar Talbaria (Part),636,836,316,381,320,455,43.2,45.3,41.3,00000
15.0,53.0,59.0,790,02,03,  Madhya Talbaria (Part),605,699,303,301,302,398,46.4,50.2,43.1,00000
15.0,53.0,59.0,818,01,01,  Abunagar,377,276,185,115,192,161,57.7,61.7,54.4,00000
15.0,53.0,59.0,818,02,01,  Sreepur,501,559,238,242,263,317,47.3,49.6,45.3,00000
15.0,53.0,59.0,818,03,01,  Garish,621,1264,287,609,334,655,32.9,32.0,33.8,00000
15.0,53.0,59.0,836,01,01,  Bakkhola,226,172,109,58,117,114,56.8,65.3,50.6,00000
15.0,53.0,59.0,836,02,01,  Tarakatia,104,224,46,99,58,125,31.7,31.7,31.7,00000
15.0,53.0,59.0,836,03,01,  2 No Tarakatia,32,30,17,16,15,14,51.6,51.5,51.7,00000
15.0,53.0,65.0,557,01,01,  Paschim Mithanala,2008,1431,930,605,1078,826,58.4,60.6,56.6,00000
15.0,53.0,65.0,557,02,01,  Baraghardas Para,676,396,300,152,376,244,63.1,66.4,60.6,00000
15.0,53.0,65.0,557,03,01,  Shasufitakia Para,277,54,125,20,152,34,83.7,86.2,81.7,00000
15.0,53.0,65.0,557,04,01,  Munshi Para,241,176,117,84,124,92,57.8,58.2,57.4,00000
15.0,53.0,65.0,557,05,01,  Kazigram,255,123,106,47,149,76,67.5,69.3,66.2,00000
15.0,53.0,65.0,557,06,01,  Rajapur,622,255,300,106,322,149,70.9,73.9,68.4,00000
15.0,53.0,65.0,557,07,01,  Gonitola,227,152,105,60,122,92,59.9,63.6,57.0,00000
15.0,53.0,65.0,557,08,01,  Miahpara,122,207,54,87,68,120,37.1,38.3,36.2,00000
15.0,53.0,65.0,557,09,01,  Master Para,186,155,81,60,105,95,54.5,57.4,52.5,00000
15.0,53.0,65.0,557,10,01,  Hadimusa,372,168,158,62,214,106,68.9,71.8,66.9,00000
15.0,53.0,65.0,557,11,01,  Darjee Para,267,171,125,68,142,103,61.0,64.8,58.0,00000
15.0,53.0,65.0,557,12,01,  Raghabpur,328,92,151,36,177,56,78.1,80.7,76.0,00000
15.0,53.0,65.0,557,13,01,  Dhompara Banderpar,311,243,149,105,162,138,56.1,58.7,54.0,00000
15.0,53.0,65.0,557,14,01,  Amani Bhuiyanpara (Dohapara),706,397,333,155,373,242,64.0,68.2,60.7,00000
15.0,53.0,65.0,799,01,01,  Purba Maliais,446,419,214,167,232,252,51.6,56.2,47.9,00000
15.0,53.0,65.0,799,02,01,  Dhonmia Para,306,247,146,106,160,141,55.3,57.9,53.2,00000
15.0,53.0,71.0,502,01,01,  Teenghariatola,1064,873,497,364,567,509,54.9,57.7,52.7,00000
15.0,53.0,71.0,502,02,01,  Safiulla Namapara,186,237,86,97,100,140,44.0,47.0,41.7,00000
15.0,53.0,71.0,502,03,01,  Sekher Taluk,314,596,144,256,170,340,34.5,36.0,33.3,00000
15.0,53.0,71.0,502,04,01,  Khomawala Para (Bhuiyangram),539,506,250,198,289,308,51.6,55.8,48.4,00000
15.0,53.0,71.0,502,05,01,  Mahanandabad (Masterpara),705,306,341,131,364,175,69.7,72.2,67.5,00000
15.0,53.0,71.0,502,06,01,  Sarkartola,622,806,301,371,321,435,43.6,44.8,42.5,00000
15.0,53.0,71.0,502,07,01,  Kazir Taluk,950,608,412,263,538,345,61.0,61.0,60.9,00000
15.0,53.0,71.0,502,08,01,  Badiulla Para,196,583,99,284,97,299,25.2,25.8,24.5,00000
15.0,53.0,71.0,502,09,01,  Chattagram Para (Jafrabad),703,572,331,243,372,329,55.1,57.7,53.1,00000
15.0,53.0,71.0,502,10,01,  Hashimnagar,471,537,206,239,265,298,46.7,46.3,47.1,00000
15.0,53.0,71.0,502,11,01,  Gazaria,356,280,174,118,182,162,56.0,59.6,52.9,00000
15.0,53.0,71.0,502,12,01,  Shektola,510,296,236,121,274,175,63.3,66.1,61.0,00000
15.0,53.0,71.0,502,13,01,  Bujurga Umednagar,249,183,117,76,132,107,57.6,60.6,55.2,00000
15.0,53.0,71.0,502,14,01,  Maghadia Hindupara,469,110,239,42,230,68,81.0,85.1,77.2,00000
15.0,53.0,71.0,502,15,01,  Maghadia Daspara,347,886,193,394,154,492,28.1,32.9,23.8,00000
15.0,53.0,71.0,502,16,01,  Miapara,601,661,286,291,315,370,47.6,49.6,46.0,00000
15.0,53.0,71.0,502,17,01,  Maghadia Banikpara,276,141,130,67,146,74,66.2,66.0,66.4,00000
15.0,53.0,71.0,502,18,01,  Gazitola,524,700,246,305,278,395,42.8,44.6,41.3,00000
15.0,53.0,71.0,502,19,01,  Hadinagar,414,375,162,168,252,207,52.5,49.1,54.9,00000
15.0,53.0,83.0,223,01,01,  Dakshin Maghadia,948,1100,409,493,539,607,46.3,45.3,47.0,00000
15.0,53.0,83.0,223,02,01,  Kazir Taluk,533,807,219,355,314,452,39.8,38.2,41.0,00000
15.0,53.0,83.0,260,01,01,  Gajaria,676,532,295,241,381,291,56.0,55.0,56.7,00000
15.0,53.0,83.0,260,02,01,  Domkhali,1909,1617,805,731,1104,886,54.1,52.4,55.5,00000
15.0,53.0,83.0,260,03,01,  Morajpur (Part),269,188,128,74,141,114,58.9,63.4,55.3,00000
15.0,53.0,83.0,902,01,01,  Purba Saherkhali,695,737,311,325,384,412,48.5,48.9,48.2,00000
15.0,53.0,83.0,902,02,01,  Paschim Saherkhali,840,617,381,269,459,348,57.7,58.6,56.9,00000
15.0,53.0,83.0,902,03,01,  Madhya Saherkhali,1362,539,603,205,759,334,71.6,74.6,69.4,00000
15.0,53.0,83.0,902,04,01,  Uttar Saherkhali Mollagram,464,334,193,146,271,188,58.1,56.9,59.0,00000
15.0,53.0,89.0,065,01,01,  Bara Kamaldaha,816,1232,393,624,423,608,39.8,38.6,41.0,00000
15.0,53.0,89.0,065,02,01,  Jafrabad,485,150,261,65,224,85,76.4,80.1,72.5,00000
15.0,53.0,89.0,530,01,01,  Maijgaon,725,427,323,170,402,257,62.9,65.5,61.0,00000
15.0,53.0,89.0,530,02,01,  Bujurga Umednagar,425,134,185,54,240,80,76.0,77.4,75.0,00000
15.0,53.0,89.0,530,03,01,  Farfaria,467,423,249,176,218,247,52.5,58.6,46.9,00000
15.0,53.0,89.0,530,04,01,  Padua,505,87,239,26,266,61,85.3,90.2,81.3,00000
15.0,53.0,95.0,914,01,01,  Mastan Nagar,1655,750,1061,319,594,431,68.8,76.9,58.0,00000
15.0,53.0,95.0,914,02,01,  Madhya Sonapahar,5239,4820,2735,2248,2504,2572,52.1,54.9,49.3,00000
15.0,53.0,95.0,914,03,01,  Uttar Sonapahar,567,76,261,30,306,46,88.2,89.7,86.9,00000
15.0,53.0,95.0,914,04,01,  Dakshin Sonapahar,1287,1178,634,554,653,624,52.2,53.4,51.1,00000
15.0,61.0,12.0,024,01,01,  Asia,2679,2528,1325,1143,1354,1385,51.4,53.7,49.4,00000
15.0,61.0,12.0,024,02,01,  Dakshin Asia,1723,1396,860,653,863,743,55.2,56.8,53.7,00000
15.0,61.0,21.0,206,01,01,  Dakshin Chatra,580,961,261,436,319,525,37.6,37.4,37.8,00000
15.0,61.0,21.0,206,02,01,  Uttar Chatra,882,560,420,245,462,315,61.2,63.2,59.5,00000
15.0,61.0,21.0,218,01,01,  Uttar Chanhara,846,990,408,461,438,529,46.1,47.0,45.3,00000
15.0,61.0,21.0,218,02,01,  Dakshin Chanhara,1309,1415,660,701,649,714,48.1,48.5,47.6,00000
15.0,61.0,39.0,357,01,01,  Halim Khanchar,1615,1124,779,539,836,585,59.0,59.1,58.8,00000
15.0,61.0,39.0,357,02,01,  Char Kanai,1791,708,958,301,833,407,71.7,76.1,67.2,00000
15.0,61.0,70.0,558,01,01,  Kharana,2953,3638,1353,1762,1600,1876,44.8,43.4,46.0,00000
15.0,61.0,70.0,558,02,01,  Dakshin Kharana,623,998,330,542,293,456,38.4,37.8,39.1,00000
15.0,61.0,70.0,558,03,01,  Paschim Kharana,469,793,210,382,259,411,37.2,35.5,38.7,00000
15.0,61.0,70.0,715,01,01,  Purba Muzafarabad,232,450,125,248,107,202,34.0,33.5,34.6,00000
15.0,61.0,70.0,715,02,01,  Madhya Muzafarabad,547,311,272,131,275,180,63.8,67.5,60.4,00000
15.0,61.0,70.0,715,03,01,  Paschim Muzafarabad,591,316,305,141,286,175,65.2,68.4,62.0,00000
15.0,61.0,70.0,715,04,01,  Purba Dakshin Para,388,170,218,75,170,95,69.5,74.4,64.2,00000
15.0,61.0,70.0,715,05,01,  Paschim Dakshin Para,258,173,138,70,120,103,59.9,66.3,53.8,00000
15.0,61.0,94.0,673,01,01,  Maliara,2227,3180,1127,1506,1100,1674,41.2,42.8,39.7,00000
15.0,61.0,94.0,673,02,01,  K.Rahman Chowdhury Para,467,700,234,344,233,356,40.0,40.5,39.6,00000
15.0,70.0,15.0,069,01,01,  Uttar Betagi,295,433,143,200,152,233,40.5,41.7,39.5,00000
15.0,70.0,15.0,069,02,01,  Paschim Betagi,953,732,457,354,496,378,56.6,56.4,56.8,00000
15.0,70.0,15.0,069,03,01,  Madhya Betagi,1548,776,787,350,761,426,66.6,69.2,64.1,00000
15.0,70.0,15.0,069,04,01,  Dakshin Betagi,815,611,364,293,451,318,57.2,55.4,58.6,00000
15.0,70.0,15.0,069,05,01,  Barua Para,1346,1220,616,542,730,678,52.5,53.2,51.8,00000
15.0,70.0,17.0,096,01,01,  Adarshagram,952,594,483,253,469,341,61.6,65.6,57.9,00000
15.0,70.0,17.0,096,02,01,  Hajigram,1297,991,603,457,694,534,56.7,56.9,56.5,00000
15.0,70.0,17.0,096,03,01,  Samiuddin Shahgram,542,615,286,307,256,308,46.8,48.2,45.4,00000
15.0,70.0,17.0,096,04,01,  Purba Chandraghona,1065,496,537,227,528,269,68.2,70.3,66.2,00000
15.0,70.0,17.0,096,05,01,  Sufigram,1896,1573,983,782,913,791,54.7,55.7,53.6,00000
15.0,70.0,17.0,096,06,01,  Nabagram,3111,1666,1818,944,1293,722,65.1,65.8,64.2,00000
15.0,70.0,17.0,096,07,01,  Banagram,3264,2978,1684,1578,1580,1400,52.3,51.6,53.0,00000
15.0,70.0,17.0,469,01,01,  Paschim Kadamtali,1520,881,749,398,771,483,63.3,65.3,61.5,00000
15.0,70.0,17.0,469,02,01,  Purba Kadamtali,622,522,309,234,313,288,54.4,56.9,52.1,00000
15.0,70.0,25.0,345,02,01,  Ghagra Khilmogal(P),410,483,177,235,233,248,45.9,43.0,48.4,00000
15.0,70.0,25.0,345,03,01,  Dakshin Khilmogal(P),1717,1297,805,587,912,710,57.0,57.8,56.2,00000
15.0,70.0,25.0,345,04,01,  Khilmogal Gazalia,440,614,202,255,238,359,41.7,44.2,39.9,00000
15.0,70.0,27.0,760,01,01,  Dakshin Kalipur,1476,1854,711,1073,765,781,44.3,39.9,49.5,00000
15.0,70.0,27.0,760,02,01,  Uttar Kalipur,1212,1326,597,701,615,625,47.8,46.0,49.6,00000
15.0,70.0,32.0,345,01,01,  Ghagra Khillmogal (Part),504,789,239,367,265,422,39.0,39.4,38.6,00000
15.0,70.0,32.0,345,02,01,  Uttar Khillmogal (Part),717,716,296,298,421,418,50.0,49.8,50.2,00000
15.0,70.0,32.0,345,03,01,  Dakshin Khillmogal (Part),230,186,94,75,136,111,55.3,55.6,55.1,00000
15.0,70.0,32.0,345,04,01,  Purba Khillmogal,690,641,295,294,395,347,51.8,50.1,53.2,00000
15.0,70.0,34.0,483,01,01,  Katakhali,461,537,205,263,256,274,46.2,43.8,48.3,00000
15.0,70.0,34.0,483,02,01,  Farash Danga,1027,657,469,295,558,362,61.0,61.4,60.7,00000
15.0,70.0,34.0,483,03,01,  Maijpara,650,373,311,167,339,206,63.5,65.1,62.2,00000
15.0,70.0,34.0,483,04,01,  Fulgazi Para,831,369,392,148,439,221,69.3,72.6,66.5,00000
15.0,70.0,34.0,483,05,01,  Sodagar Para,561,344,289,170,272,174,62.0,63.0,61.0,00000
15.0,70.0,34.0,483,06,01,  Najarer Tila,1324,585,664,271,660,314,69.4,71.0,67.8,00000
15.0,70.0,34.0,483,07,01,  Purba Kulalpara,319,245,160,118,159,127,56.6,57.6,55.6,00000
15.0,70.0,34.0,483,08,01,  Marampara,579,225,321,111,258,114,72.0,74.3,69.4,00000
15.0,70.0,34.0,483,09,01,  Purba Shekhpara,107,87,54,43,53,44,55.2,55.7,54.6,00000
15.0,70.0,34.0,483,10,01,  Amiria Para,376,260,190,121,186,139,59.1,61.1,57.2,00000
15.0,70.0,34.0,483,11,01,  Moulvipara,741,350,329,163,412,187,67.9,66.9,68.8,00000
15.0,70.0,34.0,483,12,01,  Paschim Shekhpara,310,194,159,95,151,99,61.5,62.6,60.4,00000
15.0,70.0,34.0,483,13,01,  Paschim Kulalpara,339,504,158,266,181,238,40.2,37.3,43.2,00000
15.0,70.0,34.0,483,14,01,  Rashidia Para,706,290,368,147,338,143,70.9,71.5,70.3,00000
15.0,70.0,43.0,718,01,01,  Padua,2948,3534,1442,1660,1506,1874,45.5,46.5,44.6,00000
15.0,70.0,43.0,718,02,01,  Harihar,940,1070,435,470,505,600,46.8,48.1,45.7,00000
15.0,70.0,43.0,718,03,01,  Sarasia,394,468,188,218,206,250,45.7,46.3,45.2,00000
15.0,70.0,43.0,815,01,01,  Purba Khurusia,991,1800,484,847,507,953,35.5,36.4,34.7,00000
15.0,70.0,43.0,815,02,01,  Kamal Chari,191,664,109,351,82,313,22.3,23.7,20.8,00000
15.0,70.0,51.0,359,01,01,  Saidnagar,535,735,281,324,254,411,42.1,46.4,38.2,00000
15.0,70.0,51.0,359,02,01,  Paschim Shahabdi Nagar,1041,1055,496,498,545,557,49.7,49.9,49.5,00000
15.0,70.0,51.0,359,03,01,  Purba Shahabdi Nagar,669,648,311,288,358,360,50.8,51.9,49.9,00000
15.0,70.0,51.0,732,01,01,  Uttar Parua,1104,1631,531,807,573,824,40.4,39.7,41.0,00000
15.0,70.0,51.0,732,02,01,  Madhya Parua,1378,1275,607,626,771,649,51.9,49.2,54.3,00000
15.0,70.0,60.0,773,01,03,  Dakshin Pomara,1442,859,707,379,735,480,62.7,65.1,60.5,00000
15.0,70.0,60.0,773,02,03,  Bacha Shahnagar,1038,1000,540,458,498,542,50.9,54.1,47.9,00000
15.0,70.0,60.0,773,03,03,  Hajipara Maijpara,1425,818,631,388,794,430,63.5,61.9,64.9,00000
15.0,70.0,60.0,773,04,03,  Hila Gazipara,1159,1593,479,760,680,833,42.1,38.7,44.9,00000
15.0,70.0,60.0,773,05,03,  Madhya Pomara,3795,3488,1800,1592,1995,1896,52.1,53.1,51.3,00000
15.0,70.0,60.0,773,06,03,  Hajipara Sikdarpara,975,1000,452,506,523,494,49.4,47.2,51.4,00000
15.0,70.0,60.0,773,07,03,  Sapleza Para,1468,1169,721,558,747,611,55.7,56.4,55.0,00000
15.0,70.0,69.0,124,01,01,  Rajabhuban,1474,2037,673,1031,801,1006,42.0,39.5,44.3,00000
15.0,70.0,69.0,124,02,01,  Fulbagicha,405,1105,219,626,186,479,26.8,25.9,28.0,00000
15.0,70.0,69.0,760,01,01,  Dakshin Rajanagar,1601,1800,765,853,836,947,47.1,47.3,46.9,00000
15.0,70.0,69.0,760,02,01,  Dakshin Purba Rajanagar,1071,1987,511,1127,560,860,35.0,31.2,39.4,00000
15.0,70.0,69.0,760,03,01,  Khurshed Taluk,458,538,212,270,246,268,46.0,44.0,47.9,00000
15.0,70.0,69.0,760,04,01,  Sonargaon,1239,1590,527,783,712,807,43.8,40.2,46.9,00000
15.0,70.0,77.0,829,01,01,  Dakshin Sabek,1135,305,558,123,577,182,78.8,81.9,76.0,00000
15.0,70.0,77.0,829,02,01,  Uttar Sabek,1128,774,558,374,570,400,59.3,59.9,58.8,00000
15.0,70.0,77.0,829,03,01,  Paschim Sabek,1197,850,610,391,587,459,58.5,60.9,56.1,00000
15.0,70.0,77.0,829,04,01,  Bramattar,1940,1851,927,863,1013,988,51.2,51.8,50.6,00000
15.0,70.0,77.0,829,05,01,  Santiniketan,800,613,403,296,397,317,56.6,57.7,55.6,00000
15.0,70.0,77.0,829,07,01,  Majumderkil,608,158,283,69,325,89,79.4,80.4,78.5,00000
15.0,70.0,86.0,856,01,01,  Uttar Sarapbhata,279,305,144,140,135,165,47.8,50.7,45.0,00000
15.0,70.0,86.0,856,02,01,  Samiddin Shahpara,1853,1264,824,550,1029,714,59.4,60.0,59.0,00000
15.0,70.0,86.0,856,03,01,  Madhya Sarabhata,901,971,431,469,470,502,48.1,47.9,48.4,00000
15.0,70.0,86.0,856,04,01,  Bhumirkhil,1337,1340,619,634,718,706,49.9,49.4,50.4,00000
15.0,70.0,86.0,856,05,01,  Kazirkhil,807,780,381,340,426,440,50.9,52.8,49.2,00000
15.0,70.0,86.0,856,06,01,  Sikdar Para,1196,1800,543,881,653,919,39.9,38.1,41.5,00000
15.0,70.0,86.0,856,07,01,  Uddirkhil,1048,845,476,437,572,408,55.4,52.1,58.4,00000
15.0,70.0,86.0,856,08,01,  Maylanagram,966,671,433,302,533,369,59.0,58.9,59.1,00000
15.0,70.0,86.0,856,09,01,  Azarikhil,600,988,266,450,334,538,37.8,37.2,38.3,00000
15.0,70.0,86.0,856,10,01,  Mirikhil,703,1260,302,597,401,663,35.8,33.6,37.7,00000
15.0,70.0,94.0,884,01,01,  Naya Rasta,795,1054,370,505,425,549,43.0,42.3,43.6,00000
15.0,70.0,94.0,884,02,01,  Firingir Khil,1031,1094,460,491,571,603,48.5,48.4,48.6,00000
15.0,70.0,94.0,884,03,01,  Fakira Ghat,1083,873,523,397,560,476,55.4,56.8,54.1,00000
15.0,70.0,94.0,884,04,01,  Natura Tila,676,1073,291,487,385,586,38.7,37.4,39.6,00000
15.0,70.0,94.0,884,05,01,  Pakiar Tila,1270,783,613,352,657,431,61.9,63.5,60.4,00000
15.0,70.0,94.0,884,06,01,  Mina Gazir Tila,1597,1217,717,552,880,665,56.8,56.5,57.0,00000
15.0,70.0,94.0,884,07,01,  Raja Para,1231,1328,584,657,647,671,48.1,47.1,49.1,00000
15.0,74.0,11.0,033,01,01,  Bagoan,1166,1079,583,571,583,508,51.9,50.5,53.4,00000
15.0,74.0,11.0,033,02,01,  Koyapara,2362,1396,1179,649,1183,747,62.9,64.5,61.3,00000
15.0,74.0,75.0,447,01,01,  Khalilabad,1078,531,534,274,544,257,67.0,66.1,67.9,00000
15.0,74.0,75.0,447,02,01,  Khankhanabad,448,335,198,145,250,190,57.2,57.7,56.8,00000
15.0,74.0,75.0,729,01,01,  Madhya Raozan,1763,979,862,414,901,565,64.3,67.6,61.5,00000
15.0,74.0,75.0,729,02,01,  Dakshin Raozan,527,318,262,134,265,184,62.4,66.2,59.0,00000
15.0,74.0,75.0,729,03,01,  Mohammadpur,2974,804,1421,347,1553,457,78.7,80.4,77.3,00000
15.0,74.0,75.0,729,04,01,  Mongalkhali,666,293,317,129,349,164,69.4,71.1,68.0,00000
15.0,74.0,75.0,779,01,01,  Samshernagar,1311,2004,593,1051,718,953,39.5,36.1,43.0,00000
15.0,74.0,75.0,779,02,01,  Joynagar,1242,1311,685,792,557,519,48.6,46.4,51.8,00000
15.0,74.0,88.0,696,01,01,  Kitohiparghona,766,543,372,274,394,269,58.5,57.6,59.4,00000
15.0,74.0,88.0,696,02,01,  Mirapara,990,474,476,221,514,253,67.6,68.3,67.0,00000
15.0,74.0,88.0,696,03,01,  Paschim Guzara(Aburkhil),1546,761,790,313,756,448,67.0,71.6,62.8,00000
15.0,74.0,88.0,945,01,01,  Uttar Urkirchar,2511,1163,1190,521,1321,642,68.3,69.5,67.3,00000
15.0,74.0,88.0,945,02,01,  Dakshin Urkirchar,1170,740,593,375,577,365,61.3,61.3,61.3,00000
15.0,74.0,88.0,945,03,01,  Purba Urkirchar,1000,401,467,195,533,206,71.4,70.5,72.1,00000
15.0,82.0,12.0,052,01,01,  Amilais,1499,2069,762,1004,737,1065,42.0,43.1,40.9,00000
15.0,82.0,12.0,052,02,01,  Dakshin Amilais,453,423,220,191,233,232,51.7,53.5,50.1,00000
15.0,82.0,12.0,308,01,01,  Purba Dalu,408,642,198,290,210,352,38.9,40.6,37.4,00000
15.0,82.0,12.0,308,02,01,  Paschim Dalu,784,979,406,459,378,520,44.5,46.9,42.1,00000
15.0,82.0,21.0,114,01,01,  Paschim Bazalia,1885,1277,956,584,929,693,59.6,62.1,57.3,00000
15.0,82.0,21.0,114,02,01,  Purba Bazalia,3846,2135,1995,944,1851,1191,64.3,67.9,60.8,00000
15.0,82.0,29.0,202,01,01,  Dwip Charati,1585,1609,796,816,789,793,49.6,49.4,49.9,00000
15.0,82.0,29.0,202,02,01,  Pani Charati,211,269,91,123,120,146,44.0,42.5,45.1,00000
15.0,82.0,29.0,202,03,01,  Madhya Charati,557,729,277,366,280,363,43.3,43.1,43.5,00000
15.0,82.0,29.0,202,04,01,  Dakshin Charati,1914,2809,911,1328,1003,1481,40.5,40.7,40.4,00000
15.0,82.0,29.0,959,01,01,  Dakshin Tulatali,1765,824,849,349,916,475,68.2,70.9,65.9,00000
15.0,82.0,29.0,959,02,01,  Uttar Tulatali,774,1004,359,518,415,486,43.5,40.9,46.1,00000
15.0,82.0,51.0,510,01,01,  Dakshin Kanchana,3489,2777,1648,1318,1841,1459,55.7,55.6,55.8,00000
15.0,82.0,51.0,510,02,01,  Madhya Kanchana,2626,2110,1130,1007,1496,1103,55.4,52.9,57.6,00000
15.0,82.0,51.0,510,03,01,  Uttar Kanchana,2868,3810,1268,1792,1600,2018,42.9,41.4,44.2,00000
15.0,82.0,54.0,545,01,01,  Keochia,2847,2845,1284,1350,1563,1495,50.0,48.7,51.1,00000
15.0,82.0,54.0,545,02,01,  Keochia Baitalizzat(Bdr Stn.),1303,179,1045,90,258,89,87.9,92.1,74.4,00000
15.0,82.0,69.0,678,01,01,  Uttar Marfala,1911,1449,902,658,1009,791,56.9,57.8,56.1,00000
15.0,82.0,69.0,678,02,01,  Dakshin Marfala,412,316,206,143,206,173,56.6,59.0,54.4,00000
15.0,82.0,69.0,686,01,01,  Purba Nalua,1047,1107,445,513,602,594,48.6,46.5,50.3,00000
15.0,82.0,69.0,686,02,01,  Madhya Nalua,751,734,351,350,400,384,50.6,50.1,51.0,00000
15.0,82.0,69.0,686,03,01,  Paschim Nalua,654,900,264,423,390,477,42.1,38.4,45.0,00000
15.0,86.0,16.0,089,01,01,  Uttar Banshbaria,3989,2708,2074,1222,1915,1486,59.6,62.9,56.3,00000
15.0,86.0,16.0,089,02,01,  Sikdarpara,588,742,320,331,268,411,44.2,49.2,39.5,00000
15.0,86.0,16.0,089,03,01,  Mill Area,762,339,492,192,270,147,69.2,71.9,64.7,00000
15.0,86.0,16.0,089,04,01,  South Banshbaria,2197,2096,1145,976,1052,1120,51.2,54.0,48.4,00000
15.0,86.0,16.0,089,05,01,  Boaliakul,773,819,401,403,372,416,48.6,49.9,47.2,00000
15.0,86.0,16.0,089,06,01,  Jomadarpara,369,216,191,118,178,98,63.1,61.8,64.5,00000
15.0,86.0,16.0,089,07,01,  Akil Pur,963,1310,477,645,486,665,42.4,42.5,42.2,00000
15.0,86.0,19.0,490,01,01,  Uttar Mahmudabad,3152,2179,1627,998,1525,1181,59.1,62.0,56.4,00000
15.0,86.0,19.0,490,02,01,  Hatiloda,731,575,370,249,361,326,56.0,59.8,52.5,00000
15.0,86.0,19.0,490,03,01,  Ali Chowdhury Para,732,587,474,311,258,276,55.5,60.4,48.3,00000
15.0,86.0,19.0,490,04,01,  Voyer Khil,615,525,319,243,296,282,53.9,56.8,51.2,00000
15.0,86.0,19.0,490,05,01,  Antapur,1290,1141,855,684,435,457,53.1,55.6,48.8,00000
15.0,86.0,19.0,549,01,01,  Olinagar,656,583,311,268,345,315,52.9,53.7,52.3,00000
15.0,86.0,19.0,549,02,01,  Jamadarpara,704,860,360,431,344,429,45.0,45.5,44.5,00000
15.0,86.0,19.0,801,01,01,  Nath Para,703,376,378,160,325,216,65.2,70.3,60.1,00000
15.0,86.0,19.0,801,02,01,  Dakshin Mahmudpur,2565,3619,1269,1761,1296,1858,41.5,41.9,41.1,00000
15.0,86.0,19.0,801,03,01,  Charail Kandi,541,467,284,198,257,269,53.7,58.9,48.9,00000
15.0,86.0,19.0,801,04,01,  Nadali Para,1049,934,545,466,504,468,52.9,53.9,51.9,00000
15.0,86.0,19.0,801,05,01,  Boali Para,120,371,57,178,63,193,24.4,24.3,24.6,00000
15.0,86.0,28.0,237,01,01,  Dakshin Terial,679,679,361,276,318,403,50.0,56.7,44.1,00000
15.0,86.0,28.0,237,02,01,  Purba Lalanagar,1745,1098,914,457,831,641,61.4,66.7,56.5,00000
15.0,86.0,28.0,237,03,01,  Pashim Lalanagar,1393,1564,684,689,709,875,47.1,49.8,44.8,00000
15.0,86.0,28.0,980,01,01,  Ramhat Nagar,402,281,195,108,207,173,58.9,64.4,54.5,00000
15.0,86.0,28.0,980,02,01,  Uttar Terial,774,569,402,240,372,329,57.6,62.6,53.1,00000
15.0,86.0,28.0,980,03,01,  Dakshin Fedinagar,2761,1714,1392,772,1369,942,61.7,64.3,59.2,00000
15.0,86.0,28.0,980,04,01,  Uttar Fednagar,494,157,243,62,251,95,75.9,79.7,72.5,00000
15.0,86.0,38.0,133,01,01,  Bhatiari,14295,8494,8072,4374,6223,4120,62.7,64.9,60.2,00000
15.0,86.0,38.0,133,02,01,  Imam Nagar,2460,1543,1341,753,1119,790,61.5,64.0,58.6,00000
15.0,86.0,38.0,341,01,01,  Jahanabad,4037,3306,2497,1981,1540,1325,55.0,55.8,53.8,00000
15.0,86.0,38.0,341,02,01,  Kadam Rosul,3274,1828,2258,1043,1016,785,64.2,68.4,56.4,00000
15.0,86.0,57.0,118,01,01,  Bhater Khil,2029,2111,973,1017,1056,1094,49.0,48.9,49.1,00000
15.0,86.0,57.0,118,02,01,  Bosoratnagar,751,574,394,252,357,322,56.7,61.0,52.6,00000
15.0,86.0,57.0,200,01,01,  Goptakhali,731,695,376,304,355,391,51.3,55.3,47.6,00000
15.0,86.0,57.0,200,02,01,  Hasanabad,468,567,230,265,238,302,45.2,46.5,44.1,00000
15.0,86.0,57.0,772,01,01,  Purba Muradpur,4885,3137,2580,1434,2305,1703,60.9,64.3,57.5,00000
15.0,86.0,57.0,772,02,01,  Paschim Muradpur,2928,1962,1395,888,1533,1074,59.9,61.1,58.8,00000
15.0,86.0,85.0,891,01,01,  Sitalpur,3836,2966,2328,1686,1508,1280,56.4,58.0,54.1,00000
15.0,86.0,85.0,891,02,01,  Dakshin Sitalpur,2050,1015,1360,572,690,443,66.9,70.4,60.9,00000
15.0,86.0,95.0,044,01,01,  Uttar Bagachatar,2322,1236,1099,535,1223,701,65.3,67.3,63.6,00000
15.0,86.0,95.0,044,02,01,  Dakshin Bagachatar,1703,800,803,326,900,474,68.0,71.1,65.5,00000
15.0,86.0,95.0,059,01,01,  Moha Nagar,1780,932,852,401,928,531,65.6,68.0,63.6,00000
15.0,86.0,95.0,059,02,01,  Bag Khali,2442,2681,1136,1196,1306,1485,47.7,48.7,46.8,00000
15.0,86.0,95.0,816,01,01,  Purba Saidpur,1705,1569,822,718,883,851,52.1,53.4,50.9,00000
15.0,86.0,95.0,816,02,01,  Pashim Saidpur,2236,2305,1077,1070,1159,1235,49.2,50.2,48.4,00000
84.0,7.0,10.0,026,01,01,  Amtali Bazar,153,84,83,41,70,43,64.6,66.9,61.9,00000
84.0,7.0,10.0,026,02,01,  Aziz Pradan Para,115,97,73,51,42,46,54.2,58.9,47.7,00000
84.0,7.0,10.0,026,03,01,  Churakhali,192,194,104,92,88,102,49.7,53.1,46.3,00000
84.0,7.0,10.0,026,04,01,  Chand Mia Sarder Para,104,52,54,26,50,26,66.7,67.5,65.8,00000
84.0,7.0,10.0,026,05,01,  Khirar Char,128,96,70,37,58,59,57.1,65.4,49.6,00000
84.0,7.0,10.0,026,06,01,  Master Para-1,105,41,73,22,32,19,71.9,76.8,62.7,00000
84.0,7.0,10.0,026,07,01,  Imam Para,137,89,75,39,62,50,60.6,65.8,55.4,00000
84.0,7.0,10.0,026,08,01,  Purba Amtali,88,110,54,52,34,58,44.4,50.9,37.0,00000
84.0,7.0,10.0,026,09,01,  Mahila Bazar,62,149,34,70,28,79,29.4,32.7,26.2,00000
84.0,7.0,10.0,026,10,01,  Kabir Pur,113,156,74,60,39,96,42.0,55.2,28.9,00000
84.0,7.0,10.0,026,11,01,  Ali Nagar,87,162,54,71,33,91,34.9,43.2,26.6,00000
84.0,7.0,10.0,026,12,01,  Nutan Bazar Area,91,80,48,41,43,39,53.2,53.9,52.4,00000
84.0,7.0,10.0,026,13,01,  Habib Para,123,59,60,31,63,28,67.6,65.9,69.2,00000
84.0,7.0,10.0,026,14,01,  14 No. Para,161,62,91,25,70,37,72.2,78.4,65.4,00000
84.0,7.0,10.0,026,15,01,  Pakua Khali,144,210,65,103,79,107,40.7,38.7,42.5,00000
84.0,7.0,10.0,026,16,01,  Choto Mahilla,59,69,32,35,27,34,46.1,47.8,44.3,00000
84.0,7.0,10.0,026,17,01,  Islampur-2,120,65,66,27,54,38,64.9,71.0,58.7,00000
84.0,7.0,10.0,026,18,01,  Master Para-2,20,8,11,6,9,2,71.4,64.7,81.8,00000
84.0,7.0,11.0,052,01,01,  Baghai Chhari (Part),238,122,130,49,108,73,66.1,72.6,59.7,00000
84.0,7.0,11.0,052,02,01,  Son Khala Adam,56,139,43,71,13,68,28.7,37.7,16.0,00000
84.0,7.0,11.0,052,03,01,  Jibtali,239,149,128,60,111,89,61.6,68.1,55.5,00000
84.0,7.0,11.0,052,04,01,  Talukdar Para,186,38,93,13,93,25,83.0,87.7,78.8,00000
84.0,7.0,11.0,052,05,01,  Ugal Chari,271,259,155,114,116,145,51.1,57.6,44.4,00000
84.0,7.0,11.0,052,06,01,  Haji Sonamiah Para,83,80,41,40,42,40,50.9,50.6,51.2,00000
84.0,7.0,11.0,052,07,01,  Kaji Yonus Para,58,48,25,27,33,21,54.7,48.1,61.1,00000
84.0,7.0,11.0,052,08,01,  Bapari Para,43,136,24,66,19,70,24.0,26.7,21.3,00000
84.0,7.0,11.0,052,09,01,  Haji Mukter Hossain,109,54,55,28,54,26,66.9,66.3,67.5,00000
84.0,7.0,11.0,052,10,01,  Nutun Para,55,51,28,27,27,24,51.9,50.9,52.9,00000
84.0,7.0,11.0,052,11,01,  New Laillagonghona,115,90,70,33,45,57,56.1,68.0,44.1,00000
84.0,7.0,11.0,052,12,01,  New Morgona Para,145,176,83,81,62,95,45.2,50.6,39.5,00000
84.0,7.0,11.0,052,13,01,  10.No Rabar Bagan,128,95,74,39,54,56,57.4,65.5,49.1,00000
84.0,7.0,11.0,052,14,01,  2 No.Rabar Bagan,113,84,72,30,41,54,57.4,70.6,43.2,00000
84.0,7.0,11.0,052,15,01,  Madhya Baghai Chhar (Part),62,16,36,6,26,10,79.5,85.7,72.2,00000
84.0,7.0,11.0,052,16,01,  Lord Ban,146,196,88,98,58,98,42.7,47.3,37.2,00000
84.0,7.0,11.0,261,01,01,  Balpeya,23,210,17,102,6,108,9.9,14.3,5.3,00000
84.0,7.0,11.0,261,02,01,  Lum Para,29,31,17,9,12,22,48.3,65.4,35.3,00000
84.0,7.0,11.0,261,03,01,  Dozhar Bazar,111,82,79,38,32,44,57.5,67.5,42.1,00000
84.0,7.0,11.0,261,04,01,  Hati Mara,42,126,30,54,12,72,25.0,35.7,14.3,00000
84.0,7.0,11.0,261,05,01,  Panchari,143,174,109,60,34,114,45.1,64.5,23.0,00000
84.0,7.0,11.0,261,06,01,  Porchim Gova Chari,30,89,20,40,10,49,25.2,33.3,16.9,00000
84.0,7.0,11.0,261,07,01,  Halut Kota,96,136,78,65,18,71,41.4,54.5,20.2,00000
84.0,7.0,11.0,261,08,01,  Kutira Chara,25,40,19,15,6,25,38.5,55.9,19.4,00000
84.0,7.0,11.0,261,09,01,  Dulu Banna,36,128,27,62,9,66,22.0,30.3,12.0,00000
84.0,7.0,11.0,261,10,01,  Dosar Para,85,211,61,95,24,116,28.7,39.1,17.1,00000
84.0,7.0,11.0,261,11,01,  Buya Chara,49,271,34,125,15,146,15.3,21.4,9.3,00000
84.0,7.0,11.0,261,12,01,  Prba Gova Chari,63,99,41,44,22,55,38.9,48.2,28.6,00000
84.0,7.0,11.0,261,13,01,  Maydda Gova Chari,26,90,19,40,7,50,22.4,32.2,12.3,00000
84.0,7.0,11.0,261,14,01,  Milon Para,32,207,17,102,15,105,13.4,14.3,12.5,00000
84.0,7.0,11.0,261,15,01,  Uttar Bopo Khuchari,74,99,48,43,26,56,42.8,52.7,31.7,00000
84.0,7.0,11.0,261,16,01,  Dukhin Boro Khuchari,142,264,92,113,50,151,35.0,44.9,24.9,00000
84.0,7.0,11.0,261,17,01,  Budunga Chara,61,92,46,43,15,49,39.9,51.7,23.4,00000
84.0,7.0,11.0,261,18,01,  Nava Chari,30,71,19,34,11,37,29.7,35.8,22.9,00000
84.0,7.0,11.0,261,19,01,  Ulta Chari,16,69,13,34,3,35,18.8,27.7,7.9,00000
84.0,7.0,11.0,261,20,01,  Mondira Chara,13,23,11,8,2,15,36.1,57.9,11.8,00000
84.0,7.0,11.0,732,01,01,  Murghuna Chhara,139,127,88,47,51,80,52.3,65.2,38.9,00000
84.0,7.0,11.0,732,02,01,  Ugal Chhari Mukh,281,158,164,58,117,100,64.0,73.9,53.9,00000
84.0,7.0,11.0,732,03,01,  Chhot Kocho Chhari,48,67,27,32,21,35,41.7,45.8,37.5,00000
84.0,7.0,11.0,732,04,01,  Lomba Chhara,146,106,100,40,46,66,57.9,71.4,41.1,00000
84.0,7.0,11.0,732,05,01,  Newlaillaghona,67,26,43,9,24,17,72.0,82.7,58.5,00000
84.0,7.0,11.0,732,06,01,  Purba Lalla Gona,119,41,71,6,48,35,74.4,92.2,57.8,00000
84.0,7.0,23.0,105,01,01,  Bimol Kanti Karbari Para,41,99,34,43,7,56,29.3,44.2,11.1,00000
84.0,7.0,23.0,105,02,01,  Bijoylal Karbari Para,75,57,42,24,33,33,56.8,63.6,50.0,00000
84.0,7.0,23.0,105,03,01,  Gola Para,20,111,13,47,7,64,15.3,21.7,9.9,00000
84.0,7.0,23.0,105,04,01,  Hati Mara Para,22,47,18,18,4,29,31.9,50.0,12.1,00000
84.0,7.0,23.0,105,05,01,  Purnadhan Para,144,282,98,115,46,167,33.8,46.0,21.6,00000
84.0,7.0,23.0,105,06,01,  Atulbikash Para,100,322,63,148,37,174,23.7,29.9,17.5,00000
84.0,7.0,23.0,105,07,01,  Sisutali Para,22,117,17,55,5,62,15.8,23.6,7.5,00000
84.0,7.0,23.0,105,08,01,  Santos Bikas Karbari Para,96,340,62,168,34,172,22.0,27.0,16.5,00000
84.0,7.0,23.0,105,09,01,  Lalitchandra Para,99,133,63,48,36,85,42.7,56.8,29.8,00000
84.0,7.0,23.0,105,10,01,  Subaranjan Para,59,138,36,54,23,84,29.9,40.0,21.5,00000
84.0,7.0,23.0,105,11,01,  Nabobihari Para,72,127,37,62,35,65,36.2,37.4,35.0,00000
84.0,7.0,23.0,105,12,01,  Nigira Sen Para,63,78,40,28,23,50,44.7,58.8,31.5,00000
84.0,7.0,23.0,105,13,01,  Provu Ranjan Karbari Para,123,104,71,47,52,57,54.2,60.2,47.7,00000
84.0,7.0,23.0,105,14,01,  Budda Sanker Karbari Para,102,204,59,90,43,114,33.3,39.6,27.4,00000
84.0,7.0,23.0,105,15,01,  Headman Para,62,42,42,16,20,26,59.6,72.4,43.5,00000
84.0,7.0,23.0,105,16,01,  Purnalal Para,103,70,61,30,42,40,59.5,67.0,51.2,00000
84.0,7.0,23.0,105,17,01,  Sunil Bikash Para,110,104,70,43,40,61,51.4,61.9,39.6,00000
84.0,7.0,23.0,105,18,01,  Henanda Karbary Par,256,303,143,149,113,154,45.8,49.0,42.3,00000
84.0,7.0,23.0,105,19,01,  Korengatali Bazar,405,443,242,229,163,214,47.8,51.4,43.2,00000
84.0,7.0,23.0,105,20,01,  Bisnasur Para,26,243,17,122,9,121,9.7,12.2,6.9,00000
84.0,7.0,23.0,105,21,01,  Audid Karbari Para,68,183,49,78,19,105,27.1,38.6,15.3,00000
84.0,7.0,23.0,105,22,01,  Gaino Karbari Para,55,118,32,55,23,63,31.8,36.8,26.7,00000
84.0,7.0,23.0,837,01,01,  Satya Karbari Para,193,135,106,51,87,84,58.8,67.5,50.9,00000
84.0,7.0,23.0,837,02,01,  Kattali,301,319,160,158,141,161,48.5,50.3,46.7,00000
84.0,7.0,23.0,837,03,01,  Kaminy Ranjan Para,89,170,60,78,29,92,34.4,43.5,24.0,00000
84.0,7.0,23.0,837,04,01,  Susendra Lal Para,308,286,193,130,115,156,51.9,59.8,42.4,00000
84.0,7.0,23.0,837,05,01,  Bijoysen Para,231,190,131,85,100,105,54.9,60.6,48.8,00000
84.0,7.0,23.0,837,06,01,  Rabidash Para,156,166,104,66,52,100,48.4,61.2,34.2,00000
84.0,7.0,23.0,837,07,01,  Banoulal Para,102,310,59,164,43,146,24.8,26.5,22.8,00000
84.0,7.0,23.0,837,08,01,  Nagar Prasad Karbari Para,187,271,113,129,74,142,40.8,46.7,34.3,00000
84.0,7.0,35.0,785,01,01,  Dakhin Sisak,405,267,243,102,162,165,60.3,70.4,49.5,00000
84.0,7.0,35.0,785,02,01,  Mahish Parja,142,146,84,57,58,89,49.3,59.6,39.5,00000
84.0,7.0,35.0,785,03,01,  Uttar Sarboatali,134,302,85,127,49,175,30.7,40.1,21.9,00000
84.0,7.0,35.0,785,04,01,  Chintaram Chhara,178,52,111,18,67,34,77.4,86.0,66.3,00000
84.0,7.0,35.0,785,05,01,  Jarul Bagan,68,58,38,25,30,33,54.0,60.3,47.6,00000
84.0,7.0,35.0,785,06,01,  Tangguma Muk,62,64,30,31,32,33,49.2,49.2,49.2,00000
84.0,7.0,35.0,785,07,01,  Kumra Aruk Chara,53,141,31,65,22,76,27.3,32.3,22.4,00000
84.0,7.0,35.0,785,08,01,  Sisak Khagra Chari,154,207,97,95,57,112,42.7,50.5,33.7,00000
84.0,7.0,35.0,785,09,01,  Mautang Muk,91,281,63,133,28,148,24.5,32.1,15.9,00000
84.0,7.0,35.0,785,10,01,  Dakhin Sarboatali,300,257,183,107,117,150,53.9,63.1,43.8,00000
84.0,7.0,35.0,785,11,01,  Dakaj Mara Chara,28,58,11,29,17,29,32.6,27.5,37.0,00000
84.0,7.0,35.0,785,12,01,  Uttar Khagra Chari,234,346,140,162,94,184,40.3,46.4,33.8,00000
84.0,7.0,35.0,785,13,01,  Chura Khali (Dosar),12,219,10,109,2,110,5.2,8.4,1.8,00000
84.0,7.0,35.0,785,14,01,  Uttar Sisak,322,232,203,93,119,139,58.1,68.6,46.1,00000
84.0,7.0,35.0,785,15,01,  Gola Chari,98,147,58,65,40,82,40.0,47.2,32.8,00000
84.0,7.0,35.0,785,16,01,  Shel Chari,127,156,72,63,55,93,44.9,53.3,37.2,00000
84.0,7.0,35.0,785,17,01,  Joyta Khamar,58,178,35,84,23,94,24.6,29.4,19.7,00000
84.0,7.0,35.0,785,18,01,  Dakhin Khagrachari,271,304,165,125,106,179,47.1,56.9,37.2,00000
84.0,7.0,35.0,785,19,01,  Ulta Chari,53,131,37,59,16,72,28.8,38.5,18.2,00000
84.0,7.0,35.0,785,20,01,  Uchang Chari,90,149,57,58,33,91,37.7,49.6,26.6,00000
84.0,7.0,35.0,785,21,01,  Mantang,56,157,40,75,16,82,26.3,34.8,16.3,00000
84.0,7.0,35.0,785,22,01,  Talukdar Para,165,81,104,26,61,55,67.1,80.0,52.6,00000
84.0,7.0,35.0,785,23,01,  Korolla Chari,44,32,26,14,18,18,57.9,65.0,50.0,00000
84.0,7.0,35.0,785,24,01,  Pera Chara,208,261,125,115,83,146,44.3,52.1,36.2,00000
84.0,7.0,35.0,785,25,01,  Pakuya Khali,29,64,21,27,8,37,31.2,43.8,17.8,00000
84.0,7.0,35.0,785,26,01,  Nutan Para,85,159,53,81,32,78,34.8,39.6,29.1,00000
84.0,7.0,35.0,785,27,01,  Horinat Chara,12,81,9,41,3,40,12.9,18.0,7.0,00000
84.0,7.0,35.0,785,28,01,  Thana Chandra Karbari Para,225,445,149,197,76,248,33.6,43.1,23.5,00000
84.0,7.0,47.0,419,01,01,  Pachin Kedarmar,212,49,118,19,94,30,81.2,86.1,75.8,00000
84.0,7.0,47.0,419,02,01,  Guilla Karbari Para,100,149,58,70,42,79,40.2,45.3,34.7,00000
84.0,7.0,47.0,419,03,01,  Durchari Bazar Area,1132,317,650,153,482,164,78.1,80.9,74.6,00000
84.0,7.0,47.0,419,04,01,  Dakshin Pablakhali,159,280,104,120,55,160,36.2,46.4,25.6,00000
84.0,7.0,47.0,419,05,01,  Mannayram Para,115,233,73,92,42,141,33.0,44.2,23.0,00000
84.0,7.0,47.0,419,06,01,  Purba Khedarmara,216,192,133,80,83,112,52.9,62.4,42.6,00000
84.0,7.0,47.0,419,07,01,  Uttar Hirar Char,57,171,37,77,20,94,25.0,32.5,17.5,00000
84.0,7.0,47.0,419,08,01,  Rangadur Chhari,209,438,135,198,74,240,32.3,40.5,23.6,00000
84.0,7.0,47.0,419,09,01,  Uttar Pablakhali,272,293,143,125,129,168,48.1,53.4,43.4,00000
84.0,7.0,47.0,419,10,01,  Madhym Pabla Khali,126,316,72,148,54,168,28.5,32.7,24.3,00000
84.0,7.0,47.0,419,11,01,  Dakhin Hirar Char,238,256,132,101,106,155,48.2,56.7,40.6,00000
84.0,7.0,47.0,419,12,01,  Islamabad,67,82,34,47,33,35,45.0,42.0,48.5,00000
84.0,7.0,47.0,942,01,01,  Ulu Chhari,85,104,52,48,33,56,45.0,52.0,37.1,00000
84.0,7.0,47.0,942,02,01,  Headman Para,56,120,37,58,19,62,31.8,38.9,23.5,00000
84.0,7.0,47.0,942,03,01,  Pagza Chhari,11,51,6,23,5,28,17.7,20.7,15.2,00000
84.0,7.0,47.0,942,04,01,  Rabar Bagan,34,158,24,79,10,79,17.7,23.3,11.2,00000
84.0,7.0,47.0,942,05,01,  Deva Chhari,122,180,79,76,43,104,40.4,51.0,29.3,00000
84.0,7.0,47.0,942,06,01,  Sheelkata Chhara,95,162,58,68,37,94,37.0,46.0,28.2,00000
84.0,7.0,47.0,942,07,01,  Master Para,155,110,81,46,74,64,58.5,63.8,53.6,00000
84.0,7.0,47.0,942,08,01,  Nalbunia Para,369,413,217,157,152,256,47.2,58.0,37.3,00000
84.0,7.0,47.0,942,09,01,  Bara Durchari Para,224,365,136,153,88,212,38.0,47.1,29.3,00000
84.0,7.0,59.0,523,01,03,  Kadamtali Para,182,373,107,181,75,192,32.8,37.2,28.1,00000
84.0,7.0,59.0,523,02,03,  Mattachadar Para,153,133,78,61,75,72,53.5,56.1,51.0,00000
84.0,7.0,59.0,523,03,03,  Tripura Para,69,112,44,50,25,62,38.1,46.8,28.7,00000
84.0,7.0,59.0,523,04,03,  Pitti Para,72,62,44,27,28,35,53.7,62.0,44.4,00000
84.0,7.0,59.0,523,05,03,  Shashimohan Para,71,24,34,13,37,11,74.7,72.3,77.1,00000
84.0,7.0,59.0,523,06,03,  Mahajan Para,90,34,50,10,40,24,72.6,83.3,62.5,00000
84.0,7.0,59.0,523,07,03,  Headman Para,122,49,64,18,58,31,71.3,78.0,65.2,00000
84.0,7.0,59.0,523,08,03,  Dakhin Baggona,65,47,39,18,26,29,58.0,68.4,47.3,00000
84.0,7.0,59.0,523,09,03,  Fullershwar Karbari,51,60,30,24,21,36,45.9,55.6,36.8,00000
84.0,7.0,59.0,523,10,03,  Uttar Baghai Chhari,89,53,53,22,36,31,62.7,70.7,53.7,00000
84.0,7.0,59.0,523,11,03,  Khader Chara,73,191,45,90,28,101,27.7,33.3,21.7,00000
84.0,7.0,59.0,523,12,03,  Marichaban Chara,46,114,26,52,20,62,28.8,33.3,24.4,00000
84.0,7.0,59.0,523,13,03,  Bhuiya Chara,68,307,51,158,17,149,18.1,24.4,10.2,00000
84.0,7.0,59.0,523,14,03,  Ranjan Para,40,94,27,45,13,49,29.9,37.5,21.0,00000
84.0,7.0,59.0,523,15,03,  Samatri Para,109,70,64,29,45,41,60.9,68.8,52.3,00000
84.0,7.0,59.0,523,16,03,  Darjiling Para,39,95,19,49,20,46,29.1,27.9,30.3,00000
84.0,7.0,59.0,523,17,03,  Kaijee Para,47,99,30,40,17,59,32.2,42.9,22.4,00000
84.0,7.0,59.0,523,18,03,  Bepari Para (Part),84,158,40,80,44,78,34.7,33.3,36.1,00000
84.0,7.0,59.0,523,19,03,  Matbar Para(Part),33,80,15,39,18,41,29.2,27.8,30.5,00000
84.0,7.0,59.0,523,20,03,  Munshi Para(Part),136,116,75,53,61,63,54.0,58.6,49.2,00000
84.0,7.0,59.0,523,21,03,  Sarker Para(Part),46,65,28,25,18,40,41.4,52.8,31.0,00000
84.0,7.0,59.0,523,22,03,  Imam Para(Part),52,53,30,22,22,31,49.5,57.7,41.5,00000
84.0,7.0,71.0,158,01,03,  Kamini Kishore K.Pa,12,49,7,23,5,26,19.7,23.3,16.1,00000
84.0,7.0,71.0,158,02,03,  Full Binna Para,14,61,8,34,6,27,18.7,19.0,18.2,00000
84.0,7.0,71.0,158,03,03,  Pakujja Chari Para,146,220,90,93,56,127,39.9,49.2,30.6,00000
84.0,7.0,71.0,158,04,03,  Gola Chari Para,89,150,58,65,31,85,37.2,47.2,26.7,00000
84.0,7.0,71.0,158,05,03,  Paschim Lalla Gona,45,66,27,36,18,30,40.5,42.9,37.5,00000
84.0,7.0,71.0,158,06,03,  Nalkata Chara,103,138,75,53,28,85,42.7,58.6,24.8,00000
84.0,7.0,71.0,628,01,01,  Rupkari Muslim Block,72,139,41,69,31,70,34.1,37.3,30.7,00000
84.0,7.0,71.0,628,02,01,  Baradom Para,343,379,194,156,149,223,47.5,55.4,40.1,00000
84.0,7.0,71.0,628,03,01,  Dukhaia Para,143,42,82,13,61,29,77.3,86.3,67.8,00000
84.0,7.0,71.0,628,04,01,  Golachhari Para,206,158,118,68,88,90,56.6,63.4,49.4,00000
84.0,7.0,71.0,628,05,01,  Gobogona Para,50,103,31,48,19,55,32.7,39.2,25.7,00000
84.0,7.0,71.0,628,06,01,  Morogona Para,56,71,33,32,23,39,44.1,50.8,37.1,00000
84.0,7.0,71.0,628,07,01,  Mogban Para,407,219,279,86,128,133,65.0,76.4,49.0,00000
84.0,7.0,71.0,628,08,01,  Takta Nala,45,36,27,12,18,24,55.6,69.2,42.9,00000
84.0,7.0,71.0,628,09,01,  Vokta Para,11,29,6,13,5,16,27.5,31.6,23.8,00000
84.0,7.0,71.0,628,10,01,  Parchim Master Para,46,96,23,45,23,51,32.4,33.8,31.1,00000
84.0,7.0,71.0,628,11,01,  Dhan Pata,44,79,28,35,16,44,35.8,44.4,26.7,00000
84.0,7.0,71.0,628,12,01,  Maich Chari Para,53,59,27,33,26,26,47.3,45.0,50.0,00000
84.0,7.0,71.0,628,13,01,  Milon Para,34,51,28,22,6,29,40.0,56.0,17.1,00000
84.0,7.0,83.0,209,01,01,  Bolpaya Para,7,53,4,27,3,26,11.7,12.9,10.3,00000
84.0,7.0,83.0,209,02,01,  Jaipul Para,11,81,7,34,4,47,12.0,17.1,7.8,00000
84.0,7.0,83.0,209,03,01,  Tarun Para,0,64,0,35,0,29,0.0,0.0,0.0,00000
84.0,7.0,83.0,209,04,01,  Badal Chari,0,23,0,11,0,12,0.0,0.0,0.0,00000
84.0,7.0,83.0,209,05,01,  Natun Japui Para,5,82,5,41,0,41,5.7,10.9,0.0,00000
84.0,7.0,83.0,209,06,01,  Kadam Tali Para,0,14,0,6,0,8,0.0,0.0,0.0,00000
84.0,7.0,83.0,209,07,01,  Udal Chari Para,27,90,21,40,6,50,23.1,34.4,10.7,00000
84.0,7.0,83.0,209,08,01,  Ut Chari,0,23,0,15,0,8,0.0,0.0,0.0,00000
84.0,7.0,83.0,209,09,01,  Betling Headman,19,148,16,85,3,63,11.4,15.8,4.5,00000
84.0,7.0,83.0,209,10,01,  Nutun Para,11,105,9,51,2,54,9.5,15.0,3.6,00000
84.0,7.0,83.0,314,01,01,  Baghaihat Bazar Ela,247,10,236,6,11,4,96.1,97.5,73.3,00000
84.0,7.0,83.0,314,02,01,  Thal Chara,7,59,7,29,0,30,10.6,19.4,0.0,00000
84.0,7.0,83.0,314,03,01,  Baghaihat Gangara,148,195,124,83,24,112,43.1,59.9,17.6,00000
84.0,7.0,83.0,314,04,01,  Dulu Chari,20,113,13,56,7,57,15.0,18.8,10.9,00000
84.0,7.0,83.0,314,05,01,  Baghaihat Hazachar,99,228,62,112,37,116,30.3,35.6,24.2,00000
84.0,7.0,83.0,314,06,01,  Alam Dipu,24,159,18,85,6,74,13.1,17.5,7.5,00000
84.0,7.0,83.0,314,07,01,  Gas Kata Chara,23,182,19,81,4,101,11.2,19.0,3.8,00000
84.0,7.0,83.0,314,08,01,  D. Moshjid Para,31,37,17,19,14,18,45.6,47.2,43.8,00000
84.0,7.0,83.0,314,09,01,  Dakhin Karella Chari,20,86,12,41,8,45,18.9,22.6,15.1,00000
84.0,7.0,83.0,314,10,01,  Krleya Chari,44,71,31,28,13,43,38.3,52.5,23.2,00000
84.0,7.0,83.0,314,11,01,  Uttar Karella Chari,47,120,31,61,16,59,28.1,33.7,21.3,00000
84.0,7.0,83.0,314,12,01,  6no. Adarsha Para,192,123,126,54,66,69,61.0,70.0,48.9,00000
84.0,7.0,83.0,314,13,01,  Masslang Bazar,126,110,90,57,36,53,53.4,61.2,40.4,00000
84.0,7.0,83.0,314,14,01,  Dipu Para,89,84,81,37,8,47,51.4,68.6,14.5,00000
84.0,7.0,83.0,314,15,01,  Nuya Para(Guccagram),157,190,100,81,57,109,45.2,55.2,34.3,00000
84.0,7.0,83.0,314,16,01,  Milon Para,51,298,33,152,18,146,14.6,17.8,11.0,00000
84.0,7.0,83.0,314,17,01,  Kaba Cola Para,69,97,43,46,26,51,41.6,48.3,33.8,00000
84.0,7.0,83.0,314,18,01,  Lakshmi Chhari,75,63,67,27,8,36,54.3,71.3,18.2,00000
84.0,7.0,83.0,314,19,01,  Siduzza Chara,13,185,9,92,4,93,6.6,8.9,4.1,00000
84.0,7.0,83.0,314,20,01,  Haza Chara Para,32,54,26,15,6,39,37.2,63.4,13.3,00000
84.0,7.0,83.0,314,21,01,  Sodagi Chara,79,120,63,53,16,67,39.7,54.3,19.3,00000
84.0,7.0,83.0,314,22,01,  Rat Kata Chara Vitor,84,168,63,75,21,93,33.3,45.7,18.4,00000
84.0,7.0,83.0,314,23,01,  Rat Kata Muk,75,150,54,61,21,89,33.3,47.0,19.1,00000
84.0,7.0,83.0,314,24,01,  10.No. Para,119,151,85,71,34,80,44.1,54.5,29.8,00000
84.0,7.0,83.0,314,25,01,  Gangaram Bagghihat,19,43,14,19,5,24,30.6,42.4,17.2,00000
84.0,7.0,83.0,314,26,01,  Balu Ghat,56,69,31,26,25,43,44.8,54.4,36.8,00000
84.0,7.0,83.0,314,27,01,  Bamy Baibon Chara,161,351,109,164,52,187,31.4,39.9,21.8,00000
84.0,7.0,83.0,314,28,01,  Dinay Bayba Chara,119,320,87,165,32,155,27.1,34.5,17.1,00000
84.0,7.0,83.0,314,29,01,  Dochory Para,20,87,14,48,6,39,18.7,22.6,13.3,00000
84.0,7.0,83.0,314,30,01,  Dipu Para Masalong,42,53,28,22,14,31,44.2,56.0,31.1,00000
84.0,7.0,83.0,314,31,01,  Nursary Colony,50,67,33,33,17,34,42.7,50.0,33.3,00000
84.0,7.0,83.0,314,32,01,  Sagon Bagan,110,24,61,7,49,17,82.1,89.7,74.2,00000
84.0,7.0,83.0,314,33,01,  Samani More,6,56,4,28,2,28,9.7,12.5,6.7,00000
84.0,7.0,83.0,314,34,01,  Gohatta More,1,34,1,18,0,16,2.9,5.3,0.0,00000
84.0,7.0,83.0,314,35,01,  Samuk Chara,3,89,2,50,1,39,3.3,3.8,2.5,00000
84.0,7.0,83.0,314,36,01,  Bazar Colony Baghaihat,9,19,6,6,3,13,32.1,50.0,18.8,00000
84.0,7.0,83.0,314,37,01,  Bagai Hat Bazar,157,0,157,0,0,0,100.0,100.0,0.0,00000
84.0,7.0,83.0,314,38,01,  Muslim Para,46,30,37,15,9,15,60.5,71.2,37.5,00000
84.0,7.0,83.0,314,39,01,  Dubay Para,83,39,43,21,40,18,68.0,67.2,69.0,00000
84.0,7.0,83.0,314,40,01,  Challa Toly,59,103,46,39,13,64,36.4,54.1,16.9,00000
84.0,7.0,83.0,314,41,01,  Tal Komba,38,267,28,128,10,139,12.5,17.9,6.7,00000
84.0,7.0,83.0,314,42,01,  Purba Office Para,32,108,26,49,6,59,22.9,34.7,9.2,00000
84.0,7.0,83.0,314,43,01,  Aguagga Chari(Nandaram),86,242,57,117,29,125,26.2,32.8,18.8,00000
84.0,7.0,83.0,314,44,01,  Moga Chari,8,89,7,43,1,46,8.2,14.0,2.1,00000
84.0,7.0,83.0,314,45,01,  Dakhin Mela Chara,33,43,23,17,10,26,43.4,57.5,27.8,00000
84.0,7.0,83.0,314,46,01,  Uttar Mela Chara,48,84,37,32,11,52,36.4,53.6,17.5,00000
84.0,7.0,83.0,314,47,01,  Jame Chari,118,300,84,121,34,179,28.2,41.0,16.0,00000
84.0,7.0,83.0,314,48,01,  Ulta Chari,72,165,46,68,26,97,30.4,40.4,21.1,00000
84.0,7.0,83.0,314,49,01,  Koiji Chari,63,209,41,106,22,103,23.2,27.9,17.6,00000
84.0,7.0,83.0,314,50,01,  Kola Bonnya,41,156,30,69,11,87,20.8,30.3,11.2,00000
84.0,7.0,83.0,314,51,01,  Masalang Bazar Elaka,56,67,26,33,30,34,45.5,44.1,46.9,00000
84.0,7.0,83.0,314,52,01,  Durduri Chara,7,105,6,56,1,49,6.3,9.7,2.0,00000
84.0,7.0,83.0,314,53,01,  Langal Mara,124,291,79,148,45,143,29.9,34.8,23.9,00000
84.0,7.0,83.0,314,54,01,  Hati Mutani,17,101,16,42,1,59,14.4,27.6,1.7,00000
84.0,7.0,83.0,314,55,01,  Samba Tali,53,227,41,106,12,121,18.9,27.9,9.0,00000
84.0,7.0,83.0,314,56,01,  Golakna,31,75,17,35,14,40,29.2,32.7,25.9,00000
84.0,7.0,83.0,314,57,01,  Ulu Chara,71,185,48,89,23,96,27.7,35.0,19.3,00000
84.0,7.0,83.0,314,58,01,  Hugaya Tali,104,79,81,33,23,46,56.8,71.1,33.3,00000
84.0,7.0,83.0,314,59,01,  Fakira Colony,14,33,7,18,7,15,29.8,28.0,31.8,00000
84.0,7.0,83.0,314,60,01,  Uttar Baibon Chara,55,196,37,103,18,93,21.9,26.4,16.2,00000
84.0,7.0,83.0,314,61,01,  Dakhin Baibon Chara,29,142,18,73,11,69,17.0,19.8,13.8,00000
84.0,7.0,83.0,314,62,01,  Narai Chari,19,112,16,53,3,59,14.5,23.2,4.8,00000
84.0,7.0,83.0,314,63,01,  Updha Chari,16,127,13,65,3,62,11.2,16.7,4.6,00000
84.0,7.0,83.0,314,64,01,  Haja Chara,27,182,20,85,7,97,12.9,19.0,6.7,00000
84.0,7.0,83.0,314,65,01,  Agguzza Chari,43,171,36,81,7,90,20.1,30.8,7.2,00000
84.0,7.0,83.0,314,66,01,  Sinana Chara,16,39,13,18,3,21,29.1,41.9,12.5,00000
84.0,7.0,83.0,366,01,01,  Nul Karbari Para,4,33,3,12,1,21,10.8,20.0,4.5,00000
84.0,7.0,83.0,366,02,01,  Ranu Karbari Para,9,64,9,29,0,35,12.3,23.7,0.0,00000
84.0,7.0,83.0,366,03,01,  Kanglak Headman Para,55,18,29,7,26,11,75.3,80.6,70.3,00000
84.0,7.0,83.0,366,04,01,  Pailong Para,13,94,11,42,2,52,12.1,20.8,3.7,00000
84.0,7.0,83.0,366,05,01,  Dulu Chari Para,228,909,157,430,71,479,20.1,26.7,12.9,00000
84.0,7.0,83.0,366,06,01,  Natun Para,4,79,4,38,0,41,4.8,9.5,0.0,00000
84.0,7.0,83.0,366,07,01,  Sota Kanglang Para,29,54,23,27,6,27,34.9,46.0,18.2,00000
84.0,7.0,83.0,366,08,01,  Udyapure Para,103,126,66,50,37,76,45.0,56.9,32.7,00000
84.0,7.0,83.0,366,09,01,  Boro Kanglak,53,55,37,24,16,31,49.1,60.7,34.0,00000
84.0,7.0,83.0,471,01,01,  Rangrang Chhara Par,16,124,12,61,4,63,11.4,16.4,6.0,00000
84.0,7.0,83.0,471,02,01,  Hatupara,4,83,2,42,2,41,4.6,4.5,4.7,00000
84.0,7.0,83.0,471,03,01,  Lambachara Para,27,191,26,94,1,97,12.4,21.7,1.0,00000
84.0,7.0,83.0,471,04,01,  Deba Chhara,8,95,8,47,0,48,7.8,14.5,0.0,00000
84.0,7.0,83.0,471,05,01,  Langkar Headman Par,47,80,27,38,20,42,37.0,41.5,32.3,00000
84.0,7.0,83.0,471,06,01,  New Langkar Para,14,79,8,38,6,41,15.1,17.4,12.8,00000
84.0,7.0,83.0,471,07,01,  Thal Chhara Para,39,193,28,92,11,101,16.8,23.3,9.8,00000
84.0,7.0,83.0,471,08,01,  Kingkar Dor Para,21,91,11,41,10,50,18.8,21.2,16.7,00000
84.0,7.0,83.0,471,09,01,  Kagra Chari Para,16,53,16,20,0,33,23.2,44.4,0.0,00000
84.0,7.0,83.0,471,10,01,  Tara Bunnya Para,42,144,34,59,8,85,22.6,36.6,8.6,00000
84.0,7.0,83.0,471,11,01,  Naya Para,21,71,18,31,3,40,22.8,36.7,7.0,00000
84.0,7.0,83.0,575,01,01,  Lamba Chara,42,54,19,21,23,33,43.8,47.5,41.1,00000
84.0,7.0,83.0,575,02,01,  Ruilui Headman Para,128,245,92,120,36,125,34.3,43.4,22.4,00000
84.0,7.0,83.0,575,03,01,  Nutun Para,9,21,8,11,1,10,30.0,42.1,9.1,00000
84.0,7.0,83.0,575,04,01,  Mono Adam Para,55,103,49,50,6,53,34.8,49.5,10.2,00000
84.0,7.0,83.0,575,05,01,  Pachim Semon Para,37,130,33,46,4,84,22.2,41.8,4.5,00000
84.0,7.0,83.0,575,06,01,  Purba Semon Para,24,118,21,50,3,68,16.9,29.6,4.2,00000
84.0,7.0,83.0,575,07,01,  Tal Chara,20,107,19,42,1,65,15.7,31.1,1.5,00000
84.0,7.0,83.0,575,08,01,  Khagrachari Para,45,160,33,65,12,95,22.0,33.7,11.2,00000
84.0,7.0,83.0,680,01,01,  Halop Para,29,397,19,198,10,199,6.8,8.8,4.8,00000
84.0,7.0,83.0,680,02,01,  Gachkata Chara,16,128,11,51,5,77,11.1,17.7,6.1,00000
84.0,7.0,83.0,680,03,01,  Marlang Para,32,126,23,57,9,69,20.3,28.8,11.5,00000
84.0,7.0,83.0,680,04,01,  Pittichara Para,24,122,10,55,14,67,16.4,15.4,17.3,00000
84.0,7.0,83.0,680,05,01,  Thal Chara Para,10,73,7,41,3,32,12.0,14.6,8.6,00000
84.0,7.0,83.0,680,06,01,  Changkola Audam Para,15,81,12,37,3,44,15.6,24.5,6.4,00000
84.0,7.0,83.0,680,07,01,  Sialdailai Headman,33,127,23,54,10,73,20.6,29.9,12.0,00000
84.0,7.0,83.0,680,08,01,  Munoaudam Para,60,137,44,73,16,64,30.5,37.6,20.0,00000
84.0,7.0,83.0,680,09,01,  Hogra Kiching Para,17,85,13,40,4,45,16.7,24.5,8.2,00000
84.0,7.0,83.0,680,10,01,  Lajan Para,15,165,7,80,8,85,8.3,8.0,8.6,00000
84.0,7.0,83.0,889,01,01,  Kamla Bagan,8,27,6,13,2,14,22.9,31.6,12.5,00000
84.0,7.0,83.0,889,02,01,  Lontiyan Para,15,163,11,78,4,85,8.4,12.4,4.5,00000
84.0,7.0,83.0,889,03,01,  Arun Para,46,209,30,98,16,111,18.0,23.4,12.6,00000
84.0,7.0,83.0,889,04,01,  Hazya Para,5,81,5,37,0,44,5.8,11.9,0.0,00000
84.0,7.0,83.0,889,05,01,  Tuichi Headman Para,22,52,16,25,6,27,29.7,39.0,18.2,00000
84.0,7.0,83.0,889,06,01,  Moydung Para,68,196,48,88,20,108,25.8,35.3,15.6,00000
84.0,7.0,83.0,889,07,01,  Tin Dosri Para,74,321,60,146,14,175,18.7,29.1,7.4,00000
84.0,7.0,83.0,889,08,01,  Simana Para,15,137,14,72,1,65,9.9,16.3,1.5,00000
84.0,7.0,83.0,889,09,01,  Gonda Para,152,644,122,332,30,312,19.1,26.9,8.8,00000
84.0,21.0,15.0,035,01,01,  Karalya Chari Para,14,69,7,28,7,41,16.9,20.0,14.6,00000
84.0,21.0,15.0,035,02,01,  Sakra Chhari,91,136,63,62,28,74,40.1,50.4,27.5,00000
84.0,21.0,15.0,035,03,01,  Sanmani Para,42,112,28,44,14,68,27.3,38.9,17.1,00000
84.0,21.0,15.0,035,04,01,  Nowa Para,16,29,9,12,7,17,35.6,42.9,29.2,00000
84.0,21.0,15.0,035,05,01,  Dajar Para,26,90,21,47,5,43,22.4,30.9,10.4,00000
84.0,21.0,15.0,035,06,01,  Aima Chara Mukh Para,25,54,15,24,10,30,31.6,38.5,25.0,00000
84.0,21.0,15.0,035,07,01,  Jagannat Chara Para,83,114,63,45,20,69,42.1,58.3,22.5,00000
84.0,21.0,15.0,035,08,01,  Dighal Chari Para,55,128,40,52,15,76,30.1,43.5,16.5,00000
84.0,21.0,15.0,533,01,01,  Uttar Kalabunia Par,224,244,134,105,90,139,47.9,56.1,39.3,00000
84.0,21.0,15.0,533,02,01,  Dakshin Kalabunia P,227,384,141,179,86,205,37.2,44.1,29.6,00000
84.0,21.0,15.0,533,03,01,  Motilal Karbari Par,77,285,59,129,18,156,21.3,31.4,10.3,00000
84.0,21.0,15.0,639,01,01,  Bag Chari,57,28,35,8,22,20,67.1,81.4,52.4,00000
84.0,21.0,15.0,639,02,01,  Nilmoni Karbari Pa,99,139,61,53,38,86,41.6,53.5,30.6,00000
84.0,21.0,15.0,639,03,01,  Radag Kaba Para,29,77,22,33,7,44,27.4,40.0,13.7,00000
84.0,21.0,15.0,639,04,01,  Hed Baria Para,75,171,52,71,23,100,30.5,42.3,18.7,00000
84.0,21.0,15.0,639,05,01,  Radang Kaba,24,72,20,26,4,46,25.0,43.5,8.0,00000
84.0,21.0,15.0,710,01,01,  Pera Chhara Para,25,152,20,74,5,78,14.1,21.3,6.0,00000
84.0,21.0,15.0,710,02,01,  Tal Chhara Para,7,64,6,33,1,31,9.9,15.4,3.1,00000
84.0,21.0,15.0,710,03,01,  Kadu Chara,19,127,13,59,6,68,13.0,18.1,8.1,00000
84.0,21.0,15.0,710,04,01,  Upar Karalya Chhari,13,63,10,30,3,33,17.1,25.0,8.3,00000
84.0,21.0,15.0,710,05,01,  Madhya Karalya Chha,89,134,57,57,32,77,39.9,50.0,29.4,00000
84.0,21.0,15.0,710,06,01,  Nicher Karalya Chha,45,107,30,45,15,62,29.6,40.0,19.5,00000
84.0,21.0,15.0,710,07,01,  Dulu Bunnya,17,17,13,5,4,12,50.0,72.2,25.0,00000
84.0,21.0,15.0,710,08,01,  Andhar Manik,136,135,102,49,34,86,50.2,67.5,28.3,00000
84.0,21.0,15.0,710,09,01,  Cimitha Mohajan (C.M.Para),206,178,154,62,52,116,53.6,71.3,31.0,00000
84.0,21.0,15.0,710,10,01,  Bat Tali Para,6,91,6,43,0,48,6.2,12.2,0.0,00000
84.0,21.0,15.0,710,11,01,  Kalapuna Chara,61,156,58,69,3,87,28.1,45.7,3.3,00000
84.0,21.0,15.0,923,01,01,  Kamalacharan Para,25,127,18,56,7,71,16.4,24.3,9.0,00000
84.0,21.0,15.0,923,02,01,  Goui Hat Chara,11,78,9,40,2,38,12.4,18.4,5.0,00000
84.0,21.0,15.0,923,03,01,  Nishimohan Karbari,41,63,39,29,2,34,39.4,57.4,5.6,00000
84.0,21.0,15.0,923,04,01,  Noyapara,44,270,29,139,15,131,14.0,17.3,10.3,00000
84.0,21.0,15.0,923,05,01,  Chambil Para,21,90,19,44,2,46,18.9,30.2,4.2,00000
84.0,21.0,15.0,923,06,01,  Dochhari Para,34,184,26,83,8,101,15.6,23.9,7.3,00000
84.0,21.0,15.0,959,01,01,  Madan Para,67,79,46,24,21,55,45.9,65.7,27.6,00000
84.0,21.0,15.0,959,02,01,  Bada Para,46,99,28,48,18,51,31.7,36.8,26.1,00000
84.0,21.0,15.0,959,03,01,  Headman Para,18,16,12,10,6,6,52.9,54.5,50.0,00000
84.0,21.0,15.0,959,04,01,  Bharat Para,30,42,22,13,8,29,41.7,62.9,21.6,00000
84.0,21.0,31.0,177,01,01,  Sre Nagar,49,165,31,73,18,92,22.9,29.8,16.4,00000
84.0,21.0,31.0,177,02,01,  Chitra Member Para(,35,115,26,51,9,64,23.3,33.8,12.3,00000
84.0,21.0,31.0,177,03,01,  Ranga Pani Chara,20,138,16,68,4,70,12.7,19.0,5.4,00000
84.0,21.0,31.0,213,01,01,  Mahal Chara Para,28,53,17,28,11,25,34.6,37.8,30.6,00000
84.0,21.0,31.0,213,02,01,  Madhya Shukna Chari Para,58,124,39,51,19,73,31.9,43.3,20.7,00000
84.0,21.0,31.0,213,03,01,  Shukna Chari Para,105,307,75,134,30,173,25.5,35.9,14.8,00000
84.0,21.0,31.0,355,01,01,  Nowa Para,48,173,33,82,15,91,21.7,28.7,14.2,00000
84.0,21.0,31.0,355,02,01,  Modya Nowa Para,35,106,25,47,10,59,24.8,34.7,14.5,00000
84.0,21.0,31.0,355,03,01,  Mazi Para,8,59,7,26,1,33,11.9,21.2,2.9,00000
84.0,21.0,31.0,355,04,01,  Gola Chari Para,48,98,38,40,10,58,32.9,48.7,14.7,00000
84.0,21.0,31.0,355,05,01,  Talchhara Para,5,47,4,19,1,28,9.6,17.4,3.4,00000
84.0,21.0,31.0,497,01,01,  Headman Para (Pak Mor),32,104,14,57,18,47,23.5,19.7,27.7,00000
84.0,21.0,31.0,497,02,01,  Uthan Chadora Para,8,66,7,35,1,31,10.8,16.7,3.1,00000
84.0,21.0,31.0,497,03,01,  Dulu Chhari Para,75,49,49,16,26,33,60.5,75.4,44.1,00000
84.0,21.0,31.0,497,04,01,  Musalmani Chhara Togalok Chara,51,25,30,7,21,18,67.1,81.1,53.8,00000
84.0,21.0,31.0,497,05,01,  Bai Bon Chara,35,22,24,4,11,18,61.4,85.7,37.9,00000
84.0,21.0,31.0,497,06,01,  Kuki Chhara Para,44,42,25,14,19,28,51.2,64.1,40.4,00000
84.0,21.0,31.0,497,07,01,  Latibaj Chhara,29,41,18,16,11,25,41.4,52.9,30.6,00000
84.0,21.0,31.0,497,08,01,  Taglokbakk Chhara P,24,54,17,26,7,28,30.8,39.5,20.0,00000
84.0,21.0,31.0,497,09,01,  Zero Khamer,11,41,9,19,2,22,21.2,32.1,8.3,00000
84.0,21.0,31.0,497,10,01,  Pithi Chhara,122,94,89,30,33,64,56.5,74.8,34.0,00000
84.0,21.0,31.0,497,11,01,  Kuki Chara Bazar,136,96,97,30,39,66,58.6,76.4,37.1,00000
84.0,21.0,31.0,675,01,01,  Kalabania Mukh Para,3,25,2,13,1,12,10.7,13.3,7.7,00000
84.0,21.0,31.0,675,02,01,  Laizugram Para,74,39,36,20,38,19,65.5,64.3,66.7,00000
84.0,21.0,31.0,746,01,01,  Danea Kuki Chhara,29,94,22,41,7,53,23.6,34.9,11.7,00000
84.0,21.0,31.0,746,02,01,  Chainik Para,11,23,6,8,5,15,32.4,42.9,25.0,00000
84.0,21.0,31.0,994,01,01,  Rangapani Chara Par,59,60,48,19,11,41,49.6,71.6,21.2,00000
84.0,21.0,31.0,994,02,01,  Taibang Mukh Para,210,124,134,37,76,87,62.9,78.4,46.6,00000
84.0,21.0,31.0,994,03,01,  Devi Chara Para,33,173,20,88,13,85,16.0,18.5,13.3,00000
84.0,21.0,47.0,142,01,01,  Halamba Para,16,25,8,10,8,15,39.0,44.4,34.8,00000
84.0,21.0,47.0,142,02,01,  Barbania Para,23,34,16,14,7,20,40.4,53.3,25.9,00000
84.0,21.0,47.0,142,03,01,  Headman Para,8,41,8,17,0,24,16.3,32.0,0.0,00000
84.0,21.0,47.0,284,01,01,  Begena Chhari Para,153,183,92,84,61,99,45.5,52.3,38.1,00000
84.0,21.0,47.0,284,02,01,  Hamba Chhara Para,226,176,148,66,78,110,56.2,69.2,41.5,00000
84.0,21.0,47.0,284,03,01,  Halamba Mukh Para,21,51,10,23,11,28,29.2,30.3,28.2,00000
84.0,21.0,47.0,284,04,01,  Dhochhari Para,49,153,35,71,14,82,24.3,33.0,14.6,00000
84.0,21.0,47.0,284,05,01,  Burbania Para,58,39,41,16,17,23,59.8,71.9,42.5,00000
84.0,21.0,47.0,426,01,01,  Dhagbhanga Para,25,86,18,43,7,43,22.5,29.5,14.0,00000
84.0,21.0,47.0,426,02,01,  Dewan Char Para,36,72,24,36,12,36,33.3,40.0,25.0,00000
84.0,21.0,47.0,426,03,01,  Kadamtali Para,112,26,66,7,46,19,81.2,90.4,70.8,00000
84.0,21.0,47.0,426,04,01,  Bangal Basya,118,74,86,28,32,46,61.5,75.4,41.0,00000
84.0,21.0,47.0,781,01,01,  Billa Chhari Para,131,138,78,59,53,79,48.7,56.9,40.2,00000
84.0,21.0,47.0,781,02,01,  Dochhari Para,63,93,39,50,24,43,40.4,43.8,35.8,00000
84.0,21.0,47.0,781,03,01,  Kushum Chhari Para,384,200,231,70,153,130,65.8,76.7,54.1,00000
84.0,21.0,47.0,781,04,01,  Kurkuti Chhari Para,107,95,78,33,29,62,53.0,70.3,31.9,00000
84.0,21.0,47.0,781,05,01,  Bangali Para,331,488,207,266,124,222,40.4,43.8,35.8,00000
84.0,21.0,47.0,888,01,03,  Birajdhan Para,109,39,53,16,56,23,73.6,76.8,70.9,00000
84.0,21.0,47.0,888,02,03,  Palitanga Para,112,123,60,51,52,72,47.7,54.1,41.9,00000
84.0,21.0,47.0,888,03,03,  C.O.Office Para,300,59,174,22,126,37,83.6,88.8,77.3,00000
84.0,21.0,47.0,888,04,03,  Keang Para,291,151,191,68,100,83,65.8,73.7,54.6,00000
84.0,21.0,47.0,888,05,03,  Barkal Bazar,456,107,378,65,78,42,81.0,85.3,65.0,00000
84.0,21.0,63.0,319,01,01,  Buda Chara,44,76,36,35,8,41,36.7,50.7,16.3,00000
84.0,21.0,63.0,319,02,01,  Chailyatali,232,93,136,48,96,45,71.4,73.9,68.1,00000
84.0,21.0,63.0,319,03,01,  Latibaj Chara,94,157,59,77,35,80,37.5,43.4,30.4,00000
84.0,21.0,63.0,319,04,01,  Shupari Pata Para,79,145,57,67,22,78,35.3,46.0,22.0,00000
84.0,21.0,63.0,319,05,01,  Mara Uijanu Chhari Para,16,77,12,41,4,36,17.2,22.6,10.0,00000
84.0,21.0,63.0,319,06,01,  Bara Ujan Chhari Pa,453,331,301,124,152,207,57.8,70.8,42.3,00000
84.0,21.0,63.0,319,07,01,  Arabunia Bazar (South),164,351,93,196,71,155,31.8,32.2,31.4,00000
84.0,21.0,63.0,319,08,01,  Arabunia Bara (North),205,144,110,68,95,76,58.7,61.8,55.6,00000
84.0,21.0,63.0,319,09,01,  Shegonbagan Para,200,329,116,159,84,170,37.8,42.2,33.1,00000
84.0,21.0,63.0,319,10,01,  Chairman Para,393,413,226,208,167,205,48.8,52.1,44.9,00000
84.0,21.0,63.0,319,11,01,  Porabari Bazar,4,0,3,0,1,0,100.0,100.0,100.0,00000
84.0,21.0,63.0,319,12,01,  Mirpara,132,239,71,116,61,123,35.6,38.0,33.2,00000
84.0,21.0,63.0,319,13,01,  Rokbia Chhara Para,100,132,67,50,33,82,43.1,57.3,28.7,00000
84.0,21.0,63.0,319,14,01,  Amtali Para,227,150,135,76,92,74,60.2,64.0,55.4,00000
84.0,21.0,63.0,319,15,01,  Boiragi Para,37,103,25,43,12,60,26.4,36.8,16.7,00000
84.0,21.0,63.0,319,16,01,  North Bushan Chara,183,222,120,95,63,127,45.2,55.8,33.2,00000
84.0,21.0,63.0,319,17,01,  South Bushan Chara,290,224,193,81,97,143,56.4,70.4,40.4,00000
84.0,21.0,63.0,319,18,01,  Jakko Bajei,46,55,31,22,15,33,45.5,58.5,31.3,00000
84.0,21.0,63.0,390,01,01,  Rokbia Chhara Para,82,156,50,68,32,88,34.5,42.4,26.7,00000
84.0,21.0,63.0,390,02,01,  Bajei Chhara Para,34,139,24,57,10,82,19.7,29.6,10.9,00000
84.0,21.0,63.0,390,03,01,  Bamer Kuki Chhara P,56,85,47,37,9,48,39.7,56.0,15.8,00000
84.0,21.0,63.0,390,04,01,  Daner Kuki Chhara,25,16,15,4,10,12,61.0,78.9,45.5,00000
84.0,21.0,63.0,390,05,01,  Tarengya Ghat,47,73,33,31,14,42,39.2,51.6,25.0,00000
84.0,21.0,63.0,568,01,01,  Radang Kaba,24,91,18,41,6,50,20.9,30.5,10.7,00000
84.0,21.0,63.0,568,02,01,  Gaita Mohajan Para,24,51,21,19,3,32,32.0,52.5,8.6,00000
84.0,21.0,63.0,568,03,01,  Sarat Mohanjon Para,55,91,43,35,12,56,37.7,55.1,17.6,00000
84.0,21.0,63.0,568,04,01,  Bampiland,314,133,172,73,142,60,70.2,70.2,70.3,00000
84.0,21.0,63.0,568,05,01,  Tara Chan Karbari,21,130,15,66,6,64,13.9,18.5,8.6,00000
84.0,21.0,63.0,604,01,01,  Chandabi Ghat,24,179,19,92,5,87,11.8,17.1,5.4,00000
84.0,21.0,63.0,604,02,01,  Ful Chhara,11,200,8,95,3,105,5.2,7.8,2.8,00000
84.0,21.0,63.0,604,03,01,  Tambak,57,190,48,89,9,101,23.1,35.0,8.2,00000
84.0,21.0,63.0,604,04,01,  Chadra Chhara,48,86,37,37,11,49,35.8,50.0,18.3,00000
84.0,21.0,63.0,604,05,01,  Tipura Chhara,46,63,33,23,13,40,42.2,58.9,24.5,00000
84.0,21.0,63.0,604,06,01,  Khubbang Para,225,265,163,115,62,150,45.9,58.6,29.2,00000
84.0,21.0,63.0,604,07,01,  Chumachumi Para,20,107,11,52,9,55,15.7,17.5,14.1,00000
84.0,21.0,63.0,604,08,01,  Tegamukh Para,189,264,119,114,70,150,41.7,51.1,31.8,00000
84.0,21.0,63.0,604,09,01,  Moratega Para,118,192,82,78,36,114,38.1,51.3,24.0,00000
84.0,21.0,63.0,604,10,01,  Shilkur Para,4,32,2,16,2,16,11.1,11.1,11.1,00000
84.0,21.0,63.0,604,11,01,  Gui Chari,25,149,23,68,2,81,14.4,25.3,2.4,00000
84.0,21.0,63.0,817,01,01,  Taligachha Kaba Cha,20,38,15,17,5,21,34.5,46.9,19.2,00000
84.0,21.0,63.0,817,02,01,  Kuki Chhara Para,17,41,14,19,3,22,29.3,42.4,12.0,00000
84.0,21.0,63.0,817,03,01,  Harina Bazar,1036,299,875,127,161,172,77.6,87.3,48.3,00000
84.0,21.0,63.0,817,04,01,  Sundari Chhara,14,14,11,4,3,10,50.0,73.3,23.1,00000
84.0,21.0,63.0,817,05,01,  Bhaluka Chhari Para,54,195,38,94,16,101,21.7,28.8,13.7,00000
84.0,21.0,63.0,817,06,01,  Jarul Chari,88,157,62,59,26,98,35.9,51.2,21.0,00000
84.0,21.0,63.0,817,07,01,  Taglok Bakpara,158,223,112,89,46,134,41.5,55.7,25.6,00000
84.0,21.0,63.0,817,08,01,  B.D.R.Camp,14,65,8,34,6,31,17.7,19.0,16.2,00000
84.0,21.0,63.0,817,09,01,  Tal Chara,48,62,32,21,16,41,43.6,60.4,28.1,00000
84.0,21.0,63.0,817,10,01,  Bhusan Bak (Bara Tali),159,202,107,94,52,108,44.0,53.2,32.5,00000
84.0,21.0,63.0,817,11,01,  Jamgia Chara,86,136,65,61,21,75,38.7,51.6,21.9,00000
84.0,21.0,79.0,071,01,01,  Mogpara,47,217,29,103,18,114,17.8,22.0,13.6,00000
84.0,21.0,79.0,071,02,01,  Haja Chhara Para,170,88,113,34,57,54,65.9,76.9,51.4,00000
84.0,21.0,79.0,071,03,01,  Pigira Chhara Para,36,27,22,13,14,14,57.1,62.9,50.0,00000
84.0,21.0,79.0,071,04,01,  Chegaya  Chhari P,87,326,40,171,47,155,21.1,19.0,23.3,00000
84.0,21.0,79.0,071,05,01,  Betchhari Para,222,205,140,79,82,126,52.0,63.9,39.4,00000
84.0,21.0,79.0,071,06,01,  Maij Chhari Para,176,152,119,71,57,81,53.7,62.6,41.3,00000
84.0,21.0,79.0,071,07,01,  Andhar Manik Para,104,59,64,20,40,39,63.8,76.2,50.6,00000
84.0,21.0,79.0,071,08,01,  Marang Chari Para,21,107,11,51,10,56,16.4,17.7,15.2,00000
84.0,21.0,79.0,071,09,01,  Pesky Chara Para,20,72,12,34,8,38,21.7,26.1,17.4,00000
84.0,21.0,79.0,106,01,01,  Baghachhola Para,90,38,49,15,41,23,70.3,76.6,64.1,00000
84.0,21.0,79.0,106,02,01,  Daritana Bag Para,117,28,70,8,47,20,80.7,89.7,70.1,00000
84.0,21.0,79.0,106,03,01,  Shel Chhari Para,136,81,78,28,58,53,62.7,73.6,52.3,00000
84.0,21.0,79.0,106,04,01,  Nannya Chhari Para,90,211,53,97,37,114,29.9,35.3,24.5,00000
84.0,21.0,79.0,106,05,01,  Begana Chhari,38,40,28,24,10,16,48.7,53.8,38.5,00000
84.0,21.0,79.0,106,06,01,  Kadamtali Para,70,91,37,37,33,54,43.5,50.0,37.9,00000
84.0,21.0,79.0,248,01,01,  Dhigal Chhari Para,124,87,70,35,54,52,58.8,66.7,50.9,00000
84.0,21.0,79.0,248,02,01,  Rupban Para,59,78,41,37,18,41,43.1,52.6,30.5,00000
84.0,21.0,79.0,248,03,01,  Rupban Moin Para,116,80,60,33,56,47,59.2,64.5,54.4,00000
84.0,21.0,79.0,248,04,01,  Gurukhaia Para (Petya Chari),198,144,124,45,74,99,57.9,73.4,42.8,00000
84.0,21.0,79.0,248,05,01,  Headman Para (Ukchari Para),171,176,103,73,68,103,49.3,58.5,39.8,00000
84.0,21.0,79.0,248,06,01,  Shel Chhari Para,116,173,67,69,49,104,40.1,49.3,32.0,00000
84.0,21.0,79.0,248,07,01,  Haja Chhara Para,73,38,46,10,27,28,65.8,82.1,49.1,00000
84.0,21.0,79.0,248,08,01,  Paglee Chharapara(Tanya Chari),186,196,116,77,70,119,48.7,60.1,37.0,00000
84.0,21.0,79.0,248,09,01,  Baruna Chhari Bangai Zone,819,819,470,445,349,374,50.0,51.4,48.3,00000
84.0,21.0,79.0,461,01,01,  Sheler Dakpara,32,191,18,96,14,95,14.3,15.8,12.8,00000
84.0,21.0,79.0,461,02,01,  Shublong Bazar,463,140,336,75,127,65,76.8,81.8,66.1,00000
84.0,21.0,79.0,461,03,01,  Keang Para,19,42,12,21,7,21,31.1,36.4,25.0,00000
84.0,21.0,79.0,461,04,01,  Headman Para,23,25,17,9,6,16,47.9,65.4,27.3,00000
84.0,21.0,79.0,461,05,01,  Chappya Chhara Para,97,111,60,47,37,64,46.6,56.1,36.6,00000
84.0,21.0,79.0,461,06,01,  Shuchar Chhari Para,31,134,22,63,9,71,18.8,25.9,11.3,00000
84.0,21.0,79.0,461,07,01,  Haja Chhari Para,114,159,85,59,29,100,41.8,59.0,22.5,00000
84.0,21.0,79.0,461,08,01,  Pan Chhari Para,53,132,38,59,15,73,28.6,39.2,17.0,00000
84.0,21.0,79.0,461,09,01,  Dhanudhar Karbari,46,89,30,39,16,50,34.1,43.5,24.2,00000
84.0,21.0,79.0,461,10,01,  Chairman Para,89,95,57,37,32,58,48.4,60.6,35.6,00000
84.0,21.0,79.0,852,01,01,  Moinpara,67,24,42,5,25,19,73.6,89.4,56.8,00000
84.0,21.0,79.0,852,02,01,  Haja Chhara Para,94,126,58,59,36,67,42.7,49.6,35.0,00000
84.0,21.0,79.0,852,03,01,  Indrama Chhara  Par,132,75,71,32,61,43,63.8,68.9,58.7,00000
84.0,21.0,79.0,852,04,01,  Shil Chhari Para (Maddya Adam),112,26,64,7,48,19,81.2,90.1,71.6,00000
84.0,21.0,79.0,852,05,01,  Narai Chhari Para,76,89,49,36,27,53,46.1,57.6,33.8,00000
84.0,21.0,79.0,852,06,01,  Mitinga Chhari Para,32,45,21,19,11,26,41.6,52.5,29.7,00000
84.0,21.0,79.0,852,07,01,  Buba Para,30,28,17,15,13,13,51.7,53.1,50.0,00000
84.0,25.0,19.0,099,01,03,  Dakshin Betbunia Para,474,296,225,144,249,152,61.6,61.0,62.1,00000
84.0,25.0,19.0,099,02,03,  Gazalia,129,111,63,47,66,64,53.8,57.3,50.8,00000
84.0,25.0,19.0,099,03,03,  Hemanta Para,56,42,32,12,24,30,57.1,72.7,44.4,00000
84.0,25.0,19.0,099,04,03,  Kali Chhari,120,105,59,52,61,53,53.3,53.2,53.5,00000
84.0,25.0,19.0,099,05,03,  Shikdar Para,177,112,91,51,86,61,61.2,64.1,58.5,00000
84.0,25.0,19.0,099,06,03,  Puran Basti,306,240,159,115,147,125,56.0,58.0,54.0,00000
84.0,25.0,19.0,099,07,03,  Sialbukka,154,95,96,59,58,36,61.8,61.9,61.7,00000
84.0,25.0,19.0,099,08,03,  Dakghar Para,199,184,96,90,103,94,52.0,51.6,52.3,00000
84.0,25.0,19.0,099,09,03,  Mahajan Para,112,247,65,148,47,99,31.2,30.5,32.2,00000
84.0,25.0,19.0,099,10,03,  Amchhari Para,162,172,119,117,43,55,48.5,50.4,43.9,00000
84.0,25.0,19.0,099,11,03,  Sapnala,536,426,275,213,261,213,55.7,56.4,55.1,00000
84.0,25.0,19.0,099,12,03,  P.S.T.S. Area,322,12,297,10,25,2,96.4,96.7,92.6,00000
84.0,25.0,19.0,099,13,03,  Chairman Para,22,120,14,63,8,57,15.5,18.2,12.3,00000
84.0,25.0,19.0,099,14,03,  Kalakaji,7,169,6,87,1,82,4.0,6.5,1.2,00000
84.0,25.0,19.0,099,15,03,  Raujanghona,9,39,8,19,1,20,18.8,29.6,4.8,00000
84.0,25.0,19.0,099,16,03,  Shil Chhari,16,71,12,34,4,37,18.4,26.1,9.8,00000
84.0,25.0,19.0,099,17,03,  Ghari Chhara Para,39,306,27,211,12,95,11.3,11.3,11.2,00000
84.0,25.0,19.0,099,18,03,  Pochu Para,77,205,49,93,28,112,27.3,34.5,20.0,00000
84.0,25.0,19.0,099,19,03,  Chowdhury Para,113,339,79,151,34,188,25.0,34.3,15.3,00000
84.0,25.0,19.0,099,20,03,  Haludia,7,9,5,6,2,3,43.8,45.5,40.0,00000
84.0,25.0,19.0,099,21,03,  Daila Para,87,119,53,48,34,71,42.2,52.5,32.4,00000
84.0,25.0,19.0,099,22,03,  Docter Sola,120,91,62,42,58,49,56.9,59.6,54.2,00000
84.0,25.0,19.0,099,23,03,  Natun Para,243,284,111,151,132,133,46.1,42.4,49.8,00000
84.0,25.0,19.0,099,24,03,  Headman Para,269,185,160,80,109,105,59.3,66.7,50.9,00000
84.0,25.0,19.0,099,25,03,  T&T.Para,229,27,137,9,92,18,89.5,93.8,83.6,00000
84.0,25.0,19.0,099,26,03,  Talukder Para,203,156,101,77,102,79,56.5,56.7,56.4,00000
84.0,25.0,19.0,099,27,03,  Harin Chhara,7,31,4,16,3,15,18.4,20.0,16.7,00000
84.0,25.0,19.0,099,28,03,  Goder Para,74,14,57,9,17,5,84.1,86.4,77.3,00000
84.0,25.0,19.0,099,29,03,  Chha-E-Rei Bazar,103,48,81,30,22,18,68.2,73.0,55.0,00000
84.0,25.0,19.0,099,30,03,  Balu Khali,26,88,15,34,11,54,22.8,30.6,16.9,00000
84.0,25.0,19.0,796,01,01,  Paschim Lungi Para,51,205,34,114,17,91,19.9,23.0,15.7,00000
84.0,25.0,19.0,796,02,01,  Sapmara Para,142,152,78,82,64,70,48.3,48.8,47.8,00000
84.0,25.0,19.0,796,03,01,  Bottali Para,32,95,16,51,16,44,25.2,23.9,26.7,00000
84.0,25.0,19.0,796,04,01,  Nakata,3,14,2,6,1,8,17.6,25.0,11.1,00000
84.0,25.0,19.0,796,05,01,  Duchalia Para,0,28,0,12,0,16,0.0,0.0,0.0,00000
84.0,25.0,19.0,796,06,01,  Purba Manai Para,147,211,85,89,62,122,41.1,48.9,33.7,00000
84.0,25.0,19.0,796,07,01,  Madhyam Manai Para,89,73,58,29,31,44,54.9,66.7,41.3,00000
84.0,25.0,19.0,796,08,01,  Paschim Manai Para,335,439,199,190,136,249,43.3,51.2,35.3,00000
84.0,25.0,19.0,796,09,01,  Kali Chhari,60,114,29,57,31,57,34.5,33.7,35.2,00000
84.0,25.0,19.0,796,10,01,  Lathi Chhara,106,224,61,110,45,114,32.1,35.7,28.3,00000
84.0,25.0,19.0,796,11,01,  Goder Para,100,169,54,87,46,82,37.2,38.3,35.9,00000
84.0,25.0,19.0,796,12,01,  Purba Sonai Chhari,394,261,234,96,160,165,60.2,70.9,49.2,00000
84.0,25.0,19.0,796,13,01,  Paschim Sonai Chhar,84,251,48,129,36,122,25.1,27.1,22.8,00000
84.0,25.0,19.0,796,14,01,  Mohammod Para,24,37,11,22,13,15,39.3,33.3,46.4,00000
84.0,25.0,19.0,796,15,01,  Banuban,97,84,50,38,47,46,53.6,56.8,50.5,00000
84.0,25.0,19.0,796,16,01,  Barabili,177,250,100,101,77,149,41.5,49.8,34.1,00000
84.0,25.0,19.0,796,17,01,  Purba Lungi Para,117,114,64,53,53,61,50.6,54.7,46.5,00000
84.0,25.0,19.0,796,18,01,  Amchhari Para,52,97,30,52,22,45,34.9,36.6,32.8,00000
84.0,25.0,19.0,796,19,01,  Daluchhari Para,99,123,53,57,46,66,44.6,48.2,41.1,00000
84.0,25.0,19.0,796,20,01,  Master Ghona,145,161,73,74,72,87,47.4,49.7,45.3,00000
84.0,25.0,19.0,796,21,01,  Deelite Notun Para,153,75,76,33,77,42,67.1,69.7,64.7,00000
84.0,25.0,38.0,199,01,01,  Noa Para,4,16,3,9,1,7,20.0,25.0,12.5,00000
84.0,25.0,38.0,199,02,01,  Rakta Chhari Uttar Para,9,95,5,51,4,44,8.7,8.9,8.3,00000
84.0,25.0,38.0,199,03,01,  Dabbua Para,22,112,12,47,10,65,16.4,20.3,13.3,00000
84.0,25.0,38.0,199,04,01,  Headman Para,74,161,49,70,25,91,31.5,41.2,21.6,00000
84.0,25.0,38.0,199,05,01,  Dur Chhari Para,52,200,30,84,22,116,20.6,26.3,15.9,00000
84.0,25.0,38.0,199,06,01,  Paimoi Shona Para,6,13,4,6,2,7,31.6,40.0,22.2,00000
84.0,25.0,38.0,199,07,01,  Rakta Chari Dakhin Para,15,135,11,64,4,71,10.0,14.7,5.3,00000
84.0,25.0,38.0,199,08,01,  Dabua K.P Chowdhury Bazar Para,9,29,7,18,2,11,23.7,28.0,15.4,00000
84.0,25.0,38.0,199,09,01,  Kukuchan Tila Para,17,36,9,14,8,22,32.1,39.1,26.7,00000
84.0,25.0,38.0,199,10,01,  Dabua Mazar Para,14,36,10,15,4,21,28.0,40.0,16.0,00000
84.0,25.0,38.0,199,11,01,  Dabua Bakur Para,24,185,15,91,9,94,11.5,14.2,8.7,00000
84.0,25.0,38.0,199,12,01,  Dabua Tilar Para,22,78,16,30,6,48,22.0,34.8,11.1,00000
84.0,25.0,38.0,199,13,01,  Dabua Lamar Para,36,75,20,35,16,40,32.4,36.4,28.6,00000
84.0,25.0,38.0,298,01,01,  Barma Chhari Muk Para,62,190,34,90,28,100,24.6,27.4,21.9,00000
84.0,25.0,38.0,298,02,01,  Haja Chhari Para,14,51,11,23,3,28,21.5,32.4,9.7,00000
84.0,25.0,38.0,298,03,01,  Dulu Para,93,214,63,101,30,113,30.3,38.4,21.0,00000
84.0,25.0,38.0,298,04,01,  Duchalia Para,0,54,0,28,0,26,0.0,0.0,0.0,00000
84.0,25.0,38.0,298,05,01,  Nabhanga Muk Para,7,64,5,26,2,38,9.9,16.1,5.0,00000
84.0,25.0,38.0,298,06,01,  Dobakata,34,80,18,41,16,39,29.8,30.5,29.1,00000
84.0,25.0,38.0,298,07,01,  Pitti Para,101,203,66,85,35,118,33.2,43.7,22.9,00000
84.0,25.0,38.0,298,08,01,  Chowdhury Para (M.C,64,323,41,156,23,167,16.5,20.8,12.1,00000
84.0,25.0,38.0,298,09,01,  Irakazi,4,72,2,32,2,40,5.3,5.9,4.8,00000
84.0,25.0,38.0,298,10,01,  Sukna Chhari Para,45,103,27,44,18,59,30.4,38.0,23.4,00000
84.0,25.0,38.0,298,11,01,  Dochhari Para,15,64,9,29,6,35,19.0,23.7,14.6,00000
84.0,25.0,38.0,298,12,01,  Dulugona Para,63,119,44,58,19,61,34.6,43.1,23.8,00000
84.0,25.0,38.0,298,13,01,  Noa Para,3,100,1,56,2,44,2.9,1.8,4.3,00000
84.0,25.0,38.0,298,14,01,  Sheel Chari Para,10,59,7,35,3,24,14.5,16.7,11.1,00000
84.0,25.0,38.0,995,01,01,  Dubakata,33,81,25,24,8,57,28.9,51.0,12.3,00000
84.0,25.0,38.0,995,02,01,  Nabhanga Para,123,130,83,45,40,85,48.6,64.8,32.0,00000
84.0,25.0,38.0,995,03,01,  Tongkea Para,32,173,24,83,8,90,15.6,22.4,8.2,00000
84.0,25.0,38.0,995,04,01,  Kalabunia Para,19,104,13,50,6,54,15.4,20.6,10.0,00000
84.0,25.0,57.0,398,01,01,  Choudhury Para,473,165,288,61,185,104,74.1,82.5,64.0,00000
84.0,25.0,57.0,398,02,01,  Champatali,427,221,268,97,159,124,65.9,73.4,56.2,00000
84.0,25.0,57.0,398,03,01,  Magha Chhari,105,202,58,99,47,103,34.2,36.9,31.3,00000
84.0,25.0,57.0,398,04,01,  Bogha Para,244,182,154,63,90,119,57.3,71.0,43.1,00000
84.0,25.0,57.0,398,05,01,  Napit Chhara,13,13,10,5,3,8,50.0,66.7,27.3,00000
84.0,25.0,57.0,398,06,01,  Chhota Pagli,56,88,34,38,22,50,38.9,47.2,30.6,00000
84.0,25.0,57.0,398,07,01,  Shakra Chhari,24,18,11,7,13,11,57.1,61.1,54.2,00000
84.0,25.0,57.0,398,08,01,  Chauchala Para-2,75,60,40,22,35,38,55.6,64.5,47.9,00000
84.0,25.0,57.0,398,09,01,  Ghagra Bazar,784,192,438,75,346,117,80.3,85.4,74.7,00000
84.0,25.0,57.0,398,10,01,  Mohajan Para,210,90,127,34,83,56,70.0,78.9,59.7,00000
84.0,25.0,57.0,398,11,01,  Jautha Khamar,109,27,61,9,48,18,80.1,87.1,72.7,00000
84.0,25.0,57.0,398,12,01,  Rajkhali,66,219,44,100,22,119,23.2,30.6,15.6,00000
84.0,25.0,57.0,398,13,01,  Junama Chhara,444,288,237,122,207,166,60.7,66.0,55.5,00000
84.0,25.0,57.0,398,14,01,  Chela Chhara,231,138,122,62,109,76,62.6,66.3,58.9,00000
84.0,25.0,57.0,398,15,01,  School Chhara,142,86,77,36,65,50,62.3,68.1,56.5,00000
84.0,25.0,57.0,398,16,01,  Headman Para(Dewan Para),187,126,112,46,75,80,59.7,70.9,48.4,00000
84.0,25.0,57.0,398,17,01,  Kalabagan,323,255,198,112,125,143,55.9,63.9,46.6,00000
84.0,25.0,57.0,398,18,01,  Mill Area,36,13,24,9,12,4,73.5,72.7,75.0,00000
84.0,25.0,57.0,398,19,01,  Kayang Chara,60,41,37,20,23,21,59.4,64.9,52.3,00000
84.0,25.0,57.0,398,20,01,  Contractor Para,38,56,19,27,19,29,40.4,41.3,39.6,00000
84.0,25.0,57.0,497,01,01,  Talukdar Para,116,108,66,42,50,66,51.8,61.1,43.1,00000
84.0,25.0,57.0,497,02,01,  Lambia Para,26,53,14,28,12,25,32.9,33.3,32.4,00000
84.0,25.0,57.0,497,03,01,  Pera Chhara Para,57,76,36,35,21,41,42.9,50.7,33.9,00000
84.0,25.0,57.0,497,04,01,  Ghila Chhari Para,73,76,43,25,30,51,49.0,63.2,37.0,00000
84.0,25.0,57.0,497,05,01,  Daner Ulta Para,80,146,42,69,38,77,35.4,37.8,33.0,00000
84.0,25.0,57.0,497,06,01,  Bamer Ulta Para,106,147,70,65,36,82,41.9,51.9,30.5,00000
84.0,25.0,57.0,497,07,01,  Mian Para,162,250,113,100,49,150,39.3,53.1,24.6,00000
84.0,25.0,57.0,497,08,01,  Zibtali Para,43,82,25,37,18,45,34.4,40.3,28.6,00000
84.0,25.0,57.0,497,09,01,  Ulta Rangi Para,70,165,42,75,28,90,29.8,35.9,23.7,00000
84.0,25.0,57.0,597,01,01,  Durja Para,9,103,7,55,2,48,8.0,11.3,4.0,00000
84.0,25.0,57.0,597,02,01,  Naksha Chhari,52,114,32,50,20,64,31.3,39.0,23.8,00000
84.0,25.0,57.0,597,03,01,  Puran Poya Para,20,72,15,33,5,39,21.7,31.3,11.4,00000
84.0,25.0,57.0,597,04,01,  Kaskhali,161,398,87,192,74,206,28.8,31.2,26.4,00000
84.0,25.0,57.0,597,05,01,  Chhota Navanga Para,86,193,49,85,37,108,30.8,36.6,25.5,00000
84.0,25.0,57.0,597,06,01,  Talukder Para,21,37,13,22,8,15,36.2,37.1,34.8,00000
84.0,25.0,57.0,597,07,01,  Ghumjai Para,14,29,8,15,6,14,32.6,34.8,30.0,00000
84.0,25.0,57.0,597,08,01,  Shamuk Chhari,102,281,58,139,44,142,26.6,29.4,23.7,00000
84.0,25.0,57.0,597,09,01,  Rangi Para,556,382,295,188,261,194,59.3,61.1,57.4,00000
84.0,25.0,57.0,597,11,01,  Kachukhali Karbari Para,149,99,71,44,78,55,60.1,61.7,58.6,00000
84.0,25.0,57.0,597,12,01,  Betchhari Para,314,436,165,223,149,213,41.9,42.5,41.2,00000
84.0,25.0,57.0,597,13,01,  Mitinga Chhari,84,178,48,86,36,92,32.1,35.8,28.1,00000
84.0,25.0,57.0,597,14,01,  Jautha Khamar,53,202,28,99,25,103,20.8,22.0,19.5,00000
84.0,25.0,57.0,597,15,01,  Levar Para,85,107,57,42,28,65,44.3,57.6,30.1,00000
84.0,25.0,57.0,597,16,01,  Nizpara,26,73,17,35,9,38,26.3,32.7,19.1,00000
84.0,25.0,57.0,597,17,01,  Chela Kachu Khali,88,77,54,32,34,45,53.3,62.8,43.0,00000
84.0,25.0,57.0,597,18,01,  Nimnya Bet Chhari N,8,35,4,15,4,20,18.6,21.1,16.7,00000
84.0,25.0,57.0,597,19,01,  Kachukhali Mukh,265,100,136,35,129,65,72.6,79.5,66.5,00000
84.0,25.0,57.0,597,20,01,  Bak Chhari Para,50,106,26,45,24,61,32.1,36.6,28.2,00000
84.0,25.0,57.0,597,21,01,  Noapara,64,73,39,30,25,43,46.7,56.5,36.8,00000
84.0,25.0,57.0,597,22,01,  Khajai Chhari,80,239,47,118,33,121,25.1,28.5,21.4,00000
84.0,25.0,57.0,597,23,01,  Harangi Refujee Par,66,104,41,38,25,66,38.8,51.9,27.5,00000
84.0,25.0,57.0,597,24,01,  Harangi Mukh,12,56,4,31,8,25,17.6,11.4,24.2,00000
84.0,25.0,57.0,597,25,01,  Harangi Para,99,225,58,105,41,120,30.6,35.6,25.5,00000
84.0,25.0,57.0,597,26,01,  Badal Chhari,89,221,64,99,25,122,28.7,39.3,17.0,00000
84.0,25.0,57.0,597,27,01,  Kawkhali Sadar,607,150,398,70,209,80,80.2,85.0,72.3,00000
84.0,25.0,57.0,597,28,01,  Headman Para,70,99,41,43,29,56,41.4,48.8,34.1,00000
84.0,25.0,57.0,597,29,01,  Durchari Para,39,67,22,35,17,32,36.8,38.6,34.7,00000
84.0,25.0,57.0,597,30,01,  Betchari Pahari Para,150,169,83,65,67,104,47.0,56.1,39.2,00000
84.0,25.0,57.0,597,31,01,  Buddut Area Biddutarea,215,58,117,33,98,25,78.8,78.0,79.7,00000
84.0,25.0,57.0,597,32,01,  Nizpara Lower,56,114,33,55,23,59,32.9,37.5,28.0,00000
84.0,25.0,57.0,597,33,01,  Narangi Para,26,108,16,53,10,55,19.4,23.2,15.4,00000
84.0,25.0,57.0,597,34,01,  Kawkhali Sadar Bosti,80,111,45,47,35,64,41.9,48.9,35.4,00000
84.0,25.0,57.0,597,35,01,  Khajal Moin Para,41,142,21,66,20,76,22.4,24.1,20.8,00000
84.0,25.0,57.0,895,01,01,  Pora Adam Para,139,177,97,63,42,114,44.0,60.6,26.9,00000
84.0,25.0,57.0,895,02,01,  Hazachhari,57,159,37,68,20,91,26.4,35.2,18.0,00000
84.0,25.0,57.0,895,03,01,  Ugal Chhari,84,140,59,61,25,79,37.5,49.2,24.0,00000
84.0,25.0,57.0,895,04,01,  Muba Chhari,40,25,24,10,16,15,61.5,70.6,51.6,00000
84.0,25.0,57.0,895,05,01,  Deba Chhari,100,116,67,40,33,76,46.3,62.6,30.3,00000
84.0,25.0,57.0,895,06,01,  Sukna Chhari,126,254,80,114,46,140,33.2,41.2,24.7,00000
84.0,25.0,57.0,895,07,01,  Pan Chhari,177,460,130,198,47,262,27.8,39.6,15.2,00000
84.0,25.0,76.0,696,01,01,  Shialbukka,178,49,90,19,88,30,78.4,82.6,74.6,00000
84.0,25.0,76.0,696,02,01,  Gari Chhari,84,154,50,75,34,79,35.3,40.0,30.1,00000
84.0,25.0,76.0,696,03,01,  Dabanya Chhara,312,341,144,187,168,154,47.8,43.5,52.2,00000
84.0,25.0,76.0,696,04,01,  No.1 Hatimara Para,55,102,33,48,22,54,35.0,40.7,28.9,00000
84.0,25.0,76.0,696,05,01,  No.2 Hatimara Para,122,204,68,86,54,118,37.4,44.2,31.4,00000
84.0,25.0,76.0,696,06,01,  Amchhari Para,103,127,65,44,38,83,44.8,59.6,31.4,00000
84.0,25.0,76.0,696,07,01,  Tarabunia,334,379,189,150,145,229,46.8,55.8,38.8,00000
84.0,25.0,76.0,696,08,01,  Bara Para,57,92,41,35,16,57,38.3,53.9,21.9,00000
84.0,25.0,76.0,696,09,01,  Majhi Para,186,561,120,259,66,302,24.9,31.7,17.9,00000
84.0,25.0,76.0,696,10,01,  Kola Para,45,441,26,216,19,225,9.3,10.7,7.8,00000
84.0,25.0,76.0,696,11,01,  Deba Para,27,148,16,76,11,72,15.4,17.4,13.3,00000
84.0,25.0,76.0,696,12,01,  Barai Chhari,24,241,12,123,12,118,9.1,8.9,9.2,00000
84.0,25.0,76.0,696,13,01,  Maggyama Chhara,59,100,36,43,23,57,37.1,45.6,28.8,00000
84.0,25.0,76.0,696,14,01,  Durja Para,96,193,68,84,28,109,33.2,44.7,20.4,00000
84.0,25.0,76.0,696,15,01,  Battali,89,438,52,207,37,231,16.9,20.1,13.8,00000
84.0,25.0,76.0,696,16,01,  Bara Dulu Para (Par,236,464,141,207,95,257,33.7,40.5,27.0,00000
84.0,25.0,76.0,696,17,01,  Hatimara,124,73,61,31,63,42,62.9,66.3,60.0,00000
84.0,25.0,76.0,696,18,01,  Kawkhali Bazar,166,68,87,28,79,40,70.9,75.7,66.4,00000
84.0,25.0,76.0,696,19,01,  Kaskhali,56,116,33,63,23,53,32.6,34.4,30.3,00000
84.0,25.0,76.0,696,20,01,  Poapara,251,177,133,70,118,107,58.6,65.5,52.4,00000
84.0,25.0,76.0,696,21,01,  Lower Poa Para,106,69,55,27,51,42,60.6,67.1,54.8,00000
84.0,25.0,76.0,696,22,01,  Chhota Dulu Para,137,162,79,67,58,95,45.8,54.1,37.9,00000
84.0,25.0,76.0,696,23,01,  Nouwka Para,6,37,4,20,2,17,14.0,16.7,10.5,00000
84.0,25.0,76.0,696,24,01,  Naillya Chhari Uttar,371,717,180,308,191,409,34.1,36.9,31.8,00000
84.0,25.0,76.0,696,25,01,  Sugar Mill (Adarsha),435,416,183,217,252,199,51.1,45.8,55.9,00000
84.0,25.0,76.0,696,26,01,  Puran Poa Para,47,70,29,30,18,40,40.2,49.2,31.0,00000
84.0,25.0,76.0,696,27,01,  Poapara Adarsha Gram,296,339,165,174,131,165,46.6,48.7,44.3,00000
84.0,25.0,76.0,696,28,01,  Nailla Chari Dakshin,794,660,398,305,396,355,54.6,56.6,52.7,00000
84.0,29.0,23.0,220,01,03,  Belai Chhari,1154,357,771,207,383,150,76.4,78.8,71.9,00000
84.0,29.0,23.0,220,02,03,  Killachhari Punarba,20,26,15,12,5,14,43.5,55.6,26.3,00000
84.0,29.0,23.0,220,03,03,  Belai Chari Moin,72,87,52,32,20,55,45.3,61.9,26.7,00000
84.0,29.0,23.0,220,04,03,  Duppar Char,215,259,132,129,83,130,45.4,50.6,39.0,00000
84.0,29.0,23.0,771,01,01,  Uttar Kutubdia Para,84,99,52,42,32,57,45.9,55.3,36.0,00000
84.0,29.0,23.0,771,02,01,  Dakshin Kutubdia Pa,165,175,109,50,56,125,48.5,68.6,30.9,00000
84.0,29.0,23.0,771,03,01,  Kutubdia Punarbasha,51,89,30,34,21,55,36.4,46.9,27.6,00000
84.0,29.0,23.0,771,04,01,  Gaskata Chara,36,172,27,84,9,88,17.3,24.3,9.3,00000
84.0,29.0,23.0,994,01,01,  Degal Chhari Adarsh,519,304,375,134,144,170,63.1,73.7,45.9,00000
84.0,29.0,23.0,994,02,01,  Degal Chari Moin,35,139,21,73,14,66,20.1,22.3,17.5,00000
84.0,29.0,23.0,994,03,01,  Degal Chhari Debar,28,153,22,82,6,71,15.5,21.2,7.8,00000
84.0,29.0,23.0,994,04,01,  Bohaltali Para,165,156,90,66,75,90,51.4,57.7,45.5,00000
84.0,29.0,23.0,994,05,01,  Shakra Chhari Muke,49,70,34,32,15,38,41.2,51.5,28.3,00000
84.0,29.0,23.0,994,06,01,  Dushri Para,141,345,105,169,36,176,29.0,38.3,17.0,00000
84.0,29.0,23.0,995,01,01,  Panku Para,228,204,137,69,91,135,52.8,66.5,40.3,00000
84.0,29.0,23.0,995,02,01,  Dupsheel Para,281,615,212,275,69,340,31.4,43.5,16.9,00000
84.0,29.0,23.0,995,03,01,  Tinkunia Para,34,43,24,32,10,11,44.2,42.9,47.6,00000
84.0,29.0,47.0,980,01,01,  Alikhong,72,205,58,94,14,111,26.0,38.2,11.2,00000
84.0,29.0,47.0,980,02,01,  Ulu Chhari,45,316,38,149,7,167,12.5,20.3,4.0,00000
84.0,29.0,47.0,980,03,01,  Taktanala,294,1244,207,622,87,622,19.1,25.0,12.3,00000
84.0,29.0,47.0,980,04,01,  Ora Chhari,199,1171,147,557,52,614,14.5,20.9,7.8,00000
84.0,29.0,47.0,980,05,01,  Goain Chhari,170,970,131,451,39,519,14.9,22.5,7.0,00000
84.0,29.0,47.0,980,06,01,  Tankuitang,47,766,41,405,6,361,5.8,9.2,1.6,00000
84.0,29.0,47.0,980,07,01,  Farua Bazar,157,121,135,61,22,60,56.5,68.9,26.8,00000
84.0,29.0,47.0,980,08,01,  Mondira Chhari,52,663,39,328,13,335,7.3,10.6,3.7,00000
84.0,29.0,47.0,980,09,01,  Akuzza Chhari,230,1047,167,499,63,548,18.0,25.1,10.3,00000
84.0,29.0,47.0,980,10,01,  Boiraigga Chhari,12,292,12,146,0,146,3.9,7.6,0.0,00000
84.0,29.0,47.0,980,11,01,  Tara Chhari Para,97,439,74,211,23,228,18.1,26.0,9.2,00000
84.0,29.0,47.0,980,12,01,  Gobai Chhari,55,412,39,211,16,201,11.8,15.6,7.4,00000
84.0,29.0,47.0,980,13,01,  Jumuna Chhari,157,150,100,58,57,92,51.1,63.3,38.3,00000
84.0,29.0,47.0,980,14,01,  Sukur Chhari,58,154,52,83,6,71,27.4,38.5,7.8,00000
84.0,29.0,47.0,980,15,01,  Jurul Chhari,3,56,2,23,1,33,5.1,8.0,2.9,00000
84.0,29.0,47.0,980,16,01,  Hati Chara,5,67,4,33,1,34,6.9,10.8,2.9,00000
84.0,29.0,47.0,980,17,01,  Dupani Chara Para,3,46,3,22,0,24,6.1,12.0,0.0,00000
84.0,29.0,47.0,980,18,01,  Chapru Para,7,29,4,12,3,17,19.4,25.0,15.0,00000
84.0,29.0,47.0,980,19,01,  Pronjang,22,125,13,56,9,69,15.0,18.8,11.5,00000
84.0,29.0,47.0,980,20,01,  Charjing,20,68,14,25,6,43,22.7,35.9,12.2,00000
84.0,29.0,47.0,980,21,01,  Pukur Para,82,114,67,50,15,64,41.8,57.3,19.0,00000
84.0,29.0,47.0,980,22,01,  Chalchhara Para,0,97,0,50,0,47,0.0,0.0,0.0,00000
84.0,29.0,47.0,980,23,01,  Chadarichhara Para,0,62,0,33,0,29,0.0,0.0,0.0,00000
84.0,29.0,47.0,980,24,01,  Puratan Tiger Para,1,138,1,75,0,63,0.7,1.3,0.0,00000
84.0,29.0,47.0,980,25,01,  Bilchhara Para,8,75,5,34,3,41,9.6,12.8,6.8,00000
84.0,29.0,47.0,980,26,01,  Barathali Marma Para,21,231,14,118,7,113,8.3,10.6,5.8,00000
84.0,29.0,47.0,980,27,01,  Barathali Tripura Para,98,156,82,64,16,92,38.6,56.2,14.8,00000
84.0,29.0,47.0,980,28,01,  Saizam Para,14,134,9,65,5,69,9.5,12.2,6.8,00000
84.0,29.0,71.0,440,01,01,  Punarbashan Zone,510,585,284,275,226,310,46.6,50.8,42.2,00000
84.0,29.0,71.0,440,02,01,  Kangra Chari,277,195,182,63,95,132,58.7,74.3,41.9,00000
84.0,29.0,71.0,440,03,01,  Begana Chari,37,213,26,107,11,106,14.8,19.5,9.4,00000
84.0,29.0,71.0,440,04,01,  Narai Chari Para,177,340,131,130,46,210,34.2,50.2,18.0,00000
84.0,29.0,71.0,440,05,01,  Petta  Chari,46,116,35,47,11,69,28.4,42.7,13.8,00000
84.0,29.0,71.0,440,06,01,  Marang Chhari,70,195,40,94,30,101,26.4,29.9,22.9,00000
84.0,29.0,71.0,440,07,01,  Hija Chhari,108,223,76,95,32,128,32.6,44.4,20.0,00000
84.0,29.0,71.0,440,08,01,  Shapchari,31,168,24,75,7,93,15.6,24.2,7.0,00000
84.0,29.0,71.0,440,09,01,  Deba Chhari Para,84,116,58,50,26,66,42.0,53.7,28.3,00000
84.0,29.0,71.0,550,01,01,  A.P.Batalion,93,164,74,61,19,103,36.2,54.8,15.6,00000
84.0,29.0,71.0,550,02,01,  Parikhala Moin,170,55,103,7,67,48,75.6,93.6,58.3,00000
84.0,29.0,71.0,882,01,01,  Keran  Chhari,291,163,164,65,127,98,64.1,71.6,56.4,00000
84.0,29.0,71.0,882,02,01,  Bengal Kata,160,177,97,69,63,108,47.5,58.4,36.8,00000
84.0,36.0,19.0,994,01,01,  Tanchanga Para,161,114,88,53,73,61,58.5,62.4,54.5,00000
84.0,36.0,19.0,994,02,01,  Mitinga Chari,277,247,143,125,134,122,52.9,53.4,52.3,00000
84.0,36.0,19.0,994,03,01,  College Area,364,151,182,77,182,74,70.7,70.3,71.1,00000
84.0,36.0,19.0,994,04,01,  Upazila Area,440,133,264,58,176,75,76.8,82.0,70.1,00000
84.0,36.0,19.0,994,05,01,  Koylar Depo,583,221,318,101,265,120,72.5,75.9,68.8,00000
84.0,36.0,19.0,994,06,01,  Chunarbhati,252,348,130,164,122,184,42.0,44.2,39.9,00000
84.0,36.0,19.0,994,07,01,  Driver Colony,205,34,99,10,106,24,85.8,90.8,81.5,00000
84.0,36.0,19.0,994,08,01,  Bara Gonia,1606,270,831,121,775,149,85.6,87.3,83.9,00000
84.0,36.0,19.0,994,09,01,  Shadequee Ghona,275,119,140,58,135,61,69.8,70.7,68.9,00000
84.0,36.0,19.0,994,10,01,  Fakira Ghona,199,51,112,26,87,25,79.6,81.2,77.7,00000
84.0,36.0,19.0,994,11,01,  Limon Type,616,120,342,54,274,66,83.7,86.4,80.6,00000
84.0,36.0,19.0,994,12,01,  B.Market Area,62,50,46,28,16,22,55.4,62.2,42.1,00000
84.0,36.0,19.0,994,13,01,  Junior Bangla,204,16,127,10,77,6,92.7,92.7,92.8,00000
84.0,36.0,19.0,994,14,01,  Senior Bangla,168,22,123,15,45,7,88.4,89.1,86.5,00000
84.0,36.0,19.0,994,15,01,  Engineering Colony,214,51,123,24,91,27,80.8,83.7,77.1,00000
84.0,36.0,19.0,994,16,01,  Kalabagan,1903,405,1200,231,703,174,82.5,83.9,80.2,00000
84.0,36.0,19.0,994,17,01,  Guard Colony,214,39,137,20,77,19,84.6,87.3,80.2,00000
84.0,36.0,19.0,994,18,01,  Dormitory,82,11,50,4,32,7,88.2,92.6,82.1,00000
84.0,36.0,19.0,994,19,01,  Thanaghat Area,110,51,83,38,27,13,68.3,68.6,67.5,00000
84.0,36.0,19.0,994,20,01,  Mission Area,423,33,159,10,264,23,92.8,94.1,92.0,00000
84.0,36.0,38.0,089,01,01,  Headman Para,34,112,21,52,13,60,23.3,28.8,17.8,00000
84.0,36.0,38.0,089,02,01,  Jura Chhari Para,6,38,6,23,0,15,13.6,20.7,0.0,00000
84.0,36.0,38.0,089,03,01,  Arachhari Muk,73,78,52,35,21,43,48.3,59.8,32.8,00000
84.0,36.0,38.0,089,04,01,  Baiddhya Para,10,36,9,13,1,23,21.7,40.9,4.2,00000
84.0,36.0,38.0,276,01,01,  Idris Farm (Bagarch,20,27,11,12,9,15,42.6,47.8,37.5,00000
84.0,36.0,38.0,276,02,01,  Puttya Chhari,30,40,16,19,14,21,42.9,45.7,40.0,00000
84.0,36.0,38.0,276,03,01,  Ujan Chhari,64,122,40,54,24,68,34.4,42.6,26.1,00000
84.0,36.0,38.0,276,04,01,  K.P.M.Jamai Chhari,13,7,6,3,7,4,65.0,66.7,63.6,00000
84.0,36.0,38.0,276,05,01,  Bamani Chhara,66,83,43,42,23,41,44.3,50.6,35.9,00000
84.0,36.0,38.0,276,06,01,  Mokba Chhara,27,32,11,15,16,17,45.8,42.3,48.5,00000
84.0,36.0,38.0,276,07,01,  Headman Para,149,61,82,21,67,40,71.0,79.6,62.6,00000
84.0,36.0,38.0,276,08,01,  Bazar Area,146,77,88,31,58,46,65.5,73.9,55.8,00000
84.0,36.0,38.0,276,09,01,  Maidong Para,35,118,23,53,12,65,22.9,30.3,15.6,00000
84.0,36.0,38.0,276,10,01,  Liching Para,11,84,6,45,5,39,11.6,11.8,11.4,00000
84.0,36.0,38.0,276,11,01,  Changra Chhari,280,348,173,149,107,199,44.6,53.7,35.0,00000
84.0,36.0,38.0,276,12,01,  Bara Para,230,93,124,38,106,55,71.2,76.5,65.8,00000
84.0,36.0,38.0,276,13,01,  Muslim Para,516,312,262,144,254,168,62.3,64.5,60.2,00000
84.0,36.0,38.0,276,14,01,  Kalabunia,11,81,10,37,1,44,12.0,21.3,2.2,00000
84.0,36.0,38.0,829,01,01,  Pekua Punarbashan A,115,59,68,17,47,42,66.1,80.0,52.8,00000
84.0,36.0,38.0,829,02,01,  School Area,49,66,40,44,9,22,42.6,47.6,29.0,00000
84.0,36.0,38.0,829,03,01,  Headman Para,166,165,99,61,67,104,50.2,61.9,39.2,00000
84.0,36.0,38.0,829,04,01,  Lapai Para,29,29,19,11,10,18,50.0,63.3,35.7,00000
84.0,36.0,38.0,829,05,01,  Limong Chhara,20,36,12,11,8,25,35.7,52.2,24.2,00000
84.0,36.0,38.0,829,06,01,  Koymong Para,21,26,17,13,4,13,44.7,56.7,23.5,00000
84.0,36.0,38.0,829,07,01,  Sailya Para,0,29,0,14,0,15,0.0,0.0,0.0,00000
84.0,36.0,38.0,829,08,01,  Gungmung Para,6,19,3,10,3,9,24.0,23.1,25.0,00000
84.0,36.0,57.0,110,01,01,  Gachhkata,55,190,39,93,16,97,22.4,29.5,14.2,00000
84.0,36.0,57.0,110,02,01,  Golakdhan Para,65,238,43,117,22,121,21.5,26.9,15.4,00000
84.0,36.0,57.0,165,01,01,  Harin Chhara Moin P,22,158,17,72,5,86,12.2,19.1,5.5,00000
84.0,36.0,57.0,165,02,01,  Dhaner Harin Chhara,28,208,23,99,5,109,11.9,18.9,4.4,00000
84.0,36.0,57.0,165,03,01,  Dochhara Para,40,162,30,80,10,82,19.8,27.3,10.9,00000
84.0,36.0,57.0,165,04,01,  Harin Chhara Mukhpa,92,102,58,45,34,57,47.4,56.3,37.4,00000
84.0,36.0,57.0,165,05,01,  Baibon Chhara,74,132,47,58,27,74,35.9,44.8,26.7,00000
84.0,36.0,57.0,165,06,01,  Joykumar,26,125,24,61,2,64,17.2,28.2,3.0,00000
84.0,36.0,57.0,625,01,03,  Bang Chhari,119,222,78,98,41,124,34.9,44.3,24.8,00000
84.0,36.0,57.0,625,02,03,  Chitmaran Ghat,92,95,48,54,44,41,49.2,47.1,51.8,00000
84.0,36.0,57.0,625,03,03,  Lock Gate,249,792,129,413,120,379,23.9,23.8,24.0,00000
84.0,36.0,57.0,625,04,03,  Swidish Forest Area,246,30,138,14,108,16,89.1,90.8,87.1,00000
84.0,36.0,57.0,625,05,03,  Swidish Area,552,36,415,23,137,13,93.9,94.7,91.3,00000
84.0,36.0,57.0,625,06,03,  F.I.D.C. Area,1215,527,662,253,553,274,69.7,72.3,66.9,00000
84.0,36.0,57.0,625,07,03,  K.P.M. Project Area,389,117,219,56,170,61,76.9,79.6,73.6,00000
84.0,36.0,57.0,625,08,03,  Sandwip Para,166,253,96,132,70,121,39.6,42.1,36.6,00000
84.0,36.0,57.0,625,09,03,  Jety Ghat,786,217,578,164,208,53,78.4,77.9,79.7,00000
84.0,36.0,57.0,625,10,03,  Jalia Para,84,156,50,77,34,79,35.0,39.4,30.1,00000
84.0,36.0,57.0,625,11,03,  Natun Bazar Area,1197,833,760,447,437,386,59.0,63.0,53.1,00000
84.0,36.0,57.0,625,12,03,  Chowdhury Chhara,628,98,391,50,237,48,86.5,88.7,83.2,00000
84.0,36.0,57.0,625,13,03,  Right Bank,291,15,162,4,129,11,95.1,97.6,92.1,00000
84.0,36.0,57.0,625,14,03,  Left Bank,901,112,508,45,393,67,88.9,91.9,85.4,00000
84.0,36.0,57.0,625,15,03,  Fulbagan,757,93,409,31,348,62,89.1,93.0,84.9,00000
84.0,36.0,57.0,625,16,03,  Bangla Colony,553,63,313,43,240,20,89.8,87.9,92.3,00000
84.0,36.0,57.0,625,17,03,  Brick Field,153,142,94,57,59,85,51.9,62.3,41.0,00000
84.0,36.0,57.0,625,18,03,  Army Head Quarter,473,22,368,7,105,15,95.6,98.1,87.5,00000
84.0,36.0,76.0,773,01,01,  Noapara,102,88,51,38,51,50,53.7,57.3,50.5,00000
84.0,36.0,76.0,773,02,01,  Dalu Chhari,227,179,123,72,104,107,55.9,63.1,49.3,00000
84.0,36.0,76.0,773,03,01,  Narangiri Mukh,139,52,77,12,62,40,72.8,86.5,60.8,00000
84.0,36.0,76.0,773,04,01,  Maidong,81,192,50,89,31,103,29.7,36.0,23.1,00000
84.0,36.0,76.0,773,05,01,  Jagana Chhari,71,60,37,22,34,38,54.2,62.7,47.2,00000
84.0,36.0,76.0,773,06,01,  Sita Parhar,64,153,38,76,26,77,29.5,33.3,25.2,00000
84.0,36.0,76.0,939,01,01,  Kazi Para,145,101,79,49,66,52,58.9,61.7,55.9,00000
84.0,36.0,76.0,939,02,01,  Majhi Para,147,66,74,24,73,42,69.0,75.5,63.5,00000
84.0,36.0,76.0,939,03,01,  Thana Pahar,76,8,56,2,20,6,90.5,96.6,76.9,00000
84.0,36.0,76.0,939,04,01,  Refujee Para,277,224,143,95,134,129,55.3,60.1,51.0,00000
84.0,36.0,76.0,939,05,01,  Barjiri Para,141,217,77,99,64,118,39.4,43.8,35.2,00000
84.0,36.0,76.0,939,06,01,  Lemu Chhari,294,267,148,119,146,148,52.4,55.4,49.7,00000
84.0,36.0,76.0,939,07,01,  Roykhali Bazar Area,486,159,257,58,229,101,75.3,81.6,69.4,00000
84.0,36.0,76.0,939,08,01,  Roykhali Farm Area,164,163,97,74,67,89,50.2,56.7,42.9,00000
84.0,36.0,76.0,939,09,01,  Narangri Mukh,319,118,161,55,158,63,73.0,74.5,71.5,00000
84.0,36.0,76.0,939,10,01,  Jagna Chhari,144,177,86,83,58,94,44.9,50.9,38.2,00000
84.0,36.0,76.0,939,11,01,  Barakhola Para,283,160,158,63,125,97,63.9,71.5,56.3,00000
84.0,36.0,76.0,939,12,01,  Goniakhola,236,209,119,92,117,117,53.0,56.4,50.0,00000
84.0,36.0,76.0,939,13,01,  Khantakata,515,137,253,62,262,75,79.0,80.3,77.7,00000
84.0,36.0,76.0,939,14,01,  Kodala,338,330,193,170,145,160,50.6,53.2,47.5,00000
84.0,36.0,76.0,939,15,01,  Dongnala Lama Para,144,149,80,67,64,82,49.1,54.4,43.8,00000
84.0,36.0,76.0,939,16,01,  Dongnala Mahamani P,83,38,42,10,41,28,68.6,80.8,59.4,00000
84.0,36.0,76.0,939,17,01,  Dongnala Trambo Par,114,73,65,22,49,51,61.0,74.7,49.0,00000
84.0,36.0,76.0,939,18,01,  Dongnala Chainjali,22,72,10,31,12,41,23.4,24.4,22.6,00000
84.0,36.0,76.0,939,19,01,  Dongnala Tangsi Par,46,53,24,23,22,30,46.5,51.1,42.3,00000
84.0,36.0,76.0,939,20,01,  Dongnala Amtali Par,67,68,42,33,25,35,49.6,56.0,41.7,00000
84.0,36.0,76.0,939,21,01,  Dongnala Parigya Pa,63,77,29,37,34,40,45.0,43.9,45.9,00000
84.0,36.0,76.0,939,22,01,  Tambaghona,19,57,8,30,11,27,25.0,21.1,28.9,00000
84.0,36.0,76.0,939,23,01,  Roykhali Punarbasha,55,75,38,33,17,42,42.3,53.5,28.8,00000
84.0,36.0,76.0,939,24,01,  Karigar Para,157,148,93,63,64,85,51.5,59.6,43.0,00000
84.0,36.0,76.0,939,25,01,  Mati Para,196,152,122,51,74,101,56.3,70.5,42.3,00000
84.0,36.0,76.0,939,26,01,  Hapchhari,142,184,98,81,44,103,43.6,54.7,29.9,00000
84.0,36.0,76.0,939,27,01,  Moidong,97,110,54,61,43,49,46.9,47.0,46.7,00000
84.0,36.0,76.0,939,28,01,  Balam Chhari,75,91,42,37,33,54,45.2,53.2,37.9,00000
84.0,36.0,76.0,939,29,01,  Gongri Chhara,86,246,65,116,21,130,25.9,35.9,13.9,00000
84.0,36.0,76.0,939,30,01,  Kala Maysa Mukh,83,119,51,46,32,73,41.1,52.6,30.5,00000
84.0,36.0,76.0,939,31,01,  Kala Maysa,109,67,65,26,44,41,61.9,71.4,51.8,00000
84.0,36.0,76.0,939,32,01,  Bhalukia,192,463,115,212,77,251,29.3,35.2,23.5,00000
84.0,36.0,76.0,939,33,01,  Chakua Para,25,82,15,33,10,49,23.4,31.3,16.9,00000
84.0,36.0,76.0,939,34,01,  Miri Chhara Para,49,188,28,92,21,96,20.7,23.3,17.9,00000
84.0,36.0,76.0,939,35,01,  Panchhari,76,331,48,163,28,168,18.7,22.7,14.3,00000
84.0,36.0,76.0,939,36,01,  Mitia Chhari,45,136,28,67,17,69,24.9,29.5,19.8,00000
84.0,36.0,76.0,939,37,01,  Tinchhari,116,341,67,156,49,185,25.4,30.0,20.9,00000
84.0,36.0,76.0,939,38,01,  Goba Chhara,62,290,34,124,28,166,17.6,21.5,14.4,00000
84.0,36.0,76.0,939,39,01,  Nara Chhara,115,326,75,145,40,181,26.1,34.1,18.1,00000
84.0,36.0,76.0,939,40,01,  Kachuri Para,10,101,8,45,2,56,9.0,15.1,3.4,00000
84.0,36.0,76.0,939,41,01,  Tinchhari Punarbash,30,103,24,46,6,57,22.6,34.3,9.5,00000
84.0,36.0,76.0,939,42,01,  Narangiri Bara Para,77,236,41,107,36,129,24.6,27.7,21.8,00000
84.0,36.0,86.0,994,01,01,  Debata Chhari,556,465,346,163,210,302,54.5,68.0,41.0,00000
84.0,36.0,86.0,994,02,01,  Murali Para,219,288,128,131,91,157,43.2,49.4,36.7,00000
84.0,36.0,86.0,994,03,01,  Kukimara,187,398,105,175,82,223,32.0,37.5,26.9,00000
84.0,36.0,86.0,994,04,01,  Amlaki Para,25,62,13,30,12,32,28.7,30.2,27.3,00000
84.0,36.0,86.0,994,05,01,  Tomba Para,134,181,86,73,48,108,42.5,54.1,30.8,00000
84.0,36.0,86.0,994,06,01,  Tripura Chhari,47,47,17,26,30,21,50.0,39.5,58.8,00000
84.0,36.0,86.0,994,07,01,  Agunia Chhara,69,93,38,45,31,48,42.6,45.8,39.2,00000
84.0,36.0,86.0,994,08,01,  Dekikata,22,34,13,14,9,20,39.3,48.1,31.0,00000
84.0,36.0,86.0,994,09,01,  Hatimara,20,37,12,17,8,20,35.1,41.4,28.6,00000
84.0,36.0,86.0,994,10,01,  Sap Chhari,181,69,115,14,66,55,72.4,89.1,54.5,00000
84.0,36.0,86.0,994,11,01,  Sap Chhari Main,111,90,64,35,47,55,55.2,64.6,46.1,00000
84.0,36.0,86.0,994,12,01,  Gazania,69,71,36,28,33,43,49.3,56.3,43.4,00000
84.0,36.0,86.0,994,13,01,  Paglee Mukh,60,21,42,10,18,11,74.1,80.8,62.1,00000
84.0,36.0,86.0,994,14,01,  Paglee,147,86,93,22,54,64,63.1,80.9,45.8,00000
84.0,36.0,86.0,994,15,01,  Talukder Para,109,93,70,31,39,62,54.0,69.3,38.6,00000
84.0,36.0,86.0,994,16,01,  Dulunia,81,102,51,45,30,57,44.3,53.1,34.5,00000
84.0,36.0,86.0,994,17,01,  Noapara,201,166,124,60,77,106,54.8,67.4,42.1,00000
84.0,36.0,86.0,994,18,01,  Nun Chhari,79,106,44,42,35,64,42.7,51.2,35.4,00000
84.0,36.0,86.0,994,19,01,  Nun Chhari Main,34,35,20,17,14,18,49.3,54.1,43.8,00000
84.0,36.0,86.0,994,20,01,  Barai Chhari Para,141,62,77,25,64,37,69.5,75.5,63.4,00000
84.0,36.0,86.0,994,21,01,  Wagga Jautha Khamar,110,93,62,34,48,59,54.2,64.6,44.9,00000
84.0,36.0,86.0,994,22,01,  Barai Chhari Bazar,279,48,161,23,118,25,85.3,87.5,82.5,00000
84.0,36.0,86.0,994,23,01,  Wagga Pump House,198,7,135,6,63,1,96.6,95.7,98.4,00000
84.0,36.0,86.0,994,24,01,  Wagga Chhara,324,15,244,7,80,8,95.6,97.2,90.9,00000
84.0,36.0,86.0,994,25,01,  Kuli Para,101,89,54,35,47,54,53.2,60.7,46.5,00000
84.0,36.0,86.0,994,26,01,  Ram Chhari,145,159,71,75,74,84,47.7,48.6,46.8,00000
84.0,36.0,86.0,994,27,01,  Shil Chhari,797,348,481,170,316,178,69.6,73.9,64.0,00000
84.0,36.0,86.0,994,28,01,  Shil Chhari Marma P,94,91,61,36,33,55,50.8,62.9,37.5,00000
84.0,47.0,19.0,082,01,01,  Headman Para,185,94,106,33,79,61,66.3,76.3,56.4,00000
84.0,47.0,19.0,082,02,01,  Banajugichar Bazar Alaka,835,26,731,6,104,20,97.0,99.2,83.9,00000
84.0,47.0,19.0,082,03,01,  Haliram Para,82,107,49,48,33,59,43.4,50.5,35.9,00000
84.0,47.0,19.0,082,04,01,  Katurakaia Para,181,90,114,27,67,63,66.8,80.9,51.5,00000
84.0,47.0,19.0,082,05,01,  Cumahani Para,60,39,38,9,22,30,60.6,80.9,42.3,00000
84.0,47.0,19.0,082,06,01,  Badal Kumar Para,47,36,28,24,19,12,56.6,53.8,61.3,00000
84.0,47.0,19.0,082,07,01,  Kashablal Para,90,48,54,19,36,29,65.2,74.0,55.4,00000
84.0,47.0,19.0,082,08,01,  Dabachari Para,59,31,32,12,27,19,65.6,72.7,58.7,00000
84.0,47.0,19.0,082,09,01,  Chairman Para,122,67,76,23,46,44,64.6,76.8,51.1,00000
84.0,47.0,19.0,082,10,01,  Lakhichandra Para,68,25,42,9,26,16,73.1,82.4,61.9,00000
84.0,47.0,19.0,082,11,01,  Nanaram Karbari Para,66,19,36,5,30,14,77.6,87.8,68.2,00000
84.0,47.0,19.0,165,01,01,  Chokpatighat Para,186,77,110,23,76,54,70.7,82.7,58.5,00000
84.0,47.0,19.0,165,02,01,  Samukchari Para,88,58,48,19,40,39,60.3,71.6,50.6,00000
84.0,47.0,19.0,165,03,01,  Dan Cumacumi,215,76,123,23,92,53,73.9,84.2,63.4,00000
84.0,47.0,19.0,165,04,01,  Bamer Cumacumi,93,49,53,19,40,30,65.5,73.6,57.1,00000
84.0,47.0,19.0,414,01,01,  Kangrachari Para,160,79,98,17,62,62,66.9,85.2,50.0,00000
84.0,47.0,19.0,414,02,01,  Hajjamachara Para,65,88,39,44,26,44,42.5,47.0,37.1,00000
84.0,47.0,19.0,414,03,01,  Panchari Mough Para,177,72,102,22,75,50,71.1,82.3,60.0,00000
84.0,47.0,19.0,414,04,01,  Chittima Chara,58,85,36,35,22,50,40.6,50.7,30.6,00000
84.0,47.0,19.0,414,05,01,  Nowa Para,62,20,32,3,30,17,75.6,91.4,63.8,00000
84.0,47.0,19.0,414,06,01,  Bakabakya,77,42,51,10,26,32,64.7,83.6,44.8,00000
84.0,47.0,19.0,414,07,01,  Chata Panchari,81,77,54,28,27,49,51.3,65.9,35.5,00000
84.0,47.0,19.0,414,08,01,  Baluch Para,38,101,31,43,7,58,27.3,41.9,10.8,00000
84.0,47.0,19.0,414,09,01,  Baira Chari,178,139,120,42,58,97,56.2,74.1,37.4,00000
84.0,47.0,19.0,414,10,01,  Labar Para,45,63,33,23,12,40,41.7,58.9,23.1,00000
84.0,47.0,38.0,331,01,01,  Bamer Subalong Para,121,196,82,80,39,116,38.2,50.6,25.2,00000
84.0,47.0,38.0,331,02,01,  Barkalak,108,249,76,109,32,140,30.3,41.1,18.6,00000
84.0,47.0,38.0,331,03,01,  Champay Para,105,357,70,180,35,177,22.7,28.0,16.5,00000
84.0,47.0,38.0,331,04,01,  Kuradia,41,226,33,119,8,107,15.4,21.7,7.0,00000
84.0,47.0,38.0,331,05,01,  Bagakhali,99,527,76,253,23,274,15.8,23.1,7.7,00000
84.0,47.0,38.0,331,06,01,  Dumdumya Para,124,321,84,149,40,172,27.9,36.1,18.9,00000
84.0,47.0,38.0,331,07,01,  Bosti Para,101,294,66,131,35,163,25.6,33.5,17.7,00000
84.0,47.0,38.0,331,08,01,  Kandara Chara,105,136,73,61,32,75,43.6,54.5,29.9,00000
84.0,47.0,38.0,331,09,01,  Mondirachara Para,43,137,33,64,10,73,23.9,34.0,12.0,00000
84.0,47.0,38.0,331,10,01,  Duluchari Para,101,512,87,239,14,273,16.5,26.7,4.9,00000
84.0,47.0,38.0,331,11,01,  Kunda Chara Para,86,188,75,76,11,112,31.4,49.7,8.9,00000
84.0,47.0,38.0,331,12,01,  Gabachari Para,88,77,52,31,36,46,53.3,62.7,43.9,00000
84.0,47.0,38.0,331,13,01,  Harinhat Chara Mough Para,78,141,63,61,15,80,35.6,50.8,15.8,00000
84.0,47.0,38.0,331,14,01,  Kulukpanichara(Chairman Para),51,328,40,157,11,171,13.5,20.3,6.0,00000
84.0,47.0,38.0,331,15,01,  Cimultali Para,34,210,26,97,8,113,13.9,21.1,6.6,00000
84.0,47.0,38.0,331,16,01,  Adho Para,70,360,59,169,11,191,16.3,25.9,5.4,00000
84.0,47.0,57.0,497,01,03,  Upazila Sadar Alaka,592,164,380,50,212,114,78.3,88.4,65.0,00000
84.0,47.0,57.0,497,02,03,  Jagkha Bazar Alaka,236,70,176,42,60,28,77.1,80.7,68.2,00000
84.0,47.0,57.0,497,03,03,  Balukhali Mough,244,120,143,41,101,79,67.0,77.7,56.1,00000
84.0,47.0,57.0,497,04,03,  Vitar Balukhali Para,39,102,27,39,12,63,27.7,40.9,16.0,00000
84.0,47.0,57.0,497,05,03,  Madhya Balakhali,144,139,84,58,60,81,50.9,59.2,42.6,00000
84.0,47.0,57.0,497,06,03,  Umtali Para,116,119,76,51,40,68,49.4,59.8,37.0,00000
84.0,47.0,57.0,497,07,03,  Chowdary Para,79,25,52,8,27,17,76.0,86.7,61.4,00000
84.0,47.0,57.0,497,08,03,  Maidya Vita,73,60,36,25,37,35,54.9,59.0,51.4,00000
84.0,47.0,57.0,497,09,03,  Samira Para,207,118,123,41,84,77,63.7,75.0,52.2,00000
84.0,47.0,57.0,497,10,03,  Bamer Cumacumi,24,88,16,40,8,48,21.4,28.6,14.3,00000
84.0,47.0,57.0,497,11,03,  Dura Hatchara,29,175,24,87,5,88,14.2,21.6,5.4,00000
84.0,47.0,57.0,497,12,03,  Gilatali Para,278,236,164,99,114,137,54.1,62.4,45.4,00000
84.0,47.0,57.0,497,13,03,  Shil Chari,159,204,105,81,54,123,43.8,56.5,30.5,00000
84.0,47.0,57.0,497,14,03,  Chalkha Para,126,126,86,56,40,70,50.0,60.6,36.4,00000
84.0,47.0,57.0,497,15,03,  Nowa Para,134,140,95,52,39,88,48.9,64.6,30.7,00000
84.0,47.0,57.0,497,16,03,  Sohel Para,97,138,78,45,19,93,41.3,63.4,17.0,00000
84.0,47.0,57.0,497,17,03,  Janata Para,90,151,51,68,39,83,37.3,42.9,32.0,00000
84.0,47.0,57.0,497,18,03,  Ciba Panchari Para,87,31,53,13,34,18,73.7,80.3,65.4,00000
84.0,47.0,57.0,497,19,03,  Barajgala Para,40,93,30,41,10,52,30.1,42.3,16.1,00000
84.0,47.0,57.0,580,01,01,  Headman Para,130,44,78,9,52,35,74.7,89.7,59.8,00000
84.0,47.0,57.0,580,02,01,  Gavachari Para,66,74,44,31,22,43,47.1,58.7,33.8,00000
84.0,47.0,57.0,580,03,01,  Shalbagan,57,37,43,17,14,20,60.6,71.7,41.2,00000
84.0,47.0,57.0,580,04,01,  Supchari Para,50,33,36,7,14,26,60.2,83.7,35.0,00000
84.0,47.0,57.0,580,05,01,  Nandi Chara Para,57,53,38,17,19,36,51.8,69.1,34.5,00000
84.0,47.0,57.0,580,06,01,  Thachi Para,123,97,95,34,28,63,55.9,73.6,30.8,00000
84.0,47.0,57.0,580,07,01,  Kusumchari Moin Par,42,121,26,55,16,66,25.8,32.1,19.5,00000
84.0,47.0,57.0,580,08,01,  Kusum Chari Mough Para,161,74,99,23,62,51,68.5,81.1,54.9,00000
84.0,47.0,57.0,580,09,01,  Bamer Kagrachari Para,24,64,18,28,6,36,27.3,39.1,14.3,00000
84.0,47.0,57.0,663,01,01,  Daba Chara,338,251,218,93,120,158,57.4,70.1,43.2,00000
84.0,47.0,57.0,663,02,01,  Mitinga Chari,124,61,72,22,52,39,67.0,76.6,57.1,00000
84.0,47.0,57.0,663,03,01,  Ganti Chari Para,36,118,22,53,14,65,23.4,29.3,17.7,00000
84.0,47.0,57.0,663,04,01,  Lulang Chari Para,128,207,82,88,46,119,38.2,48.2,27.9,00000
84.0,47.0,76.0,248,01,01,  Shilchari Bazar Alaka,131,74,93,31,38,43,63.9,75.0,46.9,00000
84.0,47.0,76.0,248,02,01,  Barbana Para,49,48,32,22,17,26,50.5,59.3,39.5,00000
84.0,47.0,76.0,248,03,01,  Mondira Chara Para,31,110,21,57,10,53,22.0,26.9,15.9,00000
84.0,47.0,76.0,248,04,01,  South Tintila,32,110,23,55,9,55,22.5,29.5,14.1,00000
84.0,47.0,76.0,248,05,01,  Boatali Para,53,74,38,24,15,50,41.7,61.3,23.1,00000
84.0,47.0,76.0,248,06,01,  Deputi Member Para,32,72,26,33,6,39,30.8,44.1,13.3,00000
84.0,47.0,76.0,539,01,01,  Hajachara Para,58,135,44,58,14,77,30.1,43.1,15.4,00000
84.0,47.0,76.0,539,02,01,  West Tintila Para,125,141,81,57,44,84,47.0,58.7,34.4,00000
84.0,47.0,76.0,539,03,01,  Jarulchari,16,74,16,28,0,46,17.8,36.4,0.0,00000
84.0,47.0,76.0,539,04,01,  Magachari Para,53,125,37,59,16,66,29.8,38.5,19.5,00000
84.0,47.0,76.0,539,05,01,  Jamer Chari Para,86,111,64,43,22,68,43.7,59.8,24.4,00000
84.0,47.0,76.0,539,06,01,  Maga Char Moin Para,44,109,35,39,9,70,28.8,47.3,11.4,00000
84.0,47.0,76.0,539,07,01,  Jamerchari Moin Par,20,31,15,9,5,22,39.2,62.5,18.5,00000
84.0,47.0,76.0,746,01,01,  Katal Tali Para,57,62,33,23,24,39,47.9,58.9,38.1,00000
84.0,47.0,76.0,746,02,01,  Hetchari Para,41,13,22,7,19,6,75.9,75.9,76.0,00000
84.0,47.0,76.0,746,03,01,  Badalhat Chara,33,113,27,51,6,62,22.6,34.6,8.8,00000
84.0,47.0,76.0,746,04,01,  Buatali Chara Para,67,146,58,56,9,90,31.5,50.9,9.1,00000
84.0,47.0,76.0,746,05,01,  Shilbania Chara,36,72,26,27,10,45,33.3,49.1,18.2,00000
84.0,47.0,76.0,746,06,01,  Rajatal Para,26,48,16,22,10,26,35.1,42.1,27.8,00000
84.0,47.0,76.0,746,07,01,  Fakira Chara Bazar Alaka,171,178,137,67,34,111,49.0,67.2,23.4,00000
84.0,47.0,76.0,746,08,01,  Maralia Chara Para,60,81,43,36,17,45,42.6,54.4,27.4,00000
84.0,47.0,76.0,746,09,01,  Fakir Chara Para,83,68,52,28,31,40,55.0,65.0,43.7,00000
84.0,47.0,76.0,829,01,01,  Pan Chharimough Par,110,103,72,43,38,60,51.6,62.6,38.8,00000
84.0,47.0,76.0,829,02,01,  Bandar Haja Para,45,43,32,17,13,26,51.1,65.3,33.3,00000
84.0,47.0,76.0,829,03,01,  Hajachara Para,126,159,87,63,39,96,44.2,58.0,28.9,00000
84.0,47.0,76.0,829,04,01,  Tintila Para,70,58,49,15,21,43,54.7,76.6,32.8,00000
84.0,47.0,76.0,829,05,01,  Hubukchari Para,61,87,48,32,13,55,41.2,60.0,19.1,00000
84.0,47.0,76.0,829,06,01,  Maidang Mough Para,55,81,39,36,16,45,40.4,52.0,26.2,00000
84.0,47.0,76.0,829,07,01,  Madaba Chara Para,89,82,50,36,39,46,52.0,58.1,45.9,00000
84.0,47.0,76.0,829,08,01,  Baher Madng Para,50,84,29,33,21,51,37.3,46.8,29.2,00000
84.0,47.0,76.0,829,09,01,  Jamura Chari Para,55,87,37,37,18,50,38.7,50.0,26.5,00000
84.0,47.0,76.0,829,10,01,  Beltali Para,92,174,60,81,32,93,34.6,42.6,25.6,00000
84.0,58.0,13.0,045,01,01,  Bamer Adarak Chhara,517,725,318,339,199,386,41.6,48.4,34.0,00000
84.0,58.0,13.0,045,02,01,  Karalla Chhari,356,614,211,268,145,346,36.7,44.1,29.5,00000
84.0,58.0,13.0,045,03,01,  Shila Chhara,378,431,242,190,136,241,46.7,56.0,36.1,00000
84.0,58.0,13.0,045,04,01,  Seteller Area(Danie,764,666,384,336,380,330,53.4,53.3,53.5,00000
84.0,58.0,13.0,949,01,01,  Nabin Ch.Para,188,277,123,108,65,169,40.4,53.2,27.8,00000
84.0,58.0,13.0,949,02,01,  Sadak Chara,39,107,24,55,15,52,26.7,30.4,22.4,00000
84.0,58.0,13.0,949,03,01,  Ulta Chhari,100,271,68,123,32,148,27.0,35.6,17.8,00000
84.0,58.0,13.0,949,04,01,  Banartaza Chara,83,206,51,92,32,114,28.7,35.7,21.9,00000
84.0,58.0,13.0,949,05,01,  Sukracharjya Para,67,110,51,48,16,62,37.9,51.5,20.5,00000
84.0,58.0,13.0,949,06,01,  Lamu Chhari,85,349,57,167,28,182,19.6,25.4,13.3,00000
84.0,58.0,13.0,949,07,01,  Supari Pata Chhara,93,234,56,105,37,129,28.4,34.8,22.3,00000
84.0,58.0,13.0,994,01,01,  Jattramura,313,668,170,334,143,334,31.9,33.7,30.0,00000
84.0,58.0,13.0,994,02,01,  Bhangamura,393,392,235,180,158,212,50.1,56.6,42.7,00000
84.0,58.0,13.0,994,03,01,  U.Yearing Chhari Se,250,322,138,159,112,163,43.7,46.5,40.7,00000
84.0,58.0,13.0,994,04,01,  D.Yearing Chhari Se,135,207,58,109,77,98,39.5,34.7,44.0,00000
84.0,58.0,27.0,226,01,01,  Chailiatali East,198,525,139,236,59,289,27.4,37.1,17.0,00000
84.0,58.0,27.0,226,02,01,  Chailiatali West,181,507,95,246,86,261,26.3,27.9,24.8,00000
84.0,58.0,27.0,361,01,01,  Uttar Ghanamor,197,373,125,184,72,189,34.6,40.5,27.6,00000
84.0,58.0,27.0,361,02,01,  Middlegahnamore,237,382,127,195,110,187,38.3,39.4,37.0,00000
84.0,58.0,27.0,361,03,01,  D. Ghanamor,246,214,159,96,87,118,53.5,62.4,42.4,00000
84.0,58.0,27.0,587,01,01,  Baramat,171,471,96,236,75,235,26.6,28.9,24.2,00000
84.0,58.0,27.0,587,02,01,  Dakshin Khagra Chha,29,69,15,34,14,35,29.6,30.6,28.6,00000
84.0,58.0,27.0,587,03,01,  Purba Khagra Chhari,144,401,92,210,52,191,26.4,30.5,21.4,00000
84.0,58.0,27.0,587,04,01,  Khagra Chhari West,177,236,101,122,76,114,42.9,45.3,40.0,00000
84.0,58.0,27.0,587,05,01,  Kattali Bazar,110,139,87,82,23,57,44.2,51.5,28.8,00000
84.0,58.0,27.0,859,01,01,  Uttar Rangapani Cha,126,50,53,28,73,22,71.6,65.4,76.8,00000
84.0,58.0,27.0,859,02,01,  Dakshin Rangapani C,170,212,89,103,81,109,44.5,46.4,42.6,00000
84.0,58.0,40.0,090,01,01,  Muslim Block,208,224,107,117,101,107,48.1,47.8,48.6,00000
84.0,58.0,40.0,090,02,01,  Jalia Para,271,408,144,209,127,199,39.9,40.8,39.0,00000
84.0,58.0,40.0,090,03,01,  Boiragi Bazar,206,149,109,70,97,79,58.0,60.9,55.1,00000
84.0,58.0,40.0,090,04,01,  Uttar Thaka Para,127,507,73,247,54,260,20.0,22.8,17.2,00000
84.0,58.0,40.0,090,05,01,  Dakshin Thaka Para,250,256,123,128,127,128,49.4,49.0,49.8,00000
84.0,58.0,40.0,090,06,01,  Headman Para,99,292,63,148,36,144,25.3,29.9,20.0,00000
84.0,58.0,40.0,090,07,01,  Jarulbagan,160,149,119,64,41,85,51.8,65.0,32.5,00000
84.0,58.0,40.0,090,08,01,  Lohakatbagan,45,122,28,62,17,60,26.9,31.1,22.1,00000
84.0,58.0,40.0,590,01,01,  Rang Para Bazar,121,239,73,106,48,133,33.6,40.8,26.5,00000
84.0,58.0,40.0,590,02,01,  Salbagan,120,197,68,96,52,101,37.9,41.5,34.0,00000
84.0,58.0,40.0,590,03,01,  Rahamatpur,202,229,116,125,86,104,46.9,48.1,45.3,00000
84.0,58.0,40.0,590,04,01,  Gaujpur,184,217,108,98,76,119,45.9,52.4,39.0,00000
84.0,58.0,40.0,590,05,01,  Ashraf Nagar,116,265,71,132,45,133,30.4,35.0,25.3,00000
84.0,58.0,40.0,590,06,01,  Jarulbagan,149,495,82,250,67,245,23.1,24.7,21.5,00000
84.0,58.0,40.0,590,07,01,  9 No. Nutan Para,229,189,130,80,99,109,54.8,61.9,47.6,00000
84.0,58.0,40.0,590,08,01,  10 No. Nutan Para,165,268,106,164,59,104,38.1,39.3,36.2,00000
84.0,58.0,40.0,590,09,01,  Jabar Member Para,78,145,38,71,40,74,35.0,34.9,35.1,00000
84.0,58.0,40.0,678,01,01,  Harish Khandakar Pa,41,142,24,71,17,71,22.4,25.3,19.3,00000
84.0,58.0,40.0,678,02,01,  Seraj Sarder Para,31,147,18,72,13,75,17.4,20.0,14.8,00000
84.0,58.0,40.0,678,03,01,  Samsu Sarder Para,143,316,82,163,61,153,31.2,33.5,28.5,00000
84.0,58.0,40.0,678,04,01,  Shiberaga,53,76,33,34,20,42,41.1,49.3,32.3,00000
84.0,58.0,40.0,678,05,01,  Muslim Block,60,123,27,60,33,63,32.8,31.0,34.4,00000
84.0,58.0,40.0,678,06,01,  Azizul Hoque Para,146,186,85,86,61,100,44.0,49.7,37.9,00000
84.0,58.0,40.0,678,07,01,  Siddique Para,91,101,54,57,37,44,47.4,48.6,45.7,00000
84.0,58.0,40.0,814,01,01,  Dhanusadar Para,105,97,57,50,48,47,52.0,53.3,50.5,00000
84.0,58.0,40.0,814,02,01,  Mahajan Para,73,137,48,57,25,80,34.8,45.7,23.8,00000
84.0,58.0,40.0,814,03,01,  Furer Mukh,106,139,58,79,48,60,43.3,42.3,44.4,00000
84.0,58.0,40.0,814,04,01,  Sadek Sardar Para,99,89,53,45,46,44,52.7,54.1,51.1,00000
84.0,58.0,40.0,814,05,01,  Chowdhury Para,52,131,23,70,29,61,28.4,24.7,32.2,00000
84.0,58.0,40.0,814,06,01,  Mukbul Hossain Para,93,122,56,46,37,76,43.3,54.9,32.7,00000
84.0,58.0,54.0,235,01,01,  Sonargaon,389,826,212,399,177,427,32.0,34.7,29.3,00000
84.0,58.0,54.0,235,02,01,  Rajnagar,731,667,494,322,237,345,52.3,60.5,40.7,00000
84.0,58.0,54.0,235,03,01,  Mohammadpur,227,482,132,221,95,261,32.0,37.4,26.7,00000
84.0,58.0,54.0,235,04,01,  Rasulpur,126,207,76,86,50,121,37.8,46.9,29.2,00000
84.0,58.0,54.0,235,05,01,  Murshidabad,309,263,154,124,155,139,54.0,55.4,52.7,00000
84.0,58.0,54.0,235,06,01,  Gulshakhali,226,320,118,138,108,182,41.4,46.1,37.2,00000
84.0,58.0,54.0,235,07,01,  Ahshanpur,453,313,250,137,203,176,59.1,64.6,53.6,00000
84.0,58.0,54.0,235,08,01,  Jobalakshmi Para,235,365,155,176,80,189,39.2,46.8,29.7,00000
84.0,58.0,54.0,235,09,01,  Rahmatpur,219,306,135,151,84,155,41.7,47.2,35.1,00000
84.0,58.0,54.0,235,10,01,  Jalalabad,268,537,149,240,119,297,33.3,38.3,28.6,00000
84.0,58.0,60.0,542,01,01,  Rashidpur,283,378,160,168,123,210,42.8,48.8,36.9,00000
84.0,58.0,60.0,542,02,01,  Mamunpur,72,48,42,24,30,24,60.0,63.6,55.6,00000
84.0,58.0,60.0,542,03,01,  South Rahamatpur,196,270,101,134,95,136,42.1,43.0,41.1,00000
84.0,58.0,60.0,542,04,01,  Rajapur,89,196,45,104,44,92,31.2,30.2,32.4,00000
84.0,58.0,60.0,542,05,01,  Islampur,301,494,147,246,154,248,37.9,37.4,38.3,00000
84.0,58.0,60.0,542,06,01,  Salampur,286,378,140,163,146,215,43.1,46.2,40.4,00000
84.0,58.0,60.0,542,07,01,  Hasanpur,203,287,100,140,103,147,41.4,41.7,41.2,00000
84.0,58.0,60.0,542,08,01,  Muslimpur,122,98,64,47,58,51,55.5,57.7,53.2,00000
84.0,58.0,60.0,542,09,01,  Hossainpur,242,379,143,183,99,196,39.0,43.9,33.6,00000
84.0,58.0,60.0,542,10,01,  North Rahamatpur,282,528,140,249,142,279,34.8,36.0,33.7,00000
84.0,58.0,60.0,542,11,01,  Rasulpur,430,414,219,212,211,202,50.9,50.8,51.1,00000
84.0,58.0,67.0,135,01,01,  Bara Kalak,394,303,257,103,137,200,56.5,71.4,40.7,00000
84.0,58.0,67.0,135,02,01,  Kharikata,498,562,317,235,181,327,47.0,57.4,35.6,00000
84.0,58.0,67.0,135,03,01,  Chhota Kattali,103,121,61,55,42,66,46.0,52.6,38.9,00000
84.0,58.0,67.0,135,04,01,  Baradam,68,220,46,110,22,110,23.6,29.5,16.7,00000
84.0,58.0,67.0,135,05,01,  Bengi Chhara,91,123,55,51,36,72,42.5,51.9,33.3,00000
84.0,58.0,67.0,135,06,01,  Bara Kattali,151,170,90,71,61,99,47.0,55.9,38.1,00000
84.0,58.0,67.0,135,07,01,  Kalabunna,112,136,71,46,41,90,45.2,60.7,31.3,00000
84.0,58.0,67.0,633,01,03,  Dadipara,243,303,159,122,84,181,44.5,56.6,31.7,00000
84.0,58.0,67.0,633,02,03,  Bhuiyan Chhara,134,34,75,9,59,25,79.8,89.3,70.2,00000
84.0,58.0,67.0,633,03,03,  Madhya Chhara,109,236,72,112,37,124,31.6,39.1,23.0,00000
84.0,58.0,67.0,633,04,03,  Hemachandra Kabbari,253,135,144,58,109,77,65.2,71.3,58.6,00000
84.0,58.0,67.0,633,05,03,  Baradam,487,329,282,123,205,206,59.7,69.6,49.9,00000
84.0,58.0,67.0,633,06,03,  Manikjor Chhara,153,190,78,87,75,103,44.6,47.3,42.1,00000
84.0,58.0,67.0,633,07,03,  Tintila,926,245,507,114,419,131,79.1,81.6,76.2,00000
84.0,58.0,67.0,633,08,03,  Battya Para,553,450,300,207,253,243,55.1,59.2,51.0,00000
84.0,58.0,67.0,633,09,03,  Jarnatila,651,352,348,167,303,185,64.9,67.6,62.1,00000
84.0,58.0,67.0,633,10,03,  Bamer Langadu,293,455,190,196,103,259,39.2,49.2,28.5,00000
84.0,58.0,67.0,633,11,03,  Ran Chhara,94,80,66,30,28,50,54.0,68.8,35.9,00000
84.0,58.0,67.0,633,12,03,  Kharikata,183,195,109,90,74,105,48.4,54.8,41.3,00000
84.0,58.0,67.0,633,13,03,  Sureshwar Karbari P,98,248,62,110,36,138,28.3,36.0,20.7,00000
84.0,58.0,67.0,633,14,03,  Bhaibon Chhara Baza,415,878,224,453,191,425,32.1,33.1,31.0,00000
84.0,58.0,67.0,633,15,03,  Bhaibon Chhara Puna,330,396,210,187,120,209,45.5,52.9,36.5,00000
84.0,58.0,81.0,050,01,01,  Jarulbagan,437,539,237,258,200,281,44.8,47.9,41.6,00000
84.0,58.0,81.0,050,02,01,  F.I.D.C.Tila,179,489,89,252,90,237,26.8,26.1,27.5,00000
84.0,58.0,81.0,050,03,01,  Mohammadpur,685,878,370,440,315,438,43.8,45.7,41.8,00000
84.0,58.0,81.0,050,04,01,  Bara Colony,23,139,10,69,13,70,14.2,12.7,15.7,00000
84.0,58.0,81.0,050,05,01,  Uttar Gata Chhara,216,487,117,223,99,264,30.7,34.4,27.3,00000
84.0,58.0,81.0,050,06,01,  Haresh Nagar,149,190,80,91,69,99,44.0,46.8,41.1,00000
84.0,58.0,81.0,655,01,01,  Battya Para,489,560,300,262,189,298,46.6,53.4,38.8,00000
84.0,58.0,81.0,655,02,01,  Muslim Block,433,321,231,143,202,178,57.4,61.8,53.2,00000
84.0,58.0,81.0,655,03,01,  Tintila Para,477,69,265,32,212,37,87.4,89.2,85.1,00000
84.0,58.0,81.0,655,04,01,  Rabeta Hospital,244,53,140,19,104,34,82.2,88.1,75.4,00000
84.0,58.0,81.0,655,05,01,  Jallya Para,159,113,85,52,74,61,58.5,62.0,54.8,00000
84.0,58.0,81.0,655,06,01,  Ahmed Saudagar Para,342,163,188,66,154,97,67.7,74.0,61.4,00000
84.0,58.0,81.0,655,07,01,  Masjid Tila,137,59,84,31,53,28,69.9,73.0,65.4,00000
84.0,58.0,81.0,655,08,01,  F.I.D.C.Tila,257,50,149,27,108,23,83.7,84.7,82.4,00000
84.0,58.0,81.0,655,09,01,  Dhakaya Tila,436,239,294,130,142,109,64.6,69.3,56.6,00000
84.0,58.0,81.0,655,10,01,  Mayani Mukh Bazar,130,39,103,28,27,11,76.9,78.6,71.1,00000
84.0,58.0,81.0,655,11,01,  Army Camp,402,7,390,6,12,1,98.3,98.5,92.3,00000
84.0,58.0,81.0,904,01,01,  Halder Karbari Para,124,181,76,74,48,107,40.7,50.7,31.0,00000
84.0,58.0,81.0,904,02,01,  Maria Karbari Para,122,91,89,32,33,59,57.3,73.6,35.9,00000
84.0,58.0,81.0,904,03,01,  Headman Para,70,112,41,52,29,60,38.5,44.1,32.6,00000
84.0,58.0,81.0,904,04,01,  6 No.Block (Hajachh,86,113,41,56,45,57,43.2,42.3,44.1,00000
84.0,58.0,81.0,904,05,01,  Malladwip,238,354,107,178,131,176,40.2,37.5,42.7,00000
84.0,58.0,81.0,904,06,01,  Sonai Bazar,114,87,62,45,52,42,56.7,57.9,55.3,00000
84.0,58.0,81.0,904,07,01,  1 No.Block,42,77,23,42,19,35,35.3,35.4,35.2,00000
84.0,58.0,81.0,904,08,01,  2 No.Block,103,286,54,131,49,155,26.5,29.2,24.0,00000
84.0,58.0,81.0,904,09,01,  3 No.Block,129,148,74,65,55,83,46.6,53.2,39.9,00000
84.0,58.0,81.0,904,10,01,  4 No.Block,86,126,38,65,48,61,40.6,36.9,44.0,00000
84.0,58.0,81.0,904,11,01,  5 No.Block,234,352,129,173,105,179,39.9,42.7,37.0,00000
84.0,58.0,81.0,904,12,01,  11 No.Block,41,70,21,33,20,37,36.9,38.9,35.1,00000
84.0,58.0,81.0,904,13,01,  16 No.Block,98,118,44,56,54,62,45.4,44.0,46.6,00000
84.0,58.0,81.0,904,14,01,  Islamabad,295,262,146,132,149,130,53.0,52.5,53.4,00000
84.0,75.0,19.0,099,01,01,  Bagachhari Punarbas,406,376,225,174,181,202,51.9,56.4,47.3,00000
84.0,75.0,19.0,099,02,01,  Suridas Para,58,96,36,41,22,55,37.7,46.8,28.6,00000
84.0,75.0,19.0,099,03,01,  Tarani Para,28,62,15,29,13,33,31.1,34.1,28.3,00000
84.0,75.0,19.0,099,04,01,  Ramhari Para,171,135,92,59,79,76,55.9,60.9,51.0,00000
84.0,75.0,19.0,099,05,01,  Krishnama Chhara,60,44,32,15,28,29,57.7,68.1,49.1,00000
84.0,75.0,19.0,099,06,01,  Dharmacharan Para,61,69,40,27,21,42,46.9,59.7,33.3,00000
84.0,75.0,19.0,099,07,01,  Kulashpurna Karbari,58,82,36,38,22,44,41.4,48.6,33.3,00000
84.0,75.0,19.0,099,08,01,  Bhsyadakm Para,53,76,34,30,19,46,41.1,53.1,29.2,00000
84.0,75.0,19.0,199,01,01,  Kukurmara,115,95,68,31,47,64,54.8,68.7,42.3,00000
84.0,75.0,19.0,199,02,01,  Subal Chhari,48,56,32,23,16,33,46.2,58.2,32.7,00000
84.0,75.0,19.0,199,03,01,  Islampur Punarbasha,936,618,527,298,409,320,60.2,63.9,56.1,00000
84.0,75.0,19.0,199,04,01,  Bat Bil,52,99,27,49,25,50,34.4,35.5,33.3,00000
84.0,75.0,19.0,199,05,01,  Dakmazi Chara,36,52,18,20,18,32,40.9,47.4,36.0,00000
84.0,75.0,19.0,199,06,01,  Dak Bangla Para,127,79,74,41,53,38,61.7,64.3,58.2,00000
84.0,75.0,19.0,199,07,01,  Goulsha Chari,134,149,88,61,46,88,47.3,59.1,34.3,00000
84.0,75.0,19.0,199,08,01,  Nanak Rum,83,77,45,40,38,37,51.9,52.9,50.7,00000
84.0,75.0,19.0,298,01,01,  Kamtali,42,37,23,15,19,22,53.2,60.5,46.3,00000
84.0,75.0,19.0,298,02,01,  Kurakutaya Para,23,14,12,6,11,8,62.2,66.7,57.9,00000
84.0,75.0,19.0,298,03,01,  Pulimukh,41,59,23,31,18,28,41.0,42.6,39.1,00000
84.0,75.0,19.0,298,04,01,  Tangtalya Para,22,67,15,32,7,35,24.7,31.9,16.7,00000
84.0,75.0,19.0,298,05,01,  Uttar Hatimara,85,64,54,17,31,47,57.0,76.1,39.7,00000
84.0,75.0,19.0,298,06,01,  Burighat Punarbasan,664,709,367,330,297,379,48.4,52.7,43.9,00000
84.0,75.0,19.0,298,07,01,  Burighat Bazar,118,140,75,79,43,61,45.7,48.7,41.3,00000
84.0,75.0,19.0,298,08,01,  West Hatimara,14,18,9,8,5,10,43.8,52.9,33.3,00000
84.0,75.0,19.0,298,09,01,  Purba Hatimara,59,83,36,34,23,49,41.5,51.4,31.9,00000
84.0,75.0,19.0,746,01,01,  Kanthaltali Para,164,200,98,94,66,106,45.1,51.0,38.4,00000
84.0,75.0,19.0,746,02,01,  Langal Para,134,259,85,125,49,134,34.1,40.5,26.8,00000
84.0,75.0,19.0,746,03,01,  Garjantali,154,296,90,129,64,167,34.2,41.1,27.7,00000
84.0,75.0,19.0,746,04,01,  Bhangamura,118,170,64,83,54,87,41.0,43.5,38.3,00000
84.0,75.0,19.0,845,01,01,  Nanakrum,68,85,41,34,27,51,44.4,54.7,34.6,00000
84.0,75.0,19.0,845,02,01,  Pali Para,134,134,89,50,45,84,50.0,64.0,34.9,00000
84.0,75.0,19.0,845,03,01,  Nicha Pali Para,94,135,60,59,34,76,41.0,50.4,30.9,00000
84.0,75.0,19.0,845,04,01,  Paschim Hatimara,106,93,61,31,45,62,53.3,66.3,42.1,00000
84.0,75.0,19.0,845,05,01,  Dakshin Hatimara,54,34,34,12,20,22,61.4,73.9,47.6,00000
84.0,75.0,19.0,845,06,01,  Mongkhola,161,122,91,46,70,76,56.9,66.4,47.9,00000
84.0,75.0,19.0,945,01,01,  Kanthaltali,65,44,39,16,26,28,59.6,70.9,48.1,00000
84.0,75.0,19.0,945,02,01,  Haja Chhari,1,12,1,5,0,7,7.7,16.7,0.0,00000
84.0,75.0,19.0,945,03,01,  Panchhari,86,107,55,47,31,60,44.6,53.9,34.1,00000
84.0,75.0,19.0,945,04,01,  Talukdar Para,72,189,45,83,27,106,27.6,35.2,20.3,00000
84.0,75.0,19.0,945,05,01,  Babura Para,13,20,9,10,4,10,39.4,47.4,28.6,00000
84.0,75.0,38.0,348,01,01,  Chowdhury Chhara He,172,214,104,90,68,124,44.6,53.6,35.4,00000
84.0,75.0,38.0,348,02,01,  Mantala,37,123,27,48,10,75,23.1,36.0,11.8,00000
84.0,75.0,38.0,348,03,01,  Bamer Bagha Chhari,44,70,27,31,17,39,38.6,46.6,30.4,00000
84.0,75.0,38.0,348,04,01,  Dasya Para,27,36,15,17,12,19,42.9,46.9,38.7,00000
84.0,75.0,38.0,447,01,01,  Dasya Chhari,41,57,25,25,16,32,41.8,50.0,33.3,00000
84.0,75.0,38.0,447,02,01,  Maich Chhari,173,214,104,96,69,118,44.7,52.0,36.9,00000
84.0,75.0,38.0,447,03,01,  Krisnama Chhara,217,335,137,148,80,187,39.3,48.1,30.0,00000
84.0,75.0,38.0,447,04,01,  Ramhari Para,248,170,140,60,108,110,59.3,70.0,49.5,00000
84.0,75.0,38.0,447,05,01,  Shikal Para,88,63,59,19,29,44,58.3,75.6,39.7,00000
84.0,75.0,38.0,447,06,01,  Soiandar Para,42,63,23,28,19,35,40.0,45.1,35.2,00000
84.0,75.0,38.0,547,01,01,  Ghila Chhari,384,307,257,123,127,184,55.6,67.6,40.8,00000
84.0,75.0,38.0,547,02,01,  Chai Chhari,79,126,54,48,25,78,38.5,52.9,24.3,00000
84.0,75.0,38.0,547,03,01,  Tenga Chhari,56,170,32,78,24,92,24.8,29.1,20.7,00000
84.0,75.0,38.0,547,04,01,  Jura Chhari,112,100,68,43,44,57,52.8,61.3,43.6,00000
84.0,75.0,38.0,547,05,01,  Langal Para,55,118,29,56,26,62,31.8,34.1,29.5,00000
84.0,75.0,38.0,547,06,01,  Falak Para,25,77,13,35,12,42,24.5,27.1,22.2,00000
84.0,75.0,38.0,547,07,01,  Pukur Chhari,72,72,41,30,31,42,50.0,57.7,42.5,00000
84.0,75.0,38.0,547,08,01,  Valuk Chari,15,20,6,10,9,10,42.9,37.5,47.4,00000
84.0,75.0,38.0,547,09,01,  Shila Para,21,45,14,19,7,26,31.8,42.4,21.2,00000
84.0,75.0,38.0,597,01,01,  Karat Chhari,266,126,159,39,107,87,67.9,80.3,55.2,00000
84.0,75.0,38.0,597,02,01,  Kabuk Chhari,128,107,84,29,44,78,54.5,74.3,36.1,00000
84.0,75.0,38.0,597,03,01,  Paschim Haja Chhari,76,98,39,44,37,54,43.7,47.0,40.7,00000
84.0,75.0,38.0,597,04,01,  Purba Haja Chhari,208,75,135,33,73,42,73.5,80.4,63.5,00000
84.0,75.0,38.0,597,05,01,  Moin Para,24,55,18,24,6,31,30.4,42.9,16.2,00000
84.0,75.0,38.0,597,06,01,  Dasya Chhari Punarb,50,49,26,24,24,25,50.5,52.0,49.0,00000
84.0,75.0,38.0,597,07,01,  Dasya Chhari,60,103,43,38,17,65,36.8,53.1,20.7,00000
84.0,75.0,38.0,597,08,01,  Hatimara,92,73,57,22,35,51,55.8,72.2,40.7,00000
84.0,75.0,38.0,597,09,01,  Grakata,63,62,42,26,21,36,50.4,61.8,36.8,00000
84.0,75.0,38.0,597,10,01,  Bhayadam,182,240,102,110,80,130,43.1,48.1,38.1,00000
84.0,75.0,38.0,597,11,01,  Naran Chara,30,38,20,15,10,23,44.1,57.1,30.3,00000
84.0,75.0,38.0,597,12,01,  Subal Chari,90,136,58,58,32,78,39.8,50.0,29.1,00000
84.0,75.0,38.0,597,13,01,  Naranchara Moin Para,33,110,26,49,7,61,23.1,34.7,10.3,00000
84.0,75.0,38.0,597,14,01,  Pata Chari,57,36,38,15,19,21,61.3,71.7,47.5,00000
84.0,75.0,38.0,597,15,01,  Maich Chari,32,25,18,11,14,14,56.1,62.1,50.0,00000
84.0,75.0,38.0,597,16,01,  Barkalak Para,32,13,19,3,13,10,71.1,86.4,56.5,00000
84.0,75.0,38.0,597,17,01,  Hajachari Bat Tala,67,87,42,40,25,47,43.5,51.2,34.7,00000
84.0,75.0,57.0,248,01,01,  Rijibil Para,29,61,19,33,10,28,32.2,36.5,26.3,00000
84.0,75.0,57.0,248,02,01,  Kamar Para,59,29,38,11,21,18,67.0,77.6,53.8,00000
84.0,75.0,57.0,248,03,01,  Talukdar Para,169,202,95,84,74,118,45.6,53.1,38.5,00000
84.0,75.0,57.0,248,04,01,  Puratan Para (Betchari),47,259,25,122,22,137,15.4,17.0,13.8,00000
84.0,75.0,57.0,248,05,01,  Tripura Chhari,22,156,14,78,8,78,12.4,15.2,9.3,00000
84.0,75.0,57.0,248,06,01,  Taichakma Muk Para,176,111,98,51,78,60,61.3,65.8,56.5,00000
84.0,75.0,57.0,248,07,01,  Dhosar Para,81,196,61,81,20,115,29.2,43.0,14.8,00000
84.0,75.0,57.0,248,08,01,  Jorbomahajan Para,61,97,40,42,21,55,38.6,48.8,27.6,00000
84.0,75.0,57.0,248,09,01,  Rangi Para,100,113,59,51,41,62,46.9,53.6,39.8,00000
84.0,75.0,57.0,248,10,01,  Sonaram Karbari Par,67,141,38,62,29,79,32.2,38.0,26.9,00000
84.0,75.0,57.0,248,11,01,  Chila Tali,32,96,24,45,8,51,25.0,34.8,13.6,00000
84.0,75.0,57.0,248,12,01,  Bang Mara,70,69,41,32,29,37,50.4,56.2,43.9,00000
84.0,75.0,57.0,398,01,03,  Mohajan Para,29,22,16,6,13,16,56.9,72.7,44.8,00000
84.0,75.0,57.0,398,02,03,  Naniar Char Bazar P,576,201,331,90,245,111,74.1,78.6,68.8,00000
84.0,75.0,57.0,398,03,03,  Firingi Para,187,64,105,17,82,47,74.5,86.1,63.6,00000
84.0,75.0,57.0,398,04,03,  Barapul Para,185,102,107,47,78,55,64.5,69.5,58.6,00000
84.0,75.0,57.0,398,05,03,  Chhaykuri Bil,92,84,55,41,37,43,52.3,57.3,46.3,00000
84.0,75.0,57.0,497,01,01,  Chakka Para,85,124,57,53,28,71,40.7,51.8,28.3,00000
84.0,75.0,57.0,497,02,01,  Rangay Para,33,103,19,54,14,49,24.3,26.0,22.2,00000
84.0,75.0,57.0,646,01,01,  Jadukhan Chhara,92,69,52,28,40,41,57.1,65.0,49.4,00000
84.0,75.0,57.0,646,02,01,  Harinath Chhara,68,143,47,67,21,76,32.2,41.2,21.6,00000
84.0,75.0,57.0,796,01,03,  Naniar Char Bazar A,912,431,490,222,422,209,67.9,68.8,66.9,00000
84.0,75.0,57.0,796,02,03,  Naba Karbari Para,169,121,99,50,70,71,58.3,66.4,49.6,00000
84.0,75.0,57.0,796,03,03,  Sapmara,200,284,123,124,77,160,41.3,49.8,32.5,00000
84.0,75.0,57.0,796,04,03,  Kulang Para,104,90,56,43,48,47,53.6,56.6,50.5,00000
84.0,75.0,57.0,796,05,03,  Nutan Baradam,164,83,94,25,70,58,66.4,79.0,54.7,00000
84.0,75.0,57.0,796,06,03,  Gala Chhari,85,77,50,29,35,48,52.5,63.3,42.2,00000
84.0,75.0,57.0,796,07,03,  Nayadam,186,202,110,85,76,117,47.9,56.4,39.4,00000
84.0,75.0,57.0,796,08,03,  Pata Chhari,267,168,155,76,112,92,61.4,67.1,54.9,00000
84.0,75.0,57.0,796,09,03,  Kamar Para,93,39,61,13,32,26,70.5,82.4,55.2,00000
84.0,75.0,57.0,796,10,03,  Army Zonal Head Qua,222,0,214,0,8,0,100.0,100.0,100.0,00000
84.0,75.0,57.0,995,01,01,  Headman Para,35,32,21,15,14,17,52.2,58.3,45.2,00000
84.0,75.0,57.0,995,02,01,  Disan Para,108,85,66,33,42,52,56.0,66.7,44.7,00000
84.0,75.0,57.0,995,03,01,  Dasor Para,75,122,51,51,24,71,38.1,50.0,25.3,00000
84.0,75.0,57.0,995,04,01,  Tanya Para,101,114,66,52,35,62,47.0,55.9,36.1,00000
84.0,75.0,57.0,995,05,01,  Nabin Talukder Para,40,80,25,37,15,43,33.3,40.3,25.9,00000
84.0,75.0,57.0,995,06,01,  Juripya Para,93,234,70,113,23,121,28.4,38.3,16.0,00000
84.0,75.0,57.0,995,07,01,  Larma Para,44,117,25,58,19,59,27.3,30.1,24.4,00000
84.0,75.0,57.0,995,08,01,  Maruki Para,81,73,47,32,34,41,52.6,59.5,45.3,00000
84.0,75.0,57.0,995,09,01,  Jatramani Para,62,119,46,50,16,69,34.3,47.9,18.8,00000
84.0,75.0,57.0,995,10,01,  Bamer Bagh Chhari,20,58,15,28,5,30,25.6,34.9,14.3,00000
84.0,75.0,57.0,995,11,01,  Suridas,26,62,19,32,7,30,29.5,37.3,18.9,00000
84.0,75.0,76.0,049,01,01,  Agaralya Chhara,116,223,79,99,37,124,34.2,44.4,23.0,00000
84.0,75.0,76.0,049,02,01,  Thal Char,20,181,12,92,8,89,10.0,11.5,8.2,00000
84.0,75.0,76.0,149,01,01,  Ranu Karbari Para,145,91,93,29,52,62,61.4,76.2,45.6,00000
84.0,75.0,76.0,149,02,01,  Nimna Kangal Chhari,143,134,86,43,57,91,51.6,66.7,38.5,00000
84.0,75.0,76.0,149,03,01,  Morachangi Muk,109,58,67,21,42,37,65.3,76.1,53.2,00000
84.0,75.0,76.0,149,04,01,  Rigi Bil,96,116,61,50,35,66,45.3,55.0,34.7,00000
84.0,75.0,76.0,149,05,01,  Bet Chhari Puratan,189,263,118,117,71,146,41.8,50.2,32.7,00000
84.0,75.0,76.0,149,06,01,  Paschim Dewan Para,78,114,43,58,35,56,40.6,42.6,38.5,00000
84.0,75.0,76.0,149,07,01,  Paschim Jhanatali,95,136,52,67,43,69,41.1,43.7,38.4,00000
84.0,75.0,76.0,149,08,01,  Para Chhara,86,74,52,28,34,46,53.8,65.0,42.5,00000
84.0,75.0,76.0,149,09,01,  Dosar Para,35,52,21,26,14,26,40.2,44.7,35.0,00000
84.0,75.0,76.0,696,01,01,  Darzya Para,49,93,35,37,14,56,34.5,48.6,20.0,00000
84.0,75.0,76.0,696,02,01,  Baje Chhara,51,106,29,44,22,62,32.5,39.7,26.2,00000
84.0,75.0,76.0,696,03,01,  Ram Supari Chhara P,17,112,13,46,4,66,13.2,22.0,5.7,00000
84.0,75.0,76.0,696,04,01,  Tara Chhari Para,23,101,16,51,7,50,18.5,23.9,12.3,00000
84.0,75.0,76.0,696,05,01,  Headman Para,79,237,56,102,23,135,25.0,35.4,14.6,00000
84.0,75.0,76.0,696,06,01,  Ucha Kangal Chhari,77,91,41,39,36,52,45.8,51.3,40.9,00000
84.0,75.0,76.0,696,07,01,  Haja Chhari,42,121,25,58,17,63,25.8,30.1,21.3,00000
84.0,75.0,76.0,895,01,01,  Raparam Karbaripara,46,64,29,31,17,33,41.8,48.3,34.0,00000
84.0,75.0,76.0,895,02,01,  Marachangi Muk,43,28,20,14,23,14,60.6,58.8,62.2,00000
84.0,75.0,76.0,895,03,01,  Marachang Para,345,526,205,237,140,289,39.6,46.4,32.6,00000
84.0,75.0,76.0,895,04,01,  Sabekhyong Muk,49,19,26,8,23,11,72.1,76.5,67.6,00000
84.0,75.0,76.0,895,05,01,  Bet Chhari Mukh,112,18,61,7,51,11,86.2,89.7,82.3,00000
84.0,75.0,76.0,895,06,01,  Fringi Para,78,91,49,39,29,52,46.2,55.7,35.8,00000
84.0,75.0,76.0,895,07,01,  Chankhola Para,203,88,123,42,80,46,69.8,74.5,63.5,00000
84.0,75.0,76.0,895,08,01,  Barapul Para,126,95,72,40,54,55,57.0,64.3,49.5,00000
84.0,75.0,76.0,895,09,01,  Karalya Chhari-1,180,253,102,116,78,137,41.6,46.8,36.3,00000
84.0,75.0,76.0,895,10,01,  Jautha Khamar,55,43,46,21,9,22,56.1,68.7,29.0,00000
84.0,75.0,76.0,895,11,01,  Jahanatali,334,347,181,154,153,193,49.0,54.0,44.2,00000
84.0,75.0,76.0,895,12,01,  Bak Chhari Tila,132,217,76,115,56,102,37.8,39.8,35.4,00000
84.0,75.0,76.0,895,13,01,  Shilban Para,12,32,7,13,5,19,27.3,35.0,20.8,00000
84.0,75.0,76.0,895,14,01,  Dewan Chhara,54,73,29,33,25,40,42.5,46.8,38.5,00000
84.0,75.0,76.0,895,15,01,  Madhyagram,104,224,58,104,46,120,31.7,35.8,27.7,00000
84.0,75.0,76.0,895,16,01,  Karalya Chhari-2,38,110,26,54,12,56,25.7,32.5,17.6,00000
84.0,75.0,76.0,895,17,01,  Shilanya,133,219,73,105,60,114,37.8,41.0,34.5,00000
84.0,75.0,76.0,895,18,01,  Lambha Chhara,101,50,53,22,48,28,66.9,70.7,63.2,00000
84.0,75.0,76.0,895,19,01,  Mog Chara,49,21,26,7,23,14,70.0,78.8,62.2,00000
84.0,75.0,76.0,895,20,01,  Bakcharimuk Purba Dewan Para,111,157,71,75,40,82,41.4,48.6,32.8,00000
84.0,75.0,76.0,895,21,01,  Noya Para,36,28,23,13,13,15,56.3,63.9,46.4,00000
84.0,75.0,76.0,895,22,01,  Ranghi Para,13,10,7,4,6,6,56.5,63.6,50.0,00000
84.0,78.0,23.0,596,01,01,  Bangalhalia Bazar,593,264,390,153,203,111,69.2,71.8,64.6,00000
84.0,78.0,23.0,596,02,01,  Dhalia Para,202,213,119,102,83,111,48.7,53.8,42.8,00000
84.0,78.0,23.0,596,03,01,  Naikha Chhari Para,76,181,35,87,41,94,29.6,28.7,30.4,00000
84.0,78.0,23.0,596,04,01,  Agapara,122,206,85,84,37,122,37.2,50.3,23.3,00000
84.0,78.0,23.0,596,05,01,  Khangdong Para,586,184,336,91,250,93,76.1,78.7,72.9,00000
84.0,78.0,23.0,596,06,01,  Murungdong Para,189,204,92,92,97,112,48.1,50.0,46.4,00000
84.0,78.0,23.0,596,07,01,  Kakra Chhari,198,376,122,204,76,172,34.5,37.4,30.6,00000
84.0,78.0,23.0,596,08,01,  Headman Para,150,111,75,47,75,64,57.5,61.5,54.0,00000
84.0,78.0,23.0,596,09,01,  Ramatia Para,96,67,59,26,37,41,58.9,69.4,47.4,00000
84.0,78.0,23.0,596,10,01,  Jautha Khamar,81,148,52,78,29,70,35.4,40.0,29.3,00000
84.0,78.0,23.0,596,11,01,  Shafipur Para,592,500,315,239,277,261,54.2,56.9,51.5,00000
84.0,78.0,23.0,596,12,01,  Kudumchhara Para,80,105,48,49,32,56,43.2,49.5,36.4,00000
84.0,78.0,23.0,596,13,01,  Islampur,286,220,165,101,121,119,56.5,62.0,50.4,00000
84.0,78.0,23.0,596,14,01,  Patharban Para,68,139,37,62,31,77,32.9,37.4,28.7,00000
84.0,78.0,23.0,596,15,01,  Dakbangla Ujanpara,725,339,404,150,321,189,68.1,72.9,62.9,00000
84.0,78.0,23.0,596,16,01,  Dakbangla Para,292,150,139,66,153,84,66.1,67.8,64.6,00000
84.0,78.0,23.0,596,17,01,  Bihar Para,126,87,67,42,59,45,59.2,61.5,56.7,00000
84.0,78.0,23.0,596,18,01,  Chagal Khaiya Para,101,117,53,58,48,59,46.3,47.7,44.9,00000
84.0,78.0,23.0,596,19,01,  Dhalia Muslim Para,38,95,22,44,16,51,28.6,33.3,23.9,00000
84.0,78.0,46.0,198,01,01,  Kalaya Karbari Para,21,47,11,20,10,27,30.9,35.5,27.0,00000
84.0,78.0,46.0,198,02,01,  Dhanu Chhari Para,16,156,11,82,5,74,9.3,11.8,6.3,00000
84.0,78.0,46.0,198,03,01,  Bara Kuichkha Para,31,101,22,50,9,51,23.5,30.6,15.0,00000
84.0,78.0,46.0,198,04,01,  Korban Chhara Para,8,62,3,28,5,34,11.4,9.7,12.8,00000
84.0,78.0,46.0,198,05,01,  Headman Para,43,92,26,38,17,54,31.9,40.6,23.9,00000
84.0,78.0,46.0,198,06,01,  Madan Karbari Para,42,72,23,33,19,39,36.8,41.1,32.8,00000
84.0,78.0,46.0,298,01,01,  Rajasthali Bazar (P,435,184,293,84,142,100,70.3,77.7,58.7,00000
84.0,78.0,46.0,298,02,01,  Headman Para,258,199,140,79,118,120,56.5,63.9,49.6,00000
84.0,78.0,46.0,298,03,01,  Magain Para,37,89,23,40,14,49,29.4,36.5,22.2,00000
84.0,78.0,46.0,298,04,01,  Khagra Chhari Para,171,104,103,42,68,62,62.2,71.0,52.3,00000
84.0,78.0,46.0,298,05,01,  Muba Chhari Para,41,151,26,69,15,82,21.4,27.4,15.5,00000
84.0,78.0,46.0,298,06,01,  Mohabbat  Ara,199,74,120,39,79,35,72.9,75.5,69.3,00000
84.0,78.0,46.0,298,07,01,  Ghila Mukh Para,17,133,13,68,4,65,11.3,16.0,5.8,00000
84.0,78.0,46.0,298,08,01,  Jharjhari Para,16,43,11,17,5,26,27.1,39.3,16.1,00000
84.0,78.0,46.0,298,09,01,  Mohajan Para,72,47,55,21,17,26,60.5,72.4,39.5,00000
84.0,78.0,46.0,298,10,01,  Baga Chhari Para,9,107,5,49,4,58,7.8,9.3,6.5,00000
84.0,78.0,46.0,298,11,01,  Tabamoin Para,8,18,5,6,3,12,30.8,45.5,20.0,00000
84.0,78.0,46.0,298,12,01,  Daktar Para,144,144,74,69,70,75,50.0,51.7,48.3,00000
84.0,78.0,46.0,298,13,01,  Shil Chhari Para,3,45,2,22,1,23,6.3,8.3,4.2,00000
84.0,78.0,46.0,298,14,01,  Punarbashan Para,60,130,42,62,18,68,31.6,40.4,20.9,00000
84.0,78.0,46.0,298,15,01,  Amtali Para,13,89,8,40,5,49,12.7,16.7,9.3,00000
84.0,78.0,46.0,298,16,01,  Noapara,1,24,1,11,0,13,4.0,8.3,0.0,00000
84.0,78.0,46.0,298,17,01,  Naiko Chara,12,29,8,12,4,17,29.3,40.0,19.0,00000
84.0,78.0,46.0,298,18,01,  Bhat Khaia Para,29,59,20,26,9,33,33.0,43.5,21.4,00000
84.0,78.0,46.0,298,19,01,  Semana Para,10,39,10,16,0,23,20.4,38.5,0.0,00000
84.0,78.0,46.0,298,20,01,  Jasdi Moin Para,15,46,11,18,4,28,24.6,37.9,12.5,00000
84.0,78.0,46.0,695,01,01,  Headman Para,31,74,19,34,12,40,29.5,35.8,23.1,00000
84.0,78.0,46.0,695,02,01,  Narai Chhari Para,43,311,34,152,9,159,12.1,18.3,5.4,00000
84.0,78.0,46.0,695,03,01,  Natun Para (Naraich,22,47,18,17,4,30,31.9,51.4,11.8,00000
84.0,78.0,46.0,695,04,01,  Haludda Para,11,68,6,36,5,32,13.9,14.3,13.5,00000
84.0,78.0,46.0,695,05,01,  Jautha Khamar (Kapt,14,96,9,42,5,54,12.7,17.6,8.5,00000
84.0,78.0,46.0,695,06,01,  Mitinga Chhari Para,113,153,71,63,42,90,42.5,53.0,31.8,00000
84.0,78.0,46.0,695,07,01,  Jarul Chhari Para,8,33,3,15,5,18,19.5,16.7,21.7,00000
84.0,78.0,46.0,695,08,01,  Chingkhang Para,8,23,5,10,3,13,25.8,33.3,18.8,00000
84.0,78.0,46.0,695,09,01,  Hati Chhara Punarba,57,143,38,69,19,74,28.5,35.5,20.4,00000
84.0,78.0,46.0,695,10,01,  Thale Para,4,47,4,26,0,21,7.8,13.3,0.0,00000
84.0,78.0,46.0,695,11,01,  Kaptai Bara Para,13,57,12,27,1,30,18.6,30.8,3.2,00000
84.0,78.0,46.0,695,12,01,  Robshing Para,0,40,0,15,0,25,0.0,0.0,0.0,00000
84.0,78.0,46.0,695,13,01,  Butan Para,29,84,23,33,6,51,25.7,41.1,10.5,00000
84.0,78.0,46.0,695,14,01,  Angjain Para,6,38,2,22,4,16,13.6,8.3,20.0,00000
84.0,78.0,46.0,695,15,01,  Refujee Para,44,42,31,16,13,26,51.2,66.0,33.3,00000
84.0,78.0,46.0,695,16,01,  Dushari Para,34,103,21,44,13,59,24.8,32.3,18.1,00000
84.0,78.0,46.0,695,17,01,  Kestha Para,37,83,28,34,9,49,30.8,45.2,15.5,00000
84.0,78.0,46.0,695,18,01,  Bali Para,142,357,97,156,45,201,28.5,38.3,18.3,00000
84.0,78.0,46.0,795,01,01,  Noapara,45,110,26,57,19,53,29.0,31.3,26.4,00000
84.0,78.0,46.0,795,02,01,  Chotakuikka Para,8,23,5,11,3,12,25.8,31.3,20.0,00000
84.0,78.0,46.0,795,03,01,  Talukder Para,55,64,25,34,30,30,46.2,42.4,50.0,00000
84.0,78.0,46.0,795,04,01,  Sadumar Tila,7,15,6,5,1,10,31.8,54.5,9.1,00000
84.0,78.0,71.0,099,01,01,  Noajiri Para,176,62,87,21,89,41,73.9,80.6,68.5,00000
84.0,78.0,71.0,099,02,01,  Taitong Para (Purba,204,290,125,130,79,160,41.3,49.0,33.1,00000
84.0,78.0,71.0,099,03,01,  Chibodi Prong Para,22,64,14,27,8,37,25.6,34.1,17.8,00000
84.0,78.0,71.0,099,04,01,  Jautha Khamar,31,75,26,34,5,41,29.2,43.3,10.9,00000
84.0,78.0,71.0,099,05,01,  Suchak Para,41,255,26,120,15,135,13.9,17.8,10.0,00000
84.0,78.0,71.0,099,06,01,  Kechi Para,9,93,6,46,3,47,8.8,11.5,6.0,00000
84.0,78.0,71.0,099,07,01,  Paschim Taitong Par,171,84,111,32,60,52,67.1,77.6,53.6,00000
84.0,78.0,71.0,099,08,01,  Bagh Chhara Para,23,111,17,53,6,58,17.2,24.3,9.4,00000
84.0,78.0,71.0,099,09,01,  Kamal Chhara Para,32,129,23,61,9,68,19.9,27.4,11.7,00000
84.0,78.0,71.0,099,10,01,  Chingkhyong Marma P,7,71,6,33,1,38,9.0,15.4,2.6,00000
84.0,78.0,71.0,099,11,01,  Chingkhyong Tong Pa,10,95,9,43,1,52,9.5,17.3,1.9,00000
84.0,78.0,71.0,099,12,01,  Roashe Paraa,9,112,5,57,4,55,7.4,8.1,6.8,00000
84.0,78.0,71.0,397,01,01,  Gainda Para,224,285,124,118,100,167,44.0,51.2,37.5,00000
84.0,78.0,71.0,397,02,01,  Krangshagai Para,46,152,20,67,26,85,23.2,23.0,23.4,00000
84.0,78.0,71.0,397,03,01,  Enemrong Para,53,121,34,65,19,56,30.5,34.3,25.3,00000
84.0,78.0,71.0,397,04,01,  Targa Mukh Para,59,110,34,53,25,57,34.9,39.1,30.5,00000
84.0,78.0,71.0,397,05,01,  Ugari Para,50,157,35,62,15,95,24.2,36.1,13.6,00000
84.0,78.0,71.0,397,06,01,  Longadu Para,31,71,18,27,13,44,30.4,40.0,22.8,00000
84.0,78.0,71.0,397,07,01,  Paindang Para,7,145,2,74,5,71,4.6,2.6,6.6,00000
84.0,78.0,71.0,397,08,01,  Puaito Para,21,69,15,29,6,40,23.3,34.1,13.0,00000
84.0,78.0,71.0,397,09,01,  Balumura Para,39,145,27,75,12,70,21.2,26.5,14.6,00000
84.0,78.0,71.0,397,10,01,  Longadu Punarbashan,48,55,27,24,21,31,46.6,52.9,40.4,00000
84.0,78.0,71.0,497,01,01,  Khaitak Para,14,63,11,30,3,33,18.2,26.8,8.3,00000
84.0,78.0,71.0,497,02,01,  Jimram  Para,12,32,6,14,6,18,27.3,30.0,25.0,00000
84.0,78.0,71.0,497,03,01,  Ara Chhari Para,14,39,9,17,5,22,26.4,34.6,18.5,00000
84.0,78.0,71.0,497,04,01,  Chaingkhyong Para,68,91,39,37,29,54,42.8,51.3,34.9,00000
84.0,78.0,71.0,894,01,03,  Mabbai Para,56,100,38,44,18,56,35.9,46.3,24.3,00000
84.0,78.0,71.0,894,02,03,  Haji Para,70,252,28,120,42,132,21.7,18.9,24.1,00000
84.0,78.0,71.0,894,03,03,  Angira Para,18,24,9,7,9,17,42.9,56.3,34.6,00000
84.0,78.0,71.0,894,04,03,  Tula Chhari Para,21,72,12,27,9,45,22.6,30.8,16.7,00000
84.0,78.0,71.0,894,05,03,  Tamachi Para,39,44,22,16,17,28,47.0,57.9,37.8,00000
84.0,78.0,71.0,894,06,03,  Bimachhara Para,56,59,32,21,24,38,48.7,60.4,38.7,00000
84.0,78.0,71.0,894,07,03,  Hnaramuk Tong Para,96,83,61,34,35,49,53.6,64.2,41.7,00000
84.0,78.0,71.0,894,08,03,  Marma Para(Hnaramuk,110,37,55,13,55,24,74.8,80.9,69.6,00000
84.0,78.0,71.0,894,09,03,  Tula Para,19,39,13,13,6,26,32.8,50.0,18.8,00000
84.0,78.0,71.0,894,10,03,  Mraowa Para,21,199,16,95,5,104,9.5,14.4,4.6,00000
84.0,78.0,71.0,894,11,03,  Powaithu Para,51,89,28,37,23,52,36.4,43.1,30.7,00000
84.0,78.0,71.0,894,12,03,  Mabbai Parapunarbas,29,74,13,31,16,43,28.2,29.5,27.1,00000
84.0,78.0,71.0,894,13,03,  Amchhara Para,736,291,500,142,236,149,71.7,77.9,61.3,00000
84.0,87.0,13.0,129,01,01,  Demugha Chhara Para,59,74,36,30,23,44,44.4,54.5,34.3,00000
84.0,87.0,13.0,129,02,01,  Tripura Chhara Para,165,241,108,104,57,137,40.6,50.9,29.4,00000
84.0,87.0,13.0,129,03,01,  Tripura Chhara Mukh,171,216,117,84,54,132,44.2,58.2,29.0,00000
84.0,87.0,13.0,129,04,01,  Uttar Kichinga Adam,142,55,82,23,60,32,72.1,78.1,65.2,00000
84.0,87.0,13.0,129,05,01,  Kuramara Para,203,216,125,88,78,128,48.4,58.7,37.9,00000
84.0,87.0,13.0,129,06,01,  Tongtulla Para,103,128,65,59,38,69,44.6,52.4,35.5,00000
84.0,87.0,13.0,129,07,01,  Deba Chhari Para,56,125,32,58,24,67,30.9,35.6,26.4,00000
84.0,87.0,13.0,129,08,01,  Maichha Para,173,100,104,33,69,67,63.4,75.9,50.7,00000
84.0,87.0,13.0,129,09,01,  Bhurbanna Para,40,56,25,24,15,32,41.7,51.0,31.9,00000
84.0,87.0,13.0,129,10,01,  Damai Chhara Para,107,152,64,73,43,79,41.3,46.7,35.2,00000
84.0,87.0,13.0,129,11,01,  Sailer Chhara Para,38,16,24,6,14,10,70.4,80.0,58.3,00000
84.0,87.0,13.0,129,12,01,  Kayang Chhara Para,86,29,44,11,42,18,74.8,80.0,70.0,00000
84.0,87.0,13.0,129,13,01,  Sekra Chhara Para,90,94,52,37,38,57,48.9,58.4,40.0,00000
84.0,87.0,13.0,129,14,01,  Kukiudana Para,43,35,28,14,15,21,55.1,66.7,41.7,00000
84.0,87.0,13.0,129,15,01,  Mohish Bhanga Para,51,43,27,19,24,24,54.3,58.7,50.0,00000
84.0,87.0,13.0,129,16,01,  Durkhaia Para,107,152,70,69,37,83,41.3,50.4,30.8,00000
84.0,87.0,13.0,129,17,01,  Kiching Adam Passim,21,49,13,19,8,30,30.0,40.6,21.1,00000
84.0,87.0,13.0,129,18,01,  Palad Adam Para,80,69,52,23,28,46,53.7,69.3,37.8,00000
84.0,87.0,13.0,129,19,01,  Boal Chhari Para,77,116,41,54,36,62,39.9,43.2,36.7,00000
84.0,87.0,13.0,129,20,01,  Shahas Badha Para,77,53,41,19,36,34,59.2,68.3,51.4,00000
84.0,87.0,13.0,129,21,01,  Kharigong Para,291,177,154,69,137,108,62.2,69.1,55.9,00000
84.0,87.0,13.0,129,22,01,  Saku Para,96,27,54,13,42,14,78.0,80.6,75.0,00000
84.0,87.0,13.0,129,23,01,  Kuki Para,80,42,43,17,37,25,65.6,71.7,59.7,00000
84.0,87.0,13.0,129,24,01,  Mogpara,125,46,64,22,61,24,73.1,74.4,71.8,00000
84.0,87.0,13.0,129,25,01,  Kumra Para,114,65,66,30,48,35,63.7,68.8,57.8,00000
84.0,87.0,13.0,129,26,01,  Barbua Chap Para,97,37,61,15,36,22,72.4,80.3,62.1,00000
84.0,87.0,13.0,129,27,01,  Muba Chhari Para,63,33,44,8,19,25,65.6,84.6,43.2,00000
84.0,87.0,13.0,129,28,01,  Lekhany Chhara Para,85,30,50,8,35,22,73.9,86.2,61.4,00000
84.0,87.0,13.0,129,29,01,  Uluchhari Para,86,51,59,15,27,36,62.8,79.7,42.9,00000
84.0,87.0,13.0,129,30,01,  Charikhong Mukh Par,54,43,31,16,23,27,55.7,66.0,46.0,00000
84.0,87.0,13.0,129,31,01,  Charikhong Para,157,176,83,76,74,100,47.1,52.2,42.5,00000
84.0,87.0,13.0,129,32,01,  Tingaza Para,81,70,48,23,33,47,53.6,67.6,41.3,00000
84.0,87.0,13.0,129,33,01,  Bakmara Kizing,65,57,34,28,31,29,53.3,54.8,51.7,00000
84.0,87.0,13.0,129,34,01,  Mach Barali Chara,9,8,4,2,5,6,52.9,66.7,45.5,00000
84.0,87.0,13.0,129,35,01,  Chairman Para,67,22,32,8,35,14,75.3,80.0,71.4,00000
84.0,87.0,13.0,129,36,01,  Noadam,40,18,22,4,18,14,69.0,84.6,56.3,00000
84.0,87.0,13.0,129,37,01,  Tilakky Chara,132,58,74,16,58,42,69.5,82.2,58.0,00000
84.0,87.0,13.0,129,38,01,  Kagtta Chara,50,41,26,18,24,23,54.9,59.1,51.1,00000
84.0,87.0,13.0,129,39,01,  Borudona,140,61,79,26,61,35,69.7,75.2,63.5,00000
84.0,87.0,13.0,129,40,01,  Zamchuk,19,32,11,18,8,14,37.3,37.9,36.4,00000
84.0,87.0,13.0,129,41,01,  Back Chari,66,57,45,17,21,40,53.7,72.6,34.4,00000
84.0,87.0,13.0,129,42,01,  Tans Mura,47,24,26,9,21,15,66.2,74.3,58.3,00000
84.0,87.0,13.0,129,43,01,  Mono Adam,50,10,27,2,23,8,83.3,93.1,74.2,00000
84.0,87.0,13.0,129,44,01,  Ulu Chari,26,25,16,7,10,18,51.0,69.6,35.7,00000
84.0,87.0,13.0,129,45,01,  Kurally Chari,86,32,52,8,34,24,72.9,86.7,58.6,00000
84.0,87.0,27.0,086,01,01,  Balukhali Chakma Pa,126,246,82,112,44,134,33.9,42.3,24.7,00000
84.0,87.0,27.0,086,02,01,  Farm Area,19,5,11,4,8,1,79.2,73.3,88.9,00000
84.0,87.0,27.0,086,03,01,  Muslim Block,138,101,79,50,59,51,57.7,61.2,53.6,00000
84.0,87.0,27.0,086,04,01,  Mogpara,28,41,22,22,6,19,40.6,50.0,24.0,00000
84.0,87.0,27.0,086,05,01,  Adapahar,38,47,21,22,17,25,44.7,48.8,40.5,00000
84.0,87.0,27.0,216,01,01,  Bigakhyong Para,36,56,23,25,13,31,39.1,47.9,29.5,00000
84.0,87.0,27.0,216,02,01,  Lokkana Karbari Par,51,51,34,20,17,31,50.0,63.0,35.4,00000
84.0,87.0,27.0,216,03,01,  Kuki Para,65,81,42,33,23,48,44.5,56.0,32.4,00000
84.0,87.0,27.0,346,01,01,  Fulgazi Baper Chha,68,70,43,27,25,43,49.3,61.4,36.8,00000
84.0,87.0,27.0,346,02,01,  Moddya Kainda Para,19,99,13,40,6,59,16.1,24.5,9.2,00000
84.0,87.0,27.0,346,03,01,  Dazari Para,91,111,63,48,28,63,45.0,56.8,30.8,00000
84.0,87.0,27.0,389,01,01,  Khandab Chhara Para,198,109,115,42,83,67,64.5,73.2,55.3,00000
84.0,87.0,27.0,389,02,01,  Kabuka Para,63,70,39,31,24,39,47.4,55.7,38.1,00000
84.0,87.0,27.0,389,03,01,  Tara Chhari Para,36,28,23,13,13,15,56.3,63.9,46.4,00000
84.0,87.0,27.0,389,04,01,  Hajaribak Para,60,60,42,13,18,47,50.0,76.4,27.7,00000
84.0,87.0,27.0,389,05,01,  Jarul Chhari Para,47,64,29,26,18,38,42.3,52.7,32.1,00000
84.0,87.0,27.0,432,01,01,  Haja Chhari Para,145,168,92,67,53,101,46.3,57.9,34.4,00000
84.0,87.0,27.0,432,02,01,  Prema Chhari Para,49,72,24,33,25,39,40.5,42.1,39.1,00000
84.0,87.0,27.0,432,03,01,  Shil Chhari,100,181,71,82,29,99,35.6,46.4,22.7,00000
84.0,87.0,27.0,432,04,01,  Basanda Nicher,187,237,113,105,74,132,44.1,51.8,35.9,00000
84.0,87.0,27.0,432,05,01,  Basanda Main Para,125,77,76,24,49,53,61.9,76.0,48.0,00000
84.0,87.0,27.0,562,01,01,  Badal Chhari Para,168,216,117,80,51,136,43.8,59.4,27.3,00000
84.0,87.0,27.0,562,02,01,  Kaindya Mukh Para,131,71,82,30,49,41,64.9,73.2,54.4,00000
84.0,87.0,27.0,562,03,01,  Duratang Para,91,232,58,119,33,113,28.2,32.8,22.6,00000
84.0,87.0,27.0,562,04,01,  Bamer Kaindya Para,132,165,92,68,40,97,44.4,57.5,29.2,00000
84.0,87.0,27.0,562,05,01,  Bamer Kaindya Main,83,259,59,118,24,141,24.3,33.3,14.5,00000
84.0,87.0,27.0,821,01,01,  Tripura Para,98,687,60,335,38,352,12.5,15.2,9.7,00000
84.0,87.0,27.0,821,02,01,  Muslim Para,4,79,2,39,2,40,4.8,4.9,4.8,00000
84.0,87.0,27.0,821,03,01,  Noapara,50,168,36,77,14,91,22.9,31.9,13.3,00000
84.0,87.0,27.0,821,04,01,  Maricha Bilpara,38,308,17,165,21,143,11.0,9.3,12.8,00000
84.0,87.0,27.0,821,05,01,  Khari Kong,186,236,125,90,61,146,44.1,58.1,29.5,00000
84.0,87.0,40.0,302,01,01,  Mobachari Para,57,65,45,33,12,32,46.7,57.7,27.3,00000
84.0,87.0,40.0,302,02,01,  Panchari Para,93,141,72,57,21,84,39.7,55.8,20.0,00000
84.0,87.0,40.0,302,03,01,  Aghaychari Para,127,172,76,87,51,85,42.5,46.6,37.5,00000
84.0,87.0,40.0,302,04,01,  Dhanpta Mukpara,15,73,12,33,3,40,17.0,26.7,7.0,00000
84.0,87.0,40.0,302,05,01,  Landra Char Para,33,40,20,18,13,22,45.2,52.6,37.1,00000
84.0,87.0,40.0,519,01,01,  Chairman Para,223,153,124,71,99,82,59.3,63.6,54.7,00000
84.0,87.0,40.0,519,02,01,  Navy Sailors Colony,730,31,572,17,158,14,95.9,97.1,91.9,00000
84.0,87.0,40.0,519,03,01,  Navy Officers Colon,164,26,83,15,81,11,86.3,84.7,88.0,00000
84.0,87.0,40.0,519,04,01,  M.E.S. Colony,177,17,108,10,69,7,91.2,91.5,90.8,00000
84.0,87.0,40.0,519,05,01,  Jibtali Para(Headman),112,106,74,40,38,66,51.4,64.9,36.5,00000
84.0,87.0,40.0,519,06,01,  Sukna Chhari Para,155,0,155,0,0,0,100.0,100.0,0.0,00000
84.0,87.0,40.0,648,01,01,  Bak Chhari Para,66,179,38,84,28,95,26.9,31.1,22.8,00000
84.0,87.0,40.0,648,02,01,  Para Chhari Para,8,43,6,23,2,20,15.7,20.7,9.1,00000
84.0,87.0,40.0,648,03,01,  Haja Chhari,36,91,20,49,16,42,28.3,29.0,27.6,00000
84.0,87.0,40.0,648,04,01,  Kushulla Ghona,50,14,26,7,24,7,78.1,78.8,77.4,00000
84.0,87.0,40.0,648,05,01,  Dulla Chhari,112,38,63,12,49,26,74.7,84.0,65.3,00000
84.0,87.0,40.0,648,06,01,  Raikhyong Bazar,88,37,47,8,41,29,70.4,85.5,58.6,00000
84.0,87.0,40.0,648,07,01,  Haja Chhari Tongcho,130,89,72,33,58,56,59.4,68.6,50.9,00000
84.0,87.0,40.0,648,08,01,  Panama Chhara,58,73,30,35,28,38,44.3,46.2,42.4,00000
84.0,87.0,54.0,259,01,01,  Changra Chhari,103,159,72,59,31,100,39.3,55.0,23.7,00000
84.0,87.0,54.0,259,02,01,  Battali Para,26,36,17,12,9,24,41.9,58.6,27.3,00000
84.0,87.0,54.0,259,03,01,  Haja Chhari,70,98,39,37,31,61,41.7,51.3,33.7,00000
84.0,87.0,54.0,259,04,01,  Dalu Chhari Headman,255,194,153,82,102,112,56.8,65.1,47.7,00000
84.0,87.0,54.0,259,05,01,  Kutuk Chhari Bazar,206,91,128,48,78,43,69.4,72.7,64.5,00000
84.0,87.0,54.0,259,06,01,  Badal Chhari Para,116,114,69,42,47,72,50.4,62.2,39.5,00000
84.0,87.0,54.0,259,07,01,  Chegaia Chhari Para,132,143,84,59,48,84,48.0,58.7,36.4,00000
84.0,87.0,54.0,692,01,01,  Kutuk Chhari Nicher,215,186,132,77,83,109,53.6,63.2,43.2,00000
84.0,87.0,54.0,692,02,01,  Dulchhari Para,43,123,27,57,16,66,25.9,32.1,19.5,00000
84.0,87.0,54.0,692,03,01,  Dulchhari Mointala,92,124,55,54,37,70,42.6,50.5,34.6,00000
84.0,87.0,54.0,692,04,01,  Bhui Adam Para,19,66,9,33,10,33,22.4,21.4,23.3,00000
84.0,87.0,54.0,692,05,01,  Kutuk Chhari Upar P,123,192,73,76,50,116,39.0,49.0,30.1,00000
84.0,87.0,54.0,692,06,01,  Kalabunia Para,20,58,12,24,8,34,25.6,33.3,19.0,00000
84.0,87.0,54.0,692,07,01,  Kutuk Chhari Main P,37,39,24,15,13,24,48.7,61.5,35.1,00000
84.0,87.0,54.0,692,08,01,  Bazze Chara Para,29,40,15,19,14,21,42.0,44.1,40.0,00000
84.0,87.0,54.0,994,01,01,  Gatha Chhara Para,200,272,134,98,66,174,42.4,57.8,27.5,00000
84.0,87.0,54.0,994,02,01,  Tingaria Para,27,70,20,33,7,37,27.8,37.7,15.9,00000
84.0,87.0,54.0,994,03,01,  Narayan Chhari,26,66,17,29,9,37,28.3,37.0,19.6,00000
84.0,87.0,54.0,994,04,01,  Puti Chhari Para,88,181,55,77,33,104,32.7,41.7,24.1,00000
84.0,87.0,54.0,994,05,01,  Karat Chhari Para,61,60,38,21,23,39,50.4,64.4,37.1,00000
84.0,87.0,54.0,994,06,01,  Buaradam Para,93,124,62,47,31,77,42.9,56.9,28.7,00000
84.0,87.0,54.0,994,07,01,  Putikhali Upar Para,58,40,36,8,22,32,59.2,81.8,40.7,00000
84.0,87.0,54.0,994,08,01,  Putikhali Nicher Pa,98,77,64,26,34,51,56.0,71.1,40.0,00000
84.0,87.0,54.0,994,09,01,  Pera Chhari Headman,106,190,67,83,39,107,35.8,44.7,26.7,00000
84.0,87.0,54.0,994,10,01,  Bamer Taimidang,61,194,47,81,14,113,23.9,36.7,11.0,00000
84.0,87.0,54.0,994,11,01,  Digal Chhari,61,134,49,54,12,80,31.3,47.6,13.0,00000
84.0,87.0,67.0,173,01,01,  Dippa Chhari Para,125,163,75,76,50,87,43.4,49.7,36.5,00000
84.0,87.0,67.0,173,02,01,  Rampahar,180,146,116,45,64,101,55.2,72.0,38.8,00000
84.0,87.0,67.0,173,03,01,  Nabhanga Chhari,103,97,65,37,38,60,51.5,63.7,38.8,00000
84.0,87.0,67.0,173,04,01,  Gola Chhari,213,181,140,67,73,114,54.1,67.6,39.0,00000
84.0,87.0,67.0,173,05,01,  Keret Kaita,221,183,139,68,82,115,54.7,67.1,41.6,00000
84.0,87.0,67.0,173,06,01,  Kukja Chhari,55,105,32,58,23,47,34.4,35.6,32.9,00000
84.0,87.0,67.0,173,07,01,  Awalad Bazar,24,2,17,1,7,1,92.3,94.4,87.5,00000
84.0,87.0,67.0,173,08,01,  Dulu Chari,47,43,35,16,12,27,52.2,68.6,30.8,00000
84.0,87.0,67.0,173,09,01,  Debta Chari,17,49,12,27,5,22,25.8,30.8,18.5,00000
84.0,87.0,67.0,605,01,01,  Kamila Chhari Para,183,123,108,41,75,82,59.8,72.5,47.8,00000
84.0,87.0,67.0,605,02,01,  Debata Chhari Para,41,94,25,37,16,57,30.4,40.3,21.9,00000
84.0,87.0,67.0,605,03,01,  Dighal Chhari,72,92,47,37,25,55,43.9,56.0,31.3,00000
84.0,87.0,67.0,735,01,01,  Godapura Para,27,84,16,48,11,36,24.3,25.0,23.4,00000
84.0,87.0,67.0,735,02,01,  Tarenga Para,138,116,87,37,51,79,54.3,70.2,39.2,00000
84.0,87.0,67.0,735,03,01,  Dughaia Para,126,235,86,99,40,136,34.9,46.5,22.7,00000
84.0,87.0,67.0,735,04,01,  Nutan Bazar,16,10,13,4,3,6,61.5,76.5,33.3,00000
84.0,87.0,67.0,735,05,01,  Noadam Para,14,86,11,50,3,36,14.0,18.0,7.7,00000
84.0,87.0,67.0,735,06,01,  Pera Chhara,6,62,5,30,1,32,8.8,14.3,3.0,00000
84.0,87.0,67.0,735,07,01,  Goraghona,216,221,138,118,78,103,49.4,53.9,43.1,00000
84.0,87.0,67.0,735,08,01,  Gurguga Chhari,45,131,30,58,15,73,25.6,34.1,17.0,00000
84.0,87.0,67.0,735,09,01,  Gurkhara,6,60,5,31,1,29,9.1,13.9,3.3,00000
84.0,87.0,67.0,735,10,01,  Koki Char,84,88,48,35,36,53,48.8,57.8,40.4,00000
84.0,87.0,67.0,735,11,01,  Goba Ghona Chakma Para,20,159,17,82,3,77,11.2,17.2,3.8,00000
84.0,87.0,67.0,778,01,01,  Ruaina Chhari Para,78,205,52,90,26,115,27.6,36.6,18.4,00000
84.0,87.0,67.0,778,02,01,  Agaia Chhari Main P,58,85,36,41,22,44,40.6,46.8,33.3,00000
84.0,87.0,67.0,778,03,01,  Agaia Chhari,70,125,46,50,24,75,35.9,47.9,24.2,00000
84.0,87.0,67.0,778,04,01,  Amchhari Para,97,141,70,59,27,82,40.8,54.3,24.8,00000
84.0,87.0,67.0,778,05,01,  Haja Chhari Para,73,196,48,97,25,99,27.1,33.1,20.2,00000
84.0,87.0,67.0,778,06,01,  Bajaram Karbari,54,86,32,34,22,52,38.6,48.5,29.7,00000
84.0,87.0,67.0,778,07,01,  Bhulla Chhari,55,39,31,11,24,28,58.5,73.8,46.2,00000
84.0,87.0,67.0,778,08,01,  Madhyapara,22,20,16,7,6,13,52.4,69.6,31.6,00000
84.0,87.0,67.0,778,09,01,  Polaina Chhari Para,44,60,26,23,18,37,42.3,53.1,32.7,00000
84.0,87.0,67.0,778,10,01,  Harul Chhari Para,6,11,4,4,2,7,35.3,50.0,22.2,00000
84.0,87.0,81.0,043,01,01,  Guichhari Para,48,277,31,134,17,143,14.8,18.8,10.6,00000
84.0,87.0,81.0,043,02,01,  Tamidong (Bamer),20,74,10,38,10,36,21.3,20.8,21.7,00000
84.0,87.0,81.0,043,03,01,  Noapara(Hazachari),64,156,39,71,25,85,29.1,35.5,22.7,00000
84.0,87.0,81.0,043,04,01,  Dighali Bak,142,110,88,39,54,71,56.3,69.3,43.2,00000
84.0,87.0,81.0,043,05,01,  Kalabunia Para,107,287,67,131,40,156,27.2,33.8,20.4,00000
84.0,87.0,81.0,043,07,01,  Bandar Goap,30,57,21,28,9,29,34.5,42.9,23.7,00000
84.0,87.0,81.0,908,01,01,  Dippa Chhari Para,52,212,33,95,19,117,19.7,25.8,14.0,00000
84.0,87.0,81.0,908,02,01,  Dippa Chhari Mukh,81,89,52,36,29,53,47.6,59.1,35.4,00000
84.0,87.0,81.0,908,03,01,  Bangali Para-1,106,99,63,49,43,50,51.7,56.3,46.2,00000
84.0,87.0,81.0,908,04,01,  Brick Field,162,77,88,30,74,47,67.8,74.6,61.2,00000
84.0,87.0,81.0,908,05,01,  Pria Mohan De.Para,38,14,23,2,15,12,73.1,92.0,55.6,00000
84.0,87.0,81.0,908,06,01,  Barua Para Headman,94,17,77,7,17,10,84.7,91.7,63.0,00000
84.0,87.0,81.0,908,07,01,  Amchhari Para,26,96,19,46,7,50,21.3,29.2,12.3,00000
84.0,87.0,81.0,908,08,01,  Sapchari Para,206,141,114,56,92,85,59.4,67.1,52.0,00000
84.0,87.0,81.0,908,09,01,  Sapchhari Jautha Kh,71,143,53,65,18,78,33.2,44.9,18.8,00000
84.0,87.0,81.0,908,10,01,  Bangali Para-2,366,198,206,120,160,78,64.9,63.2,67.2,00000
84.0,87.0,81.0,908,11,01,  Narai Chhara Para,112,300,71,142,41,158,27.2,33.3,20.6,00000
84.0,87.0,81.0,908,12,01,  Chairman Para,34,45,21,22,13,23,43.0,48.8,36.1,00000
84.0,87.0,81.0,908,13,01,  Rajani Para,37,52,22,26,15,26,41.6,45.8,36.6,00000
84.0,87.0,81.0,908,14,01,  Keyang Para,45,49,28,22,17,27,47.9,56.0,38.6,00000
84.0,87.0,81.0,951,01,01,  Khamar Para,155,202,83,93,72,109,43.4,47.2,39.8,00000
84.0,87.0,81.0,951,02,01,  Murang Chhari,47,152,33,71,14,81,23.6,31.7,14.7,00000
84.0,87.0,81.0,951,03,01,  Murang Chhari Khama,58,66,44,29,14,37,46.8,60.3,27.5,00000
84.0,87.0,81.0,951,04,01,  Sukur Chari Boro Para,189,254,115,109,74,145,42.7,51.3,33.8,00000
30.0,14.0,47.0,305,01,01,  Minakazi Kona,1028,479,508,192,520,287,68.2,72.6,64.4,00000
30.0,14.0,47.0,305,02,01,  Shekji Kona,477,578,216,231,261,347,45.2,48.3,42.9,00000
30.0,14.0,47.0,305,03,01,  Chaygora,956,336,492,130,464,206,74.0,79.1,69.3,00000
30.0,14.0,47.0,305,04,01,  Nowa Para,253,110,118,45,135,65,69.7,72.4,67.5,00000
30.0,14.0,47.0,305,05,01,  Dalutpur,764,321,361,122,403,199,70.4,74.7,66.9,00000
30.0,14.0,47.0,640,01,01,  Alukdaia,821,334,383,125,438,209,71.1,75.4,67.7,00000
30.0,14.0,47.0,640,02,01,  Niz Kunjara,1687,842,786,343,901,499,66.7,69.6,64.4,00000
30.0,14.0,47.0,640,03,01,  Ahowduri Para,1410,590,805,220,605,370,70.5,78.5,62.1,00000
30.0,14.0,47.0,640,04,01,  Bokshi Para,415,352,209,169,206,183,54.1,55.3,53.0,00000
30.0,14.0,47.0,640,05,01,  Satni Para,321,78,168,26,153,52,80.5,86.6,74.6,00000
30.0,14.0,76.0,371,01,01,  Purba Haripur,696,336,321,159,375,177,67.4,66.9,67.9,00000
30.0,14.0,76.0,371,02,01,  Uttar Haripur,1293,281,615,108,678,173,82.1,85.1,79.7,00000
30.0,14.0,76.0,371,03,01,  Dakshin Haripur,1626,1214,763,654,863,560,57.3,53.8,60.6,00000
30.0,14.0,76.0,742,01,01,  Pathan Nagar,884,489,410,221,474,268,64.4,65.0,63.9,00000
30.0,14.0,76.0,742,02,01,  Kanthalia,658,127,343,43,315,84,83.8,88.9,78.9,00000
30.0,14.0,76.0,882,01,01,  Paschim Sonapur,862,448,389,199,473,249,65.8,66.2,65.5,00000
30.0,14.0,76.0,882,02,01,  Purba Sonapur,529,201,230,69,299,132,72.5,76.9,69.4,00000
30.0,25.0,38.0,100,01,01,  Uttar Barai Gobinda,3011,1888,1505,838,1506,1050,61.5,64.2,58.9,00000
30.0,25.0,38.0,100,02,01,  Dakshin Barai Gobinda,1252,1190,569,578,683,612,51.3,49.6,52.7,00000
30.0,25.0,38.0,462,01,01,  Uttar Jailashkara,3129,1144,1513,480,1616,664,73.2,75.9,70.9,00000
30.0,25.0,38.0,462,02,01,  Dakshin Jailashkara,1256,1017,546,505,710,512,55.3,52.0,58.1,00000
30.0,25.0,38.0,643,01,01,  Uttar Newazpur,1031,262,493,92,538,170,79.7,84.3,76.0,00000
30.0,25.0,38.0,643,02,01,  Dakshin Newazpur,1036,389,495,169,541,220,72.7,74.5,71.1,00000
30.0,25.0,56.0,904,01,01,  Alipur,865,387,393,154,472,233,69.1,71.8,67.0,00000
30.0,25.0,56.0,904,02,01,  Udaynagar,553,553,247,231,306,322,50.0,51.7,48.7,00000
30.0,25.0,56.0,904,03,01,  Bargadia,314,103,151,39,163,64,75.3,79.5,71.8,00000
30.0,25.0,56.0,904,04,01,  Singerkhil,473,246,207,95,266,151,65.8,68.5,63.8,00000
30.0,25.0,56.0,904,05,01,  Lakshmipur,517,245,243,103,274,142,67.8,70.2,65.9,00000
30.0,25.0,56.0,904,06,01,  Rahi Praza,300,265,144,110,156,155,53.1,56.7,50.2,00000
30.0,25.0,69.0,748,01,01,  Gazaria,2296,1201,1080,538,1216,663,65.7,66.7,64.7,00000
30.0,25.0,69.0,748,02,01,  Baitarpar,1028,598,489,259,539,339,63.2,65.4,61.4,00000
30.0,25.0,69.0,748,03,01,  Omrabad,813,221,388,95,425,126,78.6,80.3,77.1,00000
30.0,25.0,69.0,748,04,01,  Paschim Purba Chandrapur Deuli,1139,829,499,360,640,469,57.9,58.1,57.7,00000
30.0,25.0,69.0,748,05,01,  Keronia,1119,742,487,324,632,418,60.1,60.0,60.2,00000
30.0,25.0,69.0,748,06,01,  Kishorganj,673,322,319,139,354,183,67.6,69.7,65.9,00000
30.0,25.0,69.0,748,07,01,  Purba Chandrapur,1315,982,609,426,706,556,57.2,58.8,55.9,00000
30.0,25.0,73.0,748,01,01,  Sapua,918,787,392,332,526,455,53.8,54.1,53.6,00000
30.0,25.0,73.0,748,02,01,  Nandigram,696,547,294,223,402,324,56.0,56.9,55.4,00000
30.0,25.0,73.0,748,03,01,  Kamar Pukuria,416,304,175,134,241,170,57.8,56.6,58.6,00000
30.0,25.0,73.0,748,04,01,  Elashkhan,72,50,33,21,39,29,59.0,61.1,57.4,00000
30.0,25.0,73.0,804,01,01,  Samaspur,1221,964,560,422,661,542,55.9,57.0,54.9,00000
30.0,25.0,73.0,804,02,01,  Mahadipur,524,492,231,189,293,303,51.6,55.0,49.2,00000
30.0,25.0,73.0,804,03,01,  Bathshiree,468,590,219,262,249,328,44.2,45.5,43.2,00000
30.0,25.0,90.0,512,01,01,  Uttar Kausalla,969,1404,355,634,614,770,40.8,35.9,44.4,00000
30.0,25.0,90.0,512,02,01,  Dakshin Kausalla,861,1589,356,756,505,833,35.1,32.0,37.7,00000
30.0,25.0,90.0,854,01,01,  Sharifpur,707,592,355,270,352,322,54.4,56.8,52.2,00000
30.0,25.0,90.0,854,02,01,  Gatamkhali,375,381,158,158,217,223,49.6,50.0,49.3,00000
30.0,25.0,90.0,964,01,01,  Uttar Raghunathpur,1653,1580,697,690,956,890,51.1,50.3,51.8,00000
30.0,25.0,90.0,964,02,01,  Babantala,90,144,30,71,60,73,38.5,29.7,45.1,00000
30.0,25.0,90.0,964,03,01,  Tangarpar,41,37,19,18,22,19,52.6,51.4,53.7,00000
30.0,25.0,94.0,170,01,01,  Uttar Chandipur,720,478,326,216,394,262,60.1,60.1,60.1,00000
30.0,25.0,94.0,170,02,01,  Rameshwarpur,394,388,165,191,229,197,50.4,46.3,53.8,00000
30.0,25.0,94.0,170,03,01,  Madhya Chandipur,3286,2291,1543,1100,1743,1191,58.9,58.4,59.4,00000
30.0,25.0,94.0,170,04,01,  Dakshin Chandipur,490,595,200,280,290,315,45.2,41.7,47.9,00000
30.0,29.0,51.0,161,01,01,  Uttar Chandpur,1420,589,728,235,692,354,70.7,75.6,66.2,00000
30.0,29.0,51.0,161,02,01,  Dakshin Chandpur,1465,738,694,340,771,398,66.5,67.1,66.0,00000
30.0,29.0,64.0,493,01,01,  Uttar Kashimpur,1255,792,605,347,650,445,61.3,63.6,59.4,00000
30.0,29.0,64.0,493,02,01,  Dakshin Kashimpur,2001,1591,934,823,1067,768,55.7,53.2,58.1,00000
30.0,41.0,27.0,259,01,01,  Daulatpur,1217,529,620,218,597,311,69.7,74.0,65.7,00000
30.0,41.0,27.0,259,02,01,  Islampur,403,222,179,91,224,131,64.5,66.3,63.1,00000
30.0,41.0,27.0,346,01,01,  Hasanpur,1367,920,649,418,718,502,59.8,60.8,58.9,00000
30.0,41.0,27.0,346,02,01,  Talpukuria,273,117,120,48,153,69,70.0,71.4,68.9,00000
30.0,41.0,54.0,201,01,01,  Purba Darbarpur,1196,452,671,216,525,236,72.6,75.6,69.0,00000
30.0,41.0,54.0,201,02,01,  Pashimdarbarpur,1361,840,760,391,601,449,61.8,66.0,57.2,00000
30.0,41.0,67.0,272,01,03,  Dakshin Sreepur,1047,807,556,348,491,459,56.5,61.5,51.7,00000
30.0,41.0,67.0,272,02,03,  Uttar Basura,145,213,57,99,88,114,40.5,36.5,43.6,00000
30.0,41.0,74.0,722,01,01,  Uttar Sreechandrapur,973,930,441,389,532,541,51.1,53.1,49.6,00000
30.0,41.0,74.0,722,02,01,  Dakshin Sreechandrapur,689,386,363,173,326,213,64.1,67.7,60.5,00000
30.0,41.0,81.0,447,01,01,  Uttar Karaiya,454,208,249,101,205,107,68.6,71.1,65.7,00000
30.0,41.0,81.0,447,02,01,  Dakshin Karaiya,859,623,475,277,384,346,58.0,63.2,52.6,00000
30.0,41.0,81.0,762,01,01,  Dakshin Poithara,316,147,177,64,139,83,68.3,73.4,62.6,00000
30.0,41.0,81.0,762,02,01,  Uttar Poithara,425,73,226,36,199,37,85.3,86.3,84.3,00000
30.0,41.0,81.0,762,03,01,  Fokhirar Khil,352,104,193,51,159,53,77.2,79.1,75.0,00000
30.0,51.0,23.0,465,01,01,  Madhyam Dhankunda,361,523,176,230,185,293,40.8,43.3,38.7,00000
30.0,51.0,23.0,465,02,01,  Gucca Gram,67,162,36,69,31,93,29.3,34.3,25.0,00000
30.0,51.0,47.0,593,01,01,  Mirzanagar,706,402,343,158,363,244,63.7,68.5,59.8,00000
30.0,51.0,47.0,593,02,01,  Chhoygharia,102,103,47,53,55,50,49.8,47.0,52.4,00000
30.0,51.0,47.0,609,01,01,  Nij Kalikapur,1016,421,496,176,520,245,70.7,73.8,68.0,00000
30.0,51.0,47.0,609,02,01,  Fakirer Khil,116,57,59,29,57,28,67.1,67.0,67.1,00000
30.0,51.0,47.0,704,01,01,  Jangalghona,248,166,129,79,119,87,59.9,62.0,57.8,00000
30.0,51.0,47.0,704,02,01,  Godanagar,281,102,136,49,145,53,73.4,73.5,73.2,00000
30.0,94.0,28.0,217,01,01,  Char Chandia (Part),4814,4856,2659,2180,2155,2676,49.8,54.9,44.6,00000
30.0,94.0,28.0,217,02,01,  Char Chandia,4779,4164,2299,1807,2480,2357,53.4,56.0,51.3,00000
30.0,94.0,28.0,217,03,01,  Dakshin Char Chandia,3562,5057,1807,2424,1755,2633,41.3,42.7,40.0,00000
30.0,94.0,28.0,217,04,01,  Paschim Char Chandia,1486,1181,696,509,790,672,55.7,57.8,54.0,00000
30.0,94.0,38.0,228,01,01,  Char Darbesh,4242,5158,1939,2435,2303,2723,45.1,44.3,45.8,00000
30.0,94.0,38.0,228,02,01,  Guchchhagram,325,664,139,330,186,334,32.9,29.6,35.8,00000
75.0,7.0,10.0,106,01,01,  Balu Char,535,433,207,179,328,254,55.3,53.6,56.4,00000
75.0,7.0,10.0,106,02,01,  Char Mehedi,102,49,43,20,59,29,67.5,68.3,67.0,00000
75.0,7.0,10.0,891,01,01,  Dakshin Abhirampur,698,314,296,138,402,176,69.0,68.2,69.6,00000
75.0,7.0,10.0,891,02,01,  Domonpur,134,98,60,48,74,50,57.8,55.6,59.7,00000
75.0,7.0,10.0,958,01,01,  Purba Sultanpur,573,445,255,202,318,243,56.3,55.8,56.7,00000
75.0,7.0,10.0,958,02,01,  Paschim Sultanpur,343,178,153,89,190,89,65.8,63.2,68.1,00000
75.0,7.0,45.0,840,01,01,  Rezakpur,914,993,381,473,533,520,47.9,44.6,50.6,00000
75.0,7.0,45.0,840,02,01,  Tulachhara,1108,477,450,201,658,276,69.9,69.1,70.4,00000
75.0,7.0,56.0,433,01,01,  Uttar Jirtali,2235,1205,1044,531,1191,674,65.0,66.3,63.9,00000
75.0,7.0,56.0,433,02,01,  Madhya Jirtali,1817,1210,846,543,971,667,60.0,60.9,59.3,00000
75.0,7.0,56.0,433,03,01,  Dakshin Jirtali,1024,1138,385,495,639,643,47.4,43.8,49.8,00000
75.0,10.0,17.0,162,01,01,  Rudra Rampur,772,205,334,95,438,110,79.0,77.9,79.9,00000
75.0,10.0,17.0,162,02,01,  Chandpur,410,149,163,68,247,81,73.3,70.6,75.3,00000
75.0,10.0,28.0,231,01,01,  Khil Para,1073,525,517,251,556,274,67.1,67.3,67.0,00000
75.0,10.0,28.0,231,02,01,  Datterbagh,406,51,238,20,168,31,88.8,92.2,84.4,00000
75.0,10.0,28.0,231,03,01,  Sreerai,230,29,107,15,123,14,88.8,87.7,89.8,00000
75.0,10.0,28.0,231,04,01,  Chhota Jibnagar,1065,530,482,246,583,284,66.8,66.2,67.2,00000
75.0,10.0,28.0,711,01,01,  Sankarpur,1019,869,473,448,546,421,54.0,51.4,56.5,00000
75.0,10.0,28.0,711,02,01,  Jaduganj,202,84,96,41,106,43,70.6,70.1,71.1,00000
75.0,10.0,28.0,711,03,01,  Khirihati,490,437,216,235,274,202,52.9,47.9,57.6,00000
75.0,10.0,38.0,454,01,01,  Lakshmanpur,238,191,107,84,131,107,55.5,56.0,55.0,00000
75.0,10.0,38.0,454,02,01,  Bhabanipur,42,40,19,17,23,23,51.2,52.8,50.0,00000
75.0,10.0,38.0,574,01,01,  Uttar Mohammadpur,1524,1044,646,581,878,463,59.3,52.6,65.5,00000
75.0,10.0,38.0,574,02,01,  Madhya Mohammadpur,848,697,344,342,504,355,54.9,50.1,58.7,00000
75.0,10.0,38.0,574,03,01,  Dakshin Mohammadpur,645,490,282,247,363,243,56.8,53.3,59.9,00000
75.0,10.0,38.0,729,01,01,  Palla Bazar,175,96,78,38,97,58,64.6,67.2,62.6,00000
75.0,10.0,38.0,729,02,01,  Dulalpur,627,540,297,321,330,219,53.7,48.1,60.1,00000
75.0,10.0,38.0,729,03,01,  Taherpur,229,103,97,49,132,54,69.0,66.4,71.0,00000
75.0,10.0,38.0,729,04,01,  Nath Para,242,176,98,84,144,92,57.9,53.8,61.0,00000
75.0,10.0,38.0,729,05,01,  Ramchandrapur,230,100,105,45,125,55,69.7,70.0,69.4,00000
75.0,10.0,38.0,729,06,01,  Dhannapur,810,212,371,100,439,112,79.3,78.8,79.7,00000
75.0,10.0,57.0,111,01,01,  Barai Para,1581,562,700,277,881,285,73.8,71.6,75.6,00000
75.0,10.0,57.0,111,02,01,  Hossainpur,689,161,306,68,383,93,81.1,81.8,80.5,00000
75.0,10.0,57.0,120,01,01,  Bhaor,1188,445,529,212,659,233,72.7,71.4,73.9,00000
75.0,10.0,57.0,120,02,01,  Nij Bhaor,1453,671,675,311,778,360,68.4,68.5,68.4,00000
75.0,10.0,57.0,120,03,01,  Alipur,260,73,110,33,150,40,78.1,76.9,78.9,00000
75.0,10.0,76.0,068,01,01,  Purba Baikunthapur,497,267,202,117,295,150,65.1,63.3,66.3,00000
75.0,10.0,76.0,068,02,01,  Paschim Baikunthapur,440,255,179,125,261,130,63.3,58.9,66.8,00000
75.0,10.0,76.0,832,01,01,  Ramnarayanpur,774,650,336,347,438,303,54.4,49.2,59.1,00000
75.0,10.0,76.0,832,02,01,  Kalyannagar,648,556,282,288,366,268,53.8,49.5,57.7,00000
75.0,10.0,76.0,832,03,01,  Kundish Para,694,493,292,224,402,269,58.5,56.6,59.9,00000
75.0,10.0,76.0,832,04,01,  Uttar Ramnarayan Pur,1702,669,751,295,951,374,71.8,71.8,71.8,00000
75.0,21.0,11.0,260,01,01,  Char Balua,219,678,119,348,100,330,24.4,25.5,23.3,00000
75.0,21.0,11.0,260,02,01,  Guchchhagram,352,955,178,477,174,478,26.9,27.2,26.7,00000
75.0,21.0,23.0,390,01,01,  Paschim Char Hazari,2216,2374,1033,1107,1183,1267,48.3,48.3,48.3,00000
75.0,21.0,23.0,390,02,01,  Madhya Char Hazari,2564,2873,1268,1323,1296,1550,47.2,48.9,45.5,00000
75.0,21.0,23.0,390,03,01,  Purba Char Hazari,5198,5470,2447,2493,2751,2977,48.7,49.5,48.0,00000
75.0,21.0,35.0,710,01,01,  Paschim Char Kakra,7308,6450,3355,2866,3953,3584,53.1,53.9,52.4,00000
75.0,21.0,35.0,710,02,01,  Purba Char Kakra,4378,3896,2016,1818,2362,2078,52.9,52.6,53.2,00000
75.0,21.0,35.0,710,03,01,  Dakshin Char Kakra,4242,3427,2018,1612,2224,1815,55.3,55.6,55.1,00000
75.0,21.0,47.0,533,01,01,  Paschim Char Parbati,3963,4289,1849,1956,2114,2333,48.0,48.6,47.5,00000
75.0,21.0,47.0,533,02,01,  Uttar Char Parbati,6461,5384,2835,2385,3626,2999,54.5,54.3,54.7,00000
75.0,21.0,47.0,533,03,01,  Dakshin Char Parbati,3278,3111,1579,1362,1699,1749,51.3,53.7,49.3,00000
75.0,21.0,71.0,852,01,01,  Dakshin Rampur,4787,4398,2291,2132,2496,2266,52.1,51.8,52.4,00000
75.0,21.0,71.0,852,02,01,  Paschim Rampur,2260,1458,1061,630,1199,828,60.8,62.7,59.2,00000
75.0,21.0,71.0,852,03,01,  Purba Rampur,3685,2256,1714,947,1971,1309,62.0,64.4,60.1,00000
75.0,36.0,15.0,026,01,01,  Purba Bara Dail,1535,4463,732,2213,803,2250,25.6,24.9,26.3,00000
75.0,36.0,15.0,026,02,01,  Paschim Bara Dail,1024,1536,509,731,515,805,40.0,41.0,39.0,00000
75.0,36.0,15.0,026,03,01,  Kalir Char,1445,4004,760,1949,685,2055,26.5,28.1,25.0,00000
75.0,36.0,15.0,960,01,01,  Uttar Rehania,1420,2032,672,969,748,1063,41.1,41.0,41.3,00000
75.0,36.0,15.0,960,02,01,  Dakshin Rehania,812,1871,376,903,436,968,30.3,29.4,31.1,00000
75.0,36.0,28.0,255,01,01,  Uttar Char Ishwar Roy,3834,8077,2000,3865,1834,4212,32.2,34.1,30.3,00000
75.0,36.0,28.0,255,02,01,  Dakshin Char Ishwar Roy,1925,1663,993,755,932,908,53.7,56.8,50.7,00000
75.0,36.0,28.0,255,03,01,  Rajar Haola,83,71,46,33,37,38,53.9,58.2,49.3,00000
75.0,36.0,28.0,255,04,01,  Char Latiya,839,1172,466,536,373,636,41.7,46.5,37.0,00000
75.0,36.0,38.0,284,01,01,  Uttar Char Ishwar Roy,3941,6344,2146,2931,1795,3413,38.3,42.3,34.5,00000
75.0,36.0,38.0,284,02,01,  Dakshin Char Ishwar Roy,3366,3231,1750,1527,1616,1704,51.0,53.4,48.7,00000
75.0,36.0,38.0,284,03,01,  Boalia,3131,5019,1597,2220,1534,2799,38.4,41.8,35.4,00000
75.0,36.0,38.0,284,04,01,  Shullukia,1625,3075,890,1446,735,1629,34.6,38.1,31.1,00000
75.0,36.0,85.0,085,01,01,  Dakshin Char Amanullah,1964,4797,1039,2173,925,2624,29.0,32.3,26.1,00000
75.0,36.0,85.0,085,02,01,  Dalchar,193,501,118,273,75,228,27.8,30.2,24.8,00000
75.0,36.0,95.0,454,01,01,  Paschim Khirodia,585,1304,329,633,256,671,31.0,34.2,27.6,00000
75.0,36.0,95.0,454,02,01,  Purba Khirodia,914,1514,495,744,419,770,37.6,40.0,35.2,00000
75.0,36.0,95.0,454,03,01,  Athara Beki,870,1896,477,952,393,944,31.5,33.4,29.4,00000
75.0,36.0,95.0,454,04,01,  Koralia,519,1374,285,683,234,691,27.4,29.4,25.3,00000
75.0,36.0,95.0,454,05,01,  Paschim Jorkhali,869,1283,460,564,409,719,40.4,44.9,36.3,00000
75.0,36.0,95.0,454,06,01,  Purba Jorkhali,1078,480,528,214,550,266,69.2,71.2,67.4,00000
75.0,36.0,95.0,454,07,01,  Uttar Tamaruddin,1622,1630,823,725,799,905,49.9,53.2,46.9,00000
75.0,36.0,95.0,454,08,01,  Dakshin Bhejugalia (Part),1539,1385,838,648,701,737,52.6,56.4,48.7,00000
75.0,36.0,95.0,454,09,01,  Uttar Bhejugalia (Part),1803,1917,965,887,838,1030,48.5,52.1,44.9,00000
75.0,80.0,13.0,402,01,01,  Idilpur,1358,1507,556,673,802,834,47.4,45.2,49.0,00000
75.0,80.0,13.0,402,02,01,  Nazirnagar,918,859,368,389,550,470,51.7,48.6,53.9,00000
75.0,80.0,28.0,211,01,01,  Chhatarpaia,7056,6073,3538,3009,3518,3064,53.7,54.0,53.4,00000
75.0,80.0,28.0,211,02,01,  Panchtupaia,560,521,302,255,258,266,51.8,54.2,49.2,00000
75.0,80.0,47.0,603,01,01,  Mahadipur,1428,1580,697,799,731,781,47.5,46.6,48.3,00000
75.0,80.0,47.0,603,02,01,  Domnakandi,676,427,362,195,314,232,61.3,65.0,57.5,00000
75.0,80.0,57.0,422,01,03,  Joynagar,801,296,360,120,441,176,73.0,75.0,71.5,00000
75.0,80.0,57.0,422,02,03,  Hizli,564,377,285,184,279,193,59.9,60.8,59.1,00000
75.0,80.0,57.0,422,03,03,  Fatehpur,208,117,103,46,105,71,64.0,69.1,59.7,00000
75.0,80.0,57.0,422,04,03,  Shovopur(Part),193,184,84,75,109,109,51.2,52.8,50.0,00000
75.0,80.0,57.0,422,05,03,  Mograjamal Pur,581,705,239,303,342,402,45.2,44.1,46.0,00000
75.0,80.0,57.0,422,06,03,  Mogua (Part),669,479,278,220,391,259,58.3,55.8,60.2,00000
75.0,83.0,15.0,009,01,01,  Abir Para,996,659,417,297,579,362,60.2,58.4,61.5,00000
75.0,83.0,15.0,009,02,01,  Tatherkhil,493,412,218,196,275,216,54.5,52.7,56.0,00000
75.0,83.0,15.0,009,03,01,  Sokarpur,270,312,106,143,164,169,46.4,42.6,49.2,00000
75.0,83.0,15.0,015,01,01,  Aichha Para,578,218,247,100,331,118,72.6,71.2,73.7,00000
75.0,83.0,15.0,015,02,01,  Krishnapur,320,176,127,62,193,114,64.5,67.2,62.9,00000
75.0,83.0,15.0,136,01,01,  Batagram,852,524,340,218,512,306,61.9,60.9,62.6,00000
75.0,83.0,15.0,136,02,01,  Mirikpur,180,79,74,35,106,44,69.5,67.9,70.7,00000
75.0,83.0,15.0,518,01,01,  Manikyanagar,1296,523,564,239,732,284,71.2,70.2,72.0,00000
75.0,83.0,15.0,518,02,01,  Barahinagar,1330,520,582,232,748,288,71.9,71.5,72.2,00000
75.0,83.0,15.0,518,03,01,  Keshorkhil,559,212,240,108,319,104,72.5,69.0,75.4,00000
75.0,83.0,15.0,518,04,01,  Barapara,240,291,95,131,145,160,45.2,42.0,47.5,00000
75.0,83.0,15.0,688,01,01,  Naya Rajarampur,678,237,339,154,339,83,74.1,68.8,80.3,00000
75.0,83.0,15.0,688,02,01,  Sanarbagh,428,125,218,82,210,43,77.4,72.7,83.0,00000
75.0,83.0,15.0,864,01,01,  Satgharia,578,419,236,200,342,219,58.0,54.1,61.0,00000
75.0,83.0,15.0,864,02,01,  Kangshanagar,197,192,76,111,121,81,50.6,40.6,59.9,00000
75.0,83.0,15.0,864,03,01,  Naori,1353,446,562,217,791,229,75.2,72.1,77.5,00000
75.0,83.0,15.0,910,01,01,  Kaicherbagh,110,113,33,60,77,53,49.3,35.5,59.2,00000
75.0,83.0,15.0,910,02,01,  Noagaon,339,302,155,111,184,191,52.9,58.3,49.1,00000
75.0,83.0,31.0,442,01,01,  Kabilpur,820,813,353,349,467,464,50.2,50.3,50.2,00000
75.0,83.0,31.0,442,02,01,  Khod Khasta,265,150,113,55,152,95,63.9,67.3,61.5,00000
75.0,83.0,35.0,318,01,01,  Durga Daulatpur,339,302,154,168,185,134,52.9,47.8,58.0,00000
75.0,83.0,35.0,318,02,01,  Surhally,669,531,293,226,376,305,55.8,56.5,55.2,00000
75.0,83.0,35.0,670,01,01,  Ramdebpur,275,255,130,139,145,116,51.9,48.3,55.6,00000
75.0,83.0,35.0,670,02,01,  Banipur,400,173,176,78,224,95,69.8,69.3,70.2,00000
75.0,83.0,59.0,982,01,01,  Ulupara,1435,670,637,300,798,370,68.2,68.0,68.3,00000
75.0,83.0,59.0,982,02,01,  Jogikhil Para,1226,754,544,357,682,397,61.9,60.4,63.2,00000
75.0,85.0,47.0,122,01,01,  Char Majid  (Part),1441,4303,782,2071,659,2232,25.1,27.4,22.8,00000
75.0,85.0,47.0,122,02,01,  Purba Char Majid,997,3232,507,1566,490,1666,23.6,24.5,22.7,00000
75.0,87.0,23.0,034,01,01,  Purba Ashwadia,829,860,358,374,471,486,49.1,48.9,49.2,00000
75.0,87.0,23.0,034,02,01,  Paschim Ashwadia,1622,1121,735,514,887,607,59.1,58.8,59.4,00000
75.0,87.0,23.0,288,02,01,  Purba Dumchar,161,183,76,88,85,95,46.8,46.3,47.2,00000
75.0,87.0,23.0,850,01,01,  Dakshin Masimpur (Part),948,466,563,250,385,216,67.0,69.2,64.1,00000
75.0,87.0,23.0,850,02,01,  Dakshin Niranjan Pur,407,139,182,65,225,74,74.5,73.7,75.3,00000
75.0,87.0,50.0,337,01,01,  Paschim Ewazbalia,1550,3005,788,1296,762,1709,34.0,37.8,30.8,00000
75.0,87.0,50.0,337,02,01,  Purba Ewazbalia,4617,7183,2201,3339,2416,3844,39.1,39.7,38.6,00000
75.0,87.0,65.0,751,01,01,  Uttar Ramhari Taluk,1312,1771,638,786,674,985,42.6,44.8,40.6,00000
75.0,87.0,65.0,751,02,01,  Dakshin Ramhari Taluk,897,1305,425,564,472,741,40.7,43.0,38.9,00000
75.0,87.0,80.0,178,01,01,  Purba Charuriya,1424,1127,658,508,766,619,55.8,56.4,55.3,00000
75.0,87.0,80.0,178,02,01,  Madhya Charuriya,771,855,340,399,431,456,47.4,46.0,48.6,00000
75.0,87.0,80.0,178,03,01,  Paschim Charuriya,1885,2258,967,1047,918,1211,45.5,48.0,43.1,00000
29.0,3.0,10.0,013,01,03,  Alfadanga,1962,451,991,189,971,262,81.3,84.0,78.8,00000
29.0,3.0,10.0,013,02,03,  Kusumdi,947,419,448,197,499,222,69.3,69.5,69.2,00000
29.0,3.0,10.0,013,03,03,  Bara Kusumdi,86,121,45,63,41,58,41.5,41.7,41.4,00000
29.0,3.0,10.0,456,01,01,  Ichhapasa,461,214,215,101,246,113,68.3,68.0,68.5,00000
29.0,3.0,10.0,456,02,01,  Modhunagar,63,101,38,49,25,52,38.4,43.7,32.5,00000
29.0,3.0,10.0,456,03,01,  Char Bakhil,66,115,38,56,28,59,36.5,40.4,32.2,00000
29.0,3.0,10.0,621,01,01,  Mahisherghop,154,166,67,68,87,98,48.1,49.6,47.0,00000
29.0,3.0,10.0,621,02,01,  Baripara,489,583,204,263,285,320,45.6,43.7,47.1,00000
29.0,3.0,10.0,663,01,01,  Mithapur,1082,960,517,444,565,516,53.0,53.8,52.3,00000
29.0,3.0,10.0,663,02,01,  Gazipur,73,35,32,13,41,22,67.6,71.1,65.1,00000
29.0,3.0,10.0,939,01,01,  Dolirchar,443,329,190,159,253,170,57.4,54.4,59.8,00000
29.0,3.0,10.0,939,02,01,  Sukurhata,251,315,119,148,132,167,44.3,44.6,44.1,00000
29.0,3.0,10.0,939,03,01,  Baisa,42,48,26,23,16,25,46.7,53.1,39.0,00000
29.0,3.0,21.0,970,01,01,  Arpara,662,644,344,296,318,348,50.7,53.8,47.7,00000
29.0,3.0,21.0,970,02,01,  Tonarchar,363,234,169,118,194,116,60.8,58.9,62.6,00000
29.0,3.0,21.0,970,03,01,  Tonapara,584,361,300,181,284,180,61.8,62.4,61.2,00000
29.0,3.0,21.0,970,04,01,  Tabni,190,173,94,72,96,101,52.3,56.6,48.7,00000
29.0,3.0,31.0,193,01,03,  Buraich,659,515,328,231,331,284,56.1,58.7,53.8,00000
29.0,3.0,31.0,193,02,03,  Sreerampur,501,211,264,114,237,97,70.4,69.8,71.0,00000
29.0,3.0,31.0,317,01,01,  Char Kholabaria,412,346,199,171,213,175,54.4,53.8,54.9,00000
29.0,3.0,31.0,317,02,01,  Kholabaria,162,246,71,117,91,129,39.7,37.8,41.4,00000
29.0,3.0,31.0,538,01,01,  Katurakandi,533,630,223,327,310,303,45.8,40.5,50.6,00000
29.0,3.0,31.0,538,02,01,  Fandha,93,63,36,29,57,34,59.6,55.4,62.6,00000
29.0,3.0,31.0,538,03,01,  Halenchati,224,91,124,31,100,60,71.1,80.0,62.5,00000
29.0,3.0,42.0,069,01,01,  Bakail,842,650,438,308,404,342,56.4,58.7,54.2,00000
29.0,3.0,42.0,069,02,01,  Nagarkanda,143,116,63,55,80,61,55.2,53.4,56.7,00000
29.0,3.0,42.0,221,01,01,  Chandra,730,719,372,342,358,377,50.4,52.1,48.7,00000
29.0,3.0,42.0,221,02,01,  Baniagati,29,17,18,6,11,11,63.0,75.0,50.0,00000
29.0,3.0,42.0,580,01,01,  Kuchiagram,776,572,349,237,427,335,57.6,59.6,56.0,00000
29.0,3.0,42.0,580,02,01,  Tagarbhanga,156,104,70,43,86,61,60.0,61.9,58.5,00000
29.0,3.0,42.0,580,03,01,  Katalsur,233,141,104,44,129,97,62.3,70.3,57.1,00000
29.0,3.0,42.0,594,01,01,  Kuldhar,145,90,61,49,84,41,61.7,55.5,67.2,00000
29.0,3.0,42.0,594,02,01,  Fulbaria,103,39,51,17,52,22,72.5,75.0,70.3,00000
29.0,3.0,42.0,704,01,01,  Naopara,1033,471,493,214,540,257,68.7,69.7,67.8,00000
29.0,3.0,42.0,704,02,01,  Charnao Para,228,136,116,65,112,71,62.6,64.1,61.2,00000
29.0,3.0,42.0,732,01,01,  Pabanbeg,354,387,162,191,192,196,47.8,45.9,49.5,00000
29.0,3.0,42.0,732,02,01,  Satiargari,38,19,15,8,23,11,66.7,65.2,67.6,00000
29.0,3.0,42.0,732,03,01,  Malidanga,152,86,75,42,77,44,63.9,64.1,63.6,00000
29.0,3.0,52.0,166,01,01,  Bhat Para,401,501,179,234,222,267,44.5,43.3,45.4,00000
29.0,3.0,52.0,166,02,01,  Char Bhat Para,88,128,43,64,45,64,40.7,40.2,41.3,00000
29.0,3.0,52.0,166,03,01,  Dakshin Bhat Para,65,39,28,18,37,21,62.5,60.9,63.8,00000
29.0,3.0,52.0,219,01,01,  Chandra,169,89,93,50,76,39,65.5,65.0,66.1,00000
29.0,3.0,52.0,219,02,01,  Char Chandra,54,57,26,25,28,32,48.6,51.0,46.7,00000
29.0,3.0,52.0,351,01,01,  Dhuljuri,1058,1143,495,538,563,605,48.1,47.9,48.2,00000
29.0,3.0,52.0,351,02,01,  Berirhat,36,18,22,11,14,7,66.7,66.7,66.7,00000
29.0,3.0,52.0,490,01,01,  Jogibarat,1188,1102,577,512,611,590,51.9,53.0,50.9,00000
29.0,3.0,52.0,490,02,01,  Naturia,68,70,26,33,42,37,49.3,44.1,53.2,00000
29.0,3.0,52.0,758,01,01,  Panchuria,153,103,83,49,70,54,59.8,62.9,56.5,00000
29.0,3.0,52.0,758,02,01,  Dakshin Panchuria,384,303,182,135,202,168,55.9,57.4,54.6,00000
29.0,3.0,52.0,991,01,01,  Uttar Char Narayandia,755,522,376,230,379,292,59.1,62.0,56.5,00000
29.0,3.0,52.0,991,02,01,  Char Narayandia,467,247,233,124,234,123,65.4,65.3,65.5,00000
29.0,3.0,52.0,991,03,01,  Uttar Char Jhama,80,35,32,20,48,15,69.6,61.5,76.2,00000
29.0,3.0,84.0,082,01,01,  Barabhag,644,779,305,344,339,435,45.3,47.0,43.8,00000
29.0,3.0,84.0,082,02,01,  Ghidha,83,40,54,19,29,21,67.5,74.0,58.0,00000
29.0,3.0,84.0,082,03,01,  Langulia,44,39,30,20,14,19,53.0,60.0,42.4,00000
29.0,3.0,84.0,760,01,01,  Panail,1342,616,598,271,744,345,68.5,68.8,68.3,00000
29.0,3.0,84.0,760,02,01,  Sathbaria,178,124,78,51,100,73,58.9,60.5,57.8,00000
29.0,3.0,84.0,829,01,01,  Chardanga,656,619,262,279,394,340,51.5,48.4,53.7,00000
29.0,3.0,84.0,829,02,01,  Sekipara,55,80,27,33,28,47,40.7,45.0,37.3,00000
29.0,3.0,84.0,953,01,01,  Tagarbanda,622,244,331,93,291,151,71.8,78.1,65.8,00000
29.0,3.0,84.0,953,02,01,  Krishnapur,593,424,278,193,315,231,58.3,59.0,57.7,00000
29.0,10.0,13.0,021,01,01,  Paschim Algi,289,812,152,401,137,411,26.2,27.5,25.0,00000
29.0,10.0,13.0,021,02,01,  Purba Algi,265,224,132,112,133,112,54.2,54.1,54.3,00000
29.0,10.0,13.0,021,03,01,  Kaikhali,141,248,64,114,77,134,36.2,36.0,36.5,00000
29.0,10.0,13.0,139,01,01,  Bidyanandi,114,188,58,94,56,94,37.7,38.2,37.3,00000
29.0,10.0,13.0,139,02,01,  Nayakandi,162,260,83,110,79,150,38.4,43.0,34.5,00000
29.0,10.0,13.0,190,01,01,  Chandra,188,178,91,83,97,95,51.4,52.3,50.5,00000
29.0,10.0,13.0,190,02,01,  Purba Aruakandi,148,319,80,146,68,173,31.7,35.4,28.2,00000
29.0,10.0,13.0,190,03,01,  Paschim Aruakandi,175,441,82,209,93,232,28.4,28.2,28.6,00000
29.0,10.0,13.0,197,01,03,  Sonakhola,636,910,294,426,342,484,41.1,40.8,41.4,00000
29.0,10.0,13.0,197,02,03,  Majhardia,183,582,84,273,99,309,23.9,23.5,24.3,00000
29.0,10.0,13.0,197,03,03,  Baliachara,670,732,312,364,358,368,47.8,46.2,49.3,00000
29.0,10.0,13.0,197,04,03,  Munshikanda,145,141,74,69,71,72,50.7,51.7,49.7,00000
29.0,10.0,13.0,197,05,03,  Sarsakandi,221,135,111,57,110,78,62.1,66.1,58.5,00000
29.0,10.0,13.0,197,06,03,  Charkanda,580,502,287,216,293,286,53.6,57.1,50.6,00000
29.0,10.0,13.0,197,07,03,  Shahmullidi,109,200,55,89,54,111,35.3,38.2,32.7,00000
29.0,10.0,13.0,636,01,01,  Manikdi,348,305,155,132,193,173,53.3,54.0,52.7,00000
29.0,10.0,13.0,636,02,01,  Bharanikdi,113,112,51,41,62,71,50.2,55.4,46.6,00000
29.0,10.0,13.0,695,01,01,  Char Balia,180,296,91,154,89,142,37.8,37.1,38.5,00000
29.0,10.0,13.0,695,02,01,  Balia,214,866,103,412,111,454,19.8,20.0,19.6,00000
29.0,10.0,13.0,848,01,01,  Shahmallikdi,619,431,295,211,324,220,59.0,58.3,59.6,00000
29.0,10.0,13.0,848,02,01,  Pirerchar,854,857,407,390,447,467,49.9,51.1,48.9,00000
29.0,10.0,13.0,848,03,01,  Talkanda,346,237,139,110,207,127,59.3,55.8,62.0,00000
29.0,10.0,13.0,936,01,01,  Sulnia,196,284,90,124,106,160,40.8,42.1,39.8,00000
29.0,10.0,13.0,936,02,01,  Nawra,146,226,68,98,78,128,39.2,41.0,37.9,00000
29.0,10.0,25.0,841,01,03,  Roypara Sadardi,810,1005,384,445,426,560,44.6,46.3,43.2,00000
29.0,10.0,25.0,841,02,03,  Purba Sadardi,930,1791,444,833,486,958,34.2,34.8,33.7,00000
29.0,10.0,39.0,073,01,01,  Bamankanda,476,416,237,180,239,236,53.4,56.8,50.3,00000
29.0,10.0,39.0,073,02,01,  Baleakanda,50,40,22,24,28,16,55.6,47.8,63.6,00000
29.0,10.0,39.0,073,03,01,  Bogail,28,13,17,9,11,4,68.3,65.4,73.3,00000
29.0,10.0,39.0,131,01,01,  Bibirkandi,467,603,232,258,235,345,43.6,47.3,40.5,00000
29.0,10.0,39.0,131,02,01,  Baroikandi,64,124,30,60,34,64,34.0,33.3,34.7,00000
29.0,10.0,39.0,131,03,01,  Mujrikandi,201,257,96,127,105,130,43.9,43.0,44.7,00000
29.0,10.0,39.0,614,01,01,  Makrampatti,479,797,219,358,260,439,37.5,38.0,37.2,00000
29.0,10.0,39.0,614,02,01,  Mathapara,259,248,124,110,135,138,51.1,53.0,49.5,00000
29.0,10.0,39.0,877,01,01,  Sautikanda,267,402,151,203,116,199,39.9,42.7,36.8,00000
29.0,10.0,39.0,877,02,01,  Heraldi,279,351,154,176,125,175,44.3,46.7,41.7,00000
29.0,10.0,47.0,592,01,01,  Bara Muskarni,435,551,211,271,224,280,44.1,43.8,44.4,00000
29.0,10.0,47.0,592,02,01,  Chhota Muskarni,273,600,133,292,140,308,31.3,31.3,31.3,00000
29.0,10.0,47.0,592,03,01,  Bhemerkanda,184,473,82,238,102,235,28.0,25.6,30.3,00000
29.0,10.0,47.0,592,04,01,  Khondakarkanda,211,96,85,40,126,56,68.7,68.0,69.2,00000
29.0,10.0,47.0,592,05,01,  Bara Pandobi,283,172,148,90,135,82,62.2,62.2,62.2,00000
29.0,10.0,47.0,592,06,01,  Chhota Panadobi,227,234,99,109,128,125,49.2,47.6,50.6,00000
29.0,10.0,47.0,592,07,01,  Sahapara,282,165,137,80,145,85,63.1,63.1,63.0,00000
29.0,10.0,47.0,592,08,01,  Senkanda,110,102,59,52,51,50,51.9,53.2,50.5,00000
29.0,10.0,47.0,592,09,01,  Chowdhurykanda,461,300,223,149,238,151,60.6,59.9,61.2,00000
29.0,10.0,47.0,592,10,01,  Rajkanda,186,179,91,89,95,90,51.0,50.6,51.4,00000
29.0,10.0,47.0,592,11,01,  Kutibari,66,77,33,35,33,42,46.2,48.5,44.0,00000
29.0,10.0,47.0,592,12,01,  Char Muskarni,121,329,60,163,61,166,26.9,26.9,26.9,00000
29.0,10.0,47.0,607,01,01,  Majhikanda,319,477,141,240,178,237,40.1,37.0,42.9,00000
29.0,10.0,47.0,607,02,01,  Singaria,382,387,199,184,183,203,49.7,52.0,47.4,00000
29.0,10.0,47.0,643,01,01,  Mansurabad,716,582,355,277,361,305,55.2,56.2,54.2,00000
29.0,10.0,47.0,643,02,01,  Khapura,337,341,163,164,174,177,49.7,49.8,49.6,00000
29.0,10.0,47.0,716,01,01,  Hamirdi,1317,1286,681,590,636,696,50.6,53.6,47.7,00000
29.0,10.0,47.0,716,02,01,  Chhota Hamirdi,203,229,95,102,108,127,47.0,48.2,46.0,00000
29.0,10.0,47.0,716,03,01,  Gazaria,480,574,226,271,254,303,45.5,45.5,45.6,00000
29.0,10.0,55.0,497,01,01,  Uttar Kalamridha,775,636,371,304,404,332,54.9,55.0,54.9,00000
29.0,10.0,55.0,497,02,01,  Dakshin Kalamridha,567,498,264,228,303,270,53.2,53.7,52.9,00000
29.0,10.0,63.0,746,01,01,  Pallibera,694,1171,350,564,344,607,37.2,38.3,36.2,00000
29.0,10.0,63.0,746,02,01,  Baliadangi,383,403,180,186,203,217,48.7,49.2,48.3,00000
29.0,10.0,63.0,746,03,01,  Goyalbera,71,239,31,114,40,125,22.9,21.4,24.2,00000
29.0,10.0,71.0,014,01,01,  Adampur,878,899,450,439,428,460,49.4,50.6,48.2,00000
29.0,10.0,71.0,014,02,01,  Sadipur,118,258,50,124,68,134,31.4,28.7,33.7,00000
29.0,10.0,71.0,563,01,01,  Lakshmipur,640,731,288,351,352,380,46.7,45.1,48.1,00000
29.0,10.0,71.0,563,02,01,  Ramdebnagar,202,331,113,164,89,167,37.9,40.8,34.8,00000
29.0,10.0,71.0,629,01,01,  Manikdaha,1076,792,546,356,530,436,57.6,60.5,54.9,00000
29.0,10.0,71.0,629,02,01,  Balerbag,123,108,48,59,75,49,53.2,44.9,60.5,00000
29.0,10.0,71.0,702,01,01,  Nazirpur,569,515,280,220,289,295,52.5,56.0,49.5,00000
29.0,10.0,71.0,702,02,01,  Khakanda Nazirpur,644,575,306,275,338,300,52.8,52.7,53.0,00000
29.0,10.0,79.0,007,01,01,  Duppasha,337,369,150,168,187,201,47.7,47.2,48.2,00000
29.0,10.0,79.0,007,02,01,  Abdullahbad,146,85,76,37,70,48,63.2,67.3,59.3,00000
29.0,10.0,79.0,007,03,01,  Char Palla,275,150,114,65,161,85,64.7,63.7,65.4,00000
29.0,10.0,79.0,007,04,01,  Chhota Palla,237,260,121,96,116,164,47.7,55.8,41.4,00000
29.0,10.0,79.0,007,05,01,  Bara Palla,331,549,156,252,175,297,37.6,38.2,37.1,00000
29.0,10.0,79.0,095,01,01,  Bhadrakanda,385,464,179,220,206,244,45.3,44.9,45.8,00000
29.0,10.0,79.0,095,02,01,  Moulvidanga,163,117,64,55,99,62,58.2,53.8,61.5,00000
29.0,10.0,79.0,095,03,01,  Awabagh,46,38,22,16,24,22,54.8,57.9,52.2,00000
29.0,10.0,79.0,095,04,01,  Alikharkanda,446,444,181,198,265,246,50.1,47.8,51.9,00000
29.0,10.0,79.0,329,01,01,  Duair,706,658,350,311,356,347,51.8,53.0,50.6,00000
29.0,10.0,79.0,329,02,01,  Char Duair,312,382,168,187,144,195,45.0,47.3,42.5,00000
29.0,10.0,79.0,329,03,01,  Khakanda,333,432,160,187,173,245,43.5,46.1,41.4,00000
29.0,10.0,87.0,307,01,01,  Dharmadi,739,880,364,411,375,469,45.6,47.0,44.4,00000
29.0,10.0,87.0,307,02,01,  Harupdia,296,444,141,217,155,227,40.0,39.4,40.6,00000
29.0,10.0,87.0,343,01,01,  Fukurhati,538,720,254,350,284,370,42.8,42.1,43.4,00000
29.0,10.0,87.0,343,02,01,  Kakzikanda,298,187,185,84,113,103,61.4,68.8,52.3,00000
29.0,10.0,87.0,351,01,01,  Fulmallik,94,89,47,44,47,45,51.4,51.6,51.1,00000
29.0,10.0,87.0,351,02,01,  Kanthalbaria,132,133,67,57,65,76,49.8,54.0,46.1,00000
29.0,10.0,87.0,358,01,01,  Dakshinkanda,316,459,157,224,159,235,40.8,41.2,40.4,00000
29.0,10.0,87.0,358,02,01,  Basabari,238,243,125,115,113,128,49.5,52.1,46.9,00000
29.0,10.0,87.0,358,03,01,  Habeli,74,185,36,95,38,90,28.6,27.5,29.7,00000
29.0,10.0,87.0,358,04,01,  Math Baria,74,112,34,53,40,59,39.8,39.1,40.4,00000
29.0,10.0,87.0,358,05,01,  Joshoherkanda,64,182,27,92,37,90,26.0,22.7,29.1,00000
29.0,10.0,87.0,358,06,01,  Fakirkanda,109,146,58,68,51,78,42.7,46.0,39.5,00000
29.0,10.0,87.0,358,07,01,  Mirakanda,243,370,120,169,123,201,39.6,41.5,38.0,00000
29.0,10.0,87.0,358,08,01,  Bara Barikanda,104,121,50,52,54,69,46.2,49.0,43.9,00000
29.0,10.0,87.0,358,09,01,  Hawaly,213,244,95,121,118,123,46.6,44.0,49.0,00000
29.0,10.0,87.0,358,10,01,  Molla Kanda,139,113,73,45,66,68,55.2,61.9,49.3,00000
29.0,10.0,87.0,731,01,01,  Nurullaganj,689,400,377,188,312,212,63.3,66.7,59.5,00000
29.0,10.0,87.0,731,02,01,  Kuraltala,158,135,80,61,78,74,53.9,56.7,51.3,00000
29.0,10.0,94.0,460,01,01,  Karikar Para,424,501,199,253,225,248,45.8,44.0,47.6,00000
29.0,10.0,94.0,460,02,01,  Kayasta Para Namapara,225,306,107,160,118,146,42.4,40.1,44.7,00000
29.0,10.0,94.0,460,03,01,  Grihasta Para,208,256,99,117,109,139,44.8,45.8,44.0,00000
29.0,10.0,94.0,460,04,01,  Bagbari,186,215,93,100,93,115,46.4,48.2,44.7,00000
29.0,10.0,94.0,460,05,01,  Benibazar,85,98,41,44,44,54,46.4,48.2,44.9,00000
29.0,10.0,94.0,460,06,01,  Miah Para,153,228,72,111,81,117,40.2,39.3,40.9,00000
29.0,10.0,94.0,460,07,01,  Dighirpar,147,178,78,88,69,90,45.2,47.0,43.4,00000
29.0,10.0,94.0,969,01,01,  Tuzarpur Purbapara,479,711,267,346,212,365,40.3,43.6,36.7,00000
29.0,10.0,94.0,969,02,01,  Kapali Para,314,173,171,86,143,87,64.5,66.5,62.2,00000
29.0,10.0,94.0,969,03,01,  Tuzarpur Jamadarpara,515,659,283,332,232,327,43.9,46.0,41.5,00000
29.0,10.0,94.0,969,04,01,  Naliapara,334,394,158,195,176,199,45.9,44.8,46.9,00000
29.0,18.0,15.0,831,01,01,  Ramnagar,382,599,196,311,186,288,38.9,38.7,39.2,00000
29.0,18.0,15.0,831,02,01,  Lakshmipur,381,527,190,235,191,292,42.0,44.7,39.5,00000
29.0,18.0,15.0,873,01,01,  Saidpur,333,661,155,336,178,325,33.5,31.6,35.4,00000
29.0,18.0,15.0,873,02,01,  Wahidabad,199,445,101,211,98,234,30.9,32.4,29.5,00000
29.0,18.0,15.0,921,01,01,  Uttar Chalinagar,298,444,156,231,142,213,40.2,40.3,40.0,00000
29.0,18.0,15.0,921,02,01,  Sotasi,407,965,217,495,190,470,29.7,30.5,28.8,00000
29.0,18.0,20.0,107,01,01,  Bangeshwardi,184,181,94,90,90,91,50.4,51.1,49.7,00000
29.0,18.0,20.0,107,02,01,  Bagharkandi,276,344,129,173,147,171,44.5,42.7,46.2,00000
29.0,18.0,20.0,107,03,01,  Taltala,318,310,165,153,153,157,50.6,51.9,49.4,00000
29.0,18.0,20.0,253,01,01,  Char Kandi Chatar,663,702,337,323,326,379,48.6,51.1,46.2,00000
29.0,18.0,20.0,253,02,01,  Gozarkandi,169,237,77,120,92,117,41.6,39.1,44.0,00000
29.0,18.0,20.0,253,03,01,  Chatar Senpara,95,79,52,35,43,44,54.6,59.8,49.4,00000
29.0,18.0,20.0,253,04,01,  Chatar Kharapara,601,592,305,272,296,320,50.4,52.9,48.1,00000
29.0,18.0,20.0,340,01,01,  Dhopadanga,915,943,463,436,452,507,49.2,51.5,47.1,00000
29.0,18.0,20.0,340,02,01,  Aruakhandi,325,470,161,235,164,235,40.9,40.7,41.1,00000
29.0,18.0,20.0,340,03,01,  Mahendrakanda,72,78,38,35,34,43,48.0,52.1,44.2,00000
29.0,18.0,25.0,080,01,01,  Arazi Sukdebnagar,51,15,29,4,22,11,77.3,87.9,66.7,00000
29.0,18.0,25.0,080,02,01,  Arazi Baikhir,55,137,23,75,32,62,28.6,23.5,34.0,00000
29.0,18.0,25.0,080,03,01,  Nandanpur,72,37,36,12,36,25,66.1,75.0,59.0,00000
29.0,18.0,25.0,080,04,01,  Poktanibonchaki,173,122,77,63,96,59,58.6,55.0,61.9,00000
29.0,18.0,25.0,080,05,01,  Chhota Baikhir,149,157,59,88,90,69,48.7,40.1,56.6,00000
29.0,18.0,25.0,080,06,01,  Baikhirarkandi,60,91,32,40,28,51,39.7,44.4,35.4,00000
29.0,18.0,25.0,111,01,01,  Bara Baikhir,992,1255,494,584,498,671,44.1,45.8,42.6,00000
29.0,18.0,25.0,111,02,01,  Baikhir Charpara,24,48,6,25,18,23,33.3,19.4,43.9,00000
29.0,18.0,25.0,111,03,01,  Banchaki,527,624,243,277,284,347,45.8,46.7,45.0,00000
29.0,18.0,25.0,354,01,01,  Poail,480,1544,234,784,246,760,23.7,23.0,24.5,00000
29.0,18.0,25.0,354,02,01,  Dhulpukuria,211,297,92,147,119,150,41.5,38.5,44.2,00000
29.0,18.0,25.0,942,01,01,  Sukdebnagar,503,661,239,316,264,345,43.2,43.1,43.3,00000
29.0,18.0,25.0,942,02,01,  Moshain,41,44,18,23,23,21,48.2,43.9,52.3,00000
29.0,18.0,25.0,942,03,01,  Pamdebnagar,86,213,32,105,54,108,28.8,23.4,33.3,00000
29.0,18.0,25.0,942,04,01,  Char Sukdebnegar,135,267,59,132,76,135,33.6,30.9,36.0,00000
29.0,18.0,35.0,288,01,01,  Ratandia,324,287,150,132,174,155,53.0,53.2,52.9,00000
29.0,18.0,35.0,288,02,01,  Daitarkati,345,285,178,145,167,140,54.8,55.1,54.4,00000
29.0,18.0,35.0,288,03,01,  Parser Char,77,25,38,10,39,15,75.5,79.2,72.2,00000
29.0,18.0,35.0,288,04,01,  Rakhalgachhi,511,527,272,257,239,270,49.2,51.4,47.0,00000
29.0,18.0,35.0,288,05,01,  Char Daitarkathi,758,882,401,434,357,448,46.2,48.0,44.3,00000
29.0,18.0,35.0,337,01,01,  Darmahati,315,113,150,46,165,67,73.6,76.5,71.1,00000
29.0,18.0,35.0,337,02,01,  Alga Para,195,187,95,99,100,88,51.0,49.0,53.2,00000
29.0,18.0,35.0,337,03,01,  Mokimpur,194,216,103,91,91,125,47.3,53.1,42.1,00000
29.0,18.0,35.0,407,01,01,  Phulgachha,78,146,34,75,44,71,34.8,31.2,38.3,00000
29.0,18.0,35.0,407,02,01,  Ghoshpur,501,526,248,272,253,254,48.8,47.7,49.9,00000
29.0,18.0,35.0,407,03,01,  Paikhati,208,353,107,177,101,176,37.1,37.7,36.5,00000
29.0,18.0,35.0,407,04,01,  Salahati,673,724,324,352,349,372,48.2,47.9,48.4,00000
29.0,18.0,35.0,407,05,01,  Char Ghoshpur,272,405,143,198,129,207,40.2,41.9,38.4,00000
29.0,18.0,35.0,407,06,01,  Balia Para,463,268,233,120,230,148,63.3,66.0,60.8,00000
29.0,18.0,35.0,407,07,01,  Bharaliar Char,176,219,102,86,74,133,44.6,54.3,35.7,00000
29.0,18.0,35.0,414,01,01,  Gohailbari,546,345,301,150,245,195,61.3,66.7,55.7,00000
29.0,18.0,35.0,414,02,01,  Lankar Char,655,770,314,392,341,378,46.0,44.5,47.4,00000
29.0,18.0,40.0,212,01,01,  Chandani,522,637,228,319,294,318,45.0,41.7,48.0,00000
29.0,18.0,40.0,212,02,01,  Reninagar,562,805,254,408,308,397,41.1,38.4,43.7,00000
29.0,18.0,40.0,212,03,01,  Satani Para,53,18,27,5,26,13,74.6,84.4,66.7,00000
29.0,18.0,40.0,212,04,01,  Nowani Para,184,163,95,76,89,87,53.0,55.6,50.6,00000
29.0,18.0,40.0,212,05,01,  Sardar Para,7,11,2,6,5,5,38.9,25.0,50.0,00000
29.0,18.0,40.0,212,06,01,  Felannagar,616,499,303,231,313,268,55.2,56.7,53.9,00000
29.0,18.0,40.0,212,07,01,  Awmritanagar,569,524,276,272,293,252,52.1,50.4,53.8,00000
29.0,18.0,40.0,302,01,01,  Dari Hariharnagar,378,481,186,228,192,253,44.0,44.9,43.1,00000
29.0,18.0,40.0,302,02,01,  Chapaldanga,410,471,194,225,216,246,46.5,46.3,46.8,00000
29.0,18.0,40.0,302,03,01,  Jaliadanga,154,140,82,60,72,80,52.4,57.7,47.4,00000
29.0,18.0,40.0,525,01,01,  Bijoynagar,187,117,93,46,94,71,61.5,66.9,57.0,00000
29.0,18.0,40.0,525,02,01,  Guabaria,68,71,34,30,34,41,48.9,53.1,45.3,00000
29.0,18.0,40.0,525,03,01,  Kamargram,407,364,206,177,201,187,52.8,53.8,51.8,00000
29.0,18.0,40.0,528,01,01,  Naderchand,33,34,20,16,13,18,49.3,55.6,41.9,00000
29.0,18.0,40.0,528,02,01,  Kamarhela,148,138,68,68,80,70,51.7,50.0,53.3,00000
29.0,18.0,60.0,146,01,01,  Beljani,1089,998,568,504,521,494,52.2,53.0,51.3,00000
29.0,18.0,60.0,146,02,01,  Kotiborni,166,82,82,38,84,44,66.9,68.3,65.6,00000
29.0,18.0,60.0,535,01,01,  Kandakul,685,922,324,457,361,465,42.6,41.5,43.7,00000
29.0,18.0,60.0,535,02,01,  Ichhakhali,635,648,315,305,320,343,49.5,50.8,48.3,00000
29.0,18.0,60.0,570,01,01,  Khail Para,57,43,26,20,31,23,57.0,56.5,57.4,00000
29.0,18.0,60.0,570,02,01,  Madhabpur,315,233,145,121,170,112,57.5,54.5,60.3,00000
29.0,18.0,60.0,570,03,01,  Gouripur,238,409,127,198,111,211,36.8,39.1,34.5,00000
29.0,18.0,60.0,570,04,01,  Madandhari,44,73,18,31,26,42,37.6,36.7,38.2,00000
29.0,18.0,60.0,570,05,01,  Amgachiadangi Uttarpara,110,153,49,68,61,85,41.8,41.9,41.8,00000
29.0,18.0,60.0,580,01,01,  Khorsuti,472,633,232,299,240,334,42.7,43.7,41.8,00000
29.0,18.0,60.0,580,02,01,  Ranidulla,224,123,109,60,115,63,64.6,64.5,64.6,00000
29.0,18.0,60.0,580,03,01,  Amgachiadhangi Dakshinpara,101,122,43,58,58,64,45.3,42.6,47.5,00000
29.0,18.0,60.0,664,01,01,  Moyna,858,872,403,380,455,492,49.6,51.5,48.0,00000
29.0,18.0,60.0,664,02,01,  Kewagram,341,522,161,245,180,277,39.5,39.7,39.4,00000
29.0,18.0,60.0,664,03,01,  Horitadacha,28,55,14,26,14,29,33.7,35.0,32.6,00000
29.0,18.0,60.0,664,04,01,  Baniary,455,455,216,215,239,240,50.0,50.1,49.9,00000
29.0,18.0,60.0,664,05,01,  Hatkholar Char,513,942,271,458,242,484,35.3,37.2,33.3,00000
29.0,18.0,60.0,664,06,01,  Panch Moyna,396,378,209,184,187,194,51.2,53.2,49.1,00000
29.0,18.0,60.0,664,07,01,  Mirerchar,162,182,86,100,76,82,47.1,46.2,48.1,00000
29.0,18.0,60.0,664,08,01,  Hatubanga,118,175,56,87,62,88,40.3,39.2,41.3,00000
29.0,18.0,60.0,664,09,01,  Bandugram,499,804,243,398,256,406,38.3,37.9,38.7,00000
29.0,18.0,60.0,688,01,01,  Mitain,182,201,82,94,100,107,47.5,46.6,48.3,00000
29.0,18.0,60.0,688,02,01,  Amgram,30,35,15,18,15,17,46.2,45.5,46.9,00000
29.0,18.0,90.0,149,01,01,  Uttar Beradi,692,656,346,311,346,345,51.3,52.7,50.1,00000
29.0,18.0,90.0,149,02,01,  Dakshin Beradi,384,479,217,215,167,264,44.5,50.2,38.7,00000
29.0,18.0,90.0,149,03,01,  Serapur,329,255,161,127,168,128,56.3,55.9,56.8,00000
29.0,18.0,90.0,368,01,01,  Dobra,521,512,281,254,240,258,50.4,52.5,48.2,00000
29.0,18.0,90.0,368,02,01,  Kendra Dobra,93,148,50,74,43,74,38.6,40.3,36.8,00000
29.0,18.0,90.0,417,01,01,  Joynagar,334,335,187,149,147,186,49.9,55.7,44.1,00000
29.0,18.0,90.0,417,02,01,  Char Bhagdia,78,146,40,73,38,73,34.8,35.4,34.2,00000
29.0,18.0,90.0,494,01,01,  Paschim Kadirdi,839,1031,419,489,420,542,44.9,46.1,43.7,00000
29.0,18.0,90.0,494,02,01,  Purba Kadirdi,814,854,417,418,397,436,48.8,49.9,47.7,00000
29.0,18.0,90.0,494,03,01,  Islampur,174,122,91,53,83,69,58.8,63.2,54.6,00000
29.0,18.0,90.0,494,04,01,  Guchchhagram,147,143,85,71,62,72,50.7,54.5,46.3,00000
29.0,18.0,90.0,828,01,01,  Ramdia,818,772,416,376,402,396,51.4,52.5,50.4,00000
29.0,18.0,90.0,828,02,01,  Dharanidhordi,104,112,63,55,41,57,48.1,53.4,41.8,00000
29.0,18.0,90.0,890,01,01,  Satair,581,922,289,468,292,454,38.7,38.2,39.1,00000
29.0,18.0,90.0,890,02,01,  Kamarhati,479,477,252,241,227,236,50.1,51.1,49.0,00000
29.0,18.0,95.0,139,01,01,  Bayra,205,183,120,83,85,100,52.8,59.1,45.9,00000
29.0,18.0,95.0,139,02,01,  Bamangati,448,331,227,143,221,188,57.5,61.4,54.0,00000
29.0,18.0,95.0,375,01,01,  Durgapur,966,1213,459,590,507,623,44.3,43.8,44.9,00000
29.0,18.0,95.0,375,02,01,  Daibaki Nandanpur,310,228,149,112,161,116,57.6,57.1,58.1,00000
29.0,18.0,95.0,375,03,01,  Bajitpur,208,405,100,199,108,206,33.9,33.4,34.4,00000
29.0,18.0,95.0,869,01,01,  Sahasrail,962,771,482,398,480,373,55.5,54.8,56.3,00000
29.0,18.0,95.0,869,02,01,  Dari Sahasrail,348,242,165,115,183,127,59.0,58.9,59.0,00000
29.0,18.0,95.0,869,03,01,  Bhul Baria,561,314,282,148,279,166,64.1,65.6,62.7,00000
29.0,18.0,95.0,894,01,01,  Shekhar,946,686,496,312,450,374,58.0,61.4,54.6,00000
29.0,18.0,95.0,894,02,01,  Char Shekhar,316,508,157,237,159,271,38.3,39.8,37.0,00000
29.0,18.0,95.0,894,03,01,  Chapkhanda,140,65,80,34,60,31,68.3,70.2,65.9,00000
29.0,18.0,95.0,960,01,01,  Teljuri,804,904,381,447,423,457,47.1,46.0,48.1,00000
29.0,18.0,95.0,960,02,01,  Amirabad,225,304,110,133,115,171,42.5,45.3,40.2,00000
29.0,18.0,95.0,960,03,01,  Bajidadpur,241,125,131,62,110,63,65.8,67.9,63.6,00000
29.0,18.0,95.0,960,04,01,  Howarbhanga,134,49,69,22,65,27,73.2,75.8,70.7,00000
29.0,21.0,19.0,141,01,03,  Lohartek,355,703,140,302,215,401,33.6,31.7,34.9,00000
29.0,21.0,19.0,141,02,03,  Abdul Mazid Khardangi,412,536,190,246,222,290,43.5,43.6,43.4,00000
29.0,21.0,19.0,141,03,03,  Karikardang,61,170,21,84,40,86,26.4,20.0,31.7,00000
29.0,21.0,19.0,141,04,03,  Abdul Karim Mridhadangi,124,190,55,86,69,104,39.5,39.0,39.9,00000
29.0,21.0,19.0,141,05,03,  Nasaruddin Munshirdangi,119,331,68,159,51,172,26.4,30.0,22.9,00000
29.0,21.0,19.0,141,06,03,  Dabiruddin Pramanikerdangi,504,606,214,276,290,330,45.4,43.7,46.8,00000
29.0,21.0,19.0,141,07,03,  Darajuddin Mollardangi,189,224,87,106,102,118,45.8,45.1,46.4,00000
29.0,21.0,19.0,141,08,03,  Tilar Char,465,830,188,400,277,430,35.9,32.0,39.2,00000
29.0,21.0,19.0,141,09,03,  Khan Mamuderdangi,441,1042,213,473,228,569,29.7,31.0,28.6,00000
29.0,21.0,19.0,141,10,03,  Mofizuddin Khalasirdangi,603,645,283,308,320,337,48.3,47.9,48.7,00000
29.0,21.0,19.0,141,11,03,  Meser Panchateterdangi,460,406,218,174,242,232,53.1,55.6,51.1,00000
29.0,21.0,19.0,141,12,03,  Yusuf Sikdardangi,11,27,3,14,8,13,28.9,17.6,38.1,00000
29.0,21.0,19.0,141,13,03,  Fajilkhardangi,207,513,85,245,122,268,28.8,25.8,31.3,00000
29.0,21.0,19.0,141,14,03,  Baliadang Muslim,870,1295,395,600,475,695,40.2,39.7,40.6,00000
29.0,21.0,19.0,141,15,03,  Hajidang,235,371,96,187,139,184,38.8,33.9,43.0,00000
29.0,21.0,19.0,141,16,03,  Abdul Gafur Mridhadangi,290,290,119,136,171,154,50.0,46.7,52.6,00000
29.0,21.0,19.0,141,17,03,  Khalashidangi,347,388,152,189,195,199,47.2,44.6,49.5,00000
29.0,21.0,19.0,141,18,03,  Kamardangi,132,180,63,75,69,105,42.3,45.7,39.7,00000
29.0,21.0,19.0,141,19,03,  Mathabhanga,76,195,42,89,34,106,28.0,32.1,24.3,00000
29.0,21.0,19.0,141,20,03,  Baikantha Sarker Dangi,2008,1283,987,568,1021,715,61.0,63.5,58.8,00000
29.0,21.0,19.0,141,21,03,  Noaya Dangi,133,254,52,116,81,138,34.4,31.0,37.0,00000
29.0,21.0,19.0,141,22,03,  Badulya Matbardangi,255,359,112,169,143,190,41.5,39.9,42.9,00000
29.0,21.0,19.0,958,01,01,  Madhu Sikdardangi,680,1203,283,558,397,645,36.1,33.7,38.1,00000
29.0,21.0,19.0,958,02,01,  Abdul Sikdardangi,417,450,238,191,179,259,48.1,55.5,40.9,00000
29.0,21.0,19.0,958,03,01,  Bachhardangi,116,139,48,61,68,78,45.5,44.0,46.6,00000
29.0,21.0,38.0,212,01,01,  Emankhar Dangi,90,130,50,64,40,66,40.9,43.9,37.7,00000
29.0,21.0,38.0,212,02,01,  Ekram Matubbar Dangi,257,477,159,231,98,246,35.0,40.8,28.5,00000
29.0,21.0,38.0,212,03,01,  Char Harirampur(Hajabbiga),195,419,100,223,95,196,31.8,31.0,32.6,00000
29.0,21.0,38.0,212,04,01,  Samir Bapur Dani,319,317,171,159,148,158,50.2,51.8,48.4,00000
29.0,21.0,38.0,390,01,01,  Char Salepur Porchem,464,1379,223,684,241,695,25.2,24.6,25.7,00000
29.0,21.0,38.0,390,02,01,  Char Salepur Purbo,728,1563,322,791,406,772,31.8,28.9,34.5,00000
29.0,21.0,38.0,674,01,01,  Aminkhrdangi,146,284,77,141,69,143,34.0,35.3,32.5,00000
29.0,21.0,38.0,674,02,01,  Sabulla Sikdardangi,67,149,29,70,38,79,31.0,29.3,32.5,00000
29.0,21.0,38.0,674,03,01,  Arojkhardangi,167,279,73,127,94,152,37.4,36.5,38.2,00000
29.0,21.0,38.0,674,04,01,  Bishoi Matbarerdangi,63,123,29,61,34,62,33.9,32.2,35.4,00000
29.0,21.0,38.0,674,05,01,  Entajmollardangi,393,370,183,167,210,203,51.5,52.3,50.8,00000
29.0,21.0,38.0,922,01,01,  Salepur Pachem,148,524,70,264,78,260,22.0,21.0,23.1,00000
29.0,21.0,38.0,922,02,01,  Salepur Modho,154,749,64,392,90,357,17.1,14.0,20.1,00000
29.0,21.0,38.0,922,03,01,  Salepur Purob,145,704,53,368,92,336,17.1,12.6,21.5,00000
29.0,21.0,57.0,883,01,01,  Rayechakderdangi,76,217,42,104,34,113,25.9,28.8,23.1,00000
29.0,21.0,57.0,883,02,01,  Sajular Mollardangi,83,151,41,78,42,73,35.5,34.5,36.5,00000
29.0,21.0,57.0,883,03,01,  Shar Mollardangi,62,161,33,71,29,90,27.8,31.7,24.4,00000
29.0,21.0,57.0,883,04,01,  Chowdory Dangi,111,235,61,107,50,128,32.1,36.3,28.1,00000
29.0,21.0,76.0,035,01,01,  Maijuddin Molladangi,102,129,51,66,51,63,44.2,43.6,44.7,00000
29.0,21.0,76.0,035,02,01,  Hajidang,132,134,64,59,68,75,49.6,52.0,47.6,00000
29.0,21.0,76.0,035,03,01,  Nabin Biswaserdangi,74,194,44,98,30,96,27.6,31.0,23.8,00000
29.0,21.0,76.0,035,04,01,  Kohel Matubarerdangi,51,57,22,25,29,32,47.2,46.8,47.5,00000
29.0,21.0,76.0,035,05,01,  Darik Sarkarerdangi,350,471,171,217,179,254,42.6,44.1,41.3,00000
29.0,21.0,76.0,035,06,01,  Banchhar Biswaserdangi,327,449,155,204,172,245,42.1,43.2,41.2,00000
29.0,21.0,76.0,035,07,01,  Telidangi,337,383,153,194,184,189,46.8,44.1,49.3,00000
29.0,21.0,76.0,035,08,01,  Dhalarpar,456,575,213,275,243,300,44.2,43.6,44.8,00000
29.0,21.0,76.0,035,09,01,  Sikdardangi,136,190,71,83,65,107,41.7,46.1,37.8,00000
29.0,21.0,76.0,035,10,01,  Sildangi,208,173,97,81,111,92,54.6,54.5,54.7,00000
29.0,21.0,76.0,035,11,01,  Chidadangi,222,368,87,183,135,185,37.6,32.2,42.2,00000
29.0,21.0,76.0,425,01,01,  Laptachar,220,247,95,105,125,142,47.1,47.5,46.8,00000
29.0,21.0,76.0,425,02,01,  Char Sarbanda,598,622,281,277,317,345,49.0,50.4,47.9,00000
29.0,21.0,76.0,461,01,01,  Dakshin Char Sultanpur,379,407,165,199,214,208,48.2,45.3,50.7,00000
29.0,21.0,76.0,461,02,01,  Kanair Tek,176,233,92,108,84,125,43.0,46.0,40.2,00000
29.0,21.0,76.0,461,03,01,  Sabdar Matbarerdangi,233,244,114,109,119,135,48.8,51.1,46.9,00000
29.0,21.0,76.0,461,04,01,  Dopadangi,393,462,194,228,199,234,46.0,46.0,46.0,00000
29.0,21.0,76.0,461,05,01,  Uttar Sultanpur,210,113,111,44,99,69,65.0,71.6,58.9,00000
29.0,21.0,76.0,461,06,01,  Khalpardangi,155,245,76,122,79,123,38.8,38.4,39.1,00000
29.0,21.0,76.0,461,07,01,  Fakirdangi,151,163,74,71,77,92,48.1,51.0,45.6,00000
29.0,21.0,76.0,603,01,01,  Gazir Tek,443,552,200,243,243,309,44.5,45.1,44.0,00000
29.0,21.0,76.0,603,02,01,  Chhota Gazir Tek,120,211,48,101,72,110,36.3,32.2,39.6,00000
29.0,21.0,76.0,638,01,01,  Okal Madbar Dangi,142,152,63,68,79,84,48.3,48.1,48.5,00000
29.0,21.0,76.0,638,02,01,  Rahman Pramanikdangi,235,218,97,113,138,105,51.9,46.2,56.8,00000
29.0,21.0,76.0,638,03,01,  Hajiganj Bazar,117,99,57,44,60,55,54.2,56.4,52.2,00000
29.0,21.0,76.0,638,04,01,  Beparidangi,402,598,177,290,225,308,40.2,37.9,42.2,00000
29.0,21.0,76.0,638,05,01,  Khalpardangi,39,42,17,24,22,18,48.1,41.5,55.0,00000
29.0,21.0,76.0,638,06,01,  Bindudangi,51,161,26,81,25,80,24.1,24.3,23.8,00000
29.0,21.0,76.0,709,01,01,  Joydeb Sarkarerdangi,497,587,240,264,257,323,45.8,47.6,44.3,00000
29.0,21.0,76.0,709,02,01,  Madhu Fakirerdangi,300,238,150,98,150,140,55.8,60.5,51.7,00000
29.0,47.0,13.0,019,01,01,  Aliabad Purbo,1762,2210,877,1026,885,1184,44.4,46.1,42.8,00000
29.0,47.0,13.0,019,02,01,  Alabad Pashim,1092,1330,543,605,549,725,45.1,47.3,43.1,00000
29.0,47.0,15.0,247,01,01,  Char Krishnapur,244,211,118,111,126,100,53.6,51.5,55.8,00000
29.0,47.0,15.0,247,02,01,  Bhashanchar,684,774,340,387,344,387,46.9,46.8,47.1,00000
29.0,47.0,15.0,646,01,01,  Komarpur,2045,1171,1069,501,976,670,63.6,68.1,59.3,00000
29.0,47.0,15.0,646,02,01,  Baidakhali,431,300,225,143,206,157,59.0,61.1,56.7,00000
29.0,47.0,15.0,830,01,01,  Raghunandanpur,2046,1678,1143,826,903,852,54.9,58.0,51.5,00000
29.0,47.0,15.0,830,02,01,  Brammam Khada Part,482,202,263,97,219,105,70.5,73.1,67.6,00000
29.0,47.0,23.0,057,01,01,  Ibrahim Molla,35,39,17,18,18,21,47.3,48.6,46.2,00000
29.0,47.0,23.0,057,02,01,  Chanda Mandaldangi,45,73,25,39,20,34,38.1,39.1,37.0,00000
29.0,47.0,23.0,057,03,01,  Haji Korban Mollardang,66,91,30,42,36,49,42.0,41.7,42.4,00000
29.0,47.0,23.0,057,04,01,  Karim Matbar,123,237,59,125,64,112,34.2,32.1,36.4,00000
29.0,47.0,23.0,057,05,01,  Jalil Mollah,110,170,49,84,61,86,39.3,36.8,41.5,00000
29.0,47.0,23.0,057,06,01,  Saidali Matbar,181,159,94,68,87,91,53.2,58.0,48.9,00000
29.0,47.0,23.0,057,07,01,  Ajiuddin Mirdha,182,169,85,78,97,91,51.9,52.1,51.6,00000
29.0,47.0,23.0,057,08,01,  Kajem Mollah,36,48,21,23,15,25,42.9,47.7,37.5,00000
29.0,47.0,23.0,057,09,01,  Oajuddin Fakirdangi,176,337,85,165,91,172,34.3,34.0,34.6,00000
29.0,47.0,23.0,057,10,01,  Yeasin Sekh,217,197,103,93,114,104,52.4,52.6,52.3,00000
29.0,47.0,23.0,057,11,01,  Osman Mir,94,135,44,68,50,67,41.0,39.3,42.7,00000
29.0,47.0,23.0,057,12,01,  Gandumatu,65,104,34,58,31,46,38.5,37.0,40.3,00000
29.0,47.0,23.0,057,13,01,  Aku Fakirdang,114,97,62,41,52,56,54.0,60.2,48.1,00000
29.0,47.0,23.0,057,14,01,  Mohammad Paldang,35,36,22,18,13,18,49.3,55.0,41.9,00000
29.0,47.0,23.0,057,15,01,  Makdhum Fakir,44,67,21,36,23,31,39.6,36.8,42.6,00000
29.0,47.0,23.0,057,16,01,  Anser Sikdardang,68,122,28,67,40,55,35.8,29.5,42.1,00000
29.0,47.0,23.0,057,17,01,  Ali Mondal,130,148,58,79,72,69,46.8,42.3,51.1,00000
29.0,47.0,23.0,057,18,01,  Mamnan,133,154,63,61,70,93,46.3,50.8,42.9,00000
29.0,47.0,23.0,057,19,01,  Yashin Mridha,141,258,59,142,82,116,35.3,29.4,41.4,00000
29.0,47.0,23.0,057,20,01,  Fazil Sarder,128,133,63,74,65,59,49.0,46.0,52.4,00000
29.0,47.0,23.0,057,21,01,  Haji Saizuddindang,150,203,73,121,77,82,42.5,37.6,48.4,00000
29.0,47.0,23.0,057,22,01,  Golapbag,109,87,55,33,54,54,55.6,62.5,50.0,00000
29.0,47.0,23.0,057,23,01,  Taijuddin Mondal,78,384,43,200,35,184,16.9,17.7,16.0,00000
29.0,47.0,23.0,057,24,01,  Haji Asruddin Mondal,219,178,98,92,121,86,55.2,51.6,58.5,00000
29.0,47.0,23.0,057,25,01,  Dirajuddin Mollah,55,63,32,25,23,38,46.6,56.1,37.7,00000
29.0,47.0,23.0,057,26,01,  Munsur Bepari,57,206,24,106,33,100,21.7,18.5,24.8,00000
29.0,47.0,23.0,057,27,01,  Ariruddin Munshidangi,208,317,96,180,112,137,39.6,34.8,45.0,00000
29.0,47.0,23.0,057,28,01,  Lalar Dangi,55,68,30,35,25,33,44.7,46.2,43.1,00000
29.0,47.0,23.0,057,29,01,  Dalu Mir,158,236,83,125,75,111,40.1,39.9,40.3,00000
29.0,47.0,23.0,057,30,01,  Amiruddin Pramanlle,203,166,107,99,96,67,55.0,51.9,58.9,00000
29.0,47.0,23.0,057,31,01,  Bhajan Khar Dangi,57,20,31,9,26,11,74.0,77.5,70.3,00000
29.0,47.0,23.0,057,32,01,  Sayjuddiner Dangi,104,94,51,49,53,45,52.5,51.0,54.1,00000
29.0,47.0,23.0,304,01,01,  Hamad Matuldang,192,186,98,85,94,101,50.8,53.6,48.2,00000
29.0,47.0,23.0,304,02,01,  Waziuddin Munshidang,237,233,129,113,108,120,50.4,53.3,47.4,00000
29.0,47.0,23.0,304,03,01,  Sajani Ray,259,228,139,115,120,113,53.2,54.7,51.5,00000
29.0,47.0,23.0,304,04,01,  Biswasdangi,157,94,64,47,93,47,62.5,57.7,66.4,00000
29.0,47.0,23.0,304,05,01,  Jainuddin Matbar,205,146,90,69,115,77,58.4,56.6,59.9,00000
29.0,47.0,23.0,304,06,01,  Mahiuddin Mridha Nohabil Mat,176,266,84,136,92,130,39.8,38.2,41.4,00000
29.0,47.0,23.0,304,07,01,  Hafazdang,372,182,196,77,176,105,67.1,71.8,62.6,00000
29.0,47.0,23.0,304,08,01,  Sabarkar,61,43,29,26,32,17,58.7,52.7,65.3,00000
29.0,47.0,23.0,304,09,01,  Alam Matbar,124,134,52,67,72,67,48.1,43.7,51.8,00000
29.0,47.0,23.0,304,10,01,  Naimuddinmat,94,53,49,23,45,30,63.9,68.1,60.0,00000
29.0,47.0,23.0,304,11,01,  Abel Munshi,413,321,210,163,203,158,56.3,56.3,56.2,00000
29.0,47.0,23.0,304,12,01,  Jamadar,261,213,163,107,98,106,55.1,60.4,48.0,00000
29.0,47.0,23.0,304,13,01,  Gopalkar,141,192,69,98,72,94,42.3,41.3,43.4,00000
29.0,47.0,23.0,304,14,01,  Chowdhurydangi,403,645,192,322,211,323,38.5,37.4,39.5,00000
29.0,47.0,23.0,304,15,01,  Somesh Matbar,64,189,24,98,40,91,25.3,19.7,30.5,00000
29.0,47.0,23.0,304,16,01,  Arsad Munshidangi And Khoaj Ma,311,408,126,221,185,187,43.3,36.3,49.7,00000
29.0,47.0,23.0,304,17,01,  Khalil Mondal Hat,1,11,1,11,0,0,8.3,8.3,0.0,00000
29.0,47.0,23.0,633,01,01,  Daraj Tullardang,310,498,146,253,164,245,38.4,36.6,40.1,00000
29.0,47.0,23.0,633,02,01,  Ekram Matbar,266,207,134,102,132,105,56.2,56.8,55.7,00000
29.0,47.0,23.0,633,03,01,  Durjankara,174,173,97,87,77,86,50.1,52.7,47.2,00000
29.0,47.0,23.0,633,04,01,  Gopal Molladangi,257,183,123,94,134,89,58.4,56.7,60.1,00000
29.0,47.0,23.0,633,05,01,  Ahammad Munshidangi,126,232,68,122,58,110,35.2,35.8,34.5,00000
29.0,47.0,23.0,988,01,01,  Kashimuddin Beparidang,408,461,204,216,204,245,47.0,48.6,45.4,00000
29.0,47.0,23.0,988,02,01,  Lokmankar,292,240,145,105,147,135,54.9,58.0,52.1,00000
29.0,47.0,23.0,988,03,01,  Raji Bepari,111,184,49,99,62,85,37.6,33.1,42.2,00000
29.0,47.0,23.0,988,04,01,  Ashiruddin Sarkar,54,69,27,37,27,32,43.9,42.2,45.8,00000
29.0,47.0,23.0,988,05,01,  Ismaildangi,217,298,111,161,106,137,42.1,40.8,43.6,00000
29.0,47.0,23.0,988,06,01,  Anwar Pasardangi,108,210,47,101,61,109,34.0,31.8,35.9,00000
29.0,47.0,23.0,988,07,01,  Delan Malik,114,252,50,129,64,123,31.1,27.9,34.2,00000
29.0,47.0,23.0,988,08,01,  Nizam Fakir,109,200,61,94,48,106,35.3,39.4,31.2,00000
29.0,47.0,23.0,988,09,01,  Malu Mondal,75,122,36,58,39,64,38.1,38.3,37.9,00000
29.0,47.0,23.0,988,10,01,  Ahammad Mollar,55,85,27,41,28,44,39.3,39.7,38.9,00000
29.0,47.0,23.0,988,11,01,  Tajuddin Patwaridangi,140,276,75,142,65,134,33.7,34.6,32.7,00000
29.0,47.0,23.0,988,12,01,  Answar Kazirdanga,66,87,32,38,34,49,43.1,45.7,41.0,00000
29.0,47.0,23.0,988,13,01,  Haji Samser Sardar,135,174,67,91,68,83,43.7,42.4,45.0,00000
29.0,47.0,23.0,988,14,01,  Momin  Matbarerdangi,251,362,117,179,134,183,40.9,39.5,42.3,00000
29.0,47.0,23.0,988,15,01,  Mominkhar Hat,72,18,42,8,30,10,80.0,84.0,75.0,00000
29.0,47.0,23.0,988,16,01,  Mofizuddin Matbar,100,289,44,156,56,133,25.7,22.0,29.6,00000
29.0,47.0,23.0,988,17,01,  Natundangi,170,326,89,173,81,153,34.3,34.0,34.6,00000
29.0,47.0,31.0,253,01,01,  Taher Fakirdangi,631,723,345,355,286,368,46.6,49.3,43.7,00000
29.0,47.0,31.0,253,02,01,  Bepari Dangi,253,238,139,114,114,124,51.5,54.9,47.9,00000
29.0,47.0,31.0,253,03,01,  Kazam Mataer Dangi,503,574,294,265,209,309,46.7,52.6,40.3,00000
29.0,47.0,31.0,266,01,01,  Adu Matbardangi,298,371,159,196,139,175,44.5,44.8,44.3,00000
29.0,47.0,31.0,266,02,01,  Munshidangi,485,407,258,189,227,218,54.4,57.7,51.0,00000
29.0,47.0,31.0,266,03,01,  Golapdidangi,580,393,315,172,265,221,59.6,64.7,54.5,00000
29.0,47.0,31.0,266,04,01,  Khidir Biswasdangi,742,936,367,454,375,482,44.2,44.7,43.8,00000
29.0,47.0,31.0,266,05,01,  Feridabad,322,293,167,142,155,151,52.4,54.0,50.7,00000
29.0,47.0,31.0,272,01,01,  Wzirmahmwd Dangi,183,137,113,57,70,80,57.2,66.5,46.7,00000
29.0,47.0,31.0,272,02,01,  Rahim Matabar Dangi,107,256,60,126,47,130,29.5,32.3,26.6,00000
29.0,47.0,31.0,272,03,01,  Vangidangi,160,168,83,89,77,79,48.8,48.3,49.4,00000
29.0,47.0,31.0,329,01,01,  Alatab Tashardar &Razab Ali M.,14,24,9,11,5,13,36.8,45.0,27.8,00000
29.0,47.0,31.0,329,02,01,  Baliaghat,157,292,83,149,74,143,35.0,35.8,34.1,00000
29.0,47.0,31.0,329,03,01,  Rikon Hazi Dangi,102,110,55,53,47,57,48.1,50.9,45.2,00000
29.0,47.0,31.0,329,04,01,  Shah Bisnas Dangi,129,317,61,161,68,156,28.9,27.5,30.4,00000
29.0,47.0,31.0,329,05,01,  Saber Matbar Dangi,40,104,27,56,13,48,27.8,32.5,21.3,00000
29.0,47.0,31.0,329,06,01,  Imman Pal & Khobir Munsi Dangi,69,329,43,170,26,159,17.3,20.2,14.1,00000
29.0,47.0,31.0,329,07,01,  Sona Mondol Dangi,43,163,23,77,20,86,20.9,23.0,18.9,00000
29.0,47.0,31.0,329,08,01,  Tamizuddin Mondal,128,85,72,37,56,48,60.1,66.1,53.8,00000
29.0,47.0,31.0,329,09,01,  Pal Dangi,842,771,464,362,378,409,52.2,56.2,48.0,00000
29.0,47.0,31.0,329,10,01,  Majidmunsi Dangi,119,148,62,71,57,77,44.6,46.6,42.5,00000
29.0,47.0,31.0,329,11,01,  Buna Dangi,140,326,68,167,72,159,30.0,28.9,31.2,00000
29.0,47.0,31.0,969,01,01,  Aizuddin Matbardangi,1980,2453,998,1143,982,1310,44.7,46.6,42.8,00000
29.0,47.0,31.0,969,02,01,  Taizuddin Munshi,201,219,107,98,94,121,47.9,52.2,43.7,00000
29.0,47.0,31.0,969,03,01,  Nazir Biswasdangi,61,113,40,55,21,58,35.1,42.1,26.6,00000
29.0,47.0,39.0,050,01,01,  Purba Bakhunda,2234,1723,1156,822,1078,901,56.5,58.4,54.5,00000
29.0,47.0,39.0,050,02,01,  Raghua Para,438,773,213,379,225,394,36.2,36.0,36.3,00000
29.0,47.0,39.0,532,01,01,  Jayar,610,396,332,176,278,220,60.6,65.4,55.8,00000
29.0,47.0,39.0,532,02,01,  Char Jayar,222,333,128,171,94,162,40.0,42.8,36.7,00000
29.0,47.0,39.0,754,01,01,  Nikhurdi,455,505,213,229,242,276,47.4,48.2,46.7,00000
29.0,47.0,39.0,754,02,01,  Char Nikhurdi,478,553,260,248,218,305,46.4,51.2,41.7,00000
29.0,47.0,55.0,475,01,01,  Harukandi,938,693,495,355,443,338,57.5,58.2,56.7,00000
29.0,47.0,55.0,475,02,01,  Hasra,271,189,149,74,122,115,58.9,66.8,51.5,00000
29.0,47.0,55.0,494,01,01,  Ichhail,467,610,234,330,233,280,43.4,41.5,45.4,00000
29.0,47.0,55.0,494,02,01,  Ghoradha,391,842,178,421,213,421,31.7,29.7,33.6,00000
29.0,47.0,55.0,494,04,01,  Laskarkandi,206,152,105,69,101,83,57.5,60.3,54.9,00000
29.0,47.0,55.0,494,05,01,  Kaowlipara,180,130,99,51,81,79,58.1,66.0,50.6,00000
29.0,47.0,55.0,494,06,01,  Aakpara,86,59,48,22,38,37,59.3,68.6,50.7,00000
29.0,47.0,55.0,494,07,01,  Dashazar,257,499,132,258,125,241,34.0,33.8,34.2,00000
29.0,47.0,55.0,494,08,01,  Sreedharpur,137,114,80,47,57,67,54.6,63.0,46.0,00000
29.0,47.0,55.0,494,09,01,  Pratappur,157,238,72,128,85,110,39.7,36.0,43.6,00000
29.0,47.0,55.0,494,10,01,  Billnalia,395,405,189,199,206,206,49.4,48.7,50.0,00000
29.0,47.0,55.0,494,11,01,  Char Mangalkot,14,10,6,4,8,6,58.3,60.0,57.1,00000
29.0,47.0,55.0,583,01,01,  Pairpur,445,452,231,209,214,243,49.6,52.5,46.8,00000
29.0,47.0,55.0,583,02,01,  Goalkandi,414,758,228,379,186,379,35.3,37.6,32.9,00000
29.0,47.0,55.0,583,03,01,  Alalpur,110,378,50,197,60,181,22.5,20.2,24.9,00000
29.0,47.0,55.0,583,04,01,  Kaijuri,480,216,229,99,251,117,69.0,69.8,68.2,00000
29.0,47.0,55.0,716,01,01,  Mangalkot,326,283,171,131,155,152,53.5,56.6,50.5,00000
29.0,47.0,55.0,716,02,01,  Charmangalkot,827,909,400,424,427,485,47.6,48.5,46.8,00000
29.0,47.0,55.0,728,01,01,  Muraridaha,1006,1279,484,618,522,661,44.0,43.9,44.1,00000
29.0,47.0,55.0,728,02,01,  Domkoron,179,179,101,79,78,100,50.0,56.1,43.8,00000
29.0,47.0,55.0,899,01,01,  Saicha,303,138,160,59,143,79,68.7,73.1,64.4,00000
29.0,47.0,55.0,899,02,01,  Bhaturdi,276,217,142,105,134,112,56.0,57.5,54.5,00000
29.0,47.0,55.0,950,01,01,  Tambulkhana,929,1157,482,552,447,605,44.5,46.6,42.5,00000
29.0,47.0,55.0,950,02,01,  Bangram,345,455,180,205,165,250,43.1,46.8,39.8,00000
29.0,47.0,63.0,190,01,01,  Chaibaria,468,276,235,119,233,157,62.9,66.4,59.7,00000
29.0,47.0,63.0,190,02,01,  Haludbaria,259,200,142,92,117,108,56.4,60.7,52.0,00000
29.0,47.0,63.0,608,01,01,  Kanaipur,1441,699,841,374,600,325,67.3,69.2,64.9,00000
29.0,47.0,63.0,608,02,01,  Malanga,1494,989,739,463,755,526,60.2,61.5,58.9,00000
29.0,47.0,63.0,722,01,01,  Mrigi,1294,1521,684,727,610,794,46.0,48.5,43.4,00000
29.0,47.0,63.0,722,02,01,  Dig Nagar,167,159,85,75,82,84,51.2,53.1,49.4,00000
29.0,47.0,63.0,722,03,01,  Srefaltali,215,300,100,151,115,149,41.7,39.8,43.6,00000
29.0,47.0,63.0,823,01,01,  Purdia Kasimabad,785,864,384,427,401,437,47.6,47.3,47.9,00000
29.0,47.0,63.0,823,02,01,  Arua Para,455,488,221,232,234,256,48.3,48.8,47.8,00000
29.0,47.0,63.0,849,01,01,  Raikali,404,825,205,404,199,421,32.9,33.7,32.1,00000
29.0,47.0,63.0,849,02,01,  Khas Kandi,583,800,292,397,291,403,42.2,42.4,41.9,00000
29.0,47.0,63.0,849,03,01,  Ulu Kandi,525,357,229,165,296,192,59.5,58.1,60.7,00000
29.0,47.0,71.0,741,01,01,  Narayanpur,307,105,169,48,138,57,74.5,77.9,70.8,00000
29.0,47.0,71.0,741,02,01,  Bazar Kaudi,77,36,40,14,37,22,68.1,74.1,62.7,00000
29.0,47.0,79.0,697,01,01,  Majchar Kourpur,1485,2009,744,1001,741,1008,42.5,42.6,42.4,00000
29.0,47.0,79.0,697,02,01,  Bahirdia,692,408,360,184,332,224,62.9,66.2,59.7,00000
29.0,47.0,79.0,697,03,01,  Dopakadi,206,59,113,20,93,39,77.7,85.0,70.5,00000
29.0,47.0,87.0,285,01,01,  Salim Biswas,26,60,14,26,12,34,30.2,35.0,26.1,00000
29.0,47.0,87.0,285,02,01,  Jalil Bepari,6,11,3,5,3,6,35.3,37.5,33.3,00000
29.0,47.0,87.0,285,03,01,  Yousuf Matbar,303,435,144,233,159,202,41.1,38.2,44.0,00000
29.0,47.0,87.0,285,04,01,  Mainuddin Matbar,264,321,125,149,139,172,45.1,45.6,44.7,00000
29.0,47.0,87.0,285,05,01,  Sultankhar,120,425,62,221,58,204,22.0,21.9,22.1,00000
29.0,47.0,87.0,285,06,01,  Mozaffar Matbar,73,266,36,130,37,136,21.5,21.7,21.4,00000
29.0,47.0,87.0,285,07,01,  Baran Biswaser,268,380,132,201,136,179,41.4,39.6,43.2,00000
29.0,47.0,87.0,285,08,01,  Aizuddin Matbar,86,127,48,65,38,62,40.4,42.5,38.0,00000
29.0,47.0,87.0,285,09,01,  Baser Mollardangi,143,214,84,103,59,111,40.1,44.9,34.7,00000
29.0,47.0,87.0,285,10,01,  Sukur Ali Mirdha,98,288,52,140,46,148,25.4,27.1,23.7,00000
29.0,47.0,87.0,285,11,01,  Kaimuddin Matbar,298,341,149,178,149,163,46.6,45.6,47.8,00000
29.0,47.0,87.0,310,01,01,  Najar Ali Matbar,23,124,10,58,13,66,15.6,14.7,16.5,00000
29.0,47.0,87.0,310,02,01,  Apajuddin Matbar,98,273,48,151,50,122,26.4,24.1,29.1,00000
29.0,47.0,87.0,310,03,01,  Joynal Fakirdangi,39,71,20,33,19,38,35.5,37.7,33.3,00000
29.0,47.0,87.0,310,04,01,  Dirajuddin Mistry,60,233,31,120,29,113,20.5,20.5,20.4,00000
29.0,47.0,87.0,310,05,01,  Osman Matbardangi,70,156,31,76,39,80,31.0,29.0,32.8,00000
29.0,47.0,87.0,310,06,01,  Soban Fakir,126,167,63,81,63,86,43.0,43.8,42.3,00000
29.0,47.0,87.0,310,07,01,  Alep Khardangi,72,144,35,75,37,69,33.3,31.8,34.9,00000
29.0,47.0,87.0,310,08,01,  Dangi Satter Bisswas D.,31,313,14,163,17,150,9.0,7.9,10.2,00000
29.0,47.0,87.0,310,09,01,  Asiruddin Bepary D.,31,144,18,64,13,80,17.7,22.0,14.0,00000
29.0,47.0,87.0,310,10,01,  Akber Mir Maldt,90,100,43,44,47,56,47.4,49.4,45.6,00000
29.0,47.0,87.0,310,11,01,  Kaim Uddin Mataber,51,158,22,85,29,73,24.4,20.6,28.4,00000
29.0,47.0,87.0,310,12,01,  Salim Mataber,68,127,28,64,40,63,34.9,30.4,38.8,00000
29.0,47.0,87.0,600,01,01,  Kudratlla Dangi,22,128,9,60,13,68,14.7,13.0,16.0,00000
29.0,47.0,87.0,600,03,01,  Rashid Munshi D.,25,104,10,56,15,48,19.4,15.2,23.8,00000
29.0,47.0,87.0,600,04,01,  Milonpal,77,147,39,69,38,78,34.4,36.1,32.8,00000
29.0,47.0,87.0,600,05,01,  Khalil Molla,56,259,28,137,28,122,17.8,17.0,18.7,00000
29.0,47.0,87.0,600,06,01,  Asmat Matbar Dingi,137,245,62,128,75,117,35.9,32.6,39.1,00000
29.0,47.0,87.0,600,07,01,  Dudu Mstberdingi,72,171,36,83,36,88,29.6,30.3,29.0,00000
29.0,47.0,87.0,600,08,01,  Taijuddin Matber Dingi,21,71,10,33,11,38,22.8,23.3,22.4,00000
29.0,47.0,87.0,600,09,01,  Afser Pattader,45,53,21,27,24,26,45.9,43.8,48.0,00000
29.0,47.0,87.0,600,10,01,  Sona Molla,15,113,5,65,10,48,11.7,7.1,17.2,00000
29.0,47.0,87.0,600,11,01,  Nazimuddin Mi.,26,119,13,57,13,62,17.9,18.6,17.3,00000
29.0,47.0,87.0,700,01,01,  Adorsho Gram,82,130,45,68,37,62,38.7,39.8,37.4,00000
29.0,47.0,87.0,700,02,01,  Hazratmatbar Dingi,24,147,12,72,12,75,14.0,14.3,13.8,00000
29.0,47.0,87.0,700,03,01,  Khalil Kha,58,92,35,48,23,44,38.7,42.2,34.3,00000
29.0,47.0,87.0,700,04,01,  Masem Mirdha,28,138,10,73,18,65,16.9,12.0,21.7,00000
29.0,47.0,87.0,700,05,01,  Joinuddin Mollar Dingi,15,45,8,22,7,23,25.0,26.7,23.3,00000
29.0,47.0,87.0,760,01,01,  Matbar Dangi Khalek,21,245,4,119,17,126,7.9,3.3,11.9,00000
29.0,47.0,87.0,760,02,01,  A.Samad Matbar,108,250,48,125,60,125,30.2,27.7,32.4,00000
29.0,47.0,87.0,760,03,01,  Sukur Sik,31,74,17,36,14,38,29.5,32.1,26.9,00000
29.0,47.0,87.0,760,04,01,  Salam Khar Dingi,15,79,5,41,10,38,16.0,10.9,20.8,00000
29.0,47.0,87.0,760,05,01,  Alimuddin  Matu Dingi,7,138,4,69,3,69,4.8,5.5,4.2,00000
29.0,47.0,87.0,760,06,01,  Kader Master Dingi,31,84,13,39,18,45,27.0,25.0,28.6,00000
29.0,47.0,87.0,760,07,01,  Md. Mt. Dingi,16,81,7,39,9,42,16.5,15.2,17.6,00000
29.0,47.0,87.0,760,08,01,  Taijuddin Mt. Dangi,15,163,3,78,12,85,8.4,3.7,12.4,00000
29.0,47.0,87.0,760,09,01,  Younuch Matbar Dingi,26,92,8,44,18,48,22.0,15.4,27.3,00000
29.0,47.0,87.0,760,10,01,  Soban Molla Dangi,71,214,28,107,43,107,24.9,20.7,28.7,00000
29.0,47.0,87.0,760,11,01,  Jalil Mollar Dangi,33,84,12,38,21,46,28.2,24.0,31.3,00000
29.0,47.0,87.0,760,12,01,  Imanti Mt. Dangi,26,47,11,23,15,24,35.6,32.4,38.5,00000
29.0,47.0,87.0,760,13,01,  Imarat Mt. Dangi,8,54,4,21,4,33,12.9,16.0,10.8,00000
29.0,47.0,87.0,760,14,01,  Kodom Ali Dangi,16,44,6,19,10,25,26.7,24.0,28.6,00000
29.0,47.0,87.0,994,01,01,  Nazimuddin Sikderdangi,63,179,26,87,37,92,26.0,23.0,28.7,00000
29.0,47.0,87.0,994,02,01,  Dangi Nuru Mondol,33,110,17,61,16,49,23.1,21.8,24.6,00000
29.0,47.0,87.0,994,03,01,  Ibrahim Matbar Dangi,22,117,9,61,13,56,15.8,12.9,18.8,00000
29.0,47.0,87.0,994,04,01,  Jahiruddin Matbar,87,273,31,154,56,119,24.2,16.8,32.0,00000
29.0,47.0,87.0,994,05,01,  Adu Mallik,41,74,21,33,20,41,35.7,38.9,32.8,00000
29.0,47.0,87.0,994,06,01,  Nabu Mallik,61,164,27,85,34,79,27.1,24.1,30.1,00000
29.0,47.0,87.0,994,07,01,  Kanu Matbar,35,183,17,86,18,97,16.1,16.5,15.7,00000
29.0,47.0,87.0,994,08,01,  Kamardangi,80,295,27,148,53,147,21.3,15.4,26.5,00000
29.0,47.0,87.0,994,09,01,  Adu Matbar,103,173,45,88,58,85,37.3,33.8,40.6,00000
29.0,47.0,87.0,994,10,01,  Lal Khardangi,30,72,10,39,20,33,29.4,20.4,37.7,00000
29.0,47.0,87.0,994,11,01,  Minajuddin Matbar Dingi,58,245,31,125,27,120,19.1,19.9,18.4,00000
29.0,47.0,87.0,994,12,01,  Abdul Latif Matbar Dingi,22,78,8,41,14,37,22.0,16.3,27.5,00000
29.0,47.0,87.0,994,13,01,  Jalal Pattader Dingi,31,79,12,38,19,41,28.2,24.0,31.7,00000
29.0,47.0,87.0,994,14,01,  Alauddin Matber Dingi,47,131,16,68,31,63,26.4,19.0,33.0,00000
29.0,47.0,87.0,994,15,01,  Rashid Munshi,107,280,43,145,64,135,27.6,22.9,32.2,00000
29.0,47.0,87.0,994,16,01,  Bandob Fakir,14,42,2,20,12,22,25.0,9.1,35.3,00000
29.0,47.0,87.0,994,17,01,  Moslem Pramank Dingi,18,58,8,24,10,34,23.7,25.0,22.7,00000
29.0,47.0,87.0,994,18,01,  Samserkhar Dingi,36,238,19,108,17,130,13.1,15.0,11.6,00000
29.0,47.0,87.0,994,19,01,  Mohammad Matbar Dingi,15,121,7,60,8,61,11.0,10.4,11.6,00000
29.0,47.0,87.0,994,20,01,  Arshad Mallikdangi,24,105,12,51,12,54,18.6,19.0,18.2,00000
29.0,47.0,87.0,994,21,01,  Wohad Molla Dangi,17,45,6,22,11,23,27.4,21.4,32.4,00000
29.0,47.0,87.0,994,22,01,  Abul Matbar,25,215,11,106,14,109,10.4,9.4,11.4,00000
29.0,47.0,87.0,994,23,01,  Notun Dangi,63,207,32,110,31,97,23.3,22.5,24.2,00000
29.0,47.0,87.0,994,24,01,  Jinnah Matbar,9,153,2,74,7,79,5.6,2.6,8.1,00000
29.0,56.0,10.0,062,01,01,  Dakshin Char Bagat,238,177,131,72,107,105,57.3,64.5,50.5,00000
29.0,56.0,10.0,062,02,01,  Purba Char Bagat,334,240,191,107,143,133,58.2,64.1,51.8,00000
29.0,56.0,10.0,062,03,01,  Bandar,187,85,97,45,90,40,68.8,68.3,69.2,00000
29.0,56.0,10.0,062,04,01,  Bagat Purba Para,263,223,133,110,130,113,54.1,54.7,53.5,00000
29.0,56.0,10.0,062,05,01,  Bagat Uttar Para,337,217,169,101,168,116,60.8,62.6,59.2,00000
29.0,56.0,10.0,062,06,01,  Bagat Dakshin Para,326,462,155,212,171,250,41.4,42.2,40.6,00000
29.0,56.0,10.0,062,07,01,  2bagat Munshi Para,308,464,163,231,145,233,39.9,41.4,38.4,00000
29.0,56.0,10.0,062,08,01,  Bagat Basupara,92,28,38,10,54,18,76.7,79.2,75.0,00000
29.0,56.0,10.0,062,09,01,  Bagat Thakur Para,357,77,189,32,168,45,82.3,85.5,78.9,00000
29.0,56.0,10.0,062,10,01,  Bagat Bazar,36,3,22,1,14,2,92.3,95.7,87.5,00000
29.0,56.0,10.0,062,11,01,  Bagat Gohail Para,114,262,48,134,66,128,30.3,26.4,34.0,00000
29.0,56.0,10.0,062,12,01,  Bagat Daspara,335,162,169,75,166,87,67.4,69.3,65.6,00000
29.0,56.0,10.0,062,13,01,  Bagat Ghoshpara,168,98,86,49,82,49,63.2,63.7,62.6,00000
29.0,56.0,10.0,062,14,01,  Bagat Nathpara,49,16,30,5,19,11,75.4,85.7,63.3,00000
29.0,56.0,10.0,062,15,01,  Bagat Biswas Para,349,317,179,147,170,170,52.4,54.9,50.0,00000
29.0,56.0,10.0,062,16,01,  Bagat Paschim Para,480,243,237,108,243,135,66.4,68.7,64.3,00000
29.0,56.0,10.0,400,01,01,  Atapur,144,98,73,51,71,47,59.5,58.9,60.2,00000
29.0,56.0,10.0,400,02,01,  Ghopghat,908,468,481,209,427,259,66.0,69.7,62.2,00000
29.0,56.0,10.0,400,03,01,  Paik Para,597,537,290,262,307,275,52.6,52.5,52.7,00000
29.0,56.0,10.0,400,04,01,  2ulukanda,47,24,28,9,19,15,66.2,75.7,55.9,00000
29.0,56.0,10.0,852,01,01,  Kasinathpur,335,239,176,108,159,131,58.4,62.0,54.8,00000
29.0,56.0,10.0,852,02,01,  Raizadapur,131,252,60,119,71,133,34.2,33.5,34.8,00000
29.0,56.0,21.0,035,01,01,  Arpara,3492,2713,1744,1283,1748,1430,56.3,57.6,55.0,00000
29.0,56.0,21.0,035,02,01,  Bhaturia,156,193,91,93,65,100,44.7,49.5,39.4,00000
29.0,56.0,21.0,035,03,01,  Bagicha,168,156,90,77,78,79,51.9,53.9,49.7,00000
29.0,56.0,21.0,396,01,01,  Dumain,1935,2060,973,966,962,1094,48.4,50.2,46.8,00000
29.0,56.0,21.0,396,02,01,  Tarapur,191,138,106,65,85,73,58.1,62.0,53.8,00000
29.0,56.0,21.0,396,03,01,  Jan Nagar,392,335,212,150,180,185,53.9,58.6,49.3,00000
29.0,56.0,21.0,396,04,01,  Nischintapur,816,556,385,252,431,304,59.5,60.4,58.6,00000
29.0,56.0,21.0,396,05,01,  Vellakandi,480,192,242,79,238,113,71.4,75.4,67.8,00000
29.0,56.0,21.0,452,01,01,  Gariadaha,574,448,300,187,274,261,56.2,61.6,51.2,00000
29.0,56.0,21.0,452,02,01,  Santipur,72,129,34,59,38,70,35.8,36.6,35.2,00000
29.0,56.0,21.0,452,03,01,  Rajdharpur,499,483,228,240,271,243,50.8,48.7,52.7,00000
29.0,56.0,21.0,452,04,01,  Paschim Arpara,477,407,255,200,222,207,54.0,56.0,51.7,00000
29.0,56.0,21.0,452,05,01,  Lakshmi Pur,353,269,189,115,164,154,56.8,62.2,51.6,00000
29.0,56.0,21.0,904,01,01,  Sidhlajuri,229,193,129,91,100,102,54.3,58.6,49.5,00000
29.0,56.0,21.0,904,02,01,  Krishnanagar,166,89,96,32,70,57,65.1,75.0,55.1,00000
29.0,56.0,21.0,904,03,01,  Jinishnagar,165,200,86,87,79,113,45.2,49.7,41.1,00000
29.0,56.0,31.0,075,01,01,  Baleshwar,876,688,462,336,414,352,56.0,57.9,54.0,00000
29.0,56.0,31.0,075,02,01,  Ramakantapur,498,410,266,180,232,230,54.8,59.6,50.2,00000
29.0,56.0,31.0,075,03,01,  Sreenathpur,247,236,124,118,123,118,51.1,51.2,51.0,00000
29.0,56.0,31.0,306,01,01,  Char Lakshmipur,437,589,238,287,199,302,42.6,45.3,39.7,00000
29.0,56.0,31.0,306,02,01,  Barail,206,320,104,163,102,157,39.2,39.0,39.4,00000
29.0,56.0,31.0,613,01,01,  Baspur,155,58,82,24,73,34,72.8,77.4,68.2,00000
29.0,56.0,31.0,613,02,01,  Char Baspur,282,231,149,106,133,125,55.0,58.4,51.6,00000
29.0,56.0,31.0,613,03,01,  Dakshin Ramdia,255,253,152,112,103,141,50.2,57.6,42.2,00000
29.0,56.0,31.0,673,01,01,  Laujana,317,391,166,199,151,192,44.8,45.5,44.0,00000
29.0,56.0,31.0,673,02,01,  Asapur,605,576,301,252,304,324,51.2,54.4,48.4,00000
29.0,56.0,31.0,673,03,01,  Patiata,305,180,156,80,149,100,62.9,66.1,59.8,00000
29.0,56.0,31.0,683,01,01,  Mahisapur,396,397,220,197,176,200,49.9,52.8,46.8,00000
29.0,56.0,31.0,683,02,01,  Kanthalbari,480,653,254,306,226,347,42.4,45.4,39.4,00000
29.0,56.0,31.0,688,01,01,  Pajakhana,390,520,193,263,197,257,42.9,42.3,43.4,00000
29.0,56.0,31.0,688,02,01,  Gangni Para,424,355,217,156,207,199,54.4,58.2,51.0,00000
29.0,56.0,31.0,688,03,01,  Bhatikandi,689,281,344,131,345,150,71.0,72.4,69.7,00000
29.0,56.0,31.0,688,04,01,  Majhkandi,1069,553,581,256,488,297,65.9,69.4,62.2,00000
29.0,56.0,37.0,654,01,01,  Manohardia,177,276,102,133,75,143,39.1,43.4,34.4,00000
29.0,56.0,37.0,654,02,01,  Elahipur,116,208,56,111,60,97,35.8,33.5,38.2,00000
29.0,56.0,37.0,654,03,01,  Tongrakandi,157,176,85,75,72,101,47.1,53.1,41.6,00000
29.0,56.0,37.0,654,04,01,  Char Manohardia,320,173,169,80,151,93,64.9,67.9,61.9,00000
29.0,56.0,37.0,654,05,01,  Kharakandi,92,47,50,19,42,28,66.2,72.5,60.0,00000
29.0,56.0,37.0,720,01,01,  Muraridia,913,586,506,274,407,312,60.9,64.9,56.6,00000
29.0,56.0,37.0,720,02,01,  Char Muraridia,226,117,120,61,106,56,65.9,66.3,65.4,00000
29.0,56.0,37.0,911,01,01,  Shibrampur,187,120,111,54,76,66,60.9,67.3,53.5,00000
29.0,56.0,37.0,911,02,01,  Aruakandi,152,126,96,52,56,74,54.7,64.9,43.1,00000
29.0,56.0,42.0,084,01,01,  Bakshipur,230,230,116,110,114,120,50.0,51.3,48.7,00000
29.0,56.0,42.0,084,02,01,  Gaisur Pur,92,185,46,88,46,97,33.2,34.3,32.2,00000
29.0,56.0,42.0,250,01,01,  Char Gaispur,362,792,190,396,172,396,31.4,32.4,30.3,00000
29.0,56.0,42.0,250,02,01,  Jarjarnagar,132,137,68,60,64,77,49.1,53.1,45.4,00000
29.0,56.0,42.0,532,01,01,  Kamarkhaligram,281,120,130,60,151,60,70.1,68.4,71.6,00000
29.0,56.0,42.0,532,02,01,  Kamarkhali Bazar,413,176,225,80,188,96,70.1,73.8,66.2,00000
29.0,56.0,42.0,657,01,01,  Maslandapur Hindupara,997,336,501,148,496,188,74.8,77.2,72.5,00000
29.0,56.0,42.0,657,02,01,  Maslandapur Dakshin Para,219,206,104,106,115,100,51.5,49.5,53.5,00000
29.0,56.0,42.0,657,03,01,  Malsandapur Paschim Para,605,755,289,383,316,372,44.5,43.0,45.9,00000
29.0,56.0,42.0,657,04,01,  Maslandapur Mollah Para,293,169,144,80,149,89,63.4,64.3,62.6,00000
29.0,56.0,42.0,657,05,01,  Swaruppur,142,269,68,122,74,147,34.5,35.8,33.5,00000
29.0,56.0,42.0,657,06,01,  Rajdharpur,281,78,133,39,148,39,78.3,77.3,79.1,00000
29.0,56.0,42.0,657,07,01,  Phulbari,406,353,211,151,195,202,53.5,58.3,49.1,00000
29.0,56.0,42.0,657,08,01,  Gandhokhali,490,405,230,191,260,214,54.7,54.6,54.9,00000
29.0,56.0,42.0,657,09,01,  Naorapara,205,105,92,37,113,68,66.1,71.3,62.4,00000
29.0,56.0,42.0,657,10,01,  Dayarampur,371,426,205,192,166,234,46.5,51.6,41.5,00000
29.0,56.0,42.0,657,11,01,  Gazi Khali,383,352,202,160,181,192,52.1,55.8,48.5,00000
29.0,56.0,42.0,876,01,01,  Salamatpur Purbapara,335,405,166,203,169,202,45.3,45.0,45.6,00000
29.0,56.0,42.0,876,02,01,  Salamatpur Paschim Para,188,65,81,19,107,46,74.3,81.0,69.9,00000
29.0,56.0,52.0,393,01,03,  Madhukhali,958,390,522,178,436,212,71.1,74.6,67.3,00000
29.0,56.0,52.0,393,02,03,  Paschim Garakhola,2106,1295,1029,633,1077,662,61.9,61.9,61.9,00000
29.0,56.0,52.0,393,03,03,  Purba Garakhola,898,233,478,105,420,128,79.4,82.0,76.6,00000
29.0,56.0,52.0,393,04,03,  Assrayankandro,79,407,41,187,38,220,16.3,18.0,14.7,00000
29.0,56.0,52.0,514,01,01,  Kamaldia,741,1065,374,521,367,544,41.0,41.8,40.3,00000
29.0,56.0,52.0,514,02,01,  Kayesdia,180,379,95,178,85,201,32.2,34.8,29.7,00000
29.0,56.0,52.0,514,03,01,  Makrail,758,575,360,274,398,301,56.9,56.8,56.9,00000
29.0,56.0,52.0,514,04,01,  Mira Para,207,259,98,135,109,124,44.4,42.1,46.8,00000
29.0,56.0,52.0,514,05,01,  Kalpoha (Part),323,206,143,100,180,106,61.1,58.8,62.9,00000
29.0,56.0,52.0,584,01,01,  Khoksahat,129,108,71,50,58,58,54.4,58.7,50.0,00000
29.0,56.0,52.0,584,02,01,  Pilkhana,115,126,62,62,53,64,47.7,50.0,45.3,00000
29.0,56.0,52.0,754,01,01,  Panchai,140,289,77,152,63,137,32.6,33.6,31.5,00000
29.0,56.0,52.0,754,02,01,  Chandpur,245,355,120,188,125,167,40.8,39.0,42.8,00000
29.0,56.0,52.0,754,03,01,  Mirzakandi,118,401,60,192,58,209,22.7,23.8,21.7,00000
29.0,56.0,52.0,754,04,01,  Lakhikanda,155,193,72,99,83,94,44.5,42.1,46.9,00000
29.0,56.0,52.0,754,05,01,  Takdia,132,443,67,229,65,214,23.0,22.6,23.3,00000
29.0,56.0,52.0,754,06,01,  Royekdah,118,154,58,81,60,73,43.4,41.7,45.1,00000
29.0,56.0,52.0,754,07,01,  Uluhat,137,145,63,76,74,69,48.6,45.3,51.7,00000
29.0,56.0,52.0,754,08,01,  Kalpoha(Part),277,427,130,219,147,208,39.3,37.2,41.4,00000
29.0,56.0,63.0,085,01,01,  Char Bamandi,299,382,160,185,139,197,43.9,46.4,41.4,00000
29.0,56.0,63.0,085,02,01,  Bamandi,287,271,153,120,134,151,51.4,56.0,47.0,00000
29.0,56.0,63.0,261,01,01,  Madhupur,91,68,51,25,40,43,57.2,67.1,48.2,00000
29.0,56.0,63.0,261,02,01,  Shibpur,175,150,103,63,72,87,53.8,62.0,45.3,00000
29.0,56.0,63.0,261,03,01,  Gopinathpur,327,237,186,100,141,137,58.0,65.0,50.7,00000
29.0,56.0,63.0,572,01,01,  Ujandia,611,320,316,124,295,196,65.6,71.8,60.1,00000
29.0,56.0,63.0,572,02,01,  Bagbari,246,218,138,115,108,103,53.0,54.5,51.2,00000
29.0,56.0,63.0,572,03,01,  Kalaikanda,292,213,161,85,131,128,57.8,65.4,50.6,00000
29.0,56.0,63.0,611,01,01,  Khodabaspur,451,420,248,194,203,226,51.8,56.1,47.3,00000
29.0,56.0,63.0,611,02,01,  Katakhali,552,771,259,372,293,399,41.7,41.0,42.3,00000
29.0,56.0,63.0,643,01,01,  Panch Konrakdi,546,575,296,284,250,291,48.7,51.0,46.2,00000
29.0,56.0,63.0,643,02,01,  Konrakdi,308,254,179,105,129,149,54.8,63.0,46.4,00000
29.0,56.0,63.0,698,01,01,  Megchami,1445,1599,768,756,677,843,47.5,50.4,44.5,00000
29.0,56.0,63.0,698,02,01,  Char Megchami,227,236,126,100,101,136,49.0,55.8,42.6,00000
29.0,56.0,63.0,698,03,01,  Jadabpur,185,140,101,68,84,72,56.9,59.8,53.8,00000
29.0,56.0,63.0,698,04,01,  Char Jadabpur,112,238,51,129,61,109,32.0,28.3,35.9,00000
29.0,56.0,63.0,778,01,01,  Digrirchar,223,173,112,85,111,88,56.3,56.9,55.8,00000
29.0,56.0,63.0,778,02,01,  Shubharkandi,261,135,136,61,125,74,65.9,69.0,62.8,00000
29.0,56.0,63.0,849,01,01,  Ramnagar,104,86,58,42,46,44,54.7,58.0,51.1,00000
29.0,56.0,63.0,849,02,01,  Bil Aralia,82,59,49,27,33,32,58.2,64.5,50.8,00000
29.0,56.0,63.0,849,03,01,  Kukni Rukni,165,252,80,130,85,122,39.6,38.1,41.1,00000
29.0,56.0,63.0,849,04,01,  Narayanpur,208,236,105,117,103,119,46.8,47.3,46.4,00000
29.0,56.0,73.0,048,01,01,  Arkandi,471,224,274,110,197,114,67.8,71.4,63.3,00000
29.0,56.0,73.0,048,02,01,  Bandar,206,102,112,45,94,57,66.9,71.3,62.3,00000
29.0,56.0,73.0,309,01,01,  Dari Bazar Madupur,197,252,98,121,99,131,43.9,44.7,43.0,00000
29.0,56.0,73.0,309,02,01,  Dari Bazar Arkandi,201,310,100,156,101,154,39.3,39.1,39.6,00000
29.0,56.0,73.0,309,03,01,  Char Bagat,214,118,100,60,114,58,64.5,62.5,66.3,00000
29.0,56.0,73.0,309,04,01,  Choperghat,167,159,90,88,77,71,51.2,50.6,52.0,00000
29.0,56.0,73.0,424,01,03,  Gondardia,1969,1285,1016,635,953,650,60.5,61.5,59.5,00000
29.0,56.0,73.0,424,02,03,  Alampur,292,81,144,37,148,44,78.3,79.6,77.1,00000
29.0,56.0,73.0,497,01,01,  Kadirpara,313,243,160,118,153,125,56.3,57.6,55.0,00000
29.0,56.0,73.0,497,02,01,  Tarapur,328,132,164,56,164,76,71.3,74.5,68.3,00000
29.0,56.0,73.0,608,01,01,  Lakshmandia,735,404,394,192,341,212,64.5,67.2,61.7,00000
29.0,56.0,73.0,608,02,01,  Kotbari,96,156,47,74,49,82,38.1,38.8,37.4,00000
29.0,56.0,73.0,608,03,01,  Alirpar,176,141,92,67,84,74,55.5,57.9,53.2,00000
29.0,56.0,73.0,741,01,01,  Uttar Noapara (Bazar),624,412,325,187,299,225,60.2,63.5,57.1,00000
29.0,56.0,73.0,741,02,01,  Nutan Noapara,284,219,142,108,142,111,56.5,56.8,56.1,00000
29.0,56.0,73.0,741,03,01,  Dakshin Noapara,257,290,116,142,141,148,47.0,45.0,48.8,00000
29.0,56.0,73.0,786,01,01,  Pichhalia,284,312,139,163,145,149,47.7,46.0,49.3,00000
29.0,56.0,73.0,786,02,01,  Algapara,202,296,98,179,104,117,40.6,35.4,47.1,00000
29.0,56.0,73.0,786,03,01,  Kurania Char,782,767,392,373,390,394,50.5,51.2,49.7,00000
29.0,56.0,73.0,880,01,01,  Samaskandi,218,134,108,55,110,79,61.9,66.3,58.2,00000
29.0,56.0,73.0,880,02,01,  Ramnathpur,33,22,17,9,16,13,60.0,65.4,55.2,00000
29.0,56.0,73.0,914,01,01,  Sitarampur,585,359,300,163,285,196,62.0,64.8,59.3,00000
29.0,56.0,73.0,914,02,01,  Sitarampur Daspara,143,132,83,62,60,70,52.0,57.2,46.2,00000
29.0,56.0,73.0,932,01,01,  Sreeramkandi,192,233,93,116,99,117,45.2,44.5,45.8,00000
29.0,56.0,73.0,932,02,01,  Char Sreeramkandi,180,274,91,144,89,130,39.6,38.7,40.6,00000
29.0,56.0,73.0,932,03,01,  Sreeramkandi Tarapur,482,627,263,310,219,317,43.5,45.9,40.9,00000
29.0,56.0,84.0,114,01,01,  Bara Gopaldi,1435,1478,755,713,680,765,49.3,51.4,47.1,00000
29.0,56.0,84.0,114,02,01,  Bhati Gopalpur,533,654,258,321,275,333,44.9,44.6,45.2,00000
29.0,56.0,84.0,452,01,01,  Hatghata,350,529,165,269,185,260,39.8,38.0,41.6,00000
29.0,56.0,84.0,452,02,01,  Char Hatghata,147,91,73,41,74,50,61.8,64.0,59.7,00000
29.0,56.0,84.0,462,01,01,  Jagannathdi,568,785,263,361,305,424,42.0,42.1,41.8,00000
29.0,56.0,84.0,462,02,01,  Jalkar,101,111,54,52,47,59,47.6,50.9,44.3,00000
29.0,56.0,84.0,473,01,01,  Jaliar Mobarakdia,217,246,115,117,102,129,46.9,49.6,44.2,00000
29.0,56.0,84.0,473,02,01,  Khurda Mokkail,147,129,73,61,74,68,53.3,54.5,52.1,00000
29.0,56.0,84.0,848,01,01,  Baksipur,140,102,79,41,61,61,57.9,65.8,50.0,00000
29.0,56.0,84.0,848,02,01,  Andharkotha,123,250,59,115,64,135,33.0,33.9,32.2,00000
29.0,56.0,84.0,866,01,01,  Dighalia,182,187,94,101,88,86,49.3,48.2,50.6,00000
29.0,56.0,84.0,866,02,01,  Char Dighalia,54,36,28,13,26,23,60.0,68.3,53.1,00000
29.0,56.0,84.0,935,01,01,  Sreerampur,173,131,80,61,93,70,56.9,56.7,57.1,00000
29.0,56.0,84.0,935,02,01,  Telikandi,119,136,50,72,69,64,46.7,41.0,51.9,00000
29.0,62.0,22.0,091,01,01,  Bara Sreebardi,269,686,145,336,124,350,28.2,30.1,26.2,00000
29.0,62.0,22.0,091,02,01,  Kanbardi,117,182,67,94,50,88,39.1,41.6,36.2,00000
29.0,62.0,22.0,320,01,01,  Gazaria,515,564,317,288,198,276,47.7,52.4,41.8,00000
29.0,62.0,22.0,320,02,01,  Kumerdia,282,285,151,143,131,142,49.7,51.4,48.0,00000
29.0,62.0,22.0,320,03,01,  Chadhat,1151,394,596,180,555,214,74.5,76.8,72.2,00000
29.0,62.0,22.0,353,01,01,  Gopalkardi,188,157,101,80,87,77,54.5,55.8,53.0,00000
29.0,62.0,22.0,353,02,01,  Gaduarpur,432,200,214,96,218,104,68.4,69.0,67.7,00000
29.0,62.0,22.0,586,01,01,  Kubirdia,112,49,71,18,41,31,69.6,79.8,56.9,00000
29.0,62.0,22.0,586,02,01,  Ramerchar,414,475,222,250,192,225,46.6,47.0,46.0,00000
29.0,62.0,27.0,133,01,01,  Bhubukdia,391,526,220,244,171,282,42.6,47.4,37.7,00000
29.0,62.0,27.0,133,02,01,  Bejbond,44,65,24,33,20,32,40.4,42.1,38.5,00000
29.0,62.0,27.0,253,01,01,  Dangi,131,305,57,145,74,160,30.0,28.2,31.6,00000
29.0,62.0,27.0,253,02,01,  Bangalkanda,231,237,117,110,114,127,49.4,51.5,47.3,00000
29.0,62.0,27.0,258,01,01,  Dangi Nagarkanda,675,658,329,319,346,339,50.6,50.8,50.5,00000
29.0,62.0,27.0,258,02,01,  Garuria,47,76,22,41,25,35,38.2,34.9,41.7,00000
29.0,62.0,27.0,333,01,01,  Goailpata,428,602,221,281,207,321,41.6,44.0,39.2,00000
29.0,62.0,27.0,333,02,01,  Mirergram,186,203,90,99,96,104,47.8,47.6,48.0,00000
29.0,62.0,27.0,524,01,01,  Kariail Kazi,92,49,47,24,45,25,65.2,66.2,64.3,00000
29.0,62.0,27.0,524,02,01,  Dah Kariail,219,99,107,41,112,58,68.9,72.3,65.9,00000
29.0,62.0,27.0,780,01,01,  Paradia,303,362,150,178,153,184,45.6,45.7,45.4,00000
29.0,62.0,27.0,780,02,01,  Rajkanda,162,234,90,111,72,123,40.9,44.8,36.9,00000
29.0,62.0,33.0,116,01,01,  Bauti Para,660,295,327,141,333,154,69.1,69.9,68.4,00000
29.0,62.0,33.0,116,02,01,  Salitha (Part-B),364,230,200,94,164,136,61.3,68.0,54.7,00000
29.0,62.0,33.0,840,01,01,  Ranpasha,275,231,134,107,141,124,54.3,55.6,53.2,00000
29.0,62.0,33.0,840,02,01,  Chukayed,169,268,72,127,97,141,38.7,36.2,40.8,00000
29.0,62.0,33.0,840,03,01,  Poradia,157,255,91,114,66,141,38.1,44.4,31.9,00000
29.0,62.0,33.0,840,04,01,  Kazikanda,105,230,55,105,50,125,31.3,34.4,28.6,00000
29.0,62.0,50.0,457,01,01,  Jiakuli,818,378,416,160,402,218,68.4,72.2,64.8,00000
29.0,62.0,50.0,457,02,01,  Sutarkandi,510,610,241,290,269,320,45.5,45.4,45.7,00000
29.0,62.0,50.0,474,01,01,  Chhota Naodubi,164,316,78,159,86,157,34.2,32.9,35.4,00000
29.0,62.0,50.0,474,02,01,  Madhya Kaichail,725,757,381,389,344,368,48.9,49.5,48.3,00000
29.0,62.0,50.0,474,03,01,  Dakshin Kaichail,855,889,418,455,437,434,49.0,47.9,50.2,00000
29.0,62.0,50.0,474,04,01,  Babur Kaichail,384,273,183,119,201,154,58.4,60.6,56.6,00000
29.0,62.0,50.0,507,01,01,  Uttar Kandipara,202,348,106,184,96,164,36.7,36.6,36.9,00000
29.0,62.0,50.0,507,02,01,  Dakshin Kandipara,354,462,172,207,182,255,43.4,45.4,41.6,00000
29.0,62.0,50.0,507,03,01,  Gohernama,178,266,94,127,84,139,40.1,42.5,37.7,00000
29.0,62.0,50.0,774,01,01,  Poradia Balia,215,472,104,221,111,251,31.3,32.0,30.7,00000
29.0,62.0,50.0,774,02,01,  Poradia Bazar,9,9,4,3,5,6,50.0,57.1,45.5,00000
29.0,62.0,50.0,774,03,01,  Kofa Balia,235,543,118,280,117,263,30.2,29.6,30.8,00000
29.0,62.0,50.0,774,04,01,  Majikanda,49,342,19,164,30,178,12.5,10.4,14.4,00000
29.0,62.0,55.0,004,01,01,  Ainpur,391,550,210,283,181,267,41.6,42.6,40.4,00000
29.0,62.0,55.0,004,02,01,  Shabhar,274,573,140,306,134,267,32.3,31.4,33.4,00000
29.0,62.0,55.0,432,01,03,  Jangurdi,1144,1197,546,535,598,662,48.9,50.5,47.5,00000
29.0,62.0,55.0,432,02,03,  Barkhadia,440,516,211,236,229,280,46.0,47.2,45.0,00000
29.0,62.0,55.0,899,01,01,  Shasha,578,439,288,217,290,222,56.8,57.0,56.6,00000
29.0,62.0,55.0,899,02,01,  Kharuahati,253,206,116,96,137,110,55.1,54.7,55.5,00000
29.0,62.0,67.0,208,01,01,  Char Chhagaldi,263,500,150,257,113,243,34.5,36.9,31.7,00000
29.0,62.0,67.0,208,02,01,  Chhagaldi,1358,1464,682,696,676,768,48.1,49.5,46.8,00000
29.0,62.0,67.0,407,01,01,  Ishwarid,611,1218,312,598,299,620,33.4,34.3,32.5,00000
29.0,62.0,67.0,407,02,01,  Bajonkanda,202,160,86,79,116,81,55.8,52.1,58.9,00000
29.0,62.0,67.0,407,03,01,  Chhota Paikkandi,279,494,125,243,154,251,36.1,34.0,38.0,00000
29.0,62.0,67.0,574,01,01,  Kodalia,618,724,309,352,309,372,46.1,46.7,45.4,00000
29.0,62.0,67.0,574,02,01,  Madbalia,89,324,43,168,46,156,21.5,20.4,22.8,00000
29.0,62.0,72.0,237,01,01,  Dafa,1105,996,597,481,508,515,52.6,55.4,49.7,00000
29.0,62.0,72.0,237,02,01,  Batal,653,568,343,267,310,301,53.5,56.2,50.7,00000
29.0,62.0,72.0,287,01,01,  Dulali,334,594,181,276,153,318,36.0,39.6,32.5,00000
29.0,62.0,72.0,287,02,01,  Chhota Kumardia,168,86,94,34,74,52,66.1,73.4,58.7,00000
29.0,62.0,72.0,641,01,01,  Majlishpur,69,361,33,206,36,155,16.0,13.8,18.8,00000
29.0,62.0,72.0,641,02,01,  Maherdia,508,473,254,233,254,240,51.8,52.2,51.4,00000
29.0,62.0,83.0,799,01,01,  Paschimpara,832,854,442,385,390,469,49.3,53.4,45.4,00000
29.0,62.0,83.0,799,02,01,  Purbapara,410,338,202,160,208,178,54.8,55.8,53.9,00000
29.0,62.0,83.0,799,03,01,  Khoyajerdanga,341,417,176,198,165,219,45.0,47.1,43.0,00000
29.0,62.0,83.0,949,01,01,  Narsinghpur,316,597,155,291,161,306,34.6,34.8,34.5,00000
29.0,62.0,83.0,949,02,01,  Baliyartan,112,231,61,108,51,123,32.7,36.1,29.3,00000
29.0,62.0,83.0,949,03,01,  Dabinagar,394,226,225,95,169,131,63.5,70.3,56.3,00000
29.0,62.0,83.0,949,04,01,  Dulardangi,208,144,113,68,95,76,59.1,62.4,55.6,00000
29.0,62.0,83.0,949,05,01,  Bazardangi,561,389,295,167,266,222,59.1,63.9,54.5,00000
29.0,62.0,94.0,087,01,01,  Bilnalia,1363,1498,670,703,693,795,47.6,48.8,46.6,00000
29.0,62.0,94.0,087,02,01,  Manikdhi,643,699,344,331,299,368,47.9,51.0,44.8,00000
29.0,62.0,94.0,087,03,01,  Piprul,147,220,64,119,83,101,40.1,35.0,45.1,00000
29.0,62.0,94.0,087,04,01,  Taleshar,118,214,60,115,58,99,35.5,34.3,36.9,00000
29.0,62.0,94.0,087,05,01,  Konagram,1193,1622,647,768,546,854,42.4,45.7,39.0,00000
29.0,62.0,94.0,853,01,01,  Sakdaldia,1951,2167,966,1050,985,1117,47.4,47.9,46.9,00000
29.0,62.0,94.0,853,02,01,  Joypur,111,253,63,118,48,135,30.5,34.8,26.2,00000
29.0,84.0,15.0,013,01,01,  Dhanai Beparidangi,309,375,147,174,162,201,45.2,45.8,44.6,00000
29.0,84.0,15.0,013,02,01,  Solenama,207,281,105,138,102,143,42.4,43.2,41.6,00000
29.0,84.0,15.0,013,03,01,  Nalartak,279,466,91,237,188,229,37.4,27.7,45.1,00000
29.0,84.0,15.0,013,04,01,  Lokman Kazidangi,120,100,45,46,75,54,54.5,49.5,58.1,00000
29.0,84.0,15.0,013,05,01,  Colony Para,49,21,25,8,24,13,70.0,75.8,64.9,00000
29.0,84.0,15.0,013,06,01,  Baliadangi,44,79,17,41,27,38,35.8,29.3,41.5,00000
29.0,84.0,15.0,013,07,01,  Kacharidangi,82,100,43,37,39,63,45.1,53.8,38.2,00000
29.0,84.0,15.0,013,08,01,  Sujauddin Beparidangi,68,104,30,49,38,55,39.5,38.0,40.9,00000
29.0,84.0,15.0,013,09,01,  Nimchan Sarkarerdangi,79,52,43,27,36,25,60.3,61.4,59.0,00000
29.0,84.0,15.0,013,10,01,  Nawas Beparidangi,22,26,9,13,13,13,45.8,40.9,50.0,00000
29.0,84.0,15.0,013,11,01,  Somir Bhuiyardangi,150,175,57,80,93,95,46.2,41.6,49.5,00000
29.0,84.0,15.0,013,12,01,  Jaladharerdangi,36,74,14,39,22,35,32.7,26.4,38.6,00000
29.0,84.0,15.0,013,13,01,  Kailaserdangi,127,135,55,58,72,77,48.5,48.7,48.3,00000
29.0,84.0,15.0,013,14,01,  Gyanendra Mistirirdangi,64,45,20,23,44,22,58.7,46.5,66.7,00000
29.0,84.0,15.0,013,15,01,  Sarat Chanderdangi,54,42,24,18,30,24,56.3,57.1,55.6,00000
29.0,84.0,15.0,013,16,01,  Sagarerdangi,34,51,13,26,21,25,40.0,33.3,45.7,00000
29.0,84.0,15.0,013,17,01,  Judishtirardangi,45,56,20,21,25,35,44.6,48.8,41.7,00000
29.0,84.0,15.0,013,18,01,  Piajkhalihat,51,47,29,26,22,21,52.0,52.7,51.2,00000
29.0,84.0,15.0,013,19,01,  Nutandangi,353,381,156,172,197,209,48.1,47.6,48.5,00000
29.0,84.0,15.0,013,20,01,  Khalpardangi,207,372,82,164,125,208,35.8,33.3,37.5,00000
29.0,84.0,15.0,013,21,01,  Biswaserdangi,83,51,36,23,47,28,61.9,61.0,62.7,00000
29.0,84.0,15.0,013,22,01,  Osman Mastadar Dangi,84,176,22,77,62,99,32.3,22.2,38.5,00000
29.0,84.0,15.0,309,01,01,  Kazidangi,312,190,141,84,171,106,62.2,62.7,61.7,00000
29.0,84.0,15.0,309,02,01,  Ranjan Mollardangi,106,132,38,59,68,73,44.5,39.2,48.2,00000
29.0,84.0,15.0,309,03,01,  Kokaram Sarkerdangi,47,55,15,25,32,30,46.1,37.5,51.6,00000
29.0,84.0,15.0,309,04,01,  Kachardangi,115,62,56,29,59,33,65.0,65.9,64.1,00000
29.0,84.0,15.0,309,05,01,  Lokman Khardangi,119,110,50,48,69,62,52.0,51.0,52.7,00000
29.0,84.0,15.0,309,06,01,  Mobarak Mollardangi,324,323,138,152,186,171,50.1,47.6,52.1,00000
29.0,84.0,15.0,309,07,01,  Ali Hossaindangi,216,164,94,70,122,94,56.8,57.3,56.5,00000
29.0,84.0,15.0,309,08,01,  Adu Fakirerdangi,45,33,24,11,21,22,57.7,68.6,48.8,00000
29.0,84.0,15.0,309,09,01,  Naju Matbarerdangi,197,139,89,60,108,79,58.6,59.7,57.8,00000
29.0,84.0,15.0,309,10,01,  Arshai Matberdangi,30,27,11,7,19,20,52.6,61.1,48.7,00000
29.0,84.0,15.0,524,01,01,  Hanner Dangi,319,183,146,74,173,109,63.5,66.4,61.3,00000
29.0,84.0,15.0,524,02,01,  Ray Dangi,55,68,24,28,31,40,44.7,46.2,43.7,00000
29.0,84.0,15.0,524,03,01,  Miroha Dangi,92,131,44,50,48,81,41.3,46.8,37.2,00000
29.0,84.0,15.0,591,01,01,  Saareng Dangi (Part),99,139,35,54,64,85,41.6,39.3,43.0,00000
29.0,84.0,15.0,591,02,01,  Gonjor Munshr Dangi,115,116,46,50,69,66,49.8,47.9,51.1,00000
29.0,84.0,15.0,591,03,01,  Baser Beparir Dangi,108,180,43,86,65,94,37.5,33.3,40.9,00000
29.0,84.0,15.0,591,04,01,  Sadar Bapari,61,105,19,51,42,54,36.7,27.1,43.8,00000
29.0,84.0,15.0,591,05,01,  Falu Beparir Dangi,33,106,13,47,20,59,23.7,21.7,25.3,00000
29.0,84.0,15.0,658,01,01,  Besay Mollardangi,47,35,16,12,31,23,57.3,57.1,57.4,00000
29.0,84.0,15.0,658,02,01,  Mirdangi,38,88,15,36,23,52,30.2,29.4,30.7,00000
29.0,84.0,15.0,658,03,01,  Satter Chowdhuryrdangi,98,134,40,60,58,74,42.2,40.0,43.9,00000
29.0,84.0,15.0,658,04,01,  Molladangi,374,423,171,189,203,234,46.9,47.5,46.5,00000
29.0,84.0,15.0,658,05,01,  Mochan Chowkidardangi,102,158,36,69,66,89,39.2,34.3,42.6,00000
29.0,84.0,15.0,658,06,01,  Sontosh Biswar Dangi,56,79,30,33,26,46,41.5,47.6,36.1,00000
29.0,84.0,15.0,658,07,01,  Darinerdangi,85,119,40,59,45,60,41.7,40.4,42.9,00000
29.0,84.0,15.0,658,08,01,  Mohammad Khardangi,16,10,6,3,10,7,61.5,66.7,58.8,00000
29.0,84.0,15.0,658,09,01,  Mathu Para Manirdangi,66,71,24,35,42,36,48.2,40.7,53.8,00000
29.0,84.0,15.0,658,10,01,  Wasuddin Mollardangi,31,27,12,13,19,14,53.4,48.0,57.6,00000
29.0,84.0,15.0,658,11,01,  Mandaldangi,67,36,28,15,39,21,65.0,65.1,65.0,00000
29.0,84.0,15.0,658,12,01,  Hakim Beparidangi,176,126,97,45,79,81,58.3,68.3,49.4,00000
29.0,84.0,15.0,658,13,01,  Kazirdangi,23,43,9,25,14,18,34.8,26.5,43.8,00000
29.0,84.0,15.0,658,14,01,  Gongir Ali Chowdhurydangi,29,16,14,9,15,7,64.4,60.9,68.2,00000
29.0,84.0,15.0,658,15,01,  Halim Chowdhurydangi,144,363,56,155,88,208,28.4,26.5,29.7,00000
29.0,84.0,15.0,658,16,01,  Abdul Azizkhardangi,32,114,11,50,21,64,21.9,18.0,24.7,00000
29.0,84.0,15.0,658,17,01,  Afaz Uddinerdangi,44,57,23,23,21,34,43.6,50.0,38.2,00000
29.0,84.0,15.0,658,18,01,  Gani Beparidangi,49,174,20,67,29,107,22.0,23.0,21.3,00000
29.0,84.0,15.0,658,19,01,  Yusuf Beparidangi,82,104,40,49,42,55,44.1,44.9,43.3,00000
29.0,84.0,15.0,658,20,01,  Osman Sekherdangi,22,82,7,42,15,40,21.2,14.3,27.3,00000
29.0,84.0,15.0,658,21,01,  Gulmirdangi,16,18,8,4,8,14,47.1,66.7,36.4,00000
29.0,84.0,15.0,658,22,01,  Ibrahimdangi,61,130,27,64,34,66,31.9,29.7,34.0,00000
29.0,84.0,15.0,658,23,01,  Dalu Mollardangi,50,44,23,16,27,28,53.2,59.0,49.1,00000
29.0,84.0,15.0,658,24,01,  Ali Beparidangi,63,65,25,32,38,33,49.2,43.9,53.5,00000
29.0,84.0,15.0,658,25,01,  Saringidangi,65,61,31,26,34,35,51.6,54.4,49.3,00000
29.0,84.0,15.0,658,26,01,  Kadam Sikdarerdangi,63,52,23,19,40,33,54.8,54.8,54.8,00000
29.0,84.0,15.0,658,27,01,  Rahim Fakirerdangi,11,44,4,22,7,22,20.0,15.4,24.1,00000
29.0,84.0,15.0,658,28,01,  Haji Khorshed Bepari,63,291,24,127,39,164,17.8,15.9,19.2,00000
29.0,84.0,15.0,658,29,01,  Nazim Sekherdangi,10,82,3,46,7,36,10.9,6.1,16.3,00000
29.0,84.0,15.0,658,30,01,  Danse Fakirerdangi,143,203,54,94,89,109,41.3,36.5,44.9,00000
29.0,84.0,15.0,658,31,01,  Dulal Fakirerdangi,55,76,23,29,32,47,42.0,44.2,40.5,00000
29.0,84.0,15.0,658,32,01,  Sardardangi,177,234,75,137,102,97,43.1,35.4,51.3,00000
29.0,84.0,15.0,658,33,01,  Kader Sekherdangi,186,143,92,65,94,78,56.5,58.6,54.7,00000
29.0,84.0,15.0,658,34,01,  Karim Sekherdangi,60,81,28,37,32,44,42.6,43.1,42.1,00000
29.0,84.0,19.0,067,01,01,  Samir Hazirdangi,177,239,73,115,104,124,42.5,38.8,45.6,00000
29.0,84.0,19.0,067,02,01,  Intas Khardangi,165,235,71,120,94,115,41.3,37.2,45.0,00000
29.0,84.0,19.0,067,03,01,  Helaluddin Khardangi,172,176,75,85,97,91,49.4,46.9,51.6,00000
29.0,84.0,19.0,067,04,01,  Ismail Sarkerdangi,224,225,133,88,91,137,49.9,60.2,39.9,00000
29.0,84.0,19.0,067,05,01,  Wahed Molladangi,161,242,71,110,90,132,40.0,39.2,40.5,00000
29.0,84.0,19.0,067,06,01,  Kazim Fakirdangi,50,79,21,42,29,37,38.8,33.3,43.9,00000
29.0,84.0,19.0,067,07,01,  Osman Mollardangi,119,310,59,157,60,153,27.7,27.3,28.2,00000
29.0,84.0,19.0,067,08,01,  Nazim Kazirdangi,42,99,13,56,29,43,29.8,18.8,40.3,00000
29.0,84.0,19.0,067,09,01,  Zakir Sikderdangi,293,231,136,105,157,126,55.9,56.4,55.5,00000
29.0,84.0,19.0,067,10,01,  Litiflkazirdangi,118,110,56,45,62,65,51.8,55.4,48.8,00000
29.0,84.0,19.0,080,01,01,  Chandpur Bazarkandi,395,669,175,316,220,353,37.1,35.6,38.4,00000
29.0,84.0,19.0,080,02,01,  Mesarerdangi,67,170,27,78,40,92,28.3,25.7,30.3,00000
29.0,84.0,19.0,080,03,01,  Gafur Matbarerdangi,42,58,15,29,27,29,42.0,34.1,48.2,00000
29.0,84.0,19.0,080,04,01,  Royerdangi,86,71,35,37,51,34,54.8,48.6,60.0,00000
29.0,84.0,19.0,080,05,01,  Panchuram Biwaserdangi,105,64,57,30,48,34,62.1,65.5,58.5,00000
29.0,84.0,19.0,080,06,01,  Jamaderdangi,184,120,97,48,87,72,60.5,66.9,54.7,00000
29.0,84.0,19.0,201,01,01,  Makbul Hossaindangi,310,439,138,207,172,232,41.4,40.0,42.6,00000
29.0,84.0,19.0,201,02,01,  Nasiruddin Khardangi,219,373,109,174,110,199,37.0,38.5,35.6,00000
29.0,84.0,19.0,201,03,01,  Tiladangi,61,165,32,77,29,88,27.0,29.4,24.8,00000
29.0,84.0,19.0,201,04,01,  Bairagidangi,48,231,28,101,20,130,17.2,21.7,13.3,00000
29.0,84.0,19.0,201,05,01,  Intas Molladangi,181,312,88,145,93,167,36.7,37.8,35.8,00000
29.0,84.0,19.0,201,06,01,  Latif Kazirdangi,110,146,48,69,62,77,43.0,41.0,44.6,00000
29.0,84.0,19.0,228,01,01,  Mesererdangi,31,42,14,17,17,25,42.5,45.2,40.5,00000
29.0,84.0,19.0,228,02,01,  Madhu Mandalerdangi,137,127,65,57,72,70,51.9,53.3,50.7,00000
29.0,84.0,19.0,228,03,01,  Gafur Matbarerdangi,342,325,167,142,175,183,51.3,54.0,48.9,00000
29.0,84.0,19.0,228,04,01,  Sajuddin Molladangi,324,291,160,146,164,145,52.7,52.3,53.1,00000
29.0,84.0,19.0,255,01,01,  Hawladerdangi,125,449,62,230,63,219,21.8,21.2,22.3,00000
29.0,84.0,19.0,255,02,01,  Nasaruddinm,221,230,115,105,106,125,49.0,52.3,45.9,00000
29.0,84.0,19.0,255,03,01,  Kosemuddin Mollardangi,83,127,36,54,47,73,39.5,40.0,39.2,00000
29.0,84.0,19.0,255,04,01,  Hazi Faizuddin Hazirdangi,131,311,56,151,75,160,29.6,27.1,31.9,00000
29.0,84.0,19.0,255,05,01,  Paban Khardangi,283,491,125,237,158,254,36.6,34.5,38.3,00000
29.0,84.0,19.0,255,06,01,  Bashir Sikdarerdangi,131,211,59,105,72,106,38.3,36.0,40.4,00000
29.0,84.0,19.0,255,07,01,  Hakimuddin Matbardangi,230,338,110,150,120,188,40.5,42.3,39.0,00000
29.0,84.0,19.0,322,01,01,  Bashar Sikdarerdangi,97,249,46,124,51,125,28.0,27.1,29.0,00000
29.0,84.0,19.0,322,02,01,  Amir Khardangi,47,249,26,125,21,124,15.9,17.2,14.5,00000
29.0,84.0,19.0,726,01,01,  Madhyer Char,512,707,243,344,269,363,42.0,41.4,42.6,00000
29.0,84.0,19.0,726,02,01,  Munshirgram,113,475,46,232,67,243,19.2,16.5,21.6,00000
29.0,84.0,19.0,726,03,01,  Moshalchedangi,116,296,52,134,64,162,28.2,28.0,28.3,00000
29.0,84.0,19.0,726,04,01,  Adu Beparidangi,257,300,119,145,138,155,46.1,45.1,47.1,00000
29.0,84.0,19.0,726,05,01,  Ganesh Sarkarerdangi,151,129,65,57,86,72,53.9,53.3,54.4,00000
29.0,84.0,19.0,726,06,01,  Mochon Howladardangi,29,118,10,58,19,60,19.7,14.7,24.1,00000
29.0,84.0,19.0,726,07,01,  Abdur Rahaman Mridhardangi,100,96,47,47,53,49,51.0,50.0,52.0,00000
29.0,84.0,19.0,726,08,01,  A.A.Mridhardangi,80,74,39,32,41,42,51.9,54.9,49.4,00000
29.0,84.0,19.0,726,09,01,  A.Bashir Mridhardangi,244,268,112,125,132,143,47.7,47.3,48.0,00000
29.0,84.0,19.0,726,10,01,  A.Bisa Miardangi,93,131,49,62,44,69,41.5,44.1,38.9,00000
29.0,84.0,19.0,726,11,01,  A.Kabel Mridhardangi,86,40,39,16,47,24,68.3,70.9,66.2,00000
29.0,84.0,19.0,726,12,01,  A.Susil Mandaldangi,135,146,65,70,70,76,48.0,48.1,47.9,00000
29.0,84.0,19.0,726,13,01,  Almirabad Dopdangi,75,35,35,19,40,16,68.2,64.8,71.4,00000
29.0,84.0,19.0,726,14,01,  A.Ganga Charanerdangi,77,36,40,11,37,25,68.1,78.4,59.7,00000
29.0,84.0,19.0,726,15,01,  A.Schoolgram,189,162,96,76,93,86,53.8,55.8,52.0,00000
29.0,84.0,19.0,726,16,01,  P.Almirabad Khal,232,343,121,164,111,179,40.3,42.5,38.3,00000
29.0,84.0,19.0,726,17,01,  Natundangi,200,233,97,112,103,121,46.2,46.4,46.0,00000
29.0,84.0,19.0,873,01,01,  Madhu Mandalerdangi,319,460,153,224,166,236,40.9,40.6,41.3,00000
29.0,84.0,19.0,873,02,01,  Lal Miardangi,41,142,24,72,17,70,22.4,25.0,19.5,00000
29.0,84.0,28.0,208,01,01,  Kazidangi,126,108,55,44,71,64,53.8,55.6,52.6,00000
29.0,84.0,28.0,208,02,01,  Sadar Khardangi,159,244,76,109,83,135,39.5,41.1,38.1,00000
29.0,84.0,28.0,208,03,01,  Boyeadangi,30,39,14,19,16,20,43.5,42.4,44.4,00000
29.0,84.0,28.0,208,04,01,  Magidangi,101,107,52,49,49,58,48.6,51.5,45.8,00000
29.0,84.0,28.0,208,05,01,  Baladangi,160,237,83,105,77,132,40.3,44.1,36.8,00000
29.0,84.0,28.0,208,06,01,  Kacharidangi,136,139,69,69,67,70,49.5,50.0,48.9,00000
29.0,84.0,28.0,208,07,01,  Boyodangi,121,119,61,55,60,64,50.4,52.6,48.4,00000
29.0,84.0,28.0,208,08,01,  Kulpar,271,262,130,114,141,148,50.8,53.3,48.8,00000
29.0,84.0,28.0,290,01,01,  Chaiterkulpar,387,574,159,284,228,290,40.3,35.9,44.0,00000
29.0,84.0,28.0,290,02,01,  Ali Hossaindangi,271,390,146,160,125,230,41.0,47.7,35.2,00000
29.0,84.0,28.0,290,03,01,  Fakirdangi,151,245,80,105,71,140,38.1,43.2,33.6,00000
29.0,84.0,28.0,376,01,01,  Dakshin Char Bishnapur,1269,1215,608,556,661,659,51.1,52.2,50.1,00000
29.0,84.0,28.0,376,02,01,  Koladangi,171,514,68,260,103,254,25.0,20.7,28.9,00000
29.0,84.0,28.0,376,03,01,  Kanchiramdangi,142,185,65,91,77,94,43.4,41.7,45.0,00000
29.0,84.0,28.0,376,04,01,  Jariperdangi (Part),476,672,219,295,257,377,41.5,42.6,40.5,00000
29.0,84.0,28.0,524,01,01,  Lohertak,353,392,139,174,214,218,47.4,44.4,49.5,00000
29.0,84.0,28.0,524,02,01,  Mridhardangi,192,149,101,76,91,73,56.3,57.1,55.5,00000
29.0,84.0,28.0,524,03,01,  Chowkidardangi,275,433,117,195,158,238,38.8,37.5,39.9,00000
29.0,84.0,28.0,524,04,01,  Nolartek,157,288,60,140,97,148,35.3,30.0,39.6,00000
29.0,84.0,28.0,524,05,01,  Jariperdangi,642,923,339,455,303,468,41.0,42.7,39.3,00000
29.0,84.0,28.0,591,01,01,  Shympurtek,240,178,126,61,114,117,57.4,67.4,49.4,00000
29.0,84.0,28.0,591,02,01,  Akondangi,181,201,88,90,93,111,47.4,49.4,45.6,00000
29.0,84.0,28.0,591,03,01,  Samherdangi,46,163,11,86,35,77,22.0,11.3,31.3,00000
29.0,84.0,28.0,591,04,01,  Azimuddin Matbardangi,107,164,53,73,54,91,39.5,42.1,37.2,00000
29.0,84.0,28.0,591,05,01,  Gani Matbardangi,72,185,22,87,50,98,28.0,20.2,33.8,00000
29.0,84.0,28.0,591,06,01,  Baddadangi,68,187,30,84,38,103,26.7,26.3,27.0,00000
29.0,84.0,28.0,591,07,01,  Pattandardangi,128,128,73,59,55,69,50.0,55.3,44.4,00000
29.0,84.0,28.0,591,08,01,  Samser Matbardangi,64,164,29,63,35,101,28.1,31.5,25.7,00000
29.0,84.0,28.0,591,09,01,  Dagu Matbardangi,243,198,140,95,103,103,55.1,59.6,50.0,00000
29.0,84.0,28.0,591,10,01,  Salim Uddinerdangi,120,131,59,55,61,76,47.8,51.8,44.5,00000
29.0,84.0,28.0,665,01,01,  Nayadangi,229,369,91,172,138,197,38.3,34.6,41.2,00000
29.0,84.0,28.0,665,02,01,  Molladangi,113,221,36,100,77,121,33.8,26.5,38.9,00000
29.0,84.0,28.0,665,03,01,  Kala Mridhardangi,104,269,37,128,67,141,27.9,22.4,32.2,00000
29.0,84.0,38.0,107,01,01,  Fazal Haque Monsr Kandi,50,104,23,48,27,56,32.5,32.4,32.5,00000
29.0,84.0,38.0,107,02,01,  Afsar Munsirdangi,195,237,91,113,104,124,45.1,44.6,45.6,00000
29.0,84.0,38.0,147,01,01,  Khalasidangi,124,344,61,154,63,190,26.5,28.4,24.9,00000
29.0,84.0,38.0,147,02,01,  Charkandi,51,318,18,158,33,160,13.8,10.2,17.1,00000
29.0,84.0,38.0,147,03,01,  Baser Kharkandi,150,183,82,84,68,99,45.0,49.4,40.7,00000
29.0,84.0,38.0,147,04,01,  Jageradangi,183,291,99,131,84,160,38.6,43.0,34.4,00000
29.0,84.0,38.0,147,05,01,  Felu Matbardangi,86,127,40,66,46,61,40.4,37.7,43.0,00000
29.0,84.0,38.0,147,06,01,  Chan Kharkandi,15,67,8,33,7,34,18.3,19.5,17.1,00000
29.0,84.0,38.0,147,07,01,  Kazikandi,93,170,44,82,49,88,35.4,34.9,35.8,00000
29.0,84.0,38.0,147,08,01,  Ramkomar Mondolar Kandi,59,70,25,33,34,37,45.7,43.1,47.9,00000
29.0,84.0,38.0,147,09,01,  Mohis Beparikandi,24,70,10,33,14,37,25.5,23.3,27.5,00000
29.0,84.0,38.0,147,10,01,  Newas Kharkandi,92,185,52,85,40,100,33.2,38.0,28.6,00000
29.0,84.0,38.0,282,01,01,  Char Manair,132,360,74,182,58,178,26.8,28.9,24.6,00000
29.0,84.0,38.0,282,02,01,  Giashuddin Fokir Kandi,262,226,121,103,141,123,53.7,54.0,53.4,00000
29.0,84.0,38.0,282,03,01,  Hazari Hazir Kandi,107,208,59,103,48,105,34.0,36.4,31.4,00000
29.0,84.0,38.0,389,01,01,  Rahmatullah Matbarkandi,400,853,188,380,212,473,31.9,33.1,30.9,00000
29.0,84.0,38.0,389,02,01,  Rarikandi,96,213,49,91,47,122,31.1,35.0,27.8,00000
29.0,84.0,38.0,389,03,01,  Dangar Matbarkandi,45,113,14,50,31,63,28.5,21.9,33.0,00000
29.0,84.0,38.0,389,04,01,  Osel Mollakandi,118,213,55,97,63,116,35.6,36.2,35.2,00000
29.0,84.0,38.0,389,05,01,  Kalai Matbarerkandi,47,175,16,79,31,96,21.2,16.8,24.4,00000
29.0,84.0,38.0,389,06,01,  Giasuddin Beparikandi,71,228,29,107,42,121,23.7,21.3,25.8,00000
29.0,84.0,38.0,389,07,01,  Ismail Matbarkandi,267,666,142,348,125,318,28.6,29.0,28.2,00000
29.0,84.0,38.0,389,08,01,  Anando Mondou Kandi,31,71,15,30,16,41,30.4,33.3,28.1,00000
29.0,84.0,38.0,564,01,01,  Amir Kharkandi,279,330,135,148,144,182,45.8,47.7,44.2,00000
29.0,84.0,38.0,564,02,01,  Bairagikandi,4,8,2,3,2,5,33.3,40.0,28.6,00000
29.0,84.0,38.0,954,01,01,  Adeluddin Mollarkandi,207,206,90,106,117,100,50.1,45.9,53.9,00000
29.0,84.0,38.0,954,02,01,  Surja Mandalerkandi,155,171,73,80,82,91,47.5,47.7,47.4,00000
29.0,84.0,47.0,506,01,01,  Jangikandi,45,129,24,53,21,76,25.9,31.2,21.6,00000
29.0,84.0,47.0,506,02,01,  Motiullah Moulvirkandi,20,70,9,35,11,35,22.2,20.5,23.9,00000
29.0,84.0,47.0,506,03,01,  Jamal Sikder Kandi,67,173,33,92,34,81,27.9,26.4,29.6,00000
29.0,84.0,47.0,506,04,01,  Sujai Munshir Kandi,23,41,10,22,13,19,35.9,31.3,40.6,00000
29.0,84.0,47.0,506,05,01,  Khauifa Kandi,144,305,68,160,76,145,32.1,29.8,34.4,00000
29.0,84.0,47.0,506,06,01,  Charag Aui Munshir Kandi,20,63,9,27,11,36,24.1,25.0,23.4,00000
29.0,84.0,47.0,551,01,01,  Karalkandi,315,359,181,178,134,181,46.7,50.4,42.5,00000
29.0,84.0,47.0,551,02,01,  Ibrahim Munshir Kandi,139,320,85,149,54,171,30.3,36.3,24.0,00000
29.0,84.0,47.0,551,03,01,  Choto Koou,35,226,25,126,10,100,13.4,16.6,9.1,00000
29.0,84.0,47.0,551,04,01,  Choto Koou Jangikandi,79,166,45,76,34,90,32.2,37.2,27.4,00000
29.0,84.0,47.0,551,05,01,  Miajan Bepari Kandi,5,9,2,6,3,3,35.7,25.0,50.0,00000
29.0,84.0,47.0,578,01,01,  Mofizuddin Hazirkandi,140,311,78,153,62,158,31.0,33.8,28.2,00000
29.0,84.0,47.0,578,02,01,  Babarali Mollarkandi,193,451,99,225,94,226,30.0,30.6,29.4,00000
29.0,84.0,47.0,578,03,01,  Jamadarkandi,90,106,54,53,36,53,45.9,50.5,40.4,00000
29.0,84.0,47.0,578,04,01,  Abdul Wahed Jamadarkandi,55,113,28,54,27,59,32.7,34.1,31.4,00000
29.0,84.0,47.0,578,05,01,  Nazirsikder Kandi,2,14,1,6,1,8,12.5,14.3,11.1,00000
29.0,84.0,47.0,578,06,01,  Nazir Madhu Hazirkandi,33,110,13,55,20,55,23.1,19.1,26.7,00000
29.0,84.0,47.0,578,07,01,  Moijuddin Matbarerkandi,199,250,88,110,111,140,44.3,44.4,44.2,00000
29.0,84.0,47.0,578,08,01,  Abdul Halim Howladerkandi,156,303,82,150,74,153,34.0,35.3,32.6,00000
29.0,84.0,47.0,578,09,01,  Karim Mouuar Kandi,19,39,8,19,11,20,32.8,29.6,35.5,00000
29.0,84.0,47.0,578,10,01,  Dubbartek,118,294,46,141,72,153,28.6,24.6,32.0,00000
29.0,84.0,47.0,578,11,01,  Nazem How.Kandi,24,51,13,27,11,24,32.0,32.5,31.4,00000
29.0,84.0,47.0,578,12,01,  Mazid Mouuobi Kandi,24,21,14,8,10,13,53.3,63.6,43.5,00000
29.0,84.0,47.0,578,13,01,  Hosen Khar Kandi,18,114,8,57,10,57,13.6,12.3,14.9,00000
29.0,84.0,47.0,578,14,01,  Molam Khar Kandi,53,67,25,37,28,30,44.2,40.3,48.3,00000
29.0,84.0,47.0,578,15,01,  Momres Khar Kandi,83,185,37,82,46,103,31.0,31.1,30.9,00000
29.0,84.0,47.0,766,01,01,  Hafij Kandi,45,326,20,147,25,179,12.1,12.0,12.3,00000
29.0,84.0,47.0,766,02,01,  Ketabdi Mat. Kandi,44,116,23,59,21,57,27.5,28.0,26.9,00000
29.0,84.0,47.0,766,03,01,  Molla Kandi,82,122,42,61,40,61,40.2,40.8,39.6,00000
29.0,84.0,47.0,766,04,01,  Khaliashi Kandi,34,92,17,49,17,43,27.0,25.8,28.3,00000
29.0,84.0,47.0,766,05,01,  Mohammad Khar Kandi,36,63,17,30,19,33,36.4,36.2,36.5,00000
29.0,84.0,47.0,766,06,01,  Charagaui Hazir Kandi,78,120,45,57,33,63,39.4,44.1,34.4,00000
29.0,84.0,47.0,766,07,01,  Howuader Kandi,53,96,27,42,26,54,35.6,39.1,32.5,00000
29.0,84.0,47.0,766,08,01,  Bepari Kandi,32,41,19,21,13,20,43.8,47.5,39.4,00000
29.0,84.0,47.0,766,09,01,  Kazi Kandi,69,178,42,89,27,89,27.9,32.1,23.3,00000
29.0,84.0,47.0,981,01,01,  Badsh Kandi,29,58,10,26,19,32,33.3,27.8,37.3,00000
29.0,84.0,47.0,981,02,01,  Panchit Kandi,87,101,40,41,47,60,46.3,49.4,43.9,00000
29.0,84.0,57.0,013,01,01,  Abdur Rahaman Munsir Dangi,26,44,22,35,4,9,37.1,38.6,30.8,00000
29.0,84.0,57.0,013,02,01,  Piaz Khali,9,12,6,5,3,7,42.9,54.5,30.0,00000
29.0,84.0,57.0,013,03,01,  Basar Dangi,83,192,36,92,47,100,30.2,28.1,32.0,00000
29.0,84.0,57.0,013,04,01,  Bepari Dangi,38,122,21,59,17,63,23.8,26.3,21.3,00000
29.0,84.0,57.0,121,01,01,  Char Balasia,674,1091,323,502,351,589,38.2,39.2,37.3,00000
29.0,84.0,57.0,121,02,01,  Ram Sunpor Dangi (Part),107,191,56,87,51,104,35.9,39.2,32.9,00000
29.0,84.0,57.0,268,01,01,  Nazim Uddinhawlader Dangi,77,132,30,67,47,65,36.8,30.9,42.0,00000
29.0,84.0,57.0,268,02,01,  Lal Mollardangi,261,268,120,123,141,145,49.3,49.4,49.3,00000
29.0,84.0,57.0,268,03,01,  Yousuf Munsird,86,179,43,77,43,102,32.5,35.8,29.7,00000
29.0,84.0,57.0,268,04,01,  Wajibulla Hawladardangi,444,721,199,327,245,394,38.1,37.8,38.3,00000
29.0,84.0,57.0,268,05,01,  Thakur Char,576,675,384,302,192,373,46.0,56.0,34.0,00000
29.0,84.0,57.0,268,06,01,  Char Noapara,734,729,351,246,383,483,50.2,58.8,44.2,00000
29.0,84.0,57.0,268,07,01,  Mokim Khardangi,38,27,17,13,21,14,58.5,56.7,60.0,00000
29.0,84.0,57.0,268,08,01,  Sardarerdangi,285,366,114,178,171,188,43.8,39.0,47.6,00000
29.0,84.0,57.0,268,09,01,  Khaskandi,34,29,18,14,16,15,54.0,56.3,51.6,00000
29.0,84.0,57.0,268,10,01,  Maizuddin Matbarkandi,7,17,3,9,4,8,29.2,25.0,33.3,00000
29.0,84.0,57.0,268,11,01,  Hanif Hazid Dangi,212,351,68,150,144,201,37.7,31.2,41.7,00000
29.0,84.0,57.0,672,01,01,  Ramsundor Dangi,108,219,45,119,63,100,33.0,27.4,38.7,00000
29.0,84.0,57.0,672,02,01,  Boxo Dangi,105,181,44,80,61,101,36.7,35.5,37.7,00000
29.0,84.0,57.0,672,03,01,  Gopi Dangi,5,20,3,8,2,12,20.0,27.3,14.3,00000
29.0,84.0,57.0,752,01,01,  Jabed Fakirdangi,105,199,38,94,67,105,34.5,28.8,39.0,00000
29.0,84.0,57.0,752,02,01,  Durjan Khardangi,346,404,153,198,193,206,46.1,43.6,48.4,00000
29.0,84.0,57.0,752,03,01,  Dabir Uddin Beparidangi,115,154,52,71,63,83,42.8,42.3,43.2,00000
29.0,84.0,57.0,752,04,01,  Dulal Matbardangi,163,210,87,88,76,122,43.7,49.7,38.4,00000
29.0,84.0,57.0,752,05,01,  Chakladardangi,173,384,68,184,105,200,31.1,27.0,34.4,00000
29.0,84.0,57.0,752,06,01,  Nutand,225,221,107,97,118,124,50.4,52.5,48.8,00000
29.0,84.0,57.0,752,07,01,  Pottendardangi,75,120,34,60,41,60,38.5,36.2,40.6,00000
29.0,84.0,57.0,752,08,01,  Tkakor Dangi,265,238,142,115,123,123,52.7,55.3,50.0,00000
29.0,84.0,57.0,752,09,01,  Baburchar Nutan Dangi,195,225,97,109,98,116,46.4,47.1,45.8,00000
29.0,84.0,57.0,752,10,01,  Karikor Dangi,27,99,9,50,18,49,21.4,15.3,26.9,00000
29.0,84.0,57.0,752,11,01,  Choto Barai Dangi,29,53,14,26,15,27,35.4,35.0,35.7,00000
29.0,84.0,57.0,752,12,01,  Babarchar Kacharirdangi,427,270,224,114,203,156,61.3,66.3,56.5,00000
29.0,84.0,57.0,752,13,01,  Babar Char Bazar,142,27,71,12,71,15,84.0,85.5,82.6,00000
29.0,84.0,57.0,752,14,01,  Mollardangi,314,537,136,247,178,290,36.9,35.5,38.0,00000
29.0,84.0,57.0,752,15,01,  Char Kumuria,639,520,321,224,318,296,55.1,58.9,51.8,00000
29.0,84.0,57.0,752,16,01,  Babur Char Khalasidangi,356,251,162,119,194,132,58.6,57.7,59.5,00000
29.0,84.0,76.0,184,01,01,  Jamalkhar Kandi,105,199,48,89,57,110,34.5,35.0,34.1,00000
29.0,84.0,76.0,184,02,01,  Sobandi Bepari Kandi,67,131,34,67,33,64,33.8,33.7,34.0,00000
29.0,84.0,76.0,184,03,01,  Wahed Mollar Kandi,43,153,20,78,23,75,21.9,20.4,23.5,00000
29.0,84.0,76.0,443,01,01,  Moroler Kandi,30,61,18,29,12,32,33.0,38.3,27.3,00000
29.0,84.0,76.0,443,03,01,  Ukil Kandi,6,92,4,45,2,47,6.1,8.2,4.1,00000
29.0,84.0,76.0,443,04,01,  Nuruddin Serder Kandi,41,70,22,27,19,43,36.9,44.9,30.6,00000
29.0,84.0,76.0,443,05,01,  Umedali Dewan Kandi,36,41,18,21,18,20,46.8,46.2,47.4,00000
29.0,84.0,76.0,443,06,01,  Inuddin Sikder Kandi,86,200,50,112,36,88,30.1,30.9,29.0,00000
29.0,84.0,76.0,484,01,01,  Shingher Kandi,20,118,8,56,12,62,14.5,12.5,16.2,00000
29.0,84.0,76.0,484,02,01,  Mulai Hazir Kandi,83,203,39,87,44,116,29.0,31.0,27.5,00000
29.0,84.0,76.0,484,03,01,  Momin Dhalir Kandi,41,119,12,50,29,69,25.6,19.4,29.6,00000
29.0,84.0,76.0,484,04,01,  Mahor Ali Sikderer Kandi,27,77,8,35,19,42,26.0,18.6,31.1,00000
29.0,84.0,76.0,484,05,01,  Mobarok Munshir Kandi,93,259,41,124,52,135,26.4,24.8,27.8,00000
29.0,84.0,76.0,484,06,01,  Chan Mia Munshir Kandi,62,168,24,98,38,70,27.0,19.7,35.2,00000
29.0,84.0,76.0,484,07,01,  Shadulla Beparir Kandi,24,51,13,26,11,25,32.0,33.3,30.6,00000
29.0,84.0,76.0,484,08,01,  Lalmia Sarker Kandi,69,161,43,79,26,82,30.0,35.2,24.1,00000
29.0,84.0,76.0,484,09,01,  Yeadali Munshir Kandi,20,90,11,53,9,37,18.2,17.2,19.6,00000
29.0,84.0,76.0,484,10,01,  Mohorali Hazir Kandi,61,134,28,71,33,63,31.3,28.3,34.4,00000
29.0,84.0,76.0,484,11,01,  Mohon Moroul Kandi,18,170,8,80,10,90,9.6,9.1,10.0,00000
29.0,84.0,76.0,484,12,01,  Choukider Kandi,30,61,11,24,19,37,33.0,31.4,33.9,00000
29.0,84.0,85.0,900,01,01,  Purba Shyampur,1916,1371,956,638,960,733,58.3,60.0,56.7,00000
29.0,84.0,85.0,900,02,01,  Paschim Shyampur,983,1006,457,495,526,511,49.4,48.0,50.7,00000
29.0,90.0,10.0,195,01,01,  Batorkanda,97,399,47,205,50,194,19.6,18.7,20.5,00000
29.0,90.0,10.0,195,02,01,  Sreekaltali,51,271,31,129,20,142,15.8,19.4,12.3,00000
29.0,90.0,10.0,195,03,01,  Chaulia,70,322,38,158,32,164,17.9,19.4,16.3,00000
29.0,90.0,11.0,062,01,01,  Char Ballabhdi,287,410,156,192,131,218,41.2,44.8,37.5,00000
29.0,90.0,11.0,062,02,01,  Kajir Ballabhdi,369,288,172,143,197,145,56.2,54.6,57.6,00000
29.0,90.0,11.0,062,03,01,  Royer Ballabhdi,173,193,84,89,89,104,47.3,48.6,46.1,00000
29.0,90.0,11.0,062,04,01,  Vhar Ballabhdi,166,343,82,172,84,171,32.6,32.3,32.9,00000
29.0,90.0,11.0,062,05,01,  Khalisha Ballabdi,99,182,57,84,42,98,35.2,40.4,30.0,00000
29.0,90.0,11.0,537,01,01,  Keshardia,43,80,23,44,20,36,35.0,34.3,35.7,00000
29.0,90.0,11.0,537,02,01,  Alampur,199,289,90,140,109,149,40.8,39.1,42.2,00000
29.0,90.0,11.0,766,01,01,  Gopinagar,102,208,56,96,46,112,32.9,36.8,29.1,00000
29.0,90.0,11.0,766,02,01,  Madhya Fulbaria,310,578,165,296,145,282,34.9,35.8,34.0,00000
29.0,90.0,11.0,766,03,01,  Uttar Fulbaria,312,179,158,86,154,93,63.5,64.8,62.3,00000
29.0,90.0,11.0,766,04,01,  Dakshin Fulbaria,98,345,50,160,48,185,22.1,23.8,20.6,00000
29.0,90.0,11.0,766,05,01,  Purba  Fulbaria,273,478,142,241,131,237,36.4,37.1,35.6,00000
29.0,90.0,11.0,766,06,01,  Baliar Char,145,205,65,101,80,104,41.4,39.2,43.5,00000
29.0,90.0,11.0,766,07,01,  Dealikanda,193,347,106,170,87,177,35.7,38.4,33.0,00000
29.0,90.0,11.0,766,08,01,  Pichnine,259,367,134,159,125,208,41.4,45.7,37.5,00000
29.0,90.0,16.0,262,01,03,  Goali Para,170,498,78,239,92,259,25.4,24.6,26.2,00000
29.0,90.0,16.0,262,02,03,  Sardar Para,69,67,33,38,36,29,50.7,46.5,55.4,00000
29.0,90.0,16.0,262,03,03,  Mridha Para,132,332,71,183,61,149,28.4,28.0,29.0,00000
29.0,90.0,16.0,262,04,03,  Durora,243,695,105,353,138,342,25.9,22.9,28.8,00000
29.0,90.0,16.0,262,05,03,  Sadhu Para,199,473,91,229,108,244,29.6,28.4,30.7,00000
29.0,90.0,16.0,262,06,03,  Namo Para,180,166,101,72,79,94,52.0,58.4,45.7,00000
29.0,90.0,16.0,262,07,03,  Bhadra Para,94,223,45,112,49,111,29.7,28.7,30.6,00000
29.0,90.0,16.0,262,08,03,  Salkha Para,478,396,237,190,241,206,54.7,55.5,53.9,00000
29.0,90.0,16.0,403,01,01,  Izarpara,285,552,127,284,158,268,34.1,30.9,37.1,00000
29.0,90.0,16.0,403,02,01,  Bhadra Para,231,471,98,230,133,241,32.9,29.9,35.6,00000
29.0,90.0,16.0,403,03,01,  Uttarpara,360,677,170,339,190,338,34.7,33.4,36.0,00000
29.0,90.0,16.0,403,04,01,  Naora Para,99,189,52,98,47,91,34.4,34.7,34.1,00000
29.0,90.0,16.0,403,05,01,  Apthopura,154,138,78,72,76,66,52.7,52.0,53.5,00000
29.0,90.0,16.0,499,01,01,  Danga Kamdia,120,287,53,135,67,152,29.5,28.2,30.6,00000
29.0,90.0,16.0,499,02,01,  Bhar Kamdia,125,520,44,239,81,281,19.4,15.5,22.4,00000
29.0,90.0,16.0,499,03,01,  Char Kamdia,90,224,32,119,58,105,28.7,21.2,35.6,00000
29.0,90.0,39.0,083,01,01,  Bara Lakshmandia,535,985,257,514,278,471,35.2,33.3,37.1,00000
29.0,90.0,39.0,083,02,01,  Kanthalbaria,325,548,184,264,141,284,37.2,41.1,33.2,00000
29.0,90.0,39.0,083,03,01,  Jogadanga,126,296,61,151,65,145,29.9,28.8,31.0,00000
29.0,90.0,39.0,083,04,01,  Khoda Lakhsmandia,204,242,94,121,110,121,45.7,43.7,47.6,00000
29.0,90.0,39.0,378,01,01,  Dahar Gatti,132,557,65,295,67,262,19.2,18.1,20.4,00000
29.0,90.0,39.0,378,02,01,  Katiar Gatti,302,205,181,105,121,100,59.6,63.3,54.8,00000
29.0,90.0,39.0,378,03,01,  Mirer Gatti,100,366,45,186,55,180,21.5,19.5,23.4,00000
29.0,90.0,39.0,378,04,01,  Kasba Gatti,323,207,181,101,142,106,60.9,64.2,57.3,00000
29.0,90.0,39.0,378,05,01,  Juna Gatti,178,268,103,138,75,130,39.9,42.7,36.6,00000
29.0,90.0,39.0,378,06,01,  Bagbari Gatti,139,113,69,53,70,60,55.2,56.6,53.8,00000
29.0,90.0,39.0,378,07,01,  Dariakandi Gatti,75,201,41,101,34,100,27.2,28.9,25.4,00000
29.0,90.0,39.0,811,01,01,  Rahut Para,104,272,55,125,49,147,27.7,30.6,25.0,00000
29.0,90.0,39.0,811,02,01,  Hatrasulpur,130,108,69,51,61,57,54.6,57.5,51.7,00000
29.0,90.0,44.0,420,01,01,  Jagannathdi,399,1014,193,499,206,515,28.2,27.9,28.6,00000
29.0,90.0,44.0,420,02,01,  Kumarkanda,335,151,141,73,194,78,68.9,65.9,71.3,00000
29.0,90.0,44.0,982,01,01,  Uzirpur,205,786,102,370,103,416,20.7,21.6,19.8,00000
29.0,90.0,44.0,982,02,01,  Shaduhati,190,514,98,256,92,258,27.0,27.7,26.3,00000
29.0,90.0,61.0,470,01,01,  Kagdi,648,1306,314,641,334,665,33.2,32.9,33.4,00000
29.0,90.0,61.0,470,02,01,  Sorjonkanda,200,461,104,236,96,225,30.3,30.6,29.9,00000
29.0,90.0,61.0,470,03,01,  Bathagram,267,790,126,404,141,386,25.3,23.8,26.8,00000
29.0,90.0,61.0,470,04,01,  Jogikanda,101,136,49,65,52,71,42.6,43.0,42.3,00000
29.0,90.0,61.0,470,05,01,  Podagudi,114,307,44,149,70,158,27.1,22.8,30.7,00000
29.0,90.0,61.0,470,06,01,  Chandakhala,152,340,85,157,67,183,30.9,35.1,26.8,00000
29.0,90.0,61.0,470,07,01,  Horerkanda,292,360,138,177,154,183,44.8,43.8,45.7,00000
29.0,90.0,78.0,049,01,01,  Chhota Bahirdia,733,881,387,476,346,405,45.4,44.8,46.1,00000
29.0,90.0,78.0,049,02,01,  Bara Bahirdia,751,712,420,363,331,349,51.3,53.6,48.7,00000
29.0,90.0,78.0,549,01,01,  Khalishadubi,81,272,34,127,47,145,22.9,21.1,24.5,00000
29.0,90.0,78.0,549,02,01,  Nidipatti,391,424,175,202,216,222,48.0,46.4,49.3,00000
29.0,90.0,78.0,620,01,01,  Uttar Madandia,112,212,52,98,60,114,34.6,34.7,34.5,00000
29.0,90.0,78.0,620,02,01,  Dakshin Madandia,132,175,63,83,69,92,43.0,43.2,42.9,00000
29.0,90.0,78.0,870,01,03,  Saltha Habeli,493,1173,228,581,265,592,29.6,28.2,30.9,00000
29.0,90.0,78.0,870,02,03,  Toyli Salthi,202,216,109,93,93,123,48.3,54.0,43.1,00000
29.0,90.0,89.0,070,01,01,  Bara Bangrail,392,905,166,447,226,458,30.2,27.1,33.0,00000
29.0,90.0,89.0,070,02,01,  Char Bangrail,333,514,158,250,175,264,39.3,38.7,39.9,00000
29.0,90.0,89.0,070,03,01,  Royer Char,478,705,229,352,249,353,40.4,39.4,41.4,00000
29.0,90.0,89.0,179,01,01,  Chandpur,379,549,190,264,189,285,40.8,41.9,39.9,00000
29.0,90.0,89.0,179,02,01,  Hoglakandi,206,202,87,102,119,100,50.5,46.0,54.3,00000
29.0,90.0,89.0,349,01,01,  Uttar Gopalia,363,489,163,277,200,212,42.6,37.0,48.5,00000
29.0,90.0,89.0,349,02,01,  Dakschin Gopalia,220,603,83,310,137,293,26.7,21.1,31.9,00000
29.0,90.0,89.0,462,01,01,  Jogardia,246,590,123,295,123,295,29.4,29.4,29.4,00000
29.0,90.0,89.0,462,02,01,  Rangardia,155,727,73,334,82,393,17.6,17.9,17.3,00000
72.0,4.0,11.0,173,01,01,  Chhayasi,324,285,163,140,161,145,53.2,53.8,52.6,00000
72.0,4.0,11.0,173,02,01,  Atrashi,131,115,63,58,68,57,53.3,52.1,54.4,00000
72.0,4.0,11.0,353,01,01,  Itakhola,290,635,154,324,136,311,31.4,32.2,30.4,00000
72.0,4.0,11.0,353,02,01,  Chak Para,21,202,10,103,11,99,9.4,8.8,10.0,00000
72.0,4.0,11.0,526,01,03,  Mobarakpur,1056,1157,553,588,503,569,47.7,48.5,46.9,00000
72.0,4.0,11.0,526,02,03,  Atpara,1029,688,546,318,483,370,59.9,63.2,56.6,00000
72.0,4.0,11.0,526,03,03,  Bakarpur,186,236,95,108,91,128,44.1,46.8,41.6,00000
72.0,4.0,11.0,526,04,03,  Mahishpur,217,219,114,121,103,98,49.8,48.5,51.2,00000
72.0,4.0,11.0,526,05,03,  Brajer Bazar,129,235,66,105,63,130,35.4,38.6,32.6,00000
72.0,4.0,11.0,699,01,01,  Panchgaj,314,441,137,207,177,234,41.6,39.8,43.1,00000
72.0,4.0,11.0,699,02,01,  Atikanda,184,513,92,239,92,274,26.4,27.8,25.1,00000
72.0,4.0,11.0,699,03,01,  Moharakanda,46,199,20,99,26,100,18.8,16.8,20.6,00000
72.0,4.0,35.0,201,01,01,  Deogaon,477,970,227,495,250,475,33.0,31.4,34.5,00000
72.0,4.0,35.0,201,02,01,  Mollik Nagar,276,337,141,169,135,168,45.0,45.5,44.6,00000
72.0,4.0,35.0,209,01,01,  Deogaon Gobindapur,343,449,174,211,169,238,43.3,45.2,41.5,00000
72.0,4.0,35.0,209,02,01,  Joynagar,162,212,78,106,84,106,43.3,42.4,44.2,00000
72.0,4.0,35.0,519,01,01,  Loneswar,309,663,182,288,127,375,31.8,38.7,25.3,00000
72.0,4.0,35.0,519,02,01,  Mirzapur,244,685,122,323,122,362,26.3,27.4,25.2,00000
72.0,4.0,35.0,800,01,01,  Ranigaon,156,219,85,101,71,118,41.6,45.7,37.6,00000
72.0,4.0,35.0,800,02,01,  Teli Para,179,250,92,115,87,135,41.7,44.4,39.2,00000
72.0,4.0,35.0,800,03,01,  Debipur,67,50,41,23,26,27,57.3,64.1,49.1,00000
72.0,4.0,47.0,475,01,01,  Kismatara,27,188,20,88,7,100,12.6,18.5,6.5,00000
72.0,4.0,47.0,475,02,01,  Aragoan,201,220,99,97,102,123,47.7,50.5,45.3,00000
72.0,4.0,47.0,735,01,01,  Pokhalgaon,331,500,176,243,155,257,39.8,42.0,37.6,00000
72.0,4.0,47.0,735,02,01,  Lakshmipur,209,204,107,93,102,111,50.6,53.5,47.9,00000
72.0,4.0,47.0,843,01,01,  Bhabanipur,98,317,58,149,40,168,23.6,28.0,19.2,00000
72.0,4.0,47.0,843,02,01,  Haripur,62,483,40,223,22,260,11.4,15.2,7.8,00000
72.0,4.0,47.0,843,03,01,  Sarmaisa,323,224,174,93,149,131,59.0,65.2,53.2,00000
72.0,4.0,47.0,843,04,01,  Ramjibanpur,165,365,86,176,79,189,31.1,32.8,29.5,00000
72.0,4.0,47.0,843,05,01,  Haripurkanda,103,376,59,199,44,177,21.5,22.9,19.9,00000
72.0,4.0,59.0,180,01,01,  Sukhari,404,968,203,477,201,491,29.4,29.9,29.0,00000
72.0,4.0,59.0,180,02,01,  Kulsree,297,613,151,322,146,291,32.6,31.9,33.4,00000
72.0,4.0,59.0,180,03,01,  Korardub,111,534,67,263,44,271,17.2,20.3,14.0,00000
72.0,4.0,59.0,180,04,01,  Dharma Roy,231,321,120,158,111,163,41.8,43.2,40.5,00000
72.0,4.0,59.0,994,01,01,  Balais,211,468,102,225,109,243,31.1,31.2,31.0,00000
72.0,4.0,59.0,994,02,01,  Sonakania,352,315,170,160,182,155,52.8,51.5,54.0,00000
72.0,4.0,71.0,129,01,01,  Bhartoshi,277,423,128,199,149,224,39.6,39.1,39.9,00000
72.0,4.0,71.0,129,02,01,  Khaliakhan,107,227,61,103,46,124,32.0,37.2,27.1,00000
72.0,4.0,71.0,129,03,01,  Darbespur,117,213,58,113,59,100,35.5,33.9,37.1,00000
72.0,4.0,71.0,317,01,01,  Guatala,457,1145,244,578,213,567,28.5,29.7,27.3,00000
72.0,4.0,71.0,317,02,01,  Baghbari,76,331,32,164,44,167,18.7,16.3,20.9,00000
72.0,4.0,71.0,338,01,01,  Ichhail,185,490,100,250,85,240,27.4,28.6,26.2,00000
72.0,4.0,71.0,338,02,01,  Shimultala,84,248,40,120,44,128,25.3,25.0,25.6,00000
72.0,4.0,71.0,558,01,01,  Mallikpur Sonai,749,1019,382,515,367,504,42.4,42.6,42.1,00000
72.0,4.0,71.0,558,02,01,  Megherkanda,301,480,135,228,166,252,38.5,37.2,39.7,00000
72.0,4.0,71.0,558,03,01,  Dashbaghia,175,175,89,94,86,81,50.0,48.6,51.5,00000
72.0,4.0,71.0,558,04,01,  Chandpur,265,425,124,202,141,223,38.4,38.0,38.7,00000
72.0,4.0,71.0,584,01,01,  Uttar Mansurpur,475,730,236,361,239,369,39.4,39.5,39.3,00000
72.0,4.0,71.0,584,02,01,  Dakshin Mansurpur,212,368,106,173,106,195,36.6,38.0,35.2,00000
72.0,4.0,71.0,958,01,01,  Swalpa Sonai,1015,1168,521,572,494,596,46.5,47.7,45.3,00000
72.0,4.0,71.0,958,02,01,  Boga Para,207,237,104,122,103,115,46.6,46.0,47.2,00000
72.0,4.0,83.0,144,01,01,  Bijoypur,479,538,252,268,227,270,47.1,48.5,45.7,00000
72.0,4.0,83.0,144,02,01,  Baliakandi,232,433,118,204,114,229,34.9,36.6,33.2,00000
72.0,4.0,83.0,793,01,01,  Ramsid,407,705,213,336,194,369,36.6,38.8,34.5,00000
72.0,4.0,83.0,793,02,01,  Benikanda,29,65,17,29,12,36,30.9,37.0,25.0,00000
72.0,4.0,83.0,951,01,01,  Swalpa Mangalsidha,159,361,95,166,64,195,30.6,36.4,24.7,00000
72.0,4.0,83.0,951,02,01,  Matikata,195,403,104,190,91,213,32.6,35.4,29.9,00000
72.0,4.0,83.0,951,03,01,  Goyalakanda,172,165,93,78,79,87,51.0,54.4,47.6,00000
72.0,4.0,83.0,951,04,01,  Sreedharpur,80,241,49,103,31,138,24.9,32.2,18.3,00000
72.0,4.0,83.0,951,05,01,  Para Rameshwarpur,73,91,40,31,33,60,44.5,56.3,35.5,00000
72.0,9.0,11.0,446,01,01,  Goral,361,569,194,278,167,291,38.8,41.1,36.5,00000
72.0,9.0,11.0,446,02,01,  Hautala,97,218,51,115,46,103,30.8,30.7,30.9,00000
72.0,9.0,11.0,476,01,01,  Hariatala,236,664,145,331,91,333,26.2,30.5,21.5,00000
72.0,9.0,11.0,476,02,01,  Sreerampur,88,681,47,358,41,323,11.4,11.6,11.3,00000
72.0,9.0,11.0,927,01,01,  Ujangaon,507,861,262,402,245,459,37.1,39.5,34.8,00000
72.0,9.0,11.0,927,02,01,  Baherkanda,157,537,84,274,73,263,22.6,23.5,21.7,00000
72.0,9.0,23.0,128,01,01,  Bari,652,754,327,361,325,393,46.4,47.5,45.3,00000
72.0,9.0,23.0,128,02,01,  Gobindapur,119,514,68,248,51,266,18.8,21.5,16.1,00000
72.0,9.0,23.0,128,03,01,  Joypur,88,127,38,60,50,67,40.9,38.8,42.7,00000
72.0,9.0,23.0,128,04,01,  Durgapur,245,454,127,216,118,238,35.1,37.0,33.1,00000
72.0,9.0,23.0,128,05,01,  Atitpur,350,602,187,293,163,309,36.8,39.0,34.5,00000
72.0,9.0,23.0,196,01,01,  Bikramsree,603,1117,306,564,297,553,35.1,35.2,34.9,00000
72.0,9.0,23.0,196,02,01,  Bakharpur,103,255,52,142,51,113,28.8,26.8,31.1,00000
72.0,9.0,23.0,196,03,01,  Saniya Para,56,218,32,107,24,111,20.4,23.0,17.8,00000
72.0,9.0,23.0,230,01,03,  Bri-Kalika,1031,800,525,379,506,421,56.3,58.1,54.6,00000
72.0,9.0,23.0,230,02,03,  Mahajan Para,109,63,55,37,54,26,63.4,59.8,67.5,00000
72.0,9.0,23.0,435,01,03,  Gobindapur,1164,335,591,155,573,180,77.7,79.2,76.1,00000
72.0,9.0,23.0,435,02,03,  Asma Bazar,387,38,205,16,182,22,91.1,92.8,89.2,00000
72.0,9.0,23.0,435,03,03,  Garma(Para Garem),396,169,201,67,195,102,70.1,75.0,65.7,00000
72.0,9.0,23.0,507,01,03,  Gopalpur,62,346,35,166,27,180,15.2,17.4,13.0,00000
72.0,9.0,23.0,507,02,03,  Gopalpur Bazar,1030,299,553,119,477,180,77.5,82.3,72.6,00000
72.0,9.0,23.0,507,03,03,  Garma,296,86,159,34,137,52,77.5,82.4,72.5,00000
72.0,9.0,23.0,507,04,03,  Gobindapur,64,73,33,42,31,31,46.7,44.0,50.0,00000
72.0,9.0,35.0,304,01,01,  Dasdhar,766,1913,408,903,358,1010,28.6,31.1,26.2,00000
72.0,9.0,35.0,304,02,01,  Saduyarkanda,389,630,194,296,195,334,38.2,39.6,36.9,00000
72.0,9.0,35.0,304,03,01,  Dabipur,193,334,83,141,110,193,36.6,37.1,36.3,00000
72.0,9.0,35.0,304,04,01,  Patanvita,58,38,31,11,27,27,60.4,73.8,50.0,00000
72.0,9.0,35.0,304,05,01,  Chanpur,378,548,182,267,196,281,40.8,40.5,41.1,00000
72.0,9.0,35.0,338,01,01,  Deopur,561,1195,259,589,302,606,31.9,30.5,33.3,00000
72.0,9.0,35.0,338,02,01,  Nutan Sekher Para,54,126,29,62,25,64,30.0,31.9,28.1,00000
72.0,9.0,35.0,480,01,01,  Harulia,283,594,148,291,135,303,32.3,33.7,30.8,00000
72.0,9.0,35.0,480,02,01,  Baniagati,9,93,3,41,6,52,8.8,6.8,10.3,00000
72.0,9.0,35.0,480,03,01,  Katiar Para,119,232,72,113,47,119,33.9,38.9,28.3,00000
72.0,9.0,35.0,480,04,01,  Kanijugni,14,31,12,13,2,18,31.1,48.0,10.0,00000
72.0,9.0,35.0,480,05,01,  Naya Para,34,380,17,175,17,205,8.2,8.9,7.7,00000
72.0,9.0,35.0,771,01,01,  Panchrukhi,141,21,75,10,66,11,87.0,88.2,85.7,00000
72.0,9.0,35.0,771,02,01,  Matikata,15,227,7,125,8,102,6.2,5.3,7.3,00000
72.0,9.0,35.0,798,01,01,  Premnagar,418,653,200,311,218,342,39.0,39.1,38.9,00000
72.0,9.0,35.0,798,02,01,  Sadurlawfa,72,251,41,135,31,116,22.3,23.3,21.1,00000
72.0,9.0,35.0,819,01,01,  Rambadhrapur,252,164,135,71,117,93,60.6,65.5,55.7,00000
72.0,9.0,35.0,819,02,01,  Derua,93,62,45,24,48,38,60.0,65.2,55.8,00000
72.0,9.0,35.0,819,03,01,  Chhalipura,312,414,150,196,162,218,43.0,43.4,42.6,00000
72.0,9.0,35.0,954,01,01,  Susang Dhobahala,110,463,58,218,52,245,19.2,21.0,17.5,00000
72.0,9.0,35.0,954,02,01,  Baravita,35,124,13,63,22,61,22.0,17.1,26.5,00000
72.0,9.0,47.0,054,01,01,  Bahadurpur,407,751,196,392,211,359,35.1,33.3,37.0,00000
72.0,9.0,47.0,054,02,01,  Khalikona,59,394,37,187,22,207,13.0,16.5,9.6,00000
72.0,9.0,47.0,074,01,01,  Nayagaon,154,171,79,78,75,93,47.4,50.3,44.6,00000
72.0,9.0,47.0,074,02,01,  Bamangaon,203,230,107,119,96,111,46.9,47.3,46.4,00000
72.0,9.0,47.0,175,01,01,  Bhatgaon,160,393,84,206,76,187,28.9,29.0,28.9,00000
72.0,9.0,47.0,175,02,01,  Kashabpur,73,89,36,41,37,48,45.1,46.8,43.5,00000
72.0,9.0,47.0,277,01,01,  Bade Chhiram,338,636,181,306,157,330,34.7,37.2,32.2,00000
72.0,9.0,47.0,277,02,01,  Khaikona,138,201,68,101,70,100,40.7,40.2,41.2,00000
72.0,9.0,47.0,277,03,01,  Sabadyabari,81,175,36,86,45,89,31.6,29.5,33.6,00000
72.0,9.0,47.0,277,04,01,  Ramarbari,94,382,53,199,41,183,19.7,21.0,18.3,00000
72.0,9.0,47.0,277,05,01,  Harirampur,43,186,23,88,20,98,18.8,20.7,16.9,00000
72.0,9.0,47.0,277,06,01,  Chhiram,552,1229,282,615,270,614,31.0,31.4,30.5,00000
72.0,9.0,47.0,717,01,01,  Balam,59,120,33,57,26,63,33.0,36.7,29.2,00000
72.0,9.0,47.0,717,02,01,  Chak Balam,93,235,50,114,43,121,28.4,30.5,26.2,00000
72.0,9.0,47.0,717,03,01,  Majh Para,107,286,53,149,54,137,27.2,26.2,28.3,00000
72.0,9.0,47.0,717,04,01,  Tarap Para,156,197,76,88,80,109,44.2,46.3,42.3,00000
72.0,9.0,47.0,717,05,01,  Purbapara,455,657,227,325,228,332,40.9,41.1,40.7,00000
72.0,9.0,47.0,866,01,01,  Kanda Para,124,225,57,125,67,100,35.5,31.3,40.1,00000
72.0,9.0,47.0,866,02,01,  Ramnagar,42,179,20,82,22,97,19.0,19.6,18.5,00000
72.0,9.0,47.0,866,03,01,  Nautana,67,229,37,116,30,113,22.6,24.2,21.0,00000
72.0,9.0,47.0,866,04,01,  Roymadhab,329,684,174,339,155,345,32.5,33.9,31.0,00000
72.0,9.0,59.0,236,01,01,  Challish Kahania,627,1170,303,585,324,585,34.9,34.1,35.6,00000
72.0,9.0,59.0,236,02,01,  Fakirer Bazar,364,102,193,43,171,59,78.1,81.8,74.3,00000
72.0,9.0,59.0,250,01,01,  Char Para,336,681,155,361,181,320,33.0,30.0,36.1,00000
72.0,9.0,59.0,250,02,01,  Fakirer Bazar,296,111,175,53,121,58,72.7,76.8,67.6,00000
72.0,9.0,59.0,250,03,01,  Sualmara,39,49,21,24,18,25,44.3,46.7,41.9,00000
72.0,9.0,59.0,250,04,01,  Rampur,298,553,158,269,140,284,35.0,37.0,33.0,00000
72.0,9.0,59.0,250,05,01,  Baluchara,79,102,40,54,39,48,43.6,42.6,44.8,00000
72.0,9.0,59.0,250,06,01,  Kanda Para,135,103,64,57,71,46,56.7,52.9,60.7,00000
72.0,9.0,59.0,250,07,01,  Chakua,231,634,118,312,113,322,26.7,27.4,26.0,00000
72.0,9.0,59.0,250,08,01,  Nagda Para,30,125,15,64,15,61,19.4,19.0,19.7,00000
72.0,9.0,59.0,250,09,01,  Chesrakanda,292,329,140,164,152,165,47.0,46.1,47.9,00000
72.0,9.0,59.0,250,10,01,  Ratnapur,61,219,28,108,33,111,21.8,20.6,22.9,00000
72.0,9.0,59.0,250,11,01,  Kamaruka,55,54,29,24,26,30,50.5,54.7,46.4,00000
72.0,9.0,59.0,250,12,01,  Char Kayrabkuri,20,69,10,35,10,34,22.5,22.2,22.7,00000
72.0,9.0,59.0,250,13,01,  Duani Chakua,6,60,4,27,2,33,9.1,12.9,5.7,00000
72.0,9.0,59.0,385,01,01,  Dudhkora,456,970,229,495,227,475,32.0,31.6,32.3,00000
72.0,9.0,59.0,385,02,01,  Bhanua Para,13,98,6,59,7,39,11.7,9.2,15.2,00000
72.0,9.0,59.0,548,01,01,  Jhawail,178,220,77,99,101,121,44.7,43.8,45.5,00000
72.0,9.0,59.0,548,02,01,  Nischintapur,206,104,114,49,92,55,66.5,69.9,62.6,00000
72.0,9.0,59.0,785,01,01,  Pichhail,55,189,27,93,28,96,22.5,22.5,22.6,00000
72.0,9.0,59.0,785,02,01,  Naya Para,89,447,37,219,52,228,16.6,14.5,18.6,00000
72.0,9.0,59.0,873,01,01,  Roypur,374,281,209,112,165,169,57.1,65.1,49.4,00000
72.0,9.0,59.0,873,02,01,  Lama Para,470,416,222,200,248,216,53.0,52.6,53.4,00000
72.0,9.0,59.0,873,03,01,  Naya Para,138,289,72,138,66,151,32.3,34.3,30.4,00000
72.0,9.0,59.0,873,04,01,  Ora Dighi,133,286,66,150,67,136,31.7,30.6,33.0,00000
72.0,9.0,59.0,873,05,01,  Baradala,27,60,11,37,16,23,31.0,22.9,41.0,00000
72.0,9.0,59.0,873,06,01,  Balochara,196,209,98,120,98,89,48.4,45.0,52.4,00000
72.0,9.0,59.0,873,07,01,  Mandertala,68,97,30,42,38,55,41.2,41.7,40.9,00000
72.0,9.0,59.0,994,01,01,  Tilsindur,208,661,110,342,98,319,23.9,24.3,23.5,00000
72.0,9.0,59.0,994,02,01,  Khoralda,66,171,35,75,31,96,27.8,31.8,24.4,00000
72.0,9.0,71.0,331,01,01,  Uttar Demura,345,562,173,273,172,289,38.0,38.8,37.3,00000
72.0,9.0,71.0,331,02,01,  Dakshin Demura,728,977,364,513,364,464,42.7,41.5,44.0,00000
72.0,9.0,71.0,345,01,01,  Deuli,343,539,198,236,145,303,38.9,45.6,32.4,00000
72.0,9.0,71.0,345,02,01,  Shimul Para,32,177,19,86,13,91,15.3,18.1,12.5,00000
72.0,9.0,71.0,345,03,01,  Purba Baisdar,81,332,47,174,34,158,19.6,21.3,17.7,00000
72.0,9.0,71.0,345,04,01,  Kadam Deuli,283,382,144,192,139,190,42.6,42.9,42.2,00000
72.0,9.0,71.0,345,06,01,  Salipura,221,442,97,217,124,225,33.3,30.9,35.5,00000
72.0,9.0,71.0,345,07,01,  Char Para,93,190,42,98,51,92,32.9,30.0,35.7,00000
72.0,9.0,71.0,351,01,01,  Dhala Para,159,307,71,146,88,161,34.1,32.7,35.3,00000
72.0,9.0,71.0,351,02,01,  Shalnagar,40,266,24,127,16,139,13.1,15.9,10.3,00000
72.0,9.0,71.0,351,03,01,  Patli,220,292,102,150,118,142,43.0,40.5,45.4,00000
72.0,9.0,71.0,494,01,01,  Hiluchia,282,367,142,169,140,198,43.5,45.7,41.4,00000
72.0,9.0,71.0,494,02,01,  Kumar Para,83,190,51,100,32,90,30.4,33.8,26.2,00000
72.0,9.0,71.0,893,01,01,  Sahata,852,1397,408,680,444,717,37.9,37.5,38.2,00000
72.0,9.0,71.0,893,02,01,  Sabaniakanda,162,425,86,207,76,218,27.6,29.4,25.9,00000
72.0,9.0,71.0,967,01,01,  Swalpa Dashal,364,684,164,344,200,340,34.7,32.3,37.0,00000
72.0,9.0,71.0,967,02,01,  Kash Para,68,516,37,261,31,255,11.6,12.4,10.8,00000
72.0,9.0,83.0,582,01,01,  Kakura,169,125,86,59,83,66,57.5,59.3,55.7,00000
72.0,9.0,83.0,582,02,01,  Burakhali,302,633,166,345,136,288,32.3,32.5,32.1,00000
72.0,9.0,83.0,656,01,01,  Mallikpur,512,1017,270,492,242,525,33.5,35.4,31.6,00000
72.0,9.0,83.0,656,02,01,  Char Mallikpur,161,182,81,95,80,87,46.9,46.0,47.9,00000
72.0,9.0,83.0,825,01,01,  Ramer Geria,139,176,68,88,71,88,44.1,43.6,44.7,00000
72.0,9.0,83.0,825,02,01,  Ashial,281,528,158,249,123,279,34.7,38.8,30.6,00000
72.0,9.0,83.0,934,01,01,  Singdha,282,492,149,243,133,249,36.4,38.0,34.8,00000
72.0,9.0,83.0,934,02,01,  Char Singdha,95,242,54,110,41,132,28.2,32.9,23.7,00000
72.0,9.0,83.0,934,03,01,  Baritpur,87,81,49,39,38,42,51.8,55.7,47.5,00000
72.0,9.0,83.0,934,04,01,  Nurullar Char,212,579,117,284,95,295,26.8,29.2,24.4,00000
72.0,9.0,83.0,934,05,01,  Sunullar Char,88,263,38,131,50,132,25.1,22.5,27.5,00000
72.0,9.0,83.0,934,06,01,  Dhirendrapur,107,143,56,59,51,84,42.8,48.7,37.8,00000
72.0,9.0,83.0,934,07,01,  Joalbhanga,144,173,80,85,64,88,45.4,48.5,42.1,00000
72.0,9.0,83.0,934,08,01,  Madarpur,30,49,17,25,13,24,38.0,40.5,35.1,00000
72.0,9.0,83.0,934,09,01,  Batia Para,202,209,95,102,107,107,49.1,48.2,50.0,00000
72.0,9.0,83.0,934,10,01,  Chandpur,138,219,82,103,56,116,38.7,44.3,32.6,00000
72.0,9.0,83.0,934,11,01,  Baingla,117,167,65,75,52,92,41.2,46.4,36.1,00000
72.0,9.0,83.0,934,12,01,  Babnikona,144,180,69,84,75,96,44.4,45.1,43.9,00000
72.0,18.0,12.0,058,01,01,  Paschim Bakaljora,260,620,125,325,135,295,29.5,27.8,31.4,00000
72.0,18.0,12.0,058,02,01,  Purba Bakaljora,131,242,64,124,67,118,35.1,34.0,36.2,00000
72.0,18.0,12.0,058,03,01,  Gopatia Para,102,103,53,47,49,56,49.8,53.0,46.7,00000
72.0,18.0,12.0,058,04,01,  Chakerkanda,146,322,87,144,59,178,31.2,37.7,24.9,00000
72.0,18.0,12.0,058,05,01,  Sariadahar,60,147,31,77,29,70,29.0,28.7,29.3,00000
72.0,18.0,12.0,067,01,01,  Balichanda,136,76,76,34,60,42,64.2,69.1,58.8,00000
72.0,18.0,12.0,067,02,01,  Kachuhali,119,154,49,69,70,85,43.6,41.5,45.2,00000
72.0,18.0,12.0,067,03,01,  Kanda Para,30,100,14,54,16,46,23.1,20.6,25.8,00000
72.0,18.0,12.0,067,04,01,  Pachh Balichanda,138,197,58,109,80,88,41.2,34.7,47.6,00000
72.0,18.0,12.0,067,05,01,  Ag Balichanda,111,110,64,50,47,60,50.2,56.1,43.9,00000
72.0,18.0,12.0,067,06,01,  Bander Para,60,61,39,31,21,30,49.6,55.7,41.2,00000
72.0,18.0,12.0,067,07,01,  Char Para,71,87,43,40,28,47,44.9,51.8,37.3,00000
72.0,18.0,12.0,208,01,01,  Uttar Charigaon Para,341,680,167,326,174,354,33.4,33.9,33.0,00000
72.0,18.0,12.0,208,02,01,  Dakshin Charigaon Para,160,413,82,192,78,221,27.9,29.9,26.1,00000
72.0,18.0,12.0,223,01,01,  Uttar Chhota Katuri,181,397,94,184,87,213,31.3,33.8,29.0,00000
72.0,18.0,12.0,223,02,01,  Dakshin Chhota Katuri,296,546,159,281,137,265,35.2,36.1,34.1,00000
72.0,18.0,12.0,381,01,01,  Patli,281,459,142,234,139,225,38.0,37.8,38.2,00000
72.0,18.0,12.0,381,02,01,  Gabhauta,275,174,132,82,143,92,61.2,61.7,60.9,00000
72.0,18.0,12.0,381,03,01,  Ramer Dighirpar,19,24,9,13,10,11,44.2,40.9,47.6,00000
72.0,18.0,12.0,431,01,01,  Gojirkona,246,615,123,309,123,306,28.6,28.5,28.7,00000
72.0,18.0,12.0,431,02,01,  Nurikhalirpar,137,290,71,135,66,155,32.1,34.5,29.9,00000
72.0,18.0,12.0,431,03,01,  Paschim Gojirkona,253,220,132,100,121,120,53.5,56.9,50.2,00000
72.0,18.0,12.0,431,04,01,  Chamarjani,88,273,48,132,40,141,24.4,26.7,22.1,00000
72.0,18.0,12.0,563,01,01,  Ketra,178,231,97,106,81,125,43.5,47.8,39.3,00000
72.0,18.0,12.0,563,02,01,  Madurpar,177,417,91,209,86,208,29.8,30.3,29.3,00000
72.0,18.0,12.0,563,03,01,  Shangsha,64,478,32,234,32,244,11.8,12.0,11.6,00000
72.0,18.0,12.0,747,01,01,  Paik Para,67,69,33,28,34,41,49.3,54.1,45.3,00000
72.0,18.0,12.0,747,02,01,  Goyesh Khalerpar,45,131,26,76,19,55,25.6,25.5,25.7,00000
72.0,18.0,12.0,747,03,01,  Kauniakanda,231,223,122,104,109,119,50.9,54.0,47.8,00000
72.0,18.0,12.0,747,04,01,  Nallarpar,130,109,71,55,59,54,54.4,56.3,52.2,00000
72.0,18.0,12.0,747,05,01,  Purba Paik Para,257,463,127,206,130,257,35.7,38.1,33.6,00000
72.0,18.0,12.0,829,01,01,  Ramnagar,344,319,205,132,139,187,51.9,60.8,42.6,00000
72.0,18.0,12.0,829,02,01,  Naya Para,188,146,100,60,88,86,56.3,62.5,50.6,00000
72.0,18.0,12.0,829,03,01,  Kakjor,211,460,103,236,108,224,31.4,30.4,32.5,00000
72.0,18.0,12.0,829,04,01,  Bhekbhokra,60,218,34,113,26,105,21.6,23.1,19.8,00000
72.0,18.0,12.0,829,05,01,  Poradahar,152,72,72,33,80,39,67.9,68.6,67.2,00000
72.0,18.0,12.0,878,01,01,  Uttar Saluakanda,153,159,68,84,85,75,49.0,44.7,53.1,00000
72.0,18.0,12.0,878,02,01,  Dakshin Saluaknada,153,290,67,144,86,146,34.5,31.8,37.1,00000
72.0,18.0,12.0,878,03,01,  Kalipur,108,289,49,151,59,138,27.2,24.5,29.9,00000
72.0,18.0,12.0,927,01,01,  Marala,493,543,235,260,258,283,47.6,47.5,47.7,00000
72.0,18.0,12.0,927,02,01,  Mangalbaria,176,280,78,148,98,132,38.6,34.5,42.6,00000
72.0,18.0,12.0,927,03,01,  Dakshin Sreeramkhila,223,299,105,141,118,158,42.7,42.7,42.8,00000
72.0,18.0,12.0,927,04,01,  Joynagar,159,197,68,104,91,93,44.7,39.5,49.5,00000
72.0,18.0,25.0,873,01,01,  Sakhaia,273,774,152,368,121,406,26.1,29.2,23.0,00000
72.0,18.0,25.0,873,02,01,  Chandigarh,575,1057,282,533,293,524,35.2,34.6,35.9,00000
72.0,18.0,51.0,140,01,03,  Bhabanipur,205,146,118,62,87,84,58.4,65.6,50.9,00000
72.0,18.0,51.0,140,02,03,  Badambari,53,66,28,35,25,31,44.5,44.4,44.6,00000
72.0,18.0,51.0,203,01,01,  Charia,299,712,147,349,152,363,29.6,29.6,29.5,00000
72.0,18.0,51.0,203,02,01,  Maskanda,207,398,96,194,111,204,34.2,33.1,35.2,00000
72.0,18.0,51.0,271,01,01,  Dashal,209,386,97,198,112,188,35.1,32.9,37.3,00000
72.0,18.0,51.0,271,02,01,  Thakur Barikanda,181,336,87,174,94,162,35.0,33.3,36.7,00000
72.0,18.0,51.0,330,01,03,  Chak Langura,276,745,141,382,135,363,27.0,27.0,27.1,00000
72.0,18.0,51.0,330,02,03,  Madhya Bagan,189,167,84,77,105,90,53.1,52.2,53.8,00000
72.0,18.0,51.0,330,03,03,  Sadhu Para,65,9,37,3,28,6,87.8,92.5,82.4,00000
72.0,18.0,51.0,606,01,01,  Lakshmipur,412,768,191,390,221,378,34.9,32.9,36.9,00000
72.0,18.0,51.0,606,02,01,  Kalikapur,436,575,195,275,241,300,43.1,41.5,44.5,00000
72.0,18.0,51.0,606,03,01,  Bharatpur,301,388,145,196,156,192,43.7,42.5,44.8,00000
72.0,18.0,51.0,606,04,01,  Kamarkhali,13,37,5,15,8,22,26.0,25.0,26.7,00000
72.0,18.0,51.0,606,05,01,  Shyamnagar,124,86,68,33,56,53,59.0,67.3,51.4,00000
72.0,18.0,51.0,669,01,01,  Menkifanda,242,513,119,250,123,263,32.1,32.2,31.9,00000
72.0,18.0,51.0,669,02,01,  Nalua Para,511,770,235,385,276,385,39.9,37.9,41.8,00000
72.0,18.0,51.0,669,03,01,  Konakanda,312,806,131,408,181,398,27.9,24.3,31.3,00000
72.0,18.0,51.0,669,04,01,  Kandapara,323,682,155,330,168,352,32.1,32.0,32.3,00000
72.0,18.0,51.0,965,01,01,  Thausal Para,112,101,58,48,54,53,52.6,54.7,50.5,00000
72.0,18.0,51.0,965,02,01,  Agar Para,236,375,112,186,124,189,38.6,37.6,39.6,00000
72.0,18.0,69.0,145,01,01,  Bhadua,436,1717,237,823,199,894,20.3,22.4,18.2,00000
72.0,18.0,69.0,145,02,01,  Bandua Ushan,351,1148,192,549,159,599,23.4,25.9,21.0,00000
72.0,18.0,69.0,145,03,01,  Uttar Naodara,88,362,45,177,43,185,19.6,20.3,18.9,00000
72.0,18.0,69.0,145,04,01,  Dakshin Naodara,97,287,55,147,42,140,25.3,27.2,23.1,00000
72.0,18.0,69.0,257,01,01,  Dakshin Sankarpur,554,696,292,315,262,381,44.3,48.1,40.7,00000
72.0,18.0,69.0,257,02,01,  Sreepur,391,876,194,466,197,410,30.9,29.4,32.5,00000
72.0,18.0,69.0,257,03,01,  Adampur,112,402,54,204,58,198,21.8,20.9,22.7,00000
72.0,18.0,69.0,315,01,01,  Dubrajpur,525,593,269,305,256,288,47.0,46.9,47.1,00000
72.0,18.0,69.0,315,02,01,  Shahapur,192,227,118,109,74,118,45.8,52.0,38.5,00000
72.0,18.0,69.0,315,03,01,  Krishnapur,111,107,56,52,55,55,50.9,51.9,50.0,00000
72.0,18.0,69.0,368,01,01,  Goakandia,870,1050,437,503,433,547,45.3,46.5,44.2,00000
72.0,18.0,69.0,368,02,01,  Jagir Para,720,896,377,428,343,468,44.6,46.8,42.3,00000
72.0,18.0,69.0,368,03,01,  Gorakhalikanda,390,1133,190,581,200,552,25.6,24.6,26.6,00000
72.0,18.0,69.0,368,04,01,  Jangaliakanda,340,580,173,296,167,284,37.0,36.9,37.0,00000
72.0,18.0,69.0,368,05,01,  Hatimarakanda,198,278,104,131,94,147,41.6,44.3,39.0,00000
72.0,18.0,69.0,368,06,01,  Kanda Para,186,378,92,164,94,214,33.0,35.9,30.5,00000
72.0,18.0,77.0,097,01,01,  Bara Batta,499,806,244,383,255,423,38.2,38.9,37.6,00000
72.0,18.0,77.0,097,02,01,  Chak Para,253,220,129,100,124,120,53.5,56.3,50.8,00000
72.0,18.0,77.0,097,03,01,  Titarjan,192,485,81,261,111,224,28.4,23.7,33.1,00000
72.0,18.0,77.0,242,01,01,  Lakshmipur,704,595,325,290,379,305,54.2,52.8,55.4,00000
72.0,18.0,77.0,242,02,01,  Shantipur,330,935,180,448,150,487,26.1,28.7,23.5,00000
72.0,18.0,77.0,291,01,01,  Deotukan,209,517,98,262,111,255,28.8,27.2,30.3,00000
72.0,18.0,77.0,291,02,01,  Kailati,300,340,146,160,154,180,46.9,47.7,46.1,00000
72.0,18.0,77.0,451,01,01,  Krishner Char,639,1182,323,578,316,604,35.1,35.8,34.3,00000
72.0,18.0,77.0,451,02,01,  Indrapur,486,772,245,393,241,379,38.6,38.4,38.9,00000
72.0,18.0,77.0,451,03,01,  Durgashram,132,405,61,206,71,199,24.6,22.8,26.3,00000
72.0,18.0,77.0,480,01,01,  Jhanjail,1264,881,679,423,585,458,58.9,61.6,56.1,00000
72.0,18.0,77.0,480,02,01,  Shuknakuri,196,677,90,340,106,337,22.5,20.9,23.9,00000
72.0,18.0,77.0,480,03,01,  Shalti Para,85,249,35,132,50,117,25.4,21.0,29.9,00000
72.0,18.0,77.0,480,04,01,  Sharishtala,45,229,21,114,24,115,16.4,15.6,17.3,00000
72.0,18.0,77.0,480,05,01,  Rambari,229,762,113,386,116,376,23.1,22.6,23.6,00000
72.0,18.0,77.0,495,01,01,  Kakairgara,321,424,151,188,170,236,43.1,44.5,41.9,00000
72.0,18.0,77.0,495,02,01,  Purba Kakair Gara,352,512,188,219,164,293,40.7,46.2,35.9,00000
72.0,18.0,77.0,495,03,01,  Nandir Chak,77,195,47,90,30,105,28.3,34.3,22.2,00000
72.0,18.0,77.0,495,04,01,  Atka Para,198,242,103,121,95,121,45.0,46.0,44.0,00000
72.0,18.0,77.0,495,05,01,  Bilaspur,644,1030,333,493,311,537,38.5,40.3,36.7,00000
72.0,18.0,77.0,495,06,01,  Purba Bilaspur,121,736,61,373,60,363,14.1,14.1,14.2,00000
72.0,18.0,77.0,495,07,01,  Gopalpur,72,600,31,289,41,311,10.7,9.7,11.6,00000
72.0,18.0,77.0,495,08,01,  Nagpur,414,748,198,366,216,382,35.6,35.1,36.1,00000
72.0,18.0,77.0,495,09,01,  Khanua,149,205,68,99,81,106,42.1,40.7,43.3,00000
72.0,18.0,77.0,496,01,01,  Godaria,716,899,377,441,339,458,44.3,46.1,42.5,00000
72.0,18.0,77.0,496,02,01,  Pukuriakanda,380,616,197,281,183,335,38.2,41.2,35.3,00000
72.0,18.0,77.0,496,03,01,  Bandshansha,239,280,110,138,129,142,46.1,44.4,47.6,00000
72.0,18.0,77.0,496,04,01,  Gopinathpur,122,96,59,47,63,49,56.0,55.7,56.3,00000
72.0,18.0,77.0,496,05,01,  Kulonja,649,949,326,491,323,458,40.6,39.9,41.4,00000
72.0,18.0,77.0,496,06,01,  Rowanikanda,39,319,17,160,22,159,10.9,9.6,12.2,00000
72.0,38.0,13.0,282,01,01,  Daudpur,247,257,135,127,112,130,49.0,51.5,46.3,00000
72.0,38.0,13.0,282,02,01,  Gobindapur,41,161,22,90,19,71,20.3,19.6,21.1,00000
72.0,38.0,13.0,371,01,01,  Hatila,163,453,76,239,87,214,26.5,24.1,28.9,00000
72.0,38.0,13.0,371,02,01,  Hararkandi,292,992,167,498,125,494,22.7,25.1,20.2,00000
72.0,38.0,13.0,876,01,01,  Ranichapur,257,717,148,369,109,348,26.4,28.6,23.9,00000
72.0,38.0,13.0,876,02,01,  Fotua,231,917,118,488,113,429,20.1,19.5,20.8,00000
72.0,38.0,13.0,876,03,01,  Faridpur,284,910,162,452,122,458,23.8,26.4,21.0,00000
72.0,38.0,13.0,905,01,01,  Saldigha,761,1169,435,556,326,613,39.4,43.9,34.7,00000
72.0,38.0,13.0,905,02,01,  Rajibpur,148,373,85,164,63,209,28.4,34.1,23.2,00000
72.0,38.0,27.0,341,01,01,  Gazipur,172,670,95,341,77,329,20.4,21.8,19.0,00000
72.0,38.0,27.0,341,02,01,  Daudpur,194,390,97,212,97,178,33.2,31.4,35.3,00000
72.0,38.0,40.0,029,01,01,  Adaura,180,130,94,58,86,72,58.1,61.8,54.4,00000
72.0,38.0,40.0,029,02,01,  Muzibnager,52,410,28,200,24,210,11.3,12.3,10.3,00000
72.0,38.0,40.0,267,01,01,  Chandpur,193,458,102,211,91,247,29.6,32.6,26.9,00000
72.0,38.0,40.0,267,02,01,  Monirampur/Dinajpur,128,350,73,174,55,176,26.8,29.6,23.8,00000
72.0,38.0,40.0,297,01,01,  Durlabhpur,88,435,53,217,35,218,16.8,19.6,13.8,00000
72.0,38.0,40.0,297,02,01,  Prasadpur,78,319,44,154,34,165,19.6,22.2,17.1,00000
72.0,38.0,40.0,504,01,01,  Kadirpur,193,350,106,185,87,165,35.5,36.4,34.5,00000
72.0,38.0,40.0,504,02,01,  Royail,322,326,169,184,153,142,49.7,47.9,51.9,00000
72.0,38.0,54.0,742,01,01,  Beri Daulatpur,62,248,31,132,31,116,20.0,19.0,21.1,00000
72.0,38.0,54.0,742,02,01,  Zaherpur,53,780,37,386,16,394,6.4,8.7,3.9,00000
72.0,38.0,54.0,787,01,01,  Nazirpur,191,461,114,229,77,232,29.3,33.2,24.9,00000
72.0,38.0,54.0,787,02,01,  Muradpur,271,403,142,206,129,197,40.2,40.8,39.6,00000
72.0,38.0,54.0,935,01,01,  Shibpur,325,195,187,94,138,101,62.5,66.5,57.7,00000
72.0,38.0,54.0,935,02,01,  Muslimpur,267,890,153,443,114,447,23.1,25.7,20.3,00000
72.0,38.0,67.0,460,01,01,  Jagannathpur,1335,3642,760,1792,575,1850,26.8,29.8,23.7,00000
72.0,38.0,67.0,460,02,01,  Rosul Pur,91,789,53,416,38,373,10.3,11.3,9.2,00000
72.0,38.0,67.0,579,01,01,  Khala Para,312,1024,171,505,141,519,23.4,25.3,21.4,00000
72.0,38.0,67.0,579,02,01,  Banuary,70,182,40,85,30,97,27.8,32.0,23.6,00000
72.0,38.0,81.0,014,01,01,  Adampur,123,449,67,216,56,233,21.5,23.7,19.4,00000
72.0,38.0,81.0,014,02,01,  Goalbari,182,509,99,249,83,260,26.3,28.4,24.2,00000
72.0,38.0,81.0,326,01,01,  Gandamara,315,147,147,71,168,76,68.2,67.4,68.9,00000
72.0,38.0,81.0,326,02,01,  Panchgachhia,141,306,74,166,67,140,31.5,30.8,32.4,00000
72.0,38.0,81.0,356,01,01,  Habibpur,61,97,40,44,21,53,38.6,47.6,28.4,00000
72.0,38.0,81.0,356,02,01,  Udau Pur,114,26,60,14,54,12,81.4,81.1,81.8,00000
72.0,38.0,81.0,602,01,01,  Khushalpur,225,202,115,85,110,117,52.7,57.5,48.5,00000
72.0,38.0,81.0,602,02,01,  Chandpur,144,361,84,160,60,201,28.5,34.4,23.0,00000
72.0,38.0,81.0,994,01,01,  Tatia,64,467,39,228,25,239,12.1,14.6,9.5,00000
72.0,38.0,81.0,994,02,01,  Noagaon,365,455,164,225,201,230,44.5,42.2,46.6,00000
72.0,40.0,11.0,033,01,01,  Baghsatra,276,731,142,362,134,369,27.4,28.2,26.6,00000
72.0,40.0,11.0,033,02,01,  Udaypur,36,86,24,37,12,49,29.5,39.3,19.7,00000
72.0,40.0,11.0,083,01,01,  Bara Kharpan,689,1240,352,610,337,630,35.7,36.6,34.9,00000
72.0,40.0,11.0,083,02,01,  Parilakul,196,344,91,171,105,173,36.3,34.7,37.8,00000
72.0,40.0,11.0,133,01,01,  Dakshin Baushari,206,344,112,177,94,167,37.5,38.8,36.0,00000
72.0,40.0,11.0,133,02,01,  Rajnagar,98,316,46,176,52,140,23.7,20.7,27.1,00000
72.0,40.0,11.0,261,01,01,  Chauhatta,241,764,117,375,124,389,24.0,23.8,24.2,00000
72.0,40.0,11.0,261,02,01,  Khariakakandi,137,299,78,122,59,177,31.4,39.0,25.0,00000
72.0,40.0,11.0,261,03,01,  Keshabpur,371,706,189,330,182,376,34.4,36.4,32.6,00000
72.0,40.0,11.0,263,01,01,  Uttar Chemti,75,197,32,101,43,96,27.6,24.1,30.9,00000
72.0,40.0,11.0,263,02,01,  Dakshin Chemti,248,246,118,137,130,109,50.2,46.3,54.4,00000
72.0,40.0,11.0,444,01,01,  Hailati,190,347,86,178,104,169,35.4,32.6,38.1,00000
72.0,40.0,11.0,444,02,01,  Mulirika,114,234,62,102,52,132,32.8,37.8,28.3,00000
72.0,40.0,11.0,822,01,01,  Putika,253,556,122,280,131,276,31.3,30.3,32.2,00000
72.0,40.0,11.0,822,02,01,  Bishara,294,371,169,176,125,195,44.2,49.0,39.1,00000
72.0,40.0,11.0,861,01,01,  Ranagaon,169,342,87,163,82,179,33.1,34.8,31.4,00000
72.0,40.0,11.0,861,02,01,  Gaypur,79,233,42,125,37,108,25.3,25.1,25.5,00000
72.0,40.0,23.0,177,01,01,  Bishampur,704,898,347,452,357,446,43.9,43.4,44.5,00000
72.0,40.0,23.0,177,02,01,  Bishampur Andaura,29,321,16,153,13,168,8.3,9.5,7.2,00000
72.0,40.0,23.0,177,03,01,  Shyampur,264,691,127,351,137,340,27.6,26.6,28.7,00000
72.0,40.0,35.0,105,01,01,  Baramara,93,496,60,236,33,260,15.8,20.3,11.3,00000
72.0,40.0,35.0,105,02,01,  Charikum Para,111,280,66,130,45,150,28.4,33.7,23.1,00000
72.0,40.0,35.0,105,03,01,  Nagani Para,175,322,109,146,66,176,35.2,42.7,27.3,00000
72.0,40.0,35.0,105,04,01,  Hindu Chak Para,86,170,55,66,31,104,33.6,45.5,23.0,00000
72.0,40.0,35.0,188,01,01,  Bishara,85,431,40,220,45,211,16.5,15.4,17.6,00000
72.0,40.0,35.0,188,02,01,  Duariakona,351,505,200,247,151,258,41.0,44.7,36.9,00000
72.0,40.0,35.0,194,01,01,  Ghilachauka,206,651,110,327,96,324,24.0,25.2,22.9,00000
72.0,40.0,35.0,194,02,01,  Kanchanpur,67,278,27,137,40,141,19.4,16.5,22.1,00000
72.0,40.0,35.0,194,03,01,  Bishar Pasha,728,397,381,189,347,208,64.7,66.8,62.5,00000
72.0,40.0,35.0,211,01,01,  Chamarjani,243,280,123,132,120,148,46.5,48.2,44.8,00000
72.0,40.0,35.0,211,02,01,  Gopir Para,73,104,32,54,41,50,41.2,37.2,45.1,00000
72.0,40.0,35.0,222,01,03,  Chandpur,1495,1000,784,489,711,511,59.9,61.6,58.2,00000
72.0,40.0,35.0,222,02,03,  Nayagaon,123,344,68,159,55,185,26.3,30.0,22.9,00000
72.0,40.0,35.0,222,03,03,  Rajapur,279,759,126,386,153,373,26.9,24.6,29.1,00000
72.0,40.0,35.0,222,04,03,  Chatragpur,834,767,430,353,404,414,52.1,54.9,49.4,00000
72.0,40.0,35.0,222,05,03,  Juzakulia,240,474,125,221,115,253,33.6,36.1,31.3,00000
72.0,40.0,35.0,222,06,03,  Ghosh Para,655,548,337,263,318,285,54.4,56.2,52.7,00000
72.0,40.0,35.0,300,01,01,  Chinahala,286,437,146,225,140,212,39.6,39.4,39.8,00000
72.0,40.0,35.0,300,02,01,  Anandapur,214,227,121,109,93,118,48.5,52.6,44.1,00000
72.0,40.0,35.0,355,01,01,  Chhota Dubiarkona,122,262,65,127,57,135,31.8,33.9,29.7,00000
72.0,40.0,35.0,355,02,01,  Bara Dubiarkona,138,215,56,108,82,107,39.1,34.1,43.4,00000
72.0,40.0,35.0,461,01,01,  Harindhara,244,171,123,75,121,96,58.8,62.1,55.8,00000
72.0,40.0,35.0,461,02,01,  Nagdra,102,150,49,70,53,80,40.5,41.2,39.8,00000
72.0,40.0,35.0,461,03,01,  Raghurampur,274,521,134,256,140,265,34.5,34.4,34.6,00000
72.0,40.0,35.0,511,01,01,  Isabpur,355,337,191,164,164,173,51.3,53.8,48.7,00000
72.0,40.0,35.0,511,02,01,  Ibrahimpur,105,155,67,65,38,90,40.4,50.8,29.7,00000
72.0,40.0,35.0,572,01,01,  Kalihala,157,775,74,378,83,397,16.8,16.4,17.3,00000
72.0,40.0,35.0,572,02,01,  Kayrakhali,41,224,23,111,18,113,15.5,17.2,13.7,00000
72.0,40.0,35.0,572,03,01,  Chak Para,88,375,46,183,42,192,19.0,20.1,17.9,00000
72.0,40.0,35.0,572,04,01,  Khodadila,144,194,83,94,61,100,42.6,46.9,37.9,00000
72.0,40.0,35.0,628,01,01,  Koyar Pur,64,128,33,65,31,63,33.3,33.7,33.0,00000
72.0,40.0,35.0,628,02,01,  Nichinpur,65,65,35,34,30,31,50.0,50.7,49.2,00000
72.0,40.0,35.0,728,01,01,  Nania,386,412,215,193,171,219,48.4,52.7,43.8,00000
72.0,40.0,35.0,728,02,01,  Rangsingpur,62,159,24,82,38,77,28.1,22.6,33.0,00000
72.0,40.0,35.0,728,03,01,  Nakdura,126,152,75,67,51,85,45.3,52.8,37.5,00000
72.0,40.0,35.0,761,01,01,  Pachhura,226,481,115,241,111,240,32.0,32.3,31.6,00000
72.0,40.0,35.0,761,02,01,  Maij Para,143,216,63,107,80,109,39.8,37.1,42.3,00000
72.0,40.0,35.0,761,03,01,  Bamani,161,386,74,187,87,199,29.4,28.4,30.4,00000
72.0,40.0,35.0,805,01,01,  Patimunji,129,178,60,84,69,94,42.0,41.7,42.3,00000
72.0,40.0,35.0,805,02,01,  Barmajan,51,91,22,40,29,51,35.9,35.5,36.3,00000
72.0,40.0,35.0,805,03,01,  Rambhadrapur,127,208,62,113,65,95,37.9,35.4,40.6,00000
72.0,40.0,35.0,817,01,01,  Pukuriakanda,39,281,19,117,20,164,12.2,14.0,10.9,00000
72.0,40.0,35.0,817,02,01,  Saud Para,224,335,116,155,108,180,40.1,42.8,37.5,00000
72.0,40.0,35.0,817,03,01,  Sauljan,183,204,88,95,95,109,47.3,48.1,46.6,00000
72.0,40.0,47.0,061,01,01,  Bamangaon,249,509,139,257,110,252,32.8,35.1,30.4,00000
72.0,40.0,47.0,061,02,01,  Sundurighat,308,718,142,317,166,401,30.0,30.9,29.3,00000
72.0,40.0,47.0,061,03,01,  Madhukura,70,189,37,83,33,106,27.0,30.8,23.7,00000
72.0,40.0,47.0,061,04,01,  Kanda Para,58,210,32,111,26,99,21.6,22.4,20.8,00000
72.0,40.0,47.0,200,01,01,  Bishwanathpur,301,475,159,236,142,239,38.8,40.3,37.3,00000
72.0,40.0,47.0,200,02,01,  Manipur Para,55,61,28,28,27,33,47.4,50.0,45.0,00000
72.0,40.0,47.0,200,03,01,  Naya Para,77,122,41,53,36,69,38.7,43.6,34.3,00000
72.0,40.0,47.0,200,04,01,  Senpara,225,294,108,134,117,160,43.4,44.6,42.2,00000
72.0,40.0,47.0,200,05,01,  Kaitapur,168,149,88,62,80,87,53.0,58.7,47.9,00000
72.0,40.0,47.0,200,06,01,  Baithakhali,108,226,50,114,58,112,32.3,30.5,34.1,00000
72.0,40.0,47.0,478,01,01,  Hat Gobindapur,391,376,208,165,183,211,51.0,55.8,46.4,00000
72.0,40.0,47.0,478,02,01,  Changkhali,118,299,66,155,52,144,28.3,29.9,26.5,00000
72.0,40.0,47.0,478,03,01,  Atachipa,205,166,110,79,95,87,55.3,58.2,52.2,00000
72.0,40.0,47.0,478,04,01,  Kurakhali,339,103,180,50,159,53,76.7,78.3,75.0,00000
72.0,40.0,47.0,550,01,01,  Kachugara,245,399,124,191,121,208,38.0,39.4,36.8,00000
72.0,40.0,47.0,550,02,01,  Bhasankura,206,311,92,148,114,163,39.8,38.3,41.2,00000
72.0,40.0,47.0,550,03,01,  Bagadubi,149,102,77,45,72,57,59.4,63.1,55.8,00000
72.0,40.0,47.0,550,04,01,  Banbar,33,51,17,22,16,29,39.3,43.6,35.6,00000
72.0,40.0,47.0,550,05,01,  Patlaban,63,118,34,59,29,59,34.8,36.6,33.0,00000
72.0,40.0,47.0,611,01,01,  Kharnai,302,547,157,263,145,284,35.6,37.4,33.8,00000
72.0,40.0,47.0,611,02,01,  Chak Para,139,237,65,117,74,120,37.0,35.7,38.1,00000
72.0,40.0,47.0,611,03,01,  Bedbari Karnai,251,563,133,262,118,301,30.8,33.7,28.2,00000
72.0,40.0,47.0,611,04,01,  Puran Para,187,189,108,92,79,97,49.7,54.0,44.9,00000
72.0,40.0,47.0,655,01,01,  Lakshmipur,195,743,110,352,85,391,20.8,23.8,17.9,00000
72.0,40.0,47.0,655,02,01,  Khaggara,162,501,80,247,82,254,24.4,24.5,24.4,00000
72.0,40.0,47.0,655,03,01,  Tilakpur,35,310,20,148,15,162,10.1,11.9,8.5,00000
72.0,40.0,47.0,655,04,01,  Bardal,434,488,223,216,211,272,47.1,50.8,43.7,00000
72.0,40.0,47.0,655,05,01,  Gajarmari,129,258,69,127,60,131,33.3,35.2,31.4,00000
72.0,40.0,47.0,655,06,01,  Bishnupur,98,253,53,129,45,124,27.9,29.1,26.6,00000
72.0,40.0,47.0,655,07,01,  Badurkanda,69,103,34,52,35,51,40.1,39.5,40.7,00000
72.0,40.0,47.0,655,08,01,  Sreepur,112,222,64,107,48,115,33.5,37.4,29.4,00000
72.0,40.0,47.0,878,01,01,  Rudranagar,102,84,59,42,43,42,54.8,58.4,50.6,00000
72.0,40.0,47.0,878,02,01,  Bausham Rudranagar,571,1655,321,796,250,859,25.7,28.7,22.5,00000
72.0,40.0,47.0,878,03,01,  Madir Kona,88,236,40,130,48,106,27.2,23.5,31.2,00000
72.0,40.0,47.0,994,01,01,  Uttar Ranigaon,437,584,208,270,229,314,42.8,43.5,42.2,00000
72.0,40.0,47.0,994,02,01,  Damdama,103,146,47,68,56,78,41.4,40.9,41.8,00000
72.0,40.0,47.0,994,03,01,  Ambari Para,185,467,96,229,89,238,28.4,29.5,27.2,00000
72.0,40.0,47.0,994,04,01,  Char Para,43,225,15,109,28,116,16.0,12.1,19.4,00000
72.0,40.0,59.0,205,01,01,  Chaitan Nagar,637,842,319,394,318,448,43.1,44.7,41.5,00000
72.0,40.0,59.0,205,02,01,  Rampur,68,187,35,90,33,97,26.7,28.0,25.4,00000
72.0,40.0,59.0,544,01,01,  Jigatala,332,555,166,272,166,283,37.4,37.9,37.0,00000
72.0,40.0,59.0,544,02,01,  Guyatala,79,283,42,141,37,142,21.8,23.0,20.7,00000
72.0,40.0,59.0,667,01,01,  Lengura,460,468,241,215,219,253,49.6,52.9,46.4,00000
72.0,40.0,59.0,667,02,01,  Fulbari,140,427,68,212,72,215,24.7,24.3,25.1,00000
72.0,40.0,59.0,667,03,01,  Kowbari,48,48,25,18,23,30,50.0,58.1,43.4,00000
72.0,40.0,59.0,667,04,01,  Taklekbari,28,36,15,15,13,21,43.8,50.0,38.2,00000
72.0,40.0,59.0,667,05,01,  Nayankandi,119,260,63,128,56,132,31.4,33.0,29.8,00000
72.0,40.0,59.0,667,06,01,  Paschim Lengura,208,429,104,208,104,221,32.7,33.3,32.0,00000
72.0,40.0,59.0,667,07,01,  Kanda Para,176,324,104,153,72,171,35.2,40.5,29.6,00000
72.0,40.0,59.0,667,08,01,  Maddyapara,259,329,127,162,132,167,44.0,43.9,44.1,00000
72.0,40.0,59.0,667,09,01,  Kala Para,121,177,59,86,62,91,40.6,40.7,40.5,00000
72.0,40.0,59.0,828,01,01,  Manikpur,278,123,143,55,135,68,69.3,72.2,66.5,00000
72.0,40.0,59.0,828,02,01,  Radhanagar,254,176,130,80,124,96,59.1,61.9,56.4,00000
72.0,40.0,59.0,828,03,01,  Joynagar,85,103,42,51,43,52,45.2,45.2,45.3,00000
72.0,40.0,59.0,928,01,01,  Shibpur,582,1145,260,575,322,570,33.7,31.1,36.1,00000
72.0,40.0,59.0,928,02,01,  Doani Para,28,66,13,30,15,36,29.8,30.2,29.4,00000
72.0,40.0,59.0,928,03,01,  Mantala,103,125,46,71,57,54,45.2,39.3,51.4,00000
72.0,40.0,59.0,928,04,01,  Ubda Para,246,267,133,152,113,115,48.0,46.7,49.6,00000
72.0,40.0,59.0,928,05,01,  Ranjitpur,33,9,13,6,20,3,78.6,68.4,87.0,00000
72.0,40.0,59.0,928,06,01,  Baluchara,175,136,81,58,94,78,56.3,58.3,54.7,00000
72.0,40.0,59.0,928,07,01,  Kebalpur,143,190,75,90,68,100,42.9,45.5,40.5,00000
72.0,40.0,59.0,928,08,01,  Taranagar,319,429,154,212,165,217,42.6,42.1,43.2,00000
72.0,40.0,59.0,928,09,01,  Gauripur,545,840,251,431,294,409,39.4,36.8,41.8,00000
72.0,40.0,71.0,022,01,01,  Pataria Para,136,126,65,59,71,67,51.9,52.4,51.4,00000
72.0,40.0,71.0,022,02,01,  Shafikhali,218,197,114,95,104,102,52.5,54.5,50.5,00000
72.0,40.0,71.0,022,03,01,  Alapsing,190,522,102,235,88,287,26.7,30.3,23.5,00000
72.0,40.0,71.0,022,04,01,  Hatibhanga,176,292,87,134,89,158,37.6,39.4,36.0,00000
72.0,40.0,71.0,022,05,01,  Nalgaria Para,116,296,65,134,51,162,28.2,32.7,23.9,00000
72.0,40.0,71.0,022,06,01,  Anandapur,473,760,229,375,244,385,38.4,37.9,38.8,00000
72.0,40.0,83.0,138,01,01,  Bekharikanda,342,530,156,276,186,254,39.2,36.1,42.3,00000
72.0,40.0,83.0,138,02,01,  Kashiorkanda,64,44,34,20,30,24,59.3,63.0,55.6,00000
72.0,40.0,83.0,138,03,01,  Uttarsunai,285,425,151,225,134,200,40.1,40.2,40.1,00000
72.0,40.0,83.0,138,04,01,  Dakshin Sunai,482,846,217,383,265,463,36.3,36.2,36.4,00000
72.0,40.0,83.0,138,05,01,  Majumder Para,90,104,46,42,44,62,46.4,52.3,41.5,00000
72.0,40.0,83.0,138,06,01,  Barai Para,123,72,54,33,69,39,63.1,62.1,63.9,00000
72.0,40.0,83.0,138,07,01,  Machiyal,97,316,40,137,57,179,23.5,22.6,24.2,00000
72.0,40.0,83.0,255,01,01,  Praktan Charulia,278,337,141,168,137,169,45.2,45.6,44.8,00000
72.0,40.0,83.0,255,02,01,  Bade Charulia,38,280,19,139,19,141,11.9,12.0,11.9,00000
72.0,40.0,83.0,255,03,01,  Ranigaon,320,487,161,268,159,219,39.7,37.5,42.1,00000
72.0,40.0,83.0,255,04,01,  Khalishajuri,49,331,18,176,31,155,12.9,9.3,16.7,00000
72.0,40.0,83.0,255,05,01,  Sreepur,180,176,80,90,100,86,50.6,47.1,53.8,00000
72.0,40.0,83.0,255,06,01,  Kagji Para,86,201,42,101,44,100,30.0,29.4,30.6,00000
72.0,40.0,83.0,255,07,01,  Pathan Para,157,147,70,67,87,80,51.6,51.1,52.1,00000
72.0,40.0,83.0,255,08,01,  Maijganga,246,282,121,135,125,147,46.6,47.3,46.0,00000
72.0,40.0,83.0,255,09,01,  Kalakona,26,76,9,37,17,39,25.5,19.6,30.4,00000
72.0,40.0,83.0,305,01,01,  Bara Salenga,124,261,63,140,61,121,32.2,31.0,33.5,00000
72.0,40.0,83.0,305,02,01,  Dakshin Atka Para,72,160,36,81,36,79,31.0,30.8,31.3,00000
72.0,40.0,83.0,344,01,01,  Dhopa Para,102,118,45,57,57,61,46.4,44.1,48.3,00000
72.0,40.0,83.0,344,02,01,  Jibanpur,56,78,32,40,24,38,41.8,44.4,38.7,00000
72.0,40.0,83.0,344,03,01,  Amtail,147,112,60,66,87,46,56.8,47.6,65.4,00000
72.0,40.0,83.0,344,04,01,  Shararkona,216,531,102,269,114,262,28.9,27.5,30.3,00000
72.0,40.0,83.0,394,01,01,  Mulgaon,281,468,155,223,126,245,37.5,41.0,34.0,00000
72.0,40.0,83.0,394,02,01,  Bhati Para,162,171,81,77,81,94,48.6,51.3,46.3,00000
72.0,40.0,83.0,394,03,01,  Palputhijana,35,60,16,22,19,38,36.8,42.1,33.3,00000
72.0,40.0,83.0,394,04,01,  Ganganagar,91,211,46,106,45,105,30.1,30.3,30.0,00000
72.0,40.0,83.0,394,05,01,  Krishtapur,121,328,45,154,76,174,26.9,22.6,30.4,00000
72.0,40.0,83.0,411,01,01,  Goatala,75,385,28,165,47,220,16.3,14.5,17.6,00000
72.0,40.0,83.0,411,02,01,  Kailati,487,393,258,200,229,193,55.3,56.3,54.3,00000
72.0,40.0,83.0,411,03,01,  Rautia,137,165,75,84,62,81,45.4,47.2,43.4,00000
72.0,40.0,83.0,811,01,01,  Pogla,70,389,25,189,45,200,15.3,11.7,18.4,00000
72.0,40.0,83.0,811,02,01,  Bade Pogla,202,226,99,123,103,103,47.2,44.6,50.0,00000
72.0,40.0,83.0,811,03,01,  Mul Pogla,101,249,57,116,44,133,28.9,32.9,24.9,00000
72.0,40.0,83.0,811,04,01,  Bahaturkanda,60,168,32,87,28,81,26.3,26.9,25.7,00000
72.0,40.0,83.0,811,05,01,  Mangalsid,118,170,60,86,58,84,41.0,41.1,40.8,00000
72.0,40.0,83.0,811,06,01,  Makhilanda,184,80,90,39,94,41,69.7,69.8,69.6,00000
72.0,40.0,83.0,811,07,01,  Ramnathpur,203,272,109,128,94,144,42.7,46.0,39.5,00000
72.0,40.0,83.0,811,08,01,  Chandankandi,84,147,33,72,51,75,36.4,31.4,40.5,00000
72.0,40.0,83.0,811,09,01,  Mankandia,108,227,45,119,63,108,32.2,27.4,36.8,00000
72.0,40.0,83.0,811,10,01,  Pogla Dhakhin,103,224,58,103,45,121,31.5,36.0,27.1,00000
72.0,40.0,83.0,850,01,01,  Rampur,117,481,61,242,56,239,19.6,20.1,19.0,00000
72.0,40.0,83.0,850,02,01,  Putijana,24,204,10,108,14,96,10.5,8.5,12.7,00000
72.0,40.0,95.0,172,01,01,  Bisauti,100,515,62,255,38,260,16.3,19.6,12.8,00000
72.0,40.0,95.0,172,02,01,  Barakanda,26,442,14,224,12,218,5.6,5.9,5.2,00000
72.0,40.0,95.0,172,03,01,  Ramnathpur,354,624,180,298,174,326,36.2,37.7,34.8,00000
72.0,40.0,95.0,172,04,01,  Chita Naya,163,742,93,356,70,386,18.0,20.7,15.4,00000
72.0,40.0,95.0,172,05,01,  Gozariakanda,37,293,26,135,11,158,11.2,16.1,6.5,00000
72.0,40.0,95.0,172,06,01,  Raypur,35,176,14,87,21,89,16.6,13.9,19.1,00000
72.0,40.0,95.0,227,01,01,  Islampur,58,115,35,49,23,66,33.5,41.7,25.8,00000
72.0,40.0,95.0,227,02,01,  Chandradinga Haripur,94,215,42,91,52,124,30.4,31.6,29.5,00000
72.0,40.0,95.0,472,01,01,  Banaikuna,83,354,40,185,43,169,19.0,17.8,20.3,00000
72.0,40.0,95.0,472,02,01,  Hasa Noagaon,141,454,61,220,80,234,23.7,21.7,25.5,00000
72.0,40.0,95.0,472,03,01,  Rajnagar,115,211,52,94,63,117,35.3,35.6,35.0,00000
72.0,40.0,95.0,472,04,01,  Baluchanda,120,610,55,266,65,344,16.4,17.1,15.9,00000
72.0,40.0,95.0,472,05,01,  Paneshwar Para,69,499,33,235,36,264,12.1,12.3,12.0,00000
72.0,40.0,95.0,472,06,01,  Pulia,65,162,26,74,39,88,28.6,26.0,30.7,00000
72.0,40.0,95.0,472,07,01,  Amgara,48,377,23,193,25,184,11.3,10.6,12.0,00000
72.0,40.0,95.0,472,08,01,  Nalla Para,357,507,171,231,186,276,41.3,42.5,40.3,00000
72.0,40.0,95.0,472,09,01,  Dairarkanda,126,261,55,125,71,136,32.6,30.6,34.3,00000
72.0,40.0,95.0,633,01,01,  Krishnapur,90,1191,49,592,41,599,7.0,7.6,6.4,00000
72.0,40.0,95.0,633,02,01,  Batania Para,45,270,26,132,19,138,14.3,16.5,12.1,00000
72.0,40.0,95.0,633,03,01,  Chaita,182,489,99,244,83,245,27.1,28.9,25.3,00000
72.0,40.0,95.0,672,01,01,  Bastapur,157,372,80,177,77,195,29.7,31.1,28.3,00000
72.0,40.0,95.0,672,02,01,  Mautala,181,390,80,178,101,212,31.7,31.0,32.3,00000
72.0,40.0,95.0,672,03,01,  Rajabari,169,150,82,58,87,92,53.0,58.6,48.6,00000
72.0,40.0,95.0,672,04,01,  Dippur,82,55,43,16,39,39,59.9,72.9,50.0,00000
72.0,40.0,95.0,672,05,01,  Mahadebpur,102,33,47,16,55,17,75.6,74.6,76.4,00000
72.0,40.0,95.0,672,06,01,  Bangkona,141,126,76,50,65,76,52.8,60.3,46.1,00000
72.0,40.0,95.0,672,07,01,  Garam Para,80,93,41,39,39,54,46.2,51.3,41.9,00000
72.0,40.0,95.0,672,08,01,  Kanda Para,67,51,39,25,28,26,56.8,60.9,51.9,00000
72.0,40.0,95.0,672,09,01,  Battala,328,369,169,158,159,211,47.1,51.7,43.0,00000
72.0,40.0,95.0,672,10,01,  Ghilasara,116,128,55,58,61,70,47.5,48.7,46.6,00000
72.0,40.0,95.0,672,11,01,  Baraduar,82,110,40,44,42,66,42.7,47.6,38.9,00000
72.0,40.0,95.0,672,12,01,  Mangara,50,45,29,15,21,30,52.6,65.9,41.2,00000
72.0,40.0,95.0,672,13,01,  Sundarighat,12,17,6,8,6,9,41.4,42.9,40.0,00000
72.0,40.0,95.0,705,01,01,  Chuta Mangara,243,400,142,207,101,193,37.8,40.7,34.4,00000
72.0,40.0,95.0,705,02,01,  Paschimpara,212,519,101,247,111,272,29.0,29.0,29.0,00000
72.0,40.0,95.0,705,03,01,  Dakshinpara,139,288,59,124,80,164,32.6,32.2,32.8,00000
72.0,40.0,95.0,705,04,01,  Purbapara,76,323,29,151,47,172,19.0,16.1,21.5,00000
72.0,40.0,95.0,705,05,01,  Mangara,172,138,80,53,92,85,55.5,60.2,52.0,00000
72.0,40.0,95.0,705,06,01,  Nayagaon,122,160,64,67,58,93,43.3,48.9,38.4,00000
72.0,40.0,95.0,705,07,01,  Harinakuri,186,455,90,195,96,260,29.0,31.6,27.0,00000
72.0,40.0,95.0,705,08,01,  Shalikabam,29,180,9,93,20,87,13.9,8.8,18.7,00000
72.0,40.0,95.0,705,09,01,  Satarhati,81,194,41,92,40,102,29.5,30.8,28.2,00000
72.0,40.0,95.0,705,10,01,  Madhyapara,184,317,94,129,90,188,36.7,42.2,32.4,00000
72.0,40.0,95.0,744,01,01,  Omargaon,188,821,85,426,103,395,18.6,16.6,20.7,00000
72.0,40.0,95.0,744,02,01,  Rambhadrapur,45,194,22,89,23,105,18.8,19.8,18.0,00000
72.0,40.0,95.0,744,03,01,  Nala Para,97,204,43,91,54,113,32.2,32.1,32.3,00000
72.0,40.0,95.0,944,01,01,  Chaita,95,279,65,139,30,140,25.4,31.9,17.6,00000
72.0,40.0,95.0,944,02,01,  Sinkata,84,501,47,241,37,260,14.4,16.3,12.5,00000
72.0,40.0,95.0,944,03,01,  Hatiber,18,32,12,17,6,15,36.0,41.4,28.6,00000
72.0,47.0,11.0,679,01,01,  Nandanura,86,185,43,90,43,95,31.7,32.3,31.2,00000
72.0,47.0,11.0,679,02,01,  Basur Bazar,25,68,11,35,14,33,26.9,23.9,29.8,00000
72.0,47.0,13.0,081,01,01,  Balaishimul,1040,2151,510,1059,530,1092,32.6,32.5,32.7,00000
72.0,47.0,13.0,081,02,01,  Rajail,216,157,102,70,114,87,57.9,59.3,56.7,00000
72.0,47.0,13.0,122,01,01,  Barsiura,103,113,56,55,47,58,47.7,50.5,44.8,00000
72.0,47.0,13.0,122,02,01,  Kaukandi,65,66,33,33,32,33,49.6,50.0,49.2,00000
72.0,47.0,13.0,122,03,01,  Basihati,56,94,30,43,26,51,37.3,41.1,33.8,00000
72.0,47.0,13.0,585,01,01,  Krishna Jibanpur,329,207,162,96,167,111,61.4,62.8,60.1,00000
72.0,47.0,13.0,585,02,01,  Sarishakona,93,19,47,9,46,10,83.0,83.9,82.1,00000
72.0,47.0,13.0,593,01,01,  Kumarua,408,423,210,192,198,231,49.1,52.2,46.2,00000
72.0,47.0,13.0,593,02,01,  Sara Para,600,730,311,336,289,394,45.1,48.1,42.3,00000
72.0,47.0,13.0,614,01,01,  Laskarpur,133,407,72,209,61,198,24.6,25.6,23.6,00000
72.0,47.0,13.0,614,02,01,  Bara Para,245,444,123,223,122,221,35.6,35.5,35.6,00000
72.0,47.0,13.0,614,03,01,  Kabi Chandrapur,314,548,153,261,161,287,36.4,37.0,35.9,00000
72.0,47.0,13.0,614,04,01,  Gandabpur,191,423,106,207,85,216,31.1,33.9,28.2,00000
72.0,47.0,13.0,716,01,01,  Noadiadigar,280,643,150,293,130,350,30.3,33.9,27.1,00000
72.0,47.0,13.0,716,02,01,  Madnakona,39,23,24,10,15,13,62.9,70.6,53.6,00000
72.0,47.0,20.0,544,01,01,  Kashipur,303,1091,157,551,146,540,21.7,22.2,21.3,00000
72.0,47.0,20.0,544,02,01,  Saguli,400,713,195,329,205,384,35.9,37.2,34.8,00000
72.0,47.0,27.0,286,01,01,  Daila,335,670,162,329,173,341,33.3,33.0,33.7,00000
72.0,47.0,27.0,286,02,01,  Bekhurati Bazar,207,80,116,38,91,42,72.1,75.3,68.4,00000
72.0,47.0,27.0,290,01,01,  Dalpa,773,1266,379,604,394,662,37.9,38.6,37.3,00000
72.0,47.0,27.0,290,02,01,  Ittauta,221,167,111,82,110,85,57.0,57.5,56.4,00000
72.0,47.0,27.0,847,01,01,  Ramnagar,823,1185,437,540,386,645,41.0,44.7,37.4,00000
72.0,47.0,27.0,847,02,01,  Kunihati,387,187,185,86,202,101,67.4,68.3,66.7,00000
72.0,47.0,33.0,032,01,01,  Angarua,392,917,219,438,173,479,29.9,33.3,26.5,00000
72.0,47.0,33.0,032,02,01,  Bajatia,157,230,63,115,94,115,40.6,35.4,45.0,00000
72.0,47.0,33.0,102,01,01,  Bandalal,335,928,195,440,140,488,26.5,30.7,22.3,00000
72.0,47.0,33.0,102,02,01,  Apiarkona,87,235,41,116,46,119,27.0,26.1,27.9,00000
72.0,47.0,33.0,118,01,01,  Basati,291,511,158,232,133,279,36.3,40.5,32.3,00000
72.0,47.0,33.0,118,02,01,  Lakshminagar,174,587,92,287,82,300,22.9,24.3,21.5,00000
72.0,47.0,33.0,118,03,01,  Miah Para,118,148,46,71,72,77,44.4,39.3,48.3,00000
72.0,47.0,33.0,118,04,01,  Buttarkandi,66,112,35,53,31,59,37.1,39.8,34.4,00000
72.0,47.0,33.0,118,05,01,  Tangua,153,228,78,115,75,113,40.2,40.4,39.9,00000
72.0,47.0,33.0,184,01,01,  Baherkanda,104,105,49,62,55,43,49.8,44.1,56.1,00000
72.0,47.0,33.0,184,02,01,  Bidhyaballabh,400,717,183,320,217,397,35.8,36.4,35.3,00000
72.0,47.0,33.0,311,01,01,  Deopara,127,174,76,89,51,85,42.2,46.1,37.5,00000
72.0,47.0,33.0,311,02,01,  Garaonda,153,223,78,106,75,117,40.7,42.4,39.1,00000
72.0,47.0,33.0,401,01,01,  Garadoba,411,527,202,243,209,284,43.8,45.4,42.4,00000
72.0,47.0,33.0,401,02,01,  Kharmahari,394,198,195,91,199,107,66.6,68.2,65.0,00000
72.0,47.0,33.0,401,03,01,  Sonakhali,179,180,96,96,83,84,49.9,50.0,49.7,00000
72.0,47.0,33.0,794,01,01,  Chandalara,204,365,95,189,109,176,35.9,33.5,38.2,00000
72.0,47.0,33.0,794,02,01,  Pubail,151,305,73,151,78,154,33.1,32.6,33.6,00000
72.0,47.0,40.0,374,01,01,  Uttar Ganda,655,930,319,453,336,477,41.3,41.3,41.3,00000
72.0,47.0,40.0,374,02,01,  Dakshin Ganda,771,944,388,462,383,482,45.0,45.6,44.3,00000
72.0,47.0,40.0,507,01,01,  Kalian,202,544,97,262,105,282,27.1,27.0,27.1,00000
72.0,47.0,40.0,507,02,01,  Marichpur,261,624,122,296,139,328,29.5,29.2,29.8,00000
72.0,47.0,40.0,724,01,01,  Paharpur,314,448,156,206,158,242,41.2,43.1,39.5,00000
72.0,47.0,40.0,724,02,01,  Pigiakandi,77,116,34,61,43,55,39.9,35.8,43.9,00000
72.0,47.0,40.0,724,03,01,  Kapasia,165,176,85,78,80,98,48.4,52.1,44.9,00000
72.0,47.0,40.0,724,04,01,  Monkanda,541,796,258,391,283,405,40.5,39.8,41.1,00000
72.0,47.0,40.0,724,05,01,  Lathiar Char,180,323,100,149,80,174,35.8,40.2,31.5,00000
72.0,47.0,47.0,135,01,01,  Bejgati,192,250,100,119,92,131,43.4,45.7,41.3,00000
72.0,47.0,47.0,135,02,01,  Besargati,23,238,13,111,10,127,8.8,10.5,7.3,00000
72.0,47.0,47.0,339,01,01,  Dighalkursa,585,842,301,395,284,447,41.0,43.2,38.9,00000
72.0,47.0,47.0,339,02,01,  Bairati,124,170,69,78,55,92,42.2,46.9,37.4,00000
72.0,47.0,47.0,954,01,01,  Tarakandi,367,550,190,273,177,277,40.0,41.0,39.0,00000
72.0,47.0,47.0,954,02,01,  Baju Para,51,292,27,139,24,153,14.9,16.3,13.6,00000
72.0,47.0,47.0,970,01,01,  Tentulia,308,635,174,290,134,345,32.7,37.5,28.0,00000
72.0,47.0,47.0,970,02,01,  Tambuli Para,5,106,3,56,2,50,4.5,5.1,3.8,00000
72.0,47.0,61.0,057,01,01,  Dulain,218,310,110,146,108,164,41.3,43.0,39.7,00000
72.0,47.0,61.0,057,02,01,  Kirtankhola,140,243,66,116,74,127,36.6,36.3,36.8,00000
72.0,47.0,61.0,085,01,01,  Balijora,512,627,242,310,270,317,45.0,43.8,46.0,00000
72.0,47.0,61.0,085,02,01,  Taraf Para,82,240,39,121,43,119,25.5,24.4,26.5,00000
72.0,47.0,61.0,188,01,01,  Pijahati,585,1085,279,533,306,552,35.0,34.4,35.7,00000
72.0,47.0,61.0,188,02,01,  Aujia,278,618,134,299,144,319,31.0,30.9,31.1,00000
72.0,47.0,61.0,188,03,01,  Baigani,233,297,124,123,109,174,44.0,50.2,38.5,00000
72.0,47.0,61.0,229,01,01,  Chak Sadak,65,242,35,103,30,139,21.2,25.4,17.8,00000
72.0,47.0,61.0,229,02,01,  Kona Para,85,212,40,94,45,118,28.6,29.9,27.6,00000
72.0,47.0,61.0,343,01,01,  Dighali,330,665,148,317,182,348,33.2,31.8,34.3,00000
72.0,47.0,61.0,343,02,01,  Dipara,171,181,85,82,86,99,48.6,50.9,46.5,00000
72.0,47.0,61.0,618,01,01,  Machiali,172,383,82,180,90,203,31.0,31.3,30.7,00000
72.0,47.0,61.0,618,02,01,  Kajlakona,73,126,37,59,36,67,36.7,38.5,35.0,00000
72.0,47.0,61.0,917,01,01,  Satashi Digar,203,298,108,146,95,152,40.5,42.5,38.5,00000
72.0,47.0,61.0,917,02,01,  Joyka,143,208,64,89,79,119,40.7,41.8,39.9,00000
72.0,47.0,67.0,446,01,01,  Mamudpur,240,889,120,431,120,458,21.3,21.8,20.8,00000
72.0,47.0,67.0,446,02,01,  Harulia,166,759,88,351,78,408,17.9,20.0,16.0,00000
72.0,47.0,67.0,446,03,01,  Pachharulia,494,481,230,226,264,255,50.7,50.4,50.9,00000
72.0,47.0,67.0,446,04,01,  Charitala,311,530,162,247,149,283,37.0,39.6,34.5,00000
72.0,47.0,74.0,045,01,01,  Atasia,182,289,89,139,93,150,38.6,39.0,38.3,00000
72.0,47.0,74.0,045,02,01,  Maizkandi,60,205,22,103,38,102,22.6,17.6,27.1,00000
72.0,47.0,74.0,364,01,01,  Durgapur,345,535,164,253,181,282,39.2,39.3,39.1,00000
72.0,47.0,74.0,364,02,01,  Dhaltakona,122,333,81,155,41,178,26.8,34.3,18.7,00000
72.0,47.0,74.0,479,01,01,  Jurail,472,1207,233,563,239,644,28.1,29.3,27.1,00000
72.0,47.0,74.0,479,02,01,  Bahuli,225,342,110,177,115,165,39.7,38.3,41.1,00000
72.0,47.0,74.0,696,01,01,  Naopara,496,619,246,298,250,321,44.5,45.2,43.8,00000
72.0,47.0,74.0,696,02,01,  Purabari,156,429,88,206,68,223,26.7,29.9,23.4,00000
72.0,47.0,74.0,696,03,01,  Barakanda,11,138,7,59,4,79,7.4,10.6,4.8,00000
72.0,47.0,74.0,696,04,01,  Sayla Para,113,167,64,76,49,91,40.4,45.7,35.0,00000
72.0,47.0,74.0,696,05,01,  Sahara,101,176,50,85,51,91,36.5,37.0,35.9,00000
72.0,47.0,74.0,696,06,01,  Dokhergati,60,187,31,81,29,106,24.3,27.7,21.5,00000
72.0,47.0,74.0,720,01,01,  Pachhar,412,1036,232,488,180,548,28.5,32.2,24.7,00000
72.0,47.0,74.0,720,02,01,  Barabari,225,543,118,260,107,283,29.3,31.2,27.4,00000
72.0,47.0,74.0,937,01,01,  Shimulatia,500,557,248,266,252,291,47.3,48.2,46.4,00000
72.0,47.0,74.0,937,02,01,  Itachdaki,120,372,71,182,49,190,24.4,28.1,20.5,00000
72.0,47.0,81.0,569,01,01,  Khalijora,515,686,282,324,233,362,42.9,46.5,39.2,00000
72.0,47.0,81.0,569,02,01,  Pulbail,101,165,51,81,50,84,38.0,38.6,37.3,00000
72.0,47.0,81.0,728,01,01,  Nagdara,155,215,85,100,70,115,41.9,45.9,37.8,00000
72.0,47.0,81.0,728,02,01,  Taluk Mahesh,93,288,48,146,45,142,24.4,24.7,24.1,00000
72.0,47.0,81.0,728,03,01,  Paikura,309,861,151,415,158,446,26.4,26.7,26.2,00000
72.0,47.0,81.0,761,01,01,  Sandrakanda,164,295,90,136,74,159,35.7,39.8,31.8,00000
72.0,47.0,81.0,761,02,01,  Saleha,34,59,15,29,19,30,36.6,34.1,38.8,00000
72.0,47.0,81.0,761,03,01,  Paratail,460,674,220,329,240,345,40.6,40.1,41.0,00000
72.0,47.0,81.0,777,01,01,  Pechandari,488,883,244,410,244,473,35.6,37.3,34.0,00000
72.0,47.0,81.0,777,02,01,  Banipur,239,333,108,170,131,163,41.8,38.8,44.6,00000
72.0,47.0,88.0,016,01,01,  Amtala,614,988,323,457,291,531,38.3,41.4,35.4,00000
72.0,47.0,88.0,016,02,01,  Koha Para,173,487,90,228,83,259,26.2,28.3,24.3,00000
72.0,47.0,88.0,372,01,01,  Kanda Para,242,398,126,197,116,201,37.8,39.0,36.6,00000
72.0,47.0,88.0,372,02,01,  Barua Para,98,160,51,77,47,83,38.0,39.8,36.2,00000
72.0,47.0,88.0,372,03,01,  Fatehpur,339,682,147,322,192,360,33.2,31.3,34.8,00000
72.0,47.0,88.0,372,04,01,  Etarbari,110,262,55,120,55,142,29.6,31.4,27.9,00000
72.0,47.0,88.0,388,01,01,  Gamruli,507,1112,275,536,232,576,31.3,33.9,28.7,00000
72.0,47.0,88.0,388,02,01,  Athka Para,69,225,26,102,43,123,23.5,20.3,25.9,00000
72.0,47.0,88.0,388,03,01,  Puranbari,438,360,222,174,216,186,54.9,56.1,53.7,00000
72.0,47.0,94.0,786,01,01,  Peri Saidpur,508,370,269,176,239,194,57.9,60.4,55.2,00000
72.0,47.0,94.0,786,02,01,  Periar Char,190,424,92,191,98,233,30.9,32.5,29.6,00000
72.0,47.0,94.0,786,03,01,  Saidpur Bazar,49,46,33,17,16,29,51.6,66.0,35.6,00000
72.0,47.0,94.0,786,04,01,  Guchchhagram,2,32,2,14,0,18,5.9,12.5,0.0,00000
72.0,47.0,94.0,974,01,01,  Tipra,462,762,228,373,234,389,37.7,37.9,37.6,00000
72.0,47.0,94.0,974,02,01,  Satbaruka,155,262,83,121,72,141,37.2,40.7,33.8,00000
72.0,56.0,10.0,167,01,01,  Biasi,125,297,69,149,56,148,29.6,31.7,27.5,00000
72.0,56.0,10.0,167,02,01,  Bantiosree,424,891,217,457,207,434,32.2,32.2,32.3,00000
72.0,56.0,10.0,272,01,01,  Uttar Deosalla,292,986,140,513,152,473,22.8,21.4,24.3,00000
72.0,56.0,10.0,272,02,01,  Dakshin Deosalla,519,961,290,481,229,480,35.1,37.6,32.3,00000
72.0,56.0,10.0,272,03,01,  Chhalakanda,85,405,41,217,44,188,17.3,15.9,19.0,00000
72.0,56.0,10.0,324,01,01,  Paschim Fatehpur,126,712,67,412,59,300,15.0,14.0,16.4,00000
72.0,56.0,10.0,324,02,01,  Dewan Para,300,1272,150,633,150,639,19.1,19.2,19.0,00000
72.0,56.0,10.0,324,03,01,  Nij Fatehpur,256,418,152,217,104,201,38.0,41.2,34.1,00000
72.0,56.0,10.0,324,04,01,  Hatsira,65,293,35,147,30,146,18.2,19.2,17.0,00000
72.0,56.0,10.0,324,05,01,  Tola Para,45,289,26,141,19,148,13.5,15.6,11.4,00000
72.0,56.0,10.0,324,06,01,  Saha Para,26,144,8,76,18,68,15.3,9.5,20.9,00000
72.0,56.0,31.0,188,01,01,  Shahpur,616,822,312,427,304,395,42.8,42.2,43.5,00000
72.0,56.0,31.0,188,02,01,  Purbapara,475,805,239,383,236,422,37.1,38.4,35.9,00000
72.0,56.0,31.0,188,03,01,  Ratnapur,482,1309,251,648,231,661,26.9,27.9,25.9,00000
72.0,56.0,31.0,188,04,01,  Chak Para,523,1151,273,564,250,587,31.2,32.6,29.9,00000
72.0,56.0,31.0,377,01,01,  Hanskuri,165,623,86,286,79,337,20.9,23.1,19.0,00000
72.0,56.0,31.0,377,02,01,  Maidham,210,408,107,193,103,215,34.0,35.7,32.4,00000
72.0,56.0,42.0,094,01,01,  Barabari,172,294,82,151,90,143,36.9,35.2,38.6,00000
72.0,56.0,42.0,094,02,01,  Sutiarpar,229,846,129,402,100,444,21.3,24.3,18.4,00000
72.0,56.0,52.0,168,01,01,  Baghdair,221,554,116,289,105,265,28.5,28.6,28.4,00000
72.0,56.0,52.0,168,02,01,  Barikandi,224,569,121,275,103,294,28.2,30.6,25.9,00000
72.0,56.0,52.0,481,01,01,  Kaikuria,128,389,64,194,64,195,24.8,24.8,24.7,00000
72.0,56.0,52.0,481,02,01,  Barburi,197,364,110,178,87,186,35.1,38.2,31.9,00000
72.0,56.0,52.0,502,01,01,  Kapasatia,233,862,129,402,104,460,21.3,24.3,18.4,00000
72.0,56.0,52.0,502,02,01,  Ganganagar,85,486,48,237,37,249,14.9,16.8,12.9,00000
72.0,56.0,52.0,764,01,01,  Parashkhila,341,851,191,408,150,443,28.6,31.9,25.3,00000
72.0,56.0,52.0,764,02,01,  Kumarikona,136,258,75,118,61,140,34.5,38.9,30.3,00000
72.0,56.0,63.0,261,01,01,  Demarganti,144,594,75,280,69,314,19.5,21.1,18.0,00000
72.0,56.0,63.0,261,02,01,  Nayahati,71,393,40,188,31,205,15.3,17.5,13.1,00000
72.0,56.0,63.0,345,01,01,  Ghatua,498,1245,277,608,221,637,28.6,31.3,25.8,00000
72.0,56.0,63.0,345,02,01,  Ramdaskhila,66,218,31,110,35,108,23.2,22.0,24.5,00000
72.0,56.0,63.0,733,01,01,  Padarkona,37,240,21,123,16,117,13.4,14.6,12.0,00000
72.0,56.0,63.0,733,02,01,  Naya Para,116,673,67,322,49,351,14.7,17.2,12.3,00000
72.0,56.0,73.0,020,01,01,  Alamsree,427,977,224,494,203,483,30.4,31.2,29.6,00000
72.0,56.0,73.0,020,02,01,  Sunakhali,126,391,63,179,63,212,24.4,26.0,22.9,00000
72.0,56.0,73.0,020,03,01,  Panch Alamsree,367,710,185,372,182,338,34.1,33.2,35.0,00000
72.0,56.0,73.0,020,04,01,  Taluk Kanai,142,218,77,104,65,114,39.4,42.5,36.3,00000
72.0,56.0,73.0,073,01,01,  Uttar Bansari,225,811,126,405,99,406,21.7,23.7,19.6,00000
72.0,56.0,73.0,073,02,01,  Dakshin Bansari,402,942,220,479,182,463,29.9,31.5,28.2,00000
72.0,56.0,73.0,638,01,01,  Uttar Makhna,201,1048,108,515,93,533,16.1,17.3,14.9,00000
72.0,56.0,73.0,638,02,01,  Dakshin Makhna,376,667,210,301,166,366,36.0,41.1,31.2,00000
72.0,56.0,73.0,712,01,01,  Nayekpur Purbapara,344,573,163,280,181,293,37.5,36.8,38.2,00000
72.0,56.0,73.0,712,02,01,  Nayekpur Paschimpara,131,548,72,250,59,298,19.3,22.4,16.5,00000
72.0,56.0,73.0,775,01,01,  Raj Deotala,144,326,77,147,67,179,30.6,34.4,27.2,00000
72.0,56.0,73.0,775,02,01,  Naogaon,309,777,158,378,151,399,28.5,29.5,27.5,00000
72.0,56.0,73.0,775,03,01,  Baosha,181,265,77,125,104,140,40.6,38.1,42.6,00000
72.0,56.0,84.0,848,01,01,  Saidpur,189,415,101,201,88,214,31.3,33.4,29.1,00000
72.0,56.0,84.0,848,02,01,  Daribinni,146,484,77,250,69,234,23.2,23.5,22.8,00000
72.0,56.0,84.0,953,01,01,  Tiasree,367,663,197,296,170,367,35.6,40.0,31.7,00000
72.0,56.0,84.0,953,02,01,  Baitakhali,57,160,37,69,20,91,26.3,34.9,18.0,00000
72.0,63.0,10.0,046,01,01,  Baham,633,579,345,313,288,266,52.2,52.4,52.0,00000
72.0,63.0,10.0,046,02,01,  Madhupur,29,148,16,71,13,77,16.4,18.4,14.4,00000
72.0,63.0,10.0,046,03,01,  Durgapur,158,432,81,228,77,204,26.8,26.2,27.4,00000
72.0,63.0,10.0,046,04,01,  Kachua Char,188,429,107,209,81,220,30.5,33.9,26.9,00000
72.0,63.0,10.0,046,05,01,  Bamer Char,258,220,127,102,131,118,54.0,55.5,52.6,00000
72.0,63.0,10.0,046,06,01,  Danuar Char,21,108,11,53,10,55,16.3,17.2,15.4,00000
72.0,63.0,10.0,046,07,01,  Gaziar Char,26,110,10,58,16,52,19.1,14.7,23.5,00000
72.0,63.0,10.0,777,01,01,  Pabai Para,140,394,65,211,75,183,26.2,23.6,29.1,00000
72.0,63.0,10.0,777,02,01,  Sonarampur,91,400,48,202,43,198,18.5,19.2,17.8,00000
72.0,63.0,21.0,093,01,01,  Baniahari,262,495,145,235,117,260,34.6,38.2,31.0,00000
72.0,63.0,21.0,093,02,01,  Gazinagar,132,101,70,47,62,54,56.7,59.8,53.4,00000
72.0,63.0,21.0,093,03,01,  Kashipur,186,519,102,263,84,256,26.4,27.9,24.7,00000
72.0,63.0,21.0,093,04,01,  Naogaon,209,254,110,119,99,135,45.1,48.0,42.3,00000
72.0,63.0,21.0,093,05,01,  Barghar,93,111,43,56,50,55,45.6,43.4,47.6,00000
72.0,63.0,21.0,139,01,01,  Baratali,519,712,270,338,249,374,42.2,44.4,40.0,00000
72.0,63.0,21.0,139,02,01,  Mamudpur,474,751,213,395,261,356,38.7,35.0,42.3,00000
72.0,63.0,21.0,419,01,01,  Bara Hatni,205,189,118,86,87,103,52.0,57.8,45.8,00000
72.0,63.0,21.0,419,02,01,  Chhota Hatni,93,226,55,110,38,116,29.2,33.3,24.7,00000
72.0,63.0,21.0,513,01,01,  Kalunka,613,844,318,417,295,427,42.1,43.3,40.9,00000
72.0,63.0,21.0,513,02,01,  Baniajuri,337,428,192,202,145,226,44.1,48.7,39.1,00000
72.0,63.0,21.0,948,01,01,  Sukdebpur,275,339,145,164,130,175,44.8,46.9,42.6,00000
72.0,63.0,21.0,948,02,01,  Char Para,121,179,69,83,52,96,40.3,45.4,35.1,00000
72.0,63.0,31.0,077,01,01,  Bamanikona,61,158,33,75,28,83,27.9,30.6,25.2,00000
72.0,63.0,31.0,077,02,01,  Mandaroa,193,662,102,330,91,332,22.6,23.6,21.5,00000
72.0,63.0,31.0,365,01,01,  Gaglajore,720,1037,338,528,382,509,41.0,39.0,42.9,00000
72.0,63.0,31.0,365,02,01,  Chawra Para,158,330,86,154,72,176,32.4,35.8,29.0,00000
72.0,63.0,31.0,450,01,01,  Jalalpur,355,573,165,314,190,259,38.3,34.4,42.3,00000
72.0,63.0,31.0,450,02,01,  Atbari,66,257,32,128,34,129,20.4,20.0,20.9,00000
72.0,63.0,31.0,956,01,01,  Shyampur,51,71,28,35,23,36,41.8,44.4,39.0,00000
72.0,63.0,31.0,956,02,01,  Nayagaon,134,293,68,143,66,150,31.4,32.2,30.6,00000
72.0,63.0,31.0,956,03,01,  Naya Para,17,134,9,57,8,77,11.3,13.6,9.4,00000
72.0,63.0,31.0,956,04,01,  Gurahai,104,317,53,166,51,151,24.7,24.2,25.2,00000
72.0,63.0,42.0,583,01,01,  Khorshimuli,504,529,256,234,248,295,48.8,52.2,45.7,00000
72.0,63.0,42.0,583,02,01,  Dhitpur,46,42,22,23,24,19,52.3,48.9,55.8,00000
72.0,63.0,42.0,637,01,01,  Maghan,497,602,242,297,255,305,45.2,44.9,45.5,00000
72.0,63.0,42.0,637,02,01,  Gaurakanda,288,140,138,57,150,83,67.3,70.8,64.4,00000
72.0,63.0,42.0,637,03,01,  Satbari,165,340,96,152,69,188,32.7,38.7,26.8,00000
72.0,63.0,42.0,637,04,01,  Gorautra,132,364,60,177,72,187,26.6,25.3,27.8,00000
72.0,63.0,42.0,637,05,01,  Kurarpar,165,159,90,87,75,72,50.9,50.8,51.0,00000
72.0,63.0,42.0,637,06,01,  Putiuga,239,593,120,290,119,303,28.7,29.3,28.2,00000
72.0,63.0,42.0,637,07,01,  Sawratali,171,286,85,140,86,146,37.4,37.8,37.1,00000
72.0,63.0,42.0,847,01,01,  Rampasha,278,434,157,211,121,223,39.0,42.7,35.2,00000
72.0,63.0,42.0,847,02,01,  Parir Char,815,1108,396,532,419,576,42.4,42.7,42.1,00000
72.0,63.0,63.0,466,01,01,  Jhikrala,245,147,136,63,109,84,62.5,68.3,56.5,00000
72.0,63.0,63.0,466,02,01,  Madhupur,190,148,104,73,86,75,56.2,58.8,53.4,00000
72.0,63.0,63.0,625,01,01,  Hasla,211,318,109,157,102,161,39.9,41.0,38.8,00000
72.0,63.0,63.0,625,02,01,  Kayra Para,459,1104,265,526,194,578,29.4,33.5,25.1,00000
72.0,63.0,63.0,676,01,01,  Mamudpur,102,373,42,190,60,183,21.5,18.1,24.7,00000
72.0,63.0,63.0,676,02,01,  Mobarakpur,48,342,24,165,24,177,12.3,12.7,11.9,00000
72.0,63.0,63.0,754,01,01,  Nihara,208,650,114,333,94,317,24.2,25.5,22.9,00000
72.0,63.0,63.0,754,02,01,  Joypur,646,1519,330,713,316,806,29.8,31.6,28.2,00000
72.0,63.0,63.0,878,01,01,  Sahildeo,383,804,194,394,189,410,32.3,33.0,31.6,00000
72.0,63.0,63.0,878,02,01,  Naya Para,121,241,62,117,59,124,33.4,34.6,32.2,00000
72.0,63.0,63.0,878,03,01,  Southkhali,62,96,33,47,29,49,39.2,41.3,37.2,00000
72.0,63.0,63.0,878,04,01,  Utiarkona,52,210,38,113,14,97,19.8,25.2,12.6,00000
72.0,63.0,73.0,217,01,01,  Bhatia,342,499,189,236,153,263,40.7,44.5,36.8,00000
72.0,63.0,73.0,217,02,01,  Naraich,309,403,154,194,155,209,43.4,44.3,42.6,00000
72.0,63.0,73.0,606,01,01,  Kulpotak,508,339,265,154,243,185,60.0,63.2,56.8,00000
72.0,63.0,73.0,606,02,01,  Mahara,170,240,85,125,85,115,41.5,40.5,42.5,00000
72.0,63.0,73.0,606,03,01,  Kandi Para,126,144,77,76,49,68,46.7,50.3,41.9,00000
72.0,63.0,73.0,606,04,01,  Lakshmanpur,237,478,131,222,106,256,33.1,37.1,29.3,00000
72.0,63.0,84.0,116,01,01,  Bara Paikura,301,789,166,365,135,424,27.6,31.3,24.2,00000
72.0,63.0,84.0,116,02,01,  Noagaon,69,385,35,190,34,195,15.2,15.6,14.8,00000
72.0,63.0,84.0,116,03,01,  Dulia,233,483,120,242,113,241,32.5,33.1,31.9,00000
72.0,63.0,84.0,357,01,01,  Fagua,303,879,155,422,148,457,25.6,26.9,24.5,00000
72.0,63.0,84.0,357,02,01,  Abdullapur,21,39,10,19,11,20,35.0,34.5,35.5,00000
72.0,63.0,84.0,357,03,01,  Kandua,137,276,84,123,53,153,33.2,40.6,25.7,00000
72.0,63.0,84.0,373,01,01,  Gajadhar,374,637,184,311,190,326,37.0,37.2,36.8,00000
72.0,63.0,84.0,373,02,01,  Haripur,211,647,135,317,76,330,24.6,29.9,18.7,00000
72.0,63.0,84.0,373,03,01,  Pasukhali,188,579,95,292,93,287,24.5,24.5,24.5,00000
72.0,63.0,84.0,373,04,01,  Anandanagar,29,185,16,92,13,93,13.6,14.8,12.3,00000
72.0,63.0,84.0,404,01,01,  Hanabir,246,610,126,271,120,339,28.7,31.7,26.1,00000
72.0,63.0,84.0,404,02,01,  Bhata Para,180,356,109,152,71,204,33.6,41.8,25.8,00000
72.0,63.0,84.0,443,01,01,  Jainpur,734,1134,371,536,363,598,39.3,40.9,37.8,00000
72.0,63.0,84.0,443,02,01,  Shibpur,27,64,13,30,14,34,29.7,30.2,29.2,00000
72.0,63.0,84.0,443,03,01,  Mohanpur,133,134,57,62,76,72,49.8,47.9,51.4,00000
72.0,63.0,84.0,738,01,01,  Naogaon,38,337,21,161,17,176,10.1,11.5,8.8,00000
72.0,63.0,84.0,738,02,01,  Azampur,97,523,47,274,50,249,15.6,14.6,16.7,00000
72.0,63.0,84.0,987,01,01,  Udaypur,95,223,53,112,42,111,29.9,32.1,27.5,00000
72.0,63.0,84.0,987,02,01,  Raghurampur,86,235,45,108,41,127,26.8,29.4,24.4,00000
72.0,74.0,13.0,015,01,01,  Amtala,547,1029,292,496,255,533,34.7,37.1,32.4,00000
72.0,74.0,13.0,015,02,01,  Kawalikona,260,259,127,118,133,141,50.1,51.8,48.5,00000
72.0,74.0,13.0,015,03,01,  Sapmara,312,945,152,470,160,475,24.8,24.4,25.2,00000
72.0,74.0,13.0,015,04,01,  Kalia,186,181,96,89,90,92,50.7,51.9,49.5,00000
72.0,74.0,13.0,015,05,01,  Jagrakanda,111,306,49,161,62,145,26.6,23.3,30.0,00000
72.0,74.0,13.0,015,06,01,  Kaliakona,53,266,29,131,24,135,16.6,18.1,15.1,00000
72.0,74.0,13.0,015,07,01,  Katakhali,108,190,48,100,60,90,36.2,32.4,40.0,00000
72.0,74.0,13.0,015,08,01,  Manikpur,191,243,77,122,114,121,44.0,38.7,48.5,00000
72.0,74.0,13.0,015,09,01,  Atka Para,198,288,87,147,111,141,40.7,37.2,44.0,00000
72.0,74.0,13.0,015,10,01,  Balnia,186,402,91,194,95,208,31.6,31.9,31.4,00000
72.0,74.0,13.0,015,11,01,  Shibnagar,157,336,70,170,87,166,31.8,29.2,34.4,00000
72.0,74.0,13.0,294,01,01,  Debpur,245,569,125,277,120,292,30.1,31.1,29.1,00000
72.0,74.0,13.0,294,02,01,  Abdullapur,146,235,74,110,72,125,38.3,40.2,36.5,00000
72.0,74.0,13.0,332,01,01,  Dugiarampur,218,409,99,192,119,217,34.8,34.0,35.4,00000
72.0,74.0,13.0,332,02,01,  Pitua,103,290,66,125,37,165,26.2,34.6,18.3,00000
72.0,74.0,13.0,332,03,01,  Naya Para,64,231,29,116,35,115,21.7,20.0,23.3,00000
72.0,74.0,13.0,914,01,01,  Shibprasadpur,266,586,143,286,123,300,31.2,33.3,29.1,00000
72.0,74.0,13.0,914,02,01,  Gobindapur,167,350,81,152,86,198,32.3,34.8,30.3,00000
72.0,74.0,13.0,914,03,01,  Ballabhpur,133,205,74,91,59,114,39.3,44.8,34.1,00000
72.0,74.0,13.0,914,04,01,  Kuraliakada (Santipur),159,179,91,88,68,91,47.0,50.8,42.8,00000
72.0,74.0,13.0,914,05,01,  Hafar,22,58,10,24,12,34,27.5,29.4,26.1,00000
72.0,74.0,13.0,960,01,01,  Swalpa Dugia,605,688,301,329,304,359,46.8,47.8,45.9,00000
72.0,74.0,13.0,960,02,01,  Basha Para,80,95,48,42,32,53,45.7,53.3,37.6,00000
72.0,74.0,13.0,960,03,01,  Char Para,220,331,112,172,108,159,39.9,39.4,40.4,00000
72.0,74.0,15.0,076,01,01,  Purba Bamanmoha,669,403,331,209,338,194,62.4,61.3,63.5,00000
72.0,74.0,15.0,076,02,01,  Paschim Bamanmoha,176,313,88,155,88,158,36.0,36.2,35.8,00000
72.0,74.0,15.0,818,01,01,  Char Para,328,424,170,189,158,235,43.6,47.4,40.2,00000
72.0,74.0,15.0,818,02,01,  Panchashi Para,338,270,193,118,145,152,55.6,62.1,48.8,00000
72.0,74.0,15.0,818,03,01,  Bararia Para,441,634,226,300,215,334,41.0,43.0,39.2,00000
72.0,74.0,23.0,183,01,01,  Bil Heluchhia,68,308,35,154,33,154,18.1,18.5,17.6,00000
72.0,74.0,23.0,183,02,01,  Gopalnagar,46,135,25,69,21,66,25.4,26.6,24.1,00000
72.0,74.0,23.0,279,01,01,  Dapunia,412,553,199,275,213,278,42.7,42.0,43.4,00000
72.0,74.0,23.0,279,02,01,  Kamardhar,84,121,40,57,44,64,41.0,41.2,40.7,00000
72.0,74.0,23.0,279,03,01,  Joypasha,54,211,28,105,26,106,20.4,21.1,19.7,00000
72.0,74.0,31.0,065,01,01,  Balidarun (Darunbali),680,600,367,299,313,301,53.1,55.1,51.0,00000
72.0,74.0,31.0,065,02,01,  Haripur,163,113,93,58,70,55,59.1,61.6,56.0,00000
72.0,74.0,31.0,065,03,01,  Maishakhali,234,164,112,68,122,96,58.8,62.2,56.0,00000
72.0,74.0,31.0,107,01,01,  Bara Kailati,802,727,429,355,373,372,52.5,54.7,50.1,00000
72.0,74.0,31.0,107,02,01,  Arbatabad (Arrongabad),314,602,169,307,145,295,34.3,35.5,33.0,00000
72.0,74.0,31.0,107,03,01,  Shibnibas,118,53,65,20,53,33,69.0,76.5,61.6,00000
72.0,74.0,31.0,107,04,01,  Char Para,336,129,170,63,166,66,72.3,73.0,71.6,00000
72.0,74.0,31.0,191,01,01,  Bil Gujabagi,302,457,175,213,127,244,39.8,45.1,34.2,00000
72.0,74.0,31.0,191,02,01,  Satburikanda,435,519,245,263,190,256,45.6,48.2,42.6,00000
72.0,74.0,31.0,191,03,01,  Khaskandi,139,366,75,177,64,189,27.5,29.8,25.3,00000
72.0,74.0,31.0,191,04,01,  Battala,274,267,131,126,143,141,50.6,51.0,50.4,00000
72.0,74.0,31.0,191,05,01,  Roha Para (Bonua Para),390,349,215,160,175,189,52.8,57.3,48.1,00000
72.0,74.0,31.0,654,01,01,  Bhasha Para,101,98,72,46,29,52,50.8,61.0,35.8,00000
72.0,74.0,31.0,654,02,01,  Maujebali,577,880,320,383,257,497,39.6,45.5,34.1,00000
72.0,74.0,31.0,681,01,01,  Mymensingh Hailora,302,649,157,330,145,319,31.8,32.2,31.3,00000
72.0,74.0,31.0,681,02,01,  Kutubpur,158,76,79,35,79,41,67.5,69.3,65.8,00000
72.0,74.0,47.0,049,01,01,  Baishdhar,433,523,230,264,203,259,45.3,46.6,43.9,00000
72.0,74.0,47.0,049,02,01,  Chak Para,354,300,188,130,166,170,54.1,59.1,49.4,00000
72.0,74.0,47.0,049,03,01,  Atka Para,317,764,146,346,171,418,29.3,29.7,29.0,00000
72.0,74.0,47.0,049,04,01,  Kanda Para,276,302,148,132,128,170,47.8,52.9,43.0,00000
72.0,74.0,47.0,145,01,01,  Boyraura,442,566,233,264,209,302,43.8,46.9,40.9,00000
72.0,74.0,47.0,145,02,01,  Bhutiarbari,66,410,38,210,28,200,13.9,15.3,12.3,00000
72.0,74.0,47.0,145,03,01,  Gidar Para,157,226,90,92,67,134,41.0,49.5,33.3,00000
72.0,74.0,47.0,309,01,01,  Dhuliganti,479,479,234,228,245,251,50.0,50.6,49.4,00000
72.0,74.0,47.0,309,02,01,  Oail Para,340,669,201,322,139,347,33.7,38.4,28.6,00000
72.0,74.0,47.0,378,01,01,  Shatkahan,232,332,110,142,122,190,41.1,43.7,39.1,00000
72.0,74.0,47.0,378,02,01,  Kamalgati,189,179,106,68,83,111,51.4,60.9,42.8,00000
72.0,74.0,47.0,596,01,01,  Lakshmiganj,190,242,101,107,89,135,44.0,48.6,39.7,00000
72.0,74.0,47.0,596,02,01,  Rampur,262,152,145,72,117,80,63.3,66.8,59.4,00000
72.0,74.0,47.0,596,03,01,  Sultanpur,70,28,36,11,34,17,71.4,76.6,66.7,00000
72.0,74.0,54.0,622,01,01,  Madanpur,1216,1955,664,893,552,1062,38.3,42.6,34.2,00000
72.0,74.0,54.0,622,02,01,  Bagha Para,289,400,162,186,127,214,41.9,46.6,37.2,00000
72.0,74.0,54.0,634,01,01,  Mananga,490,1411,280,683,210,728,25.8,29.1,22.4,00000
72.0,74.0,54.0,634,02,01,  Sultanganti,16,18,10,6,6,12,47.1,62.5,33.3,00000
72.0,74.0,54.0,687,01,01,  Nandipur,709,1060,352,508,357,552,40.1,40.9,39.3,00000
72.0,74.0,54.0,687,02,01,  Chaura Para,143,415,78,204,65,211,25.6,27.7,23.6,00000
72.0,74.0,54.0,687,03,01,  Dhanchapur,215,169,117,72,98,97,56.0,61.9,50.3,00000
72.0,74.0,54.0,966,01,01,  Tentulia,588,711,304,353,284,358,45.3,46.3,44.2,00000
72.0,74.0,54.0,966,02,01,  Kachhimpur,337,86,178,38,159,48,79.7,82.4,76.8,00000
72.0,74.0,55.0,091,01,01,  Dhorer Bangla,338,401,170,196,168,205,45.7,46.4,45.0,00000
72.0,74.0,55.0,091,02,01,  Khar Bangla,733,547,335,267,398,280,57.3,55.6,58.7,00000
72.0,74.0,55.0,168,01,01,  Bhatli Bhita,50,207,29,100,21,107,19.5,22.5,16.4,00000
72.0,74.0,55.0,168,02,01,  Burkhila,56,246,27,122,29,124,18.5,18.1,19.0,00000
72.0,74.0,55.0,675,01,01,  Muktipur,892,1569,427,814,465,755,36.2,34.4,38.1,00000
72.0,74.0,55.0,675,02,01,  Shaljan (Pukuria),174,312,93,162,81,150,35.8,36.5,35.1,00000
72.0,74.0,63.0,405,01,01,  Hapania,235,467,106,232,129,235,33.5,31.4,35.4,00000
72.0,74.0,63.0,405,02,01,  Bade Bahar,74,178,33,89,41,89,29.4,27.0,31.5,00000
72.0,74.0,79.0,114,01,01,  Bara Gara,398,1694,219,828,179,866,19.0,20.9,17.1,00000
72.0,74.0,79.0,114,02,01,  Gopalpur,118,286,52,139,66,147,29.2,27.2,31.0,00000
72.0,74.0,79.0,114,03,01,  Balijuri,181,302,95,146,86,156,37.5,39.4,35.5,00000
72.0,74.0,79.0,466,01,01,  Kachuduari,492,529,259,233,233,296,48.2,52.6,44.0,00000
72.0,74.0,79.0,466,02,01,  Char Para,243,795,136,361,107,434,23.4,27.4,19.8,00000
72.0,74.0,79.0,581,01,01,  Kumri,308,435,146,214,162,221,41.5,40.6,42.3,00000
72.0,74.0,79.0,581,02,01,  Maishakanda,18,23,9,11,9,12,43.9,45.0,42.9,00000
72.0,74.0,79.0,826,01,01,  Rauha,490,579,261,281,229,298,45.8,48.2,43.5,00000
72.0,74.0,79.0,826,02,01,  Mobarakpur,168,174,81,82,87,92,49.1,49.7,48.6,00000
72.0,74.0,79.0,826,03,01,  Char Konadahor,55,56,25,23,30,33,49.5,52.1,47.6,00000
72.0,74.0,79.0,855,01,01,  Sahapur,107,146,51,63,56,83,42.3,44.7,40.3,00000
72.0,74.0,79.0,855,02,01,  Gobindapur,10,41,3,22,7,19,19.6,12.0,26.9,00000
72.0,74.0,79.0,855,03,01,  Ratneshwar,34,91,23,46,11,45,27.2,33.3,19.6,00000
72.0,74.0,79.0,855,04,01,  Banipur,42,68,21,32,21,36,38.2,39.6,36.8,00000
72.0,74.0,87.0,306,01,01,  Dhitpur,311,371,147,188,164,183,45.6,43.9,47.3,00000
72.0,74.0,87.0,306,02,01,  Mobarakpur,268,246,131,119,137,127,52.1,52.4,51.9,00000
72.0,74.0,87.0,535,01,01,  Koyra,256,210,131,99,125,111,54.9,57.0,53.0,00000
72.0,74.0,87.0,535,02,01,  Koyra Gobindapur,124,173,62,73,62,100,41.8,45.9,38.3,00000
72.0,74.0,87.0,692,01,01,  Mymensingh Ruhi,415,527,225,255,190,272,44.1,46.9,41.1,00000
72.0,74.0,87.0,692,02,01,  Pratappur,261,353,121,174,140,179,42.5,41.0,43.9,00000
72.0,74.0,87.0,692,03,01,  Noapara,238,164,130,69,108,95,59.2,65.3,53.2,00000
72.0,74.0,87.0,692,04,01,  Kurpar,144,281,62,148,82,133,33.9,29.5,38.1,00000
72.0,74.0,94.0,153,01,01,  Betati,695,1150,359,551,336,599,37.7,39.5,35.9,00000
72.0,74.0,94.0,153,02,01,  Soarikanda,67,38,38,14,29,24,63.8,73.1,54.7,00000
72.0,74.0,94.0,922,01,01,  Shimulati,290,329,168,161,122,168,46.8,51.1,42.1,00000
72.0,74.0,94.0,922,02,01,  Paharpur,164,243,83,96,81,147,40.3,46.4,35.5,00000
72.0,74.0,94.0,971,01,01,  Tatiar,133,193,71,81,62,112,40.8,46.7,35.6,00000
72.0,74.0,94.0,971,02,01,  Jogarpar,58,244,26,121,32,123,19.2,17.7,20.6,00000
72.0,74.0,94.0,971,03,01,  Khalpar,93,246,50,110,43,136,27.4,31.3,24.0,00000
72.0,74.0,94.0,971,04,01,  Koarpar,198,250,105,123,93,127,44.2,46.1,42.3,00000
72.0,74.0,94.0,971,05,01,  Baraidahar,187,159,90,75,97,84,54.0,54.5,53.6,00000
72.0,74.0,94.0,971,06,01,  Jahangirpur,337,224,175,96,162,128,60.1,64.6,55.9,00000
72.0,74.0,94.0,971,07,01,  Char Para,291,419,144,193,147,226,41.0,42.7,39.4,00000
72.0,74.0,94.0,983,01,01,  Thakurakona,1338,1398,722,677,616,721,48.9,51.6,46.1,00000
72.0,74.0,94.0,983,02,01,  Singbajan,338,224,166,118,172,106,60.1,58.5,61.9,00000
72.0,83.0,13.0,004,01,01,  Agia,871,931,454,408,417,523,48.3,52.7,44.4,00000
72.0,83.0,13.0,004,02,01,  Bede Agia,206,166,106,68,100,98,55.4,60.9,50.5,00000
72.0,83.0,13.0,004,03,01,  Mahishbar,520,797,284,372,236,425,39.5,43.3,35.7,00000
72.0,83.0,13.0,004,04,01,  Kakiakuri,163,196,74,80,89,116,45.4,48.1,43.4,00000
72.0,83.0,13.0,004,05,01,  Fachualanji,199,174,90,68,109,106,53.4,57.0,50.7,00000
72.0,83.0,13.0,004,06,01,  Madhunal,192,361,97,165,95,196,34.7,37.0,32.6,00000
72.0,83.0,13.0,084,01,01,  Baniakanda,38,107,17,52,21,55,26.2,24.6,27.6,00000
72.0,83.0,13.0,084,02,01,  Ukakanda,89,127,39,58,50,69,41.2,40.2,42.0,00000
72.0,83.0,13.0,143,01,01,  Berail,762,852,347,403,415,449,47.2,46.3,48.0,00000
72.0,83.0,13.0,143,02,01,  Tekuria,244,324,121,160,123,164,43.0,43.1,42.9,00000
72.0,83.0,13.0,143,03,01,  Jagir,144,384,62,191,82,193,27.3,24.5,29.8,00000
72.0,83.0,13.0,143,04,01,  Padurkanda,42,339,15,169,27,170,11.0,8.2,13.7,00000
72.0,83.0,13.0,211,01,01,  Budhi,826,1294,403,620,423,674,39.0,39.4,38.6,00000
72.0,83.0,13.0,211,02,01,  Konabudhi,49,119,22,59,27,60,29.2,27.2,31.0,00000
72.0,83.0,13.0,533,01,01,  Uttar Kalduar,562,890,275,410,287,480,38.7,40.1,37.4,00000
72.0,83.0,13.0,533,02,01,  Dakshin Kalduar,427,1153,206,517,221,636,27.0,28.5,25.8,00000
72.0,83.0,13.0,592,01,01,  Kharchail,134,459,69,230,65,229,22.6,23.1,22.1,00000
72.0,83.0,13.0,592,02,01,  Kaikurikandi,3,10,3,6,0,4,23.1,33.3,0.0,00000
72.0,83.0,15.0,016,01,01,  Alampur,281,279,148,132,133,147,50.2,52.9,47.5,00000
72.0,83.0,15.0,016,02,01,  Sehala Para,149,183,66,85,83,98,44.9,43.7,45.9,00000
72.0,83.0,15.0,016,03,01,  Palastala,179,226,87,100,92,126,44.2,46.5,42.2,00000
72.0,83.0,15.0,016,04,01,  Tanganti Para,292,418,157,187,135,231,41.1,45.6,36.9,00000
72.0,83.0,23.0,249,01,01,  Chor Bahuli,107,211,46,94,61,117,33.6,32.9,34.3,00000
72.0,83.0,23.0,249,02,01,  Dadra Para,86,141,37,71,49,70,37.9,34.3,41.2,00000
72.0,83.0,31.0,033,01,01,  Atka Para,55,147,25,73,30,74,27.2,25.5,28.8,00000
72.0,83.0,31.0,033,02,01,  Char Para,39,68,23,30,16,38,36.4,43.4,29.6,00000
72.0,83.0,31.0,122,01,01,  Basati,90,339,54,168,36,171,21.0,24.3,17.4,00000
72.0,83.0,31.0,122,02,01,  Inathpur,20,96,14,55,6,41,17.2,20.3,12.8,00000
72.0,83.0,31.0,177,01,01,  Binna,336,530,161,253,175,277,38.8,38.9,38.7,00000
72.0,83.0,31.0,177,02,01,  Baman Binna,42,49,24,22,18,27,46.2,52.2,40.0,00000
72.0,83.0,31.0,309,01,01,  Aroar Char,256,514,124,268,132,246,33.2,31.6,34.9,00000
72.0,83.0,31.0,309,02,01,  Kurikunia,402,315,186,163,216,152,56.1,53.3,58.7,00000
72.0,83.0,31.0,309,03,01,  Patli,136,519,61,253,75,266,20.8,19.4,22.0,00000
72.0,83.0,31.0,309,04,01,  Dasashi,84,243,36,122,48,121,25.7,22.8,28.4,00000
72.0,83.0,31.0,309,05,01,  Dhala Mulgaon,194,236,91,116,103,120,45.1,44.0,46.2,00000
72.0,83.0,31.0,309,06,01,  Nalua Para,145,261,71,125,74,136,35.7,36.2,35.2,00000
72.0,83.0,31.0,309,07,01,  Dhala Majh Para,598,756,294,390,304,366,44.2,43.0,45.4,00000
72.0,83.0,31.0,364,01,01,  Gabia,26,31,16,14,10,17,45.6,53.3,37.0,00000
72.0,83.0,31.0,364,02,01,  Barial,340,464,179,239,161,225,42.3,42.8,41.7,00000
72.0,83.0,31.0,664,01,01,  Lauari,531,730,260,366,271,364,42.1,41.5,42.7,00000
72.0,83.0,31.0,664,02,01,  Char Para,59,213,30,102,29,111,21.7,22.7,20.7,00000
72.0,83.0,31.0,910,01,01,  Salthi,446,517,240,252,206,265,46.3,48.8,43.7,00000
72.0,83.0,31.0,910,02,01,  Ghagra Para,449,414,229,191,220,223,52.0,54.5,49.7,00000
72.0,83.0,39.0,038,01,01,  Auti,413,336,210,163,203,173,55.1,56.3,54.0,00000
72.0,83.0,39.0,038,02,01,  Nischintapur,56,76,31,37,25,39,42.4,45.6,39.1,00000
72.0,83.0,39.0,381,01,01,  Char Para,840,642,431,309,409,333,56.7,58.2,55.1,00000
72.0,83.0,39.0,381,02,01,  Kalipur,95,87,48,39,47,48,52.2,55.2,49.5,00000
72.0,83.0,39.0,381,03,01,  Kuskhali,199,154,97,79,102,75,56.4,55.1,57.6,00000
72.0,83.0,39.0,381,04,01,  Ghagra,646,628,332,283,314,345,50.7,54.0,47.6,00000
72.0,83.0,39.0,601,01,01,  Tutia,164,402,77,202,87,200,29.0,27.6,30.3,00000
72.0,83.0,39.0,601,02,01,  Chandrakona,86,174,51,88,35,86,33.1,36.7,28.9,00000
72.0,83.0,39.0,601,03,01,  Khatuair,412,424,196,205,216,219,49.3,48.9,49.7,00000
72.0,83.0,39.0,724,01,01,  Ramkanda,198,345,106,178,92,167,36.5,37.3,35.5,00000
72.0,83.0,39.0,724,02,01,  Kanda Para,252,388,109,199,143,189,39.4,35.4,43.1,00000
72.0,83.0,39.0,724,03,01,  Uduarkanda,82,184,26,88,56,96,30.8,22.8,36.8,00000
72.0,83.0,39.0,724,04,01,  Biswas Para,708,784,344,397,364,387,47.5,46.4,48.5,00000
72.0,83.0,39.0,724,05,01,  Paschimpara,554,1083,257,533,297,550,33.8,32.5,35.1,00000
72.0,83.0,39.0,724,06,01,  Madhyapara,594,984,294,467,300,517,37.6,38.6,36.7,00000
72.0,83.0,39.0,724,07,01,  Dilarakanda,93,220,47,117,46,103,29.7,28.7,30.9,00000
72.0,83.0,63.0,440,01,01,  Hogla Bazar,110,39,64,23,46,16,73.8,73.6,74.2,00000
72.0,83.0,63.0,440,02,01,  Sohagi Dahar,386,765,178,371,208,394,33.5,32.4,34.6,00000
72.0,83.0,63.0,440,03,01,  Chalit Dahar,665,386,339,189,326,197,63.3,64.2,62.3,00000
72.0,83.0,63.0,440,04,01,  Jamkona,114,356,60,173,54,183,24.3,25.8,22.8,00000
72.0,83.0,63.0,440,05,01,  Hogla Paschim Para,169,30,86,13,83,17,84.9,86.9,83.0,00000
72.0,83.0,63.0,440,06,01,  Jamirakanda,498,689,224,330,274,359,42.0,40.4,43.3,00000
72.0,83.0,63.0,440,07,01,  Khanirpas,69,129,36,76,33,53,34.8,32.1,38.4,00000
72.0,83.0,63.0,440,08,01,  Nij Hogla,722,933,338,413,384,520,43.6,45.0,42.5,00000
72.0,83.0,63.0,440,09,01,  Sadhu Para,699,899,352,438,347,461,43.7,44.6,42.9,00000
72.0,83.0,63.0,440,10,01,  Paschim Bikunia,385,374,187,168,198,206,50.7,52.7,49.0,00000
72.0,83.0,63.0,440,11,01,  Purba Bikunia,452,628,223,305,229,323,41.9,42.2,41.5,00000
72.0,83.0,63.0,440,12,01,  Shibpur,72,240,27,132,45,108,23.1,17.0,29.4,00000
72.0,83.0,63.0,440,13,01,  Paglakandar,445,399,210,193,235,206,52.7,52.1,53.3,00000
72.0,83.0,63.0,541,01,01,  Kaliharkanda,351,342,182,160,169,182,50.6,53.2,48.1,00000
72.0,83.0,63.0,541,02,01,  Chilargati,327,452,161,207,166,245,42.0,43.8,40.4,00000
72.0,83.0,63.0,541,03,01,  Joardar Para,133,240,57,109,76,131,35.7,34.3,36.7,00000
72.0,83.0,63.0,541,04,01,  Bairagi Para,212,207,98,104,114,103,50.6,48.5,52.5,00000
72.0,83.0,63.0,541,05,01,  Maiz Para,265,436,138,213,127,223,37.8,39.3,36.3,00000
72.0,83.0,63.0,541,06,01,  Kona Kalihar,347,422,167,197,180,225,45.1,45.9,44.4,00000
72.0,83.0,63.0,541,07,01,  Dulikar,122,334,71,159,51,175,26.8,30.9,22.6,00000
72.0,83.0,63.0,541,08,01,  Halida Para,97,119,49,61,48,58,44.9,44.5,45.3,00000
72.0,83.0,63.0,541,09,01,  Kalihar Char,46,419,21,206,25,213,9.9,9.3,10.5,00000
72.0,83.0,63.0,800,01,01,  Painsa,376,524,186,253,190,271,41.8,42.4,41.2,00000
72.0,83.0,63.0,800,02,01,  Pretak Para,57,243,24,132,33,111,19.0,15.4,22.9,00000
72.0,83.0,63.0,800,03,01,  Sharial Para,63,174,30,95,33,79,26.6,24.0,29.5,00000
72.0,83.0,63.0,863,01,01,  Purba Pathera,292,438,132,216,160,222,40.0,37.9,41.9,00000
72.0,83.0,63.0,863,02,01,  Ukuakanda,267,49,113,30,154,19,84.5,79.0,89.0,00000
72.0,83.0,63.0,927,01,01,  Sehala,661,827,321,392,340,435,44.4,45.0,43.9,00000
72.0,83.0,63.0,927,02,01,  Sehala Char,85,373,44,200,41,173,18.6,18.0,19.2,00000
72.0,83.0,71.0,093,01,01,  Baora Uttarpara,608,954,296,478,312,476,38.9,38.2,39.6,00000
72.0,83.0,71.0,093,02,01,  Baora Dakshinpara,711,894,386,435,325,459,44.3,47.0,41.5,00000
72.0,83.0,71.0,093,03,01,  Baora Paschimpara,82,578,38,295,44,283,12.4,11.4,13.5,00000
72.0,83.0,71.0,093,04,01,  Gumkanda,280,202,141,100,139,102,58.1,58.5,57.7,00000
72.0,83.0,71.0,270,01,01,  Daldala,231,436,138,201,93,235,34.6,40.7,28.4,00000
72.0,83.0,71.0,270,02,01,  Gojakhalikandi,608,835,259,442,349,393,42.1,36.9,47.0,00000
72.0,83.0,71.0,478,01,03,  Jaria,1214,1703,585,861,629,842,41.6,40.5,42.8,00000
72.0,83.0,71.0,478,02,03,  Jaria Bazar,598,190,331,90,267,100,75.9,78.6,72.8,00000
72.0,83.0,71.0,478,03,03,  Nalua Para,207,607,106,324,101,283,25.4,24.7,26.3,00000
72.0,83.0,71.0,728,01,01,  Megha Para,135,169,70,77,65,92,44.4,47.6,41.4,00000
72.0,83.0,71.0,728,02,01,  Chhandhara,272,727,132,341,140,386,27.2,27.9,26.6,00000
72.0,83.0,71.0,728,03,01,  Naldagra,30,163,13,76,17,87,15.5,14.6,16.3,00000
72.0,83.0,71.0,762,01,03,  Naterkona,907,966,511,499,396,467,48.4,50.6,45.9,00000
72.0,83.0,71.0,762,02,03,  Nalua Para,576,1040,300,513,276,527,35.6,36.9,34.4,00000
72.0,83.0,79.0,580,01,01,  Purbapara,526,381,287,182,239,199,58.0,61.2,54.6,00000
72.0,83.0,79.0,580,02,01,  Bandar Para,227,189,105,94,122,95,54.6,52.8,56.2,00000
72.0,83.0,79.0,580,03,01,  Chak Para,79,178,43,88,36,90,30.7,32.8,28.6,00000
72.0,83.0,79.0,580,04,01,  Mulgram,159,102,74,45,85,57,60.9,62.2,59.9,00000
72.0,83.0,79.0,580,05,01,  Kurpara,221,259,119,108,102,151,46.0,52.4,40.3,00000
72.0,83.0,79.0,580,06,01,  Lacky Pur,296,552,152,289,144,263,34.9,34.5,35.4,00000
72.0,83.0,79.0,580,07,01,  Khailajana,137,199,67,92,70,107,40.8,42.1,39.5,00000
72.0,83.0,79.0,580,08,01,  Ulukanda,171,69,89,30,82,39,71.3,74.8,67.8,00000
72.0,83.0,79.0,580,09,01,  Dulatpur,86,136,45,70,41,66,38.7,39.1,38.3,00000
72.0,83.0,79.0,580,10,01,  Akirakanda,135,223,70,111,65,112,37.7,38.7,36.7,00000
72.0,83.0,79.0,580,11,01,  Manarkanda,218,485,125,233,93,252,31.0,34.9,27.0,00000
72.0,83.0,79.0,580,12,01,  Namasudra Para,54,140,30,67,24,73,27.8,30.9,24.7,00000
72.0,83.0,79.0,580,13,01,  Banpara (Dari Para),297,691,150,314,147,377,30.1,32.3,28.1,00000
72.0,83.0,79.0,652,01,01,  Langaljora,154,594,69,285,85,309,20.6,19.5,21.6,00000
72.0,83.0,79.0,652,02,01,  Noapara,351,297,187,130,164,167,54.2,59.0,49.5,00000
72.0,83.0,79.0,783,01,01,  Paschimpur,183,196,94,85,89,111,48.3,52.5,44.5,00000
72.0,83.0,79.0,783,02,01,  Sekh Para,240,213,129,91,111,122,53.0,58.6,47.6,00000
72.0,83.0,79.0,783,03,01,  Maskanda,177,509,87,228,90,281,25.8,27.6,24.3,00000
72.0,83.0,79.0,783,04,01,  Hindu Para,298,429,153,209,145,220,41.0,42.3,39.7,00000
72.0,83.0,79.0,783,05,01,  Maij Para,336,319,166,150,170,169,51.3,52.5,50.1,00000
72.0,83.0,79.0,783,06,01,  Daspara,140,147,84,62,56,85,48.8,57.5,39.7,00000
72.0,83.0,79.0,783,07,01,  Tala Pabai,145,147,72,59,73,88,49.7,55.0,45.3,00000
72.0,83.0,79.0,842,01,01,  Pratappur,552,662,296,322,256,340,45.5,47.9,43.0,00000
72.0,83.0,79.0,842,02,01,  Fazilpur,241,264,128,121,113,143,47.7,51.4,44.1,00000
72.0,83.0,79.0,842,03,01,  Hapania,539,438,250,188,289,250,55.2,57.1,53.6,00000
72.0,83.0,79.0,939,01,01,  Shimulkandi,463,1105,240,594,223,511,29.5,28.8,30.4,00000
72.0,83.0,79.0,939,02,01,  Baharakanda,71,218,37,100,34,118,24.6,27.0,22.4,00000
72.0,83.0,87.0,283,01,01,  Dapunia,74,208,36,101,38,107,26.2,26.3,26.2,00000
72.0,83.0,87.0,283,02,01,  Shihora Duari,119,403,61,203,58,200,22.8,23.1,22.5,00000
72.0,83.0,87.0,745,01,01,  Narandia,875,790,435,363,440,427,52.6,54.5,50.7,00000
72.0,83.0,87.0,745,02,01,  Kumarkanda,90,127,47,66,43,61,41.5,41.6,41.3,00000
72.0,83.0,87.0,795,01,01,  Pailati,1049,896,560,397,489,499,53.9,58.5,49.5,00000
72.0,83.0,87.0,795,02,01,  Kola Para,436,133,234,58,202,75,76.6,80.1,72.9,00000
72.0,83.0,87.0,795,03,01,  Shahodkona,478,218,241,114,237,104,68.7,67.9,69.5,00000
72.0,83.0,87.0,795,04,01,  Salsapur,100,441,45,218,55,223,18.5,17.1,19.8,00000
72.0,83.0,87.0,982,01,01,  Tulabaid,153,253,88,105,65,148,37.7,45.6,30.5,00000
72.0,83.0,87.0,982,02,01,  Shankhala,91,269,39,137,52,132,25.3,22.2,28.3,00000
72.0,83.0,94.0,114,01,01,  Bardhar,171,566,80,260,91,306,23.2,23.5,22.9,00000
72.0,83.0,94.0,114,02,01,  Jugli,66,195,27,89,39,106,25.3,23.3,26.9,00000
72.0,83.0,94.0,160,01,01,  Bhitargaon,378,590,190,269,188,321,39.0,41.4,36.9,00000
72.0,83.0,94.0,160,02,01,  Hiri Bhita,133,356,65,174,68,182,27.2,27.2,27.2,00000
72.0,83.0,94.0,749,01,01,  Narayandahar,546,1110,298,524,248,586,33.0,36.3,29.7,00000
72.0,83.0,94.0,749,02,01,  Ukuakanda,85,171,42,80,43,91,33.2,34.4,32.1,00000
72.0,83.0,94.0,851,01,03,  Purbadhala,4311,1863,2258,828,2053,1035,69.8,73.2,66.5,00000
72.0,83.0,94.0,851,02,03,  Atka Para,263,353,131,176,132,177,42.7,42.7,42.7,00000
72.0,83.0,94.0,851,03,03,  Salmarkanda,95,103,49,49,46,54,48.0,50.0,46.0,00000
72.0,83.0,94.0,851,04,03,  Pukuriaandh,175,264,85,137,90,127,39.9,38.3,41.5,00000
72.0,83.0,94.0,851,05,03,  Digjan,98,253,49,123,49,130,27.9,28.5,27.4,00000
72.0,83.0,94.0,851,06,03,  Godaria,33,53,14,27,19,26,38.4,34.1,42.2,00000
72.0,83.0,94.0,851,07,03,  Sijkandi,286,343,144,179,142,164,45.5,44.6,46.4,00000
72.0,83.0,94.0,851,08,03,  Barnakanda,183,237,76,127,107,110,43.6,37.4,49.3,00000
72.0,83.0,94.0,851,09,03,  Naya Para,802,759,435,351,367,408,51.4,55.3,47.4,00000
39.0,7.0,11.0,015,01,01,  Alir Para,402,1213,221,563,181,650,24.9,28.2,21.8,00000
39.0,7.0,11.0,015,02,01,  Morar Para,368,910,199,408,169,502,28.8,32.8,25.2,00000
39.0,7.0,11.0,015,03,01,  Tangari Para,548,885,286,389,262,496,38.2,42.4,34.6,00000
39.0,7.0,11.0,062,01,01,  Uttar Bagar Char,266,1405,132,664,134,741,15.9,16.6,15.3,00000
39.0,7.0,11.0,062,02,01,  Dakshin Bagar Char,315,532,151,236,164,296,37.2,39.0,35.7,00000
39.0,7.0,11.0,062,03,01,  Nama Para,384,1115,181,547,203,568,25.6,24.9,26.3,00000
39.0,7.0,11.0,062,04,01,  Zula Para,139,627,67,309,72,318,18.1,17.8,18.5,00000
39.0,7.0,11.0,466,01,01,  Golakati,240,522,118,246,122,276,31.5,32.4,30.7,00000
39.0,7.0,11.0,466,02,01,  Naya Para,481,1136,259,533,222,603,29.7,32.7,26.9,00000
39.0,7.0,11.0,466,03,01,  Sarkar Para,289,484,135,222,154,262,37.4,37.8,37.0,00000
39.0,7.0,11.0,466,04,01,  Molla Para,335,495,159,226,176,269,40.4,41.3,39.6,00000
39.0,7.0,11.0,466,05,01,  Madhyapara,258,703,146,306,112,397,26.8,32.3,22.0,00000
39.0,7.0,11.0,466,06,01,  Bangal Para,73,603,32,308,41,295,10.8,9.4,12.2,00000
39.0,7.0,11.0,466,07,01,  Mandal Para,222,314,103,127,119,187,41.4,44.8,38.9,00000
39.0,7.0,11.0,466,08,01,  Suner Para,169,510,77,243,92,267,24.9,24.1,25.6,00000
39.0,7.0,11.0,466,09,01,  Dakpara,132,480,70,228,62,252,21.6,23.5,19.7,00000
39.0,7.0,11.0,855,01,01,  Parir Char,167,552,84,246,83,306,23.2,25.5,21.3,00000
39.0,7.0,11.0,855,02,01,  Ramrampur,223,676,111,298,112,378,24.8,27.1,22.9,00000
39.0,7.0,11.0,855,03,01,  Uttar Sharmara,330,986,149,497,181,489,25.1,23.1,27.0,00000
39.0,7.0,11.0,855,04,01,  Dakshin Sarmara,671,970,348,460,323,510,40.9,43.1,38.8,00000
39.0,7.0,11.0,855,05,01,  Khashergaon,416,814,195,395,221,419,33.8,33.1,34.5,00000
39.0,7.0,11.0,855,06,01,  Taliapara,821,2140,396,1046,425,1094,27.7,27.5,28.0,00000
39.0,7.0,11.0,855,07,01,  Gopalpur,684,1094,340,485,344,609,38.5,41.2,36.1,00000
39.0,7.0,11.0,855,08,01,  Dharar Char,390,890,197,426,193,464,30.5,31.6,29.4,00000
39.0,7.0,11.0,855,09,01,  Tupker Char,132,331,78,149,54,182,28.5,34.4,22.9,00000
39.0,7.0,11.0,855,10,01,  Satbhita,440,1043,228,504,212,539,29.7,31.1,28.2,00000
39.0,7.0,11.0,855,11,01,  Balur Char,155,769,94,362,61,407,16.8,20.6,13.0,00000
39.0,7.0,23.0,295,01,03,  Sarkar Para,267,145,104,61,163,84,64.8,63.0,66.0,00000
39.0,7.0,23.0,295,02,03,  Pakhi Mara,439,805,226,390,213,415,35.3,36.7,33.9,00000
39.0,7.0,23.0,295,03,03,  Uttar Simar Para,1237,1311,672,619,565,692,48.5,52.1,44.9,00000
39.0,7.0,23.0,295,04,03,  Chandraban,169,168,85,81,84,87,50.1,51.2,49.1,00000
39.0,7.0,23.0,295,05,03,  Majh Para,638,649,330,286,308,363,49.6,53.6,45.9,00000
39.0,7.0,23.0,295,06,03,  Gona Para,229,438,118,187,111,251,34.3,38.7,30.7,00000
39.0,7.0,23.0,295,07,03,  Tali Para,288,536,156,255,132,281,35.0,38.0,32.0,00000
39.0,7.0,23.0,295,08,03,  Bhatia Para,138,451,75,213,63,238,23.4,26.0,20.9,00000
39.0,7.0,23.0,295,09,03,  Dari Para,413,929,214,441,199,488,30.8,32.7,29.0,00000
39.0,7.0,23.0,295,10,03,  Tikerkandi,586,721,302,355,284,366,44.8,46.0,43.7,00000
39.0,7.0,23.0,295,11,03,  Khamar Para,125,364,65,174,60,190,25.6,27.2,24.0,00000
39.0,7.0,23.0,295,12,03,  Paschim Char Kauria Para,474,700,261,324,213,376,40.4,44.6,36.2,00000
39.0,7.0,23.0,295,13,03,  Dakshin Simar Para,442,281,254,155,188,126,61.1,62.1,59.9,00000
39.0,7.0,23.0,295,14,03,  Kayesta Para,40,61,23,28,17,33,39.6,45.1,34.0,00000
39.0,7.0,23.0,295,15,03,  Charia Para,731,418,386,186,345,232,63.6,67.5,59.8,00000
39.0,7.0,23.0,761,01,01,  Chalak Para,66,362,32,168,34,194,15.4,16.0,14.9,00000
39.0,7.0,23.0,761,02,01,  Singar Char,146,271,69,126,77,145,35.0,35.4,34.7,00000
39.0,7.0,23.0,761,03,01,  Jigatala,73,407,37,197,36,210,15.2,15.8,14.6,00000
39.0,7.0,23.0,761,04,01,  Maulvi Para,244,645,128,317,116,328,27.4,28.8,26.1,00000
39.0,7.0,23.0,761,05,01,  Beparipara,86,345,54,163,32,182,20.0,24.9,15.0,00000
39.0,7.0,23.0,761,06,01,  Ghosh Para,131,187,68,87,63,100,41.2,43.9,38.7,00000
39.0,7.0,23.0,761,07,01,  Mandal Para,273,588,149,266,124,322,31.7,35.9,27.8,00000
39.0,7.0,23.0,761,08,01,  Takir Para,135,590,78,274,57,316,18.6,22.2,15.3,00000
39.0,7.0,23.0,761,09,01,  Malir Char Dumali Para,381,526,191,247,190,279,42.0,43.6,40.5,00000
39.0,7.0,23.0,761,10,01,  Jalar Char Purba Para,269,338,146,148,123,190,44.3,49.7,39.3,00000
39.0,7.0,23.0,761,11,01,  Jalar Char Paschim Para,283,654,138,331,145,323,30.2,29.4,31.0,00000
39.0,7.0,23.0,761,12,01,  Mesher Char Paschim Para,423,518,219,250,204,268,45.0,46.7,43.2,00000
39.0,7.0,23.0,761,13,01,  Mesher Char Purba Para,265,767,145,368,120,399,25.7,28.3,23.1,00000
39.0,7.0,23.0,761,14,01,  Malir Char Paschim Para,91,279,50,154,41,125,24.6,24.5,24.7,00000
39.0,7.0,23.0,761,15,01,  Baraitari,159,185,86,81,73,104,46.2,51.5,41.2,00000
39.0,7.0,23.0,761,16,01,  Naya Para,368,874,177,412,191,462,29.6,30.1,29.2,00000
39.0,7.0,23.0,823,01,03,  Masher Char Nama Para,270,817,138,405,132,412,24.8,25.4,24.3,00000
39.0,7.0,23.0,823,02,03,  Modak Para,273,157,148,70,125,87,63.5,67.9,59.0,00000
39.0,7.0,23.0,823,03,03,  Kaghmari Para,188,565,101,264,87,301,25.0,27.7,22.4,00000
39.0,7.0,23.0,823,04,03,  Bakshiganj Nama Para,808,681,436,304,372,377,54.3,58.9,49.7,00000
39.0,7.0,23.0,823,05,03,  Bakshiganj Uttar Para,424,381,222,166,202,215,52.7,57.2,48.4,00000
39.0,7.0,23.0,823,06,03,  Mali Para,56,19,31,8,25,11,74.7,79.5,69.4,00000
39.0,7.0,23.0,823,07,03,  Bakshiganj Bazar,595,199,321,97,274,102,74.9,76.8,72.9,00000
39.0,7.0,23.0,823,08,03,  Saudagar Para,265,349,147,158,118,191,43.2,48.2,38.2,00000
39.0,7.0,23.0,823,09,03,  Miah Para,634,560,316,247,318,313,53.1,56.1,50.4,00000
39.0,7.0,23.0,823,10,03,  Bayen Para,579,420,326,184,253,236,58.0,63.9,51.7,00000
39.0,7.0,23.0,823,11,03,  Pakhimara,272,189,129,83,143,106,59.0,60.8,57.4,00000
39.0,7.0,23.0,823,12,03,  Jigatala,198,355,90,184,108,171,35.8,32.8,38.7,00000
39.0,7.0,23.0,823,13,03,  Sardar Para,473,236,246,122,227,114,66.7,66.8,66.6,00000
39.0,7.0,23.0,932,01,01,  Purbapara,872,1433,459,691,413,742,37.8,39.9,35.8,00000
39.0,7.0,23.0,932,02,01,  Paschimpara,1012,1427,525,666,487,761,41.5,44.1,39.0,00000
39.0,7.0,23.0,932,03,01,  Monaksha,211,321,108,154,103,167,39.7,41.2,38.1,00000
39.0,7.0,35.0,134,01,01,  Puran Battajore,791,1262,403,580,388,682,38.5,41.0,36.3,00000
39.0,7.0,35.0,134,02,01,  Jurarpar,304,274,160,121,144,153,52.6,56.9,48.5,00000
39.0,7.0,35.0,134,03,01,  Ujan Para,422,524,207,238,215,286,44.6,46.5,42.9,00000
39.0,7.0,35.0,134,04,01,  Purbapara,697,882,334,396,363,486,44.1,45.8,42.8,00000
39.0,7.0,35.0,134,05,01,  Paschimpara,551,600,265,306,286,294,47.9,46.4,49.3,00000
39.0,7.0,35.0,134,06,01,  Kumarikanda,186,208,93,91,93,117,47.2,50.5,44.3,00000
39.0,7.0,35.0,134,07,01,  Chak Para,288,140,142,56,146,84,67.3,71.7,63.5,00000
39.0,7.0,35.0,134,08,01,  Charia Para,109,181,53,78,56,103,37.6,40.5,35.2,00000
39.0,7.0,35.0,134,09,01,  Khamaria Para,347,403,169,178,178,225,46.3,48.7,44.2,00000
39.0,7.0,35.0,134,10,01,  Birgaon Kanda Para,135,154,68,66,67,88,46.7,50.7,43.2,00000
39.0,7.0,35.0,134,11,01,  Birgaon Uttar Para,311,335,148,145,163,190,48.1,50.5,46.2,00000
39.0,7.0,35.0,134,12,01,  Dater Char Dakshin Para(Part2),79,200,37,97,42,103,28.3,27.6,29.0,00000
39.0,7.0,35.0,413,01,01,  Dakshin Birgoan,333,377,210,164,123,213,46.9,56.1,36.6,00000
39.0,7.0,35.0,413,02,01,  Chandrabaj,834,1247,441,577,393,670,40.1,43.3,37.0,00000
39.0,7.0,35.0,413,03,01,  Panatia Para,394,918,197,425,197,493,30.0,31.7,28.6,00000
39.0,7.0,35.0,413,04,01,  Purbapara,470,1113,220,524,250,589,29.7,29.6,29.8,00000
39.0,7.0,35.0,413,05,01,  Madhyapara,156,559,93,265,63,294,21.8,26.0,17.6,00000
39.0,7.0,35.0,413,06,01,  Paschimpara,293,731,152,338,141,393,28.6,31.0,26.4,00000
39.0,7.0,35.0,413,07,01,  Chanderban,215,583,122,278,93,305,26.9,30.5,23.4,00000
39.0,7.0,35.0,413,08,01,  Fazilapara,168,136,76,57,92,79,55.3,57.1,53.8,00000
39.0,7.0,35.0,781,01,01,  Datter Char Paschimpara,437,673,222,319,215,354,39.4,41.0,37.8,00000
39.0,7.0,35.0,781,02,01,  Datter Char Purbapara,324,440,166,199,158,241,42.4,45.5,39.6,00000
39.0,7.0,35.0,781,03,01,  Datter Char Dakshinpara(Pa.1),290,542,145,272,145,270,34.9,34.8,34.9,00000
39.0,7.0,35.0,781,04,01,  Palashtala,868,1477,439,666,429,811,37.0,39.7,34.6,00000
39.0,7.0,35.0,781,05,01,  Tila Para,135,204,82,96,53,108,39.8,46.1,32.9,00000
39.0,7.0,47.0,335,01,01,  Ramrampur,95,213,45,104,50,109,30.8,30.2,31.4,00000
39.0,7.0,47.0,335,02,01,  Dhanua,637,1199,314,541,323,658,34.7,36.7,32.9,00000
39.0,7.0,47.0,335,03,01,  Uttar Kamalpur,364,724,189,345,175,379,33.5,35.4,31.6,00000
39.0,7.0,47.0,335,04,01,  Dakshin Kamalpur,350,268,186,119,164,149,56.6,61.0,52.4,00000
39.0,7.0,47.0,335,05,01,  Balurgaon,207,255,115,108,92,147,44.8,51.6,38.5,00000
39.0,7.0,47.0,335,06,01,  Naya Para (Part-1),35,23,20,11,15,12,60.3,64.5,55.6,00000
39.0,7.0,47.0,357,01,01,  Samnath Para,11,80,8,38,3,42,12.1,17.4,6.7,00000
39.0,7.0,47.0,357,02,01,  Balujuri,166,504,95,238,71,266,24.8,28.5,21.1,00000
39.0,7.0,47.0,357,03,01,  Dhiglakuna,112,232,64,118,48,114,32.6,35.2,29.6,00000
39.0,7.0,47.0,357,04,01,  Baishnab Para,122,510,57,253,65,257,19.3,18.4,20.2,00000
39.0,7.0,47.0,390,01,01,  Gedra Kamalpur,420,611,231,270,189,341,40.7,46.1,35.7,00000
39.0,7.0,47.0,390,02,01,  Majh Gedra,368,436,190,186,178,250,45.8,50.5,41.6,00000
39.0,7.0,47.0,390,03,01,  Khamar Gedra,388,378,210,150,178,228,50.7,58.3,43.8,00000
39.0,7.0,47.0,390,04,01,  Mirdha Para,317,541,163,247,154,294,36.9,39.8,34.4,00000
39.0,7.0,47.0,390,05,01,  Naya Para(Part-2),202,318,103,128,99,190,38.8,44.6,34.3,00000
39.0,7.0,47.0,502,01,01,  Jadur Char,231,256,126,102,105,154,47.4,55.3,40.5,00000
39.0,7.0,47.0,502,02,01,  Tengramari,257,300,118,137,139,163,46.1,46.3,46.0,00000
39.0,7.0,47.0,502,03,01,  Palashtala,551,638,299,278,252,360,46.3,51.8,41.2,00000
39.0,7.0,47.0,692,01,01,  Satani Para,301,639,152,306,149,333,32.0,33.2,30.9,00000
39.0,7.0,47.0,692,02,01,  Lauchapra,587,1058,315,467,272,591,35.7,40.3,31.5,00000
39.0,7.0,47.0,692,03,01,  Kanekandi,228,296,114,148,114,148,43.5,43.5,43.5,00000
39.0,7.0,47.0,692,04,01,  Baklakandi,180,224,89,95,91,129,44.6,48.4,41.4,00000
39.0,7.0,59.0,435,01,01,  Kalkihara Bhatia,475,1827,268,852,207,975,20.6,23.9,17.5,00000
39.0,7.0,59.0,435,02,01,  Kalkihara Uzan,200,721,103,314,97,407,21.7,24.7,19.2,00000
39.0,7.0,59.0,435,03,01,  Purba Kalkihara,196,1035,117,496,79,539,15.9,19.1,12.8,00000
39.0,7.0,59.0,435,04,01,  Gugrakandi,237,332,133,146,104,186,41.7,47.7,35.9,00000
39.0,7.0,59.0,435,05,01,  Madarer Char,317,711,149,323,168,388,30.8,31.6,30.2,00000
39.0,7.0,59.0,435,06,01,  Maichanir Char,242,1727,144,863,98,864,12.3,14.3,10.2,00000
39.0,7.0,59.0,808,01,01,  Airmari,593,1208,344,577,249,631,32.9,37.4,28.3,00000
39.0,7.0,59.0,808,02,01,  Khewar Char Uzan,555,1016,309,461,246,555,35.3,40.1,30.7,00000
39.0,7.0,59.0,808,03,01,  Khewar Char Bhati,421,1041,227,503,194,538,28.8,31.1,26.5,00000
39.0,7.0,59.0,808,04,01,  Chiner Char,214,414,115,203,99,211,34.1,36.2,31.9,00000
39.0,7.0,59.0,808,05,01,  Rabiar Char,384,1020,192,478,192,542,27.4,28.7,26.2,00000
39.0,7.0,59.0,808,06,01,  Tupker Char Puran,475,1174,261,534,214,640,28.8,32.8,25.1,00000
39.0,7.0,59.0,808,07,01,  Tupker Char Nutan,357,934,202,430,155,504,27.7,32.0,23.5,00000
39.0,7.0,59.0,808,08,01,  Sheker Char,488,1229,283,613,205,616,28.4,31.6,25.0,00000
39.0,7.0,59.0,808,09,01,  Zagir Para,245,712,137,341,108,371,25.6,28.7,22.5,00000
39.0,7.0,59.0,808,10,01,  Awal Para,126,366,62,182,64,184,25.6,25.4,25.8,00000
39.0,7.0,59.0,808,11,01,  Merur Char,1076,1924,610,917,466,1007,35.9,39.9,31.6,00000
39.0,7.0,59.0,808,12,01,  Baghadubi,78,654,47,318,31,336,10.7,12.9,8.4,00000
39.0,7.0,59.0,808,13,01,  Fakir Para,362,806,206,377,156,429,31.0,35.3,26.7,00000
39.0,7.0,71.0,171,01,01,  Chaira Para,39,271,29,130,10,141,12.6,18.2,6.6,00000
39.0,7.0,71.0,171,02,01,  Gomer Char,85,290,49,136,36,154,22.7,26.5,18.9,00000
39.0,7.0,71.0,171,03,01,  Binoder Char,377,1057,211,502,166,555,26.3,29.6,23.0,00000
39.0,7.0,71.0,575,01,01,  Daria Para,65,178,30,86,35,92,26.7,25.9,27.6,00000
39.0,7.0,71.0,575,02,01,  Chak Para,50,337,29,172,21,165,12.9,14.4,11.3,00000
39.0,7.0,71.0,575,03,01,  Nama Para,92,183,50,80,42,103,33.5,38.5,29.0,00000
39.0,7.0,71.0,575,04,01,  Nanjalya,150,661,85,318,65,343,18.5,21.1,15.9,00000
39.0,7.0,71.0,575,05,01,  Maharband,182,450,97,211,85,239,28.8,31.5,26.2,00000
39.0,7.0,71.0,575,06,01,  Dikpara,326,728,160,348,166,380,30.9,31.5,30.4,00000
39.0,7.0,71.0,575,07,01,  Soloymondal Para,110,337,50,164,60,173,24.6,23.4,25.8,00000
39.0,7.0,71.0,575,08,01,  Fakir Para,103,173,55,73,48,100,37.3,43.0,32.4,00000
39.0,7.0,71.0,575,09,01,  Mridha Para,154,564,83,268,71,296,21.4,23.6,19.3,00000
39.0,7.0,71.0,575,10,01,  Baskanda Puran Para,128,167,62,73,66,94,43.4,45.9,41.3,00000
39.0,7.0,71.0,575,11,01,  Baskanda Nutan Para,304,755,155,345,149,410,28.7,31.0,26.7,00000
39.0,7.0,71.0,575,12,01,  Vatia Para,130,374,70,177,60,197,25.8,28.3,23.3,00000
39.0,7.0,71.0,575,13,01,  Taluk Para,59,148,31,75,28,73,28.5,29.2,27.7,00000
39.0,7.0,71.0,575,14,01,  Kayesta Para,65,164,32,86,33,78,28.4,27.1,29.7,00000
39.0,7.0,71.0,575,15,01,  Daripura,134,225,69,96,65,129,37.3,41.8,33.5,00000
39.0,7.0,71.0,575,16,01,  Thakur Para,175,669,94,310,81,359,20.7,23.3,18.4,00000
39.0,7.0,71.0,575,17,01,  Tamboly Para,78,202,41,92,37,110,27.9,30.8,25.2,00000
39.0,7.0,71.0,715,01,01,  Uttar Kushalnagar,303,734,146,352,157,382,29.2,29.3,29.1,00000
39.0,7.0,71.0,715,02,01,  Dakshin Kushalnagar,376,1510,220,738,156,772,19.9,23.0,16.8,00000
39.0,7.0,71.0,777,01,01,  Natun Para,89,247,44,117,45,130,26.5,27.3,25.7,00000
39.0,7.0,71.0,777,02,01,  Sarkar Para,128,163,57,80,71,83,44.0,41.6,46.1,00000
39.0,7.0,71.0,777,03,01,  Nilakshmia Bazar,144,156,88,70,56,86,48.0,55.7,39.4,00000
39.0,7.0,71.0,777,04,01,  Jalu Para,52,95,27,39,25,56,35.4,40.9,30.9,00000
39.0,7.0,71.0,777,05,01,  Uttar Para,167,236,89,107,78,129,41.4,45.4,37.7,00000
39.0,7.0,71.0,777,06,01,  Paschimpara,238,378,113,180,125,198,38.6,38.6,38.7,00000
39.0,7.0,71.0,777,07,01,  Paschim Beparipara,88,410,47,196,41,214,17.7,19.3,16.1,00000
39.0,7.0,71.0,777,08,01,  Dakshin Bepari Para,135,411,81,183,54,228,24.7,30.7,19.1,00000
39.0,7.0,71.0,777,09,01,  Sajimara,469,1964,282,956,187,1008,19.3,22.8,15.6,00000
39.0,7.0,71.0,777,10,01,  Naya Para,105,410,56,206,49,204,20.4,21.4,19.4,00000
39.0,7.0,71.0,777,11,01,  Pagla Para,315,818,152,397,163,421,27.8,27.7,27.9,00000
39.0,7.0,71.0,777,12,01,  Munshi Para,66,31,29,12,37,19,68.0,70.7,66.1,00000
39.0,7.0,83.0,870,01,01,  Uttar Datuakanda,262,862,136,415,126,447,23.3,24.7,22.0,00000
39.0,7.0,83.0,870,02,01,  Madhya Datuakanda,285,848,152,419,133,429,25.2,26.6,23.7,00000
39.0,7.0,83.0,870,03,01,  Dakshin Datuakanda,236,449,130,209,106,240,34.5,38.3,30.6,00000
39.0,7.0,83.0,870,04,01,  Masjid Para,130,309,72,140,58,169,29.6,34.0,25.6,00000
39.0,7.0,83.0,870,05,01,  Khatar Char,393,933,193,452,200,481,29.6,29.9,29.4,00000
39.0,7.0,83.0,870,06,01,  Airmari,561,1216,284,560,277,656,31.6,33.6,29.7,00000
39.0,7.0,83.0,870,07,01,  Char Airmari,276,655,150,323,126,332,29.6,31.7,27.5,00000
39.0,7.0,83.0,870,08,01,  Kamalerbati Purba Para,316,1330,163,624,153,706,19.2,20.7,17.8,00000
39.0,7.0,83.0,870,09,01,  Kamalerbati Mondal Para,255,770,132,381,123,389,24.9,25.7,24.0,00000
39.0,7.0,83.0,870,10,01,  Madaner Char,155,747,90,371,65,376,17.2,19.5,14.7,00000
39.0,7.0,83.0,870,11,01,  Shek Para,47,126,28,62,19,64,27.2,31.1,22.9,00000
39.0,7.0,83.0,870,12,01,  Niler Char,98,264,50,128,48,136,27.1,28.1,26.1,00000
39.0,7.0,83.0,870,13,01,  Daspara,98,274,45,136,53,138,26.3,24.9,27.7,00000
39.0,7.0,83.0,870,14,01,  Majher Para,130,325,57,146,73,179,28.6,28.1,29.0,00000
39.0,7.0,83.0,870,15,01,  Archakanda,160,659,92,309,68,350,19.5,22.9,16.3,00000
39.0,7.0,83.0,870,16,01,  Thandarban,262,657,145,323,117,334,28.5,31.0,25.9,00000
39.0,7.0,83.0,870,17,01,  Bilerpar,73,454,44,218,29,236,13.9,16.8,10.9,00000
39.0,7.0,83.0,870,18,01,  Derurbil,162,450,85,197,77,253,26.5,30.1,23.3,00000
39.0,7.0,83.0,870,19,01,  Bangal Para,330,846,184,407,146,439,28.1,31.1,25.0,00000
39.0,7.0,83.0,870,20,01,  Gazir Para,225,350,123,172,102,178,39.1,41.7,36.4,00000
39.0,7.0,83.0,870,21,01,  Char Gazir Para,112,277,58,115,54,162,28.8,33.5,25.0,00000
39.0,7.0,83.0,870,22,01,  Kutuber Char,213,928,117,436,96,492,18.7,21.2,16.3,00000
39.0,7.0,83.0,870,23,01,  Balurgaon,41,437,22,211,19,226,8.6,9.4,7.8,00000
39.0,15.0,17.0,093,01,01,  Daoar Para,395,989,204,470,191,519,28.5,30.3,26.9,00000
39.0,15.0,17.0,093,02,01,  Tetultali,186,215,101,104,85,111,46.4,49.3,43.4,00000
39.0,15.0,17.0,093,03,01,  Char Khar Char,181,331,88,156,93,175,35.4,36.1,34.7,00000
39.0,15.0,17.0,093,04,01,  Shahjadpur,371,980,197,460,174,520,27.5,30.0,25.1,00000
39.0,15.0,17.0,093,05,01,  Kalakanda,671,1859,333,873,338,986,26.5,27.6,25.5,00000
39.0,15.0,17.0,093,06,01,  Bashedpur,444,819,241,399,203,420,35.2,37.7,32.6,00000
39.0,15.0,17.0,093,07,01,  Nayagram,426,879,228,421,198,458,32.6,35.1,30.2,00000
39.0,15.0,17.0,093,08,01,  Zhalur Char,411,1516,205,788,206,728,21.3,20.6,22.1,00000
39.0,15.0,17.0,093,09,01,  Nazirpur,125,297,69,140,56,157,29.6,33.0,26.3,00000
39.0,15.0,17.0,093,10,01,  Kandirgram,475,868,233,437,242,431,35.4,34.8,36.0,00000
39.0,15.0,17.0,093,11,01,  Bangargram,310,503,147,246,163,257,38.1,37.4,38.8,00000
39.0,15.0,17.0,093,12,01,  Sardar Para,348,1223,197,617,151,606,22.2,24.2,19.9,00000
39.0,15.0,17.0,093,13,01,  Upra Para,208,558,116,270,92,288,27.2,30.1,24.2,00000
39.0,15.0,17.0,093,14,01,  Polaikandi Naya Para,239,780,134,356,105,424,23.5,27.3,19.8,00000
39.0,15.0,17.0,093,15,01,  Pollakandi,684,1068,373,520,311,548,39.0,41.8,36.2,00000
39.0,15.0,17.0,093,16,01,  Farazi Para,167,569,89,256,78,313,22.7,25.8,19.9,00000
39.0,15.0,17.0,093,17,01,  Akanda Para,453,1308,224,641,229,667,25.7,25.9,25.6,00000
39.0,15.0,17.0,746,01,01,  Bhangergram,55,233,23,120,32,113,19.1,16.1,22.1,00000
39.0,15.0,17.0,746,02,01,  Khuter Char,239,524,115,238,124,286,31.3,32.6,30.2,00000
39.0,15.0,17.0,746,03,01,  Bhatir Para,420,886,230,411,190,475,32.2,35.9,28.6,00000
39.0,15.0,17.0,746,04,01,  Hashempur,88,142,38,68,50,74,38.3,35.8,40.3,00000
39.0,15.0,17.0,746,05,01,  Kutuber Char,61,485,43,228,18,257,11.2,15.9,6.5,00000
39.0,15.0,17.0,746,06,01,  Shek Para,123,834,67,389,56,445,12.9,14.7,11.2,00000
39.0,15.0,17.0,746,07,01,  Madaner Char,170,1009,86,521,84,488,14.4,14.2,14.7,00000
39.0,15.0,17.0,746,08,01,  Madarer Char,257,1165,139,549,118,616,18.1,20.2,16.1,00000
39.0,15.0,29.0,186,01,01,  Moulvir Char,739,1419,375,619,364,800,34.2,37.7,31.3,00000
39.0,15.0,29.0,186,02,01,  Kamarer Char,843,1594,437,727,406,867,34.6,37.5,31.9,00000
39.0,15.0,29.0,186,03,01,  Baira Para,553,1134,295,538,258,596,32.8,35.4,30.2,00000
39.0,15.0,29.0,186,04,01,  Miah Para,172,684,104,311,68,373,20.1,25.1,15.4,00000
39.0,15.0,29.0,186,05,01,  Fakir Para,190,303,104,147,86,156,38.5,41.4,35.5,00000
39.0,15.0,29.0,186,06,01,  Baul Para,110,257,62,111,48,146,30.0,35.8,24.7,00000
39.0,15.0,29.0,186,07,01,  Sakoa Para,36,135,20,59,16,76,21.1,25.3,17.4,00000
39.0,15.0,29.0,186,08,01,  Bepari Para,150,462,88,219,62,243,24.5,28.7,20.3,00000
39.0,15.0,29.0,186,09,01,  Daskhin Mukir Char,402,793,202,382,200,411,33.6,34.6,32.7,00000
39.0,15.0,29.0,699,01,01,  Paschim Lanker Char,342,647,153,317,189,330,34.6,32.6,36.4,00000
39.0,15.0,29.0,699,02,01,  Madhya Lanker Char,435,970,231,457,204,513,31.0,33.6,28.5,00000
39.0,15.0,29.0,699,03,01,  Dakshin Lanker Char,288,758,154,341,134,417,27.5,31.1,24.3,00000
39.0,15.0,29.0,886,01,01,  Patadhua Para,761,1360,373,662,388,698,35.9,36.0,35.7,00000
39.0,15.0,29.0,886,02,01,  Akanda Para,489,1356,245,615,244,741,26.5,28.5,24.8,00000
39.0,15.0,29.0,886,03,01,  Shek Para,243,335,124,145,119,190,42.0,46.1,38.5,00000
39.0,15.0,29.0,886,04,01,  Mandal Para,473,832,222,367,251,465,36.2,37.7,35.1,00000
39.0,15.0,29.0,886,05,01,  Tupker Char,314,738,151,341,163,397,29.8,30.7,29.1,00000
39.0,15.0,29.0,886,06,01,  Paschimpara,679,1143,361,512,318,631,37.3,41.4,33.5,00000
39.0,15.0,29.0,886,07,01,  Madhyapara,602,1120,309,480,293,640,35.0,39.2,31.4,00000
39.0,15.0,29.0,886,08,01,  Lamba Para,1336,2768,742,1277,594,1491,32.6,36.8,28.5,00000
39.0,15.0,29.0,886,09,01,  Uttar Makir Char,554,1133,290,540,264,593,32.8,34.9,30.8,00000
39.0,15.0,36.0,342,01,01,  Kholabari,317,838,164,426,153,412,27.4,27.8,27.1,00000
39.0,15.0,36.0,342,02,01,  Char Magurihat,924,1688,508,823,416,865,35.4,38.2,32.5,00000
39.0,15.0,36.0,357,01,03,  Chikajan Digir Par,269,500,137,204,132,296,35.0,40.2,30.8,00000
39.0,15.0,36.0,357,02,03,  Paschim Takimari,384,911,198,424,186,487,29.7,31.8,27.6,00000
39.0,15.0,36.0,357,03,03,  Purba Takimari,147,180,73,82,74,98,45.0,47.1,43.0,00000
39.0,15.0,36.0,652,01,01,  Purba Kazla Para,520,956,248,423,272,533,35.2,37.0,33.8,00000
39.0,15.0,36.0,652,02,01,  Paschim Kazla Para,571,1405,301,661,270,744,28.9,31.3,26.6,00000
39.0,15.0,36.0,839,01,01,  Rampura Balamari,380,653,202,297,178,356,36.8,40.5,33.3,00000
39.0,15.0,36.0,839,02,01,  Rampura Borokthil,785,1436,428,667,357,769,35.3,39.1,31.7,00000
39.0,15.0,43.0,155,01,01,  Katkur,11,57,1,27,10,30,16.2,3.6,25.0,00000
39.0,15.0,43.0,155,02,01,  Kathal Tali,31,199,12,89,19,110,13.5,11.9,14.7,00000
39.0,15.0,43.0,373,01,03,  Dakatia Para,153,171,69,84,84,87,47.2,45.1,49.1,00000
39.0,15.0,43.0,373,02,03,  Daskhin Holkar Char,61,284,30,145,31,139,17.7,17.1,18.2,00000
39.0,15.0,43.0,373,03,03,  Uttar Holkar Char,162,593,101,269,61,324,21.5,27.3,15.8,00000
39.0,15.0,43.0,373,04,03,  Uttar Balur Gram,547,962,284,440,263,522,36.2,39.2,33.5,00000
39.0,15.0,43.0,373,05,03,  Daskhin Balur Garam,401,889,194,398,207,491,31.1,32.8,29.7,00000
39.0,15.0,43.0,373,06,03,  Ram Pura(Part),201,367,95,169,106,198,35.4,36.0,34.9,00000
39.0,15.0,51.0,077,01,01,  Dakatia Para,302,416,150,193,152,223,42.1,43.7,40.5,00000
39.0,15.0,51.0,077,02,01,  Panthamari,507,1006,269,451,238,555,33.5,37.4,30.0,00000
39.0,15.0,51.0,077,03,01,  Madhyapara,464,1066,237,484,227,582,30.3,32.9,28.1,00000
39.0,15.0,51.0,077,04,01,  Bepari Para,287,854,155,422,132,432,25.2,26.9,23.4,00000
39.0,15.0,51.0,077,05,01,  Goalkanda,397,1312,219,604,178,708,23.2,26.6,20.1,00000
39.0,15.0,51.0,077,06,01,  Sarkar Para,281,735,157,340,124,395,27.7,31.6,23.9,00000
39.0,15.0,51.0,077,07,01,  Kumarer Char,291,785,150,376,141,409,27.0,28.5,25.6,00000
39.0,15.0,51.0,077,08,01,  Patharer Char,149,304,63,129,86,175,32.9,32.8,33.0,00000
39.0,15.0,51.0,077,09,01,  Chengtimari,942,1354,478,602,464,752,41.0,44.3,38.2,00000
39.0,15.0,51.0,419,01,01,  Dangdhara,432,875,208,412,224,463,33.1,33.5,32.6,00000
39.0,15.0,51.0,419,02,01,  Makonerchar,84,394,37,195,47,199,17.6,15.9,19.1,00000
39.0,15.0,51.0,544,01,01,  Paschimpara,414,547,220,261,194,286,43.1,45.7,40.4,00000
39.0,15.0,51.0,544,02,01,  Madhyapara,661,1074,364,531,297,543,38.1,40.7,35.4,00000
39.0,15.0,51.0,544,03,01,  Akanda Para,112,363,57,177,55,186,23.6,24.4,22.8,00000
39.0,15.0,51.0,544,04,01,  Purbapara,249,740,136,336,113,404,25.2,28.8,21.9,00000
39.0,15.0,51.0,606,01,01,  Madhyapara,409,709,221,290,188,419,36.6,43.2,31.0,00000
39.0,15.0,51.0,606,02,01,  Munshi Para,324,244,158,117,166,127,57.0,57.5,56.7,00000
39.0,15.0,51.0,606,03,01,  Fakir Para,155,282,84,114,71,168,35.5,42.4,29.7,00000
39.0,15.0,51.0,606,04,01,  Khapara,213,822,115,401,98,421,20.6,22.3,18.9,00000
39.0,15.0,51.0,637,01,01,  Karkhana,346,919,193,413,153,506,27.4,31.8,23.2,00000
39.0,15.0,51.0,637,02,01,  Sonakura,304,736,152,328,152,408,29.2,31.7,27.1,00000
39.0,15.0,51.0,637,03,01,  Bindur Char,600,973,320,424,280,549,38.1,43.0,33.8,00000
39.0,15.0,51.0,637,04,01,  Kawniar Char,708,1128,362,535,346,593,38.6,40.4,36.8,00000
39.0,15.0,51.0,637,05,01,  Makhner Char,204,707,114,345,90,362,22.4,24.8,19.9,00000
39.0,15.0,51.0,637,06,01,  Nimaimari,421,642,218,296,203,346,39.6,42.4,37.0,00000
39.0,15.0,51.0,637,07,01,  Bahaz Para Karkhana,174,237,81,106,93,131,42.3,43.3,41.5,00000
39.0,15.0,58.0,450,01,01,  Purbapara,651,1703,358,809,293,894,27.7,30.7,24.7,00000
39.0,15.0,58.0,450,02,01,  Paschimpara,500,722,250,338,250,384,40.9,42.5,39.4,00000
39.0,15.0,58.0,684,01,01,  Madhya Kharma,717,1111,388,538,329,573,39.2,41.9,36.5,00000
39.0,15.0,58.0,684,02,01,  Bhati Para,424,415,252,180,172,235,50.5,58.3,42.3,00000
39.0,15.0,58.0,684,03,01,  Dighalkandi,429,884,228,434,201,450,32.7,34.4,30.9,00000
39.0,15.0,58.0,684,04,01,  Teli Para,231,583,137,278,94,305,28.4,33.0,23.6,00000
39.0,15.0,58.0,684,05,01,  Purbapara,363,404,224,178,139,226,47.3,55.7,38.1,00000
39.0,15.0,58.0,684,06,01,  Char Kharma,264,915,148,461,116,454,22.4,24.3,20.4,00000
39.0,15.0,58.0,684,07,01,  Paschimpara,228,170,134,73,94,97,57.3,64.7,49.2,00000
39.0,15.0,58.0,684,08,01,  Gaen Para,68,196,43,97,25,99,25.8,30.7,20.2,00000
39.0,15.0,58.0,684,09,01,  Gali Para,35,91,17,46,18,45,27.8,27.0,28.6,00000
39.0,15.0,58.0,684,10,01,  Jameria Kanda,113,186,64,88,49,98,37.8,42.1,33.3,00000
39.0,15.0,58.0,684,11,01,  Gajkanda,97,123,58,67,39,56,44.1,46.4,41.1,00000
39.0,15.0,58.0,684,12,01,  Nayapara,182,146,108,62,74,84,55.5,63.5,46.8,00000
39.0,15.0,58.0,948,01,01,  Tilakpur,71,222,36,108,35,114,24.2,25.0,23.5,00000
39.0,15.0,58.0,948,02,01,  Nainda Kura,61,341,33,167,28,174,15.2,16.5,13.9,00000
39.0,15.0,58.0,948,03,01,  Kawniar Charapara,61,355,32,173,29,182,14.7,15.6,13.7,00000
39.0,15.0,58.0,948,04,01,  Mandal Para,24,81,14,31,10,50,22.9,31.1,16.7,00000
39.0,15.0,58.0,948,05,01,  Mistry Para,22,225,12,109,10,116,8.9,9.9,7.9,00000
39.0,15.0,58.0,948,06,01,  Khan Para,102,204,45,93,57,111,33.3,32.6,33.9,00000
39.0,15.0,58.0,948,07,01,  Madhya Para,125,329,68,159,57,170,27.5,30.0,25.1,00000
39.0,15.0,58.0,948,08,01,  Bepari Para,101,202,54,75,47,127,33.3,41.9,27.0,00000
39.0,15.0,58.0,979,01,01,  Char Utmarchar,523,1291,270,620,253,671,28.8,30.3,27.4,00000
39.0,15.0,58.0,979,02,01,  Bir Utmar Char,258,538,136,261,122,277,32.4,34.3,30.6,00000
39.0,15.0,65.0,559,01,01,  Sarkar Para,163,334,80,141,83,193,32.8,36.2,30.1,00000
39.0,15.0,65.0,559,02,01,  Nayagram,180,572,96,268,84,304,23.9,26.4,21.6,00000
39.0,15.0,65.0,559,03,01,  Chak Para,179,525,87,231,92,294,25.4,27.4,23.8,00000
39.0,15.0,65.0,559,04,01,  Archakandi,274,464,143,221,131,243,37.1,39.3,35.0,00000
39.0,15.0,65.0,559,05,01,  Katerbil,414,1012,219,463,195,549,29.0,32.1,26.2,00000
39.0,15.0,65.0,559,06,01,  Goalerbhita,289,585,132,250,157,335,33.1,34.6,31.9,00000
39.0,15.0,65.0,559,07,01,  Sapmari,1162,1522,629,719,533,803,43.3,46.7,39.9,00000
39.0,15.0,65.0,559,08,01,  Chaker Char,313,1106,142,526,171,580,22.1,21.3,22.8,00000
39.0,15.0,65.0,559,09,01,  Sabuzpur,1008,1471,502,683,506,788,40.7,42.4,39.1,00000
39.0,15.0,65.0,559,10,01,  Char Hatibhanga,407,1100,209,497,198,603,27.0,29.6,24.7,00000
39.0,15.0,65.0,559,11,01,  Amkhawa Purbapara,310,726,161,350,149,376,29.9,31.5,28.4,00000
39.0,15.0,65.0,559,12,01,  Goar Duva,216,501,105,235,111,266,30.1,30.9,29.4,00000
39.0,15.0,87.0,792,01,01,  Patherar Char,137,379,75,170,62,209,26.6,30.6,22.9,00000
39.0,15.0,87.0,792,02,01,  Madhyachar,300,893,155,420,145,473,25.1,27.0,23.5,00000
39.0,15.0,87.0,792,03,01,  Chengtimari,333,925,160,445,173,480,26.5,26.4,26.5,00000
39.0,15.0,87.0,792,04,01,  Digrir Char,859,1464,442,710,417,754,37.0,38.4,35.6,00000
39.0,15.0,87.0,792,05,01,  Kanda Para,119,430,62,197,57,233,21.7,23.9,19.7,00000
39.0,15.0,87.0,792,06,01,  Uttar  Rahimpur,362,943,208,440,154,503,27.7,32.1,23.4,00000
39.0,15.0,87.0,792,07,01,  Dakshin Rahimpur,362,796,171,375,191,421,31.3,31.3,31.2,00000
39.0,15.0,87.0,792,08,01,  Matherghat,450,1076,235,533,215,543,29.5,30.6,28.4,00000
39.0,15.0,87.0,792,09,01,  Uttar Moamari,364,1289,185,618,179,671,22.0,23.0,21.1,00000
39.0,15.0,87.0,792,10,01,  Dakshin Moamari,283,662,151,312,132,350,29.9,32.6,27.4,00000
39.0,15.0,87.0,792,11,01,  Shek Para,156,540,88,270,68,270,22.4,24.6,20.1,00000
39.0,15.0,87.0,792,12,01,  Paik Para,229,370,120,166,109,204,38.2,42.0,34.8,00000
39.0,15.0,87.0,792,13,01,  Taratia,264,580,150,272,114,308,31.3,35.5,27.0,00000
39.0,15.0,87.0,792,14,01,  Poravita,374,1106,200,544,174,562,25.3,26.9,23.6,00000
39.0,15.0,87.0,792,15,01,  Bhitakandi,315,765,160,374,155,391,29.2,30.0,28.4,00000
39.0,15.0,87.0,792,16,01,  Jhaudanga,731,1387,378,664,353,723,34.5,36.3,32.8,00000
39.0,15.0,87.0,792,17,01,  Kalakanda,275,487,128,229,147,258,36.1,35.9,36.3,00000
39.0,15.0,87.0,792,18,01,  Kumrakanda,198,541,83,268,115,273,26.8,23.6,29.6,00000
39.0,15.0,87.0,792,19,01,  Bania Para,496,1170,261,555,235,615,29.8,32.0,27.6,00000
39.0,15.0,87.0,792,20,01,  Mandal Para,243,503,128,244,115,259,32.6,34.4,30.7,00000
39.0,15.0,87.0,792,21,01,  Dakragram,293,642,156,286,137,356,31.3,35.3,27.8,00000
39.0,15.0,87.0,792,22,01,  Uttar Bhathkhawa,362,1326,176,624,186,702,21.4,22.0,20.9,00000
39.0,15.0,87.0,792,23,01,  Dakshin Bhathkhawa,405,1952,207,953,198,999,17.2,17.8,16.5,00000
39.0,15.0,87.0,792,24,01,  Nayagram,106,230,67,106,39,124,31.5,38.7,23.9,00000
39.0,29.0,13.0,075,01,01,  Berergram,150,312,86,143,64,169,32.5,37.6,27.5,00000
39.0,29.0,13.0,075,02,01,  Kachhima,303,674,156,304,147,370,31.0,33.9,28.4,00000
39.0,29.0,13.0,075,03,01,  Gona Para,360,793,212,362,148,431,31.2,36.9,25.6,00000
39.0,29.0,13.0,075,04,01,  Belgachha,215,822,115,370,100,452,20.7,23.7,18.1,00000
39.0,29.0,13.0,075,05,01,  Goalerdoba,339,965,174,449,165,516,26.0,27.9,24.2,00000
39.0,29.0,13.0,075,06,01,  Fakir Para,345,658,188,281,157,377,34.4,40.1,29.4,00000
39.0,29.0,13.0,356,01,01,  Dhantala,419,1039,235,487,184,552,28.7,32.5,25.0,00000
39.0,29.0,13.0,356,02,01,  Maz Para,185,262,82,121,103,141,41.4,40.4,42.2,00000
39.0,29.0,15.0,205,01,01,  Digrir Char,572,2937,363,1439,209,1498,16.3,20.1,12.2,00000
39.0,29.0,15.0,205,02,01,  Amdanga (Part),81,741,56,368,25,373,9.9,13.2,6.3,00000
39.0,29.0,15.0,994,01,01,  Kandar Char,743,2435,443,1149,300,1286,23.4,27.8,18.9,00000
39.0,29.0,15.0,994,02,01,  Lakshimpur,480,2179,305,1033,175,1146,18.1,22.8,13.2,00000
39.0,29.0,15.0,994,03,01,  Harindhara,443,1882,269,912,174,970,19.1,22.8,15.2,00000
39.0,29.0,15.0,994,04,01,  Pirijpur,442,1487,226,696,216,791,22.9,24.5,21.4,00000
39.0,29.0,23.0,270,01,01,  Pechar Char,342,918,182,438,160,480,27.1,29.4,25.0,00000
39.0,29.0,23.0,270,02,01,  Chinar Char,656,2317,346,1191,310,1126,22.1,22.5,21.6,00000
39.0,29.0,23.0,270,03,01,  Chatal Para,213,891,127,426,86,465,19.3,23.0,15.6,00000
39.0,29.0,23.0,270,04,01,  Sajaler Char,377,973,225,494,152,479,27.9,31.3,24.1,00000
39.0,29.0,23.0,270,05,01,  Benuar Char,1547,4618,853,2205,694,2413,25.1,27.9,22.3,00000
39.0,29.0,23.0,616,01,01,  Baliamari,294,1199,157,590,137,609,19.7,21.0,18.4,00000
39.0,29.0,23.0,616,02,01,  Digrir Char,329,2676,186,1368,143,1308,10.9,12.0,9.9,00000
39.0,29.0,23.0,616,03,01,  Tabur Char,215,1032,117,515,98,517,17.2,18.5,15.9,00000
39.0,29.0,23.0,616,04,01,  Agrakhali,227,1633,142,831,85,802,12.2,14.6,9.6,00000
39.0,29.0,31.0,043,01,01,  Purba Baliadaha,391,877,197,415,194,462,30.8,32.2,29.6,00000
39.0,29.0,31.0,043,02,01,  Paschim Baliadaha,387,426,191,188,196,238,47.6,50.4,45.2,00000
39.0,29.0,31.0,054,01,01,  Purba Bamna,341,631,180,274,161,357,35.1,39.6,31.1,00000
39.0,29.0,31.0,054,02,01,  Paschim Bamna,783,1494,431,658,352,836,34.4,39.6,29.6,00000
39.0,29.0,31.0,054,03,01,  Chhotadeli,197,379,112,177,85,202,34.2,38.8,29.6,00000
39.0,29.0,31.0,335,01,01,  Chinaduli (Purba),427,978,220,465,207,513,30.4,32.1,28.8,00000
39.0,29.0,31.0,335,02,01,  Debrai,235,664,128,320,107,344,26.1,28.6,23.7,00000
39.0,29.0,31.0,335,03,01,  Pahlowanbad,143,184,82,73,61,111,43.7,52.9,35.5,00000
39.0,29.0,31.0,335,04,01,  Singbhanga,401,854,207,377,194,477,32.0,35.4,28.9,00000
39.0,29.0,31.0,335,05,01,  Azambad,420,554,224,251,196,303,43.1,47.2,39.3,00000
39.0,29.0,31.0,335,06,01,  Dewan Para,342,380,180,164,162,216,47.4,52.3,42.9,00000
39.0,29.0,31.0,335,07,01,  Sadar Para,599,624,316,278,283,346,49.0,53.2,45.0,00000
39.0,29.0,31.0,335,08,01,  Chinaduli (Pachim),362,561,195,258,167,303,39.2,43.0,35.5,00000
39.0,29.0,31.0,443,01,01,  Faliamari,254,276,123,119,131,157,47.9,50.8,45.5,00000
39.0,29.0,31.0,443,02,01,  Khamaria Para,441,968,231,440,210,528,31.3,34.4,28.5,00000
39.0,29.0,31.0,443,03,01,  Akanda Para,349,738,182,324,167,414,32.1,36.0,28.7,00000
39.0,29.0,31.0,443,04,01,  Gutuail Bazar,208,685,109,334,99,351,23.3,24.6,22.0,00000
39.0,29.0,31.0,443,05,01,  Dakshin Gilabari,375,679,196,290,179,389,35.6,40.3,31.5,00000
39.0,29.0,31.0,443,06,01,  Gilabari,205,572,111,251,94,321,26.4,30.7,22.7,00000
39.0,29.0,31.0,443,07,01,  Nadi Para,173,351,89,147,84,204,33.0,37.7,29.2,00000
39.0,29.0,31.0,443,08,01,  Kachima,227,379,118,167,109,212,37.5,41.4,34.0,00000
39.0,29.0,39.0,173,01,01,  Char Dadna,267,503,152,243,115,260,34.7,38.5,30.7,00000
39.0,29.0,39.0,173,02,01,  Bakchar,181,612,112,294,69,318,22.8,27.6,17.8,00000
39.0,29.0,39.0,173,03,01,  Belkuchi Para,103,707,62,349,41,358,12.7,15.1,10.3,00000
39.0,29.0,39.0,400,01,01,  Porar Char,1072,3270,634,1513,438,1757,24.7,29.5,20.0,00000
39.0,29.0,39.0,400,02,01,  Sarkar Para,422,1028,228,514,194,514,29.1,30.7,27.4,00000
39.0,29.0,39.0,400,03,01,  Tangrakura,287,408,165,191,122,217,41.3,46.3,36.0,00000
39.0,29.0,39.0,400,04,01,  Bhatia Para,200,843,131,424,69,419,19.2,23.6,14.1,00000
39.0,29.0,39.0,400,05,01,  Tangria,112,186,63,73,49,113,37.6,46.3,30.2,00000
39.0,29.0,39.0,400,06,01,  Shah Para,430,1382,226,712,204,670,23.7,24.1,23.3,00000
39.0,29.0,39.0,400,07,01,  Aguner Char,448,1265,286,613,162,652,26.2,31.8,19.9,00000
39.0,29.0,39.0,400,08,01,  Mora Kandi,555,1176,323,555,232,621,32.1,36.8,27.2,00000
39.0,29.0,39.0,457,01,01,  Datta Para,335,447,166,216,169,231,42.8,43.5,42.3,00000
39.0,29.0,39.0,457,02,01,  Fulkar Char,735,1631,435,745,300,886,31.1,36.9,25.3,00000
39.0,29.0,39.0,457,03,01,  Karaitala,712,2286,409,1146,303,1140,23.7,26.3,21.0,00000
39.0,29.0,39.0,908,01,01,  Tengra Para,102,276,68,131,34,145,27.0,34.2,19.0,00000
39.0,29.0,39.0,908,02,01,  Malpara,233,662,135,301,98,361,26.0,31.0,21.4,00000
39.0,29.0,39.0,908,03,01,  Dakpara,61,388,38,215,23,173,13.6,15.0,11.7,00000
39.0,29.0,39.0,908,04,01,  Chandapur,517,1462,317,692,200,770,26.1,31.4,20.6,00000
39.0,29.0,39.0,908,05,01,  Morabanda(Shah Para),29,355,21,197,8,158,7.6,9.6,4.8,00000
39.0,29.0,47.0,551,01,01,  Kachhimer Char,570,1034,327,495,243,539,35.5,39.8,31.1,00000
39.0,29.0,47.0,551,02,01,  Bolaki Para,540,2068,356,943,184,1125,20.7,27.4,14.1,00000
39.0,29.0,47.0,702,01,01,  Kumirdaha,403,2044,237,968,166,1076,16.5,19.7,13.4,00000
39.0,29.0,47.0,702,02,01,  Malmara,581,1679,353,764,228,915,25.7,31.6,19.9,00000
39.0,29.0,47.0,702,03,01,  Mohammadpur,565,3370,327,1613,238,1757,14.4,16.9,11.9,00000
39.0,29.0,47.0,702,04,01,  Savar Char,499,1902,306,879,193,1023,20.8,25.8,15.9,00000
39.0,29.0,47.0,702,05,01,  Savukura,414,1439,268,714,146,725,22.3,27.3,16.8,00000
39.0,29.0,55.0,789,01,01,  Pachabahala,1802,3723,940,1757,862,1966,32.6,34.9,30.5,00000
39.0,29.0,55.0,789,02,01,  Dharmakura,480,1198,249,599,231,599,28.6,29.4,27.8,00000
39.0,29.0,55.0,800,01,01,  Panchbaria,742,1551,389,718,353,833,32.4,35.1,29.8,00000
39.0,29.0,55.0,800,02,01,  Kachihara,361,1339,200,660,161,679,21.2,23.3,19.2,00000
39.0,29.0,63.0,659,01,01,  Miapara,188,754,110,341,78,413,20.0,24.4,15.9,00000
39.0,29.0,63.0,659,02,01,  Sardar Para,357,618,187,304,170,314,36.6,38.1,35.1,00000
39.0,29.0,63.0,659,03,01,  Bepari Para,330,665,167,289,163,376,33.2,36.6,30.2,00000
39.0,29.0,63.0,659,04,01,  Purbapara,256,472,147,215,109,257,35.2,40.6,29.8,00000
39.0,29.0,63.0,659,05,01,  Jotdar Para,407,474,189,207,218,267,46.2,47.7,44.9,00000
39.0,29.0,63.0,659,06,01,  Akanda Para,103,184,47,91,56,93,35.9,34.1,37.6,00000
39.0,29.0,63.0,659,07,01,  Pashcim Madhypara,296,572,146,269,150,303,34.1,35.2,33.1,00000
39.0,29.0,63.0,659,08,01,  Athia Mary,229,462,121,210,108,252,33.1,36.6,30.0,00000
39.0,29.0,71.0,757,01,01,  Bhoswar Ghar,88,244,53,108,35,136,26.5,32.9,20.5,00000
39.0,29.0,71.0,757,02,01,  Sonamuki,402,714,200,333,202,381,36.0,37.5,34.6,00000
39.0,29.0,71.0,757,03,01,  Ulia,256,424,148,191,108,233,37.6,43.7,31.7,00000
39.0,29.0,71.0,757,04,01,  Rajnagar,82,237,52,115,30,122,25.7,31.1,19.7,00000
39.0,29.0,71.0,757,05,01,  Kabirtar,426,1409,236,672,190,737,23.2,26.0,20.5,00000
39.0,29.0,71.0,757,06,01,  Rambhadara,737,1625,393,749,344,876,31.2,34.4,28.2,00000
39.0,29.0,71.0,757,07,01,  Noar Para,298,1036,163,499,135,537,22.3,24.6,20.1,00000
39.0,29.0,71.0,757,08,01,  Tanta Para,832,2948,493,1346,339,1602,22.0,26.8,17.5,00000
39.0,29.0,71.0,757,09,01,  Brammattar,221,1044,120,531,101,513,17.5,18.4,16.4,00000
39.0,29.0,87.0,811,01,01,  Patharshi,1332,1726,738,748,594,978,43.6,49.7,37.8,00000
39.0,29.0,87.0,811,02,01,  Muradabad,954,1943,514,936,440,1007,32.9,35.4,30.4,00000
39.0,36.0,17.0,383,01,01,  Bara Gajiar Para,422,453,195,217,227,236,48.2,47.3,49.0,00000
39.0,36.0,17.0,383,02,01,  Chhota Gajiar Para,274,234,140,110,134,124,53.9,56.0,51.9,00000
39.0,36.0,17.0,440,01,01,  Harinakanda,224,337,116,161,108,176,39.9,41.9,38.0,00000
39.0,36.0,17.0,440,02,01,  Chandpur,223,230,117,88,106,142,49.2,57.1,42.7,00000
39.0,36.0,19.0,654,01,01,  Megha,437,692,215,332,222,360,38.7,39.3,38.1,00000
39.0,36.0,19.0,654,02,01,  Naya Para,274,537,136,242,138,295,33.8,36.0,31.9,00000
39.0,36.0,19.0,654,03,01,  Lakshmipur,127,254,76,111,51,143,33.3,40.6,26.3,00000
39.0,36.0,19.0,654,04,01,  Doail Para,450,766,212,368,238,398,37.0,36.6,37.4,00000
39.0,36.0,19.0,787,01,01,  Purba Pardighali,501,813,267,351,234,462,38.1,43.2,33.6,00000
39.0,36.0,19.0,787,02,01,  Chak Para,545,649,262,300,283,349,45.6,46.6,44.8,00000
39.0,36.0,19.0,787,03,01,  Shapara,78,180,42,84,36,96,30.2,33.3,27.3,00000
39.0,36.0,19.0,871,01,01,  Sontia 1 No.,143,256,65,116,78,140,35.8,35.9,35.8,00000
39.0,36.0,19.0,871,02,01,  Sontia 2 No.,342,723,178,332,164,391,32.1,34.9,29.5,00000
39.0,36.0,19.0,871,03,01,  Sontia 3 No.,487,776,252,355,235,421,38.6,41.5,35.8,00000
39.0,36.0,19.0,871,04,01,  Santia Bazar,206,119,111,49,95,70,63.4,69.4,57.6,00000
39.0,36.0,19.0,871,05,01,  Santia Patal,392,486,190,233,202,253,44.6,44.9,44.4,00000
39.0,36.0,19.0,871,06,01,  Gopinthpur,800,1542,432,736,368,806,34.2,37.0,31.3,00000
39.0,36.0,19.0,871,07,01,  Sontia Part,174,99,98,41,76,58,63.7,70.5,56.7,00000
39.0,36.0,19.0,871,08,01,  Fakir Para,150,258,78,118,72,140,36.8,39.8,34.0,00000
39.0,36.0,19.0,871,09,01,  Bapari Para,125,259,64,118,61,141,32.6,35.2,30.2,00000
39.0,36.0,19.0,871,10,01,  Pachamanik,18,44,10,20,8,24,29.0,33.3,25.0,00000
39.0,36.0,19.0,968,01,01,  Tararbhita,313,533,155,249,158,284,37.0,38.4,35.7,00000
39.0,36.0,19.0,968,02,01,  Hatubhanga,381,644,194,317,187,327,37.2,38.0,36.4,00000
39.0,36.0,23.0,310,01,01,  Mithuakanda,79,170,29,92,50,78,31.7,24.0,39.1,00000
39.0,36.0,23.0,310,02,01,  Boalmari,143,624,79,277,64,347,18.6,22.2,15.6,00000
39.0,36.0,23.0,310,03,01,  Khan Para,192,172,96,74,96,98,52.7,56.5,49.5,00000
39.0,36.0,23.0,310,04,01,  Dakshinpara,171,254,85,103,86,151,40.2,45.2,36.3,00000
39.0,36.0,23.0,310,05,01,  Naya Para,102,298,52,148,50,150,25.5,26.0,25.0,00000
39.0,36.0,23.0,310,06,01,  Madhyapara,440,358,214,145,226,213,55.1,59.6,51.5,00000
39.0,36.0,23.0,480,01,01,  Itail,507,1538,261,710,246,828,24.8,26.9,22.9,00000
39.0,36.0,23.0,480,02,01,  Baperi Para,53,264,21,130,32,134,16.7,13.9,19.3,00000
39.0,36.0,23.0,480,03,01,  Modak Para,98,248,60,102,38,146,28.3,37.0,20.7,00000
39.0,36.0,23.0,480,04,01,  Choura Para,125,359,65,165,60,194,25.8,28.3,23.6,00000
39.0,36.0,23.0,848,01,01,  Char Para,222,307,112,143,110,164,42.0,43.9,40.1,00000
39.0,36.0,23.0,848,02,01,  Madhyapara,177,189,84,84,93,105,48.4,50.0,47.0,00000
39.0,36.0,23.0,848,03,01,  Paschimpara,303,305,163,166,140,139,49.8,49.5,50.2,00000
39.0,36.0,23.0,848,04,01,  Boalmari,99,229,42,110,57,119,30.2,27.6,32.4,00000
39.0,36.0,23.0,848,05,01,  Natamari,41,120,21,56,20,64,25.5,27.3,23.8,00000
39.0,36.0,23.0,864,01,01,  Kachua Para,415,289,198,123,217,166,58.9,61.7,56.7,00000
39.0,36.0,23.0,864,02,01,  Maisal Para,226,305,109,136,117,169,42.6,44.5,40.9,00000
39.0,36.0,23.0,864,03,01,  Tarafdar Para,226,263,115,126,111,137,46.2,47.7,44.8,00000
39.0,36.0,23.0,864,04,01,  Deppara,108,154,39,69,69,85,41.2,36.1,44.8,00000
39.0,36.0,23.0,864,05,01,  Khapsakuri,130,126,66,66,64,60,50.8,50.0,51.6,00000
39.0,36.0,23.0,864,06,01,  Naitamari,65,137,26,67,39,70,32.2,28.0,35.8,00000
39.0,36.0,23.0,864,07,01,  Chak Para,178,292,98,130,80,162,37.9,43.0,33.1,00000
39.0,36.0,23.0,864,08,01,  Boalmari,141,280,65,130,76,150,33.5,33.3,33.6,00000
39.0,36.0,23.0,864,09,01,  Madhyapara,495,669,254,336,241,333,42.5,43.1,42.0,00000
39.0,36.0,23.0,864,10,01,  Dakshinpara,292,672,154,300,138,372,30.3,33.9,27.1,00000
39.0,36.0,23.0,864,11,01,  Bramuttar,420,491,223,240,197,251,46.1,48.2,44.0,00000
39.0,36.0,23.0,864,12,01,  Katalshah,206,110,113,44,93,66,65.2,72.0,58.5,00000
39.0,36.0,23.0,864,13,01,  Dakhalpur,101,57,55,28,46,29,63.9,66.3,61.3,00000
39.0,36.0,35.0,200,01,01,  Binonder Para,561,508,284,238,277,270,52.5,54.4,50.6,00000
39.0,36.0,35.0,200,02,01,  Mangal Pur,136,189,74,92,62,97,41.8,44.6,39.0,00000
39.0,36.0,35.0,200,03,01,  Koch Ghar,626,486,330,210,296,276,56.3,61.1,51.7,00000
39.0,36.0,35.0,200,04,01,  Bichotia Para,110,106,55,45,55,61,50.9,55.0,47.4,00000
39.0,36.0,35.0,200,05,01,  Kachashara,599,567,329,277,270,290,51.4,54.3,48.2,00000
39.0,36.0,41.0,497,01,01,  Bhati Para,429,907,217,428,212,479,32.1,33.6,30.7,00000
39.0,36.0,41.0,497,02,01,  Rangamatia,247,609,138,278,109,331,28.9,33.2,24.8,00000
39.0,36.0,41.0,497,03,01,  Madhyapara,194,430,113,207,81,223,31.1,35.3,26.6,00000
39.0,36.0,41.0,497,04,01,  Ujan Para,412,1813,203,917,209,896,18.5,18.1,18.9,00000
39.0,36.0,41.0,497,05,01,  Chanda Para,229,674,130,329,99,345,25.4,28.3,22.3,00000
39.0,36.0,47.0,163,01,01,  Char Bir Gaila,268,474,140,218,128,256,36.1,39.1,33.3,00000
39.0,36.0,47.0,163,02,01,  Hajipur,287,183,160,94,127,89,61.1,63.0,58.8,00000
39.0,36.0,47.0,163,03,01,  Kumargati,152,160,83,76,69,84,48.7,52.2,45.1,00000
39.0,36.0,47.0,163,04,01,  Duani Para,130,135,59,64,71,71,49.1,48.0,50.0,00000
39.0,36.0,47.0,163,05,01,  Panchgachhi,108,159,63,69,45,90,40.4,47.7,33.3,00000
39.0,36.0,47.0,163,06,01,  Bepari Para,233,235,126,115,107,120,49.8,52.3,47.1,00000
39.0,36.0,47.0,163,07,01,  Taira Para,73,164,31,74,42,90,30.8,29.5,31.8,00000
39.0,36.0,47.0,454,01,01,  Kalta Para,912,1143,429,529,483,614,44.4,44.8,44.0,00000
39.0,36.0,47.0,454,02,01,  Jaliar Para,85,209,44,92,41,117,28.9,32.4,25.9,00000
39.0,36.0,47.0,454,03,01,  Gauripur,212,191,107,86,105,105,52.6,55.4,50.0,00000
39.0,36.0,47.0,454,04,01,  Jhawram,556,851,274,384,282,467,39.5,41.6,37.7,00000
39.0,36.0,47.0,454,05,01,  Kumargati,101,240,49,110,52,130,29.6,30.8,28.6,00000
39.0,36.0,47.0,454,06,01,  Panchgachhi,206,237,107,110,99,127,46.5,49.3,43.8,00000
39.0,36.0,47.0,454,07,01,  Khash Hasil,303,432,167,198,136,234,41.2,45.8,36.8,00000
39.0,36.0,47.0,454,08,01,  Hasiltanki,585,351,292,143,293,208,62.5,67.1,58.5,00000
39.0,36.0,53.0,717,01,01,  Fakirpur,158,116,83,57,75,59,57.7,59.3,56.0,00000
39.0,36.0,53.0,717,02,01,  Naya Para,743,886,396,400,347,486,45.6,49.7,41.7,00000
39.0,36.0,53.0,717,03,01,  Hazi Para,420,438,209,214,211,224,49.0,49.4,48.5,00000
39.0,36.0,53.0,717,04,01,  Bilpara,187,230,88,100,99,130,44.8,46.8,43.2,00000
39.0,36.0,53.0,717,05,01,  Khal Para,180,173,89,74,91,99,51.0,54.6,47.9,00000
39.0,36.0,53.0,717,06,01,  Hindu Para,260,290,136,137,124,153,47.3,49.8,44.8,00000
39.0,36.0,53.0,717,07,01,  Chander Chak,426,453,239,207,187,246,48.5,53.6,43.2,00000
39.0,36.0,53.0,717,08,01,  Majh Para,726,344,348,149,378,195,67.9,70.0,66.0,00000
39.0,36.0,53.0,717,09,01,  Banpara,752,976,389,457,363,519,43.5,46.0,41.2,00000
39.0,36.0,53.0,717,10,01,  Dakshinpara,402,463,206,205,196,258,46.5,50.1,43.2,00000
39.0,36.0,53.0,717,11,01,  Narundi Brahmmuttar,680,1013,364,474,316,539,40.2,43.4,37.0,00000
39.0,36.0,53.0,717,12,01,  Bepari Para,95,377,42,169,53,208,20.1,19.9,20.3,00000
39.0,36.0,53.0,717,13,01,  Bazar,374,117,216,64,158,53,76.2,77.1,74.9,00000
39.0,36.0,53.0,717,14,01,  Mahishora,371,360,199,154,172,206,50.8,56.4,45.5,00000
39.0,36.0,65.0,737,01,01,  Pakulla (Part),1081,1844,563,864,518,980,37.0,39.5,34.6,00000
39.0,36.0,65.0,737,02,01,  Gazariata,286,818,151,370,135,448,25.9,29.0,23.2,00000
39.0,36.0,65.0,818,01,01,  Ramnagar,697,1444,359,680,338,764,32.6,34.6,30.7,00000
39.0,36.0,65.0,818,02,01,  Chandpur,122,474,66,225,56,249,20.5,22.7,18.4,00000
39.0,36.0,65.0,818,03,01,  Sunitiki,130,190,65,91,65,99,40.6,41.7,39.6,00000
39.0,36.0,65.0,838,01,01,  Naya Para,413,995,225,467,188,528,29.3,32.5,26.3,00000
39.0,36.0,65.0,838,02,01,  Kayarpar,146,351,57,167,89,184,29.4,25.4,32.6,00000
39.0,36.0,65.0,838,03,01,  Khettri Para,396,799,204,374,192,425,33.1,35.3,31.1,00000
39.0,36.0,65.0,838,04,01,  Bhati Para,526,862,266,401,260,461,37.9,39.9,36.1,00000
39.0,36.0,65.0,838,05,01,  Sekh Para,690,1605,340,734,350,871,30.1,31.7,28.7,00000
39.0,36.0,65.0,838,06,01,  Ujan Para (Rashidpur),645,830,326,383,319,447,43.7,46.0,41.6,00000
39.0,36.0,65.0,838,07,01,  Alinagar,97,181,52,83,45,98,34.9,38.5,31.5,00000
39.0,36.0,65.0,838,08,01,  Mirik Pur,218,419,117,202,101,217,34.2,36.7,31.8,00000
39.0,36.0,65.0,838,09,01,  Bastatala,197,301,94,154,103,147,39.6,37.9,41.2,00000
39.0,36.0,65.0,838,10,01,  Gada Khali,213,547,104,254,109,293,28.0,29.1,27.1,00000
39.0,36.0,65.0,991,01,01,  Tulsipur,209,313,99,147,110,166,40.0,40.2,39.9,00000
39.0,36.0,65.0,991,02,01,  Tulsipur Bazar,121,77,63,38,58,39,61.1,62.4,59.8,00000
39.0,36.0,65.0,991,03,01,  Tulsipur Khah,88,144,44,68,44,76,37.9,39.3,36.7,00000
39.0,36.0,71.0,520,01,01,  Kaidola,2047,4499,1056,2135,991,2364,31.3,33.1,29.5,00000
39.0,36.0,71.0,520,02,01,  Bere Potal,113,197,57,96,56,101,36.5,37.3,35.7,00000
39.0,36.0,71.0,520,03,01,  Potal,96,204,45,94,51,110,32.0,32.4,31.7,00000
39.0,36.0,71.0,520,04,01,  Boyalmupar,152,198,82,96,70,102,43.4,46.1,40.7,00000
39.0,36.0,71.0,520,05,01,  Jafarshahi,486,543,241,259,245,284,47.2,48.2,46.3,00000
39.0,36.0,77.0,043,01,01,  Bade Chandi,998,1096,506,491,492,605,47.7,50.8,44.8,00000
39.0,36.0,77.0,043,02,01,  Khalishakuri,647,1112,333,501,314,611,36.8,39.9,33.9,00000
39.0,36.0,83.0,924,01,01,  Tarakandi,173,337,80,168,93,169,33.9,32.3,35.5,00000
39.0,36.0,83.0,924,02,01,  Matikhola,446,538,223,255,223,283,45.3,46.7,44.1,00000
39.0,36.0,83.0,924,03,01,  Baitamari,341,465,157,218,184,247,42.3,41.9,42.7,00000
39.0,36.0,83.0,924,04,01,  Sreepur,370,708,186,355,184,353,34.3,34.4,34.3,00000
39.0,36.0,83.0,928,01,01,  Salatpur,72,256,35,125,37,131,22.0,21.9,22.0,00000
39.0,36.0,83.0,928,02,01,  Palashkura,201,305,96,153,105,152,39.7,38.6,40.9,00000
39.0,36.0,89.0,273,01,01,  Charsi Dipoli Bari,678,530,324,241,354,289,56.1,57.3,55.1,00000
39.0,36.0,89.0,273,02,01,  Kanderpara,552,559,286,248,266,311,49.7,53.6,46.1,00000
39.0,36.0,89.0,273,03,01,  Shakpara,97,214,50,95,47,119,31.2,34.5,28.3,00000
39.0,36.0,89.0,273,04,01,  Munsipara,423,383,201,181,222,202,52.5,52.6,52.4,00000
39.0,36.0,89.0,273,05,01,  Konipara,349,376,185,169,164,207,48.1,52.3,44.2,00000
39.0,36.0,89.0,273,06,01,  Khalifa Para,435,384,209,194,226,190,53.1,51.9,54.3,00000
39.0,36.0,89.0,273,07,01,  Lohora,235,383,111,181,124,202,38.0,38.0,38.0,00000
39.0,36.0,89.0,293,01,01,  Daherpar,357,384,172,173,185,211,48.2,49.9,46.7,00000
39.0,36.0,89.0,293,02,01,  Baluyata,784,942,399,442,385,500,45.4,47.4,43.5,00000
39.0,36.0,89.0,711,01,01,  Narayanpur,1192,1818,629,847,563,971,39.6,42.6,36.7,00000
39.0,36.0,89.0,711,02,01,  Patilaaura,123,209,62,89,61,120,37.0,41.1,33.7,00000
39.0,36.0,95.0,353,01,01,  Digrir Char,536,741,270,369,266,372,42.0,42.3,41.7,00000
39.0,36.0,95.0,353,02,01,  Kaziar Char,675,1507,340,717,335,790,30.9,32.2,29.8,00000
39.0,36.0,95.0,353,03,01,  Hanumaner Char,480,445,254,217,226,228,51.9,53.9,49.8,00000
39.0,36.0,95.0,380,01,01,  Bhati Gajaria,745,1416,409,715,336,701,34.5,36.4,32.4,00000
39.0,36.0,95.0,380,02,01,  Madhya Gajaria,386,728,217,373,169,355,34.6,36.8,32.3,00000
39.0,36.0,95.0,844,01,01,  Rehai Gajaria,286,827,161,406,125,421,25.7,28.4,22.9,00000
39.0,36.0,95.0,844,02,01,  Algir Char,63,289,43,148,20,141,17.9,22.5,12.4,00000
39.0,36.0,95.0,969,01,01,  Tabir Char,763,2135,427,1026,336,1109,26.3,29.4,23.3,00000
39.0,36.0,95.0,969,02,01,  Shaheber Char,68,341,37,169,31,172,16.6,18.0,15.3,00000
39.0,36.0,95.0,994,01,01,  Tikrakandi,639,874,318,408,321,466,42.2,43.8,40.8,00000
39.0,36.0,95.0,994,02,01,  Dauyatala,1007,1493,531,720,476,773,40.3,42.4,38.1,00000
39.0,36.0,95.0,994,03,01,  Tulsir Char,301,575,162,255,139,320,34.4,38.8,30.3,00000
39.0,36.0,95.0,994,04,01,  Chhota Dauyatala,601,738,290,365,311,373,44.9,44.3,45.5,00000
39.0,36.0,95.0,994,05,01,  Balur Char,297,318,146,160,151,158,48.3,47.7,48.9,00000
39.0,58.0,23.0,965,01,01,  Sukhnagari,1090,2320,596,1092,494,1228,32.0,35.3,28.7,00000
39.0,58.0,23.0,965,02,01,  Char Shuknagari,533,857,267,402,266,455,38.3,39.9,36.9,00000
39.0,58.0,23.0,965,03,01,  Dakshin Shuknagari,730,2082,416,1031,314,1051,26.0,28.7,23.0,00000
39.0,58.0,23.0,965,04,01,  Birendragari,233,856,116,421,117,435,21.4,21.6,21.2,00000
39.0,58.0,23.0,965,05,01,  Char Andagari,285,1250,154,611,131,639,18.6,20.1,17.0,00000
39.0,58.0,47.0,680,01,01,  Pakhshimari,375,409,181,176,194,233,47.8,50.7,45.4,00000
39.0,58.0,47.0,680,02,01,  Bakur Char,390,1514,203,707,187,807,20.5,22.3,18.8,00000
39.0,58.0,47.0,680,03,01,  Naya Para Balabharat,564,1300,318,608,246,692,30.3,34.3,26.2,00000
39.0,58.0,47.0,680,04,01,  Char Gopalpur,850,1802,416,819,434,983,32.1,33.7,30.6,00000
39.0,58.0,47.0,680,05,01,  Bil Gopalpur,328,794,174,353,154,441,29.2,33.0,25.9,00000
39.0,58.0,47.0,680,06,01,  Moslemabad,1695,2705,865,1229,830,1476,38.5,41.3,36.0,00000
39.0,58.0,47.0,680,07,01,  Jorekhali,982,1588,494,714,488,874,38.2,40.9,35.8,00000
39.0,58.0,59.0,329,01,01,  Char Phuljore,518,1868,309,919,209,949,21.7,25.2,18.0,00000
39.0,58.0,59.0,329,02,01,  Phuljore,69,358,45,182,24,176,16.2,19.8,12.0,00000
39.0,58.0,59.0,570,01,01,  Jorekhali (Golabari),337,670,193,311,144,359,33.5,38.3,28.6,00000
39.0,58.0,59.0,570,02,01,  Char Golabari,1563,2942,822,1444,741,1498,34.7,36.3,33.1,00000
39.0,58.0,59.0,570,03,01,  Ramchandrapur,333,555,203,251,130,304,37.5,44.7,30.0,00000
39.0,58.0,71.0,182,01,01,  Paschimpara,508,1032,277,460,231,572,33.0,37.6,28.8,00000
39.0,58.0,71.0,182,02,01,  Ilshamari,408,602,196,269,212,333,40.4,42.2,38.9,00000
39.0,58.0,71.0,182,03,01,  Laldoba,382,792,195,378,187,414,32.5,34.0,31.1,00000
39.0,58.0,71.0,482,01,01,  Ghugumari Nijpara,566,1297,285,586,281,711,30.4,32.7,28.3,00000
39.0,58.0,71.0,482,02,01,  Mathabhanga Para,131,212,66,84,65,128,38.2,44.0,33.7,00000
39.0,58.0,71.0,629,01,01,  Purbapara,693,1294,363,583,330,711,34.9,38.4,31.7,00000
39.0,58.0,71.0,629,02,01,  Paschimpara,851,2025,454,952,397,1073,29.6,32.3,27.0,00000
39.0,58.0,71.0,768,01,01,  Purba Nalchhia,649,1224,343,549,306,675,34.7,38.5,31.2,00000
39.0,58.0,71.0,768,02,01,  Paschim Nalchhia,662,1784,325,824,337,960,27.1,28.3,26.0,00000
39.0,61.0,17.0,014,01,01,  Purba Adra,578,1119,297,515,281,604,34.1,36.6,31.8,00000
39.0,61.0,17.0,014,02,01,  Paschim Adra,463,665,243,292,220,373,41.0,45.4,37.1,00000
39.0,61.0,17.0,078,01,01,  Dakshin Baghadoba,801,1241,407,568,394,673,39.2,41.7,36.9,00000
39.0,61.0,17.0,078,02,01,  Alairpar,312,554,171,252,141,302,36.0,40.4,31.8,00000
39.0,61.0,17.0,078,03,01,  Nama Bandha,282,474,141,230,141,244,37.3,38.0,36.6,00000
39.0,61.0,17.0,973,01,01,  Purba Thuri,713,1240,362,561,351,679,36.5,39.2,34.1,00000
39.0,61.0,17.0,973,02,01,  Paschim Thuri,721,1446,369,650,352,796,33.3,36.2,30.7,00000
39.0,61.0,19.0,262,01,01,  Char Palisha Uttarpara,485,1140,261,538,224,602,29.8,32.7,27.1,00000
39.0,61.0,19.0,262,02,01,  Char Palisha Madhyapara,853,1713,435,814,418,899,33.2,34.8,31.7,00000
39.0,61.0,19.0,262,03,01,  Char Palisha Purbapara,763,1298,400,632,363,666,37.0,38.8,35.3,00000
39.0,61.0,19.0,262,04,01,  Betmari,648,1607,333,763,315,844,28.7,30.4,27.2,00000
39.0,61.0,38.0,611,01,01,  Kona Malancha,833,915,446,412,387,503,47.7,52.0,43.5,00000
39.0,61.0,38.0,611,02,01,  Karaichara,460,490,225,240,235,250,48.4,48.4,48.5,00000
39.0,61.0,38.0,767,01,01,  Debarchara,280,308,142,139,138,169,47.6,50.5,45.0,00000
39.0,61.0,38.0,767,02,01,  Kamalabari,94,81,37,36,57,45,53.7,50.7,55.9,00000
39.0,61.0,38.0,767,03,01,  Fulkucha,1144,1327,564,621,580,706,46.3,47.6,45.1,00000
39.0,61.0,38.0,767,04,01,  China Shukarpar,112,232,60,104,52,128,32.6,36.6,28.9,00000
39.0,61.0,47.0,071,01,01,  Mashkail,398,765,216,353,182,412,34.2,38.0,30.6,00000
39.0,61.0,47.0,071,02,01,  Tarafrag,368,333,175,149,193,184,52.5,54.0,51.2,00000
39.0,61.0,47.0,071,03,01,  Bagbari,169,147,79,64,90,83,53.5,55.2,52.0,00000
39.0,61.0,47.0,071,04,01,  Charbagbari,151,210,69,94,82,116,41.8,42.3,41.4,00000
39.0,61.0,47.0,071,05,01,  Topbagbari,217,420,126,193,91,227,34.1,39.5,28.6,00000
39.0,61.0,47.0,071,06,01,  Dakhin Bagbari,215,195,108,97,107,98,52.4,52.7,52.2,00000
39.0,61.0,47.0,135,01,01,  Char Bashi,362,715,199,345,163,370,33.6,36.6,30.6,00000
39.0,61.0,47.0,135,02,01,  Bir Banshi,270,259,139,123,131,136,51.0,53.1,49.1,00000
39.0,61.0,47.0,234,01,01,  Paschim Chabilapur,289,616,163,270,126,346,31.9,37.6,26.7,00000
39.0,61.0,47.0,234,02,01,  Purba Chabilapur,407,1294,219,616,188,678,23.9,26.2,21.7,00000
39.0,61.0,47.0,234,03,01,  Akandapara,383,504,209,211,174,293,43.2,49.8,37.3,00000
39.0,61.0,47.0,234,04,01,  Uttar Chabilapur,159,217,87,102,72,115,42.3,46.0,38.5,00000
39.0,61.0,47.0,234,05,01,  Dakhin Chabilapur,179,175,95,72,84,103,50.6,56.9,44.9,00000
39.0,61.0,47.0,390,01,01,  Char Ghosher Para,1242,1853,658,836,584,1017,40.1,44.0,36.5,00000
39.0,61.0,47.0,390,02,01,  Bir Ghosher Para,922,2168,472,1008,450,1160,29.8,31.9,28.0,00000
39.0,61.0,57.0,504,01,01,  Purbapara,284,397,145,183,139,214,41.7,44.2,39.4,00000
39.0,61.0,57.0,504,02,01,  Paschimpara,785,901,410,401,375,500,46.6,50.6,42.9,00000
39.0,61.0,57.0,533,01,01,  Dakshin Jhaugara,668,1162,368,515,300,647,36.5,41.7,31.7,00000
39.0,61.0,57.0,533,02,01,  Daher Para,546,891,281,425,265,466,38.0,39.8,36.3,00000
39.0,61.0,57.0,533,03,01,  Paschim Jhaugara,496,501,254,219,242,282,49.7,53.7,46.2,00000
39.0,61.0,57.0,533,04,01,  Purba Jhaugara,560,800,317,366,243,434,41.2,46.4,35.9,00000
39.0,61.0,57.0,753,01,01,  Pairbari,221,435,119,204,102,231,33.7,36.8,30.6,00000
39.0,61.0,57.0,753,02,01,  Natun Pairbari,195,374,96,176,99,198,34.3,35.3,33.3,00000
39.0,61.0,57.0,888,01,01,  Sekh Shadi,557,1661,324,776,233,885,25.1,29.5,20.8,00000
39.0,61.0,57.0,888,02,01,  Sekh Shadi Natun Para,413,770,208,359,205,411,34.9,36.7,33.3,00000
39.0,61.0,57.0,888,03,01,  Topkar Char,265,412,150,192,115,220,39.1,43.9,34.3,00000
39.0,61.0,66.0,291,01,01,  Chinitala,513,1109,289,502,224,607,31.6,36.5,27.0,00000
39.0,61.0,66.0,291,02,01,  Pirgachha,76,299,41,141,35,158,20.3,22.5,18.1,00000
39.0,61.0,66.0,568,01,01,  Kangal Kursa,301,597,164,282,137,315,33.5,36.8,30.3,00000
39.0,61.0,66.0,568,02,01,  Dhalibhita,248,435,130,197,118,238,36.3,39.8,33.1,00000
39.0,61.0,66.0,724,01,01,  Pacha Bahala,496,1538,289,698,207,840,24.4,29.3,19.8,00000
39.0,61.0,66.0,724,02,01,  Pugli Para,123,430,73,178,50,252,22.2,29.1,16.6,00000
39.0,61.0,66.0,938,01,01,  Ramar Para,87,212,35,103,52,109,29.1,25.4,32.3,00000
39.0,61.0,66.0,938,02,01,  Daudpur,197,278,100,138,97,140,41.5,42.0,40.9,00000
39.0,61.0,66.0,938,04,01,  Para Gali,298,83,158,37,140,46,78.2,81.0,75.3,00000
39.0,61.0,66.0,938,05,01,  Tanaki,443,497,249,231,194,266,47.1,51.9,42.2,00000
39.0,61.0,66.0,938,06,01,  Naya Para,86,287,47,122,39,165,23.1,27.8,19.1,00000
39.0,61.0,76.0,596,01,01,  Khasimara,544,1268,270,576,274,692,30.0,31.9,28.4,00000
39.0,61.0,76.0,596,02,01,  Putia Para,426,689,225,323,201,366,38.2,41.1,35.4,00000
39.0,61.0,76.0,596,03,01,  Purar Char,392,717,222,332,170,385,35.3,40.1,30.6,00000
39.0,61.0,76.0,646,01,01,  Mahmudpur,819,1096,428,502,391,594,42.8,46.0,39.7,00000
39.0,61.0,76.0,646,02,01,  Char Mahmudpur,972,2502,518,1199,454,1303,28.0,30.2,25.8,00000
39.0,61.0,76.0,646,03,01,  Gobindi,730,1720,376,796,354,924,29.8,32.1,27.7,00000
39.0,61.0,76.0,646,04,01,  Kazikata,793,2638,395,1252,398,1386,23.1,24.0,22.3,00000
39.0,61.0,76.0,646,05,01,  Nalsia,602,855,332,413,270,442,41.3,44.6,37.9,00000
39.0,61.0,76.0,646,06,01,  Banabandha,175,384,85,191,90,193,31.3,30.8,31.8,00000
39.0,61.0,76.0,646,07,01,  Adbaria,565,1123,295,492,270,631,33.5,37.5,30.0,00000
39.0,61.0,76.0,746,01,01,  Panch Paila,1058,1910,579,833,479,1077,35.6,41.0,30.8,00000
39.0,61.0,76.0,746,02,01,  Paila,806,1628,407,746,399,882,33.1,35.3,31.1,00000
39.0,61.0,76.0,746,03,01,  Roknai Para,191,487,102,229,89,258,28.2,30.8,25.6,00000
39.0,61.0,76.0,746,04,01,  Charailper,275,688,143,321,132,367,28.6,30.8,26.5,00000
39.0,61.0,85.0,156,01,01,  Basudebpur,260,1018,151,493,109,525,20.3,23.4,17.2,00000
39.0,61.0,85.0,156,02,01,  Rupshihata,275,867,135,432,140,435,24.1,23.8,24.3,00000
39.0,61.0,85.0,156,03,01,  Kaurabaid,114,537,54,260,60,277,17.5,17.2,17.8,00000
39.0,61.0,85.0,326,01,01,  Deulabari,257,584,122,262,135,322,30.6,31.8,29.5,00000
39.0,61.0,85.0,326,02,01,  Pramanik Para,207,350,113,145,94,205,37.2,43.8,31.4,00000
39.0,61.0,85.0,326,03,01,  Sardar Para,175,517,87,255,88,262,25.3,25.4,25.1,00000
39.0,61.0,85.0,405,01,03,  Charildar,531,764,288,342,243,422,41.0,45.7,36.5,00000
39.0,61.0,85.0,405,02,03,  Majhband Bangla,209,555,121,263,88,292,27.4,31.5,23.2,00000
39.0,61.0,85.0,405,03,03,  Bagur Para,140,724,79,329,61,395,16.2,19.4,13.4,00000
39.0,61.0,85.0,405,04,03,  Gobindapur,381,880,216,425,165,455,30.2,33.7,26.6,00000
39.0,61.0,85.0,419,01,01,  Gobindapur,54,311,28,152,26,159,14.8,15.6,14.1,00000
39.0,61.0,85.0,419,02,01,  Natarpur,213,494,122,220,91,274,30.1,35.7,24.9,00000
39.0,61.0,85.0,419,03,01,  Kanch Mastair,50,135,24,53,26,82,27.0,31.2,24.1,00000
39.0,61.0,85.0,469,01,01,  Haripur,421,1095,217,498,204,597,27.8,30.3,25.5,00000
39.0,61.0,85.0,469,02,01,  Pathalia,321,513,171,206,150,307,38.5,45.4,32.8,00000
39.0,61.0,85.0,703,01,01,  Munshinogla,614,1117,355,504,259,613,35.5,41.3,29.7,00000
39.0,61.0,85.0,703,02,01,  Nalkuri,241,669,141,308,100,361,26.5,31.4,21.7,00000
39.0,61.0,97.0,465,01,01,  Amdanga (Part),190,392,87,199,103,193,32.6,30.4,34.8,00000
39.0,61.0,97.0,465,02,01,  Shaympur,334,1353,181,683,153,670,19.8,20.9,18.6,00000
39.0,61.0,97.0,465,03,01,  Kajir Kata,317,1102,182,541,135,561,22.3,25.2,19.4,00000
39.0,61.0,97.0,465,04,01,  Balur Char,431,1726,243,881,188,845,20.0,21.6,18.2,00000
39.0,61.0,97.0,465,05,01,  Tukkar Char,681,1628,353,818,328,810,29.5,30.1,28.8,00000
39.0,61.0,97.0,465,06,01,  Char Basata,504,1103,269,518,235,585,31.4,34.2,28.7,00000
39.0,61.0,97.0,465,07,01,  2nd Char,153,605,77,312,76,293,20.2,19.8,20.6,00000
39.0,61.0,97.0,465,08,01,  Gobindi,228,274,123,119,105,155,45.4,50.8,40.4,00000
39.0,61.0,97.0,465,09,01,  Bauler Para,136,378,76,191,60,187,26.5,28.5,24.3,00000
39.0,85.0,10.0,320,01,01,  Daulatpur,1540,1379,779,652,761,727,52.8,54.4,51.1,00000
39.0,85.0,10.0,320,02,01,  Mendarber,365,332,193,148,172,184,52.4,56.6,48.3,00000
39.0,85.0,10.0,320,03,01,  Batikamari,579,465,282,186,297,279,55.5,60.3,51.6,00000
39.0,85.0,10.0,320,04,01,  4rampur,287,250,128,122,159,128,53.4,51.2,55.4,00000
39.0,85.0,10.0,713,01,01,  Nather Para,237,448,124,200,113,248,34.6,38.3,31.3,00000
39.0,85.0,10.0,713,02,01,  Tikra Para,287,358,148,168,139,190,44.5,46.8,42.2,00000
39.0,85.0,10.0,713,03,01,  Kashinath Pur(Part),159,183,78,86,81,97,46.5,47.6,45.5,00000
39.0,85.0,10.0,975,01,01,  Chandpur,334,170,153,74,181,96,66.3,67.4,65.3,00000
39.0,85.0,10.0,975,02,01,  Taraniata,385,472,195,216,190,256,44.9,47.4,42.6,00000
39.0,85.0,10.0,975,03,01,  Kashinathpur,300,512,164,238,136,274,36.9,40.8,33.2,00000
39.0,85.0,10.0,975,04,01,  Kabariyabari,751,1014,411,435,340,579,42.5,48.6,37.0,00000
39.0,85.0,21.0,045,01,03,  Bausi Dopadha,144,49,65,23,79,26,74.6,73.9,75.2,00000
39.0,85.0,21.0,045,02,03,  Nayapara,88,225,45,103,43,122,28.1,30.4,26.1,00000
39.0,85.0,21.0,045,03,03,  Periyata,179,274,99,103,80,171,39.5,49.0,31.9,00000
39.0,85.0,21.0,045,04,03,  Bausi Gojaria,114,152,63,76,51,76,42.9,45.3,40.2,00000
39.0,85.0,21.0,045,05,03,  Choukha,226,243,111,118,115,125,48.2,48.5,47.9,00000
39.0,85.0,21.0,117,01,01,  Bhatara,1650,1333,837,594,813,739,55.3,58.5,52.4,00000
39.0,85.0,21.0,117,02,01,  Uder Para,93,227,41,111,52,116,29.1,27.0,31.0,00000
39.0,85.0,21.0,117,03,01,  Mohanganj,30,93,15,45,15,48,24.4,25.0,23.8,00000
39.0,85.0,21.0,117,04,01,  Kashari Para,175,221,82,107,93,114,44.2,43.4,44.9,00000
39.0,85.0,21.0,117,05,01,  Gopinathpur,220,321,110,163,110,158,40.7,40.3,41.0,00000
39.0,85.0,21.0,117,06,01,  Parpara,512,775,256,354,256,421,39.8,42.0,37.8,00000
39.0,85.0,31.0,032,01,01,  Balia,557,1025,270,464,287,561,35.2,36.8,33.8,00000
39.0,85.0,31.0,032,02,01,  Char Balia,705,1493,352,726,353,767,32.1,32.7,31.5,00000
39.0,85.0,31.0,111,01,01,  Bhabanipur,926,922,469,416,457,506,50.1,53.0,47.5,00000
39.0,85.0,31.0,111,02,01,  Loknathpur,190,217,83,92,107,125,46.7,47.4,46.1,00000
39.0,85.0,31.0,111,03,01,  Garadoba,422,335,204,142,218,193,55.7,59.0,53.0,00000
39.0,85.0,31.0,216,01,01,  Chaparkona,1685,1703,839,770,846,933,49.7,52.1,47.6,00000
39.0,85.0,31.0,216,02,01,  Purbachar,141,224,65,109,76,115,38.6,37.4,39.8,00000
39.0,85.0,31.0,216,03,01,  Kolarpar,115,123,55,56,60,67,48.3,49.5,47.2,00000
39.0,85.0,31.0,216,04,01,  Degribanda,533,694,255,333,278,361,43.4,43.4,43.5,00000
39.0,85.0,31.0,373,01,01,  Doail,1950,2508,1009,1132,941,1376,43.7,47.1,40.6,00000
39.0,85.0,31.0,373,02,01,  Parmanandapur,471,416,231,177,240,239,53.1,56.6,50.1,00000
39.0,85.0,31.0,373,03,01,  Panchanadapur,263,346,125,157,138,189,43.2,44.3,42.2,00000
39.0,85.0,31.0,373,04,01,  Krishnapur,401,333,170,156,231,177,54.6,52.1,56.6,00000
39.0,85.0,31.0,373,05,01,  Gobindapur,481,496,247,236,234,260,49.2,51.1,47.4,00000
39.0,85.0,31.0,373,06,01,  Rampur,102,206,53,89,49,117,33.1,37.3,29.5,00000
39.0,85.0,31.0,373,07,01,  Ramanadapur,418,531,219,225,199,306,44.0,49.3,39.4,00000
39.0,85.0,31.0,373,08,01,  Kazia Sadar,101,219,63,92,38,127,31.6,40.6,23.0,00000
39.0,85.0,31.0,379,01,01,  Dolbhiti,776,1180,403,545,373,635,39.7,42.5,37.0,00000
39.0,85.0,31.0,379,02,01,  Harkhali,113,251,66,109,47,142,31.0,37.7,24.9,00000
39.0,85.0,31.0,412,01,01,  Gram Nikai,445,483,231,217,214,266,48.0,51.6,44.6,00000
39.0,85.0,31.0,412,02,01,  Adachaki,419,542,220,254,199,288,43.6,46.4,40.9,00000
39.0,85.0,31.0,412,03,01,  Maishakandi,71,77,40,35,31,42,48.0,53.3,42.5,00000
39.0,85.0,31.0,445,01,01,  Hasra,451,720,245,347,206,373,38.5,41.4,35.6,00000
39.0,85.0,31.0,445,02,01,  Majalia,842,1450,432,638,410,812,36.7,40.4,33.6,00000
39.0,85.0,31.0,445,03,01,  Prasadpur,252,179,126,77,126,102,58.5,62.1,55.3,00000
39.0,85.0,31.0,451,01,01,  Hatbari,786,1475,376,701,410,774,34.8,34.9,34.6,00000
39.0,85.0,31.0,451,02,01,  Char Hatbari,588,824,298,377,290,447,41.6,44.1,39.3,00000
39.0,85.0,31.0,805,01,01,  Royder Para,859,1298,441,613,418,685,39.8,41.8,37.9,00000
39.0,85.0,31.0,805,02,01,  Udna Para,292,337,156,154,136,183,46.4,50.3,42.6,00000
39.0,85.0,42.0,091,01,01,  Barabaria,969,1351,502,661,467,690,41.8,43.2,40.4,00000
39.0,85.0,42.0,091,02,01,  Bir Barabaria,321,94,170,41,151,53,77.3,80.6,74.0,00000
39.0,85.0,63.0,078,01,01,  Baraipatal,1015,1593,521,749,494,844,38.9,41.0,36.9,00000
39.0,85.0,63.0,078,02,01,  Fuladher Para,1118,954,521,429,597,525,54.0,54.8,53.2,00000
39.0,85.0,63.0,098,01,01,  Basuria,242,291,118,124,124,167,45.4,48.8,42.6,00000
39.0,85.0,63.0,098,02,01,  Padmapur,289,225,141,93,148,132,56.2,60.3,52.9,00000
39.0,85.0,63.0,098,03,01,  Narpara,473,479,239,223,234,256,49.7,51.7,47.8,00000
39.0,85.0,63.0,098,04,01,  Radhanagar,445,738,237,339,208,399,37.6,41.1,34.3,00000
39.0,85.0,63.0,693,01,01,  Dakatia Nendi,215,875,112,432,103,443,19.7,20.6,18.9,00000
39.0,85.0,63.0,693,02,01,  Nalsanda,732,1664,367,837,365,827,30.6,30.5,30.6,00000
39.0,85.0,63.0,693,03,01,  Balia Menda,298,915,151,463,147,452,24.6,24.6,24.5,00000
39.0,85.0,63.0,693,04,01,  Mirkuta,285,923,139,439,146,484,23.6,24.0,23.2,00000
39.0,85.0,63.0,798,01,01,  Raspal,37,56,22,24,15,32,39.8,47.8,31.9,00000
39.0,85.0,63.0,798,02,01,  Gopalganj (Kawamara),996,1027,529,436,467,591,49.2,54.8,44.1,00000
39.0,85.0,73.0,183,01,01,  Binnafair,272,856,148,433,124,423,24.1,25.5,22.7,00000
39.0,85.0,73.0,183,02,01,  Shimultair,176,102,94,45,82,57,63.3,67.6,59.0,00000
39.0,85.0,73.0,183,03,01,  Monar Para,648,686,320,308,328,378,48.6,51.0,46.5,00000
39.0,85.0,73.0,183,04,01,  Sanchar Par,483,396,267,161,216,235,54.9,62.4,47.9,00000
39.0,85.0,73.0,183,05,01,  Patabuga,300,497,153,243,147,254,37.6,38.6,36.7,00000
39.0,85.0,73.0,183,06,01,  Bagarpar,1033,1327,529,598,504,729,43.8,46.9,40.9,00000
39.0,85.0,73.0,183,07,01,  Gobindanagar,739,835,357,379,382,456,47.0,48.5,45.6,00000
39.0,85.0,73.0,183,08,01,  Putiar Para,683,1276,351,599,332,677,34.9,36.9,32.9,00000
39.0,85.0,73.0,183,09,01,  Chak Para,564,323,281,149,283,174,63.6,65.3,61.9,00000
39.0,85.0,73.0,301,01,01,  Checheyabadha,341,192,174,91,167,101,64.0,65.7,62.3,00000
39.0,85.0,73.0,301,02,01,  Damodapur,592,906,277,427,315,479,39.5,39.3,39.7,00000
39.0,85.0,73.0,765,01,01,  Pogaldigha,1517,2363,815,1119,702,1244,39.1,42.1,36.1,00000
39.0,85.0,73.0,765,02,01,  Korani Para,224,224,100,105,124,119,50.0,48.8,51.0,00000
39.0,85.0,73.0,765,03,01,  Ramchandrakhali,375,463,186,223,189,240,44.7,45.5,44.1,00000
39.0,85.0,73.0,765,04,01,  Tarakandi,1001,933,495,435,506,498,51.8,53.2,50.4,00000
39.0,85.0,73.0,765,05,01,  Kandar Para,1100,803,564,382,536,421,57.8,59.6,56.0,00000
39.0,85.0,73.0,765,06,01,  Char Para,578,356,290,171,288,185,61.9,62.9,60.9,00000
39.0,85.0,73.0,765,07,01,  Pakhi Mara,3458,786,1882,500,1576,286,81.5,79.0,84.6,00000
39.0,85.0,73.0,765,08,01,  Palisha,531,600,277,292,254,308,46.9,48.7,45.2,00000
39.0,85.0,73.0,765,09,01,  Dhuriarbhita,706,956,362,466,344,490,42.5,43.7,41.2,00000
39.0,85.0,73.0,765,10,01,  Gobindapatal,353,260,197,117,156,143,57.6,62.7,52.2,00000
39.0,85.0,73.0,818,01,01,  Baira,1188,959,619,433,569,526,55.3,58.8,52.0,00000
39.0,85.0,73.0,818,02,01,  Rudrabaira,1251,1038,617,481,634,557,54.7,56.2,53.2,00000
39.0,85.0,73.0,818,03,01,  Gachhbaira,385,685,208,329,177,356,36.0,38.7,33.2,00000
39.0,85.0,73.0,818,04,01,  Gendar Para,930,695,456,331,474,364,57.2,57.9,56.6,00000
39.0,85.0,73.0,818,05,01,  Baishar Char Para,213,187,109,96,104,91,53.3,53.2,53.3,00000
39.0,85.0,84.0,811,01,01,  Rouha,658,1659,339,827,319,832,28.4,29.1,27.7,00000
39.0,85.0,84.0,811,02,01,  Khalishakuri,86,254,50,131,36,123,25.3,27.6,22.6,00000
59.0,24.0,10.0,035,01,01,  Aralia,1235,929,659,437,576,492,57.1,60.1,53.9,00000
59.0,24.0,10.0,035,02,01,  Maudarkandi,633,695,352,314,281,381,47.7,52.9,42.4,00000
59.0,24.0,10.0,035,03,01,  Abdullahpur,122,284,48,131,74,153,30.0,26.8,32.6,00000
59.0,24.0,10.0,843,01,01,  Bara Roypur,1128,1299,556,582,572,717,46.5,48.9,44.4,00000
59.0,24.0,10.0,843,02,01,  Chhota Roypur,732,684,379,311,353,373,51.7,54.9,48.6,00000
59.0,24.0,21.0,177,01,01,  Char Bausia Barakandi,1632,1515,896,689,736,826,51.9,56.5,47.1,00000
59.0,24.0,21.0,177,02,01,  Monairkandi,673,754,331,313,342,441,47.2,51.4,43.7,00000
59.0,24.0,21.0,177,03,01,  Bhakterkandi,445,405,236,179,209,226,52.4,56.9,48.0,00000
59.0,24.0,21.0,177,04,01,  Paschimkandi,436,294,221,131,215,163,59.7,62.8,56.9,00000
59.0,24.0,21.0,177,05,01,  Faragikandi,770,834,408,399,362,435,48.0,50.6,45.4,00000
59.0,24.0,21.0,177,06,01,  Madhyakandi,640,638,335,300,305,338,50.1,52.8,47.4,00000
59.0,24.0,21.0,177,07,01,  Tek Para,210,199,93,95,117,104,51.3,49.5,52.9,00000
59.0,24.0,21.0,257,01,01,  Old Chaudda Kahania,217,331,99,177,118,154,39.6,35.9,43.4,00000
59.0,24.0,21.0,257,02,01,  New Chaudda Kahania,153,270,68,139,85,131,36.2,32.9,39.4,00000
59.0,24.0,21.0,941,01,01,  Purba Chak,714,684,361,328,353,356,51.1,52.4,49.8,00000
59.0,24.0,21.0,941,02,01,  Nayakandi,504,449,269,188,235,261,52.9,58.9,47.4,00000
59.0,24.0,31.0,151,01,01,  Bhitikandi,709,335,377,139,332,196,67.9,73.1,62.9,00000
59.0,24.0,31.0,151,02,01,  Nayakandi,507,315,236,127,271,188,61.7,65.0,59.0,00000
59.0,24.0,31.0,932,01,01,  Bhaber Char,1882,947,1053,413,829,534,66.5,71.8,60.8,00000
59.0,24.0,31.0,932,02,01,  Kawniakandi,271,208,153,84,118,124,56.6,64.6,48.8,00000
59.0,24.0,31.0,932,03,01,  Sreenagar,509,326,267,133,242,193,61.0,66.8,55.6,00000
59.0,24.0,31.0,932,04,01,  Char Pathalia,733,219,376,91,357,128,77.0,80.5,73.6,00000
59.0,24.0,42.0,310,01,03,  Kajipura,321,103,167,46,154,57,75.7,78.4,73.0,00000
59.0,24.0,42.0,310,02,03,  Dakshin Lamchhari,263,44,129,20,134,24,85.7,86.6,84.8,00000
59.0,24.0,42.0,355,01,01,  Fuldi,250,428,116,211,134,217,36.9,35.5,38.2,00000
59.0,24.0,42.0,355,02,01,  Barafdi,45,63,21,29,24,34,41.7,42.0,41.4,00000
59.0,24.0,42.0,408,01,01,  Gosair Char,700,172,343,82,357,90,80.3,80.7,79.9,00000
59.0,24.0,42.0,408,02,01,  Doulatpur,238,99,121,48,117,51,70.6,71.6,69.6,00000
59.0,24.0,42.0,515,01,01,  Kalsarkandi,398,13,196,5,202,8,96.8,97.5,96.2,00000
59.0,24.0,42.0,515,02,01,  Banshgaon,543,218,274,89,269,129,71.4,75.5,67.6,00000
59.0,24.0,42.0,675,01,01,  Nayanagar,346,733,147,337,199,396,32.1,30.4,33.4,00000
59.0,24.0,42.0,675,02,01,  Balu Char,172,175,64,77,108,98,49.6,45.4,52.4,00000
59.0,24.0,42.0,755,01,01,  Pradhaner Char,512,333,260,143,252,190,60.6,64.5,57.0,00000
59.0,24.0,42.0,755,02,01,  Amirabad,211,220,98,98,113,122,49.0,50.0,48.1,00000
59.0,24.0,52.0,106,01,01,  Bara Basur Char,281,196,143,96,138,100,58.9,59.8,58.0,00000
59.0,24.0,52.0,106,02,01,  Chhota Basur Char,244,296,101,157,143,139,45.2,39.1,50.7,00000
59.0,24.0,52.0,248,01,01,  New Chashi Char,874,749,470,369,404,380,53.9,56.0,51.5,00000
59.0,24.0,52.0,248,02,01,  Old Chashi Char,785,1224,341,621,444,603,39.1,35.4,42.4,00000
59.0,24.0,52.0,737,01,01,  Kadamtali,433,349,202,142,231,207,55.4,58.7,52.7,00000
59.0,24.0,52.0,737,02,01,  Datter Char,404,328,186,153,218,175,55.2,54.9,55.5,00000
59.0,24.0,52.0,737,03,01,  Basar Char,793,582,378,280,415,302,57.7,57.4,57.9,00000
59.0,24.0,63.0,186,01,01,  Char Betaki (Nutanchar),511,517,272,283,239,234,49.7,49.0,50.5,00000
59.0,24.0,63.0,186,02,01,  Char Balakia,662,727,350,382,312,345,47.7,47.8,47.5,00000
59.0,24.0,63.0,186,03,01,  Bhati Balakia,233,573,124,304,109,269,28.9,29.0,28.8,00000
59.0,24.0,63.0,186,04,01,  Tanbalaki,1938,2041,1017,1045,921,996,48.7,49.3,48.0,00000
59.0,24.0,63.0,453,01,01,  Hossaindi,839,564,433,264,406,300,59.8,62.1,57.5,00000
59.0,24.0,63.0,453,02,01,  Bazar Hossaindi,461,245,267,117,194,128,65.3,69.5,60.2,00000
59.0,24.0,63.0,453,03,01,  Petta Hossaindi,465,245,274,128,191,117,65.5,68.2,62.0,00000
59.0,24.0,63.0,470,01,01,  Ishpanir Char Farazi Para,328,167,168,88,160,79,66.3,65.6,66.9,00000
59.0,24.0,63.0,470,02,01,  Uttarpara,733,710,367,386,366,324,50.8,48.7,53.0,00000
59.0,24.0,63.0,870,01,01,  Kandargaon,374,89,331,60,43,29,80.8,84.7,59.7,00000
59.0,24.0,63.0,870,02,01,  Char Sakirgaon,358,123,229,98,129,25,74.4,70.0,83.8,00000
59.0,24.0,73.0,213,01,01,  Tanusarkandi (Cholokoli),147,197,74,103,73,94,42.7,41.8,43.7,00000
59.0,24.0,73.0,213,02,01,  Charkalipur (Barumollakandi),203,207,107,108,96,99,49.5,49.8,49.2,00000
59.0,24.0,73.0,213,03,01,  Naimuddin Sarkarkandi,266,157,124,67,142,90,62.9,64.9,61.2,00000
59.0,24.0,73.0,213,04,01,  Bara Kalipura,255,403,108,200,147,203,38.8,35.1,42.0,00000
59.0,24.0,73.0,906,01,01,  Solani,677,863,325,407,352,456,44.0,44.4,43.6,00000
59.0,24.0,73.0,906,02,01,  Japta,94,43,53,21,41,22,68.6,71.6,65.1,00000
59.0,24.0,84.0,142,01,01,  Bara Bhater Char,917,480,487,246,430,234,65.6,66.4,64.8,00000
59.0,24.0,84.0,142,02,01,  Madhya Bhater Char,976,264,570,120,406,144,78.7,82.6,73.8,00000
59.0,24.0,84.0,142,03,01,  Bishdona Bhater Char,524,161,302,73,222,88,76.5,80.5,71.6,00000
59.0,24.0,84.0,142,04,01,  Baraikandi Bhater Char,578,327,292,147,286,180,63.9,66.5,61.4,00000
59.0,24.0,84.0,692,01,01,  Nijgaon,477,643,255,323,222,320,42.6,44.1,41.0,00000
59.0,24.0,84.0,692,02,01,  Uttarshaupur,207,211,121,83,86,128,49.5,59.3,40.2,00000
59.0,44.0,15.0,293,01,01,  Dhararhat,286,194,154,81,132,113,59.6,65.5,53.9,00000
59.0,44.0,15.0,293,02,01,  Madhaisur,117,50,50,23,67,27,70.1,68.5,71.3,00000
59.0,44.0,15.0,781,01,01,  Paysa,644,354,351,161,293,193,64.5,68.6,60.3,00000
59.0,44.0,15.0,781,02,01,  Paschimpara,244,121,121,56,123,65,66.8,68.4,65.4,00000
59.0,44.0,31.0,373,01,01,  Gholtali,466,474,231,249,235,225,49.6,48.1,51.1,00000
59.0,44.0,31.0,373,02,01,  Kalikata,128,163,54,80,74,83,44.0,40.3,47.1,00000
59.0,44.0,39.0,968,01,01,  Uttar Haldia,2068,1176,1067,564,1001,612,63.7,65.4,62.1,00000
59.0,44.0,39.0,968,02,01,  Karpasha,828,426,409,203,419,223,66.0,66.8,65.3,00000
59.0,44.0,47.0,142,01,01,  Paschim Bharakar,222,307,118,179,104,128,42.0,39.7,44.8,00000
59.0,44.0,47.0,142,02,01,  Purba Bharakar,699,558,355,282,344,276,55.6,55.7,55.5,00000
59.0,44.0,47.0,461,01,01,  Paschim Kalma,971,597,608,381,363,216,61.9,61.5,62.7,00000
59.0,44.0,47.0,461,02,01,  Madhya Kalma,701,241,298,111,403,130,74.4,72.9,75.6,00000
59.0,44.0,47.0,461,03,01,  Dakshin Kalma,745,429,363,200,382,229,63.5,64.5,62.5,00000
59.0,44.0,47.0,461,04,01,  Purba Kalma,612,632,288,327,324,305,49.2,46.8,51.5,00000
59.0,44.0,47.0,461,05,01,  Uttar Kalma,514,364,228,180,286,184,58.5,55.9,60.9,00000
59.0,44.0,63.0,133,01,01,  Bagbari,222,97,100,56,122,41,69.6,64.1,74.8,00000
59.0,44.0,63.0,133,02,01,  Ramnagar,86,27,46,7,40,20,76.1,86.8,66.7,00000
59.0,44.0,63.0,533,01,01,  Khala Para,763,481,335,276,428,205,61.3,54.8,67.6,00000
59.0,44.0,63.0,533,02,01,  Narsingapur,313,230,164,136,149,94,57.6,54.7,61.3,00000
59.0,44.0,63.0,533,03,01,  Kalarbagh,184,46,107,26,77,20,80.0,80.5,79.4,00000
59.0,44.0,63.0,533,04,01,  Naya Bari,172,37,102,18,70,19,82.3,85.0,78.7,00000
59.0,44.0,63.0,559,01,01,  Khidir Para,1608,816,966,468,642,348,66.3,67.4,64.8,00000
59.0,44.0,63.0,559,02,01,  Bankhira,201,161,83,78,118,83,55.5,51.6,58.7,00000
59.0,44.0,63.0,799,01,01,  Uttar Pinganali,127,89,59,54,68,35,58.8,52.2,66.0,00000
59.0,44.0,63.0,799,02,01,  Dakshin Pingnali,251,158,144,50,107,108,61.4,74.2,49.8,00000
59.0,44.0,63.0,799,03,01,  Pashuram Para,255,115,133,56,122,59,68.9,70.4,67.4,00000
59.0,44.0,63.0,799,04,01,  Dastirbagh,116,109,60,42,56,67,51.6,58.8,45.5,00000
59.0,44.0,71.0,541,01,01,  Kharia,938,716,446,310,492,406,56.7,59.0,54.8,00000
59.0,44.0,71.0,541,02,01,  Paschim Kharia,394,324,191,166,203,158,54.9,53.5,56.2,00000
59.0,44.0,71.0,977,01,01,  Kumarbhog,1552,937,761,429,791,508,62.4,63.9,60.9,00000
59.0,44.0,71.0,977,02,01,  Tentulia,311,136,161,70,150,66,69.6,69.7,69.4,00000
59.0,44.0,87.0,524,01,01,  Sitarampur,234,200,106,97,128,103,53.9,52.2,55.4,00000
59.0,44.0,87.0,524,02,01,  Gadai Biswas,239,66,115,35,124,31,78.4,76.7,80.0,00000
59.0,44.0,87.0,524,03,01,  Kazir Pagla,1230,539,649,269,581,270,69.5,70.7,68.3,00000
59.0,56.0,20.0,123,01,01,  Tantikandi,333,639,159,306,174,333,34.3,34.2,34.3,00000
59.0,56.0,20.0,123,02,01,  Majikandiha,460,408,222,220,238,188,53.0,50.2,55.9,00000
59.0,56.0,20.0,123,03,01,  Khalasikandi,92,177,55,98,37,79,34.2,35.9,31.9,00000
59.0,56.0,20.0,123,04,01,  Dewankandi,443,469,225,233,218,236,48.6,49.1,48.0,00000
59.0,56.0,20.0,123,05,01,  Nayeberkandi,41,109,25,62,16,47,27.3,28.7,25.4,00000
59.0,56.0,20.0,123,06,01,  Paschim Namakandi,144,235,73,108,71,127,38.0,40.3,35.9,00000
59.0,56.0,20.0,123,07,01,  Dakshinkandi,139,317,76,158,63,159,30.5,32.5,28.4,00000
59.0,56.0,20.0,123,08,01,  Fatu Bepari Kandi,76,69,40,36,36,33,52.4,52.6,52.2,00000
59.0,56.0,20.0,123,09,01,  Mijhikandi  Kandi,243,735,126,365,117,370,24.8,25.7,24.0,00000
59.0,56.0,20.0,123,10,01,  Solanikandi,103,276,47,144,56,132,27.2,24.6,29.8,00000
59.0,56.0,20.0,123,11,01,  Kalir Char Sikdarkandi,519,1004,281,499,238,505,34.1,36.0,32.0,00000
59.0,56.0,20.0,265,01,01,  Char Jogendra,193,245,101,103,92,142,44.1,49.5,39.3,00000
59.0,56.0,20.0,265,02,01,  Somar Dalikandi,466,553,210,252,256,301,45.7,45.5,46.0,00000
59.0,56.0,20.0,314,01,01,  Kawadi,9,39,4,22,5,17,18.8,15.4,22.7,00000
59.0,56.0,20.0,314,02,01,  Uttar Bak Char,80,500,36,254,44,246,13.8,12.4,15.2,00000
59.0,56.0,20.0,369,01,01,  Dakshin Tarki,240,253,108,124,132,129,48.7,46.6,50.6,00000
59.0,56.0,20.0,369,02,01,  Batakandi,94,75,49,36,45,39,55.6,57.6,53.6,00000
59.0,56.0,20.0,407,01,01,  Uttar Saidpur,684,1107,326,521,358,586,38.2,38.5,37.9,00000
59.0,56.0,20.0,407,02,01,  Dakshin Saidpur,595,686,280,307,315,379,46.4,47.7,45.4,00000
59.0,56.0,20.0,416,01,01,  Jajira Purbapara,571,744,291,339,280,405,43.4,46.2,40.9,00000
59.0,56.0,20.0,416,02,01,  Jajira Kunjanagar,291,418,149,186,142,232,41.0,44.5,38.0,00000
59.0,56.0,20.0,416,03,01,  Jajira Kachari Parajana,170,285,104,138,66,147,37.4,43.0,31.0,00000
59.0,56.0,20.0,416,04,01,  Jajira Bakchar,197,916,102,429,95,487,17.7,19.2,16.3,00000
59.0,56.0,20.0,729,01,01,  Sarhati,65,236,25,111,40,125,21.6,18.4,24.2,00000
59.0,56.0,20.0,729,02,01,  Nagar Dubsa,134,242,66,107,68,135,35.6,38.2,33.5,00000
59.0,56.0,20.0,862,01,01,  Rari Para (Hindu Para),286,228,165,98,121,130,55.6,62.7,48.2,00000
59.0,56.0,20.0,862,02,01,  Rari Para (Muslim Para),475,625,225,294,250,331,43.2,43.4,43.0,00000
59.0,56.0,20.0,976,01,01,  Tepir Char,187,353,112,192,75,161,34.6,36.8,31.8,00000
59.0,56.0,20.0,976,02,01,  Chhay Ghariakandi,199,289,89,140,110,149,40.8,38.9,42.5,00000
59.0,56.0,22.0,056,01,01,  Atpara,753,526,347,238,406,288,58.9,59.3,58.5,00000
59.0,56.0,22.0,056,02,01,  Acharji Para,45,38,28,17,17,21,54.2,62.2,44.7,00000
59.0,56.0,22.0,085,01,01,  Guhpara,423,234,203,129,220,105,64.4,61.1,67.7,00000
59.0,56.0,22.0,085,02,01,  Purahit Para,159,59,77,29,82,30,72.9,72.6,73.2,00000
59.0,56.0,22.0,085,03,01,  Pukur Para,300,259,136,139,164,120,53.7,49.5,57.7,00000
59.0,56.0,22.0,085,04,01,  Shom Para,167,101,77,58,90,43,62.3,57.0,67.7,00000
59.0,56.0,22.0,085,05,01,  Basu Para,177,59,83,26,94,33,75.0,76.1,74.0,00000
59.0,56.0,22.0,085,06,01,  Battacharya Para,157,105,72,55,85,50,59.9,56.7,63.0,00000
59.0,56.0,22.0,331,01,01,  Churain,1075,543,550,311,525,232,66.4,63.9,69.4,00000
59.0,56.0,22.0,331,02,01,  Azimpur,382,269,185,132,197,137,58.7,58.4,59.0,00000
59.0,56.0,22.0,331,03,01,  Dekra Para,491,286,159,137,332,149,63.2,53.7,69.0,00000
59.0,56.0,22.0,852,01,01,  Ramsingha,1390,988,663,502,727,486,58.5,56.9,59.9,00000
59.0,56.0,22.0,852,02,01,  Satra Para,596,393,262,196,334,197,60.3,57.2,62.9,00000
59.0,56.0,22.0,852,03,01,  Malpara,223,112,114,50,109,62,66.6,69.5,63.7,00000
59.0,56.0,22.0,852,04,01,  Ghosh Para,71,52,25,27,46,25,57.7,48.1,64.8,00000
59.0,56.0,22.0,852,05,01,  Saraswati,461,166,195,87,266,79,73.5,69.1,77.1,00000
59.0,56.0,23.0,208,01,01,  Sardarkandi,254,667,155,324,99,343,27.6,32.4,22.4,00000
59.0,56.0,23.0,208,02,01,  Mahessur Nayakandi,446,448,230,192,216,256,49.9,54.5,45.8,00000
59.0,56.0,23.0,208,03,01,  Chenga Buniakandi,251,304,145,148,106,156,45.2,49.5,40.5,00000
59.0,56.0,23.0,208,04,01,  Mahessur Dhalikandi,60,231,29,114,31,117,20.6,20.3,20.9,00000
59.0,56.0,23.0,208,05,01,  Mahessur Purbakandi,388,326,198,144,190,182,54.3,57.9,51.1,00000
59.0,56.0,23.0,208,06,01,  Mahessur Paschimkandi,136,327,58,165,78,162,29.4,26.0,32.5,00000
59.0,56.0,23.0,208,07,01,  Baliakandi,194,191,100,84,94,107,50.4,54.3,46.8,00000
59.0,56.0,23.0,208,08,01,  Bater Char,225,252,100,118,125,134,47.2,45.9,48.3,00000
59.0,56.0,23.0,208,09,01,  Asulir Char Purbakandi,518,704,274,371,244,333,42.4,42.5,42.3,00000
59.0,56.0,23.0,208,10,01,  Asulir Char Paschimkandi,443,497,222,250,221,247,47.1,47.0,47.2,00000
59.0,56.0,23.0,208,11,01,  Bagher Char Patna,45,150,30,132,15,18,23.1,18.5,45.5,00000
59.0,56.0,23.0,208,12,01,  Purba Bagher Char,246,808,137,401,109,407,23.3,25.5,21.1,00000
59.0,56.0,23.0,208,13,01,  Uttar Bhukailash,262,703,132,390,130,313,27.2,25.3,29.3,00000
59.0,56.0,23.0,208,14,01,  Dakshin Bhukailash,259,443,150,245,109,198,36.9,38.0,35.5,00000
59.0,56.0,28.0,312,01,01,  Uttar Char Masura,733,1317,354,678,379,639,35.8,34.3,37.2,00000
59.0,56.0,28.0,312,02,01,  Dakshin Char Masura,1252,2422,612,1147,640,1275,34.1,34.8,33.4,00000
59.0,56.0,28.0,312,03,01,  Harinagar (Fultala)Part-1,475,349,226,182,249,167,57.6,55.4,59.9,00000
59.0,56.0,28.0,578,01,01,  Fultala(Part-2),15,68,7,33,8,35,18.1,17.5,18.6,00000
59.0,56.0,28.0,578,02,01,  Baghaikandi Part-2,75,101,36,46,39,55,42.6,43.9,41.5,00000
59.0,56.0,28.0,957,01,01,  Tarki Purbapara,639,658,319,330,320,328,49.3,49.2,49.4,00000
59.0,56.0,28.0,957,02,01,  Tarki Pachimpara,561,776,287,374,274,402,42.0,43.4,40.5,00000
59.0,56.0,28.0,957,03,01,  Batakandi,236,297,120,141,116,156,44.3,46.0,42.6,00000
59.0,56.0,28.0,957,04,01,  B.T.Hogla,810,928,387,454,423,474,46.6,46.0,47.2,00000
59.0,56.0,28.0,957,05,01,  Hoglakandi,777,1016,378,502,399,514,43.3,43.0,43.7,00000
59.0,56.0,28.0,957,06,01,  Char Kewar,928,710,472,318,456,392,56.7,59.7,53.8,00000
59.0,56.0,28.0,957,07,01,  Uttar Guharkandi,754,493,384,219,370,274,60.5,63.7,57.5,00000
59.0,56.0,28.0,957,08,01,  Dakshin Guharkandi,299,376,159,190,140,186,44.3,45.6,42.9,00000
59.0,56.0,28.0,957,09,01,  Changa Buniakandi (Hamidpur),204,213,101,94,103,119,48.9,51.8,46.4,00000
59.0,56.0,28.0,957,10,01,  Kadamtali,501,742,247,384,254,358,40.3,39.1,41.5,00000
59.0,56.0,28.0,957,11,01,  Sotta Mollahkandi,193,323,90,158,103,165,37.4,36.3,38.4,00000
59.0,56.0,28.0,957,12,01,  Kash Kandi,451,380,246,183,205,197,54.3,57.3,51.0,00000
59.0,56.0,28.0,957,13,01,  Nal Bonia Kandi,1101,500,543,215,558,285,68.8,71.6,66.2,00000
59.0,56.0,28.0,957,14,01,  Baghaiakandi Part 1,768,474,349,202,419,272,61.8,63.3,60.6,00000
59.0,56.0,28.0,957,15,01,  Pora Kandi,85,76,40,37,45,39,52.8,51.9,53.6,00000
59.0,56.0,28.0,957,16,01,  Mohan Puriakandi,88,146,49,73,39,73,37.6,40.2,34.8,00000
59.0,56.0,28.0,957,17,01,  Tarki Islampur (Fultala),568,729,277,333,291,396,43.8,45.4,42.4,00000
59.0,56.0,38.0,900,01,01,  Dewankandi,431,701,236,335,195,366,38.1,41.3,34.8,00000
59.0,56.0,38.0,900,02,01,  Uttarkandi,881,999,506,478,375,521,46.9,51.4,41.9,00000
59.0,56.0,38.0,900,03,01,  Madhyakandi,324,454,165,225,159,229,41.6,42.3,41.0,00000
59.0,56.0,38.0,900,04,01,  Dakshinkandi,426,806,234,405,192,401,34.6,36.6,32.4,00000
59.0,56.0,38.0,900,05,01,  Sabura Kandi,410,359,223,173,187,186,53.3,56.3,50.1,00000
59.0,56.0,47.0,104,01,01,  Uttar Kewar,829,444,427,199,402,245,65.1,68.2,62.1,00000
59.0,56.0,47.0,104,02,01,  Dakshin Kewar,1332,720,738,342,594,378,64.9,68.3,61.1,00000
59.0,56.0,47.0,104,03,01,  Madhya Kewar,533,239,249,107,284,132,69.0,69.9,68.3,00000
59.0,56.0,47.0,104,04,01,  Magui Digirpar,215,209,109,105,106,104,50.7,50.9,50.5,00000
59.0,56.0,47.0,104,05,01,  Nuritali,364,286,180,140,184,146,56.0,56.3,55.8,00000
59.0,56.0,47.0,464,01,01,  Ghasir Pukurpar,543,256,257,120,286,136,68.0,68.2,67.8,00000
59.0,56.0,47.0,464,02,01,  Bara Uthan,195,78,85,35,110,43,71.4,70.8,71.9,00000
59.0,56.0,47.0,625,01,01,  Uttar Mahakali,1792,853,829,398,963,455,67.8,67.6,67.9,00000
59.0,56.0,47.0,625,02,01,  Madhya Mahakali,1238,1605,527,796,711,809,43.5,39.8,46.8,00000
59.0,56.0,47.0,625,03,01,  Dakshin Mahakali,914,905,401,443,513,462,50.2,47.5,52.6,00000
59.0,56.0,47.0,758,01,01,  Nair Pukurpar,1346,904,635,457,711,447,59.8,58.2,61.4,00000
59.0,56.0,47.0,758,02,01,  Chhota Makuhati,403,366,210,214,193,152,52.4,49.5,55.9,00000
59.0,56.0,57.0,028,01,01,  Amghata Part-1,682,1354,303,653,379,701,33.5,31.7,35.1,00000
59.0,56.0,57.0,028,02,01,  Natun Amghata,77,106,43,39,34,67,42.1,52.4,33.7,00000
59.0,56.0,57.0,303,01,01,  Char Dumria,878,1143,432,543,446,600,43.4,44.3,42.6,00000
59.0,56.0,57.0,303,02,01,  Chaitar Char,357,448,172,201,185,247,44.3,46.1,42.8,00000
59.0,56.0,57.0,303,03,01,  Amghata Part-2,27,34,14,19,13,15,44.3,42.4,46.4,00000
59.0,56.0,57.0,445,01,01,  Gabuabari,202,100,103,37,99,63,66.9,73.6,61.1,00000
59.0,56.0,57.0,445,02,01,  Chhota Kowardali,201,104,100,55,101,49,65.9,64.5,67.3,00000
59.0,56.0,57.0,644,01,01,  Mahishpur Part-2,432,293,185,134,247,159,59.6,58.0,60.8,00000
59.0,56.0,57.0,644,02,01,  Makuhati,1404,1199,702,568,702,631,53.9,55.3,52.7,00000
59.0,56.0,57.0,644,03,01,  Purba Makuhati,576,505,269,236,307,269,53.3,53.3,53.3,00000
59.0,56.0,57.0,644,04,01,  Rajar Char,821,744,392,310,429,434,52.5,55.8,49.7,00000
59.0,56.0,57.0,701,01,01,  Mollahkandi,294,418,144,213,150,205,41.3,40.3,42.3,00000
59.0,56.0,57.0,701,02,01,  Khas Mollahkandi,189,177,96,83,93,94,51.6,53.6,49.7,00000
59.0,56.0,57.0,701,03,01,  Kangsapur,342,692,180,334,162,358,33.1,35.0,31.2,00000
59.0,56.0,57.0,760,01,01,  Noada,524,684,267,353,257,331,43.4,43.1,43.7,00000
59.0,56.0,57.0,760,02,01,  Lakshmi Debi,149,267,83,134,66,133,35.8,38.2,33.2,00000
59.0,56.0,76.0,170,01,01,  Champatali,999,392,498,200,501,192,71.8,71.3,72.3,00000
59.0,56.0,76.0,170,02,01,  Ratanpur,708,584,350,291,358,293,54.8,54.6,55.0,00000
59.0,56.0,76.0,435,01,01,  Firingi Bazar,657,714,345,345,312,369,47.9,50.0,45.8,00000
59.0,56.0,76.0,435,02,01,  Sarkar Para,1403,1389,695,671,708,718,50.3,50.9,49.6,00000
59.0,56.0,76.0,435,03,01,  Adariatali,1099,729,567,349,532,380,60.1,61.9,58.3,00000
59.0,56.0,76.0,682,01,01,  Mirer Sarai,1352,1794,671,962,681,832,43.0,41.1,45.0,00000
59.0,56.0,76.0,682,02,01,  Char Mirer Sarai,2024,745,1756,525,268,220,73.1,77.0,54.9,00000
59.0,56.0,76.0,682,03,01,  Paschim Noagaon,1253,998,626,533,627,465,55.7,54.0,57.4,00000
59.0,56.0,76.0,682,04,01,  Purba Noagaon,3078,2161,1603,1118,1475,1043,58.8,58.9,58.6,00000
59.0,56.0,76.0,777,01,01,  Panchasar,1460,462,733,208,727,254,76.0,77.9,74.1,00000
59.0,56.0,76.0,777,02,01,  Sardar Para,1202,380,593,162,609,218,76.0,78.5,73.6,00000
59.0,56.0,76.0,777,03,01,  Ramgaon,682,354,335,179,347,175,65.8,65.2,66.5,00000
59.0,56.0,76.0,777,04,01,  Maligaon,344,424,159,218,185,206,44.8,42.2,47.3,00000
59.0,56.0,76.0,777,05,01,  K.P.Bagh,329,210,162,98,167,112,61.0,62.3,59.9,00000
59.0,56.0,76.0,777,06,01,  Kashipur,437,225,220,101,217,124,66.0,68.5,63.6,00000
59.0,56.0,76.0,777,07,01,  Bibagh,1186,840,601,439,585,401,58.5,57.8,59.3,00000
59.0,56.0,76.0,777,08,01,  Banika Para,307,251,157,149,150,102,55.0,51.3,59.5,00000
59.0,56.0,76.0,777,09,01,  Talir Bil,470,332,249,215,221,117,58.6,53.7,65.4,00000
59.0,56.0,76.0,777,10,01,  Durgabari,592,381,308,195,284,186,60.8,61.2,60.4,00000
59.0,56.0,76.0,777,11,01,  Jor Pukurpar,795,504,416,244,379,260,61.2,63.0,59.3,00000
59.0,56.0,76.0,777,12,01,  Doshkani,882,582,442,276,440,306,60.2,61.6,59.0,00000
59.0,56.0,76.0,777,13,01,  Malir Patpar,1101,981,574,462,527,519,52.9,55.4,50.4,00000
59.0,56.0,76.0,777,14,01,  Kuti Para,229,228,131,111,98,117,50.1,54.1,45.6,00000
59.0,56.0,76.0,777,15,01,  Dingabhanga,1950,1460,1023,744,927,716,57.2,57.9,56.4,00000
59.0,56.0,76.0,777,16,01,  Muktarpur,1376,1190,768,594,608,596,53.6,56.4,50.5,00000
59.0,56.0,76.0,777,17,01,  Gosaibagh,1866,1386,996,704,870,682,57.4,58.6,56.1,00000
59.0,56.0,76.0,777,18,01,  Baghbari,482,420,231,220,251,200,53.4,51.2,55.7,00000
59.0,56.0,76.0,777,19,01,  Palpara,274,178,145,77,129,101,60.6,65.3,56.1,00000
59.0,56.0,76.0,777,20,01,  Goal Rayal Dighirpar,776,317,387,153,389,164,71.0,71.7,70.3,00000
59.0,56.0,76.0,786,01,03,  Paschim Moktarpur,3997,3039,2738,1604,1259,1435,56.8,63.1,46.7,00000
59.0,56.0,76.0,786,02,03,  Char Santaspur,1356,1126,782,600,574,526,54.6,56.6,52.2,00000
59.0,56.0,85.0,483,01,01,  Gobindapur,303,132,154,68,149,64,69.7,69.4,70.0,00000
59.0,56.0,85.0,483,02,01,  Chogharpar,553,352,282,190,271,162,61.1,59.7,62.6,00000
59.0,56.0,85.0,483,03,01,  Purba Dewsar,679,274,342,120,337,154,71.2,74.0,68.6,00000
59.0,56.0,85.0,521,01,01,  Jora Deul,1599,1006,788,506,811,500,61.4,60.9,61.9,00000
59.0,56.0,85.0,521,02,01,  Panhata,1606,1172,786,591,820,581,57.8,57.1,58.5,00000
59.0,56.0,85.0,540,01,01,  Kalinji Para,694,567,327,289,367,278,55.0,53.1,56.9,00000
59.0,56.0,85.0,540,02,01,  Palervorat,190,124,108,70,82,54,60.5,60.7,60.3,00000
59.0,56.0,85.0,559,01,01,  Uttar Kazi Kasba,1045,1021,529,518,516,503,50.6,50.5,50.6,00000
59.0,56.0,85.0,559,02,01,  Dakshin Kazi Kasba,733,576,404,291,329,285,56.0,58.1,53.6,00000
59.0,56.0,85.0,559,03,01,  Paschim Kazi Kasba,845,663,472,331,373,332,56.0,58.8,52.9,00000
59.0,56.0,85.0,559,04,01,  Sipai Para,905,299,446,157,459,142,75.2,74.0,76.4,00000
59.0,56.0,85.0,559,05,01,  Uttar Sipaipara,685,320,358,178,327,142,68.2,66.8,69.7,00000
59.0,56.0,85.0,568,01,01,  Khanka,1128,725,575,375,553,350,60.9,60.5,61.2,00000
59.0,56.0,85.0,568,02,01,  Dakshin Deosar,921,593,507,303,414,290,60.8,62.6,58.8,00000
59.0,56.0,85.0,568,03,01,  Paschim Deosar,186,91,143,64,43,27,67.1,69.1,61.4,00000
59.0,56.0,85.0,767,01,01,  Panam,1167,780,623,371,544,409,59.9,62.7,57.1,00000
59.0,56.0,85.0,767,02,01,  Milky Para,655,390,360,190,295,200,62.7,65.5,59.6,00000
59.0,56.0,85.0,843,01,03,  Rampal,890,755,454,359,436,396,54.1,55.8,52.4,00000
59.0,56.0,85.0,843,02,03,  Dhalagaon Bazar,577,524,301,257,276,267,52.4,53.9,50.8,00000
59.0,56.0,85.0,938,01,01,  Sukhabaspur,1565,771,763,367,802,404,67.0,67.5,66.5,00000
59.0,56.0,85.0,938,02,01,  Raghurampur,630,420,317,209,313,211,60.0,60.3,59.7,00000
59.0,74.0,11.0,040,01,01,  Mollahkandi Balur Char,1645,2778,931,1534,714,1244,37.2,37.8,36.5,00000
59.0,74.0,11.0,040,02,01,  Khas Mahal Balur Char,2711,5920,1359,3583,1352,2337,31.4,27.5,36.6,00000
59.0,74.0,11.0,040,03,01,  Khasnagar,795,1554,387,845,408,709,33.8,31.4,36.5,00000
59.0,74.0,11.0,040,04,01,  Akbarnagar,534,660,297,388,237,272,44.7,43.4,46.6,00000
59.0,74.0,11.0,040,05,01,  Rajnagar,707,730,350,351,357,379,49.2,49.9,48.5,00000
59.0,74.0,11.0,194,01,01,  Krishnanagar,469,176,230,74,239,102,72.7,75.7,70.1,00000
59.0,74.0,11.0,194,02,01,  Muradnagar,324,160,151,63,173,97,66.9,70.6,64.1,00000
59.0,74.0,11.0,194,03,01,  Purba Kalinagar,748,446,378,217,370,229,62.6,63.5,61.8,00000
59.0,74.0,11.0,194,04,01,  Paschim Kalinagar,743,738,375,367,368,371,50.2,50.5,49.8,00000
59.0,74.0,11.0,218,01,01,  Khaskandi Charergaon,477,487,230,240,247,247,49.5,48.9,50.0,00000
59.0,74.0,11.0,218,02,01,  Khaskandi Madhyer Char,1012,1589,549,791,463,798,38.9,41.0,36.7,00000
59.0,74.0,11.0,218,03,01,  Uttar Khaskandi,512,569,259,319,253,250,47.4,44.8,50.3,00000
59.0,74.0,13.0,080,01,01,  Basail,1660,1058,817,540,843,518,61.1,60.2,61.9,00000
59.0,74.0,13.0,080,02,01,  Dakatia Para,343,225,179,139,164,86,60.4,56.3,65.6,00000
59.0,74.0,20.0,396,01,01,  Gobardi,834,528,444,264,390,264,61.2,62.7,59.6,00000
59.0,74.0,20.0,396,02,01,  Royerbagh,533,120,287,47,246,73,81.6,85.9,77.1,00000
59.0,74.0,20.0,396,03,01,  Chiknisar,247,383,120,186,127,197,39.2,39.2,39.2,00000
59.0,74.0,20.0,606,01,01,  Kumarkhali,275,543,119,271,156,272,33.6,30.5,36.4,00000
59.0,74.0,20.0,606,02,01,  Bhuira,499,400,227,191,272,209,55.5,54.3,56.5,00000
59.0,74.0,27.0,275,01,01,  Chitrakot,534,304,254,118,280,186,63.7,68.3,60.1,00000
59.0,74.0,27.0,275,02,01,  Nagerhati,101,45,48,19,53,26,69.2,71.6,67.1,00000
59.0,74.0,27.0,275,03,01,  Ghoshnagar,60,29,24,13,36,16,67.4,64.9,69.2,00000
59.0,74.0,27.0,275,04,01,  Kamalpur,162,102,79,47,83,55,61.4,62.7,60.1,00000
59.0,74.0,27.0,275,05,01,  Kalipur,363,194,153,84,210,110,65.2,64.6,65.6,00000
59.0,74.0,27.0,275,06,01,  Kartikpur,468,235,238,96,230,139,66.6,71.3,62.3,00000
59.0,74.0,27.0,558,01,01,  Khalpar,604,300,287,124,317,176,66.8,69.8,64.3,00000
59.0,74.0,27.0,558,02,01,  Ghoshnagar,330,104,165,47,165,57,76.0,77.8,74.3,00000
59.0,74.0,27.0,566,01,01,  Nayagaon,544,233,280,94,264,139,70.0,74.9,65.5,00000
59.0,74.0,27.0,566,02,01,  Kharsul,780,177,412,76,368,101,81.5,84.4,78.5,00000
59.0,74.0,27.0,566,03,01,  Lalpur,375,211,175,92,200,119,64.0,65.5,62.7,00000
59.0,74.0,27.0,566,04,01,  Kharkhola,304,144,155,65,149,79,67.9,70.5,65.4,00000
59.0,74.0,33.0,622,01,01,  Uttar Kusumpur,1317,797,617,379,700,418,62.3,61.9,62.6,00000
59.0,74.0,33.0,622,02,01,  Dakshin Kusumpur,624,531,293,253,331,278,54.0,53.7,54.4,00000
59.0,74.0,33.0,833,01,01,  Paschim Rajdia,1105,546,542,272,563,274,66.9,66.6,67.3,00000
59.0,74.0,33.0,833,02,01,  Purba Rajdia,579,679,266,341,313,338,46.0,43.8,48.1,00000
59.0,74.0,33.0,833,03,01,  Tenguria Para,834,588,436,290,398,298,58.6,60.1,57.2,00000
59.0,74.0,33.0,922,01,01,  Paschim Sialdi,1235,864,705,446,530,418,58.8,61.3,55.9,00000
59.0,74.0,33.0,922,02,01,  Madhyam Sialdi,821,681,379,336,442,345,54.7,53.0,56.2,00000
59.0,74.0,33.0,922,03,01,  Purba Sialdi,591,472,272,241,319,231,55.6,53.0,58.0,00000
59.0,74.0,40.0,161,01,01,  Chamardi,972,877,487,435,485,442,52.6,52.8,52.3,00000
59.0,74.0,40.0,161,02,01,  Sujanagar,164,173,86,79,78,94,48.7,52.1,45.3,00000
59.0,74.0,47.0,074,01,01,  Barihaji,1345,557,614,262,731,295,70.7,70.1,71.2,00000
59.0,74.0,47.0,074,02,01,  Chalti Para,508,262,246,130,262,132,66.0,65.4,66.5,00000
59.0,74.0,47.0,469,01,01,  Kazisal,400,358,174,161,226,197,52.8,51.9,53.4,00000
59.0,74.0,47.0,469,02,01,  Kotgaon,1155,707,593,344,562,363,62.0,63.3,60.8,00000
59.0,74.0,47.0,469,03,01,  Lakshmi Bilas,1154,533,610,230,544,303,68.4,72.6,64.2,00000
59.0,74.0,47.0,550,01,01,  Akiakanda (Baliakanda,215,94,115,39,100,55,69.6,74.7,64.5,00000
59.0,74.0,47.0,550,02,01,  Kayain,486,106,228,37,258,69,82.1,86.0,78.9,00000
59.0,74.0,47.0,550,03,01,  Ramerkachra,138,280,70,139,68,141,33.0,33.5,32.5,00000
59.0,74.0,47.0,930,01,01,  Bara Sikarpur,981,802,469,374,512,428,55.0,55.6,54.5,00000
59.0,74.0,47.0,930,02,01,  Chhota Sikarpur,404,260,229,133,175,127,60.8,63.3,57.9,00000
59.0,74.0,47.0,930,03,01,  Kala Royer Char,309,133,153,48,156,85,69.9,76.1,64.7,00000
59.0,74.0,47.0,946,01,01,  Sulpur,754,351,355,160,399,191,68.2,68.9,67.6,00000
59.0,74.0,47.0,946,02,01,  Mohanganj,103,152,41,89,62,63,40.4,31.5,49.6,00000
59.0,74.0,47.0,946,03,01,  Kanchikata,53,23,26,14,27,9,69.7,65.0,75.0,00000
59.0,74.0,61.0,186,01,01,  Konspura,807,1088,421,499,386,589,42.6,45.8,39.6,00000
59.0,74.0,61.0,186,02,01,  Chandibardi,218,157,123,62,95,95,58.1,66.5,50.0,00000
59.0,74.0,61.0,186,03,01,  Kathsagara,159,129,85,63,74,66,55.2,57.4,52.9,00000
59.0,74.0,61.0,186,04,01,  Nayagaon,196,230,101,99,95,131,46.0,50.5,42.0,00000
59.0,74.0,61.0,186,05,01,  Natun Char,405,537,194,253,211,284,43.0,43.4,42.6,00000
59.0,74.0,61.0,186,06,01,  Puran Bhasan Char,363,417,164,217,199,200,46.5,43.0,49.9,00000
59.0,74.0,61.0,186,07,01,  Natun Bhasan Char,912,669,427,318,485,351,57.7,57.3,58.0,00000
59.0,74.0,61.0,186,08,01,  Malikanda,20,48,11,24,9,24,29.4,31.4,27.3,00000
59.0,74.0,61.0,630,01,01,  Latabdi,668,1154,333,528,335,626,36.7,38.7,34.9,00000
59.0,74.0,61.0,630,02,01,  Nimtala,577,1108,271,538,306,570,34.2,33.5,34.9,00000
59.0,74.0,74.0,331,01,01,  Fursail,1388,1246,688,645,700,601,52.7,51.6,53.8,00000
59.0,74.0,74.0,331,02,01,  Rathbari,211,206,112,92,99,114,50.6,54.9,46.5,00000
59.0,74.0,74.0,331,03,01,  Goragigara,1116,617,558,290,558,327,64.4,65.8,63.1,00000
59.0,74.0,81.0,647,01,01,  Madhupur,1436,878,772,475,664,403,62.1,61.9,62.2,00000
59.0,74.0,81.0,647,02,01,  Jahangirnagar,554,216,273,90,281,126,71.9,75.2,69.0,00000
59.0,74.0,81.0,647,03,01,  Gokulnagar,350,127,172,52,178,75,73.4,76.8,70.4,00000
59.0,74.0,81.0,873,01,01,  Saidpur,753,337,488,150,265,187,69.1,76.5,58.6,00000
59.0,74.0,81.0,873,02,01,  Mohammadpur,290,79,143,25,147,54,78.6,85.1,73.1,00000
59.0,74.0,88.0,283,01,01,  Char Mardan,633,419,313,191,320,228,60.2,62.1,58.4,00000
59.0,74.0,88.0,283,02,01,  Danir Para,1401,1027,732,511,669,516,57.7,58.9,56.5,00000
59.0,74.0,88.0,817,01,01,  Purba Abir Para,513,255,236,134,277,121,66.8,63.8,69.6,00000
59.0,74.0,88.0,817,02,01,  Mirnur Khilaon,290,281,153,147,137,134,50.8,51.0,50.6,00000
59.0,74.0,88.0,865,01,01,  Rasunia,1356,1221,639,645,717,576,52.6,49.8,55.5,00000
59.0,74.0,88.0,865,02,01,  Rangamulia,88,98,38,48,50,50,47.3,44.2,50.0,00000
59.0,74.0,88.0,865,03,01,  Khilla Para,640,622,310,318,330,304,50.7,49.4,52.1,00000
59.0,74.0,88.0,954,01,01,  Tajpur,2632,1744,1258,830,1374,914,60.1,60.2,60.1,00000
59.0,74.0,88.0,954,02,01,  Damalia,392,761,173,395,219,366,34.0,30.5,37.4,00000
59.0,74.0,94.0,056,01,01,  Baram,550,496,288,234,262,262,52.6,55.2,50.0,00000
59.0,74.0,94.0,056,02,01,  Araibaria,265,221,98,103,167,118,54.5,48.8,58.6,00000
59.0,74.0,94.0,056,03,01,  Baher Char,352,276,154,142,198,134,56.1,52.0,59.6,00000
59.0,74.0,94.0,800,01,01,  Pausar,2254,1010,1076,444,1178,566,69.1,70.8,67.5,00000
59.0,74.0,94.0,800,02,01,  Singerdak,702,228,338,143,364,85,75.5,70.3,81.1,00000
59.0,74.0,94.0,800,03,01,  Krishnanagar,27,57,16,39,11,18,32.1,29.1,37.9,00000
59.0,84.0,11.0,029,01,01,  Purba Atpara,852,569,410,287,442,282,60.0,58.8,61.0,00000
59.0,84.0,11.0,029,02,01,  Paschim Atpara,674,459,298,212,376,247,59.5,58.4,60.4,00000
59.0,84.0,13.0,039,01,01,  Baghra,2037,1376,1072,694,965,682,59.7,60.7,58.6,00000
59.0,84.0,13.0,039,02,01,  Purba Baghra,1027,981,501,520,526,461,51.1,49.1,53.3,00000
59.0,84.0,13.0,039,03,01,  Paschim Baghra,1170,905,651,470,519,435,56.4,58.1,54.4,00000
59.0,84.0,13.0,039,04,01,  Musalli Para,178,263,94,145,84,118,40.4,39.3,41.6,00000
59.0,84.0,13.0,039,05,01,  Mollahkandi,278,215,132,117,146,98,56.4,53.0,59.8,00000
59.0,84.0,13.0,039,06,01,  Nalter,222,337,87,168,135,169,39.7,34.1,44.4,00000
59.0,84.0,13.0,039,07,01,  Birbarkhola,511,337,269,179,242,158,60.3,60.0,60.5,00000
59.0,84.0,13.0,039,08,01,  Khairkhola,133,216,81,110,52,106,38.1,42.4,32.9,00000
59.0,84.0,13.0,039,09,01,  Rudra Para,964,1179,519,651,445,528,45.0,44.4,45.7,00000
59.0,84.0,13.0,039,10,01,  Jahanabad,851,707,425,343,426,364,54.6,55.3,53.9,00000
59.0,84.0,13.0,039,11,01,  Baicharpar,309,178,179,85,130,93,63.4,67.8,58.3,00000
59.0,84.0,13.0,039,12,01,  Kanthalbari,943,699,477,366,466,333,57.4,56.6,58.3,00000
59.0,84.0,13.0,039,13,01,  Purba Kanthalbari,209,197,85,102,124,95,51.5,45.5,56.6,00000
59.0,84.0,13.0,039,14,01,  Balur Chak,319,431,157,200,162,231,42.5,44.0,41.2,00000
59.0,84.0,13.0,039,15,01,  Madhya Baghra,1532,875,843,415,689,460,63.6,67.0,60.0,00000
59.0,84.0,13.0,565,01,01,  Magdal,162,103,87,51,75,52,61.1,63.0,59.1,00000
59.0,84.0,13.0,565,02,01,  Nayabari,107,57,63,28,44,29,65.2,69.2,60.3,00000
59.0,84.0,20.0,068,01,01,  Paschim Baraikhali,1672,1184,758,551,914,633,58.5,57.9,59.1,00000
59.0,84.0,20.0,068,02,01,  Purba Baraikhali,1907,1245,873,565,1034,680,60.5,60.7,60.3,00000
59.0,84.0,20.0,136,01,01,  Dakshin Madankhali,1234,700,524,338,710,362,63.8,60.8,66.2,00000
59.0,84.0,20.0,136,02,01,  Uttar Madankhali,608,354,259,157,349,197,63.2,62.3,63.9,00000
59.0,84.0,20.0,136,03,01,  Khahra,1626,1061,753,475,873,586,60.5,61.3,59.8,00000
59.0,84.0,27.0,448,01,01,  Uttar Kamargaon,2645,1998,1289,962,1356,1036,57.0,57.3,56.7,00000
59.0,84.0,27.0,448,02,01,  Dakshin Kamargaon,1578,1554,770,783,808,771,50.4,49.6,51.2,00000
59.0,84.0,27.0,448,03,01,  Madhya Kamargaon,2080,2288,1042,1116,1038,1172,47.6,48.3,47.0,00000
59.0,84.0,33.0,146,01,01,  Birtara,880,759,437,353,443,406,53.7,55.3,52.2,00000
59.0,84.0,33.0,146,02,01,  Mashakhola,419,385,199,184,220,201,52.1,52.0,52.3,00000
59.0,84.0,47.0,234,01,01,  Dakshin Paiksa (Paschim),914,514,426,226,488,288,64.0,65.3,62.9,00000
59.0,84.0,47.0,234,02,01,  Dakshin Paiksa (Purba),453,272,192,133,261,139,62.5,59.1,65.3,00000
59.0,84.0,47.0,526,01,01,  Uttar Kola Para,1141,620,623,308,518,312,64.8,66.9,62.4,00000
59.0,84.0,47.0,526,02,01,  Kola Para,1204,493,702,209,502,284,70.9,77.1,63.9,00000
59.0,84.0,47.0,526,03,01,  Noapara,523,248,234,103,289,145,67.8,69.4,66.6,00000
59.0,84.0,47.0,526,04,01,  Dakshin Kola Para,362,300,172,163,190,137,54.7,51.3,58.1,00000
59.0,84.0,47.0,819,01,01,  Samaspur,511,211,257,95,254,116,70.8,73.0,68.6,00000
59.0,84.0,47.0,819,02,01,  Brahman Paiksha,711,131,350,54,361,77,84.4,86.6,82.4,00000
59.0,84.0,54.0,117,01,01,  Bibandi,875,563,378,246,497,317,60.8,60.6,61.1,00000
59.0,84.0,54.0,117,02,01,  Moslem Para,72,97,31,51,41,46,42.6,37.8,47.1,00000
59.0,84.0,54.0,117,03,01,  Baghbari,388,305,170,160,218,145,56.0,51.5,60.1,00000
59.0,84.0,54.0,117,04,01,  Jholdi,184,67,97,25,87,42,73.3,79.5,67.4,00000
59.0,84.0,54.0,117,05,01,  Tonia Mandra,213,93,110,44,103,49,69.6,71.4,67.8,00000
59.0,84.0,54.0,331,01,01,  Haria,343,117,141,53,202,64,74.6,72.7,75.9,00000
59.0,84.0,54.0,331,02,01,  Paschim Munshia,318,297,135,127,183,170,51.7,51.5,51.8,00000
59.0,84.0,54.0,399,01,01,  Jhapatia,422,515,204,244,218,271,45.0,45.5,44.6,00000
59.0,84.0,54.0,399,02,01,  Bangaon,237,159,102,73,135,86,59.8,58.3,61.1,00000
59.0,84.0,54.0,536,01,01,  Kukutia,661,278,326,132,335,146,70.4,71.2,69.6,00000
59.0,84.0,54.0,536,02,01,  Uttarpara,357,138,153,60,204,78,72.1,71.8,72.3,00000
59.0,84.0,54.0,780,01,01,  Khodaibari,204,86,105,34,99,52,70.3,75.5,65.6,00000
59.0,84.0,54.0,780,02,01,  Rana,191,256,90,125,101,131,42.7,41.9,43.5,00000
59.0,84.0,61.0,078,01,01,  Basailbhog,460,306,236,190,224,116,60.1,55.4,65.9,00000
59.0,84.0,61.0,078,02,01,  Hoglagada,516,274,255,137,261,137,65.3,65.1,65.6,00000
59.0,84.0,61.0,546,01,01,  Kusuri Para,528,293,265,144,263,149,64.3,64.8,63.8,00000
59.0,84.0,61.0,546,02,01,  Musuri Para,162,117,81,53,81,64,58.1,60.4,55.9,00000
59.0,84.0,67.0,370,01,01,  Hatar Para,685,205,317,97,368,108,77.0,76.6,77.3,00000
59.0,84.0,67.0,370,02,01,  Kabutarkhola,1332,571,620,295,712,276,70.0,67.8,72.1,00000
59.0,84.0,67.0,790,01,01,  Uttar Rarikhal,1478,663,759,363,719,300,69.0,67.6,70.6,00000
59.0,84.0,67.0,790,02,01,  Balasur,4022,4273,1943,2034,2079,2239,48.5,48.9,48.1,00000
59.0,84.0,67.0,790,03,01,  Dakshin Rarikhal,675,265,351,125,324,140,71.8,73.7,69.8,00000
59.0,84.0,67.0,790,04,01,  Mani Mandal,292,65,144,28,148,37,81.8,83.7,80.0,00000
59.0,84.0,74.0,702,01,03,  Deulbhog,2367,1465,1176,808,1191,657,61.8,59.3,64.4,00000
59.0,84.0,74.0,702,02,03,  Kharakandi,605,369,286,201,319,168,62.1,58.7,65.5,00000
59.0,84.0,74.0,916,01,03,  Gajalhati,646,862,384,534,262,328,42.8,41.8,44.4,00000
59.0,84.0,74.0,916,02,03,  Mathura Para,2195,1432,1217,825,978,607,60.5,59.6,61.7,00000
59.0,84.0,74.0,916,03,03,  Babur Dighirpar,1854,955,930,486,924,469,66.0,65.7,66.3,00000
59.0,84.0,81.0,507,01,01,  Keutkhali,1476,1533,687,748,789,785,49.1,47.9,50.1,00000
59.0,84.0,81.0,507,02,01,  Putimara,127,160,49,75,78,85,44.3,39.5,47.9,00000
59.0,84.0,81.0,848,01,01,  Sholaghar,3782,2586,1875,1237,1907,1349,59.4,60.3,58.6,00000
59.0,84.0,81.0,848,02,01,  Shamshabad,753,650,364,310,389,340,53.7,54.0,53.4,00000
59.0,84.0,81.0,848,03,01,  Pakira Para,576,612,256,274,320,338,48.5,48.3,48.6,00000
59.0,84.0,81.0,848,04,01,  Khaiagaon,963,1057,479,484,484,573,47.7,49.7,45.8,00000
59.0,84.0,81.0,848,05,01,  Bhuichitra,581,180,281,74,300,106,76.3,79.2,73.9,00000
59.0,84.0,81.0,848,06,01,  Chanbari,293,159,135,76,158,83,64.8,64.0,65.6,00000
59.0,84.0,94.0,692,01,01,  Paragaon,963,681,414,333,549,348,58.6,55.4,61.2,00000
59.0,84.0,94.0,692,02,01,  Sufiganj,124,199,53,97,71,102,38.4,35.3,41.0,00000
59.0,84.0,94.0,936,01,01,  Tantar,494,318,230,152,264,166,60.8,60.2,61.4,00000
59.0,84.0,94.0,936,02,01,  Balita(Balitia),185,116,86,51,99,65,61.5,62.8,60.4,00000
59.0,84.0,94.0,994,01,01,  Uttargaon,618,304,325,176,293,128,67.0,64.9,69.6,00000
59.0,84.0,94.0,994,02,01,  Purarbagh,218,169,112,88,106,81,56.3,56.0,56.7,00000
59.0,94.0,11.0,748,01,01,  Dakshin Paik Para,1370,1020,665,520,705,500,57.3,56.1,58.5,00000
59.0,94.0,11.0,748,02,01,  Uttar Paik Para,2645,1956,1298,997,1347,959,57.5,56.6,58.4,00000
59.0,94.0,15.0,029,01,01,  Aparkati,432,264,199,114,233,150,62.1,63.6,60.8,00000
59.0,94.0,15.0,029,02,01,  Dampara,428,358,169,169,259,189,54.5,50.0,57.8,00000
59.0,94.0,15.0,029,03,01,  Shalikar Para,142,31,64,16,78,15,82.1,80.0,83.9,00000
59.0,94.0,15.0,037,01,01,  Arial,897,640,420,320,477,320,58.4,56.8,59.8,00000
59.0,94.0,15.0,037,02,01,  Nagerpar,209,258,93,104,116,154,44.8,47.2,43.0,00000
59.0,94.0,15.0,037,03,01,  Dahir Para,18,30,6,15,12,15,37.5,28.6,44.4,00000
59.0,94.0,15.0,037,04,01,  Algakandi,326,71,293,58,33,13,82.1,83.5,71.7,00000
59.0,94.0,15.0,037,05,01,  Dighirpar,248,111,136,36,112,75,69.1,79.1,59.9,00000
59.0,94.0,15.0,037,06,01,  Thakurpar,57,36,27,16,30,20,61.3,62.8,60.0,00000
59.0,94.0,15.0,037,07,01,  Shanbari,573,272,262,122,311,150,67.8,68.2,67.5,00000
59.0,94.0,15.0,037,08,01,  Bilerpar,247,236,125,113,122,123,51.1,52.5,49.8,00000
59.0,94.0,15.0,037,09,01,  Bhadra Para,271,237,131,121,140,116,53.3,52.0,54.7,00000
59.0,94.0,15.0,037,10,01,  Basulla,416,634,197,274,219,360,39.6,41.8,37.8,00000
59.0,94.0,15.0,037,11,01,  Nitira,765,379,386,189,379,190,66.9,67.1,66.6,00000
59.0,94.0,15.0,486,01,01,  Hat Baligaon,1764,2389,1009,1347,755,1042,42.5,42.8,42.0,00000
59.0,94.0,15.0,486,02,01,  Bangaon,100,46,51,18,49,28,68.5,73.9,63.6,00000
59.0,94.0,15.0,486,03,01,  Islampur,972,940,483,462,489,478,50.8,51.1,50.6,00000
59.0,94.0,15.0,486,04,01,  Nayagaon,592,486,281,244,311,242,54.9,53.5,56.2,00000
59.0,94.0,15.0,598,01,01,  Khurda Chashi,78,81,27,38,51,43,49.1,41.5,54.3,00000
59.0,94.0,15.0,598,02,01,  Hadrabaj,56,55,22,22,34,33,50.5,50.0,50.7,00000
59.0,94.0,15.0,733,01,01,  Nurpur,398,338,172,163,226,175,54.1,51.3,56.4,00000
59.0,94.0,15.0,733,02,01,  Gopin Pur,285,111,127,42,158,69,72.0,75.1,69.6,00000
59.0,94.0,15.0,965,01,01,  Tailkai,545,504,259,236,286,268,52.0,52.3,51.6,00000
59.0,94.0,15.0,965,02,01,  Baligaon,62,33,33,19,29,14,65.3,63.5,67.4,00000
59.0,94.0,23.0,059,01,01,  Autshahi,1860,1428,918,663,942,765,56.6,58.1,55.2,00000
59.0,94.0,23.0,059,02,01,  Mamardul,196,217,82,95,114,122,47.5,46.3,48.3,00000
59.0,94.0,23.0,261,01,01,  Chashiri,770,723,370,341,400,382,51.6,52.0,51.2,00000
59.0,94.0,23.0,261,02,01,  Mirzanagar,575,247,270,110,305,137,70.0,71.1,69.0,00000
59.0,94.0,23.0,538,01,01,  Chaia Para,180,71,91,34,89,37,71.7,72.8,70.6,00000
59.0,94.0,23.0,538,02,01,  Dhanjugal,70,26,41,10,29,16,72.9,80.4,64.4,00000
59.0,94.0,23.0,538,03,01,  Kaichail,997,480,491,231,506,249,67.5,68.0,67.0,00000
59.0,94.0,23.0,538,04,01,  Jaharpura,258,80,139,36,119,44,76.3,79.4,73.0,00000
59.0,94.0,31.0,561,01,01,  Kanda Para,660,519,315,248,345,271,56.0,56.0,56.0,00000
59.0,94.0,31.0,561,02,01,  Changari,848,632,406,307,442,325,57.3,56.9,57.6,00000
59.0,94.0,39.0,374,01,01,  Dhipur,1137,1140,534,596,603,544,49.9,47.3,52.6,00000
59.0,94.0,39.0,374,02,01,  Rauthbhog,876,931,393,452,483,479,48.5,46.5,50.2,00000
59.0,94.0,39.0,374,03,01,  Barai Para,331,303,148,167,183,136,52.2,47.0,57.4,00000
59.0,94.0,39.0,411,01,01,  Duliata,1008,558,417,265,591,293,64.4,61.1,66.9,00000
59.0,94.0,39.0,411,02,01,  Mutukpur,952,438,485,223,467,215,68.5,68.5,68.5,00000
59.0,94.0,39.0,643,01,01,  Mariail,837,924,434,486,403,438,47.5,47.2,47.9,00000
59.0,94.0,39.0,643,02,01,  Belua,232,174,108,97,124,77,57.1,52.7,61.7,00000
59.0,94.0,39.0,703,01,03,  Nayananda,931,591,497,308,434,283,61.2,61.7,60.5,00000
59.0,94.0,39.0,703,02,03,  Rangmaher,672,220,339,87,333,133,75.3,79.6,71.5,00000
59.0,94.0,39.0,703,03,03,  Nagarkandi,638,344,312,161,326,183,65.0,66.0,64.0,00000
59.0,94.0,39.0,703,04,03,  Karmaka Hawla,313,142,165,73,148,69,68.8,69.3,68.2,00000
59.0,94.0,47.0,658,01,01,  Uttar Mulchar,1569,1085,762,491,807,594,59.1,60.8,57.6,00000
59.0,94.0,47.0,658,02,01,  Dakshin Mularchar,384,818,173,406,211,412,31.9,29.9,33.9,00000
59.0,94.0,47.0,658,03,01,  Kandarbari,268,327,141,152,127,175,45.0,48.1,42.1,00000
59.0,94.0,55.0,104,01,01,  Banari,61,377,30,186,31,191,13.9,13.9,14.0,00000
59.0,94.0,55.0,104,02,01,  Nagar Jowar,44,111,22,70,22,41,28.4,23.9,34.9,00000
59.0,94.0,63.0,067,01,01,  Baghia,698,460,383,307,315,153,60.3,55.5,67.3,00000
59.0,94.0,63.0,067,02,01,  Laskar Dighirpar,122,107,70,50,52,57,53.3,58.3,47.7,00000
59.0,94.0,63.0,493,01,01,  Hatkhan,811,741,414,384,397,357,52.3,51.9,52.7,00000
59.0,94.0,63.0,493,02,01,  Baihal,679,413,353,256,326,157,62.2,58.0,67.5,00000
59.0,94.0,63.0,493,03,01,  Tunisar,124,66,56,33,68,33,65.3,62.9,67.3,00000
59.0,94.0,63.0,516,01,01,  Chap,688,507,314,248,374,259,57.6,55.9,59.1,00000
59.0,94.0,63.0,516,02,01,  Akusar,243,196,122,91,121,105,55.4,57.3,53.5,00000
59.0,94.0,63.0,516,03,01,  Mail Para,86,50,44,22,42,28,63.2,66.7,60.0,00000
59.0,94.0,63.0,516,04,01,  Jashalong,750,850,337,417,413,433,46.9,44.7,48.8,00000
59.0,94.0,63.0,516,05,01,  Naya Dighirpara,333,226,177,125,156,101,59.6,58.6,60.7,00000
59.0,94.0,63.0,822,01,01,  Uttarpura,913,765,443,375,470,390,54.4,54.2,54.7,00000
59.0,94.0,63.0,822,02,01,  Dakshinpura,664,684,360,329,304,355,49.3,52.2,46.1,00000
59.0,94.0,63.0,905,01,01,  Uttar Serajabad,975,750,545,388,430,362,56.5,58.4,54.3,00000
59.0,94.0,63.0,905,02,01,  Dakshin Serajabad,619,462,310,219,309,243,57.3,58.6,56.0,00000
59.0,94.0,63.0,905,03,01,  Nayakandi,110,238,39,120,71,118,31.6,24.5,37.6,00000
59.0,94.0,63.0,905,04,01,  Darjarpar,148,170,67,83,81,87,46.5,44.7,48.2,00000
59.0,94.0,71.0,082,01,01,  Bainkhara,385,373,187,208,198,165,50.8,47.3,54.5,00000
59.0,94.0,71.0,082,02,01,  Bhangania,621,310,322,135,299,175,66.7,70.5,63.1,00000
59.0,94.0,71.0,082,03,01,  Chousar,289,276,134,123,155,153,51.2,52.1,50.3,00000
59.0,94.0,71.0,082,04,01,  Maligaon,165,306,83,139,82,167,35.0,37.4,32.9,00000
59.0,94.0,71.0,164,01,01,  Bhat Para,56,78,25,40,31,38,41.8,38.5,44.9,00000
59.0,94.0,71.0,164,02,01,  Baghbari,469,361,212,175,257,186,56.5,54.8,58.0,00000
59.0,94.0,71.0,620,01,01,  Maldha,851,944,395,500,456,444,47.4,44.1,50.7,00000
59.0,94.0,71.0,620,02,01,  Adabari,306,311,135,157,171,154,49.6,46.2,52.6,00000
59.0,94.0,71.0,785,01,01,  Paysagaon,373,230,175,96,198,134,61.9,64.6,59.6,00000
59.0,94.0,71.0,785,02,01,  Dhopar Pasha,517,613,219,288,298,325,45.8,43.2,47.8,00000
59.0,94.0,79.0,381,01,01,  Dhamaran,1450,1033,704,627,746,406,58.4,52.9,64.8,00000
59.0,94.0,79.0,381,02,01,  Bionia,364,176,183,82,181,94,67.4,69.1,65.8,00000
59.0,94.0,79.0,568,01,01,  Kathadia,1598,1606,795,807,803,799,49.9,49.6,50.1,00000
59.0,94.0,79.0,568,02,01,  Lakharan,577,326,290,158,287,168,63.9,64.7,63.1,00000
59.0,94.0,87.0,269,01,01,  Chatati Para,426,295,204,145,222,150,59.1,58.5,59.7,00000
59.0,94.0,87.0,269,02,01,  Jinaisar,34,57,13,24,21,33,37.4,35.1,38.9,00000
35.0,32.0,11.0,219,01,01,  Borasi,1575,737,837,335,738,402,68.1,71.4,64.7,00000
35.0,32.0,11.0,219,02,01,  Banshbari,322,254,150,126,172,128,55.9,54.3,57.3,00000
35.0,32.0,11.0,219,03,01,  Ghoshgathi,729,810,382,402,347,408,47.4,48.7,46.0,00000
35.0,32.0,11.0,219,04,01,  Bhennabari,1735,942,817,469,918,473,64.8,63.5,66.0,00000
35.0,32.0,11.0,219,05,01,  Puran Pathalia,352,345,164,179,188,166,50.5,47.8,53.1,00000
35.0,32.0,13.0,477,01,01,  Kalpur,1006,611,487,284,519,327,62.2,63.2,61.3,00000
35.0,32.0,13.0,477,02,01,  Telibhita,297,171,148,77,149,94,63.5,65.8,61.3,00000
35.0,32.0,17.0,344,01,01,  Durgapur,991,651,481,325,510,326,60.4,59.7,61.0,00000
35.0,32.0,17.0,344,02,01,  Nilakhi,477,473,253,216,224,257,50.2,53.9,46.6,00000
35.0,32.0,21.0,407,01,01,  Uttar Gobra,846,429,409,212,437,217,66.4,65.9,66.8,00000
35.0,32.0,21.0,407,02,01,  Gobra,1110,504,592,251,518,253,68.8,70.2,67.2,00000
35.0,32.0,21.0,407,03,01,  Malo Para,248,122,114,55,134,67,67.0,67.5,66.7,00000
35.0,32.0,21.0,407,04,01,  Dakshin Gobra,467,277,232,130,235,147,62.8,64.1,61.5,00000
35.0,32.0,21.0,407,05,01,  Chapil,241,161,113,78,128,83,60.0,59.2,60.7,00000
35.0,32.0,21.0,407,06,01,  Bhatia Para,245,96,130,41,115,55,71.8,76.0,67.6,00000
35.0,32.0,34.0,015,01,01,  Arpara,1099,743,571,341,528,402,59.7,62.6,56.8,00000
35.0,32.0,34.0,015,02,01,  Bherarhat,219,161,108,82,111,79,57.6,56.8,58.4,00000
35.0,32.0,34.0,031,01,01,  Bade Khagail,1173,545,629,248,544,297,68.3,71.7,64.7,00000
35.0,32.0,34.0,031,02,01,  Laskhmipur,174,248,101,122,73,126,41.2,45.3,36.7,00000
35.0,32.0,34.0,423,01,01,  Paschim Haridaspur,954,552,514,262,440,290,63.3,66.2,60.3,00000
35.0,32.0,34.0,423,02,01,  Purba Haridaspur,1149,477,595,242,554,235,70.7,71.1,70.2,00000
35.0,32.0,38.0,094,01,01,  Barapa,590,443,296,187,294,256,57.1,61.3,53.5,00000
35.0,32.0,38.0,094,02,01,  Char Barapa,374,369,167,185,207,184,50.3,47.4,52.9,00000
35.0,32.0,38.0,955,01,01,  Durgapur,666,391,328,199,338,192,63.0,62.2,63.8,00000
35.0,32.0,38.0,955,02,01,  Tentulia,487,206,240,86,247,120,70.3,73.6,67.3,00000
35.0,32.0,51.0,806,01,01,  Roypasha,492,403,248,201,244,202,55.0,55.2,54.7,00000
35.0,32.0,51.0,806,02,01,  Lakshmipur,41,100,21,43,20,57,29.1,32.8,26.0,00000
35.0,32.0,56.0,391,01,01,  Ghoser Char,5443,2582,2907,1293,2536,1289,67.8,69.2,66.3,00000
35.0,32.0,56.0,391,02,01,  Char Manikdaha,2667,1276,1434,564,1233,712,67.6,71.8,63.4,00000
35.0,32.0,60.0,282,01,01,  Gopinathpur,1043,699,496,335,547,364,59.9,59.7,60.0,00000
35.0,32.0,60.0,282,02,01,  Naldanga,103,220,52,117,51,103,31.9,30.8,33.1,00000
35.0,32.0,60.0,297,01,01,  Dalina,1003,871,530,389,473,482,53.5,57.7,49.5,00000
35.0,32.0,60.0,297,02,01,  Bagajuri,285,147,160,72,125,75,66.0,69.0,62.5,00000
35.0,32.0,60.0,297,03,01,  Kandargati,217,205,112,104,105,101,51.4,51.9,51.0,00000
35.0,32.0,60.0,297,04,01,  Dalina Guchagram,23,86,10,42,13,44,21.1,19.2,22.8,00000
35.0,32.0,64.0,689,01,01,  Paschim Nizra,1397,802,691,379,706,423,63.5,64.6,62.5,00000
35.0,32.0,64.0,689,02,01,  Botbari,232,192,106,107,126,85,54.7,49.8,59.7,00000
35.0,32.0,64.0,689,03,01,  Narikelbari,371,319,178,131,193,188,53.8,57.6,50.7,00000
35.0,32.0,64.0,689,04,01,  Dakshin Nizra,747,578,351,239,396,339,56.4,59.5,53.9,00000
35.0,32.0,64.0,689,05,01,  Duyani Para,253,44,116,22,137,22,85.2,84.1,86.2,00000
35.0,32.0,69.0,728,01,01,  Paitkelbaria,246,141,124,70,122,71,63.6,63.9,63.2,00000
35.0,32.0,69.0,728,02,01,  Pukuria,760,485,373,222,387,263,61.0,62.7,59.5,00000
35.0,32.0,69.0,728,03,01,  Char Pukuria,717,770,375,397,342,373,48.2,48.6,47.8,00000
35.0,32.0,69.0,877,01,01,  Sonasur,170,159,79,78,91,81,51.7,50.3,52.9,00000
35.0,32.0,69.0,877,02,01,  Ghoshgati,148,140,79,59,69,81,51.4,57.2,46.0,00000
35.0,32.0,73.0,321,01,01,  Digherkul,885,493,472,232,413,261,64.2,67.0,61.3,00000
35.0,32.0,73.0,321,02,01,  Raghunathpur,1211,652,658,287,553,365,65.0,69.6,60.2,00000
35.0,32.0,73.0,321,03,01,  Andarkota,31,31,18,11,13,20,50.0,62.1,39.4,00000
35.0,32.0,73.0,814,01,01,  Raghunathpur,2378,1218,1296,554,1082,664,66.1,70.1,62.0,00000
35.0,32.0,73.0,814,02,01,  Andarkota,45,58,24,24,21,34,43.7,50.0,38.2,00000
35.0,32.0,73.0,861,01,01,  Silna,989,808,527,391,462,417,55.0,57.4,52.6,00000
35.0,32.0,73.0,861,02,01,  Singarkul,660,1162,321,575,339,587,36.2,35.8,36.6,00000
35.0,32.0,77.0,078,01,01,  Domrasur,1300,495,688,202,612,293,72.4,77.3,67.6,00000
35.0,32.0,77.0,078,02,01,  Puyesur,318,125,169,58,149,67,71.8,74.4,69.0,00000
35.0,32.0,77.0,078,03,01,  Degirpar,315,89,165,37,150,52,78.0,81.7,74.3,00000
35.0,32.0,77.0,078,04,01,  Bairagitala,217,10,99,5,118,5,95.6,95.2,95.9,00000
35.0,32.0,77.0,979,01,01,  Tutamandra,1087,749,579,353,508,396,59.2,62.1,56.2,00000
35.0,32.0,77.0,979,02,01,  Ghoshalkandi,417,526,217,245,200,281,44.2,47.0,41.6,00000
35.0,32.0,77.0,979,03,01,  Baroikandi,143,247,79,109,64,138,36.7,42.0,31.7,00000
35.0,32.0,77.0,979,04,01,  Patkelbari,1431,702,791,289,640,413,67.1,73.2,60.8,00000
35.0,32.0,77.0,979,05,01,  Maskandi,224,209,116,93,108,116,51.7,55.5,48.2,00000
35.0,32.0,82.0,101,01,01,  Paschimpara,851,438,451,174,400,264,66.0,72.2,60.2,00000
35.0,32.0,82.0,101,02,01,  Dakshinpara,876,368,469,160,407,208,70.4,74.6,66.2,00000
35.0,32.0,82.0,101,03,01,  Madhyapara,783,345,410,138,373,207,69.4,74.8,64.3,00000
35.0,32.0,82.0,101,04,01,  Uttarpara,871,398,476,170,395,228,68.6,73.7,63.4,00000
35.0,32.0,82.0,101,05,01,  Satpar Bazar,330,103,188,50,142,53,76.2,79.0,72.8,00000
35.0,32.0,82.0,101,06,01,  Kalibhita,508,316,293,134,215,182,61.7,68.6,54.2,00000
35.0,32.0,82.0,101,07,01,  Guchchhagram,132,184,78,73,54,111,41.8,51.7,32.7,00000
35.0,32.0,82.0,101,08,01,  Teli Bhita,189,70,100,28,89,42,73.0,78.1,67.9,00000
35.0,32.0,82.0,148,01,01,  Betbhita,592,254,329,95,263,159,70.0,77.6,62.3,00000
35.0,32.0,82.0,148,02,01,  Satpar Goldar Para,159,247,85,115,74,132,39.2,42.5,35.9,00000
35.0,32.0,82.0,148,03,01,  Satpar,733,154,395,49,338,105,82.6,89.0,76.3,00000
35.0,32.0,82.0,168,01,01,  Bhennabari,1585,1080,864,452,721,628,59.5,65.7,53.4,00000
35.0,32.0,82.0,168,02,01,  Chamta,575,712,295,330,280,382,44.7,47.2,42.3,00000
35.0,32.0,82.0,818,01,01,  Sanpukuria,813,549,449,247,364,302,59.7,64.5,54.7,00000
35.0,32.0,82.0,818,02,01,  Baraibhita,280,166,147,76,133,90,62.8,65.9,59.6,00000
35.0,32.0,82.0,818,03,01,  Barakhola,232,201,142,75,90,126,53.6,65.4,41.7,00000
35.0,32.0,82.0,818,04,01,  Chak Kurulia,111,86,66,35,45,51,56.3,65.3,46.9,00000
35.0,32.0,82.0,818,05,01,  Radhanagar,143,167,69,78,74,89,46.1,46.9,45.4,00000
35.0,32.0,82.0,818,06,01,  Asrawanprokalpa (Guchcha Gram),11,74,4,31,7,43,12.9,11.4,14.0,00000
35.0,32.0,86.0,712,01,01,  Paikerdanga,389,478,216,222,173,256,44.9,49.3,40.3,00000
35.0,32.0,86.0,712,02,01,  Suchidanga,245,191,130,86,115,105,56.2,60.2,52.3,00000
35.0,32.0,86.0,712,03,01,  Kuthibari,372,316,190,139,182,177,54.1,57.8,50.7,00000
35.0,32.0,86.0,885,01,01,  Dakshin Suktail,1252,1313,594,582,658,731,48.8,50.5,47.4,00000
35.0,32.0,86.0,885,02,01,  Uttar Suktail,460,699,247,295,213,404,39.7,45.6,34.5,00000
35.0,32.0,86.0,885,03,01,  Char Suktail,351,279,174,122,177,157,55.7,58.8,53.0,00000
35.0,32.0,86.0,885,04,01,  Banbari,186,180,91,82,95,98,50.8,52.6,49.2,00000
35.0,32.0,86.0,916,01,01,  Tala,207,107,100,42,107,65,65.9,70.4,62.2,00000
35.0,32.0,86.0,916,02,01,  Chartala,286,764,151,428,135,336,27.2,26.1,28.7,00000
35.0,32.0,86.0,916,03,01,  Jagar Char,228,228,124,111,104,117,50.0,52.8,47.1,00000
35.0,32.0,86.0,916,04,01,  Moynar Para,62,91,26,43,36,48,40.5,37.7,42.9,00000
35.0,32.0,90.0,705,01,01,  Nizra Parkul,115,60,56,26,59,34,65.7,68.3,63.4,00000
35.0,32.0,90.0,705,02,01,  Nizra Duiani Para,99,45,50,20,49,25,68.8,71.4,66.2,00000
35.0,32.0,90.0,705,03,01,  Nizra Sekhi Para,689,375,355,165,334,210,64.8,68.3,61.4,00000
35.0,32.0,90.0,705,04,01,  Padmabila,617,714,325,336,292,378,46.4,49.2,43.6,00000
35.0,32.0,90.0,705,05,01,  Andharkota,287,217,144,103,143,114,56.9,58.3,55.6,00000
35.0,32.0,90.0,705,06,01,  Nizra Swani Para,634,718,351,365,283,353,46.9,49.0,44.5,00000
35.0,32.0,90.0,963,01,01,  Dakshinpara,661,1089,334,559,327,530,37.8,37.4,38.2,00000
35.0,32.0,90.0,963,03,01,  Malenga,780,424,384,207,396,217,64.8,65.0,64.6,00000
35.0,32.0,94.0,336,01,01,  Dumdia,1160,528,573,221,587,307,68.7,72.2,65.7,00000
35.0,32.0,94.0,336,02,01,  Barail,252,239,132,105,120,134,51.3,55.7,47.2,00000
35.0,32.0,94.0,626,01,01,  Manikhar,803,541,451,239,352,302,59.7,65.4,53.8,00000
35.0,32.0,94.0,626,02,01,  Gopalpur,609,277,305,126,304,151,68.7,70.8,66.8,00000
35.0,32.0,94.0,626,03,01,  Madhupur,473,873,249,411,224,462,35.1,37.7,32.7,00000
35.0,32.0,94.0,626,04,01,  Char Saraspur,120,326,66,162,54,164,26.9,28.9,24.8,00000
35.0,43.0,11.0,468,01,01,  Jotkura,1076,515,563,231,513,284,67.6,70.9,64.4,00000
35.0,43.0,11.0,468,02,01,  Ghona Para,246,91,125,34,121,57,73.0,78.6,68.0,00000
35.0,43.0,33.0,455,01,01,  Purba Jikabari,388,467,215,217,173,250,45.4,49.8,40.9,00000
35.0,43.0,33.0,455,02,01,  Paschim Jikabari,568,217,312,103,256,114,72.4,75.2,69.2,00000
35.0,43.0,33.0,455,03,01,  Gazaria,131,78,71,34,60,44,62.7,67.6,57.7,00000
35.0,43.0,40.0,243,01,01,  Dahar Durgapur,319,451,151,212,168,239,41.4,41.6,41.3,00000
35.0,43.0,40.0,243,02,01,  Saheberchar,437,173,212,86,225,87,71.6,71.1,72.1,00000
35.0,43.0,40.0,256,01,01,  Dari Padmabila,185,248,100,111,85,137,42.7,47.4,38.3,00000
35.0,43.0,40.0,256,02,01,  Charpadmavilla,810,584,395,246,415,338,58.1,61.6,55.1,00000
35.0,43.0,47.0,680,01,01,  Nijamkandi,645,472,338,222,307,250,57.7,60.4,55.1,00000
35.0,43.0,47.0,680,02,01,  Taltala,653,350,337,171,316,179,65.1,66.3,63.8,00000
35.0,43.0,54.0,032,01,01,  Aruakandi,569,207,282,98,287,109,73.3,74.2,72.5,00000
35.0,43.0,54.0,032,02,01,  Purba Aruakandi,316,182,144,94,172,88,63.5,60.5,66.2,00000
35.0,43.0,54.0,539,01,01,  Khagrabaria,1303,436,602,198,701,238,74.9,75.3,74.7,00000
35.0,43.0,54.0,539,02,01,  Chhota Khagrabaria,126,62,64,31,62,31,67.0,67.4,66.7,00000
35.0,43.0,54.0,988,01,01,  Tilchhara,1657,948,792,413,865,535,63.6,65.7,61.8,00000
35.0,43.0,54.0,988,02,01,  Gopalpur,538,228,272,98,266,130,70.2,73.5,67.2,00000
35.0,43.0,74.0,083,01,01,  Bahirbhag,454,171,213,82,241,89,72.6,72.2,73.0,00000
35.0,43.0,74.0,083,02,01,  Dhopa Para,228,133,101,61,127,72,63.2,62.3,63.8,00000
35.0,43.0,74.0,083,03,01,  Borihat,287,161,133,87,154,74,64.1,60.5,67.5,00000
35.0,43.0,74.0,083,04,01,  Dohisara,439,215,225,107,214,108,67.1,67.8,66.5,00000
35.0,43.0,88.0,134,01,01,  Bhattai Dhoba,1502,1260,753,610,749,650,54.4,55.2,53.5,00000
35.0,43.0,88.0,134,02,01,  Raitkandi,611,364,262,132,349,232,62.7,66.5,60.1,00000
35.0,51.0,13.0,328,01,01,  Gachha Para,996,679,475,315,521,364,59.5,60.1,58.9,00000
35.0,51.0,13.0,328,02,01,  Uttarpara,786,593,389,259,397,334,57.0,60.0,54.3,00000
35.0,51.0,13.0,328,03,01,  Chittra Para,780,579,348,238,432,341,57.4,59.4,55.9,00000
35.0,51.0,13.0,328,04,01,  Purbapara,1181,813,580,338,601,475,59.2,63.2,55.9,00000
35.0,51.0,13.0,328,05,01,  Bhuar Para,412,204,197,81,215,123,66.9,70.9,63.6,00000
35.0,51.0,13.0,328,06,01,  Noadha(Part),99,109,47,53,52,56,47.6,47.0,48.1,00000
35.0,51.0,13.0,646,01,01,  Nagra,504,315,246,134,258,181,61.5,64.7,58.8,00000
35.0,51.0,13.0,646,02,01,  Noadha(Part),51,87,22,46,29,41,37.0,32.4,41.4,00000
35.0,51.0,15.0,119,01,01,  Bandhabari,2474,2175,1156,1000,1318,1175,53.2,53.6,52.9,00000
35.0,51.0,15.0,119,02,01,  Hasua,295,335,132,149,163,186,46.8,47.0,46.7,00000
35.0,51.0,23.0,039,01,01,  Bagan Uttarpar (Part),699,162,361,68,338,94,81.2,84.1,78.2,00000
35.0,51.0,23.0,039,02,01,  Kawria,60,69,32,31,28,38,46.5,50.8,42.4,00000
35.0,51.0,23.0,039,03,01,  Dauatali,554,156,290,64,264,92,78.0,81.9,74.2,00000
35.0,51.0,23.0,039,04,01,  Sikir Bazar,167,34,94,14,73,20,83.1,87.0,78.5,00000
35.0,51.0,23.0,089,01,01,  Baluhar,396,445,194,205,202,240,47.1,48.6,45.7,00000
35.0,51.0,23.0,089,02,01,  Uttar Sonatia,43,19,20,8,23,11,69.4,71.4,67.6,00000
35.0,51.0,23.0,109,01,03,  Bandal,306,94,174,45,132,49,76.5,79.5,72.9,00000
35.0,51.0,23.0,109,02,03,  Mothbari,308,39,145,16,163,23,88.8,90.1,87.6,00000
35.0,51.0,23.0,636,01,03,  Dahar Para (Part),360,253,186,119,174,134,58.7,61.0,56.5,00000
35.0,51.0,23.0,636,02,03,  Madanpar,431,56,223,22,208,34,88.5,91.0,86.0,00000
35.0,51.0,23.0,636,03,03,  Shimulbari (Part),113,35,63,11,50,24,76.4,85.1,67.6,00000
35.0,51.0,31.0,606,01,01,  Majhbari,1379,891,625,412,754,479,60.7,60.3,61.2,00000
35.0,51.0,31.0,606,02,01,  Loharonka,775,613,368,256,407,357,55.8,59.0,53.3,00000
35.0,51.0,31.0,606,03,01,  Bankura,549,406,271,169,278,237,57.5,61.6,54.0,00000
35.0,51.0,31.0,606,04,01,  Atrabari,222,183,111,88,111,95,54.8,55.8,53.9,00000
35.0,51.0,39.0,079,01,01,  Baikunthapur,1038,906,573,403,465,503,53.4,58.7,48.0,00000
35.0,51.0,39.0,079,02,01,  Tetulbari,319,191,174,84,145,107,62.5,67.4,57.5,00000
35.0,51.0,39.0,159,01,01,  Barua,1386,908,725,410,661,498,60.4,63.9,57.0,00000
35.0,51.0,39.0,159,02,01,  Jalenga,34,33,17,20,17,13,50.7,45.9,56.7,00000
35.0,51.0,39.0,199,01,01,  Padma Jira,7,15,5,9,2,6,31.8,35.7,25.0,00000
35.0,51.0,39.0,199,02,01,  Kandir Pathar,21,62,11,27,10,35,25.3,28.9,22.2,00000
35.0,51.0,39.0,199,03,01,  Shimulbari,476,471,267,225,209,246,50.3,54.3,45.9,00000
35.0,51.0,39.0,199,04,01,  Madhyakandi,623,478,347,205,276,273,56.6,62.9,50.3,00000
35.0,51.0,39.0,199,05,01,  Khejurbari,359,62,195,25,164,37,85.3,88.6,81.6,00000
35.0,51.0,39.0,199,06,01,  Eagarabari,235,269,123,125,112,144,46.6,49.6,43.8,00000
35.0,51.0,39.0,199,07,01,  Kumarkandi,307,180,171,73,136,107,63.0,70.1,56.0,00000
35.0,51.0,39.0,199,09,01,  Paschimkandi,245,230,129,102,116,128,51.6,55.8,47.5,00000
35.0,51.0,39.0,218,01,01,  Chak Pukuria,290,208,149,94,141,114,58.2,61.3,55.3,00000
35.0,51.0,39.0,218,02,01,  Ruthiarpar,306,197,165,87,141,110,60.8,65.5,56.2,00000
35.0,51.0,39.0,218,03,01,  Mach Para,675,428,352,189,323,239,61.2,65.1,57.5,00000
35.0,51.0,39.0,487,01,01,  Kalabari,1627,1164,912,485,715,679,58.3,65.3,51.3,00000
35.0,51.0,39.0,487,02,01,  Kafulabari,433,262,234,108,199,154,62.3,68.4,56.4,00000
35.0,51.0,39.0,487,03,01,  Bhangarpar,290,343,148,159,142,184,45.8,48.2,43.6,00000
35.0,51.0,39.0,487,04,01,  Hijalbari,697,264,379,116,318,148,72.5,76.6,68.2,00000
35.0,51.0,39.0,487,05,01,  Kaliganj Gram,178,67,89,28,89,39,72.7,76.1,69.5,00000
35.0,51.0,39.0,487,06,01,  Kaliganj Bazar,66,14,37,5,29,9,82.5,88.1,76.3,00000
35.0,51.0,39.0,487,07,01,  Petkatha,30,70,15,29,15,41,30.0,34.1,26.8,00000
35.0,51.0,39.0,487,08,01,  Tetulbari,217,80,108,34,109,46,73.1,76.1,70.3,00000
35.0,51.0,39.0,656,01,01,  Nalua,1002,584,533,249,469,335,63.2,68.2,58.3,00000
35.0,51.0,39.0,656,02,01,  Kumria,516,135,280,49,236,86,79.3,85.1,73.3,00000
35.0,51.0,47.0,099,01,01,  Banarjhor,214,317,95,175,119,142,40.3,35.2,45.6,00000
35.0,51.0,47.0,099,02,01,  Nayakandi(Part),21,23,9,12,12,11,47.7,42.9,52.2,00000
35.0,51.0,47.0,288,01,01,  Dhara Basail,1248,1175,653,547,595,628,51.5,54.4,48.7,00000
35.0,51.0,47.0,288,02,01,  Gobhtamarabad,158,370,85,190,73,180,29.9,30.9,28.9,00000
35.0,51.0,47.0,338,01,01,  Ambari,164,199,92,91,72,108,45.2,50.3,40.0,00000
35.0,51.0,47.0,338,02,01,  Goutamerabad(Part),82,115,46,57,36,58,41.6,44.7,38.3,00000
35.0,51.0,47.0,338,03,01,  Gazalia,187,404,113,261,74,143,31.6,30.2,34.1,00000
35.0,51.0,47.0,338,04,01,  Machartara(Part),143,130,79,67,64,63,52.4,54.1,50.4,00000
35.0,51.0,47.0,358,01,01,  Ghugrahati,145,190,67,98,78,92,43.3,40.6,45.9,00000
35.0,51.0,47.0,358,02,01,  Tarakandar(Part),100,61,57,25,43,36,62.1,69.5,54.4,00000
35.0,51.0,47.0,358,03,01,  Baraibhita,291,230,132,113,159,117,55.9,53.9,57.6,00000
35.0,51.0,47.0,427,01,01,  Hijalbari,349,183,181,81,168,102,65.6,69.1,62.2,00000
35.0,51.0,47.0,427,02,01,  Lebubari,197,182,107,90,90,92,52.0,54.3,49.5,00000
35.0,51.0,47.0,427,03,01,  Nayakandi(Part),32,102,13,55,19,47,23.9,19.1,28.8,00000
35.0,51.0,47.0,577,01,01,  Kacharibhita,350,460,165,233,185,227,43.2,41.5,44.9,00000
35.0,51.0,47.0,577,02,01,  Nayakandi,395,129,204,59,191,70,75.4,77.6,73.2,00000
35.0,51.0,47.0,587,01,01,  Dakshin Machartara,62,54,29,25,33,29,53.4,53.7,53.2,00000
35.0,51.0,47.0,587,02,01,  Nayakandi(Part),68,69,33,33,35,36,49.6,50.0,49.3,00000
35.0,51.0,47.0,587,03,01,  Talpukuria(Part),325,273,163,137,162,136,54.3,54.3,54.4,00000
35.0,51.0,47.0,587,04,01,  Bhennabari(Part),61,65,34,36,27,29,48.4,48.6,48.2,00000
35.0,51.0,47.0,935,01,01,  Bhennabari,430,512,246,265,184,247,45.6,48.1,42.7,00000
35.0,51.0,47.0,935,02,01,  Machartara(Part),173,159,91,81,82,78,52.1,52.9,51.3,00000
35.0,51.0,47.0,935,03,01,  Talpukuria,176,179,90,81,86,98,49.6,52.6,46.7,00000
35.0,51.0,47.0,935,04,01,  Ambaria(Part),8,40,4,20,4,20,16.7,16.7,16.7,00000
35.0,51.0,55.0,129,01,01,  Baniari,562,554,295,266,267,288,50.4,52.6,48.1,00000
35.0,51.0,55.0,129,02,01,  Kandi,247,227,107,89,140,138,52.1,54.6,50.4,00000
35.0,51.0,55.0,258,01,01,  Charkhali,705,1121,345,520,360,601,38.6,39.9,37.5,00000
35.0,51.0,55.0,258,02,01,  Lakhir Para,990,764,514,353,476,411,56.4,59.3,53.7,00000
35.0,51.0,55.0,298,01,01,  Dhorar,381,416,178,194,203,222,47.8,47.8,47.8,00000
35.0,51.0,55.0,298,02,01,  Ambari,111,267,51,112,60,155,29.4,31.3,27.9,00000
35.0,51.0,55.0,447,01,01,  Jamila,619,673,318,302,301,371,47.9,51.3,44.8,00000
35.0,51.0,55.0,447,02,01,  Biamerkandi,365,487,186,208,179,279,42.8,47.2,39.1,00000
35.0,51.0,55.0,447,03,01,  Hajrabari,135,99,68,41,67,58,57.7,62.4,53.6,00000
35.0,51.0,55.0,447,04,01,  Naugata,114,58,57,25,57,33,66.3,69.5,63.3,00000
35.0,51.0,55.0,447,05,01,  Tilbari,258,137,145,72,113,65,65.3,66.8,63.5,00000
35.0,51.0,55.0,626,01,01,  Mandra,1127,951,562,441,565,510,54.2,56.0,52.6,00000
35.0,51.0,55.0,626,02,01,  Khagbari,48,66,28,32,20,34,42.1,46.7,37.0,00000
35.0,51.0,55.0,965,01,01,  Tihati,544,449,243,190,301,259,54.8,56.1,53.8,00000
35.0,51.0,55.0,965,02,01,  Pobnar Para,278,209,132,83,146,126,57.1,61.4,53.7,00000
35.0,51.0,55.0,975,01,01,  Tuparia,811,798,404,384,407,414,50.4,51.3,49.6,00000
35.0,51.0,55.0,975,02,01,  Sonargari,302,526,145,229,157,297,36.5,38.8,34.6,00000
35.0,51.0,63.0,278,01,01,  Deopura,294,220,145,101,149,119,57.2,58.9,55.6,00000
35.0,51.0,63.0,278,02,01,  Magurakandi,88,186,46,88,42,98,32.1,34.3,30.0,00000
35.0,51.0,63.0,278,03,01,  Phulbari,213,91,114,39,99,52,70.1,74.5,65.6,00000
35.0,51.0,63.0,895,01,01,  Sonakhali,268,362,140,186,128,176,42.5,42.9,42.1,00000
35.0,51.0,63.0,895,02,01,  Tarail,305,206,156,101,149,105,59.7,60.7,58.7,00000
35.0,51.0,63.0,895,03,01,  Char Gopalpur,165,124,80,76,85,48,57.1,51.3,63.9,00000
35.0,51.0,71.0,169,01,01,  Atashibari,510,77,247,28,263,49,86.9,89.8,84.3,00000
35.0,51.0,71.0,169,02,01,  Rajindarpar,189,29,101,3,88,26,86.7,97.1,77.2,00000
35.0,51.0,71.0,169,03,01,  Kalabhita,111,44,48,19,63,25,71.6,71.6,71.6,00000
35.0,51.0,71.0,169,04,01,  Batbari,589,155,294,57,295,98,79.2,83.8,75.1,00000
35.0,51.0,71.0,169,05,01,  Bhuturia,403,164,207,65,196,99,71.1,76.1,66.4,00000
35.0,51.0,71.0,169,06,01,  Aruakandi,128,33,57,13,71,20,79.5,81.4,78.0,00000
35.0,51.0,71.0,169,07,01,  Sonailbari,132,63,70,25,62,38,67.7,73.7,62.0,00000
35.0,51.0,71.0,169,08,01,  Gabbari,112,34,61,14,51,20,76.7,81.3,71.8,00000
35.0,51.0,71.0,179,01,01,  Tuthbari,180,142,94,65,86,77,55.9,59.1,52.8,00000
35.0,51.0,71.0,179,02,01,  Baruabari,601,245,295,103,306,142,71.0,74.1,68.3,00000
35.0,51.0,71.0,179,03,01,  Chalitabari,86,104,40,51,46,53,45.3,44.0,46.5,00000
35.0,51.0,71.0,179,04,01,  Kalikabari,255,155,124,69,131,86,62.2,64.2,60.4,00000
35.0,51.0,71.0,179,05,01,  Sreefalbari,371,162,198,68,173,94,69.6,74.4,64.8,00000
35.0,51.0,71.0,238,01,01,  Chhota Dighalia,681,233,353,112,328,121,74.5,75.9,73.1,00000
35.0,51.0,71.0,238,02,01,  Kachikatha,166,125,89,63,77,62,57.0,58.6,55.4,00000
35.0,51.0,71.0,238,03,01,  Gachbari,93,58,46,24,47,34,61.6,65.7,58.0,00000
35.0,51.0,71.0,238,04,01,  Radhaganj,120,73,66,36,54,37,62.2,64.7,59.3,00000
35.0,51.0,71.0,378,01,01,  Uttar Dighalia,332,331,177,160,155,171,50.1,52.5,47.5,00000
35.0,51.0,71.0,378,02,01,  Dakshin Dighalia,234,173,120,79,114,94,57.5,60.3,54.8,00000
35.0,51.0,71.0,378,03,01,  Khagbari,177,76,90,29,87,47,70.0,75.6,64.9,00000
35.0,51.0,71.0,378,04,01,  Debgram,706,353,381,152,325,201,66.7,71.5,61.8,00000
35.0,51.0,71.0,378,05,01,  Chikati Bari,548,173,285,61,263,112,76.0,82.4,70.1,00000
35.0,51.0,71.0,378,06,01,  Pindal Para,198,251,82,112,116,139,44.1,42.3,45.5,00000
35.0,51.0,71.0,616,01,01,  Mandarbari,378,224,196,111,182,113,62.8,63.8,61.7,00000
35.0,51.0,71.0,616,02,01,  Ambari,220,105,114,49,106,56,67.7,69.9,65.4,00000
35.0,51.0,71.0,616,03,01,  Jotiarbari,156,164,61,77,95,87,48.8,44.2,52.2,00000
35.0,51.0,71.0,676,01,01,  Narikelbari,1891,1130,992,486,899,644,62.6,67.1,58.3,00000
35.0,51.0,71.0,676,02,01,  Cheptarpar,188,48,102,11,86,37,79.7,90.3,69.9,00000
35.0,51.0,71.0,676,03,01,  Mulbari,146,15,75,5,71,10,90.7,93.8,87.7,00000
35.0,51.0,71.0,676,04,01,  Hairadhara,150,87,78,36,72,51,63.3,68.4,58.5,00000
35.0,51.0,71.0,676,05,01,  Bhangarhat,33,40,22,36,11,4,45.2,37.9,73.3,00000
35.0,51.0,79.0,726,01,01,  Ramshil,2307,1328,1221,571,1086,757,63.5,68.1,58.9,00000
35.0,51.0,79.0,726,02,01,  Soladaha,310,240,162,106,148,134,56.4,60.4,52.5,00000
35.0,51.0,79.0,746,01,01,  Kafulabari,1013,853,511,403,502,450,54.3,55.9,52.7,00000
35.0,51.0,79.0,746,02,01,  Kabarbari,231,187,113,83,118,104,55.3,57.7,53.2,00000
35.0,51.0,87.0,417,01,01,  Paschim Hazrabari,766,345,441,146,325,199,68.9,75.1,62.0,00000
35.0,51.0,87.0,417,02,01,  Dakshin Hazrabari,670,233,404,98,266,135,74.2,80.5,66.3,00000
35.0,51.0,87.0,417,03,01,  Uttar Hazrabari,714,466,384,211,330,255,60.5,64.5,56.4,00000
35.0,51.0,87.0,417,04,01,  Bahorabari,682,402,371,168,311,234,62.9,68.8,57.1,00000
35.0,51.0,87.0,417,05,01,  Tikribari,567,286,315,109,252,177,66.5,74.3,58.7,00000
35.0,51.0,87.0,417,06,01,  Golabari,368,96,203,39,165,57,79.3,83.9,74.3,00000
35.0,51.0,87.0,537,01,01,  Konerbhita,390,300,204,128,186,172,56.5,61.4,52.0,00000
35.0,51.0,87.0,537,02,01,  Pakharpar,344,151,185,61,159,90,69.5,75.2,63.9,00000
35.0,51.0,87.0,736,01,01,  Ramshil Bhuterbari,1033,369,533,148,500,221,73.7,78.3,69.3,00000
35.0,51.0,87.0,736,02,01,  Betkachia,269,85,145,39,124,46,76.0,78.8,72.9,00000
35.0,51.0,87.0,736,03,01,  Bagol Bari,78,16,42,4,36,12,83.0,91.3,75.0,00000
35.0,51.0,87.0,865,01,01,  Lebubari,107,33,53,14,54,19,76.4,79.1,74.0,00000
35.0,51.0,87.0,865,02,01,  Paikerbari,852,497,442,213,410,284,63.2,67.5,59.1,00000
35.0,51.0,87.0,865,03,01,  Latenga,1206,427,640,167,566,260,73.9,79.3,68.5,00000
35.0,51.0,87.0,865,04,01,  Badartala,126,66,68,30,58,36,65.6,69.4,61.7,00000
35.0,51.0,94.0,666,01,01,  Kalarbari,425,347,190,164,235,183,55.1,53.7,56.2,00000
35.0,51.0,94.0,666,02,01,  Narayankhana,564,485,295,224,269,261,53.8,56.8,50.8,00000
35.0,51.0,94.0,925,01,01,  Suagram,2203,1335,1126,646,1077,689,62.3,63.5,61.0,00000
35.0,58.0,10.0,176,01,01,  Bhumsara,273,259,144,120,129,139,51.3,54.5,48.1,00000
35.0,58.0,10.0,176,02,01,  Amirabad,96,193,50,85,46,108,33.2,37.0,29.9,00000
35.0,58.0,10.0,330,01,01,  Gaendar,207,253,100,112,107,141,45.0,47.2,43.1,00000
35.0,58.0,10.0,330,02,01,  Naldanga,306,173,166,57,140,116,63.9,74.4,54.7,00000
35.0,58.0,10.0,492,01,01,  Bakpura,159,78,97,31,62,47,67.1,75.8,56.9,00000
35.0,58.0,10.0,492,02,01,  Kalinagar,924,575,516,219,408,356,61.6,70.2,53.4,00000
35.0,58.0,10.0,588,01,01,  Bhramarbila,56,75,30,33,26,42,42.7,47.6,38.2,00000
35.0,58.0,10.0,588,02,01,  Krishnapur,249,207,116,98,133,109,54.6,54.2,55.0,00000
35.0,58.0,11.0,062,01,01,  Bahugram,1333,810,729,364,604,446,62.2,66.7,57.5,00000
35.0,58.0,11.0,062,02,01,  Mothbari,168,105,88,51,80,54,61.5,63.3,59.7,00000
35.0,58.0,11.0,344,01,01,  Garalgati,1028,563,508,200,520,363,64.6,71.8,58.9,00000
35.0,58.0,11.0,344,02,01,  Majhigati,636,296,325,113,311,183,68.2,74.2,63.0,00000
35.0,58.0,11.0,344,03,01,  Bara Tarail,563,269,261,113,302,156,67.7,69.8,65.9,00000
35.0,58.0,11.0,344,04,01,  Chhota Tarail,309,193,171,75,138,118,61.6,69.5,53.9,00000
35.0,58.0,11.0,344,05,01,  Bidbhu Basuria,130,112,67,45,63,67,53.7,59.8,48.5,00000
35.0,58.0,16.0,798,01,01,  Pora Ujanikhanjapur,423,885,205,405,218,480,32.3,33.6,31.2,00000
35.0,58.0,16.0,798,02,01,  Poraujani Banshbaria,511,250,239,119,272,131,67.1,66.8,67.5,00000
35.0,58.0,16.0,894,01,01,  Shimulsur,223,566,123,249,100,317,28.3,33.1,24.0,00000
35.0,58.0,16.0,894,02,01,  Digharia,511,567,271,216,240,351,47.4,55.6,40.6,00000
35.0,58.0,22.0,478,01,01,  Kahaldia,997,1129,508,531,489,598,46.9,48.9,45.0,00000
35.0,58.0,22.0,478,02,01,  Dakalipur,163,60,73,26,90,34,73.1,73.7,72.6,00000
35.0,58.0,27.0,047,01,01,  Bagat,484,327,256,121,228,206,59.7,67.9,52.5,00000
35.0,58.0,27.0,047,02,01,  Dighalkandi,122,85,71,31,51,54,58.9,69.6,48.6,00000
35.0,58.0,27.0,167,01,01,  Bhajandi,790,1023,399,478,391,545,43.6,45.5,41.8,00000
35.0,58.0,27.0,167,02,01,  Brahmankandi,20,59,10,29,10,30,25.3,25.6,25.0,00000
35.0,58.0,27.0,191,01,01,  Bishwambhardi,575,423,287,205,288,218,57.6,58.3,56.9,00000
35.0,58.0,27.0,191,02,01,  Khajtapur,392,577,182,265,210,312,40.5,40.7,40.2,00000
35.0,58.0,27.0,191,03,01,  Joaria,185,155,82,71,103,84,54.4,53.6,55.1,00000
35.0,58.0,27.0,928,01,01,  Sunuria,368,661,190,308,178,353,35.8,38.2,33.5,00000
35.0,58.0,27.0,928,02,01,  Mirerdangi,185,206,100,104,85,102,47.3,49.0,45.5,00000
35.0,58.0,33.0,368,01,01,  Gobandapur,962,428,488,192,474,236,69.2,71.8,66.8,00000
35.0,58.0,33.0,368,02,01,  Dighirpar,446,241,208,107,238,134,64.9,66.0,64.0,00000
35.0,58.0,33.0,368,03,01,  Fakir Hatkhola,202,133,100,45,102,88,60.3,69.0,53.7,00000
35.0,58.0,33.0,607,01,01,  Latibpur,185,246,68,123,117,123,42.9,35.6,48.8,00000
35.0,58.0,33.0,607,02,01,  Kalidaharpar,73,31,36,14,37,17,70.2,72.0,68.5,00000
35.0,58.0,33.0,875,01,01,  Sarupi,251,48,124,20,127,28,83.9,86.1,81.9,00000
35.0,58.0,33.0,875,02,01,  Bhramargram,121,40,62,12,59,28,75.2,83.8,67.8,00000
35.0,58.0,33.0,913,01,01,  Sreenibashkati,568,103,289,47,279,56,84.6,86.0,83.3,00000
35.0,58.0,33.0,913,02,01,  Kazitola,93,91,50,46,43,45,50.5,52.1,48.9,00000
35.0,58.0,33.0,913,03,01,  Kulapar (Fularpar),391,275,196,116,195,159,58.7,62.8,55.1,00000
35.0,58.0,39.0,004,01,01,  Aruakandi,421,369,213,179,208,190,53.3,54.3,52.3,00000
35.0,58.0,39.0,004,02,01,  Achar Para,257,273,143,124,114,149,48.5,53.6,43.3,00000
35.0,58.0,39.0,334,01,01,  Uttar Gangarampur,437,552,210,264,227,288,44.2,44.3,44.1,00000
35.0,58.0,39.0,334,02,01,  Dakshin Gangarampur,576,1124,322,556,254,568,33.9,36.7,30.9,00000
35.0,58.0,39.0,334,03,01,  Golakandi,426,1027,233,524,193,503,29.3,30.8,27.7,00000
35.0,58.0,39.0,377,01,01,  Gohala,742,379,418,185,324,194,66.2,69.3,62.5,00000
35.0,58.0,39.0,377,02,01,  Biswanathpur,148,48,81,23,67,25,75.5,77.9,72.8,00000
35.0,58.0,39.0,411,01,01,  Harir Char,381,355,205,164,176,191,51.8,55.6,48.0,00000
35.0,58.0,39.0,411,02,01,  Fatehpur,262,140,135,66,127,74,65.2,67.2,63.2,00000
35.0,58.0,39.0,684,01,01,  Munirkandi,806,721,377,311,429,410,52.8,54.8,51.1,00000
35.0,58.0,39.0,684,02,01,  Debottar,135,70,63,35,72,35,65.9,64.3,67.3,00000
35.0,58.0,39.0,684,03,01,  Hatiardaha,53,45,24,15,29,30,54.1,61.5,49.2,00000
35.0,58.0,44.0,440,01,01,  Jalirpar (Guchchhagram),4192,1796,2176,791,2016,1005,70.0,73.3,66.7,00000
35.0,58.0,44.0,440,02,01,  Santipur,271,207,154,98,117,109,56.7,61.1,51.8,00000
35.0,58.0,44.0,440,03,01,  Hotathgram,128,174,75,82,53,92,42.4,47.8,36.6,00000
35.0,58.0,44.0,440,04,01,  Asraon,124,416,66,206,58,210,23.0,24.3,21.6,00000
35.0,58.0,44.0,487,01,01,  Kaligram,2694,2236,1345,1022,1349,1214,54.6,56.8,52.6,00000
35.0,58.0,44.0,487,02,01,  Baniar Char,1978,746,1019,302,959,444,72.6,77.1,68.4,00000
35.0,58.0,44.0,487,03,01,  Fulkumari,574,392,320,169,254,223,59.4,65.4,53.2,00000
35.0,58.0,44.0,487,04,01,  Talbari,411,245,213,113,198,132,62.7,65.3,60.0,00000
35.0,58.0,50.0,157,01,01,  Betgram,1013,1000,545,407,468,593,50.3,57.2,44.1,00000
35.0,58.0,50.0,157,02,01,  Nayakandi,341,438,158,223,183,215,43.8,41.5,46.0,00000
35.0,58.0,50.0,157,03,01,  Tongrail,146,105,79,39,67,66,58.2,66.9,50.4,00000
35.0,58.0,50.0,511,01,01,  Kasalia,382,409,191,177,191,232,48.3,51.9,45.2,00000
35.0,58.0,50.0,511,02,01,  Delbagarkandi,213,224,110,97,103,127,48.7,53.1,44.8,00000
35.0,58.0,50.0,511,03,01,  Hindu Kasalia,61,126,33,48,28,78,32.6,40.7,26.4,00000
35.0,58.0,50.0,511,04,01,  Ibrahim Kasalia,67,156,41,66,26,90,30.0,38.3,22.4,00000
35.0,58.0,55.0,153,01,01,  Bejara,859,198,394,83,465,115,81.3,82.6,80.2,00000
35.0,58.0,55.0,153,02,01,  Tekerhat,30,45,11,19,19,26,40.0,36.7,42.2,00000
35.0,58.0,55.0,234,01,01,  Chhota Bhatra,327,310,143,139,184,171,51.3,50.7,51.8,00000
35.0,58.0,55.0,234,02,01,  Chilarpar,31,15,15,5,16,10,67.4,75.0,61.5,00000
35.0,58.0,55.0,430,01,01,  Bariangram,69,65,37,27,32,38,51.5,57.8,45.7,00000
35.0,58.0,55.0,430,02,01,  Chitalkona,66,44,35,21,31,23,60.0,62.5,57.4,00000
35.0,58.0,55.0,430,03,01,  Induhati,237,102,134,48,103,54,69.9,73.6,65.6,00000
35.0,58.0,61.0,636,01,01,  Maharajpur,1728,1639,866,784,862,855,51.3,52.5,50.2,00000
35.0,58.0,61.0,636,02,01,  Ramkrishnapur,266,447,140,212,126,235,37.3,39.8,34.9,00000
35.0,58.0,67.0,014,01,01,  Aikdia,615,643,292,290,323,353,48.9,50.2,47.8,00000
35.0,58.0,67.0,014,02,01,  Paikdia,789,936,396,461,393,475,45.7,46.2,45.3,00000
35.0,58.0,67.0,014,03,01,  Nawra,666,560,298,247,368,313,54.3,54.7,54.0,00000
35.0,58.0,67.0,014,04,01,  Bamunia,210,281,103,148,107,133,42.8,41.0,44.6,00000
35.0,58.0,67.0,339,01,01,  Ganiari,339,209,168,111,171,98,61.9,60.2,63.6,00000
35.0,58.0,67.0,339,02,01,  Mothbari,158,99,70,49,88,50,61.5,58.8,63.8,00000
35.0,58.0,67.0,358,01,01,  Ghonshi,770,1134,380,544,390,590,40.4,41.1,39.8,00000
35.0,58.0,67.0,358,02,01,  Satiani,113,356,66,193,47,163,24.1,25.5,22.4,00000
35.0,58.0,67.0,554,01,01,  Khanpura,287,265,145,119,142,146,52.0,54.9,49.3,00000
35.0,58.0,67.0,554,02,01,  Uttar Khanpura,110,177,49,98,61,79,38.3,33.3,43.6,00000
35.0,58.0,67.0,554,03,01,  Dhalikandi,185,122,88,51,97,71,60.3,63.3,57.7,00000
35.0,58.0,78.0,435,01,01,  Jaigirar Para,151,204,78,97,73,107,42.5,44.6,40.6,00000
35.0,58.0,78.0,435,02,01,  Surop Khorikini,164,355,87,165,77,190,31.6,34.5,28.8,00000
35.0,58.0,83.0,822,01,01,  Raghdi,448,569,215,252,233,317,44.1,46.0,42.4,00000
35.0,58.0,83.0,822,02,01,  Nayakandi,92,316,48,145,44,171,22.5,24.9,20.5,00000
35.0,58.0,83.0,822,03,01,  Ghoshkandi,29,101,14,47,15,54,22.3,23.0,21.7,00000
35.0,58.0,83.0,822,04,01,  Mridhakandi,29,95,17,50,12,45,23.4,25.4,21.1,00000
35.0,58.0,83.0,822,05,01,  Dighirpar,31,67,19,29,12,38,31.6,39.6,24.0,00000
35.0,58.0,83.0,822,06,01,  Mathpar,62,160,35,75,27,85,27.9,31.8,24.1,00000
35.0,58.0,83.0,822,07,01,  Garjina,132,138,67,67,65,71,48.9,50.0,47.8,00000
35.0,58.0,83.0,822,08,01,  Garubhanga,76,248,40,146,36,102,23.5,21.5,26.1,00000
35.0,58.0,94.0,138,01,01,  Basudebpur,909,802,485,357,424,445,53.1,57.6,48.8,00000
35.0,58.0,94.0,138,02,01,  Banahati,382,537,219,271,163,266,41.6,44.7,38.0,00000
35.0,58.0,94.0,143,01,01,  Basuria,361,423,201,183,160,240,46.0,52.3,40.0,00000
35.0,58.0,94.0,143,02,01,  Tikerdanga,135,127,69,50,66,77,51.5,58.0,46.2,00000
35.0,58.0,94.0,277,01,01,  Dharma Royerbari,452,237,239,95,213,142,65.6,71.6,60.0,00000
35.0,58.0,94.0,277,02,01,  Barampalta,281,996,159,477,122,519,22.0,25.0,19.0,00000
35.0,58.0,94.0,641,01,01,  Mahatali,736,896,384,396,352,500,45.1,49.2,41.3,00000
35.0,58.0,94.0,641,02,01,  Decreekandi,193,167,91,77,102,90,53.6,54.2,53.1,00000
35.0,91.0,19.0,429,01,01,  Gajalia,406,486,163,269,243,217,45.5,37.7,52.8,00000
35.0,91.0,19.0,429,02,01,  Munsher Char,543,472,236,245,307,227,53.5,49.1,57.5,00000
35.0,91.0,19.0,429,03,01,  Sener Char,266,96,138,45,128,51,73.5,75.4,71.5,00000
35.0,91.0,19.0,429,04,01,  Singi Para,580,554,272,277,308,277,51.1,49.5,52.6,00000
35.0,91.0,28.0,215,01,01,  Parchim Tarail,104,60,54,26,50,34,63.4,67.5,59.5,00000
35.0,91.0,28.0,215,02,01,  Uttar Kathigram,174,110,89,54,85,56,61.3,62.2,60.3,00000
35.0,91.0,28.0,215,03,01,  Bhairabnagar,199,141,110,58,89,83,58.5,65.5,51.7,00000
35.0,91.0,28.0,280,01,01,  Sharabari,236,129,126,63,110,66,64.7,66.7,62.5,00000
35.0,91.0,28.0,280,02,01,  Chithalia,147,111,71,51,76,60,57.0,58.2,55.9,00000
35.0,91.0,28.0,280,03,01,  Dumuria,574,158,314,65,260,93,78.4,82.8,73.7,00000
35.0,91.0,28.0,280,04,01,  Narayankhali,119,254,59,129,60,125,31.9,31.4,32.4,00000
35.0,91.0,28.0,280,05,01,  Uttar Dumuria,107,241,53,119,54,122,30.7,30.8,30.7,00000
35.0,91.0,28.0,280,06,01,  Chhota Dumuria,586,178,300,83,286,95,76.7,78.3,75.1,00000
35.0,91.0,28.0,280,07,01,  Labutala,376,473,178,241,198,232,44.3,42.5,46.0,00000
35.0,91.0,28.0,510,01,01,  Par Jhanjhania,927,637,423,342,504,295,59.3,55.3,63.1,00000
35.0,91.0,28.0,510,02,01,  Dakshin Pakurtia,676,392,308,184,368,208,63.3,62.6,63.9,00000
35.0,91.0,28.0,510,03,01,  Uttar Pakurtia,626,454,275,238,351,216,58.0,53.6,61.9,00000
35.0,91.0,28.0,510,04,01,  Uttar Banshbaria,415,444,179,228,236,216,48.3,44.0,52.2,00000
35.0,91.0,28.0,510,05,01,  Dakshin Banshbaria,1044,1020,484,546,560,474,50.6,47.0,54.2,00000
35.0,91.0,28.0,510,06,01,  Lebutala,287,156,161,76,126,80,64.8,67.9,61.2,00000
35.0,91.0,28.0,510,07,01,  Karfa,457,281,244,150,213,131,61.9,61.9,61.9,00000
35.0,91.0,28.0,510,08,01,  Madhukhali,526,282,265,117,261,165,65.1,69.4,61.3,00000
35.0,91.0,28.0,920,01,01,  Salukha,161,76,83,34,78,42,67.9,70.9,65.0,00000
35.0,91.0,28.0,920,02,01,  Purba Tarail,379,211,224,103,155,108,64.2,68.5,58.9,00000
35.0,91.0,28.0,920,03,01,  Purba Bhairabnagar,298,287,169,135,129,152,50.9,55.6,45.9,00000
35.0,91.0,28.0,920,04,01,  Bhennabari,177,291,101,145,76,146,37.8,41.1,34.2,00000
35.0,91.0,28.0,920,05,01,  Char Gopalpur,645,270,346,132,299,138,70.5,72.4,68.4,00000
35.0,91.0,28.0,920,06,01,  Dakshin Kathigram,117,67,65,30,52,37,63.6,68.4,58.4,00000
35.0,91.0,28.0,920,07,01,  Kanai Nagar,84,35,50,18,34,17,70.6,73.5,66.7,00000
35.0,91.0,28.0,920,08,01,  Patil Jhapa,33,30,18,16,15,14,52.4,52.9,51.7,00000
35.0,91.0,38.0,452,01,01,  Gopalpur,2380,1023,1323,437,1057,586,69.9,75.2,64.3,00000
35.0,91.0,38.0,452,02,01,  Baladanga,83,87,49,41,34,46,48.8,54.4,42.5,00000
35.0,91.0,38.0,452,03,01,  Saraydanga,377,499,174,226,203,273,43.0,43.5,42.6,00000
35.0,91.0,38.0,542,01,01,  Joaria,788,480,403,238,385,242,62.1,62.9,61.4,00000
35.0,91.0,38.0,542,02,01,  Bannabari,355,426,183,207,172,219,45.5,46.9,44.0,00000
35.0,91.0,38.0,542,03,01,  Tharial,123,123,69,70,54,53,50.0,49.6,50.5,00000
35.0,91.0,38.0,542,04,01,  Sonakhali,87,48,47,22,40,26,64.4,68.1,60.6,00000
35.0,91.0,76.0,045,01,03,  Dariarkul,266,436,132,232,134,204,37.9,36.3,39.6,00000
35.0,91.0,76.0,045,02,03,  Balargati,91,61,52,31,39,30,59.9,62.7,56.5,00000
35.0,91.0,76.0,339,01,03,  Chingaria,384,548,202,253,182,295,41.2,44.4,38.2,00000
35.0,91.0,76.0,339,02,03,  Nobukhali,212,277,118,129,94,148,43.4,47.8,38.8,00000
35.0,91.0,76.0,339,03,03,  Kakaibunia,257,247,148,121,109,126,51.0,55.0,46.4,00000
35.0,91.0,76.0,972,01,03,  Baghyarkul,324,335,161,167,163,168,49.2,49.1,49.2,00000
35.0,91.0,76.0,972,02,03,  Baladanga,383,228,205,109,178,119,62.7,65.3,59.9,00000
82.0,7.0,17.0,060,01,01,  Uttar Baharpur,1204,957,598,464,606,493,55.7,56.3,55.1,00000
82.0,7.0,17.0,060,02,01,  Madhyam Baharpur,1138,770,572,362,566,408,59.6,61.2,58.1,00000
82.0,7.0,17.0,060,03,01,  Dakshin Baharpur,893,577,466,263,427,314,60.7,63.9,57.6,00000
82.0,7.0,17.0,060,04,01,  Char Baharpur,461,320,244,150,217,170,59.0,61.9,56.1,00000
82.0,7.0,17.0,537,01,01,  Jadupur,291,163,145,80,146,83,64.1,64.4,63.8,00000
82.0,7.0,17.0,537,02,01,  Samaspur,215,109,124,48,91,61,66.4,72.1,59.9,00000
82.0,7.0,17.0,653,01,01,  Kupdi,190,220,91,110,99,110,46.3,45.3,47.4,00000
82.0,7.0,17.0,653,02,01,  Kupdidangi,102,164,56,84,46,80,38.3,40.0,36.5,00000
82.0,7.0,17.0,773,01,01,  Pakalia,246,157,135,80,111,77,61.0,62.8,59.0,00000
82.0,7.0,17.0,773,02,01,  Char Pakalia,292,173,154,92,138,81,62.8,62.6,63.0,00000
82.0,7.0,17.0,783,01,01,  Parkul Gohailbari,238,203,112,98,126,105,54.0,53.3,54.5,00000
82.0,7.0,17.0,783,02,01,  Khurda Ramdi,358,410,181,199,177,211,46.6,47.6,45.6,00000
82.0,7.0,17.0,783,03,01,  Gohalbare,260,323,129,167,131,156,44.6,43.6,45.6,00000
82.0,7.0,17.0,783,04,01,  Parkul,123,128,65,60,58,68,49.0,52.0,46.0,00000
82.0,7.0,17.0,799,01,01,  Paturia,431,292,242,117,189,175,59.6,67.4,51.9,00000
82.0,7.0,17.0,799,02,01,  Char Guadaha,264,338,137,163,127,175,43.9,45.7,42.1,00000
82.0,7.0,17.0,799,03,01,  Matlakhali,417,426,228,201,189,225,49.5,53.1,45.7,00000
82.0,7.0,17.0,799,04,01,  Betanga Bazar,352,374,196,184,156,190,48.5,51.6,45.1,00000
82.0,7.0,19.0,080,01,03,  Uttar Baliakandi,1479,652,764,278,715,374,69.4,73.3,65.7,00000
82.0,7.0,19.0,080,02,03,  Dakshin Baliakandi,2011,1366,1026,668,985,698,59.5,60.6,58.5,00000
82.0,7.0,19.0,216,01,01,  Bhimnagar,627,677,314,334,313,343,48.1,48.5,47.7,00000
82.0,7.0,19.0,216,02,01,  Purba Bhimnagar,304,156,144,83,160,73,66.1,63.4,68.7,00000
82.0,7.0,19.0,281,01,01,  Chamta,208,147,121,71,87,76,58.6,63.0,53.4,00000
82.0,7.0,19.0,281,02,01,  Banagram,145,85,67,42,78,43,63.0,61.5,64.5,00000
82.0,7.0,19.0,281,03,01,  Kanaigara,41,70,25,31,16,39,36.9,44.6,29.1,00000
82.0,7.0,19.0,281,04,01,  Bara Kanaibila,85,112,47,52,38,60,43.1,47.5,38.8,00000
82.0,7.0,19.0,281,05,01,  Taltala,123,47,68,16,55,31,72.4,81.0,64.0,00000
82.0,7.0,19.0,281,06,01,  Bauni,120,137,62,67,58,70,46.7,48.1,45.3,00000
82.0,7.0,19.0,281,07,01,  Chhota Kanabila,62,38,36,15,26,23,62.0,70.6,53.1,00000
82.0,7.0,19.0,371,01,01,  Deokol,106,89,56,43,50,46,54.4,56.6,52.1,00000
82.0,7.0,19.0,371,02,01,  Harikhali,28,43,17,21,11,22,39.4,44.7,33.3,00000
82.0,7.0,19.0,402,01,03,  Sreepur,89,38,37,17,52,21,70.1,68.5,71.2,00000
82.0,7.0,19.0,402,02,03,  Durgabardi,225,186,120,91,105,95,54.7,56.9,52.5,00000
82.0,7.0,19.0,743,01,01,  Nischintapur,543,646,259,310,284,336,45.7,45.5,45.8,00000
82.0,7.0,19.0,743,02,01,  Bahir Char,248,236,136,105,112,131,51.2,56.4,46.1,00000
82.0,7.0,19.0,768,01,01,  Paikandi,825,822,407,389,418,433,50.1,51.1,49.1,00000
82.0,7.0,19.0,768,02,01,  Purba Paikandi,337,105,170,42,167,63,76.2,80.2,72.6,00000
82.0,7.0,19.0,814,01,01,  Purba Maukuri,878,890,450,450,428,440,49.7,50.0,49.3,00000
82.0,7.0,19.0,814,02,01,  Amtala Bazar,90,104,43,55,47,49,46.4,43.9,49.0,00000
82.0,7.0,47.0,145,01,01,  Bara Mallik,1207,877,625,440,582,437,57.9,58.7,57.1,00000
82.0,7.0,47.0,145,02,01,  Ambaria,142,138,65,75,77,63,50.7,46.4,55.0,00000
82.0,7.0,47.0,437,01,01,  Ganapatia,193,328,106,167,87,161,37.0,38.8,35.1,00000
82.0,7.0,47.0,437,02,01,  Chhota Bhellabari,213,122,110,53,103,69,63.6,67.5,59.9,00000
82.0,7.0,47.0,437,03,01,  Dangi Para,70,77,37,35,33,42,47.6,51.4,44.0,00000
82.0,7.0,47.0,437,04,01,  Hirunkandi,134,116,67,58,67,58,53.6,53.6,53.6,00000
82.0,7.0,47.0,603,01,01,  Purba Khalkula,663,741,315,370,348,371,47.2,46.0,48.4,00000
82.0,7.0,47.0,603,02,01,  Paschim Khalkula,838,834,410,403,428,431,50.1,50.4,49.8,00000
82.0,7.0,47.0,603,03,01,  Anandanagar,115,80,60,34,55,46,59.0,63.8,54.5,00000
82.0,7.0,47.0,603,04,01,  Batsala,294,289,142,140,152,149,50.4,50.4,50.5,00000
82.0,7.0,47.0,603,05,01,  Sarutia,308,257,154,121,154,136,54.5,56.0,53.1,00000
82.0,7.0,47.0,733,01,01,  Narayanpur,382,363,186,186,196,177,51.3,50.0,52.5,00000
82.0,7.0,47.0,733,02,01,  Sekara,323,347,154,161,169,186,48.2,48.9,47.6,00000
82.0,7.0,47.0,829,01,01,  Purba Rajdharpur,224,198,106,95,118,103,53.1,52.7,53.4,00000
82.0,7.0,47.0,829,02,01,  Paschim Rajdharpur,222,188,116,88,106,100,54.1,56.9,51.5,00000
82.0,7.0,47.0,829,03,01,  Rajdharpur Molla Para,248,128,113,67,135,61,66.0,62.8,68.9,00000
82.0,7.0,47.0,829,04,01,  Alikhar Para,130,104,60,45,70,59,55.6,57.1,54.3,00000
82.0,7.0,47.0,829,05,01,  Bari Chhara,53,84,25,51,28,33,38.7,32.9,45.9,00000
82.0,7.0,47.0,829,06,01,  Sreeramkandi,377,327,190,167,187,160,53.6,53.2,53.9,00000
82.0,7.0,47.0,829,07,01,  Baunara,104,51,47,30,57,21,67.1,61.0,73.1,00000
82.0,7.0,47.0,959,01,01,  Tenai,250,141,122,74,128,67,63.9,62.2,65.6,00000
82.0,7.0,47.0,959,02,01,  Barai Tenai,164,102,83,53,81,49,61.7,61.0,62.3,00000
82.0,7.0,57.0,472,01,01,  Gosai Gobindapur,571,604,285,301,286,303,48.6,48.6,48.6,00000
82.0,7.0,57.0,472,02,01,  Sholakura,247,285,118,145,129,140,46.4,44.9,48.0,00000
82.0,7.0,57.0,663,01,01,  Lakshmandia,774,466,426,213,348,253,62.4,66.7,57.9,00000
82.0,7.0,57.0,663,02,01,  Masalia,420,235,231,106,189,129,64.1,68.5,59.4,00000
82.0,7.0,57.0,663,03,01,  Bagchidanga,312,304,151,153,161,151,50.6,49.7,51.6,00000
82.0,7.0,57.0,718,01,01,  Nalia,577,305,304,142,273,163,65.4,68.2,62.6,00000
82.0,7.0,57.0,718,02,01,  Sabni Para,287,163,145,75,142,88,63.8,65.9,61.7,00000
82.0,7.0,66.0,055,01,01,  Bahar Sadhukhali,199,454,101,218,98,236,30.5,31.7,29.3,00000
82.0,7.0,66.0,055,02,01,  Aksukna,213,340,128,153,85,187,38.5,45.6,31.3,00000
82.0,7.0,66.0,055,03,01,  Basukhali,165,208,83,105,82,103,44.2,44.1,44.3,00000
82.0,7.0,66.0,140,01,01,  Bara Janjal,47,69,22,33,25,36,40.5,40.0,41.0,00000
82.0,7.0,66.0,140,02,01,  Natun Gurguria,556,418,299,195,257,223,57.1,60.5,53.5,00000
82.0,7.0,66.0,557,01,01,  Janjal,1273,892,729,376,544,516,58.8,66.0,51.3,00000
82.0,7.0,66.0,557,02,01,  Donikhali,283,223,150,112,133,111,55.9,57.3,54.5,00000
82.0,7.0,66.0,557,03,01,  Khaguria,32,11,21,2,11,9,74.4,91.3,55.0,00000
82.0,7.0,66.0,557,04,01,  Alankarpur,970,439,481,200,489,239,68.8,70.6,67.2,00000
82.0,7.0,66.0,557,05,01,  Bablatala,28,10,21,4,7,6,73.7,84.0,53.8,00000
82.0,7.0,66.0,557,06,01,  Chapalbagha,28,11,10,6,18,5,71.8,62.5,78.3,00000
82.0,7.0,66.0,557,07,01,  Gangasagar,233,207,131,86,102,121,53.0,60.4,45.7,00000
82.0,7.0,66.0,557,08,01,  Khalilpur,37,16,15,7,22,9,69.8,68.2,71.0,00000
82.0,7.0,66.0,804,01,01,  Ag Potra,539,724,305,350,234,374,42.7,46.6,38.5,00000
82.0,7.0,66.0,804,02,01,  Char Potra,337,360,176,176,161,184,48.4,50.0,46.7,00000
82.0,7.0,66.0,804,03,01,  Pachh Potra,249,301,136,146,113,155,45.3,48.2,42.2,00000
82.0,7.0,66.0,804,04,01,  Taralia,230,257,130,115,100,142,47.2,53.1,41.3,00000
82.0,7.0,66.0,804,05,01,  Habaspur,247,85,140,25,107,60,74.4,84.8,64.1,00000
82.0,7.0,66.0,819,01,01,  Push Amla,404,273,244,114,160,159,59.7,68.2,50.2,00000
82.0,7.0,66.0,819,02,01,  Samadhinagar,241,128,148,49,93,79,65.3,75.1,54.1,00000
82.0,7.0,66.0,819,03,01,  Bijoynagar,22,40,11,20,11,20,35.5,35.5,35.5,00000
82.0,7.0,66.0,939,01,01,  Sukna,258,156,146,62,112,94,62.3,70.2,54.4,00000
82.0,7.0,66.0,939,02,01,  Abhaynagar,150,175,80,90,70,85,46.2,47.1,45.2,00000
82.0,7.0,66.0,939,03,01,  Maharajpur,216,141,109,72,107,69,60.5,60.2,60.8,00000
82.0,7.0,66.0,939,04,01,  Purana Ghurghuria,595,371,327,163,268,208,61.6,66.7,56.3,00000
82.0,7.0,85.0,130,01,01,  Ghikamal,816,827,416,391,400,436,49.7,51.5,47.8,00000
82.0,7.0,85.0,130,02,01,  Patkia Bari,834,769,423,385,411,384,52.0,52.4,51.7,00000
82.0,7.0,85.0,130,03,01,  Char Ghikamal,446,410,226,210,220,200,52.1,51.8,52.4,00000
82.0,7.0,85.0,130,04,01,  Marabila,353,667,160,348,193,319,34.6,31.5,37.7,00000
82.0,7.0,85.0,130,05,01,  Taluk Para,154,91,75,46,79,45,62.9,62.0,63.7,00000
82.0,7.0,85.0,130,06,01,  Khateagara,177,151,96,62,81,89,54.0,60.8,47.6,00000
82.0,7.0,85.0,231,01,01,  Bil Dhamu,870,631,439,299,431,332,58.0,59.5,56.5,00000
82.0,7.0,85.0,231,02,01,  Char Bil Dhamu,127,145,76,57,51,88,46.7,57.1,36.7,00000
82.0,7.0,85.0,266,01,01,  Bil Taka Para,754,396,379,188,375,208,65.6,66.8,64.3,00000
82.0,7.0,85.0,266,02,01,  Char Taka Para,125,103,68,44,57,59,54.8,60.7,49.1,00000
82.0,7.0,85.0,366,01,01,  Delua,144,135,72,61,72,74,51.6,54.1,49.3,00000
82.0,7.0,85.0,366,02,01,  Adachaki,10,21,5,12,5,9,32.3,29.4,35.7,00000
82.0,7.0,85.0,366,03,01,  Dhauarghat,15,7,8,4,7,3,68.2,66.7,70.0,00000
82.0,7.0,85.0,447,01,01,  Garakola,522,289,255,127,267,162,64.4,66.8,62.2,00000
82.0,7.0,85.0,447,02,01,  Baordaha,43,25,25,15,18,10,63.2,62.5,64.3,00000
82.0,7.0,85.0,447,03,01,  Chapal Bagha,76,31,36,16,40,15,71.0,69.2,72.7,00000
82.0,7.0,85.0,447,04,01,  Sonakadar,342,327,169,150,173,177,51.1,53.0,49.4,00000
82.0,7.0,85.0,909,01,01,  Sholabaria,428,215,229,89,199,126,66.6,72.0,61.2,00000
82.0,7.0,85.0,909,02,01,  Bil Malenga,173,87,74,41,99,46,66.5,64.3,68.3,00000
82.0,7.0,85.0,909,03,01,  Par Sholabaria,236,205,131,101,105,104,53.5,56.5,50.2,00000
82.0,7.0,85.0,994,01,01,  Uttar Salmara,30,57,11,28,19,29,34.5,28.2,39.6,00000
82.0,7.0,85.0,994,02,01,  Bil Hijli,64,81,38,36,26,45,44.1,51.4,36.6,00000
82.0,7.0,95.0,125,01,01,  Garia Para,166,113,85,59,81,54,59.5,59.0,60.0,00000
82.0,7.0,95.0,125,02,01,  Sikdar Para,115,119,54,57,61,62,49.1,48.6,49.6,00000
82.0,7.0,95.0,125,03,01,  Elangir Para,178,177,95,90,83,87,50.1,51.4,48.8,00000
82.0,7.0,95.0,135,01,01,  Char Para,321,334,170,162,151,172,49.0,51.2,46.7,00000
82.0,7.0,95.0,135,02,01,  Danga Para,309,259,145,130,164,129,54.4,52.7,56.0,00000
82.0,7.0,95.0,135,03,01,  Mollah Para,563,268,290,126,273,142,67.7,69.7,65.8,00000
82.0,7.0,95.0,135,04,01,  Senpara,153,123,80,61,73,62,55.4,56.7,54.1,00000
82.0,7.0,95.0,180,01,01,  Salda Para,466,425,251,215,215,210,52.3,53.9,50.6,00000
82.0,7.0,95.0,180,02,01,  Purba Saheb Para,281,160,142,73,139,87,63.7,66.0,61.5,00000
82.0,7.0,95.0,180,03,01,  Paschim Saheb Para,239,249,129,118,110,131,49.0,52.2,45.6,00000
82.0,7.0,95.0,180,04,01,  Jialagari,443,375,228,180,215,195,54.2,55.9,52.4,00000
82.0,7.0,95.0,180,05,01,  Tekati,467,385,238,186,229,199,54.8,56.1,53.5,00000
82.0,7.0,95.0,356,01,01,  Dakshinbari,878,549,435,253,443,296,61.5,63.2,59.9,00000
82.0,7.0,95.0,356,02,01,  Baghmara,332,217,169,103,163,114,60.5,62.1,58.8,00000
82.0,7.0,95.0,356,03,01,  Sitaldaha,255,125,133,54,122,71,67.1,71.1,63.2,00000
82.0,7.0,95.0,356,04,01,  Mechhuaghata,614,238,284,106,330,132,72.1,72.8,71.4,00000
82.0,7.0,95.0,356,05,01,  Bakshibari,741,566,368,277,373,289,56.7,57.1,56.3,00000
82.0,7.0,95.0,356,06,01,  Char Dakshinbari,534,460,292,214,242,246,53.7,57.7,49.6,00000
82.0,7.0,95.0,356,07,01,  Baldakhal,103,258,47,121,56,137,28.5,28.0,29.0,00000
82.0,7.0,95.0,356,08,01,  Goal Para,335,179,154,98,181,81,65.2,61.1,69.1,00000
82.0,7.0,95.0,522,01,01,  Indurdi,623,443,310,231,313,212,58.4,57.3,59.6,00000
82.0,7.0,95.0,522,02,01,  Char Indurdi,551,319,277,156,274,163,63.3,64.0,62.7,00000
82.0,7.0,95.0,658,01,01,  Kursi,624,523,300,259,324,264,54.4,53.7,55.1,00000
82.0,7.0,95.0,658,02,01,  Jahaudangi,152,122,68,64,84,58,55.5,51.5,59.2,00000
82.0,7.0,95.0,763,01,01,  Kuri Para,241,201,134,86,107,115,54.5,60.9,48.2,00000
82.0,7.0,95.0,763,02,01,  Gang Char,494,420,237,193,257,227,54.0,55.1,53.1,00000
82.0,7.0,95.0,763,03,01,  Thakur Para,388,235,204,107,184,128,62.3,65.6,59.0,00000
82.0,7.0,95.0,763,04,01,  Doppara,445,557,228,275,217,282,44.4,45.3,43.5,00000
82.0,7.0,95.0,763,05,01,  Paschimpara,493,286,235,127,258,159,63.3,64.9,61.9,00000
82.0,7.0,95.0,763,06,01,  Uttar Ghoramara,389,370,192,188,197,182,51.3,50.5,52.0,00000
82.0,7.0,95.0,763,07,01,  Dakshin Ghoramara,201,180,94,93,107,87,52.8,50.3,55.2,00000
82.0,7.0,95.0,763,08,01,  Dublabari,292,163,139,77,153,86,64.2,64.4,64.0,00000
82.0,7.0,95.0,763,09,01,  Hogladangi,256,200,112,111,144,89,56.1,50.2,61.8,00000
82.0,7.0,95.0,763,10,01,  Karchadangi,187,129,104,60,83,69,59.2,63.4,54.6,00000
82.0,7.0,95.0,929,01,01,  Kamardaha,373,269,183,135,190,134,58.1,57.5,58.6,00000
82.0,7.0,95.0,929,02,01,  Paschim Sonapur,852,535,434,244,418,291,61.4,64.0,59.0,00000
82.0,7.0,95.0,929,03,01,  Purba Sonapur,762,521,397,240,365,281,59.4,62.3,56.5,00000
82.0,7.0,95.0,929,04,01,  Char Dakshinbari,331,154,159,77,172,77,68.2,67.4,69.1,00000
82.0,29.0,19.0,179,01,01,  Bishnupur,309,260,153,120,156,140,54.3,56.0,52.7,00000
82.0,29.0,19.0,179,02,01,  Char Aliel,274,166,125,76,149,90,62.3,62.2,62.3,00000
82.0,29.0,38.0,285,01,01,  Hussain Mollargram,89,246,42,125,47,121,26.6,25.1,28.0,00000
82.0,29.0,38.0,285,02,01,  Naimuddin Khargram,50,165,29,89,21,76,23.3,24.6,21.6,00000
82.0,29.0,38.0,285,03,01,  Dulal Beparigram,33,108,20,58,13,50,23.4,25.6,20.6,00000
82.0,29.0,38.0,285,04,01,  Zafar Sarderar,41,122,26,63,15,59,25.2,29.2,20.3,00000
82.0,29.0,38.0,285,05,01,  Ainuddin Pramanikgram,93,247,49,127,44,120,27.4,27.8,26.8,00000
82.0,29.0,38.0,285,06,01,  Mozzafar Mollargram,7,115,4,62,3,53,5.7,6.1,5.4,00000
82.0,29.0,38.0,285,07,01,  A.Aziz Mirdhargram,37,103,14,60,23,43,26.4,18.9,34.8,00000
82.0,29.0,38.0,285,08,01,  Madhab Baruergram,40,80,24,35,16,45,33.3,40.7,26.2,00000
82.0,29.0,38.0,285,09,01,  Abdul Khaleque Mollargram,30,177,14,92,16,85,14.5,13.2,15.8,00000
82.0,29.0,38.0,285,10,01,  Parashullar,10,231,5,127,5,104,4.1,3.8,4.6,00000
82.0,29.0,38.0,285,11,01,  Tamimzuddin Mollargram,121,256,57,137,64,119,32.1,29.4,35.0,00000
82.0,29.0,38.0,285,12,01,  Khepu Sarder Gram,36,75,19,39,17,36,32.4,32.8,32.1,00000
82.0,29.0,38.0,285,13,01,  Umed Ali Sarderer,46,51,26,26,20,25,47.4,50.0,44.4,00000
82.0,29.0,38.0,285,14,01,  Rukman Sarderer,54,229,17,116,37,113,19.1,12.8,24.7,00000
82.0,29.0,38.0,285,15,01,  Rokan Bepary,108,231,56,119,52,112,31.9,32.0,31.7,00000
82.0,29.0,38.0,285,16,01,  Somir Mridhargram,40,92,21,41,19,51,30.3,33.9,27.1,00000
82.0,29.0,38.0,285,17,01,  Tasir Matbarergram,176,324,93,154,83,170,35.2,37.7,32.8,00000
82.0,29.0,38.0,285,18,01,  Kitabdi Mollargram,82,157,42,73,40,84,34.3,36.5,32.3,00000
82.0,29.0,38.0,285,19,01,  Juran Mollar Gram,15,47,7,25,8,22,24.2,21.9,26.7,00000
82.0,29.0,38.0,285,20,01,  Hakim Ali Sarkargram,71,141,33,72,38,69,33.5,31.4,35.5,00000
82.0,29.0,38.0,285,21,01,  Ansar Majhirgram,39,85,22,47,17,38,31.5,31.9,30.9,00000
82.0,29.0,38.0,476,01,01,  Jadu Fakirergram,347,349,180,161,167,188,49.9,52.8,47.0,00000
82.0,29.0,38.0,476,02,01,  Torab Sardarergram,129,284,55,144,74,140,31.2,27.6,34.6,00000
82.0,29.0,38.0,476,03,01,  Adu Beparirgram,140,326,59,178,81,148,30.0,24.9,35.4,00000
82.0,29.0,38.0,476,04,01,  Wahed Shekher Gram,16,139,6,61,10,78,10.3,9.0,11.4,00000
82.0,29.0,38.0,476,05,01,  Ansar Beparirgram,16,44,10,19,6,25,26.7,34.5,19.4,00000
82.0,29.0,38.0,476,06,01,  Saidullargram,215,573,118,266,97,307,27.3,30.7,24.0,00000
82.0,29.0,38.0,476,07,01,  Siraj Khargram,138,203,82,99,56,104,40.5,45.3,35.0,00000
82.0,29.0,38.0,476,08,01,  Ishaq Mansurgram,39,81,20,37,19,44,32.5,35.1,30.2,00000
82.0,29.0,38.0,476,09,01,  Minaz Uddin Seaker Gram,12,185,6,92,6,93,6.1,6.1,6.1,00000
82.0,29.0,38.0,476,10,01,  Jitu Sardaergram,110,223,63,109,47,114,33.0,36.6,29.2,00000
82.0,29.0,38.0,476,11,01,  Ainal Mollargram,62,217,32,106,30,111,22.2,23.2,21.3,00000
82.0,29.0,38.0,476,12,01,  Tumser Matbarergram,62,70,25,35,37,35,47.0,41.7,51.4,00000
82.0,29.0,38.0,476,13,01,  Nabulla Beparirgram,142,223,67,96,75,127,38.9,41.1,37.1,00000
82.0,29.0,38.0,613,01,01,  Sreedham Matbarergram,14,113,9,52,5,61,11.0,14.8,7.6,00000
82.0,29.0,38.0,613,02,01,  Anath Sardarergram,34,110,20,53,14,57,23.6,27.4,19.7,00000
82.0,29.0,38.0,942,01,01,  Kaimuddin Mondalergram,127,216,70,101,57,115,37.0,40.9,33.1,00000
82.0,29.0,38.0,942,02,01,  Nahari Mondalergram,171,248,90,120,81,128,40.8,42.9,38.8,00000
82.0,29.0,38.0,942,03,01,  Hatem Mondalergram,126,399,74,203,52,196,24.0,26.7,21.0,00000
82.0,29.0,38.0,942,04,01,  Dholla Para,201,569,122,273,79,296,26.1,30.9,21.1,00000
82.0,29.0,38.0,942,05,01,  Nallu Mandalergram,73,189,36,99,37,90,27.9,26.7,29.1,00000
82.0,29.0,38.0,942,06,01,  Shahajuddin Beparigram,146,259,70,120,76,139,36.0,36.8,35.3,00000
82.0,29.0,38.0,942,07,01,  1 No.Bepari Para,257,324,151,145,106,179,44.2,51.0,37.2,00000
82.0,29.0,38.0,942,08,01,  2 No.Bepari Para,249,227,120,108,129,119,52.3,52.6,52.0,00000
82.0,29.0,38.0,942,09,01,  Lukman Chaimanergram,133,69,78,30,55,39,65.8,72.2,58.5,00000
82.0,29.0,38.0,942,10,01,  Barkat Sardarergram,391,264,176,125,215,139,59.7,58.5,60.7,00000
82.0,29.0,38.0,942,11,01,  Sona Fakirergram,252,344,139,161,113,183,42.3,46.3,38.2,00000
82.0,29.0,38.0,942,12,01,  Gafur Mollargram,209,541,114,262,95,279,27.9,30.3,25.4,00000
82.0,29.0,38.0,942,13,01,  Idrish Sheker Gram,70,280,47,134,23,146,20.0,26.0,13.6,00000
82.0,29.0,38.0,942,14,01,  Madrasha Para,169,261,86,106,83,155,39.3,44.8,34.9,00000
82.0,29.0,38.0,942,15,01,  B.I.W.T.A. Terminal,80,18,68,8,12,10,81.6,89.5,54.5,00000
82.0,29.0,38.0,942,16,01,  Daulatdia Bazar,185,315,112,103,73,212,37.0,52.1,25.6,00000
82.0,29.0,38.0,942,17,01,  Pros Quarter,74,1398,18,47,56,1351,5.0,27.7,4.0,00000
82.0,29.0,38.0,942,18,01,  Maher Mandalergram,124,298,58,142,66,156,29.4,29.0,29.7,00000
82.0,29.0,38.0,942,19,01,  Kuti Mollargram,68,241,43,118,25,123,22.0,26.7,16.9,00000
82.0,29.0,38.0,942,20,01,  Hossain Mandalergram,429,676,232,330,197,346,38.8,41.3,36.3,00000
82.0,29.0,38.0,942,21,01,  Taher Kazirgram,161,371,80,186,81,185,30.3,30.1,30.5,00000
82.0,29.0,38.0,942,22,01,  Jalil Sardarergram,166,250,100,120,66,130,39.9,45.5,33.7,00000
82.0,29.0,38.0,942,23,01,  Sohrab Mandalergram,52,420,21,223,31,197,11.0,8.6,13.6,00000
82.0,29.0,38.0,942,24,01,  Anu Matbarergram,130,244,64,128,66,116,34.8,33.3,36.3,00000
82.0,29.0,38.0,942,25,01,  Hatat Para,92,459,52,225,40,234,16.7,18.8,14.6,00000
82.0,29.0,38.0,942,26,01,  Mangal Sarderer Gram,270,363,152,180,118,183,42.7,45.8,39.2,00000
82.0,29.0,38.0,942,27,01,  Nasir Sarder Gram,157,276,84,129,73,147,36.3,39.4,33.2,00000
82.0,29.0,38.0,942,28,01,  Umer Ali Mollar Gram,378,444,201,209,177,235,46.0,49.0,43.0,00000
82.0,29.0,38.0,942,29,01,  Falumollar Gram,141,282,75,147,66,135,33.3,33.8,32.8,00000
82.0,29.0,38.0,942,30,01,  Rostam Mollar Gram,34,63,18,33,16,30,35.1,35.3,34.8,00000
82.0,29.0,76.0,518,01,03,  Bahadurpur,723,569,336,239,387,330,56.0,58.4,54.0,00000
82.0,29.0,76.0,518,02,03,  Mansur Khapara,128,155,53,78,75,77,45.2,40.5,49.3,00000
82.0,29.0,76.0,518,03,03,  Mangalpur,142,377,56,164,86,213,27.4,25.5,28.8,00000
82.0,29.0,76.0,518,04,03,  Maizuddin Mollah Para,203,239,95,106,108,133,45.9,47.3,44.8,00000
82.0,29.0,76.0,518,05,03,  Sabdul Khar Para,215,172,116,74,99,98,55.6,61.1,50.3,00000
82.0,29.0,76.0,518,06,03,  M.Dorajtullah Mridha Para,92,141,44,74,48,67,39.5,37.3,41.7,00000
82.0,29.0,76.0,518,07,03,  Maizuddin Mandal Para,296,336,145,155,151,181,46.8,48.3,45.5,00000
82.0,29.0,76.0,518,08,03,  Makhan Babur Char,95,155,40,83,55,72,38.0,32.5,43.3,00000
82.0,29.0,76.0,518,09,03,  Nasher Matbar Para,107,276,59,140,48,136,27.9,29.6,26.1,00000
82.0,29.0,76.0,804,01,01,  Sreedam Datter Para,458,209,241,89,217,120,68.7,73.0,64.4,00000
82.0,29.0,76.0,804,02,01,  Kasimuddiner Sarkar Para,154,174,81,74,73,100,47.0,52.3,42.2,00000
82.0,29.0,76.0,804,03,01,  Januki Royer Para,56,136,23,58,33,78,29.2,28.4,29.7,00000
82.0,29.0,76.0,804,04,01,  Harej Matbar Para,181,116,84,54,97,62,60.9,60.9,61.0,00000
82.0,29.0,76.0,804,05,01,  Ramjan Matbar Para,684,576,358,258,326,318,54.3,58.1,50.6,00000
82.0,29.0,76.0,804,06,01,  Nabu Ashimuddin Para,533,608,286,281,247,327,46.7,50.4,43.0,00000
82.0,29.0,76.0,804,07,01,  Bishwambar Kabiraj Para,15,29,6,13,9,16,34.1,31.6,36.0,00000
82.0,29.0,76.0,804,08,01,  Bishwanather Para,79,157,38,77,41,80,33.5,33.0,33.9,00000
82.0,29.0,76.0,804,09,01,  M.Derajtullah Mridhar Para,444,337,229,151,215,186,56.9,60.3,53.6,00000
82.0,29.0,76.0,804,10,01,  Reajuddin Matbar Para,244,283,130,123,114,160,46.3,51.4,41.6,00000
82.0,29.0,76.0,804,11,01,  Paschim Baliadangi,204,368,94,180,110,188,35.7,34.3,36.9,00000
82.0,29.0,76.0,836,01,01,  Haji Dudukhardangi,413,543,202,274,211,269,43.2,42.4,44.0,00000
82.0,29.0,76.0,836,02,01,  Sahajuddin Matbar Para,266,296,130,145,136,151,47.3,47.3,47.4,00000
82.0,29.0,76.0,836,03,01,  Jainuddin Sardar Para,277,357,145,164,132,193,43.7,46.9,40.6,00000
82.0,29.0,76.0,836,04,01,  Saher Mandal Para,341,450,174,213,167,237,43.1,45.0,41.3,00000
82.0,29.0,76.0,836,05,01,  Gafur Matbar Para,255,287,127,138,128,149,47.0,47.9,46.2,00000
82.0,29.0,76.0,836,06,01,  Daraperdangi,232,410,131,193,101,217,36.1,40.4,31.8,00000
82.0,29.0,76.0,836,07,01,  Bakartila,297,391,151,197,146,194,43.2,43.4,42.9,00000
82.0,29.0,76.0,836,08,01,  Jatin Baidyer Para,260,223,136,104,124,119,53.8,56.7,51.0,00000
82.0,29.0,76.0,836,09,01,  Nalia Para,318,331,161,155,157,176,49.0,50.9,47.1,00000
82.0,29.0,76.0,836,10,01,  Faizuddin Matbar Para,132,312,84,151,48,161,29.7,35.7,23.0,00000
82.0,29.0,76.0,836,11,01,  Omed Ali Bepari Para,71,260,32,140,39,120,21.5,18.6,24.5,00000
82.0,29.0,76.0,836,12,01,  Ghani Matbar Para,75,452,39,216,36,236,14.2,15.3,13.2,00000
82.0,29.0,76.0,836,13,01,  Haji Abdul Gafur Mandal Para,232,970,109,477,123,493,19.3,18.6,20.0,00000
82.0,29.0,76.0,836,14,01,  Bholai Matbar Para,138,278,68,148,70,130,33.2,31.5,35.0,00000
82.0,29.0,76.0,836,15,01,  Habil Mandal Para,362,646,175,304,187,342,35.9,36.5,35.3,00000
82.0,29.0,76.0,994,01,03,  Makkon Royer Para,101,168,50,74,51,94,37.5,40.3,35.2,00000
82.0,29.0,76.0,994,02,03,  Natun Para,292,727,138,389,154,338,28.7,26.2,31.3,00000
82.0,47.0,70.0,083,01,01,  Bara Kalkalia,848,1009,418,505,430,504,45.7,45.3,46.0,00000
82.0,47.0,70.0,083,02,01,  Hogla Dangi,569,336,296,165,273,171,62.9,64.2,61.5,00000
82.0,47.0,70.0,893,01,01,  Sarba Kultia,154,182,77,90,77,92,45.8,46.1,45.6,00000
82.0,47.0,70.0,893,02,01,  Saestapur,244,189,123,90,121,99,56.4,57.7,55.0,00000
82.0,47.0,95.0,151,01,01,  Bhiti,644,607,327,307,317,300,51.5,51.6,51.4,00000
82.0,47.0,95.0,151,02,01,  Bila Dangi,181,108,91,52,90,56,62.6,63.6,61.6,00000
82.0,73.0,20.0,243,01,01,  Char Jhikiri,2732,4394,1384,2136,1348,2258,38.3,39.3,37.4,00000
82.0,73.0,20.0,243,02,01,  Kacharipara,1039,1490,502,756,537,734,41.1,39.9,42.3,00000
82.0,73.0,35.0,060,01,01,  Bonogram,508,645,267,285,241,360,44.1,48.4,40.1,00000
82.0,73.0,35.0,060,02,01,  Uttar Bangram,63,146,26,78,37,68,30.1,25.0,35.2,00000
82.0,73.0,35.0,098,01,01,  Basa Kushtia,246,433,131,200,115,233,36.2,39.6,33.0,00000
82.0,73.0,35.0,098,02,01,  Dakhin Basa Kustia,123,232,68,111,55,121,34.6,38.0,31.3,00000
82.0,73.0,35.0,098,03,01,  Badna Bhanga,154,260,75,133,79,127,37.2,36.1,38.3,00000
82.0,73.0,35.0,521,01,01,  Kalimahar,944,845,490,372,454,473,52.8,56.8,49.0,00000
82.0,73.0,35.0,521,02,01,  Char Kalimohor,158,177,76,81,82,96,47.2,48.4,46.1,00000
82.0,73.0,35.0,521,03,01,  Uttar Kalimohor,66,43,40,15,26,28,60.6,72.7,48.1,00000
82.0,73.0,35.0,713,01,01,  Nachana,411,354,205,164,206,190,53.7,55.6,52.0,00000
82.0,73.0,35.0,713,02,01,  Muradpur,108,204,58,98,50,106,34.6,37.2,32.1,00000
82.0,73.0,35.0,870,01,01,  Sajuria,346,537,202,253,144,284,39.2,44.4,33.6,00000
82.0,73.0,35.0,870,02,01,  Char Sajuria,289,394,142,202,147,192,42.3,41.3,43.4,00000
82.0,73.0,40.0,554,01,01,  Kasba Majhail,806,490,391,238,415,252,62.2,62.2,62.2,00000
82.0,73.0,40.0,554,02,01,  Notabhanga,843,825,451,416,392,409,50.5,52.0,48.9,00000
82.0,73.0,40.0,711,01,01,  Nabradaha,359,293,177,151,182,142,55.1,54.0,56.2,00000
82.0,73.0,40.0,711,02,01,  Daribanglat,101,174,55,72,46,102,36.7,43.3,31.1,00000
82.0,73.0,50.0,635,01,01,  Machh Para,516,399,267,184,249,215,56.4,59.2,53.7,00000
82.0,73.0,50.0,635,02,01,  Kalinagar,406,369,211,166,195,203,52.4,56.0,49.0,00000
82.0,73.0,50.0,691,01,01,  Eghna Khamar Para,745,832,379,397,366,435,47.2,48.8,45.7,00000
82.0,73.0,50.0,691,02,01,  Birampur,233,312,110,148,123,164,42.8,42.6,42.9,00000
82.0,73.0,50.0,843,01,01,  Ramkole,448,196,229,84,219,112,69.6,73.2,66.2,00000
82.0,73.0,50.0,843,02,01,  Bahadurpur,567,394,295,181,272,213,59.0,62.0,56.1,00000
82.0,73.0,65.0,081,01,01,  Bara Chaubaria,665,713,356,357,309,356,48.3,49.9,46.5,00000
82.0,73.0,65.0,081,02,01,  Mahis Bhanga,372,331,184,158,188,173,52.9,53.8,52.1,00000
82.0,73.0,75.0,767,01,01,  Babupara,290,453,154,227,136,226,39.0,40.4,37.6,00000
82.0,73.0,75.0,767,02,01,  Char Para,361,373,190,179,171,194,49.2,51.5,46.8,00000
82.0,73.0,75.0,767,03,01,  Bhatra Charjipara,359,340,194,167,165,173,51.4,53.7,48.8,00000
82.0,73.0,75.0,767,04,01,  Lasker Para,166,166,91,74,75,92,50.0,55.2,44.9,00000
82.0,73.0,75.0,767,05,01,  Baliapara,302,90,158,45,144,45,77.0,77.8,76.2,00000
82.0,73.0,75.0,767,06,01,  Kuri Para,339,243,197,108,142,135,58.2,64.6,51.3,00000
82.0,73.0,75.0,767,07,01,  Chand Pur,487,445,250,219,237,226,52.3,53.3,51.2,00000
82.0,73.0,80.0,706,01,01,  Muchidaha,567,404,302,192,265,212,58.4,61.1,55.6,00000
82.0,73.0,80.0,706,02,01,  Khamardangi,370,329,180,154,190,175,52.9,53.9,52.1,00000
82.0,73.0,80.0,706,03,01,  Hamuapar,104,349,64,178,40,171,23.0,26.4,19.0,00000
82.0,73.0,90.0,896,01,01,  Bahaladanga,1706,2398,863,1177,843,1221,41.6,42.3,40.8,00000
82.0,73.0,90.0,896,02,01,  Bil Padmia,246,211,121,95,125,116,53.8,56.0,51.9,00000
82.0,73.0,90.0,896,03,01,  Khama Dangi,367,441,194,207,173,234,45.4,48.4,42.5,00000
82.0,73.0,90.0,896,04,01,  Baghar Char,195,223,94,102,101,121,46.7,48.0,45.5,00000
82.0,73.0,90.0,896,05,01,  Adhar Kota,35,62,17,28,18,34,36.1,37.8,34.6,00000
82.0,73.0,90.0,896,06,01,  Shak Para,123,158,72,76,51,82,43.8,48.6,38.3,00000
82.0,73.0,90.0,896,07,01,  Pirali Para,188,219,89,98,99,121,46.2,47.6,45.0,00000
82.0,73.0,90.0,896,08,01,  Paler Dangi,361,375,194,172,167,203,49.0,53.0,45.1,00000
82.0,73.0,90.0,896,09,01,  Sarisha,602,590,329,277,273,313,50.5,54.3,46.6,00000
82.0,76.0,21.0,168,01,01,  Char Para,309,194,144,90,165,104,61.4,61.5,61.3,00000
82.0,76.0,21.0,168,02,01,  Purba Bhabadia,926,760,455,339,471,421,54.9,57.3,52.8,00000
82.0,76.0,21.0,168,03,01,  Paschim Bhabadia,721,771,349,370,372,401,48.3,48.5,48.1,00000
82.0,76.0,21.0,168,04,01,  Aminpur,120,303,60,144,60,159,28.4,29.4,27.4,00000
82.0,76.0,32.0,496,01,01,  Jaukura,926,936,473,433,453,503,49.7,52.2,47.4,00000
82.0,76.0,32.0,496,02,01,  Dhaua Para,497,686,251,345,246,341,42.0,42.1,41.9,00000
82.0,76.0,45.0,458,01,01,  Hatbaria,603,742,317,357,286,385,44.8,47.0,42.6,00000
82.0,76.0,45.0,458,02,01,  Olipur,206,171,123,75,83,96,54.6,62.1,46.4,00000
82.0,76.0,45.0,458,03,01,  Shibtala,143,192,59,101,84,91,42.7,36.9,48.0,00000
82.0,76.0,80.0,163,01,01,  Bethulia,1581,1786,751,858,830,928,47.0,46.7,47.2,00000
82.0,76.0,80.0,163,02,01,  Kazibadha,439,331,208,148,231,183,57.0,58.4,55.8,00000
82.0,76.0,94.0,918,01,01,  Par Sailkati,486,156,246,60,240,96,75.7,80.4,71.4,00000
82.0,76.0,94.0,918,02,01,  Sailkati,656,565,348,260,308,305,53.7,57.2,50.2,00000
82.0,76.0,94.0,918,03,01,  Shyamnagar,474,118,244,47,230,71,80.1,83.8,76.4,00000
61.0,13.0,17.0,880,01,01,  Purura,2079,2304,1089,1087,990,1217,47.4,50.0,44.9,00000
61.0,13.0,17.0,880,02,01,  Chaparbari,593,372,308,166,285,206,61.5,65.0,58.0,00000
61.0,13.0,43.0,834,01,01,  Panihadi,397,643,208,301,189,342,38.2,40.9,35.6,00000
61.0,13.0,43.0,834,02,01,  Nayabhita,76,106,38,54,38,52,41.8,41.3,42.2,00000
61.0,13.0,43.0,903,01,01,  Randhia,1003,1112,494,527,509,585,47.4,48.4,46.5,00000
61.0,13.0,43.0,903,02,01,  Dhulia,2382,2474,1172,1180,1210,1294,49.1,49.8,48.3,00000
61.0,13.0,60.0,468,01,01,  Kachina,2991,3363,1531,1543,1460,1820,47.1,49.8,44.5,00000
61.0,13.0,60.0,468,02,01,  Kawnia,354,341,190,161,164,180,50.9,54.1,47.7,00000
61.0,13.0,60.0,480,01,01,  Kadigar,822,1401,411,668,411,733,37.0,38.1,35.9,00000
61.0,13.0,60.0,480,02,01,  Talabo,1220,1281,604,633,616,648,48.8,48.8,48.7,00000
61.0,13.0,60.0,789,01,01,  Palgaon,1734,2833,872,1278,862,1555,38.0,40.6,35.7,00000
61.0,13.0,60.0,789,02,01,  Tamat,2460,3971,1245,1843,1215,2128,38.3,40.3,36.3,00000
61.0,13.0,69.0,137,01,03,  Bhandabo,1518,1298,753,655,765,643,53.9,53.5,54.3,00000
61.0,13.0,69.0,137,02,03,  Dhayrapara,636,470,347,236,289,234,57.5,59.5,55.3,00000
61.0,13.0,69.0,137,03,03,  Boytapara,485,695,238,338,247,357,41.1,41.3,40.9,00000
61.0,13.0,69.0,308,01,03,  Dhamsur,1743,2550,874,1241,869,1309,40.6,41.3,39.9,00000
61.0,13.0,69.0,308,02,03,  Mamarishpur,2104,2373,1132,1170,972,1203,47.0,49.2,44.7,00000
61.0,13.0,69.0,308,03,03,  Gadomia,715,481,421,230,294,251,59.8,64.7,53.9,00000
61.0,13.0,69.0,308,04,03,  Akhalia,1427,1343,828,639,599,704,51.5,56.4,46.0,00000
61.0,13.0,69.0,629,01,01,  Mallikbari,2129,2596,1009,1281,1120,1315,45.1,44.1,46.0,00000
61.0,13.0,69.0,629,02,01,  Nayanpur,2037,3551,998,1707,1039,1844,36.5,36.9,36.0,00000
61.0,13.0,69.0,949,01,01,  Satenga,1145,1679,589,823,556,856,40.5,41.7,39.4,00000
61.0,13.0,69.0,949,02,01,  Barta,1077,1598,534,795,543,803,40.3,40.2,40.3,00000
61.0,13.0,77.0,102,01,01,  Bandia,1217,821,622,383,595,438,59.7,61.9,57.6,00000
61.0,13.0,77.0,102,02,01,  Nijhuri,293,493,141,236,152,257,37.3,37.4,37.2,00000
61.0,13.0,77.0,606,01,01,  Boraid,1249,1094,626,509,623,585,53.3,55.2,51.6,00000
61.0,13.0,77.0,606,02,01,  Rampur,480,784,237,370,243,414,38.0,39.0,37.0,00000
61.0,13.0,77.0,606,03,01,  Bonkua,712,510,371,243,341,267,58.3,60.4,56.1,00000
61.0,13.0,77.0,606,04,01,  Bogajan,731,1364,402,633,329,731,34.9,38.8,31.0,00000
61.0,13.0,77.0,606,05,01,  Soail,526,1064,256,536,270,528,33.1,32.3,33.8,00000
61.0,13.0,77.0,606,06,01,  Panibhanda,724,1331,369,655,355,676,35.2,36.0,34.4,00000
61.0,13.0,77.0,606,07,01,  Jagatber,239,204,123,97,116,107,54.0,55.9,52.0,00000
61.0,13.0,94.0,754,01,01,  Talutdtia,489,892,245,427,244,465,35.4,36.5,34.4,00000
61.0,13.0,94.0,754,02,01,  Kholabari,664,590,327,305,337,285,53.0,51.7,54.2,00000
61.0,13.0,94.0,754,03,01,  Menjena,674,635,346,301,328,334,51.5,53.5,49.5,00000
61.0,13.0,94.0,754,04,01,  Narangi,838,759,419,369,419,390,52.5,53.2,51.8,00000
61.0,16.0,10.0,053,01,01,  Dakshin Baghber,454,778,257,373,197,405,36.9,40.8,32.7,00000
61.0,16.0,10.0,053,02,01,  Chariakanda,339,857,190,418,149,439,28.3,31.3,25.3,00000
61.0,16.0,10.0,286,01,01,  Madhya Salkona,69,38,35,19,34,19,64.5,64.8,64.2,00000
61.0,16.0,10.0,286,02,01,  Purba Salkona,145,86,75,41,70,45,62.8,64.7,60.9,00000
61.0,16.0,10.0,286,03,01,  Chakarna,91,232,48,99,43,133,28.2,32.7,24.4,00000
61.0,16.0,10.0,286,04,01,  Jigatala,107,255,47,122,60,133,29.6,27.8,31.1,00000
61.0,16.0,10.0,286,05,01,  Dighirpar,140,279,73,130,67,149,33.4,36.0,31.0,00000
61.0,16.0,10.0,286,06,01,  Purba Sreepur,52,153,28,76,24,77,25.4,26.9,23.8,00000
61.0,16.0,10.0,286,07,01,  Surjyapur,174,272,94,139,80,133,39.0,40.3,37.6,00000
61.0,16.0,10.0,286,08,01,  Uttar Baghber,542,614,291,288,251,326,46.9,50.3,43.5,00000
61.0,16.0,10.0,412,01,01,  Gosta Bahali,500,1441,284,718,216,723,25.8,28.3,23.0,00000
61.0,16.0,10.0,412,02,01,  Bade Kharia,82,188,51,97,31,91,30.4,34.5,25.4,00000
61.0,16.0,10.0,412,03,01,  Amgachhiakanda,57,163,35,82,22,81,25.9,29.9,21.4,00000
61.0,16.0,10.0,636,01,01,  Mekiarkanda,496,1022,233,485,263,537,32.7,32.5,32.9,00000
61.0,16.0,10.0,636,02,01,  Dakshin Domghata,336,668,174,320,162,348,33.5,35.2,31.8,00000
61.0,16.0,10.0,654,01,01,  Munshirhat,267,110,153,55,114,55,70.8,73.6,67.5,00000
61.0,16.0,10.0,654,02,01,  Paschim Sreepur,480,956,265,482,215,474,33.4,35.5,31.2,00000
61.0,16.0,10.0,654,03,01,  Chandirkanda,214,714,115,356,99,358,23.1,24.4,21.7,00000
61.0,16.0,10.0,654,04,01,  Jigagachhia,207,656,102,325,105,331,24.0,23.9,24.1,00000
61.0,16.0,10.0,681,01,01,  Nayankandi,418,1380,221,684,197,696,23.2,24.4,22.1,00000
61.0,16.0,10.0,681,02,01,  Atka Para,120,284,61,137,59,147,29.7,30.8,28.6,00000
61.0,16.0,10.0,681,03,01,  Kawali Para,58,225,27,113,31,112,20.5,19.3,21.7,00000
61.0,16.0,10.0,842,01,01,  Uttar Domghata,255,451,135,227,120,224,36.1,37.3,34.9,00000
61.0,16.0,10.0,842,02,01,  Paschim Salkona,243,431,143,196,100,235,36.1,42.2,29.9,00000
61.0,16.0,10.0,842,03,01,  Uttar Salkona,149,321,76,139,73,182,31.7,35.3,28.6,00000
61.0,16.0,10.0,842,04,01,  Madhya Salkona,283,477,151,243,132,234,37.2,38.3,36.1,00000
61.0,16.0,10.0,842,05,01,  Mandalia,279,1246,140,624,139,622,18.3,18.3,18.3,00000
61.0,16.0,10.0,842,06,01,  Chandrapur,75,282,52,129,23,153,21.0,28.7,13.1,00000
61.0,16.0,10.0,860,01,01,  Sanandakhila,402,997,209,497,193,500,28.7,29.6,27.8,00000
61.0,16.0,10.0,860,02,01,  Solakanda,65,361,47,171,18,190,15.3,21.6,8.7,00000
61.0,16.0,10.0,860,03,01,  Digharkanda,93,278,44,135,49,143,25.1,24.6,25.5,00000
61.0,16.0,10.0,860,04,01,  Ullahkanda,51,92,28,51,23,41,35.7,35.4,35.9,00000
61.0,16.0,47.0,237,01,01,  Chhanatia,371,719,189,331,182,388,34.0,36.3,31.9,00000
61.0,16.0,47.0,237,02,01,  Ghagutiarpar,190,457,103,211,87,246,29.4,32.8,26.1,00000
61.0,16.0,47.0,397,01,01,  Guatala,339,762,159,381,180,381,30.8,29.4,32.1,00000
61.0,16.0,47.0,397,02,01,  Bil Miahkanda,196,271,98,148,98,123,42.0,39.8,44.3,00000
61.0,16.0,47.0,397,03,01,  Char Boali,96,519,51,252,45,267,15.6,16.8,14.4,00000
61.0,16.0,47.0,397,04,01,  Matikhala,223,964,99,503,124,461,18.8,16.4,21.2,00000
61.0,16.0,47.0,397,05,01,  Katakhali,28,54,17,28,11,26,34.1,37.8,29.7,00000
61.0,16.0,47.0,397,06,01,  Gugrarpar,162,649,78,327,84,322,20.0,19.3,20.7,00000
61.0,16.0,47.0,397,07,01,  Gobindapur,424,1004,194,496,230,508,29.7,28.1,31.2,00000
61.0,16.0,47.0,397,08,01,  Izara Para,229,577,96,277,133,300,28.4,25.7,30.7,00000
61.0,16.0,47.0,397,09,01,  Guatala Bandar,545,529,285,249,260,280,50.7,53.4,48.1,00000
61.0,16.0,47.0,508,01,01,  Joka,231,760,111,358,120,402,23.3,23.7,23.0,00000
61.0,16.0,47.0,508,02,01,  Babuikona,64,365,35,174,29,191,14.9,16.7,13.2,00000
61.0,16.0,47.0,567,01,01,  Kanthal Kusi,90,609,37,284,53,325,12.9,11.5,14.0,00000
61.0,16.0,47.0,567,02,01,  Batuarkuri,165,486,78,231,87,255,25.3,25.2,25.4,00000
61.0,16.0,47.0,567,03,01,  Jirkhali,13,128,7,60,6,68,9.2,10.4,8.1,00000
61.0,16.0,47.0,567,04,01,  Marajan,76,521,33,254,43,267,12.7,11.5,13.9,00000
61.0,16.0,47.0,567,05,01,  Gazaria,37,173,16,81,21,92,17.6,16.5,18.6,00000
61.0,16.0,47.0,872,01,01,  Raghurampur,345,1174,179,545,166,629,22.7,24.7,20.9,00000
61.0,16.0,47.0,872,02,01,  Charpara,6,13,3,7,3,6,31.6,30.0,33.3,00000
61.0,16.0,52.0,089,01,01,  Uttar Baligaon,223,263,110,119,113,144,45.9,48.0,44.0,00000
61.0,16.0,52.0,089,02,01,  Purba Baligaon,161,346,83,157,78,189,31.8,34.6,29.2,00000
61.0,16.0,52.0,089,03,01,  Paschim Baligaon,256,343,122,159,134,184,42.7,43.4,42.1,00000
61.0,16.0,52.0,089,04,01,  Dakshin Baligaon,248,434,123,191,125,243,36.4,39.2,34.0,00000
61.0,16.0,52.0,089,05,01,  Madhya Baligaon,207,474,105,218,102,256,30.4,32.5,28.5,00000
61.0,16.0,52.0,161,01,01,  Mandartali,159,143,68,66,91,77,52.6,50.7,54.2,00000
61.0,16.0,52.0,161,02,01,  Jigatala,365,809,185,414,180,395,31.1,30.9,31.3,00000
61.0,16.0,52.0,161,03,01,  Defulia Para,100,210,47,90,53,120,32.3,34.3,30.6,00000
61.0,16.0,52.0,161,04,01,  Bhuiyan Para,323,906,162,418,161,488,26.3,27.9,24.8,00000
61.0,16.0,52.0,161,05,01,  Chandrakona,494,563,235,262,259,301,46.7,47.3,46.3,00000
61.0,16.0,52.0,161,06,01,  Keshia Para,138,274,63,138,75,136,33.5,31.3,35.5,00000
61.0,16.0,52.0,161,07,01,  Chhaluatala,170,250,81,122,89,128,40.5,39.9,41.0,00000
61.0,16.0,52.0,340,01,01,  Ganai,133,402,70,181,63,221,24.9,27.9,22.2,00000
61.0,16.0,52.0,340,02,01,  Galaidanga,382,899,187,432,195,467,29.8,30.2,29.5,00000
61.0,16.0,52.0,367,01,01,  Roypur,230,790,119,362,111,428,22.5,24.7,20.6,00000
61.0,16.0,52.0,367,02,01,  Bhaluka Para,467,470,223,211,244,259,49.8,51.4,48.5,00000
61.0,16.0,52.0,367,03,01,  Jaripa Para,469,1187,237,577,232,610,28.3,29.1,27.6,00000
61.0,16.0,52.0,367,04,01,  Ghoshgaon,400,831,210,391,190,440,32.5,34.9,30.2,00000
61.0,16.0,73.0,313,01,01,  Dudhnai,466,1338,223,631,243,707,25.8,26.1,25.6,00000
61.0,16.0,73.0,313,02,01,  Charerbhita,52,307,27,144,25,163,14.5,15.8,13.3,00000
61.0,16.0,73.0,313,03,01,  Putiarkanda,18,368,13,188,5,180,4.7,6.5,2.7,00000
61.0,16.0,73.0,313,04,01,  Tenga Para,94,236,43,120,51,116,28.5,26.4,30.5,00000
61.0,16.0,73.0,313,05,01,  Kashinathpur,415,1417,234,686,181,731,22.7,25.4,19.8,00000
61.0,16.0,73.0,313,06,01,  Chander Char,122,383,70,178,52,205,24.2,28.2,20.2,00000
61.0,16.0,73.0,313,07,01,  Taranagar,60,176,29,87,31,89,25.4,25.0,25.8,00000
61.0,16.0,73.0,313,08,01,  Kawar Kanda,110,478,66,230,44,248,18.7,22.3,15.1,00000
61.0,16.0,73.0,708,01,01,  Patam,210,958,110,472,100,486,18.0,18.9,17.1,00000
61.0,16.0,73.0,708,02,01,  Gopinpur,111,1062,54,521,57,541,9.5,9.4,9.5,00000
61.0,16.0,73.0,708,03,01,  Angrakanda,204,498,87,262,117,236,29.1,24.9,33.1,00000
61.0,16.0,73.0,708,04,01,  Madanpur,66,676,32,335,34,341,8.9,8.7,9.1,00000
61.0,16.0,73.0,708,05,01,  Betgachhia,170,986,87,465,83,521,14.7,15.8,13.7,00000
61.0,16.0,73.0,708,06,01,  Rawti,301,921,147,437,154,484,24.6,25.2,24.1,00000
61.0,20.0,23.0,098,01,01,  Balian,893,1006,450,496,443,510,47.0,47.6,46.5,00000
61.0,20.0,23.0,098,02,01,  Balasar,1631,1747,836,843,795,904,48.3,49.8,46.8,00000
61.0,20.0,23.0,098,03,01,  Shorearpar,985,887,477,447,508,440,52.6,51.6,53.6,00000
61.0,20.0,35.0,526,01,01,  Kalibajail,4233,4083,2179,1961,2054,2122,50.9,52.6,49.2,00000
61.0,20.0,35.0,526,02,01,  Char Kalibajail,1256,1513,652,746,604,767,45.4,46.6,44.1,00000
61.0,20.0,41.0,460,01,01,  Enayetpur,2850,4450,1391,2153,1459,2297,39.0,39.2,38.8,00000
61.0,20.0,41.0,460,02,01,  Saidpur,1894,2441,972,1196,922,1245,43.7,44.8,42.5,00000
61.0,20.0,47.0,485,01,03,  Jorbari (Part),3395,3914,1702,1847,1693,2067,46.4,48.0,45.0,00000
61.0,20.0,47.0,485,02,03,  Ichail,1410,2301,685,1077,725,1224,38.0,38.9,37.2,00000
61.0,20.0,47.0,485,03,03,  Kalakanda,992,1349,447,643,545,706,42.4,41.0,43.6,00000
61.0,20.0,83.0,542,01,01,  Kamlapur,699,1623,305,777,394,846,30.1,28.2,31.8,00000
61.0,20.0,83.0,542,02,01,  Kalakupa,34,268,14,130,20,138,11.3,9.7,12.7,00000
61.0,20.0,83.0,542,03,01,  Bandasatra,129,332,56,180,73,152,28.0,23.7,32.4,00000
61.0,20.0,83.0,814,01,01,  Patuli,680,1402,354,691,326,711,32.7,33.9,31.4,00000
61.0,20.0,83.0,814,02,01,  Bailajan,1195,1760,595,814,600,946,40.4,42.2,38.8,00000
61.0,20.0,83.0,814,03,01,  Kalar Char,303,410,137,200,166,210,42.5,40.7,44.1,00000
61.0,20.0,83.0,814,04,01,  Barkhila,385,743,195,363,190,380,34.1,34.9,33.3,00000
61.0,20.0,94.0,879,01,01,  Rangamatia,743,1611,392,777,351,834,31.6,33.5,29.6,00000
61.0,20.0,94.0,879,02,01,  Hatilate,1674,2790,802,1358,872,1432,37.5,37.1,37.8,00000
61.0,22.0,31.0,512,01,01,  Jasara,1432,1635,666,815,766,820,46.7,45.0,48.3,00000
61.0,22.0,31.0,512,02,01,  Bakhura,1540,2162,729,1067,811,1095,41.6,40.6,42.5,00000
61.0,22.0,37.0,541,01,01,  Kaja,543,775,225,354,318,421,41.2,38.9,43.0,00000
61.0,22.0,37.0,541,02,01,  Baghra,219,251,106,127,113,124,46.6,45.5,47.7,00000
61.0,22.0,37.0,655,01,01,  Langair,2764,2895,1364,1416,1400,1479,48.8,49.1,48.6,00000
61.0,22.0,37.0,655,02,01,  Paschim Golabari,195,377,89,167,106,210,34.1,34.8,33.5,00000
61.0,22.0,37.0,655,03,01,  Purba Golabari,232,609,91,307,141,302,27.6,22.9,31.8,00000
61.0,22.0,37.0,655,04,01,  Hawakhali,143,280,70,139,73,141,33.8,33.5,34.1,00000
61.0,22.0,44.0,221,01,01,  Bir Kharua,989,756,478,341,511,415,56.7,58.4,55.2,00000
61.0,22.0,44.0,221,02,01,  Khairkhanda,323,277,164,132,159,145,53.8,55.4,52.3,00000
61.0,22.0,44.0,704,01,01,  Mukhi,2307,2404,1196,1143,1111,1261,49.0,51.1,46.8,00000
61.0,22.0,44.0,704,02,01,  Bailona,606,724,270,354,336,370,45.6,43.3,47.6,00000
61.0,22.0,50.0,004,01,01,  Alali,1237,777,595,369,642,408,61.4,61.7,61.1,00000
61.0,22.0,50.0,004,02,01,  Goairpar,201,563,89,305,112,258,26.3,22.6,30.3,00000
61.0,22.0,50.0,004,03,01,  Chanuta,256,132,127,69,129,63,66.0,64.8,67.2,00000
61.0,22.0,50.0,743,01,01,  Nigair,3698,4028,1803,1970,1895,2058,47.9,47.8,47.9,00000
61.0,22.0,50.0,743,02,01,  Sutar Chakor,474,410,230,206,244,204,53.6,52.8,54.5,00000
61.0,22.0,56.0,758,01,01,  Paithal,2792,2098,1376,962,1416,1136,57.1,58.9,55.5,00000
61.0,22.0,56.0,758,02,01,  Goalbor,1114,763,523,372,591,391,59.4,58.4,60.2,00000
61.0,22.0,56.0,758,03,01,  Joydharkhali,946,813,464,394,482,419,53.8,54.1,53.5,00000
61.0,22.0,69.0,842,01,01,  Rasulpur,1885,2321,912,1118,973,1203,44.8,44.9,44.7,00000
61.0,22.0,69.0,842,02,01,  Sandail Para,679,807,316,386,363,421,45.7,45.0,46.3,00000
61.0,22.0,69.0,842,03,01,  Chaiani Para,1517,2298,712,1115,805,1183,39.8,39.0,40.5,00000
61.0,22.0,82.0,384,01,03,  Dhamail,1425,792,682,371,743,421,64.3,64.8,63.8,00000
61.0,22.0,82.0,384,02,03,  Jaleshwar,1100,891,538,442,562,449,55.2,54.9,55.6,00000
61.0,22.0,88.0,408,01,01,  Dobasia,709,895,293,440,416,455,44.2,40.0,47.8,00000
61.0,22.0,88.0,408,02,01,  Bamankhali,1151,1345,511,701,640,644,46.1,42.2,49.8,00000
61.0,22.0,94.0,477,01,01,  Mohulul,207,162,87,74,120,88,56.1,54.0,57.7,00000
61.0,22.0,94.0,477,02,01,  Ganda Para,390,555,190,291,200,264,41.3,39.5,43.1,00000
61.0,22.0,94.0,477,03,01,  Nura Para,307,383,149,190,158,193,44.5,44.0,45.0,00000
61.0,22.0,94.0,477,04,01,  Hatpara,423,357,220,180,203,177,54.2,55.0,53.4,00000
61.0,23.0,18.0,114,01,01,  Baruamari,1486,1166,786,510,700,656,56.0,60.6,51.6,00000
61.0,23.0,18.0,114,02,01,  Dubrachhara,488,446,274,191,214,255,52.2,58.9,45.6,00000
61.0,23.0,18.0,114,03,01,  Khan Para,261,372,147,173,114,199,41.2,45.9,36.4,00000
61.0,23.0,18.0,114,04,01,  Anantaganj,12,72,7,36,5,36,14.3,16.3,12.2,00000
61.0,23.0,18.0,114,05,01,  Tenguriakanda,188,426,98,213,90,213,30.6,31.5,29.7,00000
61.0,23.0,18.0,114,06,01,  Khuliar Char,302,409,163,183,139,226,42.5,47.1,38.1,00000
61.0,23.0,18.0,114,07,01,  Sutirpar,286,395,163,168,123,227,42.0,49.2,35.1,00000
61.0,23.0,18.0,114,08,01,  Khelar Algi,276,388,145,199,131,189,41.6,42.2,40.9,00000
61.0,23.0,18.0,114,09,01,  Bhati Para,341,702,169,331,172,371,32.7,33.8,31.7,00000
61.0,23.0,18.0,114,10,01,  Kashir Char,242,1083,121,536,121,547,18.3,18.4,18.1,00000
61.0,23.0,18.0,114,11,01,  Godaria Para,259,315,136,148,123,167,45.1,47.9,42.4,00000
61.0,23.0,18.0,114,12,01,  Lakshmipur,779,701,392,299,387,402,52.6,56.7,49.0,00000
61.0,23.0,18.0,660,01,01,  Napter Algi,383,523,203,255,180,268,42.3,44.3,40.2,00000
61.0,23.0,18.0,660,02,01,  Naobhanga,1230,1246,598,577,632,669,49.7,50.9,48.6,00000
61.0,23.0,22.0,692,01,01,  Nijamabad,31,85,15,36,16,49,26.7,29.4,24.6,00000
61.0,23.0,22.0,692,02,01,  Mirakanda,190,190,85,88,105,102,50.0,49.1,50.7,00000
61.0,23.0,22.0,692,03,01,  Khajandar,43,59,29,22,14,37,42.2,56.9,27.5,00000
61.0,23.0,22.0,692,04,01,  Phulhar,283,731,142,359,141,372,27.9,28.3,27.5,00000
61.0,23.0,22.0,692,05,01,  Trishaghar,233,288,112,126,121,162,44.7,47.1,42.8,00000
61.0,23.0,22.0,692,06,01,  Patantola,289,315,153,146,136,169,47.8,51.2,44.6,00000
61.0,23.0,22.0,692,07,01,  Fatemanagar (Kalibari),82,153,44,64,38,89,34.9,40.7,29.9,00000
61.0,23.0,22.0,692,08,01,  Maminpur,227,393,121,190,106,203,36.6,38.9,34.3,00000
61.0,23.0,22.0,692,09,01,  Mamudnagar,427,389,205,196,222,193,52.3,51.1,53.5,00000
61.0,23.0,22.0,692,10,01,  Bashabari,96,136,43,55,53,81,41.4,43.9,39.6,00000
61.0,23.0,22.0,692,11,01,  Naya Para,273,406,129,186,144,220,40.2,41.0,39.6,00000
61.0,23.0,22.0,692,12,01,  Ashtoghar,424,459,222,232,202,227,48.0,48.9,47.1,00000
61.0,23.0,22.0,692,13,01,  Mirikpur,270,543,146,256,124,287,33.2,36.3,30.2,00000
61.0,23.0,22.0,692,14,01,  Baluchara,188,424,90,209,98,215,30.7,30.1,31.3,00000
61.0,23.0,22.0,692,15,01,  Garpara,236,641,118,321,118,320,26.9,26.9,26.9,00000
61.0,23.0,31.0,530,01,01,  Purba Kona Para,354,955,163,446,191,509,27.0,26.8,27.3,00000
61.0,23.0,31.0,530,02,01,  Paschim Konapara,598,1313,297,646,301,667,31.3,31.5,31.1,00000
61.0,23.0,31.0,861,01,01,  Purba Salihar,865,2042,448,948,417,1094,29.8,32.1,27.6,00000
61.0,23.0,31.0,861,02,01,  Paschim Salihar,792,1476,371,681,421,795,34.9,35.3,34.6,00000
61.0,23.0,49.0,466,01,01,  Purba Kaorait,772,1220,414,568,358,652,38.8,42.2,35.4,00000
61.0,23.0,49.0,466,02,01,  Paschim Kaorait,913,1073,469,506,444,567,46.0,48.1,43.9,00000
61.0,23.0,49.0,591,01,01,  Purba Mailakanda,776,870,402,426,374,444,47.1,48.6,45.7,00000
61.0,23.0,49.0,591,02,01,  Shyamgaon,976,276,541,145,435,131,78.0,78.9,76.9,00000
61.0,23.0,49.0,591,03,01,  Paschim Mailakanda,998,1116,524,515,474,601,47.2,50.4,44.1,00000
61.0,23.0,58.0,135,01,01,  Purba Bir Ahammadpur,358,816,187,395,171,421,30.5,32.1,28.9,00000
61.0,23.0,58.0,135,02,01,  Paschim Bir Ahammadpur,530,1140,271,564,259,576,31.7,32.5,31.0,00000
61.0,23.0,58.0,612,01,01,  Kushapara,124,289,52,140,72,149,30.0,27.1,32.6,00000
61.0,23.0,58.0,612,02,01,  Nayanagar,131,139,71,70,60,69,48.5,50.4,46.5,00000
61.0,23.0,58.0,612,03,01,  Baoshalipara,101,274,47,137,54,137,26.9,25.5,28.3,00000
61.0,23.0,58.0,612,04,01,  Niz Maoha,178,381,87,178,91,203,31.8,32.8,31.0,00000
61.0,23.0,58.0,612,05,01,  Kudalia,41,133,17,61,24,72,23.6,21.8,25.0,00000
61.0,23.0,58.0,612,06,01,  Laxinagar,230,593,134,288,96,305,27.9,31.8,23.9,00000
61.0,23.0,58.0,612,07,01,  Boraikandi,265,564,140,287,125,277,32.0,32.8,31.1,00000
61.0,23.0,72.0,290,01,01,  Bhasabanda,245,336,114,167,131,169,42.2,40.6,43.7,00000
61.0,23.0,72.0,290,02,01,  Char Dharua,296,323,141,168,155,155,47.8,45.6,50.0,00000
61.0,23.0,72.0,290,03,01,  Dharua,1058,1080,536,495,522,585,49.5,52.0,47.2,00000
61.0,23.0,72.0,290,04,01,  Ramnathpur,308,297,172,131,136,166,50.9,56.8,45.0,00000
61.0,23.0,72.0,736,01,01,  Paschimpara,663,1191,339,602,324,589,35.8,36.0,35.5,00000
61.0,23.0,72.0,736,02,01,  Shibpur,249,665,126,340,123,325,27.2,27.0,27.5,00000
61.0,23.0,85.0,093,01,01,  Balijuri,302,393,165,183,137,210,43.5,47.4,39.5,00000
61.0,23.0,85.0,093,02,01,  Natun Para,377,265,188,122,189,143,58.7,60.6,56.9,00000
61.0,23.0,85.0,473,01,01,  Hasanpur,383,645,191,291,192,354,37.3,39.6,35.2,00000
61.0,23.0,85.0,473,02,01,  Kutubpur,347,451,186,211,161,240,43.5,46.9,40.1,00000
61.0,23.0,85.0,473,03,01,  Ukuakandi,356,265,179,134,177,131,57.3,57.2,57.5,00000
61.0,23.0,85.0,669,01,01,  Manati,794,1261,436,594,358,667,38.6,42.3,34.9,00000
61.0,23.0,85.0,669,02,01,  Dari Para (Monati),455,1013,230,522,225,491,31.0,30.6,31.4,00000
61.0,23.0,85.0,921,01,01,  Baroani,356,666,150,327,206,339,34.8,31.4,37.8,00000
61.0,23.0,85.0,921,02,01,  Charali,927,1094,477,513,450,581,45.9,48.2,43.6,00000
61.0,23.0,85.0,921,03,01,  Atka Para,213,148,101,79,112,69,59.0,56.1,61.9,00000
61.0,23.0,85.0,921,04,01,  Maniarkanda,215,618,105,295,110,323,25.8,26.3,25.4,00000
61.0,23.0,85.0,921,05,01,  Tatakandi,670,1124,345,581,325,543,37.3,37.3,37.4,00000
61.0,23.0,85.0,921,06,01,  Bolarkanda,128,252,57,117,71,135,33.7,32.8,34.5,00000
61.0,24.0,17.0,030,01,01,  Amtail Baroani,511,845,232,399,279,446,37.7,36.8,38.5,00000
61.0,24.0,17.0,030,02,01,  Amtail Chariani,187,692,89,325,98,367,21.3,21.5,21.1,00000
61.0,24.0,17.0,092,01,01,  Bahir Shimul,1040,1277,526,578,514,699,44.9,47.6,42.4,00000
61.0,24.0,17.0,092,02,01,  Chakerkanda,176,515,88,236,88,279,25.5,27.2,24.0,00000
61.0,24.0,17.0,092,03,01,  Suarkanda,182,420,91,183,91,237,30.2,33.2,27.7,00000
61.0,24.0,17.0,302,01,01,  Dhopa Gochhina,159,363,76,170,83,193,30.5,30.9,30.1,00000
61.0,24.0,17.0,302,02,01,  Nasai Para,322,521,157,246,165,275,38.2,39.0,37.5,00000
61.0,24.0,17.0,302,03,01,  Khondal,361,315,178,152,183,163,53.4,53.9,52.9,00000
61.0,24.0,17.0,302,04,01,  Shimalgara,261,318,133,149,128,169,45.1,47.2,43.1,00000
61.0,24.0,17.0,587,01,01,  Kona Para,235,621,126,311,109,310,27.5,28.8,26.0,00000
61.0,24.0,17.0,587,02,01,  Jogania,100,97,57,38,43,59,50.8,60.0,42.2,00000
61.0,24.0,20.0,074,01,01,  Baghaitala,802,897,422,407,380,490,47.2,50.9,43.7,00000
61.0,24.0,20.0,074,02,01,  Betkuri,350,652,184,300,166,352,34.9,38.0,32.0,00000
61.0,24.0,21.0,017,01,01,  Atuajangal,717,2167,365,1039,352,1128,24.9,26.0,23.8,00000
61.0,24.0,21.0,017,02,01,  Palashkanda,685,1384,364,657,321,727,33.1,35.7,30.6,00000
61.0,24.0,21.0,179,01,01,  Bildora,631,1179,329,574,302,605,34.9,36.4,33.3,00000
61.0,24.0,21.0,179,02,01,  Purba Dariakanda,187,685,99,346,88,339,21.4,22.2,20.6,00000
61.0,24.0,21.0,179,03,01,  Kaziakandi,513,948,271,442,242,506,35.1,38.0,32.4,00000
61.0,24.0,21.0,690,01,01,  Nischintapur,296,698,150,344,146,354,29.8,30.4,29.2,00000
61.0,24.0,21.0,690,02,01,  Digarkanda,164,372,79,190,85,182,30.6,29.4,31.8,00000
61.0,24.0,33.0,142,01,01,  Baruigaon,164,81,86,40,78,41,66.9,68.3,65.5,00000
61.0,24.0,33.0,142,02,01,  Mokimpur,172,123,90,68,82,55,58.3,57.0,59.9,00000
61.0,24.0,33.0,203,01,01,  Birguchhina,268,521,143,248,125,273,34.0,36.6,31.4,00000
61.0,24.0,33.0,203,02,01,  Garpara,491,827,253,403,238,424,37.3,38.6,36.0,00000
61.0,24.0,33.0,296,01,01,  Dharakanda,165,632,82,313,83,319,20.7,20.8,20.6,00000
61.0,24.0,33.0,296,02,01,  Purba Dhara,214,673,97,330,117,343,24.1,22.7,25.4,00000
61.0,24.0,33.0,296,03,01,  Lalarpar,103,501,46,248,57,253,17.1,15.6,18.4,00000
61.0,24.0,33.0,296,04,01,  Dhara,424,1025,232,498,192,527,29.3,31.8,26.7,00000
61.0,24.0,33.0,618,01,01,  Kutikura,427,682,187,360,240,322,38.5,34.2,42.7,00000
61.0,24.0,33.0,618,02,01,  Ounuahkanda,86,323,38,163,48,160,21.0,18.9,23.1,00000
61.0,24.0,33.0,667,01,01,  Makimpur Nagua,425,833,224,416,201,417,33.8,35.0,32.5,00000
61.0,24.0,33.0,667,02,01,  Baniakanda,111,208,53,109,58,99,34.8,32.7,36.9,00000
61.0,24.0,33.0,939,01,01,  Teguria,543,508,267,245,276,263,51.7,52.1,51.2,00000
61.0,24.0,33.0,939,02,01,  Kanda Para,123,226,57,114,66,112,35.2,33.3,37.1,00000
61.0,24.0,40.0,271,01,01,  Ghona Para,132,491,77,251,55,240,21.2,23.5,18.6,00000
61.0,24.0,40.0,271,02,01,  Gungiajuni,224,242,110,112,114,130,48.1,49.5,46.7,00000
61.0,24.0,40.0,271,03,01,  Joytok,92,385,43,189,49,196,19.3,18.5,20.0,00000
61.0,24.0,40.0,271,04,01,  Maij Para,251,530,117,263,134,267,32.1,30.8,33.4,00000
61.0,24.0,40.0,271,05,01,  Chak Mokamia,438,1365,225,662,213,703,24.3,25.4,23.3,00000
61.0,24.0,40.0,315,01,01,  Purba Dhurail,403,870,192,427,211,443,31.7,31.0,32.3,00000
61.0,24.0,40.0,315,02,01,  Paschim Dhurail,641,1042,321,513,320,529,38.1,38.5,37.7,00000
61.0,24.0,40.0,414,01,01,  Gorakpur,416,814,214,377,202,437,33.8,36.2,31.6,00000
61.0,24.0,40.0,414,02,01,  Char Gorakpur,376,564,176,282,200,282,40.0,38.4,41.5,00000
61.0,24.0,40.0,760,01,01,  Darabanni,476,967,231,449,245,518,33.0,34.0,32.1,00000
61.0,24.0,40.0,760,02,01,  Purba Pabaijuri,300,636,139,310,161,326,32.1,31.0,33.1,00000
61.0,24.0,40.0,760,03,01,  Gazaria Para,200,257,90,127,110,130,43.8,41.5,45.8,00000
61.0,24.0,40.0,760,04,01,  Paschim Pabiajuri,764,1763,373,811,391,952,30.2,31.5,29.1,00000
61.0,24.0,40.0,760,05,01,  Uttar Pabiajuri,70,129,37,61,33,68,35.2,37.8,32.7,00000
61.0,24.0,40.0,988,01,01,  Banpara,590,988,295,512,295,476,37.4,36.6,38.3,00000
61.0,24.0,40.0,988,02,01,  Jhaugara,354,813,167,374,187,439,30.3,30.9,29.9,00000
61.0,24.0,40.0,988,03,01,  Konna Para,210,427,104,202,106,225,33.0,34.0,32.0,00000
61.0,24.0,47.0,135,01,01,  Gabrakhali,243,780,129,386,114,394,23.8,25.0,22.4,00000
61.0,24.0,47.0,135,02,01,  Beltali,121,297,67,132,54,165,28.9,33.7,24.7,00000
61.0,24.0,47.0,135,03,01,  Barak,93,615,51,308,42,307,13.1,14.2,12.0,00000
61.0,24.0,47.0,135,04,01,  Namsa Para,74,173,36,81,38,92,30.0,30.8,29.2,00000
61.0,24.0,47.0,135,05,01,  Kanda Para,69,151,35,67,34,84,31.4,34.3,28.8,00000
61.0,24.0,47.0,135,06,01,  Bandarghat,78,263,38,126,40,137,22.9,23.2,22.6,00000
61.0,24.0,47.0,135,07,01,  Dakia Para,212,319,106,126,106,193,39.9,45.7,35.5,00000
61.0,24.0,47.0,327,01,01,  Dumnikura,160,310,81,155,79,155,34.0,34.3,33.8,00000
61.0,24.0,47.0,327,02,01,  Jhata Para,67,88,35,36,32,52,43.2,49.3,38.1,00000
61.0,24.0,47.0,358,01,01,  Gazir Bhita,500,373,231,174,269,199,57.3,57.0,57.5,00000
61.0,24.0,47.0,358,02,01,  Anchangri,169,240,79,114,90,126,41.3,40.9,41.7,00000
61.0,24.0,47.0,865,01,01,  Samania Para,1145,1425,568,666,577,759,44.6,46.0,43.2,00000
61.0,24.0,47.0,865,02,01,  Boalmara,365,253,184,114,181,139,59.1,61.7,56.6,00000
61.0,24.0,47.0,865,03,01,  Mahajanikanda,231,493,109,259,122,234,31.9,29.6,34.3,00000
61.0,24.0,47.0,927,01,01,  Surjyapur,313,513,164,250,149,263,37.9,39.6,36.2,00000
61.0,24.0,47.0,927,02,01,  Dhalapani,110,108,52,50,58,58,50.5,51.0,50.0,00000
61.0,24.0,47.0,927,03,01,  Katalmari,212,394,115,191,97,203,35.0,37.6,32.3,00000
61.0,24.0,47.0,976,01,01,  Uttar Nalkura,46,429,29,199,17,230,9.7,12.7,6.9,00000
61.0,24.0,47.0,976,02,01,  Bhotiadara,57,231,35,108,22,123,19.8,24.5,15.2,00000
61.0,24.0,61.0,401,01,01,  Gobrakura,1604,2468,816,1210,788,1258,39.4,40.3,38.5,00000
61.0,24.0,61.0,401,02,01,  Gopaka Paschin,1027,1527,510,751,517,776,40.2,40.4,40.0,00000
61.0,24.0,61.0,426,01,03,  Haluaghat,2339,966,1172,440,1167,526,70.8,72.7,68.9,00000
61.0,24.0,61.0,426,02,03,  Hauhrohat Bazar Pacshim,941,231,417,88,524,143,80.3,82.6,78.6,00000
61.0,24.0,61.0,506,01,01,  Kalianikanda,783,1464,387,752,396,712,34.8,34.0,35.7,00000
61.0,24.0,61.0,506,02,01,  Kali Anikanda Paschim,909,1553,442,746,467,807,36.9,37.2,36.7,00000
61.0,24.0,61.0,673,01,01,  Manikura,384,652,201,319,183,333,37.1,38.7,35.5,00000
61.0,24.0,61.0,673,02,01,  Manikpur Dakshin,2208,3560,1184,1646,1024,1914,38.3,41.8,34.9,00000
61.0,24.0,61.0,970,01,03,  Uttar Khairakuri,3529,1479,1864,688,1665,791,70.5,73.0,67.8,00000
61.0,24.0,61.0,970,02,03,  Islampur,480,184,239,86,241,98,72.3,73.5,71.1,00000
61.0,24.0,67.0,370,01,01,  Ghilabhuin,607,812,300,367,307,445,42.8,45.0,40.8,00000
61.0,24.0,67.0,370,02,01,  Gigatala,353,743,180,353,173,390,32.2,33.8,30.7,00000
61.0,24.0,67.0,482,01,01,  Jugli,305,828,148,374,157,454,26.9,28.4,25.7,00000
61.0,24.0,67.0,482,02,01,  Naya Para,405,689,202,317,203,372,37.0,38.9,35.3,00000
61.0,24.0,67.0,482,03,01,  Kala Pagla,143,385,76,186,67,199,27.1,29.0,25.2,00000
61.0,24.0,67.0,679,01,01,  Zadukura,302,483,150,232,152,251,38.5,39.3,37.7,00000
61.0,24.0,67.0,679,02,01,  Khalishakuri,185,367,101,189,84,178,33.5,34.8,32.1,00000
61.0,24.0,67.0,679,03,01,  Mankanda,271,618,135,286,136,332,30.5,32.1,29.1,00000
61.0,24.0,74.0,284,01,01,  Darsapar,84,299,46,147,38,152,21.9,23.8,20.0,00000
61.0,24.0,74.0,284,02,01,  Ganginapar,415,709,208,351,207,358,36.9,37.2,36.6,00000
61.0,24.0,74.0,494,01,01,  Fakir Para,335,679,171,340,164,339,33.0,33.5,32.6,00000
61.0,24.0,74.0,494,02,01,  Atka Para,209,175,101,81,108,94,54.4,55.5,53.5,00000
61.0,24.0,74.0,494,03,01,  Bhaki Para,70,320,36,153,34,167,17.9,19.0,16.9,00000
61.0,24.0,74.0,494,04,01,  Bara Daspara,353,425,166,207,187,218,45.4,44.5,46.2,00000
61.0,24.0,74.0,494,05,01,  3chhota Daspara,269,326,138,152,131,174,45.2,47.6,43.0,00000
61.0,24.0,74.0,494,06,01,  Jamgara,113,165,54,80,59,85,40.6,40.3,41.0,00000
61.0,24.0,74.0,494,07,01,  Maij Para,405,527,196,236,209,291,43.5,45.4,41.8,00000
61.0,24.0,74.0,494,08,01,  Pagal Para,721,545,352,275,369,270,57.0,56.1,57.7,00000
61.0,24.0,74.0,494,09,01,  Daspara (Part),123,214,52,101,71,113,36.5,34.0,38.6,00000
61.0,24.0,74.0,512,01,01,  Goniarikanda,174,379,90,180,84,199,31.5,33.3,29.7,00000
61.0,24.0,74.0,512,02,01,  Karaikanda,376,853,185,394,191,459,30.6,32.0,29.4,00000
61.0,24.0,74.0,512,03,01,  Nakhria Para,161,370,82,185,79,185,30.3,30.7,29.9,00000
61.0,24.0,74.0,512,04,01,  Juka Bilarkanda,112,368,61,182,51,186,23.3,25.1,21.5,00000
61.0,24.0,74.0,512,05,01,  Bara Khalarpar,270,565,126,272,144,293,32.3,31.7,33.0,00000
61.0,24.0,84.0,833,01,01,  Bariakanda,186,635,97,315,89,320,22.7,23.5,21.8,00000
61.0,24.0,84.0,833,02,01,  Sakuai,1617,2027,849,937,768,1090,44.4,47.5,41.3,00000
61.0,31.0,54.0,589,01,01,  Kumuriar Char,279,843,151,414,128,429,24.9,26.7,23.0,00000
61.0,31.0,54.0,589,02,01,  Kulla Para,314,608,151,303,163,305,34.1,33.3,34.8,00000
61.0,31.0,54.0,589,03,01,  Nijgaon,491,337,230,142,261,195,59.3,61.8,57.2,00000
61.0,31.0,54.0,589,04,01,  Rauler Char,418,765,210,348,208,417,35.3,37.6,33.3,00000
61.0,31.0,54.0,589,05,01,  Bil Baul,378,907,205,430,173,477,29.4,32.3,26.6,00000
61.0,31.0,54.0,589,06,01,  Satihari,586,1007,291,504,295,503,36.8,36.6,37.0,00000
61.0,31.0,54.0,589,07,01,  Panch Para,1259,1198,628,613,631,585,51.2,50.6,51.9,00000
61.0,31.0,76.0,868,01,01,  Nij Sharisha,515,875,261,419,254,456,37.1,38.4,35.8,00000
61.0,31.0,76.0,868,02,01,  Guilakanda,430,1124,188,531,242,593,27.7,26.1,29.0,00000
61.0,31.0,76.0,868,03,01,  Maruakhali,611,1232,318,587,293,645,33.2,35.1,31.2,00000
61.0,31.0,76.0,868,04,01,  Badhati,165,619,90,278,75,341,21.0,24.5,18.0,00000
61.0,31.0,76.0,868,05,01,  Duliakandi,289,565,149,265,140,300,33.8,36.0,31.8,00000
61.0,52.0,23.0,014,01,03,  Dakshin Akua,6721,4386,3373,2163,3348,2223,60.5,60.9,60.1,00000
61.0,52.0,23.0,014,02,03,  Moral Para,4232,2600,2173,1373,2059,1227,61.9,61.3,62.7,00000
61.0,52.0,23.0,014,03,03,  Dargah Para,809,794,389,442,420,352,50.5,46.8,54.4,00000
61.0,52.0,23.0,014,04,03,  Chukitala (Part-1),3553,2079,1770,976,1783,1103,63.1,64.5,61.8,00000
61.0,52.0,23.0,014,05,03,  Gondropa,1176,1084,584,515,592,569,52.0,53.1,51.0,00000
61.0,52.0,23.0,014,06,03,  Nayapara,675,40,334,8,341,32,94.4,97.7,91.4,00000
61.0,52.0,23.0,127,01,03,  Uzan Barera,1173,1318,645,627,528,691,47.1,50.7,43.3,00000
61.0,52.0,23.0,127,02,03,  Kanda Para,465,767,236,407,229,360,37.7,36.7,38.9,00000
61.0,52.0,23.0,127,03,03,  Madhya Barera,2866,2747,1448,1524,1418,1223,51.1,48.7,53.7,00000
61.0,52.0,23.0,127,04,03,  Bhati Barera,1779,1358,930,708,849,650,56.7,56.8,56.6,00000
56.6,61.0,52.0,023,998,03,*Cantonment,3109,133,2483,58,626,75,95.9,97.7,89.3,00000
61.0,52.0,25.0,029,01,01,  Ashtadhar,826,807,425,391,401,416,50.6,52.1,49.1,00000
61.0,52.0,25.0,029,02,01,  Kuturakanda,883,1293,455,584,428,709,40.6,43.8,37.6,00000
61.0,52.0,27.0,204,01,03,  Baera,6233,5848,3225,2721,3008,3127,51.6,54.2,49.0,00000
61.0,52.0,27.0,204,02,03,  Chalakandi,525,853,286,417,239,436,38.1,40.7,35.4,00000
61.0,52.0,27.0,204,03,03,  Fakirakandi,142,356,72,164,70,192,28.5,30.5,26.7,00000
61.0,52.0,27.0,204,04,03,  Chabagiya,210,238,123,111,87,127,46.9,52.6,40.7,00000
61.0,52.0,27.0,351,01,03,  Shekarikanda,747,306,384,145,363,161,70.9,72.6,69.3,00000
61.0,52.0,27.0,351,02,03,  Fakirakanda,230,215,138,95,92,120,51.7,59.2,43.4,00000
61.0,52.0,27.0,351,03,03,  Digarkanda,3329,2603,1782,1307,1547,1296,56.1,57.7,54.4,00000
61.0,52.0,31.0,201,01,01,  Naya Para,194,605,80,293,114,312,24.3,21.4,26.8,00000
61.0,52.0,31.0,201,02,01,  Banpara,305,1376,153,668,152,708,18.1,18.6,17.7,00000
61.0,52.0,31.0,201,03,01,  Bhati Para,577,2165,284,1087,293,1078,21.0,20.7,21.4,00000
61.0,52.0,31.0,201,04,01,  Barti Para,586,1440,284,698,302,742,28.9,28.9,28.9,00000
61.0,52.0,31.0,201,05,01,  Jafar Mandaler Para,398,1655,198,842,200,813,19.4,19.0,19.7,00000
61.0,52.0,31.0,201,06,01,  Mridha Para,702,1583,292,811,410,772,30.7,26.5,34.7,00000
61.0,52.0,31.0,201,07,01,  Kushtia Para,1024,1713,462,883,562,830,37.4,34.3,40.4,00000
61.0,52.0,31.0,201,08,01,  Baitamari,446,442,227,211,219,231,50.2,51.8,48.7,00000
61.0,52.0,31.0,201,09,01,  Madhumari,279,305,147,150,132,155,47.8,49.5,46.0,00000
61.0,52.0,31.0,201,10,01,  Bagherkanda,281,547,124,272,157,275,33.9,31.3,36.3,00000
61.0,52.0,33.0,231,01,01,  Barabila,1071,2016,551,990,520,1026,34.7,35.8,33.6,00000
61.0,52.0,33.0,231,02,01,  Puthamara,465,903,248,438,217,465,34.0,36.2,31.8,00000
61.0,52.0,33.0,269,01,01,  Haripur,762,2308,380,1136,382,1172,24.8,25.1,24.6,00000
61.0,52.0,33.0,269,02,01,  Alalpur,771,1702,398,838,373,864,31.2,32.2,30.2,00000
61.0,52.0,33.0,276,01,03,  Char Ishwardia,3116,6253,1624,3041,1492,3212,33.3,34.8,31.7,00000
61.0,52.0,33.0,276,02,03,  Char Kalibari,6206,6667,3402,3296,2804,3371,48.2,50.8,45.4,00000
61.0,52.0,33.0,276,03,03,  Char Jhawgora,1278,1028,673,464,605,564,55.4,59.2,51.8,00000
61.0,52.0,33.0,276,04,03,  Char Gobodia,1261,1712,641,835,620,877,42.4,43.4,41.4,00000
61.0,52.0,54.0,433,01,01,  Ujan Ghagra,1809,3701,826,1872,983,1829,32.8,30.6,35.0,00000
61.0,52.0,54.0,433,02,01,  Putialir Char,487,1294,262,625,225,669,27.3,29.5,25.2,00000
61.0,52.0,54.0,433,03,01,  Barerar Par,563,1194,273,616,290,578,32.0,30.7,33.4,00000
61.0,52.0,54.0,433,04,01,  Ghagra,441,1030,228,517,213,513,30.0,30.6,29.3,00000
61.0,52.0,54.0,433,05,01,  Char Ghagra,1024,1425,525,661,499,764,41.8,44.3,39.5,00000
61.0,52.0,54.0,433,06,01,  Bhati Ghagra Ujan Para,550,694,284,296,266,398,44.2,49.0,40.1,00000
61.0,52.0,54.0,433,07,01,  Bhati Ghagra Bhati Para,748,1125,419,523,329,602,39.9,44.5,35.3,00000
61.0,52.0,54.0,433,08,01,  Chak Naju,504,1496,259,744,245,752,25.2,25.8,24.6,00000
61.0,52.0,54.0,433,09,01,  Shankanda,190,377,87,197,103,180,33.5,30.6,36.4,00000
61.0,52.0,54.0,433,10,01,  Tekarbati,90,330,54,169,36,161,21.4,24.2,18.3,00000
61.0,52.0,54.0,433,11,01,  Barerpar Bhati Para,1215,1564,617,792,598,772,43.7,43.8,43.6,00000
61.0,52.0,67.0,605,01,03,  Khagdahar,2797,3124,1470,1627,1327,1497,47.2,47.5,47.0,00000
61.0,52.0,67.0,605,02,03,  Bagherkanda,858,820,465,395,393,425,51.1,54.1,48.0,00000
61.0,52.0,67.0,718,01,01,  Mirzapur,795,1106,399,541,396,565,41.8,42.4,41.2,00000
61.0,52.0,67.0,718,02,01,  Mankanda,489,445,262,199,227,246,52.4,56.8,48.0,00000
61.0,52.0,74.0,246,01,01,  Balur Char,79,326,44,161,35,165,19.5,21.5,17.5,00000
61.0,52.0,74.0,246,02,01,  Maddayar Char,285,899,140,477,145,422,24.1,22.7,25.6,00000
61.0,52.0,74.0,246,03,01,  Nama Para,280,1043,142,520,138,523,21.2,21.5,20.9,00000
61.0,52.0,74.0,246,04,01,  Balla Para,103,223,61,109,42,114,31.6,35.9,26.9,00000
61.0,52.0,74.0,246,05,01,  Paschimpara,130,404,56,193,74,211,24.3,22.5,26.0,00000
61.0,52.0,74.0,643,01,01,  Kushtia Bazar,328,180,176,75,152,105,64.6,70.1,59.1,00000
61.0,52.0,74.0,643,02,01,  Sreerampur,201,232,102,113,99,119,46.4,47.4,45.4,00000
61.0,52.0,74.0,643,03,01,  Fakir Para,208,311,99,136,109,175,40.1,42.1,38.4,00000
61.0,52.0,74.0,643,04,01,  Kabariakanda,416,340,195,169,221,171,55.0,53.6,56.4,00000
61.0,52.0,74.0,643,05,01,  Chak Para,696,1288,335,607,361,681,35.1,35.6,34.6,00000
61.0,52.0,74.0,643,06,01,  Nadir Par,601,1247,294,574,307,673,32.5,33.9,31.3,00000
61.0,52.0,74.0,643,07,01,  Nama Kushtia,594,561,278,275,316,286,51.4,50.3,52.5,00000
61.0,52.0,74.0,643,08,01,  Jagannath Para,150,130,72,51,78,79,53.6,58.5,49.7,00000
61.0,52.0,88.0,112,01,01,  Bir Baola,312,861,153,413,159,448,26.6,27.0,26.2,00000
61.0,52.0,88.0,112,02,01,  Char Baola,365,1513,172,714,193,799,19.4,19.4,19.5,00000
61.0,52.0,88.0,329,01,01,  Chak Shyamrampur,1335,3887,682,1970,653,1917,25.6,25.7,25.4,00000
61.0,52.0,88.0,329,02,01,  Fadiar Char,365,1533,192,752,173,781,19.2,20.3,18.1,00000
61.0,52.0,88.0,493,01,01,  Tan Hasadia,480,885,237,410,243,475,35.2,36.6,33.8,00000
61.0,52.0,88.0,493,02,01,  Char Hasadia,744,2023,398,1018,346,1005,26.9,28.1,25.6,00000
61.0,52.0,94.0,239,01,01,  Kona Para,1291,2100,626,1006,665,1094,38.1,38.4,37.8,00000
61.0,52.0,94.0,239,02,01,  Char Bhabanipur,1629,2738,844,1329,785,1409,37.3,38.8,35.8,00000
61.0,52.0,94.0,239,03,01,  Anandipur,969,1975,481,1012,488,963,32.9,32.2,33.6,00000
61.0,52.0,94.0,920,01,01,  Char Sirta,642,1330,332,655,310,675,32.6,33.6,31.5,00000
61.0,52.0,94.0,920,02,01,  Sirta,1668,3138,815,1477,853,1661,34.7,35.6,33.9,00000
61.0,65.0,16.0,118,01,01,  Baragram,550,809,305,362,245,447,40.5,45.7,35.4,00000
61.0,65.0,16.0,118,02,01,  Mogaltala,377,150,190,66,187,84,71.5,74.2,69.0,00000
61.0,65.0,16.0,118,03,01,  Mirzakanda,399,368,199,168,200,200,52.0,54.2,50.0,00000
61.0,65.0,16.0,118,04,01,  Said Para,1600,1481,849,688,751,793,51.9,55.2,48.6,00000
61.0,65.0,16.0,118,05,01,  Bakchar,339,555,172,266,167,289,37.9,39.3,36.6,00000
61.0,65.0,17.0,129,01,01,  Basati Purbapara,323,341,153,170,170,171,48.6,47.4,49.9,00000
61.0,65.0,17.0,129,02,01,  Basati Charpara,334,537,150,273,184,264,38.3,35.5,41.1,00000
61.0,65.0,17.0,129,03,01,  Basati Paschimpara,245,256,133,123,112,133,48.9,52.0,45.7,00000
61.0,65.0,17.0,129,04,01,  Basati Ganakpara,54,51,25,26,29,25,51.4,49.0,53.7,00000
61.0,65.0,17.0,636,01,01,  Langulia,1371,1514,683,730,688,784,47.5,48.3,46.7,00000
61.0,65.0,17.0,636,02,01,  Chak Langulia,204,583,106,286,98,297,25.9,27.0,24.8,00000
61.0,65.0,17.0,636,03,01,  Manirambari Part,620,939,328,443,292,496,39.8,42.5,37.1,00000
61.0,65.0,17.0,636,04,01,  Krishna Nogar,530,1017,277,485,253,532,34.3,36.4,32.2,00000
61.0,65.0,17.0,636,05,01,  Jaminpur,125,203,62,98,63,105,38.1,38.8,37.5,00000
61.0,65.0,17.0,636,06,01,  Senbari,67,86,32,40,35,46,43.8,44.4,43.2,00000
61.0,65.0,17.0,670,01,01,  Tulasipara,702,621,352,299,350,322,53.1,54.1,52.1,00000
61.0,65.0,17.0,670,02,01,  Daspara,202,163,104,75,98,88,55.3,58.1,52.7,00000
61.0,65.0,17.0,670,03,01,  Akanpara,358,343,175,164,183,179,51.1,51.6,50.6,00000
61.0,65.0,17.0,670,04,01,  Palpara,273,365,138,173,135,192,42.8,44.4,41.3,00000
61.0,65.0,17.0,670,05,01,  Maizpara,330,354,158,181,172,173,48.2,46.6,49.9,00000
61.0,65.0,17.0,670,06,01,  Paschimpara,450,458,246,227,204,231,49.6,52.0,46.9,00000
61.0,65.0,17.0,670,07,01,  Baparipara,123,209,71,96,52,113,37.0,42.5,31.5,00000
61.0,65.0,94.0,190,01,01,  Birashi,1161,1176,587,552,574,624,49.7,51.5,47.9,00000
61.0,65.0,94.0,190,02,01,  Madanpur,248,368,139,189,109,179,40.3,42.4,37.8,00000
61.0,65.0,94.0,190,03,01,  Majherband,350,420,191,212,159,208,45.5,47.4,43.3,00000
61.0,65.0,94.0,190,04,01,  Andharia,172,356,96,157,76,199,32.6,37.9,27.6,00000
61.0,65.0,94.0,922,01,01,  Sasa Naljora,587,881,324,406,263,475,40.0,44.4,35.6,00000
61.0,65.0,94.0,922,02,01,  Kanda Para,447,831,243,414,204,417,35.0,37.0,32.9,00000
61.0,65.0,94.0,922,03,01,  Anoakanda,263,518,149,260,114,258,33.7,36.4,30.6,00000
61.0,65.0,94.0,922,04,01,  Tarakanda,392,567,194,276,198,291,40.9,41.3,40.5,00000
61.0,65.0,94.0,922,05,01,  Sasa,587,1028,337,501,250,527,36.3,40.2,32.2,00000
61.0,65.0,94.0,922,06,01,  Kaldari,135,267,78,122,57,145,33.6,39.0,28.2,00000
61.0,65.0,94.0,991,01,01,  Purbapara,1410,1879,729,984,681,895,42.9,42.6,43.2,00000
61.0,65.0,94.0,991,02,01,  Char Para,1223,1433,678,677,545,756,46.0,50.0,41.9,00000
61.0,65.0,94.0,991,03,01,  Madhyapara,970,887,518,413,452,474,52.2,55.6,48.8,00000
61.0,65.0,94.0,991,04,01,  Aj Purbapara,798,896,427,444,371,452,47.1,49.0,45.1,00000
61.0,65.0,94.0,991,05,01,  Teri Para,441,723,239,368,202,355,37.9,39.4,36.3,00000
61.0,65.0,94.0,991,06,01,  Paschimpara,535,526,284,261,251,265,50.4,52.1,48.6,00000
61.0,65.0,94.0,991,07,01,  Gouri Para,383,331,202,152,181,179,53.6,57.1,50.3,00000
61.0,72.0,13.0,018,01,03,  Garowa,267,462,139,217,128,245,36.6,39.0,34.3,00000
61.0,72.0,13.0,018,02,03,  Haula Para,673,1066,300,529,373,537,38.7,36.2,41.0,00000
61.0,72.0,13.0,018,03,03,  Paschim Shibnagar,306,323,148,147,158,176,48.6,50.2,47.3,00000
61.0,72.0,13.0,018,04,03,  Udang,202,125,91,64,111,61,61.8,58.7,64.5,00000
61.0,72.0,13.0,018,05,03,  Sutaratia,487,440,231,222,256,218,52.5,51.0,54.0,00000
61.0,72.0,13.0,018,06,03,  Goichkali,400,422,186,204,214,218,48.7,47.7,49.5,00000
61.0,72.0,13.0,018,07,03,  Purba Shibnagar,361,455,172,216,189,239,44.2,44.3,44.2,00000
61.0,72.0,13.0,018,08,03,  Jhaugara (Part),160,383,68,170,92,213,29.5,28.6,30.2,00000
61.0,72.0,13.0,018,09,03,  Achargaon (Part),751,533,345,225,406,308,58.5,60.5,56.9,00000
61.0,72.0,13.0,018,10,03,  Sunamkhali,178,171,87,85,91,86,51.0,50.6,51.4,00000
61.0,72.0,13.0,329,01,01,  Dhargaon,1559,2130,794,1019,765,1111,42.3,43.8,40.8,00000
61.0,72.0,13.0,329,02,01,  Nathraj,309,717,160,350,149,367,30.1,31.4,28.9,00000
61.0,72.0,15.0,250,01,01,  Char Madhupur,515,774,256,380,259,394,40.0,40.3,39.7,00000
61.0,72.0,15.0,250,02,01,  Mathalia Para,307,834,144,431,163,403,26.9,25.0,28.8,00000
61.0,72.0,15.0,250,03,01,  Maij Para,708,2103,345,1025,363,1078,25.2,25.2,25.2,00000
61.0,72.0,15.0,250,04,01,  Akanda Para,610,707,298,351,312,356,46.3,45.9,46.7,00000
61.0,72.0,15.0,250,05,01,  Sipaikanda,611,1099,305,544,306,555,35.7,35.9,35.5,00000
61.0,72.0,31.0,130,01,01,  Biara,542,536,297,266,245,270,50.3,52.8,47.6,00000
61.0,72.0,31.0,130,02,01,  Taljhanga,465,368,233,172,232,196,55.8,57.5,54.2,00000
61.0,72.0,31.0,378,01,01,  Gayespur,459,652,235,305,224,347,41.3,43.5,39.2,00000
61.0,72.0,31.0,378,02,01,  Madhya Gayespur,161,266,82,134,79,132,37.7,38.0,37.4,00000
61.0,72.0,31.0,378,03,01,  Pass Gayespur,215,247,106,128,109,119,46.5,45.3,47.8,00000
61.0,72.0,31.0,769,01,01,  Panchbaria,375,380,165,189,210,191,49.7,46.6,52.4,00000
61.0,72.0,31.0,769,02,01,  Gopinathpur,255,478,99,226,156,252,34.8,30.5,38.2,00000
61.0,72.0,31.0,909,01,01,  Sialdhara,360,479,182,227,178,252,42.9,44.5,41.4,00000
61.0,72.0,31.0,909,02,01,  Undail,279,573,140,273,139,300,32.7,33.9,31.7,00000
61.0,72.0,31.0,958,01,01,  Goaria,325,777,148,390,177,387,29.5,27.5,31.4,00000
61.0,72.0,31.0,958,02,01,  Solhary,318,569,126,320,192,249,35.9,28.3,43.5,00000
61.0,72.0,31.0,958,03,01,  Sreerampur,125,468,47,238,78,230,21.1,16.5,25.3,00000
61.0,72.0,39.0,317,01,01,  Deuldanga,1260,1955,593,992,667,963,39.2,37.4,40.9,00000
61.0,72.0,39.0,317,02,01,  Kona Deuldanga,159,571,73,275,86,296,21.8,21.0,22.5,00000
61.0,72.0,39.0,317,03,01,  Para Galgati,189,368,87,179,102,189,33.9,32.7,35.1,00000
61.0,72.0,39.0,335,01,01,  Dhitpur,66,367,30,189,36,178,15.2,13.7,16.8,00000
61.0,72.0,39.0,335,02,01,  Kismat Banagram,444,544,202,263,242,281,44.9,43.4,46.3,00000
61.0,72.0,39.0,470,01,01,  Karikandi,601,1253,311,609,290,644,32.4,33.8,31.0,00000
61.0,72.0,39.0,470,02,01,  Bathuadi,921,1639,448,790,473,849,36.0,36.2,35.8,00000
61.0,72.0,39.0,470,03,01,  Dakshin Jahangirpur,777,1200,381,572,396,628,39.3,40.0,38.7,00000
61.0,72.0,39.0,470,04,01,  Khan Para,221,689,105,318,116,371,24.3,24.8,23.8,00000
61.0,72.0,39.0,470,05,01,  Uttar Jahangirpur,666,894,317,443,349,451,42.7,41.7,43.6,00000
61.0,72.0,39.0,470,06,01,  Talia Para,621,773,299,375,322,398,44.5,44.4,44.7,00000
61.0,72.0,39.0,470,07,01,  Baragharia,284,419,138,203,146,216,40.4,40.5,40.3,00000
61.0,72.0,39.0,860,01,01,  Roypasha,660,1384,317,688,343,696,32.3,31.5,33.0,00000
61.0,72.0,39.0,860,02,01,  Battapur,107,204,53,93,54,111,34.4,36.3,32.7,00000
61.0,72.0,39.0,964,01,01,  Tarapasha,690,836,324,413,366,423,45.2,44.0,46.4,00000
61.0,72.0,39.0,964,02,01,  Hariakandi,151,528,67,273,84,255,22.2,19.7,24.8,00000
61.0,72.0,39.0,964,03,01,  Shahanu Jail,254,162,118,80,136,82,61.1,59.6,62.4,00000
61.0,72.0,47.0,006,01,01,  Abdullahpur,274,933,148,426,126,507,22.7,25.8,19.9,00000
61.0,72.0,47.0,006,02,01,  Haula Para,155,612,96,277,59,335,20.2,25.7,15.0,00000
61.0,72.0,47.0,402,01,01,  Haliura,1792,3238,936,1604,856,1634,35.6,36.9,34.4,00000
61.0,72.0,47.0,402,02,01,  Harirampur,48,139,26,79,22,60,25.7,24.8,26.8,00000
61.0,72.0,47.0,402,03,01,  Nandipur,21,21,16,12,5,9,50.0,57.1,35.7,00000
61.0,72.0,47.0,402,04,01,  Astahail,10,46,5,22,5,24,17.9,18.5,17.2,00000
61.0,72.0,47.0,427,01,01,  Hatshira,323,399,177,184,146,215,44.7,49.0,40.4,00000
61.0,72.0,47.0,427,02,01,  Birashi,274,459,134,246,140,213,37.4,35.3,39.7,00000
61.0,72.0,47.0,579,01,01,  Kharua,692,954,385,485,307,469,42.0,44.3,39.6,00000
61.0,72.0,47.0,579,02,01,  Narandrapur,321,801,155,406,166,395,28.6,27.6,29.6,00000
61.0,72.0,47.0,579,03,01,  Fulbaria,217,459,106,219,111,240,32.1,32.6,31.6,00000
61.0,72.0,47.0,579,04,01,  Chalua Para,380,610,185,287,195,323,38.4,39.2,37.6,00000
61.0,72.0,47.0,579,05,01,  Kakuria,137,148,62,73,75,75,48.1,45.9,50.0,00000
61.0,72.0,47.0,579,06,01,  Char Para,101,196,44,103,57,93,34.0,29.9,38.0,00000
61.0,72.0,47.0,579,07,01,  Matikata,104,124,56,61,48,63,45.6,47.9,43.2,00000
61.0,72.0,47.0,579,08,01,  Tawail,81,76,44,33,37,43,51.6,57.1,46.3,00000
61.0,72.0,47.0,579,09,01,  Habatiakanda,134,137,68,62,66,75,49.4,52.3,46.8,00000
61.0,72.0,47.0,592,01,01,  Koyarpur,308,315,153,143,155,172,49.4,51.7,47.4,00000
61.0,72.0,47.0,592,02,01,  Ramdi,91,137,55,59,36,78,39.9,48.2,31.6,00000
61.0,72.0,47.0,592,03,01,  Joydebpur,38,46,18,21,20,25,45.2,46.2,44.4,00000
61.0,72.0,47.0,592,04,01,  Binbaghair,64,150,36,54,28,96,29.9,40.0,22.6,00000
61.0,72.0,47.0,677,01,01,  Mahishkura,474,640,228,327,246,313,42.5,41.1,44.0,00000
61.0,72.0,47.0,677,02,01,  Dewanganj,589,615,300,289,289,326,48.9,50.9,47.0,00000
61.0,72.0,55.0,872,01,01,  Sadullanagar,42,317,27,145,15,172,11.7,15.7,8.0,00000
61.0,72.0,55.0,872,02,01,  Titkhala,100,179,53,80,47,99,35.8,39.8,32.2,00000
61.0,72.0,55.0,885,01,01,  Saidgram,636,730,314,335,322,395,46.6,48.4,44.9,00000
61.0,72.0,55.0,885,02,01,  Nayanpur,191,296,104,135,87,161,39.2,43.5,35.1,00000
61.0,72.0,55.0,885,03,01,  Kalanga,744,466,395,209,349,257,61.5,65.4,57.6,00000
61.0,72.0,55.0,885,04,01,  Chamta,136,186,86,84,50,102,42.2,50.6,32.9,00000
61.0,72.0,55.0,994,01,01,  Uttar Palahar,473,694,256,350,217,344,40.5,42.2,38.7,00000
61.0,72.0,55.0,994,02,01,  Atka Para,337,508,153,248,184,260,39.9,38.2,41.4,00000
61.0,72.0,63.0,103,01,01,  Bara Para,21,150,8,73,13,77,12.3,9.9,14.4,00000
61.0,72.0,63.0,103,02,01,  Nagar Kachuri,242,317,109,143,133,174,43.3,43.3,43.3,00000
61.0,72.0,63.0,103,03,01,  Rajgati,115,218,57,114,58,104,34.5,33.3,35.8,00000
61.0,72.0,63.0,103,04,01,  Daudpur (Kamarpatti),33,44,19,21,14,23,42.9,47.5,37.8,00000
61.0,72.0,63.0,201,01,01,  Uttar Changbhadara,315,419,143,206,172,213,42.9,41.0,44.7,00000
61.0,72.0,63.0,201,02,01,  Dakshin Changbhadra,342,254,157,116,185,138,57.4,57.5,57.3,00000
61.0,72.0,63.0,207,01,01,  Chapai,251,435,124,224,127,211,36.6,35.6,37.6,00000
61.0,72.0,63.0,207,02,01,  Mohanpur,240,292,106,151,134,141,45.1,41.2,48.7,00000
61.0,72.0,63.0,689,01,01,  Merenga,825,1037,378,480,447,557,44.3,44.1,44.5,00000
61.0,72.0,63.0,689,02,01,  Maijhati,427,732,190,353,237,379,36.8,35.0,38.5,00000
61.0,72.0,63.0,695,01,01,  Muragala,563,671,275,307,288,364,45.6,47.3,44.2,00000
61.0,72.0,63.0,695,02,01,  Mundirbad,127,187,65,90,62,97,40.4,41.9,39.0,00000
61.0,72.0,63.0,701,01,01,  Uttar Musuli,500,826,234,408,266,418,37.7,36.4,38.9,00000
61.0,72.0,63.0,701,02,01,  Panch Musuli,364,594,181,289,183,305,38.0,38.5,37.5,00000
61.0,72.0,63.0,701,03,01,  Ag Musuli,559,521,278,284,281,237,51.8,49.5,54.2,00000
61.0,72.0,63.0,701,04,01,  Naya Para,429,495,199,243,230,252,46.4,45.0,47.7,00000
61.0,72.0,63.0,854,01,01,  Rasulpur,277,575,134,261,143,314,32.5,33.9,31.3,00000
61.0,72.0,63.0,854,02,01,  Chak Mati,353,288,165,139,188,149,55.1,54.3,55.8,00000
61.0,72.0,63.0,854,03,01,  Kismat Rasulpur,353,435,152,219,201,216,44.8,41.0,48.2,00000
61.0,72.0,63.0,854,04,01,  Purba Kamalpur,48,55,20,21,28,34,46.6,48.8,45.2,00000
61.0,72.0,63.0,854,05,01,  Char Para,96,133,39,57,57,76,41.9,40.6,42.9,00000
61.0,72.0,63.0,946,01,01,  Subhakhila,240,474,128,223,112,251,33.6,36.5,30.9,00000
61.0,72.0,63.0,946,02,01,  Narandrapur,153,306,72,141,81,165,33.3,33.8,32.9,00000
61.0,72.0,63.0,946,03,01,  Bahadurpur,331,635,165,297,166,338,34.3,35.7,32.9,00000
61.0,72.0,71.0,146,01,01,  Bhati,1201,2129,610,1011,591,1118,36.1,37.6,34.6,00000
61.0,72.0,71.0,146,02,01,  Patchani,478,878,248,407,230,471,35.3,37.9,32.8,00000
61.0,72.0,71.0,146,03,01,  Charia,596,1044,292,522,304,522,36.3,35.9,36.8,00000
61.0,72.0,71.0,720,01,01,  Monakasha,201,487,105,249,96,238,29.2,29.7,28.7,00000
61.0,72.0,71.0,720,02,01,  Balderpar,124,147,64,79,60,68,45.8,44.8,46.9,00000
61.0,72.0,79.0,280,01,01,  Darilla,746,1254,359,594,387,660,37.3,37.7,37.0,00000
61.0,72.0,79.0,280,02,01,  Paschim Darilla,750,1248,348,596,402,652,37.5,36.9,38.1,00000
61.0,72.0,79.0,824,01,01,  Rajgati Khala Para,429,678,221,321,208,357,38.8,40.8,36.8,00000
61.0,72.0,79.0,824,02,01,  Rajgati,436,896,212,419,224,477,32.7,33.6,32.0,00000
61.0,72.0,87.0,903,01,01,  Sherpur,1690,2709,852,1305,838,1404,38.4,39.5,37.4,00000
61.0,72.0,87.0,903,02,01,  Marakona,828,1142,413,576,415,566,42.0,41.8,42.3,00000
61.0,72.0,87.0,903,03,01,  Matikata,120,313,57,163,63,150,27.7,25.9,29.6,00000
61.0,72.0,87.0,903,04,01,  Madarinagar,1281,1957,635,958,646,999,39.6,39.9,39.3,00000
61.0,72.0,94.0,354,01,01,  Noagaon,432,256,189,128,243,128,62.8,59.6,65.5,00000
61.0,72.0,94.0,354,02,01,  Ghagair,169,147,85,73,84,74,53.5,53.8,53.2,00000
61.0,72.0,94.0,354,03,01,  Dakura Para,173,153,80,76,93,77,53.1,51.3,54.7,00000
61.0,72.0,94.0,354,04,01,  Ullah Para,164,423,82,210,82,213,27.9,28.1,27.8,00000
61.0,72.0,94.0,408,01,01,  Haripur,163,165,78,89,85,76,49.7,46.7,52.8,00000
61.0,72.0,94.0,408,02,01,  Talia,355,355,162,180,193,175,50.0,47.4,52.4,00000
61.0,72.0,94.0,408,03,01,  Bagurikanda,186,543,85,253,101,290,25.5,25.1,25.8,00000
61.0,72.0,94.0,408,04,01,  Dhaki Para,60,188,23,86,37,102,24.2,21.1,26.6,00000
61.0,72.0,94.0,494,01,01,  Kachuri,788,1058,379,510,409,548,42.7,42.6,42.7,00000
61.0,72.0,94.0,494,02,01,  Kandarpapur,205,294,96,136,109,158,41.1,41.4,40.8,00000
61.0,72.0,94.0,494,03,01,  Jalaygati,277,343,123,166,154,177,44.7,42.6,46.5,00000
61.0,72.0,94.0,494,04,01,  Kismat Chachuri,316,537,149,262,167,275,37.0,36.3,37.8,00000
61.0,72.0,94.0,494,05,01,  Nama Para,75,184,42,87,33,97,29.0,32.6,25.4,00000
61.0,72.0,94.0,494,06,01,  Sing Para,202,227,96,100,106,127,47.1,49.0,45.5,00000
61.0,72.0,94.0,494,07,01,  Dhaki Para,158,123,79,62,79,61,56.2,56.0,56.4,00000
61.0,72.0,94.0,726,01,01,  Narayanpur,425,382,199,170,226,212,52.7,53.9,51.6,00000
61.0,72.0,94.0,726,02,01,  Barai Para,289,91,153,30,136,61,76.1,83.6,69.0,00000
61.0,72.0,94.0,726,03,01,  Bakchanda Bazar,328,129,179,60,149,69,71.8,74.9,68.3,00000
61.0,72.0,94.0,933,01,01,  Pachh Singrail,94,143,42,68,52,75,39.7,38.2,40.9,00000
61.0,72.0,94.0,933,02,01,  Hindu Para,142,253,65,124,77,129,35.9,34.4,37.4,00000
61.0,72.0,94.0,933,03,01,  Barua Para,71,146,28,71,43,75,32.7,28.3,36.4,00000
61.0,72.0,94.0,933,04,01,  Krishnapur,190,150,84,64,106,86,55.9,56.8,55.2,00000
61.0,72.0,94.0,933,05,01,  Char Para,124,173,56,99,68,74,41.8,36.1,47.9,00000
61.0,72.0,94.0,933,06,01,  Bhati Para,200,164,94,68,106,96,54.9,58.0,52.5,00000
61.0,72.0,94.0,933,07,01,  Agpara,154,262,65,133,89,129,37.0,32.8,40.8,00000
61.0,72.0,94.0,933,08,01,  Madhyapara,453,690,226,316,227,374,39.6,41.7,37.8,00000
61.0,72.0,94.0,933,09,01,  Nadirpar,235,407,110,194,125,213,36.6,36.2,37.0,00000
61.0,72.0,94.0,933,10,01,  Konadagar,316,429,149,221,167,208,42.4,40.3,44.5,00000
61.0,72.0,94.0,976,01,01,  Udang,611,661,280,305,331,356,48.0,47.9,48.2,00000
61.0,72.0,94.0,976,02,01,  Madhupur,412,520,194,265,218,255,44.2,42.3,46.1,00000
61.0,81.0,11.0,188,01,01,  Paschim Balia,743,1040,386,501,357,539,41.7,43.5,39.8,00000
61.0,81.0,11.0,188,02,01,  Dakshin Balia,824,828,421,387,403,441,49.9,52.1,47.7,00000
61.0,81.0,11.0,188,03,01,  Madhya Balia,592,745,301,340,291,405,44.3,47.0,41.8,00000
61.0,81.0,11.0,188,04,01,  Purba Balia,348,355,192,164,156,191,49.5,53.9,45.0,00000
61.0,81.0,11.0,188,05,01,  Shimulia,341,559,167,266,174,293,37.9,38.6,37.3,00000
61.0,81.0,13.0,634,01,01,  Lautia,1008,1695,524,805,484,890,37.3,39.4,35.2,00000
61.0,81.0,13.0,634,02,01,  Tenguliakanda,264,392,129,183,135,209,40.2,41.3,39.2,00000
61.0,81.0,13.0,663,01,01,  Digharkanda,418,793,217,368,201,425,34.5,37.1,32.1,00000
61.0,81.0,13.0,663,02,01,  Amudpur,74,395,35,193,39,202,15.8,15.4,16.2,00000
61.0,81.0,13.0,663,03,01,  Daudpur,80,290,33,151,47,139,21.6,17.9,25.3,00000
61.0,81.0,13.0,663,04,01,  Majhiail,620,975,300,492,320,483,38.9,37.9,39.9,00000
61.0,81.0,18.0,342,01,01,  Deola,261,310,125,145,136,165,45.7,46.3,45.2,00000
61.0,81.0,18.0,342,02,01,  Bahadurpur,122,210,55,96,67,114,36.7,36.4,37.0,00000
61.0,81.0,31.0,455,01,01,  Hariagati,399,411,191,198,208,213,49.3,49.1,49.4,00000
61.0,81.0,31.0,455,02,01,  Bhadrakanda,526,881,270,434,256,447,37.4,38.4,36.4,00000
61.0,81.0,31.0,455,03,01,  Bhangarpar,81,198,53,95,28,103,29.0,35.8,21.4,00000
61.0,81.0,31.0,637,01,01,  Lunhala,385,978,203,504,182,474,28.2,28.7,27.7,00000
61.0,81.0,31.0,637,02,01,  Kholakhota,130,306,74,157,56,149,29.8,32.0,27.3,00000
61.0,81.0,45.0,428,01,01,  Gobindakhila,156,193,77,89,79,104,44.7,46.4,43.2,00000
61.0,81.0,45.0,428,02,01,  Baherkanda,110,506,58,235,52,271,17.9,19.8,16.1,00000
61.0,81.0,45.0,428,03,01,  Ashiya,131,319,59,148,72,171,29.1,28.5,29.6,00000
61.0,81.0,49.0,492,01,01,  Baladiapara,420,836,207,399,213,437,33.4,34.2,32.8,00000
61.0,81.0,49.0,492,02,01,  Subhalia Para,242,514,109,255,133,259,32.0,29.9,33.9,00000
61.0,81.0,49.0,551,01,01,  Paschim Kamaria,909,1143,474,538,435,605,44.3,46.8,41.8,00000
61.0,81.0,49.0,551,02,01,  Purba Kamaria,1480,2087,687,1013,793,1074,41.5,40.4,42.5,00000
61.0,81.0,49.0,707,01,01,  Paschim Mujahardi,365,685,173,319,192,366,34.8,35.2,34.4,00000
61.0,81.0,49.0,707,02,01,  Purba Mujahardi,507,1185,247,594,260,591,30.0,29.4,30.6,00000
61.0,81.0,54.0,488,01,01,  Paschim Imadpur,841,1275,420,618,421,657,39.7,40.5,39.1,00000
61.0,81.0,54.0,488,02,01,  Purba Imadpur,752,850,375,406,377,444,46.9,48.0,45.9,00000
61.0,81.0,54.0,886,01,01,  Sahapur (Part),794,1046,427,485,367,561,43.2,46.8,39.5,00000
61.0,81.0,54.0,886,02,01,  Sahpur Uttar(Part),269,406,121,219,148,187,39.9,35.6,44.2,00000
61.0,81.0,63.0,372,01,01,  Dhitpur,222,253,100,121,122,132,46.7,45.2,48.0,00000
61.0,81.0,63.0,372,02,01,  Solakhali,94,182,46,93,48,89,34.1,33.1,35.0,00000
61.0,81.0,63.0,687,01,01,  Matichapur,561,1553,241,789,320,764,26.5,23.4,29.5,00000
61.0,81.0,63.0,687,02,01,  Balikanda,243,304,125,147,118,157,44.4,46.0,42.9,00000
61.0,81.0,63.0,687,03,01,  Kushkanda,126,477,65,225,61,252,20.9,22.4,19.5,00000
61.0,81.0,72.0,294,01,01,  Charia,226,308,128,145,98,163,42.3,46.9,37.5,00000
61.0,81.0,72.0,294,02,01,  Meghahala,302,381,148,179,154,202,44.2,45.3,43.3,00000
61.0,81.0,72.0,294,03,01,  Maruakandi,328,573,154,276,174,297,36.4,35.8,36.9,00000
61.0,81.0,72.0,294,04,01,  Nagdora,149,129,77,57,72,72,53.6,57.5,50.0,00000
61.0,81.0,72.0,423,01,01,  Goalkandi,180,388,79,180,101,208,31.7,30.5,32.7,00000
61.0,81.0,72.0,423,02,01,  Hirarkanda,213,288,96,136,117,152,42.5,41.4,43.5,00000
61.0,81.0,72.0,423,03,01,  Narayanpur,97,139,40,74,57,65,41.1,35.1,46.7,00000
61.0,81.0,72.0,856,01,01,  Rampur,426,404,235,189,191,215,51.3,55.4,47.0,00000
61.0,81.0,72.0,856,02,01,  Singherkandi,335,427,178,204,157,223,44.0,46.6,41.3,00000
61.0,81.0,81.0,153,01,01,  Basati,1088,1619,571,743,517,876,40.2,43.5,37.1,00000
61.0,81.0,81.0,153,02,01,  Kanda Para,160,130,79,60,81,70,55.2,56.8,53.6,00000
61.0,81.0,81.0,153,03,01,  Hossainpur,574,545,263,266,311,279,51.3,49.7,52.7,00000
61.0,81.0,81.0,692,01,01,  Tarakanda,236,518,114,241,122,277,31.3,32.1,30.6,00000
61.0,81.0,81.0,692,02,01,  Kharerpar,145,396,73,197,72,199,26.8,27.0,26.6,00000
61.0,81.0,81.0,692,03,01,  Merigai,430,513,213,244,217,269,45.6,46.6,44.7,00000
61.0,81.0,90.0,931,01,01,  Singheshwar,756,678,395,289,361,389,52.7,57.7,48.1,00000
61.0,81.0,90.0,931,02,01,  Chandpur,247,342,125,156,122,186,41.9,44.5,39.6,00000
61.0,81.0,90.0,931,03,01,  Kalirkanda,418,415,189,217,229,198,50.2,46.6,53.6,00000
61.0,81.0,90.0,931,04,01,  Khatshiakanda,243,287,127,143,116,144,45.8,47.0,44.6,00000
61.0,81.0,90.0,931,05,01,  Bhat Para,545,701,263,372,282,329,43.7,41.4,46.2,00000
61.0,81.0,90.0,931,06,01,  Banpara,283,525,119,253,164,272,35.0,32.0,37.6,00000
61.0,81.0,90.0,931,07,01,  Bonuakanda,73,132,34,63,39,69,35.6,35.1,36.1,00000
61.0,81.0,90.0,931,08,01,  Palashkanda,290,462,138,196,152,266,38.6,41.3,36.4,00000
61.0,81.0,90.0,931,09,01,  Jagarkanda,128,317,75,161,53,156,28.8,31.8,25.4,00000
61.0,81.0,90.0,931,10,01,  Mahaljikanda,126,88,57,44,69,44,58.9,56.4,61.1,00000
61.0,94.0,13.0,402,01,01,  Gopalpur,723,565,389,264,334,301,56.1,59.6,52.6,00000
61.0,94.0,13.0,402,02,01,  Chakibari,668,912,333,429,335,483,42.3,43.7,41.0,00000
61.0,94.0,13.0,427,01,01,  Kachachara,782,1207,444,599,338,608,39.3,42.6,35.7,00000
61.0,94.0,13.0,427,02,01,  Nijpara,410,903,231,438,179,465,31.2,34.5,27.8,00000
61.0,94.0,13.0,427,03,01,  Dhanirachala,519,521,278,255,241,266,49.9,52.2,47.5,00000
61.0,94.0,13.0,427,04,01,  Sardanbari,358,408,228,183,130,225,46.7,55.5,36.6,00000
61.0,94.0,13.0,427,05,01,  Puran Kashiganj,559,663,285,299,274,364,45.7,48.8,42.9,00000
61.0,94.0,13.0,427,06,01,  Kathliband,212,317,111,155,101,162,40.1,41.7,38.4,00000
61.0,94.0,15.0,122,01,01,  Ujan Bailar,1147,1325,559,611,588,714,46.4,47.8,45.2,00000
61.0,94.0,15.0,122,02,01,  Sammuk Bailar,1313,1735,636,860,677,875,43.1,42.5,43.6,00000
61.0,94.0,15.0,122,03,01,  Hindu Palli,195,517,97,264,98,253,27.4,26.9,27.9,00000
61.0,94.0,15.0,122,04,01,  Palpara,241,298,126,152,115,146,44.7,45.3,44.1,00000
61.0,94.0,15.0,122,05,01,  Munshi Para,386,637,170,310,216,327,37.7,35.4,39.8,00000
61.0,94.0,15.0,122,06,01,  Mathbari,734,880,396,455,338,425,45.5,46.5,44.3,00000
61.0,94.0,15.0,122,07,01,  Bharadoba,450,759,228,405,222,354,37.2,36.0,38.5,00000
61.0,94.0,15.0,122,08,01,  Char Para,702,1290,347,624,355,666,35.2,35.7,34.8,00000
61.0,94.0,15.0,122,09,01,  Bashkuri,817,1324,410,656,407,668,38.2,38.5,37.9,00000
61.0,94.0,15.0,122,10,01,  Angar Char,90,93,49,49,41,44,49.2,50.0,48.2,00000
61.0,94.0,15.0,122,11,01,  Bakshi Para,215,446,92,222,123,224,32.5,29.3,35.4,00000
61.0,94.0,19.0,218,01,01,  Beara,2114,4200,1106,1991,1008,2209,33.5,35.7,31.3,00000
61.0,94.0,19.0,218,02,01,  Rama Mritaganj,495,268,232,122,263,146,64.9,65.5,64.3,00000
61.0,94.0,28.0,408,01,01,  Katakhali,821,1382,423,657,398,725,37.3,39.2,35.4,00000
61.0,94.0,28.0,408,02,01,  Maishatiki,701,1414,363,695,338,719,33.1,34.3,32.0,00000
61.0,94.0,28.0,408,03,01,  Chowpagaria,877,1190,425,567,452,623,42.4,42.8,42.0,00000
61.0,94.0,28.0,408,04,01,  Latiarpar,506,490,249,239,257,251,50.8,51.0,50.6,00000
61.0,94.0,28.0,408,05,01,  Ujan Daspara,1001,1615,486,788,515,827,38.3,38.1,38.4,00000
61.0,94.0,28.0,408,06,01,  Sonakhali,655,1207,306,565,349,642,35.2,35.1,35.2,00000
61.0,94.0,28.0,408,07,01,  Pajlar Char,581,667,318,314,263,353,46.6,50.3,42.7,00000
61.0,94.0,28.0,408,08,01,  Char Kumaria,1565,1761,773,842,792,919,47.1,47.9,46.3,00000
61.0,94.0,28.0,408,09,01,  Goisa Para,455,658,226,318,229,340,40.9,41.5,40.2,00000
61.0,94.0,28.0,408,10,01,  Hapania,695,863,344,412,351,451,44.6,45.5,43.8,00000
61.0,94.0,28.0,408,11,01,  Palashtali,791,1185,393,571,398,614,40.0,40.8,39.3,00000
61.0,94.0,28.0,408,12,01,  Jhaiarpar,579,770,265,371,314,399,42.9,41.7,44.0,00000
61.0,94.0,28.0,408,13,01,  Bhawalia Para,614,852,327,433,287,419,41.9,43.0,40.7,00000
61.0,94.0,28.0,408,14,01,  Shimulia Para,457,869,217,428,240,441,34.5,33.6,35.2,00000
61.0,94.0,28.0,408,15,01,  Bangu Sarkarer Kanda,151,329,66,162,85,167,31.5,28.9,33.7,00000
61.0,94.0,28.0,408,16,01,  Deaniakanda,133,276,69,126,64,150,32.5,35.4,29.9,00000
61.0,94.0,28.0,408,17,01,  Dakshin Bhati Para,1255,1331,596,645,659,686,48.5,48.0,49.0,00000
61.0,94.0,28.0,408,18,01,  Madhya Bhati Para,1053,1982,486,968,567,1014,34.7,33.4,35.9,00000
61.0,94.0,28.0,408,19,01,  Ujan Bhati Para,1181,1422,562,709,619,713,45.4,44.2,46.5,00000
61.0,94.0,28.0,408,20,01,  Bhati Daspara,866,1157,430,552,436,605,42.8,43.8,41.9,00000
61.0,94.0,38.0,885,01,01,  Rargaon,1187,1890,597,925,590,965,38.6,39.2,37.9,00000
61.0,94.0,38.0,885,02,01,  Nigurkanda,687,993,332,486,355,507,40.9,40.6,41.2,00000
61.0,94.0,38.0,885,03,01,  Dakshinkanda,969,1049,493,493,476,556,48.0,50.0,46.1,00000
61.0,94.0,38.0,885,04,01,  Kanda Para,192,467,92,225,100,242,29.1,29.0,29.2,00000
61.0,94.0,47.0,068,01,01,  Baghadaria,350,428,174,211,176,217,45.0,45.2,44.8,00000
61.0,94.0,47.0,068,02,01,  Char Baghadaria,250,745,133,354,117,391,25.1,27.3,23.0,00000
61.0,94.0,47.0,068,03,01,  Daker Chak,81,87,45,40,36,47,48.2,52.9,43.4,00000
61.0,94.0,47.0,204,01,01,  Barma,847,1870,445,896,402,974,31.2,33.2,29.2,00000
61.0,94.0,47.0,204,02,01,  Alongani,351,725,177,342,174,383,32.6,34.1,31.2,00000
61.0,94.0,47.0,613,01,01,  Kanihari,762,2196,360,1090,402,1106,25.8,24.8,26.7,00000
61.0,94.0,47.0,613,02,01,  Palashtala,131,161,56,67,75,94,44.9,45.5,44.4,00000
61.0,94.0,47.0,613,03,01,  Bahulikanda,129,524,54,239,75,285,19.8,18.4,20.8,00000
61.0,94.0,47.0,613,04,01,  Taltala,330,1286,154,631,176,655,20.4,19.6,21.2,00000
61.0,94.0,47.0,613,05,01,  Madlargop,145,393,73,183,72,210,27.0,28.5,25.5,00000
61.0,94.0,47.0,613,06,01,  Surularkanda,123,296,63,136,60,160,29.4,31.7,27.3,00000
61.0,94.0,47.0,613,07,01,  Sharoghatikanda,201,225,102,101,99,124,47.2,50.2,44.4,00000
61.0,94.0,47.0,967,01,01,  Thapanhala,423,502,195,227,228,275,45.7,46.2,45.3,00000
61.0,94.0,47.0,967,02,01,  Barakanda,118,367,55,173,63,194,24.3,24.1,24.5,00000
61.0,94.0,57.0,626,01,01,  Bangaon,336,761,191,370,145,391,30.6,34.0,27.1,00000
61.0,94.0,57.0,626,02,01,  Dari Kanthal,544,618,274,288,270,330,46.8,48.8,45.0,00000
61.0,94.0,57.0,626,03,01,  Dugulia,733,739,354,356,379,383,49.8,49.9,49.7,00000
61.0,94.0,57.0,626,04,01,  Ainakhet,516,389,258,169,258,220,57.0,60.4,54.0,00000
61.0,94.0,57.0,626,05,01,  Rajabari,485,912,236,451,249,461,34.7,34.4,35.1,00000
61.0,94.0,57.0,626,06,01,  Tentulia,1145,1347,594,657,551,690,45.9,47.5,44.4,00000
61.0,94.0,57.0,626,07,01,  Harder Bhita,1094,1880,543,925,551,955,36.8,37.0,36.6,00000
61.0,94.0,57.0,626,08,01,  Singrail,593,892,306,419,287,473,39.9,42.2,37.8,00000
61.0,94.0,57.0,626,09,01,  Bil Boka,1128,1190,562,580,566,610,48.7,49.2,48.1,00000
61.0,94.0,61.0,024,01,01,  Alahari,304,333,121,174,183,159,47.7,41.0,53.5,00000
61.0,94.0,61.0,024,02,01,  Bada Miah,788,1546,370,735,418,811,33.8,33.5,34.0,00000
61.0,94.0,61.0,024,03,01,  Durgapur,729,1270,369,590,360,680,36.5,38.5,34.6,00000
61.0,94.0,61.0,024,04,01,  Jyada,498,613,244,278,254,335,44.8,46.7,43.1,00000
61.0,94.0,61.0,024,05,01,  Kharhor,555,811,277,397,278,414,40.6,41.1,40.2,00000
61.0,94.0,61.0,024,06,01,  Koragachha,111,1083,76,559,35,524,9.3,12.0,6.3,00000
61.0,94.0,61.0,024,07,01,  Tanpara,478,723,235,343,243,380,39.8,40.7,39.0,00000
61.0,94.0,61.0,024,08,01,  Egara Para,198,472,93,252,105,220,29.6,27.0,32.3,00000
61.0,94.0,61.0,583,01,01,  Porabari Doradi Para,669,526,354,263,315,263,56.0,57.4,54.5,00000
61.0,94.0,61.0,583,02,01,  Khagati Para,1091,2901,554,1343,537,1558,27.3,29.2,25.6,00000
61.0,94.0,61.0,583,03,01,  Bamankhali,317,525,165,256,152,269,37.6,39.2,36.1,00000
61.0,94.0,61.0,583,04,01,  Roymani,961,1695,491,863,470,832,36.2,36.3,36.1,00000
61.0,94.0,61.0,583,05,01,  Hariaguni,106,267,58,122,48,145,28.4,32.2,24.9,00000
61.0,94.0,66.0,872,01,03,  Darirampur,239,198,124,89,115,109,54.7,58.2,51.3,00000
61.0,94.0,66.0,872,02,03,  Bir Rampur,837,793,460,380,377,413,51.3,54.8,47.7,00000
61.0,94.0,66.0,872,03,03,  Chak Rampur,2006,3509,996,1660,1010,1849,36.4,37.5,35.3,00000
61.0,94.0,66.0,872,04,03,  Char Para,2527,2116,1236,1048,1291,1068,54.4,54.1,54.7,00000
61.0,94.0,66.0,872,05,03,  Bhati Para,1524,3180,809,1574,715,1606,32.4,33.9,30.8,00000
36.2,61.0,94.0,085,940,01,*Silimpur,2394,3337,1213,1589,1181,1748,41.8,43.3,40.3,00000
67.0,2.0,23.0,021,01,03,  Araihazar Krishnapura,91,135,53,68,38,67,40.3,43.8,36.2,00000
67.0,2.0,23.0,021,02,03,  Araihazar,1524,429,819,193,705,236,78.0,80.9,74.9,00000
67.0,2.0,23.0,021,03,03,  Dighirpar,94,18,54,9,40,9,83.9,85.7,81.6,00000
67.0,2.0,23.0,021,04,03,  Debipura,121,85,64,46,57,39,58.7,58.2,59.4,00000
67.0,2.0,23.0,021,05,03,  Goal Para,98,66,50,34,48,32,59.8,59.5,60.0,00000
67.0,2.0,23.0,021,06,03,  Nagar Para,210,265,111,135,99,130,44.2,45.1,43.2,00000
67.0,2.0,23.0,467,01,01,  Binar Char,392,447,213,233,179,214,46.7,47.8,45.5,00000
67.0,2.0,23.0,467,02,01,  Jhaugara,514,1410,272,690,242,720,26.7,28.3,25.2,00000
67.0,2.0,23.0,467,03,01,  Lakhupura,82,128,36,57,46,71,39.0,38.7,39.3,00000
67.0,2.0,23.0,467,04,01,  Dighaldi,284,130,136,65,148,65,68.6,67.7,69.5,00000
67.0,2.0,23.0,467,05,01,  Jhaugara Krishnapura,26,168,11,91,15,77,13.4,10.8,16.3,00000
67.0,2.0,23.0,559,01,01,  Majar Char,234,250,128,125,106,125,48.3,50.6,45.9,00000
67.0,2.0,23.0,559,02,01,  Kamrangir Char,883,892,477,431,406,461,49.7,52.5,46.8,00000
67.0,2.0,23.0,559,03,01,  Hatkhola,92,221,41,119,51,102,29.4,25.6,33.3,00000
67.0,2.0,23.0,559,04,01,  Daspara,407,757,197,374,210,383,35.0,34.5,35.4,00000
67.0,2.0,23.0,559,05,01,  Chamirkandi,640,667,322,292,318,375,49.0,52.4,45.9,00000
67.0,2.0,23.0,559,06,01,  Mougakanda,23,366,7,170,16,196,5.9,4.0,7.5,00000
67.0,2.0,23.0,693,01,01,  Mukundi,358,600,180,301,178,299,37.4,37.4,37.3,00000
67.0,2.0,23.0,693,02,01,  Panna Baraipara,643,261,312,122,331,139,71.1,71.9,70.4,00000
67.0,2.0,23.0,747,01,01,  Noapara,756,1196,373,602,383,594,38.7,38.3,39.2,00000
67.0,2.0,23.0,747,02,01,  Abdullapur,179,195,95,83,84,112,47.9,53.4,42.9,00000
67.0,2.0,26.0,172,01,01,  P.Bishnandi,562,1545,311,775,251,770,26.7,28.6,24.6,00000
67.0,2.0,26.0,172,02,01,  Purbapara,452,1038,234,494,218,544,30.3,32.1,28.6,00000
67.0,2.0,26.0,172,03,01,  Kala Para,236,508,122,266,114,242,31.7,31.4,32.0,00000
67.0,2.0,26.0,172,04,01,  Chaler Char,103,471,47,219,56,252,17.9,17.7,18.2,00000
67.0,2.0,26.0,301,01,01,  Dari Bishnandi,877,1124,477,547,400,577,43.8,46.6,40.9,00000
67.0,2.0,26.0,301,02,01,  Naya Para,254,825,158,418,96,407,23.5,27.4,19.1,00000
67.0,2.0,26.0,333,01,01,  Dayakanda,920,2820,498,1336,422,1484,24.6,27.2,22.1,00000
67.0,2.0,26.0,333,02,01,  Naya Para,145,341,81,149,64,192,29.8,35.2,25.0,00000
67.0,2.0,26.0,333,03,01,  Kanda Para,62,263,29,142,33,121,19.1,17.0,21.4,00000
67.0,2.0,26.0,333,04,01,  Chandanpura,62,258,29,112,33,146,19.4,20.6,18.4,00000
67.0,2.0,26.0,408,01,01,  Gazipura,924,1402,474,694,450,708,39.7,40.6,38.9,00000
67.0,2.0,26.0,408,02,01,  Baluakandi,238,701,129,342,109,359,25.3,27.4,23.3,00000
67.0,2.0,26.0,564,01,01,  Karaitala,587,1481,320,723,267,758,28.4,30.7,26.0,00000
67.0,2.0,26.0,564,02,01,  Sharifpur,225,695,115,335,110,360,24.5,25.6,23.4,00000
67.0,2.0,26.0,564,03,01,  Panchkania,175,442,78,221,97,221,28.4,26.1,30.5,00000
67.0,2.0,26.0,564,04,01,  Roypura,74,147,33,80,41,67,33.5,29.2,38.0,00000
67.0,2.0,29.0,086,01,01,  Balia Para,1914,1387,973,713,941,674,58.0,57.7,58.3,00000
67.0,2.0,29.0,086,02,01,  Kadamdi,94,129,47,62,47,67,42.2,43.1,41.2,00000
67.0,2.0,29.0,086,03,01,  Bhartibalia Para,563,359,287,173,276,186,61.1,62.4,59.7,00000
67.0,2.0,29.0,371,01,01,  Edbardi,1314,827,698,396,616,431,61.4,63.8,58.8,00000
67.0,2.0,29.0,371,02,01,  Utrapur,525,666,276,326,249,340,44.1,45.8,42.3,00000
67.0,2.0,31.0,069,01,01,  Bajbi,859,776,453,410,406,366,52.5,52.5,52.6,00000
67.0,2.0,31.0,069,02,01,  Purbapara,665,304,399,128,266,176,68.6,75.7,60.2,00000
67.0,2.0,31.0,069,03,01,  Tati Para,548,511,280,275,268,236,51.7,50.5,53.2,00000
67.0,2.0,31.0,365,01,01,  Hatkhola Para,452,310,233,136,219,174,59.3,63.1,55.7,00000
67.0,2.0,31.0,365,02,01,  Kalibari Bazar,100,46,89,41,11,5,68.5,68.5,68.8,00000
67.0,2.0,31.0,365,03,01,  Patita Para,149,87,75,47,74,40,63.1,61.5,64.9,00000
67.0,2.0,31.0,365,04,01,  Kumar Para,543,480,261,224,282,256,53.1,53.8,52.4,00000
67.0,2.0,31.0,365,05,01,  Khan Para,661,310,338,163,323,147,68.1,67.5,68.7,00000
67.0,2.0,31.0,365,06,01,  Raghabdi,328,470,175,232,153,238,41.1,43.0,39.1,00000
67.0,2.0,31.0,365,07,01,  Singrati,38,385,21,207,17,178,9.0,9.2,8.7,00000
67.0,2.0,31.0,365,08,01,  Nutan Banti,371,367,179,192,192,175,50.3,48.2,52.3,00000
67.0,2.0,31.0,365,09,01,  Malpara,251,435,143,208,108,227,36.6,40.7,32.2,00000
67.0,2.0,31.0,365,10,01,  Chowdhury Para,448,478,194,245,254,233,48.4,44.2,52.2,00000
67.0,2.0,31.0,365,11,01,  Girda Para,1142,846,640,398,502,448,57.4,61.7,52.8,00000
67.0,2.0,31.0,365,12,01,  Nagar Para,318,197,226,138,92,59,61.7,62.1,60.9,00000
67.0,2.0,31.0,365,13,01,  Rishi Para,93,481,58,237,35,244,16.2,19.7,12.5,00000
67.0,2.0,31.0,365,14,01,  Kathalia Para,163,145,101,77,62,68,52.9,56.7,47.7,00000
67.0,2.0,31.0,365,15,01,  Paschimpara,294,183,156,93,138,90,61.6,62.7,60.5,00000
67.0,2.0,31.0,763,01,01,  Manehar,310,249,173,126,137,123,55.5,57.9,52.7,00000
67.0,2.0,31.0,763,02,01,  Char Para,651,648,319,313,332,335,50.1,50.5,49.8,00000
67.0,2.0,31.0,763,03,01,  Karmakar Para,251,178,137,78,114,100,58.5,63.7,53.3,00000
67.0,2.0,31.0,763,04,01,  Dewan Para,391,608,212,308,179,300,39.1,40.8,37.4,00000
67.0,2.0,31.0,763,05,01,  Nayapara,466,398,238,211,228,187,53.9,53.0,54.9,00000
67.0,2.0,31.0,763,06,01,  Mollah Para,1007,846,491,396,516,450,54.3,55.4,53.4,00000
67.0,2.0,31.0,763,07,01,  Panchbaria,1277,1235,616,592,661,643,50.8,51.0,50.7,00000
67.0,2.0,31.0,860,01,01,  Dari Satyabhandi,678,1025,341,572,337,453,39.8,37.3,42.7,00000
67.0,2.0,31.0,860,02,01,  Nayapara,359,161,194,75,165,86,69.0,72.1,65.7,00000
67.0,2.0,31.0,860,03,01,  Bhuyan Para,978,350,502,165,476,185,73.6,75.3,72.0,00000
67.0,2.0,31.0,860,04,01,  Mollah Para,360,280,190,129,170,151,56.3,59.6,53.0,00000
67.0,2.0,31.0,951,01,01,  Tingaon,416,432,210,222,206,210,49.1,48.6,49.5,00000
67.0,2.0,31.0,951,02,01,  Duptara Bazar,67,40,47,22,20,18,62.6,68.1,52.6,00000
67.0,2.0,39.0,043,01,01,  Bagadi,450,886,215,434,235,452,33.7,33.1,34.2,00000
67.0,2.0,39.0,043,02,01,  Dakshinpara,100,246,44,128,56,118,28.9,25.6,32.2,00000
67.0,2.0,39.0,048,01,01,  Bagadi Noapara,252,463,113,244,139,219,35.2,31.7,38.8,00000
67.0,2.0,39.0,048,02,01,  Jalakandi,5,40,2,22,3,18,11.1,8.3,14.3,00000
67.0,2.0,39.0,107,01,01,  Kanda Para,477,475,237,232,240,243,50.1,50.5,49.7,00000
67.0,2.0,39.0,107,02,01,  Dakshinpara,53,48,29,24,24,24,52.5,54.7,50.0,00000
67.0,2.0,39.0,231,01,01,  Chautharkhanda,25,62,15,35,10,27,28.7,30.0,27.0,00000
67.0,2.0,39.0,231,02,01,  Nayakhanda,139,397,74,220,65,177,25.9,25.2,26.9,00000
67.0,2.0,39.0,231,03,01,  Akhar Para,249,790,122,407,127,383,24.0,23.1,24.9,00000
67.0,2.0,39.0,231,04,01,  Nagarjoar,70,162,40,81,30,81,30.2,33.1,27.0,00000
67.0,2.0,39.0,618,01,01,  Goal Para,320,200,174,98,146,102,61.5,64.0,58.9,00000
67.0,2.0,39.0,618,02,01,  Dakshinpara,76,105,39,50,37,55,42.0,43.8,40.2,00000
67.0,2.0,47.0,091,01,01,  Ballabhdi,260,445,132,218,128,227,36.9,37.7,36.1,00000
67.0,2.0,47.0,091,02,01,  Ballabhdi Khanda,187,422,99,213,88,209,30.7,31.7,29.6,00000
67.0,2.0,47.0,091,03,01,  Barujkhanda,54,111,28,55,26,56,32.7,33.7,31.7,00000
67.0,2.0,47.0,150,01,01,  Bhiti Kamaldi,293,220,142,108,151,112,57.1,56.8,57.4,00000
67.0,2.0,47.0,150,02,01,  Para Manohardi,242,368,113,181,129,187,39.7,38.4,40.8,00000
67.0,2.0,47.0,274,01,01,  Chhota Salmadi,77,69,40,33,37,36,52.7,54.8,50.7,00000
67.0,2.0,47.0,274,02,01,  Salmadi,106,71,50,32,56,39,59.9,61.0,58.9,00000
67.0,2.0,47.0,392,01,01,  Gadadhardi,55,69,28,34,27,35,44.4,45.2,43.5,00000
67.0,2.0,47.0,392,02,01,  Chandibardi,166,204,73,85,93,119,44.9,46.2,43.9,00000
67.0,2.0,47.0,392,03,01,  Saizadi,71,170,24,83,47,87,29.5,22.4,35.1,00000
67.0,2.0,47.0,424,01,01,  Hazadi,209,117,99,54,110,63,64.1,64.7,63.6,00000
67.0,2.0,47.0,424,02,01,  Nayapara,161,428,77,219,84,209,27.3,26.0,28.7,00000
67.0,2.0,47.0,424,03,01,  Singhadirkanda,50,217,28,98,22,119,18.7,22.2,15.6,00000
67.0,2.0,47.0,424,04,01,  Apardi,53,127,23,62,30,65,29.4,27.1,31.6,00000
67.0,2.0,47.0,510,01,01,  Kahindi,202,631,96,301,106,330,24.2,24.2,24.3,00000
67.0,2.0,47.0,510,02,01,  Khandakar Kalagachhia,78,400,34,187,44,213,16.3,15.4,17.1,00000
67.0,2.0,47.0,510,03,01,  Ramnagar,82,122,40,61,42,61,40.2,39.6,40.8,00000
67.0,2.0,47.0,527,01,01,  Kalagachhia,841,1152,434,539,407,613,42.2,44.6,39.9,00000
67.0,2.0,47.0,527,02,01,  Nagarjoar,109,193,56,94,53,99,36.1,37.3,34.9,00000
67.0,2.0,47.0,553,01,01,  Daria Singapur,139,225,65,109,74,116,38.2,37.4,38.9,00000
67.0,2.0,47.0,553,02,01,  Narandi,733,1198,355,570,378,628,38.0,38.4,37.6,00000
67.0,2.0,47.0,553,03,01,  Sultansadi,38,23,17,11,21,12,62.3,60.7,63.6,00000
67.0,2.0,47.0,553,04,01,  Ilamdi,188,252,91,122,97,130,42.7,42.7,42.7,00000
67.0,2.0,47.0,645,01,01,  Madhabdi,398,741,186,349,212,392,34.9,34.8,35.1,00000
67.0,2.0,47.0,645,02,01,  Ilamdi Kandapara,354,573,160,266,194,307,38.2,37.6,38.7,00000
67.0,2.0,47.0,645,03,01,  Daldirkanda,12,80,5,29,7,51,13.0,14.7,12.1,00000
67.0,2.0,47.0,806,01,01,  Roynadi,83,140,49,57,34,83,37.2,46.2,29.1,00000
67.0,2.0,47.0,806,02,01,  Tuterbhag,220,412,110,207,110,205,34.8,34.7,34.9,00000
67.0,2.0,47.0,806,03,01,  Paschim Sarapdi,161,196,83,102,78,94,45.1,44.9,45.3,00000
67.0,2.0,47.0,806,04,01,  Purba Sarapdi,47,34,24,14,23,20,58.0,63.2,53.5,00000
67.0,2.0,47.0,865,01,01,  Sendi,253,570,110,259,143,311,30.7,29.8,31.5,00000
67.0,2.0,47.0,865,02,01,  Sendi Hajibari,43,165,19,82,24,83,20.7,18.8,22.4,00000
67.0,2.0,47.0,887,01,01,  Singhadi,463,483,222,215,241,268,48.9,50.8,47.3,00000
67.0,2.0,47.0,887,02,01,  Asarampur,158,128,71,56,87,72,55.2,55.9,54.7,00000
67.0,2.0,55.0,473,01,01,  Jhukandi,399,1215,201,536,198,679,24.7,27.3,22.6,00000
67.0,2.0,55.0,473,02,01,  Madhyachar,329,1417,160,680,169,737,18.8,19.0,18.7,00000
67.0,2.0,55.0,473,03,01,  Purbakandi,379,925,206,405,173,520,29.1,33.7,25.0,00000
67.0,2.0,55.0,500,01,01,  Kadmir Char,241,1141,145,539,96,602,17.4,21.2,13.8,00000
67.0,2.0,55.0,500,02,01,  Badalpur,234,478,104,187,130,291,32.9,35.7,30.9,00000
67.0,2.0,55.0,532,01,01,  Kalapaharia,487,1862,280,857,207,1005,20.7,24.6,17.1,00000
67.0,2.0,55.0,532,02,01,  Noagaon,126,838,74,400,52,438,13.1,15.6,10.6,00000
67.0,2.0,55.0,736,01,01,  Ezarkandi,395,1515,211,634,184,881,20.7,25.0,17.3,00000
67.0,2.0,55.0,736,02,01,  Gobindapur,161,477,91,220,70,257,25.2,29.3,21.4,00000
67.0,2.0,55.0,736,03,01,  Radhanagar,555,1006,302,462,253,544,35.6,39.5,31.7,00000
67.0,2.0,55.0,736,04,01,  Hazirtek,730,1570,410,684,320,886,31.7,37.5,26.5,00000
67.0,2.0,55.0,736,05,01,  Ulukandi,366,921,216,409,150,512,28.4,34.6,22.7,00000
67.0,2.0,55.0,736,06,01,  Khaliar Char,402,1857,215,883,187,974,17.8,19.6,16.1,00000
67.0,2.0,55.0,736,07,01,  Chan Kasimpur,47,302,28,128,19,174,13.5,17.9,9.8,00000
67.0,2.0,55.0,736,08,01,  Ali Pura,50,480,25,243,25,237,9.4,9.3,9.5,00000
67.0,2.0,63.0,220,01,01,  Kamalapur,37,294,21,145,16,149,11.2,12.7,9.7,00000
67.0,2.0,63.0,220,02,01,  Dengurkandi,86,749,45,380,41,369,10.3,10.6,10.0,00000
67.0,2.0,63.0,731,01,01,  Sambhupura,621,321,267,136,354,185,65.9,66.3,65.7,00000
67.0,2.0,63.0,731,02,01,  Mohanpura,457,668,203,312,254,356,40.6,39.4,41.6,00000
67.0,2.0,63.0,731,03,01,  Nijar Para,102,187,50,88,52,99,35.3,36.2,34.4,00000
67.0,2.0,63.0,731,04,01,  Dumar Char,299,477,146,209,153,268,38.5,41.1,36.3,00000
67.0,2.0,63.0,731,05,01,  Naya Para,40,98,20,46,20,52,29.0,30.3,27.8,00000
67.0,2.0,63.0,731,06,01,  Panchani,266,509,124,244,142,265,34.3,33.7,34.9,00000
67.0,2.0,63.0,731,07,01,  Kadamtali,99,300,43,144,56,156,24.8,23.0,26.4,00000
67.0,2.0,63.0,731,08,01,  Tatuakanda (Ka),195,252,94,107,101,145,43.6,46.8,41.1,00000
67.0,2.0,63.0,731,09,01,  Lalurkandi,500,511,247,233,253,278,49.5,51.5,47.6,00000
67.0,2.0,63.0,731,10,01,  Manikpur,45,175,27,79,18,96,20.5,25.5,15.8,00000
67.0,2.0,63.0,731,11,01,  Aganagar,98,213,50,107,48,106,31.5,31.8,31.2,00000
67.0,2.0,63.0,731,12,01,  Champaknagar,175,416,100,180,75,236,29.6,35.7,24.1,00000
67.0,2.0,63.0,731,13,01,  Baher Char,300,468,159,220,141,248,39.1,42.0,36.2,00000
67.0,2.0,63.0,731,14,01,  Tataytala,279,387,140,170,139,217,41.9,45.2,39.0,00000
67.0,2.0,63.0,731,15,01,  Nayanabad,510,1008,250,463,260,545,33.6,35.1,32.3,00000
67.0,2.0,63.0,731,16,01,  Lalnagar,552,646,278,304,274,342,46.1,47.8,44.5,00000
67.0,2.0,63.0,731,17,01,  Najarpura,56,139,27,68,29,71,28.7,28.4,29.0,00000
67.0,2.0,63.0,731,18,01,  Islampur,110,275,48,129,62,146,28.6,27.1,29.8,00000
67.0,2.0,63.0,731,19,01,  Hoglakanda,199,222,97,94,102,128,47.3,50.8,44.3,00000
67.0,2.0,63.0,731,20,01,  Khagkanda,573,1297,292,585,281,712,30.6,33.3,28.3,00000
67.0,2.0,63.0,731,21,01,  Khagkanda Naya Para,186,655,83,298,103,357,22.1,21.8,22.4,00000
67.0,2.0,63.0,731,22,01,  Tatuakanda (Kha),314,527,144,230,170,297,37.3,38.5,36.4,00000
67.0,2.0,63.0,731,23,01,  Jalarpar Kanda Para,14,286,8,140,6,146,4.7,5.4,3.9,00000
67.0,2.0,63.0,731,24,01,  Pachani Chaker Bari,71,146,38,69,33,77,32.7,35.5,30.0,00000
67.0,2.0,71.0,537,01,01,  Uttarpara,398,627,190,310,208,317,38.8,38.0,39.6,00000
67.0,2.0,71.0,537,02,01,  Molla Para,203,376,97,162,106,214,35.1,37.5,33.1,00000
67.0,2.0,71.0,537,03,01,  Balia Para,403,1315,185,703,218,612,23.5,20.8,26.3,00000
67.0,2.0,71.0,537,04,01,  Gang Para,129,159,68,78,61,81,44.8,46.6,43.0,00000
67.0,2.0,71.0,537,05,01,  Bhiti Para,172,213,75,109,97,104,44.7,40.8,48.3,00000
67.0,2.0,71.0,537,06,01,  Khoas Para,158,465,74,239,84,226,25.4,23.6,27.1,00000
67.0,2.0,79.0,414,01,01,  Gopaldi,1267,747,690,357,577,390,62.9,65.9,59.7,00000
67.0,2.0,79.0,414,02,01,  Ulukandi,2547,2195,1383,1122,1164,1073,53.7,55.2,52.0,00000
67.0,2.0,79.0,596,01,01,  Kanda Para,231,234,116,114,115,120,49.7,50.4,48.9,00000
67.0,2.0,79.0,596,02,01,  Muradpur,268,229,144,126,124,103,53.9,53.3,54.6,00000
67.0,2.0,79.0,596,03,01,  Lakshmibardi,1707,785,927,389,780,396,68.5,70.4,66.3,00000
67.0,2.0,79.0,817,01,01,  Ratnagardi,42,286,24,140,18,146,12.8,14.6,11.0,00000
67.0,2.0,79.0,817,02,01,  Sonakanda,321,635,168,314,153,321,33.6,34.9,32.3,00000
67.0,2.0,79.0,839,01,01,  Shadashadi,1143,1124,595,563,548,561,50.4,51.4,49.4,00000
67.0,2.0,79.0,839,02,01,  Kamalapur,174,176,99,86,75,90,49.7,53.5,45.5,00000
67.0,2.0,79.0,994,01,01,  Uttar Kalagachhia,818,581,461,287,357,294,58.5,61.6,54.8,00000
67.0,2.0,79.0,994,02,01,  Kalagachhia,336,828,169,426,167,402,28.9,28.4,29.3,00000
67.0,2.0,79.0,994,03,01,  Kalamiarkandi,179,107,103,44,76,63,62.6,70.1,54.7,00000
67.0,2.0,79.0,994,04,01,  Hoglakandi,276,417,125,211,151,206,39.8,37.2,42.3,00000
67.0,2.0,79.0,994,05,01,  Rishi Para,42,287,20,147,22,140,12.8,12.0,13.6,00000
67.0,2.0,79.0,994,06,01,  Naya Para,81,78,44,37,37,41,50.9,54.3,47.4,00000
67.0,2.0,87.0,118,01,01,  Matain,906,892,455,440,451,452,50.4,50.8,49.9,00000
67.0,2.0,87.0,118,02,01,  Noagaon,1036,1313,493,684,543,629,44.1,41.9,46.3,00000
67.0,2.0,87.0,118,03,01,  Tekpara,1784,2478,942,1216,842,1262,41.9,43.7,40.0,00000
67.0,2.0,87.0,118,04,01,  Purinda,2183,1640,1145,810,1038,830,57.1,58.6,55.6,00000
67.0,2.0,87.0,118,05,01,  Noynagar,63,47,37,21,26,26,57.3,63.8,50.0,00000
67.0,2.0,87.0,338,01,01,  Deabai,513,776,274,391,239,385,39.8,41.2,38.3,00000
67.0,2.0,87.0,338,02,01,  Kapaliar Tek,131,145,56,85,75,60,47.5,39.7,55.6,00000
67.0,2.0,87.0,769,01,03,  Sanpara,908,517,448,227,460,290,63.7,66.4,61.3,00000
67.0,2.0,87.0,769,02,03,  Maiz Para,566,1029,267,515,299,514,35.5,34.1,36.8,00000
67.0,2.0,87.0,769,03,03,  Ghosh Para,163,144,96,66,67,78,53.1,59.3,46.2,00000
67.0,2.0,87.0,769,04,03,  Naya Para,215,91,106,38,109,53,70.3,73.6,67.3,00000
67.0,2.0,87.0,769,05,03,  Khan Para,143,177,71,88,72,89,44.7,44.7,44.7,00000
67.0,2.0,87.0,769,06,03,  Bhuyan Para,176,133,91,56,85,77,57.0,61.9,52.5,00000
67.0,2.0,87.0,769,07,03,  Purbapara,259,273,134,138,125,135,48.7,49.3,48.1,00000
67.0,2.0,87.0,769,08,03,  Dighirpar,209,137,111,65,98,72,60.4,63.1,57.6,00000
67.0,2.0,87.0,769,09,03,  Gazaria Khal Para,348,281,165,134,183,147,55.3,55.2,55.5,00000
67.0,2.0,87.0,769,10,03,  Paschimpara,1495,1258,857,657,638,601,54.3,56.6,51.5,00000
67.0,2.0,87.0,769,11,03,  Singrati,2,7,1,5,1,2,22.2,16.7,33.3,00000
67.0,2.0,87.0,812,01,01,  Rasulpur,2040,1584,1048,792,992,792,56.3,57.0,55.6,00000
67.0,2.0,87.0,812,02,01,  Bahadurpur,524,829,280,430,244,399,38.7,39.4,37.9,00000
67.0,2.0,87.0,812,03,01,  Bilpar,67,381,30,197,37,184,15.0,13.2,16.7,00000
67.0,2.0,87.0,855,01,01,  Sakhergaon,331,403,156,212,175,191,45.1,42.4,47.8,00000
67.0,2.0,87.0,855,02,01,  Satgram,383,273,163,124,220,149,58.4,56.8,59.6,00000
67.0,2.0,87.0,855,03,01,  Pakutura,104,103,52,52,52,51,50.2,50.0,50.5,00000
67.0,2.0,87.0,855,04,01,  Nowadda,271,247,131,122,140,125,52.3,51.8,52.8,00000
67.0,2.0,87.0,855,05,01,  Ziar Tek,132,317,72,166,60,151,29.4,30.3,28.4,00000
67.0,2.0,87.0,855,06,01,  Burburiar Tek,75,234,35,117,40,117,24.3,23.0,25.5,00000
67.0,2.0,87.0,855,07,01,  Dopar Tek,114,471,41,255,73,216,19.5,13.9,25.3,00000
67.0,2.0,87.0,855,08,01,  Asuhat,503,712,225,373,278,339,41.4,37.6,45.1,00000
67.0,2.0,94.0,026,01,01,  Purba Atadi,367,653,167,307,200,346,36.0,35.2,36.6,00000
67.0,2.0,94.0,026,02,01,  Paschim Atadi,239,475,119,249,120,226,33.5,32.3,34.7,00000
67.0,2.0,94.0,026,03,01,  Sitaramkandi,156,154,66,72,90,82,50.3,47.8,52.3,00000
67.0,2.0,94.0,161,01,01,  Bijoynagar (Beparibari),177,412,83,207,94,205,30.1,28.6,31.4,00000
67.0,2.0,94.0,161,02,01,  Dadigoan,65,331,25,164,40,167,16.4,13.2,19.3,00000
67.0,2.0,94.0,451,01,01,  Jangalia,945,1544,480,747,465,797,38.0,39.1,36.8,00000
67.0,2.0,94.0,451,02,01,  Changakandi Para,323,349,158,154,165,195,48.1,50.6,45.8,00000
67.0,4.0,24.0,093,01,01,  Ramgong,21,46,11,23,10,23,31.3,32.4,30.3,00000
67.0,4.0,24.0,093,02,01,  Maligaon,39,222,19,119,20,103,14.9,13.8,16.3,00000
67.0,4.0,24.0,349,01,01,  Ulukandi,236,236,176,122,60,114,50.0,59.1,34.5,00000
67.0,4.0,24.0,349,02,01,  Daudargaon,137,199,68,103,69,96,40.8,39.8,41.8,00000
67.0,4.0,24.0,463,01,01,  Tati Para,70,207,33,116,37,91,25.3,22.1,28.9,00000
67.0,4.0,24.0,463,02,01,  Paschimpara,98,267,43,135,55,132,26.8,24.2,29.4,00000
67.0,4.0,24.0,463,03,01,  Naya Mati,220,316,106,159,114,157,41.0,40.0,42.1,00000
67.0,4.0,24.0,463,04,01,  Bamna Dighirpar,57,126,27,66,30,60,31.1,29.0,33.3,00000
67.0,4.0,24.0,463,05,01,  Dhanpur,102,176,47,89,55,87,36.7,34.6,38.7,00000
67.0,4.0,24.0,463,06,01,  Durgapur,119,101,63,48,56,53,54.1,56.8,51.4,00000
67.0,4.0,24.0,463,07,01,  Guabari,39,28,17,15,22,13,58.2,53.1,62.9,00000
67.0,4.0,24.0,463,08,01,  Dakarband,211,187,113,87,98,100,53.0,56.5,49.5,00000
67.0,4.0,24.0,463,09,01,  Pachani,76,32,37,19,39,13,70.4,66.1,75.0,00000
67.0,4.0,24.0,463,10,01,  Kashipur,72,66,33,31,39,35,52.2,51.6,52.7,00000
67.0,4.0,24.0,463,11,01,  Marabari,71,126,32,63,39,63,36.0,33.7,38.2,00000
67.0,4.0,24.0,463,12,01,  Rambadrarbagh,127,173,64,93,63,80,42.3,40.8,44.1,00000
67.0,4.0,24.0,463,13,01,  Bhabanipur,73,79,38,42,35,37,48.0,47.5,48.6,00000
67.0,4.0,24.0,463,14,01,  H.Khaser Kanda,235,185,122,96,113,89,56.0,56.0,55.9,00000
67.0,4.0,24.0,463,15,01,  Kanchan Nagar,50,66,25,34,25,32,43.1,42.4,43.9,00000
67.0,4.0,24.0,466,01,01,  Haria Chowdhury Para,484,573,259,282,225,291,45.8,47.9,43.6,00000
67.0,4.0,24.0,466,02,01,  Haria Chakrabarti Para,81,57,44,30,37,27,58.7,59.5,57.8,00000
67.0,4.0,24.0,466,03,01,  Haria Gobindi,42,198,19,91,23,107,17.5,17.3,17.7,00000
67.0,4.0,24.0,466,04,01,  Haria Baidya Para,689,1050,336,543,353,507,39.6,38.2,41.0,00000
67.0,4.0,24.0,562,01,01,  Khamargaon,260,446,133,210,127,236,36.8,38.8,35.0,00000
67.0,4.0,24.0,562,02,01,  Sanpara,269,289,143,142,126,147,48.2,50.2,46.2,00000
67.0,4.0,24.0,562,03,01,  Amirabad,71,131,32,72,39,59,35.1,30.8,39.8,00000
67.0,4.0,24.0,730,01,01,  Nagarjoar,39,67,18,37,21,30,36.8,32.7,41.2,00000
67.0,4.0,24.0,730,02,01,  Roypur,86,224,34,111,52,113,27.7,23.4,31.5,00000
67.0,4.0,24.0,827,01,01,  Dakshin Damodardi,405,659,210,339,195,320,38.1,38.3,37.9,00000
67.0,4.0,24.0,827,02,01,  Uttar Damodardi,229,223,124,105,105,118,50.7,54.1,47.1,00000
67.0,4.0,24.0,827,03,01,  Paschim Damodardi,205,151,108,53,97,98,57.6,67.1,49.7,00000
67.0,4.0,24.0,827,04,01,  Hariganj,134,138,71,71,63,67,49.3,50.0,48.5,00000
67.0,4.0,24.0,827,05,01,  Panchabati,316,313,170,155,146,158,50.2,52.3,48.0,00000
67.0,4.0,27.0,073,01,01,  Bara Alamdi,464,362,228,180,236,182,56.2,55.9,56.5,00000
67.0,4.0,27.0,073,02,01,  Chander Bhola,102,132,52,60,50,72,43.6,46.4,41.0,00000
67.0,4.0,27.0,099,01,01,  Baradi Bazar,70,21,57,10,13,11,76.9,85.1,54.2,00000
67.0,4.0,27.0,099,02,01,  Chowdhury Para,32,55,14,22,18,33,36.8,38.9,35.3,00000
67.0,4.0,27.0,099,03,01,  Senpara,406,573,196,286,210,287,41.5,40.7,42.3,00000
67.0,4.0,27.0,099,04,01,  Mistry Para,310,117,162,51,148,66,72.6,76.1,69.2,00000
67.0,4.0,27.0,099,05,01,  Daspara,55,61,27,30,28,31,47.4,47.4,47.5,00000
67.0,4.0,27.0,099,06,01,  Nagpara,56,117,30,54,26,63,32.4,35.7,29.2,00000
67.0,4.0,27.0,099,07,01,  Dalardi,281,273,136,125,145,148,50.7,52.1,49.5,00000
67.0,4.0,27.0,099,08,01,  Puran Nagar,303,296,144,136,159,160,50.6,51.4,49.8,00000
67.0,4.0,27.0,099,09,01,  Orollahpur,118,113,53,50,65,63,51.1,51.5,50.8,00000
67.0,4.0,27.0,099,10,01,  Ballabherkandi,244,225,137,99,107,126,52.0,58.1,45.9,00000
67.0,4.0,27.0,099,11,01,  Raghunath Royer Dighirpar,79,85,45,36,34,49,48.2,55.6,41.0,00000
67.0,4.0,27.0,099,12,01,  Bhenga Majirpukur,44,37,23,15,21,22,54.3,60.5,48.8,00000
67.0,4.0,27.0,099,13,01,  Mothar Pukurpar,165,81,85,36,80,45,67.1,70.2,64.0,00000
67.0,4.0,27.0,099,14,01,  Chader Para,287,415,136,191,151,224,40.9,41.6,40.3,00000
67.0,4.0,27.0,099,15,01,  Markundi Pur,116,60,56,29,60,31,65.9,65.9,65.9,00000
67.0,4.0,27.0,420,01,01,  Bastoon Bagh,156,136,76,68,80,68,53.4,52.8,54.1,00000
67.0,4.0,27.0,420,02,01,  Khaserkandi,40,75,25,34,15,41,34.8,42.4,26.8,00000
67.0,4.0,27.0,449,01,01,  Goal Para,374,269,176,121,198,148,58.2,59.3,57.2,00000
67.0,4.0,27.0,449,02,01,  Joynagar,19,17,9,6,10,11,52.8,60.0,47.6,00000
67.0,4.0,27.0,636,01,01,  Machhlandapur,288,470,130,207,158,263,38.0,38.6,37.5,00000
67.0,4.0,27.0,636,02,01,  Khashbagh,320,255,160,127,160,128,55.7,55.7,55.6,00000
67.0,4.0,27.0,636,03,01,  Machhlandapur Paschim Para,132,288,54,133,78,155,31.4,28.9,33.5,00000
67.0,4.0,27.0,636,04,01,  Mandar Para,310,570,130,284,180,286,35.2,31.4,38.6,00000
67.0,4.0,27.0,690,01,01,  Panchbagh,199,393,99,194,100,199,33.6,33.8,33.4,00000
67.0,4.0,27.0,690,02,01,  Kolabagh,14,70,6,39,8,31,16.7,13.3,20.5,00000
67.0,4.0,27.0,690,03,01,  Bagher Para,123,255,62,137,61,118,32.5,31.2,34.1,00000
67.0,4.0,27.0,696,01,01,  Markandadi,73,113,39,52,34,61,39.2,42.9,35.8,00000
67.0,4.0,27.0,696,02,01,  Jhau Gara,50,26,22,10,28,16,65.8,68.8,63.6,00000
67.0,4.0,27.0,790,01,01,  Nunertek,465,1178,239,573,226,605,28.3,29.4,27.2,00000
67.0,4.0,27.0,790,02,01,  Tekpara,109,324,47,134,62,190,25.2,26.0,24.6,00000
67.0,4.0,27.0,790,04,01,  Ragunar Char,39,173,24,77,15,96,18.4,23.8,13.5,00000
67.0,4.0,27.0,790,05,01,  Shantiban,33,152,19,67,14,85,17.8,22.1,14.1,00000
67.0,4.0,27.0,790,06,01,  Sabuj Bagh,69,202,26,93,43,109,25.5,21.8,28.3,00000
67.0,4.0,34.0,127,01,01,  Basigaon,403,494,206,234,197,260,44.9,46.8,43.1,00000
67.0,4.0,34.0,127,02,01,  Mali Para,427,312,206,166,221,146,57.8,55.4,60.2,00000
67.0,4.0,34.0,130,01,01,  Basabo,316,352,154,166,162,186,47.3,48.1,46.6,00000
67.0,4.0,34.0,130,02,01,  Banshtal,817,860,431,406,386,454,48.7,51.5,46.0,00000
67.0,4.0,34.0,198,01,01,  Brahmanbaga,540,856,283,439,257,417,38.7,39.2,38.1,00000
67.0,4.0,34.0,198,02,01,  Bagabaria,316,501,184,277,132,224,38.7,39.9,37.1,00000
67.0,4.0,34.0,201,01,01,  Burumdi,1177,464,601,211,576,253,71.7,74.0,69.5,00000
67.0,4.0,34.0,201,02,01,  Jhalkandi,220,89,130,36,90,53,71.2,78.3,62.9,00000
67.0,4.0,34.0,500,01,01,  Jampur,807,504,416,245,391,259,61.6,62.9,60.2,00000
67.0,4.0,34.0,500,02,01,  Kadamtali,351,181,187,87,164,94,66.0,68.2,63.6,00000
67.0,4.0,34.0,528,01,01,  Khaena,345,195,171,87,174,108,63.9,66.3,61.7,00000
67.0,4.0,34.0,528,02,01,  Balabu,353,261,179,123,174,138,57.5,59.3,55.8,00000
67.0,4.0,34.0,921,01,01,  Sinlaba,167,312,76,154,91,158,34.9,33.0,36.5,00000
67.0,4.0,34.0,921,02,01,  Gabtali,240,224,131,133,109,91,51.7,49.6,54.5,00000
67.0,4.0,34.0,969,01,01,  Tilaba,158,233,83,109,75,124,40.4,43.2,37.7,00000
67.0,4.0,34.0,969,02,01,  Nanaba,150,203,74,114,76,89,42.5,39.4,46.1,00000
67.0,4.0,34.0,969,03,01,  Faittaba,205,134,116,71,89,63,60.5,62.0,58.6,00000
67.0,4.0,34.0,980,01,01,  Utma,433,320,253,143,180,177,57.5,63.9,50.4,00000
67.0,4.0,34.0,980,02,01,  Ambagh,253,127,144,57,109,70,66.6,71.6,60.9,00000
67.0,4.0,43.0,139,01,01,  Purba Behakair,2779,2945,1424,1502,1355,1443,48.5,48.7,48.4,00000
67.0,4.0,43.0,139,02,01,  Paschim Behakair,2079,741,1079,336,1000,405,73.7,76.3,71.2,00000
67.0,4.0,43.0,139,03,01,  Sonapur,7058,2679,3677,1164,3381,1515,72.5,76.0,69.1,00000
67.0,4.0,43.0,287,01,01,  Bara Chengail,1081,1323,568,692,513,631,45.0,45.1,44.8,00000
67.0,4.0,43.0,287,02,01,  Khalpar Chengail,581,512,318,259,263,253,53.2,55.1,51.0,00000
67.0,4.0,43.0,287,03,01,  Kashipur,322,146,170,74,152,72,68.8,69.7,67.9,00000
67.0,4.0,43.0,523,01,01,  Kanchpur,6349,2959,3373,1314,2976,1645,68.2,72.0,64.4,00000
67.0,4.0,43.0,523,02,01,  Senpara,3166,2215,1772,1036,1394,1179,58.8,63.1,54.2,00000
67.0,4.0,43.0,523,03,01,  Pathatta,740,272,443,141,297,131,73.1,75.9,69.4,00000
67.0,4.0,43.0,591,01,01,  Kusaba,414,327,229,151,185,176,55.9,60.3,51.2,00000
67.0,4.0,43.0,591,02,01,  Sukher Tek,565,543,292,250,273,293,51.0,53.9,48.2,00000
67.0,4.0,51.0,028,01,01,  Ashrafdi,112,354,68,170,44,184,24.0,28.6,19.3,00000
67.0,4.0,51.0,028,02,01,  Durlabherkandi,16,37,7,20,9,17,30.2,25.9,34.6,00000
67.0,4.0,51.0,113,01,01,  Bari Majlish,3000,839,1607,412,1393,427,78.1,79.6,76.5,00000
67.0,4.0,51.0,113,02,01,  Bari Chinish,1007,274,580,131,427,143,78.6,81.6,74.9,00000
67.0,4.0,51.0,147,01,01,  Bhairabdi,249,235,130,127,119,108,51.4,50.6,52.4,00000
67.0,4.0,51.0,147,02,01,  Daldar,121,191,58,88,63,103,38.8,39.7,38.0,00000
67.0,4.0,51.0,270,01,01,  Char Subika,89,137,59,79,30,58,39.4,42.8,34.1,00000
67.0,4.0,51.0,270,02,01,  Chhota Kazirgoan,191,120,102,52,89,68,61.4,66.2,56.7,00000
67.0,4.0,51.0,270,03,01,  Kanainagar,65,27,32,10,33,17,70.7,76.2,66.0,00000
67.0,4.0,51.0,537,01,01,  Kaliganj,172,189,104,87,68,102,47.6,54.5,40.0,00000
67.0,4.0,51.0,537,02,01,  Majher Char,278,133,146,69,132,64,67.6,67.9,67.3,00000
67.0,4.0,51.0,537,03,01,  Ilusdi(Eliasdi),235,365,126,170,109,195,39.2,42.6,35.9,00000
67.0,4.0,51.0,560,01,01,  Khalia Para,73,107,42,49,31,58,40.6,46.2,34.8,00000
67.0,4.0,51.0,560,02,01,  Baghbari,159,116,77,54,82,62,57.8,58.8,56.9,00000
67.0,4.0,51.0,639,01,01,  Madhabpur,399,109,219,53,180,56,78.5,80.5,76.3,00000
67.0,4.0,51.0,639,02,01,  Pich Madhabpur,112,68,58,28,54,40,62.2,67.4,57.4,00000
67.0,4.0,51.0,912,01,01,  Shola Para,761,378,380,179,381,199,66.8,68.0,65.7,00000
67.0,4.0,51.0,912,02,01,  Bisheskhana,115,100,52,46,63,54,53.5,53.1,53.8,00000
67.0,4.0,51.0,912,03,01,  Dahar Para,155,80,74,40,81,40,66.0,64.9,66.9,00000
67.0,4.0,51.0,912,04,01,  Mogra Para Bazar,5,33,5,32,0,1,13.2,13.5,0.0,00000
67.0,4.0,60.0,068,01,01,  Baneshwardi,112,175,56,87,56,88,39.0,39.2,38.9,00000
67.0,4.0,60.0,068,02,01,  Pekir Char,94,222,38,112,56,110,29.7,25.3,33.7,00000
67.0,4.0,60.0,247,01,01,  Gobindapur,557,245,283,103,274,142,69.5,73.3,65.9,00000
67.0,4.0,60.0,247,02,01,  Char Para,307,330,138,162,169,168,48.2,46.0,50.1,00000
67.0,4.0,60.0,596,01,01,  Ladhur Char,1013,1187,477,563,536,624,46.0,45.9,46.2,00000
67.0,4.0,60.0,596,02,01,  Nich Chak,537,555,244,272,293,283,49.2,47.3,50.9,00000
67.0,4.0,60.0,596,03,01,  Chowra Para,536,1110,267,483,269,627,32.6,35.6,30.0,00000
67.0,4.0,60.0,596,04,01,  Bijoynagar,167,341,82,164,85,177,32.9,33.3,32.4,00000
67.0,4.0,60.0,596,05,01,  Shekandi,287,388,141,196,146,192,42.5,41.8,43.2,00000
67.0,4.0,60.0,596,06,01,  Bhowmik Para,216,394,113,198,103,196,35.4,36.3,34.4,00000
67.0,4.0,60.0,602,01,01,  Lakshmibardi,148,408,59,191,89,217,26.6,23.6,29.1,00000
67.0,4.0,60.0,602,02,01,  Dari Para,182,190,71,85,111,105,48.9,45.5,51.4,00000
67.0,4.0,60.0,602,03,01,  Kanda Para,179,217,84,110,95,107,45.2,43.3,47.0,00000
67.0,4.0,60.0,753,01,01,  Naogaon,388,507,197,232,191,275,43.4,45.9,41.0,00000
67.0,4.0,60.0,753,02,01,  Char Naogaon,300,233,145,113,155,120,56.3,56.2,56.4,00000
67.0,4.0,60.0,753,03,01,  Dhandi,65,113,27,59,38,54,36.5,31.4,41.3,00000
67.0,4.0,60.0,753,04,01,  Munshirpur,346,88,160,40,186,48,79.7,80.0,79.5,00000
67.0,4.0,60.0,821,01,01,  Parameshwardi,770,419,380,197,390,222,64.8,65.9,63.7,00000
67.0,4.0,60.0,821,02,01,  Sankandi,405,635,217,314,188,321,38.9,40.9,36.9,00000
67.0,4.0,60.0,821,03,01,  Bhiti Parameshwardi,590,386,329,195,261,191,60.5,62.8,57.7,00000
67.0,4.0,69.0,235,01,01,  Chengakandi,453,439,261,223,192,216,50.8,53.9,47.1,00000
67.0,4.0,69.0,235,02,01,  Manaikandi,388,191,224,79,164,112,67.0,73.9,59.4,00000
67.0,4.0,69.0,267,01,01,  Jauchar,2938,2493,1993,1322,945,1171,54.1,60.1,44.7,00000
67.0,4.0,69.0,267,02,01,  Protaper Char,2415,917,1410,429,1005,488,72.5,76.7,67.3,00000
67.0,4.0,69.0,267,03,01,  Ganganagar,919,500,726,276,193,224,64.8,72.5,46.3,00000
67.0,4.0,69.0,267,04,01,  Islampur,1018,611,769,355,249,256,62.5,68.4,49.3,00000
67.0,4.0,69.0,267,05,01,  Kadirgaon,1391,561,1004,317,387,244,71.3,76.0,61.3,00000
67.0,4.0,69.0,267,06,01,  Adharsha Gram,191,191,103,104,88,87,50.0,49.8,50.3,00000
67.0,4.0,69.0,295,01,01,  Chayhishya,448,281,237,128,211,153,61.5,64.9,58.0,00000
67.0,4.0,69.0,295,02,01,  Purba Kandergaon,403,260,220,121,183,139,60.8,64.5,56.8,00000
67.0,4.0,69.0,400,01,01,  Chander Chak,153,72,73,26,80,46,68.0,73.7,63.5,00000
67.0,4.0,69.0,400,02,01,  Dudhghata,1084,1170,509,550,575,620,48.1,48.1,48.1,00000
67.0,4.0,69.0,400,03,01,  Kurbanpur,442,471,223,236,219,235,48.4,48.6,48.2,00000
67.0,4.0,69.0,497,01,01,  Jainpur,829,414,420,194,409,220,66.7,68.4,65.0,00000
67.0,4.0,69.0,497,02,01,  Paschim Kandergaon,236,174,113,88,123,86,57.6,56.2,58.9,00000
67.0,4.0,69.0,741,01,01,  Nagergaon,379,162,186,78,193,84,70.1,70.5,69.7,00000
67.0,4.0,69.0,741,02,01,  Mirdakandi,589,122,394,59,195,63,82.8,87.0,75.6,00000
67.0,4.0,69.0,761,01,01,  Ratanpur,304,152,161,69,143,83,66.7,70.0,63.3,00000
67.0,4.0,69.0,761,02,01,  Maricherkandi,95,78,43,35,52,43,54.9,55.1,54.7,00000
67.0,4.0,69.0,838,01,01,  Pirijpur,1913,1132,1114,642,799,490,62.8,63.4,62.0,00000
67.0,4.0,69.0,838,02,01,  Nayagaon,258,254,135,121,123,133,50.4,52.7,48.0,00000
67.0,4.0,77.0,096,01,01,  Baraba,552,616,285,320,267,296,47.3,47.1,47.4,00000
67.0,4.0,77.0,096,02,01,  Baistaki,419,624,236,318,183,306,40.2,42.6,37.4,00000
67.0,4.0,77.0,105,01,01,  Baraibari,242,226,136,105,106,121,51.7,56.4,46.7,00000
67.0,4.0,77.0,105,02,01,  Bailor,336,465,187,261,149,204,41.9,41.7,42.2,00000
67.0,4.0,77.0,153,01,01,  Bharat,459,366,231,181,228,185,55.6,56.1,55.2,00000
67.0,4.0,77.0,153,02,01,  Konabari,685,591,325,263,360,328,53.7,55.3,52.3,00000
67.0,4.0,77.0,153,03,01,  Gozaria Para,861,611,471,307,390,304,58.5,60.5,56.2,00000
67.0,4.0,77.0,153,04,01,  Shoruamgaon,59,157,37,67,22,90,27.3,35.6,19.6,00000
67.0,4.0,77.0,156,01,01,  Khidirpur,589,409,331,218,258,191,59.0,60.3,57.5,00000
67.0,4.0,77.0,156,02,01,  Naya Para,490,591,250,311,240,280,45.3,44.6,46.2,00000
67.0,4.0,77.0,156,03,01,  Dargahbari,254,526,133,275,121,251,32.6,32.6,32.5,00000
67.0,4.0,77.0,156,04,01,  Goalbari,11,20,7,10,4,10,35.5,41.2,28.6,00000
67.0,4.0,77.0,156,05,01,  Bhargaon,1005,1218,500,626,505,592,45.2,44.4,46.0,00000
67.0,4.0,77.0,156,06,01,  Kazi Para,363,454,189,248,174,206,44.4,43.2,45.8,00000
67.0,4.0,77.0,156,07,01,  Nandipur,261,205,142,100,119,105,56.0,58.7,53.1,00000
67.0,4.0,77.0,156,08,01,  Noagaon,140,165,72,81,68,84,45.9,47.1,44.7,00000
67.0,4.0,77.0,156,09,01,  Choura Para,430,514,238,264,192,250,45.6,47.4,43.4,00000
67.0,4.0,77.0,156,10,01,  Baishtaki,499,374,286,163,213,211,57.2,63.7,50.2,00000
67.0,4.0,77.0,156,11,01,  Gangapur,232,365,117,180,115,185,38.9,39.4,38.3,00000
67.0,4.0,77.0,776,01,01,  Deobhog,348,522,184,273,164,249,40.0,40.3,39.7,00000
67.0,4.0,77.0,776,02,01,  Andhar Manik,315,711,151,392,164,319,30.7,27.8,34.0,00000
67.0,4.0,77.0,776,03,01,  Nayapur,906,636,498,322,408,314,58.8,60.7,56.5,00000
67.0,4.0,77.0,776,04,01,  Kanthali Para,592,738,423,464,169,274,44.5,47.7,38.1,00000
67.0,4.0,77.0,779,01,01,  Panchamighat,331,114,161,50,170,64,74.4,76.3,72.6,00000
67.0,4.0,77.0,779,02,01,  Nagar Tangabo,247,184,140,97,107,87,57.3,59.1,55.2,00000
67.0,4.0,77.0,779,03,01,  Belpara,217,312,107,159,110,153,41.0,40.2,41.8,00000
67.0,4.0,77.0,779,04,01,  Gulnagar,175,288,100,141,75,147,37.8,41.5,33.8,00000
67.0,4.0,77.0,779,05,01,  Kazardi,302,199,170,95,132,104,60.3,64.2,55.9,00000
67.0,4.0,77.0,779,06,01,  Baniabari,236,172,118,88,118,84,57.8,57.3,58.4,00000
67.0,4.0,77.0,779,07,01,  Noakandi,639,271,331,134,308,137,70.2,71.2,69.2,00000
67.0,4.0,77.0,779,08,01,  Bishnupur,193,145,96,65,97,80,57.1,59.6,54.8,00000
67.0,4.0,77.0,884,01,01,  Amgaon,473,540,255,269,218,271,46.7,48.7,44.6,00000
67.0,4.0,77.0,884,02,01,  Chotrabasa,202,279,110,141,92,138,42.0,43.8,40.0,00000
67.0,4.0,77.0,884,03,01,  Mulkhar Tek,243,648,130,381,113,267,27.3,25.4,29.7,00000
67.0,4.0,77.0,884,04,01,  Laskarbari,169,360,81,180,88,180,31.9,31.0,32.8,00000
67.0,4.0,77.0,884,05,01,  Boragaon,1220,1393,674,737,546,656,46.7,47.8,45.4,00000
67.0,4.0,77.0,884,06,01,  Dakshinpara,118,142,57,69,61,73,45.4,45.2,45.5,00000
67.0,4.0,77.0,884,07,01,  Pingila,19,82,7,41,12,41,18.8,14.6,22.6,00000
67.0,4.0,77.0,923,01,01,  Sinraba,168,177,92,91,76,86,48.7,50.3,46.9,00000
67.0,4.0,77.0,923,02,01,  Diabari,12,20,5,11,7,9,37.5,31.3,43.8,00000
67.0,4.0,86.0,253,01,01,  Char Hogla,1378,889,741,421,637,468,60.8,63.8,57.6,00000
67.0,4.0,86.0,253,02,01,  Madhya Char,387,525,196,250,191,275,42.4,43.9,41.0,00000
67.0,4.0,86.0,622,01,01,  Elahinagar Mollar Para,287,94,152,54,135,40,75.3,73.8,77.1,00000
67.0,4.0,86.0,622,02,01,  Elahinagar Paschim Para,613,289,298,130,315,159,68.0,69.6,66.5,00000
67.0,4.0,86.0,722,01,01,  Mugar Char,265,182,127,87,138,95,59.3,59.3,59.2,00000
67.0,4.0,86.0,722,02,01,  Tekpara,155,128,72,59,83,69,54.8,55.0,54.6,00000
67.0,4.0,86.0,722,03,01,  Manairkandi,296,322,143,149,153,173,47.9,49.0,46.9,00000
67.0,4.0,86.0,770,01,01,  Gobindpur,271,60,127,25,144,35,81.9,83.6,80.4,00000
67.0,4.0,86.0,770,02,01,  Baniachang,387,339,186,162,201,177,53.3,53.4,53.2,00000
67.0,4.0,86.0,892,01,01,  Shambhupura,497,617,239,300,258,317,44.6,44.3,44.9,00000
67.0,4.0,86.0,892,02,01,  Darigaon,460,417,231,202,229,215,52.5,53.3,51.6,00000
67.0,4.0,94.0,082,01,01,  Khetergaon,113,195,53,93,60,102,36.7,36.3,37.0,00000
67.0,4.0,94.0,082,02,01,  Noakandi,190,52,89,21,101,31,78.5,80.9,76.5,00000
67.0,4.0,94.0,082,03,01,  Lama Para,41,30,20,10,21,20,57.7,66.7,51.2,00000
67.0,4.0,94.0,309,01,01,  Kheter Bhulua,117,122,53,59,64,63,49.0,47.3,50.4,00000
67.0,4.0,94.0,309,02,01,  Dakshinpara,266,255,136,121,130,134,51.1,52.9,49.2,00000
67.0,4.0,94.0,346,01,01,  Dakshin Darikandi,90,186,50,98,40,88,32.6,33.8,31.3,00000
67.0,4.0,94.0,346,02,01,  Gangkul,93,137,44,67,49,70,40.4,39.6,41.2,00000
67.0,4.0,94.0,380,01,01,  Daulatpur,267,181,144,68,123,113,59.6,67.9,52.1,00000
67.0,4.0,94.0,380,02,01,  Darikandi,278,151,149,74,129,77,64.8,66.8,62.6,00000
67.0,4.0,94.0,548,01,01,  Kanda Para,178,203,74,90,104,113,46.7,45.1,47.9,00000
67.0,4.0,94.0,548,02,01,  Sazalerkandi,122,79,59,36,63,43,60.7,62.1,59.4,00000
67.0,4.0,94.0,614,01,01,  Majhir Char,150,296,76,131,74,165,33.6,36.7,31.0,00000
67.0,4.0,94.0,614,02,01,  Baniatala,48,35,31,13,17,22,57.8,70.5,43.6,00000
67.0,4.0,94.0,710,01,01,  Darikandi,389,315,215,158,174,157,55.3,57.6,52.6,00000
67.0,4.0,94.0,710,02,01,  Jhaddergaon,313,157,173,72,140,85,66.6,70.6,62.2,00000
67.0,4.0,94.0,710,03,01,  Sochergaon,85,57,45,22,40,35,59.9,67.2,53.3,00000
67.0,4.0,94.0,710,04,01,  Bhitikandi,136,210,75,97,61,113,39.3,43.6,35.1,00000
67.0,4.0,94.0,710,05,01,  Baluakandi,173,123,91,51,82,72,58.4,64.1,53.2,00000
67.0,4.0,94.0,895,01,01,  Purba Sanmandi,1299,1470,673,734,626,736,46.9,47.8,46.0,00000
67.0,4.0,94.0,895,02,01,  Paschim Sanmandi,749,763,352,379,397,384,49.5,48.2,50.8,00000
67.0,4.0,94.0,895,03,01,  Sonkanda,411,363,221,159,190,204,53.1,58.2,48.2,00000
67.0,4.0,94.0,895,04,01,  Maheshwardi,222,169,116,79,106,90,56.8,59.5,54.1,00000
67.0,4.0,94.0,895,05,01,  Kapaia Kandi,147,333,74,173,73,160,30.6,30.0,31.3,00000
67.0,4.0,94.0,895,06,01,  Goperbagh,342,587,178,286,164,301,36.8,38.4,35.3,00000
67.0,4.0,94.0,895,07,01,  Masurakandi,387,407,203,208,184,199,48.7,49.4,48.0,00000
67.0,4.0,94.0,895,08,01,  Baraikandi,163,174,88,79,75,95,48.4,52.7,44.1,00000
67.0,4.0,94.0,895,09,01,  Katakhali,74,88,38,52,36,36,45.7,42.2,50.0,00000
67.0,4.0,94.0,940,01,01,  Jangal,356,339,176,161,180,178,51.2,52.2,50.3,00000
67.0,4.0,94.0,940,02,01,  Baburkandi,116,182,64,91,52,91,38.9,41.3,36.4,00000
67.0,4.0,94.0,940,03,01,  Sonarkandi,217,109,119,63,98,46,66.6,65.4,68.1,00000
67.0,4.0,94.0,940,04,01,  Naya Para,113,169,52,87,61,82,40.1,37.4,42.7,00000
67.0,4.0,94.0,940,05,01,  Boterkandi,277,244,134,128,143,116,53.2,51.1,55.2,00000
67.0,4.0,94.0,940,06,01,  Chengakandi,664,332,330,159,334,173,66.7,67.5,65.9,00000
67.0,4.0,94.0,940,07,01,  Nowabkandi,171,188,92,78,79,110,47.6,54.1,41.8,00000
67.0,4.0,94.0,940,08,01,  Panchani,227,423,108,209,119,214,34.9,34.1,35.7,00000
67.0,4.0,94.0,940,09,01,  Girdain,343,180,174,91,169,89,65.6,65.7,65.5,00000
67.0,4.0,94.0,940,10,01,  Charlal,482,268,249,119,233,149,64.3,67.7,61.0,00000
67.0,4.0,94.0,940,11,01,  Imanerkandi,662,496,326,235,336,261,57.2,58.1,56.3,00000
67.0,4.0,94.0,940,12,01,  Bhatir Char,225,229,117,101,108,128,49.6,53.7,45.8,00000
67.0,6.0,15.0,082,01,01,  Puran Bandar,157,168,63,80,94,88,48.3,44.1,51.6,00000
67.0,6.0,15.0,082,02,01,  Jhalokati,208,74,93,29,115,45,73.8,76.2,71.9,00000
67.0,6.0,15.0,082,03,01,  Chowdhurybari{Colony},827,1028,374,534,453,494,44.6,41.2,47.8,00000
67.0,6.0,15.0,082,04,01,  Kalabagh,2819,2390,1472,1197,1347,1193,54.1,55.2,53.0,00000
67.0,6.0,15.0,082,05,01,  Kanda Para,548,277,275,127,273,150,66.4,68.4,64.5,00000
67.0,6.0,15.0,082,06,01,  Kazibari {Chowdhury Bari},456,568,236,264,220,304,44.5,47.2,42.0,00000
67.0,6.0,15.0,553,01,01,  Kusiara,2705,1640,1374,806,1331,834,62.3,63.0,61.5,00000
67.0,6.0,15.0,553,02,01,  Padugar,295,191,160,88,135,103,60.7,64.5,56.7,00000
67.0,6.0,15.0,553,03,01,  Olak,489,412,231,209,258,203,54.3,52.5,56.0,00000
67.0,6.0,15.0,651,01,01,  Mirkundir Char (Baluchar),294,247,118,128,176,119,54.3,48.0,59.7,00000
67.0,6.0,15.0,651,02,01,  Raghabdi,25,51,9,30,16,21,32.9,23.1,43.2,00000
67.0,6.0,15.0,953,01,01,  Tingaon,916,596,484,292,432,304,60.6,62.4,58.7,00000
67.0,6.0,15.0,953,02,01,  Bhadrason,323,264,157,122,166,142,55.0,56.3,53.9,00000
67.0,6.0,31.0,030,01,01,  Amair,631,236,320,102,311,134,72.8,75.8,69.9,00000
67.0,6.0,31.0,030,02,01,  Karaiabari,168,96,91,55,77,41,63.6,62.3,65.3,00000
67.0,6.0,31.0,194,01,01,  Chandarbari,98,56,52,20,46,36,63.6,72.2,56.1,00000
67.0,6.0,31.0,194,02,01,  Battala,253,179,141,82,112,97,58.6,63.2,53.6,00000
67.0,6.0,31.0,194,03,01,  Gokul Daserbagh,1115,509,646,229,469,280,68.7,73.8,62.6,00000
67.0,6.0,31.0,276,01,01,  Monarbari,546,446,300,219,246,227,55.0,57.8,52.0,00000
67.0,6.0,31.0,276,02,01,  Ranijhee,175,143,81,66,94,77,55.0,55.1,55.0,00000
67.0,6.0,31.0,276,03,01,  Malamat,608,453,326,221,282,232,57.3,59.6,54.9,00000
67.0,6.0,31.0,276,04,01,  Senerbari,594,826,313,382,281,444,41.8,45.0,38.8,00000
67.0,6.0,31.0,276,05,01,  Nayamati,705,556,323,243,382,313,55.9,57.1,55.0,00000
67.0,6.0,31.0,276,06,01,  Choirarbari,362,185,194,94,168,91,66.2,67.4,64.9,00000
67.0,6.0,31.0,276,07,01,  Dhamgar,562,672,304,332,258,340,45.5,47.8,43.1,00000
67.0,6.0,31.0,276,08,01,  Josheerpar,28,78,10,40,18,38,26.4,20.0,32.1,00000
67.0,6.0,31.0,441,01,01,  Kamtal,862,841,470,405,392,436,50.6,53.7,47.3,00000
67.0,6.0,31.0,441,02,01,  Royerbagh,51,56,30,25,21,31,47.7,54.5,40.4,00000
67.0,6.0,31.0,441,03,01,  Malibhita,407,401,208,199,199,202,50.4,51.1,49.6,00000
67.0,6.0,31.0,441,04,01,  Dasdona,367,284,212,127,155,157,56.4,62.5,49.7,00000
67.0,6.0,31.0,441,05,01,  Shyampur,91,220,53,110,38,110,29.3,32.5,25.7,00000
67.0,6.0,31.0,441,06,01,  Mohjampur,228,131,135,58,93,73,63.5,69.9,56.0,00000
67.0,6.0,31.0,441,07,01,  Jugi Para,135,67,72,25,63,42,66.8,74.2,60.0,00000
67.0,6.0,31.0,441,08,01,  Chirai Para,224,229,113,113,111,116,49.4,50.0,48.9,00000
67.0,6.0,31.0,523,01,01,  Halua Para,198,259,113,120,85,139,43.3,48.5,37.9,00000
67.0,6.0,31.0,523,02,01,  Khalpar,110,90,58,44,52,46,55.0,56.9,53.1,00000
67.0,6.0,31.0,523,03,01,  Kazi Para,362,336,194,150,168,186,51.9,56.4,47.5,00000
67.0,6.0,31.0,523,04,01,  Sreerampur,259,243,129,126,130,117,51.6,50.6,52.6,00000
67.0,6.0,31.0,523,05,01,  Kuchiamora,185,442,98,233,87,209,29.5,29.6,29.4,00000
67.0,6.0,31.0,523,06,01,  Mollar Para,120,71,71,28,49,43,62.8,71.7,53.3,00000
67.0,6.0,31.0,523,07,01,  Adda,79,230,39,137,40,93,25.6,22.2,30.1,00000
67.0,6.0,31.0,523,08,01,  Kamrabow,225,209,103,99,122,110,51.8,51.0,52.6,00000
67.0,6.0,31.0,543,01,01,  Khocerchora,265,201,130,94,135,107,56.9,58.0,55.8,00000
67.0,6.0,31.0,543,02,01,  Anandanagar,445,252,226,126,219,126,63.8,64.2,63.5,00000
67.0,6.0,47.0,020,01,01,  Alisardi,156,201,77,97,79,104,43.7,44.3,43.2,00000
67.0,6.0,47.0,020,02,01,  Chanabura,336,210,172,82,164,128,61.5,67.7,56.2,00000
67.0,6.0,47.0,020,03,01,  Char Dhaleshwari,321,532,170,282,151,250,37.6,37.6,37.7,00000
67.0,6.0,47.0,143,01,01,  Burundi,1117,617,575,295,542,322,64.4,66.1,62.7,00000
67.0,6.0,47.0,143,02,01,  Kuriabhita,213,83,108,38,105,45,72.0,74.0,70.0,00000
67.0,6.0,47.0,584,01,01,  Char Gharmora,718,546,385,256,333,290,56.8,60.1,53.5,00000
67.0,6.0,47.0,584,02,01,  Punainagar,862,525,450,236,412,289,62.1,65.6,58.8,00000
67.0,6.0,47.0,605,01,01,  Nayanagar (1),332,190,169,88,163,102,63.6,65.8,61.5,00000
67.0,6.0,47.0,605,02,01,  Farazikandi (Part-1),1447,597,746,270,701,327,70.8,73.4,68.2,00000
67.0,6.0,47.0,605,03,01,  Madhabpasha (1),604,414,297,210,307,204,59.3,58.6,60.1,00000
67.0,6.0,47.0,605,04,01,  Madhabpasha (2),240,221,116,119,124,102,52.1,49.4,54.9,00000
67.0,6.0,47.0,605,05,01,  Alinagar,876,633,425,322,451,311,58.1,56.9,59.2,00000
67.0,6.0,47.0,605,06,01,  Kandi Para,264,198,127,94,137,104,57.1,57.5,56.8,00000
67.0,6.0,47.0,677,01,01,  Mukfuldi,491,235,233,110,258,125,67.6,67.9,67.4,00000
67.0,6.0,47.0,677,02,01,  Chankhola,273,176,142,84,131,92,60.8,62.8,58.7,00000
67.0,6.0,47.0,759,01,01,  Nisang,906,507,435,214,471,293,64.1,67.0,61.6,00000
67.0,6.0,47.0,759,02,01,  Daulatpur,91,56,50,28,41,28,61.9,64.1,59.4,00000
67.0,6.0,47.0,759,03,01,  Chowdhurygaon,235,138,130,70,105,68,63.0,65.0,60.7,00000
67.0,6.0,47.0,800,01,01,  Sabdi,217,280,107,133,110,147,43.7,44.6,42.8,00000
67.0,6.0,47.0,800,02,01,  Kalabagh,225,60,111,22,114,38,78.9,83.5,75.0,00000
67.0,6.0,47.0,800,03,01,  Aiztala,150,48,85,19,65,29,75.8,81.7,69.1,00000
67.0,6.0,47.0,800,04,01,  Kalinagar,81,95,43,47,38,48,46.0,47.8,44.2,00000
67.0,6.0,63.0,512,01,01,  Keodhala (Part),1934,1186,1079,595,855,591,62.0,64.5,59.1,00000
67.0,6.0,63.0,512,02,01,  Nehal Sardarerbagh,403,469,221,257,182,212,46.2,46.2,46.2,00000
67.0,6.0,63.0,512,03,01,  Kainuli Bhita,371,463,189,253,182,210,44.5,42.8,46.4,00000
67.0,6.0,63.0,512,04,01,  Pukuniabari,263,140,126,69,137,71,65.3,64.6,65.9,00000
67.0,6.0,63.0,512,05,01,  Dobaria,201,236,100,102,101,134,46.0,49.5,43.0,00000
67.0,6.0,63.0,512,06,01,  Laushar,523,640,288,302,235,338,45.0,48.8,41.0,00000
67.0,6.0,63.0,512,07,01,  Baghdubaria,216,445,117,249,99,196,32.7,32.0,33.6,00000
67.0,6.0,63.0,512,08,01,  Jattrabhita,100,60,46,29,54,31,62.5,61.3,63.5,00000
67.0,6.0,63.0,512,09,01,  Bidyapati,213,181,93,81,120,100,54.1,53.4,54.5,00000
67.0,6.0,79.0,071,01,01,  Baligaon,392,449,202,211,190,238,46.6,48.9,44.4,00000
67.0,6.0,79.0,071,02,01,  Ramurarbagh,22,59,7,37,15,22,27.2,15.9,40.5,00000
67.0,6.0,79.0,133,01,01,  Bar Para,719,803,379,446,340,357,47.2,45.9,48.8,00000
67.0,6.0,79.0,133,02,01,  Bangalbari,76,147,46,76,30,71,34.1,37.7,29.7,00000
67.0,6.0,79.0,133,03,01,  Tajpur,414,832,224,399,190,433,33.2,36.0,30.5,00000
67.0,6.0,79.0,133,04,01,  Haribari,335,440,175,214,160,226,43.2,45.0,41.5,00000
67.0,6.0,79.0,133,05,01,  Shashnerbagh,491,495,229,243,262,252,49.8,48.5,51.0,00000
67.0,6.0,79.0,133,06,01,  Bajurbagh,287,421,158,193,129,228,40.5,45.0,36.1,00000
67.0,6.0,79.0,235,01,01,  Dakshin Kulcharitra,244,215,135,109,109,106,53.2,55.3,50.7,00000
67.0,6.0,79.0,235,02,01,  Minarbari,527,629,261,311,266,318,45.6,45.6,45.5,00000
67.0,6.0,79.0,235,03,01,  Kalarbagh,164,228,86,108,78,120,41.8,44.3,39.4,00000
67.0,6.0,79.0,359,01,01,  Ukilarbagh,76,73,36,34,40,39,51.0,51.4,50.6,00000
67.0,6.0,79.0,359,02,01,  Gobindakul,158,282,87,163,71,119,35.9,34.8,37.4,00000
67.0,6.0,79.0,359,03,01,  Phonkul,297,401,133,188,164,213,42.6,41.4,43.5,00000
67.0,6.0,79.0,502,01,01,  Daulatpur,307,177,183,91,124,86,63.4,66.8,59.0,00000
67.0,6.0,79.0,502,02,01,  Bhatgaon,205,121,108,58,97,63,62.9,65.1,60.6,00000
67.0,6.0,79.0,502,03,01,  Kamtal,1064,760,542,393,522,367,58.3,58.0,58.7,00000
67.0,6.0,79.0,520,01,01,  Patakaa,66,46,27,23,39,23,58.9,54.0,62.9,00000
67.0,6.0,79.0,520,02,01,  Bairaginirpar,152,101,91,42,61,59,60.1,68.4,50.8,00000
67.0,6.0,79.0,689,01,01,  Uttar Musapur,309,550,145,271,164,279,36.0,34.9,37.0,00000
67.0,6.0,79.0,689,02,01,  Dakshin Musapur,191,168,92,81,99,87,53.2,53.2,53.2,00000
67.0,6.0,79.0,738,01,01,  Langalbanda Nagar,371,465,201,240,170,225,44.4,45.6,43.0,00000
67.0,6.0,79.0,738,02,01,  Langalbanda Bazar,163,107,83,59,80,48,60.4,58.5,62.5,00000
67.0,6.0,79.0,738,03,01,  Malibagh,642,322,359,137,283,185,66.6,72.4,60.5,00000
67.0,6.0,79.0,738,04,01,  Tabalpara,225,135,126,58,99,77,62.5,68.5,56.3,00000
67.0,6.0,79.0,738,05,01,  Jogi Para,143,261,72,123,71,138,35.4,36.9,34.0,00000
67.0,6.0,79.0,738,06,01,  Chirai Para,515,514,267,279,248,235,50.0,48.9,51.3,00000
67.0,6.0,79.0,738,07,01,  Baksarail,153,322,79,154,74,168,32.2,33.9,30.6,00000
67.0,6.0,79.0,892,01,01,  Char Islampur,344,602,179,310,165,292,36.4,36.6,36.1,00000
67.0,6.0,79.0,892,02,01,  Char Gangarampur,372,317,174,142,198,175,54.0,55.1,53.1,00000
67.0,58.0,20.0,348,01,01,  Puran Gopchar,1145,2578,574,1524,571,1054,30.8,27.4,35.1,00000
67.0,58.0,20.0,348,02,01,  Dikrir Char,1821,1409,1085,781,736,628,56.4,58.1,54.0,00000
67.0,58.0,20.0,348,03,01,  Mukterkandi,504,207,306,115,198,92,70.9,72.7,68.3,00000
67.0,58.0,20.0,348,04,01,  Kurerpar,1332,1380,648,694,684,686,49.1,48.3,49.9,00000
67.0,58.0,20.0,348,05,01,  Kroker Char,451,700,226,351,225,349,39.2,39.2,39.2,00000
67.0,58.0,25.0,189,01,01,  Char Bairagadi,1121,925,565,434,556,491,54.8,56.6,53.1,00000
67.0,58.0,25.0,189,02,01,  Mirganj,251,186,120,89,131,97,57.4,57.4,57.5,00000
67.0,58.0,25.0,213,01,01,  Akbarnagar,727,3158,449,1899,278,1259,18.7,19.1,18.1,00000
67.0,58.0,25.0,213,02,01,  Rajnagar,58,97,32,46,26,51,37.4,41.0,33.8,00000
67.0,58.0,25.0,213,03,01,  Madhyanagar,1854,1770,905,872,949,898,51.2,50.9,51.4,00000
67.0,58.0,25.0,213,04,01,  Gopalnagar,1942,2404,1028,1333,914,1071,44.7,43.5,46.0,00000
67.0,58.0,25.0,213,05,01,  Pratapnagar,725,4457,485,2746,240,1711,14.0,15.0,12.3,00000
67.0,58.0,25.0,213,06,01,  Lakshminagar,1837,1895,932,1025,905,870,49.2,47.6,51.0,00000
67.0,58.0,25.0,213,07,01,  Rajapur,1173,2494,590,1380,583,1114,32.0,29.9,34.4,00000
67.0,58.0,25.0,213,08,01,  Ramnagar,1311,756,689,359,622,397,63.4,65.7,61.0,00000
67.0,58.0,25.0,213,09,01,  Kaninagar,961,636,456,308,505,328,60.2,59.7,60.6,00000
67.0,58.0,25.0,213,10,01,  Ganganagar,693,1009,285,485,408,524,40.7,37.0,43.8,00000
67.0,58.0,25.0,213,11,01,  Radhanagar,1391,1157,685,539,706,618,54.6,56.0,53.3,00000
67.0,58.0,25.0,213,12,01,  Prasannanagar,804,935,389,456,415,479,46.2,46.0,46.4,00000
67.0,58.0,25.0,213,13,01,  Muktarkandi,200,70,102,30,98,40,74.1,77.3,71.0,00000
67.0,58.0,25.0,213,14,01,  Char Prasannanagar,322,376,162,176,160,200,46.1,47.9,44.4,00000
67.0,58.0,25.0,213,15,01,  Char Nabinagar,1938,4076,1070,2302,868,1774,32.2,31.7,32.9,00000
67.0,58.0,25.0,213,16,01,  Guchchhagram,52,77,29,36,23,41,40.3,44.6,35.9,00000
67.0,58.0,31.0,402,01,01,  Dharmaganj,14239,9494,7604,4748,6635,4746,60.0,61.6,58.3,00000
67.0,58.0,31.0,402,02,01,  Nabinagar,1495,796,802,352,693,444,65.3,69.5,60.9,00000
67.0,58.0,31.0,402,03,01,  Arafatnagar,490,334,269,165,221,169,59.5,62.0,56.7,00000
67.0,58.0,31.0,758,01,01,  Masdair,12900,8241,7255,4045,5645,4196,61.0,64.2,57.4,00000
67.0,58.0,31.0,758,02,01,  Ghosherbhag,3652,1388,1915,599,1737,789,72.5,76.2,68.8,00000
67.0,58.0,37.0,474,01,01,  Fatulla,12963,8542,7313,4155,5650,4387,60.3,63.8,56.3,00000
67.0,58.0,37.0,474,02,01,  Kotalerbhag,4891,2831,2916,1383,1975,1448,63.3,67.8,57.7,00000
67.0,58.0,37.0,474,03,01,  Sastapur,9947,4799,5501,2357,4446,2442,67.5,70.0,64.5,00000
67.0,58.0,47.0,643,01,01,  Uttar Masinabanda,1635,573,819,277,816,296,74.0,74.7,73.4,00000
67.0,58.0,47.0,643,02,01,  Dakhsin Masinabanda,1088,512,556,256,532,256,68.0,68.5,67.5,00000
67.0,58.0,47.0,643,03,01,  Barirtek,736,406,380,226,356,180,64.4,62.7,66.4,00000
67.0,58.0,47.0,643,04,01,  Purba Masinabanda,1883,1207,968,597,915,610,60.9,61.9,60.0,00000
67.0,58.0,47.0,848,01,01,  Purba Gognagar,1248,589,631,260,617,329,67.9,70.8,65.2,00000
67.0,58.0,47.0,848,02,01,  Paschim Gognagar,886,514,434,254,452,260,63.3,63.1,63.5,00000
67.0,58.0,47.0,848,03,01,  Kadamtali,882,441,453,217,429,224,66.7,67.6,65.7,00000
67.0,58.0,47.0,848,04,01,  Puran Sayedpur,1326,921,656,490,670,431,59.0,57.2,60.9,00000
67.0,58.0,47.0,848,05,01,  Natun Sayedpur,1615,756,849,367,766,389,68.1,69.8,66.3,00000
67.0,58.0,47.0,848,06,01,  Char Sayedpur,3254,2930,1785,1474,1469,1456,52.6,54.8,50.2,00000
67.0,58.0,63.0,521,01,01,  Uttar Goalbanda,5031,3237,2576,1639,2455,1598,60.8,61.1,60.6,00000
67.0,58.0,63.0,521,02,01,  Dakshin Goalbanda,3164,1651,1644,787,1520,864,65.7,67.6,63.8,00000
67.0,58.0,63.0,521,03,01,  Farajikandi,1718,1143,904,591,814,552,60.0,60.5,59.6,00000
67.0,58.0,63.0,639,01,01,  Kashipur,12027,11836,6692,5914,5335,5922,50.4,53.1,47.4,00000
67.0,58.0,63.0,639,02,01,  Uttar Narasingpur,2162,2608,1172,1274,990,1334,45.3,47.9,42.6,00000
67.0,58.0,63.0,639,03,01,  Madhya Narsingpur,1090,837,609,426,481,411,56.6,58.8,53.9,00000
67.0,58.0,63.0,639,04,01,  Dakshin Narsingpur,419,326,215,152,204,174,56.2,58.6,54.0,00000
67.0,58.0,63.0,639,05,01,  Sreedhardi,1508,840,810,383,698,457,64.2,67.9,60.4,00000
67.0,58.0,63.0,639,06,01,  Char Kashipur,588,948,284,495,304,453,38.3,36.5,40.2,00000
67.0,58.0,63.0,639,07,01,  Chowdhurygaon,3862,1509,2097,791,1765,718,71.9,72.6,71.1,00000
67.0,58.0,63.0,640,01,01,  Paschim Deobhog,14643,12121,7843,5952,6800,6169,54.7,56.9,52.4,00000
67.0,58.0,63.0,640,02,01,  Bangla Bazar,2753,2112,1427,1030,1326,1082,56.6,58.1,55.1,00000
67.0,58.0,63.0,640,03,01,  Deobhog Nagar,5819,3096,3315,1512,2504,1584,65.3,68.7,61.3,00000
67.0,58.0,63.0,640,04,01,  Bholail,3131,1384,1847,644,1284,740,69.3,74.1,63.4,00000
67.0,58.0,79.0,165,01,01,  Bhuigar,16148,6073,8958,2919,7190,3154,72.7,75.4,69.5,00000
67.0,58.0,79.0,165,02,01,  Mamudpur,3688,1277,2054,599,1634,678,74.3,77.4,70.7,00000
67.0,58.0,79.0,165,03,01,  Nitaipur,1445,412,773,188,672,224,77.8,80.4,75.0,00000
67.0,58.0,79.0,165,04,01,  Raghunatpur,2204,1213,1219,637,985,576,64.5,65.7,63.1,00000
67.0,58.0,79.0,379,01,01,  Deul Para (East),17296,10434,9005,4965,8291,5469,62.4,64.5,60.3,00000
67.0,58.0,79.0,379,02,01,  Shidnar,1560,672,843,334,717,338,69.9,71.6,68.0,00000
67.0,58.0,79.0,379,03,01,  Brahmangaon(Muslimnagar),5030,2336,2606,1127,2424,1209,68.3,69.8,66.7,00000
67.0,58.0,79.0,379,04,01,  Adarshanagar,1157,347,619,162,538,185,76.9,79.3,74.4,00000
67.0,58.0,79.0,379,05,01,  Enayetnagar,1445,906,762,439,683,467,61.5,63.4,59.4,00000
67.0,58.0,79.0,379,06,01,  Nischintapur,5542,4133,2974,2014,2568,2119,57.3,59.6,54.8,00000
67.0,58.0,79.0,379,07,01,  Daulatpur,2159,1657,1172,797,987,860,56.6,59.5,53.4,00000
67.0,58.0,79.0,379,08,01,  Gobindapur (Munsibag),1873,1225,999,617,874,608,60.5,61.8,59.0,00000
67.0,58.0,79.0,379,09,01,  Nayamati,5528,2811,2887,1389,2641,1422,66.3,67.5,65.0,00000
67.0,58.0,79.0,426,01,01,  Dhopatita,4194,3345,2412,1749,1782,1596,55.6,58.0,52.8,00000
67.0,58.0,79.0,426,02,01,  Nandalalpur,4440,3466,2426,1759,2014,1707,56.2,58.0,54.1,00000
67.0,58.0,79.0,710,01,01,  Lama Para,12931,7839,7652,3858,5279,3981,62.3,66.5,57.0,00000
67.0,58.0,79.0,710,02,01,  Nayamati,282,246,167,114,115,132,53.4,59.4,46.6,00000
67.0,58.0,79.0,710,03,01,  Kutubpur,3228,2511,1795,1216,1433,1295,56.2,59.6,52.5,00000
67.0,58.0,79.0,710,04,01,  Ramarbagh,5786,2137,3587,1013,2199,1124,73.0,78.0,66.2,00000
67.0,58.0,79.0,805,01,01,  Purbapara,15592,12459,8572,6425,7020,6034,55.6,57.2,53.8,00000
67.0,58.0,79.0,805,02,01,  Paschimpara,1732,1183,1165,651,567,532,59.4,64.2,51.6,00000
67.0,68.0,22.0,657,01,01,  Chari Taluk,2578,2805,1320,1330,1258,1475,47.9,49.8,46.0,00000
67.0,68.0,22.0,657,02,01,  Dari Chari Taluk,603,272,305,125,298,147,68.9,70.9,67.0,00000
67.0,68.0,22.0,905,01,01,  Taora,1481,1714,740,829,741,885,46.4,47.2,45.6,00000
67.0,68.0,22.0,905,02,01,  Shimulia,443,765,221,378,222,387,36.7,36.9,36.5,00000
67.0,68.0,25.0,164,01,01,  Bhaela,880,1204,490,632,390,572,42.2,43.7,40.5,00000
67.0,68.0,25.0,164,02,01,  Murtajabad,2349,1175,1364,565,985,610,66.7,70.7,61.8,00000
67.0,68.0,25.0,164,03,01,  Tekpara,549,747,289,382,260,365,42.4,43.1,41.6,00000
67.0,68.0,25.0,164,04,01,  Sonaba,812,827,422,432,390,395,49.5,49.4,49.7,00000
67.0,68.0,25.0,164,05,01,  Nahati,625,241,369,128,256,113,72.2,74.2,69.4,00000
67.0,68.0,25.0,192,01,01,  Bulta,1420,461,849,265,571,196,75.5,76.2,74.4,00000
67.0,68.0,25.0,192,02,01,  Balaikha,1834,940,1021,445,813,495,66.1,69.6,62.2,00000
67.0,68.0,25.0,192,03,01,  Aukhab,2373,2004,1427,961,946,1043,54.2,59.8,47.6,00000
67.0,68.0,25.0,192,04,01,  Majhi Para,1308,1593,688,828,620,765,45.1,45.4,44.8,00000
67.0,68.0,25.0,652,01,01,  Mithaba,1156,473,669,232,487,241,71.0,74.3,66.9,00000
67.0,68.0,25.0,652,02,01,  Hatab,1272,938,759,488,513,450,57.6,60.9,53.3,00000
67.0,68.0,25.0,732,01,01,  Miahbari,605,357,320,184,285,173,62.9,63.5,62.2,00000
67.0,68.0,25.0,732,02,01,  Gopaliabari,147,34,82,20,65,14,81.2,80.4,82.3,00000
67.0,68.0,25.0,732,03,01,  Panchaikhan,1260,1469,628,767,632,702,46.2,45.0,47.4,00000
67.0,68.0,25.0,732,04,01,  Telai Para,659,430,367,216,292,214,60.5,63.0,57.7,00000
67.0,68.0,25.0,746,01,01,  Sonab,532,480,295,244,237,236,52.6,54.7,50.1,00000
67.0,68.0,25.0,746,02,01,  Paragaon,994,1491,548,746,446,745,40.0,42.3,37.4,00000
67.0,68.0,25.0,746,03,01,  Murabo,566,428,297,205,269,223,56.9,59.2,54.7,00000
67.0,68.0,25.0,746,04,01,  Fakirer Dargah,47,29,31,14,16,15,61.8,68.9,51.6,00000
67.0,68.0,25.0,746,05,01,  Thakur Barirtek,589,460,406,227,183,233,56.1,64.1,44.0,00000
67.0,68.0,25.0,746,06,01,  Labra Para,524,462,287,227,237,235,53.1,55.8,50.2,00000
67.0,68.0,31.0,065,01,01,  Baglapag,599,282,283,132,316,150,68.0,68.2,67.8,00000
67.0,68.0,31.0,065,02,01,  Kanda Para,110,93,56,44,54,49,54.2,56.0,52.4,00000
67.0,68.0,31.0,098,01,01,  Amdia,337,189,175,78,162,111,64.1,69.2,59.3,00000
67.0,68.0,31.0,098,02,01,  Uttar Hatab,669,935,331,448,338,487,41.7,42.5,41.0,00000
67.0,68.0,31.0,098,03,01,  Kazirtek,232,274,116,132,116,142,45.8,46.8,45.0,00000
67.0,68.0,31.0,150,01,01,  Beldi,904,787,516,445,388,342,53.5,53.7,53.2,00000
67.0,68.0,31.0,150,02,01,  Sonadi,53,20,27,8,26,12,72.6,77.1,68.4,00000
67.0,68.0,31.0,323,01,01,  Daudpur,254,136,118,61,136,75,65.1,65.9,64.5,00000
67.0,68.0,31.0,323,02,01,  Asuli Daudpur,706,997,358,557,348,440,41.5,39.1,44.2,00000
67.0,68.0,31.0,323,03,01,  Khash Daudpur,361,689,192,445,169,244,34.4,30.1,40.9,00000
67.0,68.0,31.0,328,01,01,  Debagram,397,436,213,235,184,201,47.7,47.5,47.8,00000
67.0,68.0,31.0,328,02,01,  Kazirbagh,477,426,250,217,227,209,52.8,53.5,52.1,00000
67.0,68.0,31.0,328,03,01,  Biralbari,167,220,80,105,87,115,43.2,43.2,43.1,00000
67.0,68.0,31.0,408,01,01,  Hankur,274,343,132,173,142,170,44.4,43.3,45.5,00000
67.0,68.0,31.0,408,02,01,  Sonatala,96,30,52,12,44,18,76.2,81.3,71.0,00000
67.0,68.0,31.0,427,01,01,  Hirnal,118,147,65,59,53,88,44.5,52.4,37.6,00000
67.0,68.0,31.0,427,02,01,  Kalni,225,196,110,101,115,95,53.4,52.1,54.8,00000
67.0,68.0,31.0,427,03,01,  Khailasa,91,109,45,61,46,48,45.5,42.5,48.9,00000
67.0,68.0,31.0,427,04,01,  Majhi Para Hirnal,86,162,43,88,43,74,34.7,32.8,36.8,00000
67.0,68.0,31.0,464,01,01,  Kaknibagh,111,74,52,33,59,41,60.0,61.2,59.0,00000
67.0,68.0,31.0,464,02,01,  Lobartek,41,66,22,32,19,34,38.3,40.7,35.8,00000
67.0,68.0,31.0,478,01,01,  Kamalkati,197,151,94,71,103,80,56.6,57.0,56.3,00000
67.0,68.0,31.0,478,02,01,  Khas Kamalkati,497,528,280,286,217,242,48.5,49.5,47.3,00000
67.0,68.0,31.0,483,01,01,  Kamta,21,40,11,18,10,22,34.4,37.9,31.3,00000
67.0,68.0,31.0,483,02,01,  Gobindapur,854,560,464,282,390,278,60.4,62.2,58.4,00000
67.0,68.0,31.0,483,03,01,  Chapri,199,157,113,85,86,72,55.9,57.1,54.4,00000
67.0,68.0,31.0,483,04,01,  Dhamshi,410,155,218,61,192,94,72.6,78.1,67.1,00000
67.0,68.0,31.0,483,05,01,  Palkhan,327,253,176,129,151,124,56.4,57.7,54.9,00000
67.0,68.0,31.0,483,06,01,  Pingkhan,197,142,112,66,85,76,58.1,62.9,52.8,00000
67.0,68.0,31.0,483,07,01,  Kamta Manoharpur,205,95,113,48,92,47,68.3,70.2,66.2,00000
67.0,68.0,31.0,483,08,01,  Tikhana Kamta Guchchhagram,57,211,29,98,28,113,21.3,22.8,19.9,00000
67.0,68.0,31.0,563,01,01,  Kuliadi,420,251,220,123,200,128,62.6,64.1,61.0,00000
67.0,68.0,31.0,563,02,01,  Uttar Dighaliartek,340,234,178,111,162,123,59.2,61.6,56.8,00000
67.0,68.0,31.0,797,01,01,  Putina,435,302,205,137,230,165,59.0,59.9,58.2,00000
67.0,68.0,31.0,797,02,01,  Khas Putina,199,153,99,74,100,79,56.5,57.2,55.9,00000
67.0,68.0,31.0,802,01,01,  Raghurampur,195,202,92,93,103,109,49.1,49.7,48.6,00000
67.0,68.0,31.0,802,02,01,  Dakshin Dighaliar Tek,69,76,28,32,41,44,47.6,46.7,48.2,00000
67.0,68.0,31.0,802,03,01,  Majhi Para (Raghurampur),181,230,96,129,85,101,44.0,42.7,45.7,00000
67.0,68.0,31.0,802,04,01,  Bagrar Tek,62,53,33,22,29,31,53.9,60.0,48.3,00000
67.0,68.0,39.0,004,01,01,  Adhuria,316,100,161,43,155,57,76.0,78.9,73.1,00000
67.0,68.0,39.0,004,02,01,  Porab,115,120,66,56,49,64,48.9,54.1,43.4,00000
67.0,68.0,39.0,023,01,01,  Amlaba,917,848,484,417,433,431,52.0,53.7,50.1,00000
67.0,68.0,39.0,023,02,01,  Singlab,1692,803,985,414,707,389,67.8,70.4,64.5,00000
67.0,68.0,39.0,023,03,01,  Kali,240,288,137,144,103,144,45.5,48.8,41.7,00000
67.0,68.0,39.0,023,04,01,  Seulkali,224,346,116,162,108,184,39.3,41.7,37.0,00000
67.0,68.0,39.0,023,05,01,  Dulurdia,39,77,19,37,20,40,33.6,33.9,33.3,00000
67.0,68.0,39.0,023,06,01,  Tengra Tek,53,129,28,58,25,71,29.1,32.6,26.0,00000
67.0,68.0,39.0,023,07,01,  Itala,48,44,32,17,16,27,52.2,65.3,37.2,00000
67.0,68.0,39.0,309,01,01,  Darikandi,557,235,328,121,229,114,70.3,73.1,66.8,00000
67.0,68.0,39.0,309,02,01,  Horagaon,1673,1035,932,519,741,516,61.8,64.2,58.9,00000
67.0,68.0,39.0,309,03,01,  Dahargaon,1245,993,914,560,331,433,55.6,62.0,43.3,00000
67.0,68.0,39.0,394,01,01,  Balaikhar Tek,2168,1442,1334,644,834,798,60.1,67.4,51.1,00000
67.0,68.0,39.0,394,02,01,  Golakandail,12982,10109,7154,4971,5828,5138,56.2,59.0,53.1,00000
67.0,68.0,39.0,530,01,01,  Kumer Tek,142,344,56,174,86,170,29.2,24.3,33.6,00000
67.0,68.0,39.0,530,02,01,  Kesraba,268,341,135,185,133,156,44.0,42.2,46.0,00000
67.0,68.0,39.0,530,03,01,  Matkhola,118,98,68,44,50,54,54.6,60.7,48.1,00000
67.0,68.0,39.0,600,01,01,  Mahana,2234,1974,1295,949,939,1025,53.1,57.7,47.8,00000
67.0,68.0,39.0,600,02,01,  Mahana Tekpara,318,139,184,69,134,70,69.6,72.7,65.7,00000
67.0,68.0,55.0,107,01,01,  Baralu,1120,856,587,418,533,438,56.7,58.4,54.9,00000
67.0,68.0,55.0,107,02,01,  Pirpara,168,162,92,91,76,71,50.9,50.3,51.7,00000
67.0,68.0,55.0,107,03,01,  Paragaon,674,429,341,195,333,234,61.1,63.6,58.7,00000
67.0,68.0,55.0,107,04,01,  Daktarkhali,536,249,276,109,260,140,68.3,71.7,65.0,00000
67.0,68.0,55.0,131,01,01,  Baruna,970,1071,501,512,469,559,47.5,49.5,45.6,00000
67.0,68.0,55.0,131,02,01,  Rataldia,74,70,33,36,41,34,51.4,47.8,54.7,00000
67.0,68.0,55.0,131,03,01,  Faitatali,47,81,29,38,18,43,36.7,43.3,29.5,00000
67.0,68.0,55.0,417,01,01,  Haria,414,499,224,240,190,259,45.3,48.3,42.3,00000
67.0,68.0,55.0,417,02,01,  Haria Nadirpar,298,166,164,84,134,82,64.2,66.1,62.0,00000
67.0,68.0,55.0,450,01,01,  Kayet Para,249,379,122,189,127,190,39.6,39.2,40.1,00000
67.0,68.0,55.0,450,02,01,  Chaner Tek,27,103,16,59,11,44,20.8,21.3,20.0,00000
67.0,68.0,55.0,525,01,01,  Uttarpara,160,248,82,127,78,121,39.2,39.2,39.2,00000
67.0,68.0,55.0,525,02,01,  Khamar Para,440,148,237,62,203,86,74.8,79.3,70.2,00000
67.0,68.0,55.0,525,03,01,  Nagar Para,459,377,256,189,203,188,54.9,57.5,51.9,00000
67.0,68.0,55.0,525,04,01,  Baghbari,83,129,48,62,35,67,39.2,43.6,34.3,00000
67.0,68.0,55.0,525,05,01,  Dilpar,257,181,145,83,112,98,58.7,63.6,53.3,00000
67.0,68.0,55.0,525,06,01,  Nayamati,142,263,86,132,56,131,35.1,39.4,29.9,00000
67.0,68.0,55.0,525,07,01,  Piralia,18,77,12,38,6,39,18.9,24.0,13.3,00000
67.0,68.0,55.0,610,01,01,  Ichhakali,814,337,450,146,364,191,70.7,75.5,65.6,00000
67.0,68.0,55.0,610,02,01,  Majhina Nadirpar,1192,513,639,235,553,278,69.9,73.1,66.5,00000
67.0,68.0,55.0,610,03,01,  Majhina,364,469,193,244,171,225,43.7,44.2,43.2,00000
67.0,68.0,55.0,610,04,01,  Bamankul,365,284,196,125,169,159,56.2,61.1,51.5,00000
67.0,68.0,55.0,610,05,01,  Mailab,116,69,67,32,49,37,62.7,67.7,57.0,00000
67.0,68.0,55.0,694,01,01,  Chhoydona,142,356,79,178,63,178,28.5,30.7,26.1,00000
67.0,68.0,55.0,694,02,01,  Paschimpara,595,753,301,387,294,366,44.1,43.8,44.5,00000
67.0,68.0,55.0,694,03,01,  Madhyapara,461,371,228,185,233,186,55.4,55.2,55.6,00000
67.0,68.0,55.0,694,04,01,  Purbapara,681,780,363,382,318,398,46.6,48.7,44.4,00000
67.0,68.0,55.0,694,05,01,  Nimer Tek,267,204,142,99,125,105,56.7,58.9,54.3,00000
67.0,68.0,55.0,793,01,01,  Bhawli Para,725,674,400,320,325,354,51.8,55.6,47.9,00000
67.0,68.0,55.0,793,02,01,  Pubgaon,1910,562,1051,269,859,293,77.3,79.6,74.6,00000
67.0,68.0,55.0,793,03,01,  Chand Para,1765,900,950,439,815,461,66.2,68.4,63.9,00000
67.0,68.0,55.0,793,04,01,  Char Chand Para,509,844,296,376,213,468,37.6,44.0,31.3,00000
67.0,68.0,55.0,793,05,01,  Chandpara Punarbasnkendra,9341,9983,4818,4584,4523,5399,48.3,51.2,45.6,00000
67.0,68.0,63.0,089,01,01,  Baniadi,949,893,515,433,434,460,51.5,54.3,48.5,00000
67.0,68.0,63.0,089,02,01,  Balainagar,250,344,138,161,112,183,42.1,46.2,38.0,00000
67.0,68.0,63.0,089,03,01,  Makimnagar,227,135,126,62,101,73,62.7,67.0,58.0,00000
67.0,68.0,63.0,234,01,03,  Brahmangaon,1481,842,782,361,699,481,63.8,68.4,59.2,00000
67.0,68.0,63.0,234,02,03,  Haoli Para,509,361,265,178,244,183,58.5,59.8,57.1,00000
67.0,68.0,63.0,234,03,03,  Pabai,473,198,251,82,222,116,70.5,75.4,65.7,00000
67.0,68.0,63.0,234,04,03,  Kaitarbari,67,55,31,28,36,27,54.9,52.5,57.1,00000
67.0,68.0,63.0,234,05,03,  Bagliabari,105,116,59,49,46,67,47.5,54.6,40.7,00000
67.0,68.0,63.0,234,06,03,  Mirgadai,175,226,99,120,76,106,43.6,45.2,41.8,00000
67.0,68.0,63.0,234,07,03,  Machhimpur,1150,1325,619,650,531,675,46.5,48.8,44.0,00000
67.0,68.0,63.0,234,08,03,  Tangirghat,703,242,374,102,329,140,74.4,78.6,70.1,00000
67.0,68.0,63.0,234,09,03,  Darikandi,2425,1480,1322,702,1103,778,62.1,65.3,58.6,00000
67.0,68.0,63.0,234,10,03,  Ganganagar,1490,1055,797,510,693,545,58.5,61.0,56.0,00000
67.0,68.0,63.0,666,01,03,  Mura Para,1298,854,783,429,515,425,60.3,64.6,54.8,00000
67.0,68.0,63.0,666,02,03,  Barabhita,323,146,159,72,164,74,68.9,68.8,68.9,00000
67.0,68.0,63.0,750,01,01,  Parain,205,221,114,100,91,121,48.1,53.3,42.9,00000
67.0,68.0,63.0,750,02,01,  Barai Para,282,165,146,68,136,97,63.1,68.2,58.4,00000
67.0,68.0,79.0,145,01,01,  Bariasoni,1008,1428,540,713,468,715,41.4,43.1,39.6,00000
67.0,68.0,79.0,145,02,01,  Bariar Tek,479,210,260,87,219,123,69.5,74.9,64.0,00000
67.0,68.0,79.0,229,01,01,  Brahmankhali,1059,1014,559,511,500,503,51.1,52.2,49.9,00000
67.0,68.0,79.0,229,02,01,  Baghbari,398,148,211,67,187,81,72.9,75.9,69.8,00000
67.0,68.0,79.0,398,01,01,  Gutiaba,715,1112,373,524,342,588,39.1,41.6,36.8,00000
67.0,68.0,79.0,398,02,01,  Agar Para,329,586,173,292,156,294,36.0,37.2,34.7,00000
67.0,68.0,79.0,398,03,01,  Alampur,582,489,323,216,259,273,54.3,59.9,48.7,00000
67.0,68.0,79.0,398,04,01,  Dakshinbagh,831,880,435,444,396,436,48.6,49.5,47.6,00000
67.0,68.0,79.0,436,01,01,  Jangir,1501,1251,800,589,701,662,54.5,57.6,51.4,00000
67.0,68.0,79.0,436,02,01,  Harinda,569,467,290,221,279,246,54.9,56.8,53.1,00000
67.0,68.0,79.0,436,03,01,  Suriab,309,352,167,172,142,180,46.7,49.3,44.1,00000
67.0,68.0,79.0,605,01,01,  Maijgaon,437,257,225,119,212,138,63.0,65.4,60.6,00000
67.0,68.0,79.0,605,02,01,  Kadirartek,268,117,145,57,123,60,69.6,71.8,67.2,00000
67.0,68.0,79.0,769,01,01,  Pasi,565,630,311,330,254,300,47.3,48.5,45.8,00000
67.0,68.0,79.0,769,02,01,  Pania Agra,181,227,96,116,85,111,44.4,45.3,43.4,00000
67.0,68.0,79.0,769,03,01,  Goal Para,381,265,199,131,182,134,59.0,60.3,57.6,00000
67.0,68.0,79.0,783,01,01,  Pitalganj,1965,2380,1018,1158,947,1222,45.2,46.8,43.7,00000
67.0,68.0,79.0,783,02,01,  Madhukhali,532,567,297,280,235,287,48.4,51.5,45.0,00000
67.0,68.0,79.0,943,01,01,  Teknoadda,293,621,155,313,138,308,32.1,33.1,30.9,00000
67.0,68.0,79.0,943,02,01,  Maij Para,244,206,138,98,106,108,54.2,58.5,49.5,00000
67.0,68.0,79.0,943,03,01,  Bageraga,3,34,1,19,2,15,8.1,5.0,11.8,00000
33.0,30.0,23.0,463,01,01,  Itahata,3622,2937,2038,1429,1584,1508,55.2,58.8,51.2,00000
33.0,30.0,23.0,463,02,01,  Barbaika,3479,2724,2060,1266,1419,1458,56.1,61.9,49.3,00000
33.0,30.0,23.0,463,03,01,  Dighir Chala,4109,2713,2258,1360,1851,1353,60.2,62.4,57.8,00000
33.0,30.0,23.0,463,04,01,  Kadda Bazar,470,573,261,285,209,288,45.1,47.8,42.1,00000
33.0,30.0,23.0,463,05,01,  Lathibhanga,308,210,159,84,149,126,59.5,65.4,54.2,00000
33.0,30.0,23.0,463,06,01,  Goldighla Tek,465,228,276,113,189,115,67.1,71.0,62.2,00000
33.0,30.0,23.0,463,07,01,  Khoar Para,1048,417,619,190,429,227,71.5,76.5,65.4,00000
33.0,30.0,23.0,463,08,01,  Kanthalia Para,716,444,483,229,233,215,61.7,67.8,52.0,00000
33.0,30.0,23.0,463,09,01,  Gaylaypara,162,203,97,94,65,109,44.4,50.8,37.4,00000
33.0,30.0,23.0,751,01,01,  Naojuri,3311,2288,2086,1124,1225,1164,59.1,65.0,51.3,00000
33.0,30.0,23.0,751,02,01,  Kalakair,236,402,139,216,97,186,37.0,39.2,34.3,00000
33.0,30.0,23.0,814,01,01,  Paler Para,938,997,489,460,449,537,48.5,51.5,45.5,00000
33.0,30.0,23.0,814,02,01,  Mir Baher,276,207,144,98,132,109,57.1,59.5,54.8,00000
33.0,30.0,25.0,586,01,01,  Chhota Kayer,1705,766,892,353,813,413,69.0,71.6,66.3,00000
33.0,30.0,25.0,586,02,01,  Bara Kayer,2185,1266,1119,586,1066,680,63.3,65.6,61.1,00000
33.0,30.0,25.0,586,03,01,  Nalchhata,70,67,38,30,32,37,51.1,55.9,46.4,00000
33.0,30.0,31.0,349,01,01,  Gachha,1915,1190,1061,549,854,641,61.7,65.9,57.1,00000
33.0,30.0,31.0,349,02,01,  Aripara,209,219,112,102,97,117,48.8,52.3,45.3,00000
33.0,30.0,31.0,349,03,01,  Malipara,504,180,349,77,155,103,73.7,81.9,60.1,00000
33.0,30.0,31.0,349,04,01,  Rangamati,272,165,132,80,140,85,62.2,62.3,62.2,00000
33.0,30.0,31.0,593,01,01,  Kamarjuri,6914,3693,4121,1792,2793,1901,65.2,69.7,59.5,00000
33.0,30.0,31.0,628,01,01,  Uttar Khalikair,14733,5895,8778,2698,5955,3197,71.4,76.5,65.1,00000
33.0,30.0,31.0,628,02,01,  Dakshin Khalikair,19756,8826,11335,3982,8421,4844,69.1,74.0,63.5,00000
33.0,30.0,31.0,628,03,01,  Adarsha Gram,3653,1155,2284,544,1369,611,76.0,80.8,69.1,00000
33.0,30.0,47.0,280,01,01,  Latifpur,3910,2874,2158,1352,1752,1522,57.6,61.5,53.5,00000
33.0,30.0,47.0,280,02,01,  Tentuibari,2064,883,1293,397,771,486,70.0,76.5,61.3,00000
33.0,30.0,47.0,387,01,01,  Gobindabari,683,656,401,326,282,330,51.0,55.2,46.1,00000
33.0,30.0,47.0,387,02,01,  Hatimara,1531,1030,787,466,744,564,59.8,62.8,56.9,00000
33.0,30.0,47.0,387,03,01,  Enayetpur,5735,2133,3050,958,2685,1175,72.9,76.1,69.6,00000
33.0,30.0,47.0,387,04,01,  Dakshin Juran,1396,792,741,349,655,443,63.8,68.0,59.7,00000
33.0,30.0,47.0,387,05,01,  Sardaganj,8102,5544,4329,2607,3773,2937,59.4,62.4,56.2,00000
33.0,30.0,47.0,551,01,01,  Kasimpur,3492,1287,2032,612,1460,675,73.1,76.9,68.4,00000
33.0,30.0,47.0,551,02,01,  Naya Para,3685,1528,2226,678,1459,850,70.7,76.7,63.2,00000
33.0,30.0,47.0,551,03,01,  Nadirpar,1740,613,996,272,744,341,73.9,78.5,68.6,00000
33.0,30.0,47.0,873,01,01,  Saraba,5631,1853,3332,889,2299,964,75.2,78.9,70.5,00000
33.0,30.0,47.0,873,02,01,  Mosartek,560,229,375,112,185,117,71.0,77.0,61.3,00000
33.0,30.0,47.0,879,01,01,  Sarupaitali,401,803,217,393,184,410,33.3,35.6,31.0,00000
33.0,30.0,47.0,879,02,01,  Danjoykhali,456,581,255,296,201,285,44.0,46.3,41.4,00000
33.0,30.0,54.0,028,01,01,  Gazaria Para,4076,2065,2500,1048,1576,1017,66.4,70.5,60.8,00000
33.0,30.0,54.0,028,02,01,  Nanduail,1695,978,955,448,740,530,63.4,68.1,58.3,00000
33.0,30.0,54.0,028,03,01,  Kumarkhada,164,187,99,86,65,101,46.7,53.5,39.2,00000
33.0,30.0,54.0,028,04,01,  Bhauaraid,2648,1725,1600,824,1048,901,60.6,66.0,53.8,00000
33.0,30.0,54.0,028,05,01,  Jangalia Para,2157,1681,1164,773,993,908,56.2,60.1,52.2,00000
33.0,30.0,54.0,028,06,01,  Banagram,121,89,74,47,47,42,57.6,61.2,52.8,00000
33.0,30.0,54.0,073,01,01,  Bahadurpur,2350,1658,1299,747,1051,911,58.6,63.5,53.6,00000
33.0,30.0,54.0,073,02,01,  Tulsi Bhita,1979,1422,1130,692,849,730,58.2,62.0,53.8,00000
33.0,30.0,54.0,989,01,01,  Porabari,1268,919,717,393,551,526,58.0,64.6,51.2,00000
33.0,30.0,54.0,989,02,01,  Uttar Salna,2301,2069,1300,917,1001,1152,52.7,58.6,46.5,00000
33.0,30.0,60.0,070,01,01,  Ambagh,21468,15343,12496,8309,8972,7034,58.3,60.1,56.1,00000
33.0,30.0,60.0,070,02,01,  Kaler Bhita,854,850,464,386,390,464,50.1,54.6,45.7,00000
33.0,30.0,60.0,070,03,01,  Megh Lal,453,660,248,311,205,349,40.7,44.4,37.0,00000
33.0,30.0,60.0,070,04,01,  Baghia,1888,1288,1045,584,843,704,59.4,64.1,54.5,00000
33.0,30.0,60.0,070,05,01,  Baghia Nadirpar,215,255,117,114,98,141,45.7,50.6,41.0,00000
33.0,30.0,60.0,070,06,01,  Katlakhali,143,86,82,42,61,44,62.4,66.1,58.1,00000
33.0,30.0,60.0,070,07,01,  Rajabari,856,230,481,108,375,122,78.8,81.7,75.5,00000
33.0,30.0,60.0,076,01,01,  Baimail,24814,12895,13934,6526,10880,6369,65.8,68.1,63.1,00000
33.0,30.0,60.0,076,02,01,  Baimail Nadirpar,498,1425,288,860,210,565,25.9,25.1,27.1,00000
33.0,30.0,60.0,076,03,01,  Juran Chhonkhola(Majipara,16,19,9,9,7,10,45.7,50.0,41.2,00000
33.0,30.0,60.0,471,01,01,  Ahaki,272,333,140,147,132,186,45.0,48.8,41.5,00000
33.0,30.0,60.0,471,02,01,  Jayer Tek,941,774,527,351,414,423,54.9,60.0,49.5,00000
33.0,30.0,60.0,687,01,01,  Jarun,20677,6127,12159,2901,8518,3226,77.1,80.7,72.5,00000
33.0,30.0,60.0,687,02,01,  Harinachala,13914,5825,8153,2831,5761,2994,70.5,74.2,65.8,00000
33.0,30.0,60.0,687,03,01,  Deoliabari,13232,6601,9604,3775,3628,2826,66.7,71.8,56.2,00000
33.0,30.0,60.0,687,04,01,  Konabari,22723,4737,14574,2252,8149,2485,82.7,86.6,76.6,00000
33.0,30.0,67.0,107,01,01,  Nayanpur,9671,3116,5021,1488,4650,1628,75.6,77.1,74.1,00000
33.0,30.0,67.0,107,02,01,  Pingail,550,397,287,186,263,211,58.1,60.7,55.5,00000
33.0,30.0,67.0,107,03,01,  Chungarchala,90,199,49,97,41,102,31.1,33.6,28.7,00000
33.0,30.0,67.0,107,04,01,  Singratoli,324,420,157,194,167,226,43.5,44.7,42.5,00000
33.0,30.0,67.0,107,05,01,  Dargahchala,634,522,330,245,304,277,54.8,57.4,52.3,00000
33.0,30.0,67.0,107,06,01,  Naljani,507,441,236,218,271,223,53.5,52.0,54.9,00000
33.0,30.0,67.0,107,07,01,  Lutiarchala,458,369,236,166,222,203,55.4,58.7,52.2,00000
33.0,30.0,67.0,107,08,01,  Patpocha,233,161,118,74,115,87,59.1,61.5,56.9,00000
33.0,30.0,67.0,107,09,01,  Koraitoli,758,259,404,117,354,142,74.5,77.5,71.4,00000
33.0,30.0,67.0,107,10,01,  Rakhitpur,252,171,140,77,112,94,59.6,64.5,54.4,00000
33.0,30.0,67.0,107,11,01,  Ranipur,327,357,160,174,167,183,47.8,47.9,47.7,00000
33.0,30.0,67.0,107,12,01,  Janakail,524,201,254,87,270,114,72.3,74.5,70.3,00000
33.0,30.0,67.0,107,13,01,  Rodrapur,933,768,523,365,410,403,54.9,58.9,50.4,00000
33.0,30.0,67.0,107,14,01,  Haldoba,507,288,291,130,216,158,63.8,69.1,57.8,00000
33.0,30.0,67.0,107,15,01,  Rajendrapur Cantonment,2416,266,1816,105,600,161,90.1,94.5,78.8,00000
33.0,30.0,67.0,197,01,01,  Manipur,8093,3997,4789,1890,3304,2107,66.9,71.7,61.1,00000
33.0,30.0,67.0,197,02,01,  Naya Para,5067,3473,2997,1520,2070,1953,59.3,66.3,51.5,00000
33.0,30.0,67.0,293,01,01,  Purba Dagari,1704,1339,934,559,770,780,56.0,62.6,49.7,00000
33.0,30.0,67.0,293,02,01,  Paschim Dagari,1783,1479,1002,666,781,813,54.7,60.1,49.0,00000
33.0,30.0,67.0,293,03,01,  Naya Para,2250,1739,1325,820,925,919,56.4,61.8,50.2,00000
33.0,30.0,67.0,638,01,01,  Shibirchala,9218,4792,5242,2336,3976,2456,65.8,69.2,61.8,00000
33.0,30.0,67.0,638,02,01,  Baniarchala,8817,4299,4916,2033,3901,2266,67.2,70.7,63.3,00000
33.0,30.0,67.0,638,03,01,  Bhabanipur,7154,2904,4112,1418,3042,1486,71.1,74.4,67.2,00000
33.0,30.0,67.0,689,01,01,  Mirzapur,3431,3215,1982,1850,1449,1365,51.6,51.7,51.5,00000
33.0,30.0,67.0,689,02,01,  Kanjanol,2311,1782,1543,838,768,944,56.5,64.8,44.9,00000
33.0,30.0,67.0,831,01,01,  Sarkar Para,2098,1510,1052,655,1046,855,58.1,61.6,55.0,00000
33.0,30.0,67.0,831,02,01,  Madhya Para,1681,1457,859,641,822,816,53.6,57.3,50.2,00000
33.0,30.0,67.0,831,03,01,  Bortha Para,2176,1719,1143,753,1033,966,55.9,60.3,51.7,00000
33.0,30.0,67.0,831,04,01,  Uttarpara,558,1130,285,513,273,617,33.1,35.7,30.7,00000
33.0,30.0,67.0,831,05,01,  Nowla Para,884,791,448,339,436,452,52.8,56.9,49.1,00000
33.0,30.0,67.0,831,06,01,  Moyta Para,1060,1251,537,531,523,720,45.9,50.3,42.1,00000
33.0,30.0,81.0,180,01,01,  Bindan,968,474,511,234,457,240,67.1,68.6,65.6,00000
33.0,30.0,81.0,180,02,01,  Badurtala,252,227,121,117,131,110,52.6,50.8,54.4,00000
33.0,30.0,81.0,180,03,01,  Gojain,55,64,29,30,26,34,46.2,49.2,43.3,00000
33.0,30.0,81.0,203,01,01,  Boran,139,134,73,59,66,75,50.9,55.3,46.8,00000
33.0,30.0,81.0,203,02,01,  Patak Tek,242,177,135,95,107,82,57.8,58.7,56.6,00000
33.0,30.0,81.0,356,01,01,  Dhopa Para,289,203,144,94,145,109,58.7,60.5,57.1,00000
33.0,30.0,81.0,356,02,01,  Baunir Tek,285,85,162,34,123,51,77.0,82.7,70.7,00000
33.0,30.0,81.0,412,01,01,  Harbaid,92,180,51,91,41,89,33.8,35.9,31.5,00000
33.0,30.0,81.0,412,02,01,  Kodalia,186,222,107,111,79,111,45.6,49.1,41.6,00000
33.0,30.0,81.0,412,03,01,  Mathalia,318,86,168,36,150,50,78.7,82.4,75.0,00000
33.0,30.0,81.0,582,01,01,  Khilgaon,1102,836,581,432,521,404,56.9,57.4,56.3,00000
33.0,30.0,81.0,582,02,01,  Kumaria,249,173,134,85,115,88,59.0,61.2,56.7,00000
33.0,30.0,81.0,836,01,01,  Pubail,619,142,339,62,280,80,81.3,84.5,77.8,00000
33.0,30.0,81.0,836,02,01,  Nayani Para,2195,1105,1117,504,1078,601,66.5,68.9,64.2,00000
33.0,30.0,81.0,836,03,01,  Bara Dhal,458,79,244,29,214,50,85.3,89.4,81.1,00000
33.0,30.0,81.0,836,04,01,  Haribari Tek,593,281,340,138,253,143,67.8,71.1,63.9,00000
33.0,30.0,81.0,836,05,01,  Demati,94,118,47,58,47,60,44.3,44.8,43.9,00000
33.0,30.0,81.0,836,06,01,  Sapmara,280,86,143,36,137,50,76.5,79.9,73.3,00000
33.0,30.0,81.0,910,01,01,  Sorul,512,312,275,137,237,175,62.1,66.7,57.5,00000
33.0,30.0,81.0,910,02,01,  Baroibari,447,105,250,51,197,54,81.0,83.1,78.5,00000
33.0,32.0,13.0,442,01,01,  Gosatra,1006,591,503,258,503,333,63.0,66.1,60.2,00000
33.0,32.0,13.0,442,02,01,  Chowdhury Tek,422,79,207,25,215,54,84.2,89.2,79.9,00000
33.0,32.0,19.0,210,01,01,  Berachala,142,197,72,88,70,109,41.9,45.0,39.1,00000
33.0,32.0,19.0,210,02,01,  Shimulchala,136,299,71,144,65,155,31.3,33.0,29.5,00000
33.0,32.0,19.0,265,01,01,  Boali,702,688,367,318,335,370,50.5,53.6,47.5,00000
33.0,32.0,19.0,265,02,01,  Nanderchala,120,153,63,78,57,75,44.0,44.7,43.2,00000
33.0,32.0,19.0,265,03,01,  Sikdarchala,141,125,76,52,65,73,53.0,59.4,47.1,00000
33.0,32.0,19.0,265,04,01,  Kapasia Chala,70,92,39,35,31,57,43.2,52.7,35.2,00000
33.0,32.0,19.0,353,01,01,  Kundaghata,372,280,199,132,173,148,57.1,60.1,53.9,00000
33.0,32.0,19.0,353,02,01,  Dakurail,418,101,218,36,200,65,80.5,85.8,75.5,00000
33.0,32.0,19.0,353,03,01,  Dhoal Samudra,440,153,236,57,204,96,74.2,80.5,68.0,00000
33.0,32.0,19.0,431,01,01,  Golaia,331,347,183,132,148,215,48.8,58.1,40.8,00000
33.0,32.0,19.0,431,02,01,  Madankhali,212,200,103,92,109,108,51.5,52.8,50.2,00000
33.0,32.0,19.0,596,01,01,  Raghunathpur,204,149,124,60,80,89,57.8,67.4,47.3,00000
33.0,32.0,19.0,596,02,01,  Sreepur,545,726,304,326,241,400,42.9,48.3,37.6,00000
33.0,32.0,19.0,596,03,01,  Madhyapara,168,234,109,100,59,134,41.8,52.2,30.6,00000
33.0,32.0,19.0,596,04,01,  Gaburiachala,664,768,339,392,325,376,46.4,46.4,46.4,00000
33.0,32.0,19.0,596,05,01,  Dhopadhara,153,303,78,149,75,154,33.6,34.4,32.8,00000
33.0,32.0,19.0,596,06,01,  Gachhbari,840,716,439,303,401,413,54.0,59.2,49.3,00000
33.0,32.0,19.0,596,07,01,  Bathenachala,63,86,33,32,30,54,42.3,50.8,35.7,00000
33.0,32.0,19.0,674,01,01,  Nandichala,78,86,44,40,34,46,47.6,52.4,42.5,00000
33.0,32.0,19.0,674,02,01,  Talgachhiachala,170,75,93,27,77,48,69.4,77.5,61.6,00000
33.0,32.0,19.0,674,03,01,  Kapasiachala,271,154,157,64,114,90,63.8,71.0,55.9,00000
33.0,32.0,19.0,674,04,01,  Gabchala,214,209,106,93,108,116,50.6,53.3,48.2,00000
33.0,32.0,19.0,862,01,01,  Sonatala,761,583,403,244,358,339,56.6,62.3,51.4,00000
33.0,32.0,19.0,862,02,01,  Chabagan,364,416,182,184,182,232,46.7,49.7,44.0,00000
33.0,32.0,19.0,862,03,01,  Jhingahati,428,456,238,207,190,249,48.4,53.5,43.3,00000
33.0,32.0,19.0,862,04,01,  Naya Para,474,599,236,279,238,320,44.2,45.8,42.7,00000
33.0,32.0,19.0,862,05,01,  Karaitali,189,188,105,87,84,101,50.1,54.7,45.4,00000
33.0,32.0,47.0,508,01,01,  Jathila,789,1172,426,519,363,653,40.2,45.1,35.7,00000
33.0,32.0,47.0,508,02,01,  Mazidchala,289,423,155,196,134,227,40.6,44.2,37.1,00000
33.0,32.0,47.0,508,03,01,  Amtail,178,299,96,133,82,166,37.3,41.9,33.1,00000
33.0,32.0,47.0,508,04,01,  Barachala,224,290,112,128,112,162,43.6,46.7,40.9,00000
33.0,32.0,47.0,508,05,01,  Bagair,370,367,179,149,191,218,50.2,54.6,46.7,00000
33.0,32.0,47.0,508,06,01,  Amgachhachala,85,84,45,41,40,43,50.3,52.3,48.2,00000
33.0,32.0,47.0,569,01,01,  Khalishajani,701,739,377,316,324,423,48.7,54.4,43.4,00000
33.0,32.0,47.0,569,02,01,  Ramchandrapur,576,837,330,349,246,488,40.8,48.6,33.5,00000
33.0,32.0,47.0,569,03,01,  Kenduar Baid,250,383,148,211,102,172,39.5,41.2,37.2,00000
33.0,32.0,47.0,569,04,01,  Sirajpur,191,141,101,72,90,69,57.5,58.4,56.6,00000
33.0,32.0,47.0,569,05,01,  Kathachora,779,848,399,388,380,460,47.9,50.7,45.2,00000
33.0,32.0,47.0,569,06,01,  Baheratali,692,785,355,337,337,448,46.9,51.3,42.9,00000
33.0,32.0,47.0,619,01,01,  Mantala,457,721,218,328,239,393,38.8,39.9,37.8,00000
33.0,32.0,47.0,619,02,01,  Pubachala,609,652,306,279,303,373,48.3,52.3,44.8,00000
33.0,32.0,47.0,646,01,01,  Mothajuri,315,655,163,287,152,368,32.5,36.2,29.2,00000
33.0,32.0,47.0,646,02,01,  Gayenchala,154,239,82,112,72,127,39.2,42.3,36.2,00000
33.0,32.0,47.0,646,03,01,  Salonga,267,787,130,365,137,422,25.3,26.3,24.5,00000
33.0,32.0,47.0,646,04,01,  Talchala,283,645,148,291,135,354,30.5,33.7,27.6,00000
33.0,32.0,47.0,646,05,01,  Phida Para,380,599,200,289,180,310,38.8,40.9,36.7,00000
33.0,32.0,47.0,646,06,01,  Bakchala,201,342,105,150,96,192,37.0,41.2,33.3,00000
33.0,32.0,47.0,646,07,01,  Khil Para,234,449,120,202,114,247,34.3,37.3,31.6,00000
33.0,32.0,47.0,646,08,01,  Motha Para,245,132,115,70,130,62,65.0,62.2,67.7,00000
33.0,32.0,47.0,646,09,01,  Saldaha Para,261,377,133,165,128,212,40.9,44.6,37.6,00000
33.0,32.0,47.0,646,10,01,  Pingabaha,109,201,60,84,49,117,35.2,41.7,29.5,00000
33.0,32.0,47.0,646,11,01,  Kachighata,493,436,256,188,237,248,53.1,57.7,48.9,00000
33.0,32.0,47.0,646,12,01,  Uttar Fulbaria Para,632,820,346,367,286,453,43.5,48.5,38.7,00000
33.0,32.0,47.0,646,13,01,  Fulbaria Bazar,294,114,180,64,114,50,72.1,73.8,69.5,00000
33.0,32.0,47.0,646,14,01,  Purba Fulbari Para,495,478,283,218,212,260,50.9,56.5,44.9,00000
33.0,32.0,47.0,646,15,01,  Dakshin Fulbaria Para,481,528,242,244,239,284,47.7,49.8,45.7,00000
33.0,32.0,47.0,646,16,01,  Karichala,192,535,92,255,100,280,26.4,26.5,26.3,00000
33.0,32.0,47.0,646,17,01,  Rampur,153,159,79,73,74,86,49.0,52.0,46.3,00000
33.0,32.0,47.0,646,18,01,  Naya Para,28,78,16,38,12,40,26.4,29.6,23.1,00000
33.0,32.0,47.0,646,19,01,  Bagarpur,147,240,61,110,86,130,38.0,35.7,39.8,00000
33.0,32.0,47.0,994,01,01,  Uttar Shimulia,397,499,213,211,184,288,44.3,50.2,39.0,00000
33.0,32.0,47.0,994,02,01,  Janpara,150,274,84,122,66,152,35.4,40.8,30.3,00000
33.0,32.0,47.0,994,03,01,  Kombal Para,293,289,163,110,130,179,50.3,59.7,42.1,00000
33.0,32.0,47.0,994,04,01,  Sindukchala,34,101,19,49,15,52,25.2,27.9,22.4,00000
33.0,32.0,57.0,403,01,01,  Sailakhali,300,123,163,45,137,78,70.9,78.4,63.7,00000
33.0,32.0,57.0,403,02,01,  Galachipa,322,298,171,132,151,166,51.9,56.4,47.6,00000
33.0,32.0,57.0,403,03,01,  Berichala,113,45,64,11,49,34,71.5,85.3,59.0,00000
33.0,32.0,57.0,403,04,01,  Baharia Chala,334,193,185,75,149,118,63.4,71.2,55.8,00000
33.0,32.0,57.0,403,05,01,  Sejab,98,80,54,29,44,51,55.1,65.1,46.3,00000
33.0,32.0,57.0,580,01,01,  Kusulnath,123,94,62,44,61,50,56.7,58.5,55.0,00000
33.0,32.0,57.0,580,02,01,  Kuarchala,435,493,236,244,199,249,46.9,49.2,44.4,00000
33.0,32.0,57.0,580,03,01,  Busbari,21,33,10,16,11,17,38.9,38.5,39.3,00000
33.0,32.0,57.0,580,04,01,  Kathaltali,209,129,120,51,89,78,61.8,70.2,53.3,00000
33.0,32.0,57.0,602,01,01,  Purba Barachala,226,159,116,76,110,83,58.7,60.4,57.0,00000
33.0,32.0,57.0,602,02,01,  Palashtali,558,304,297,127,261,177,64.7,70.0,59.6,00000
33.0,32.0,57.0,602,03,01,  Jamalpur,362,196,238,89,124,107,64.9,72.8,53.7,00000
33.0,32.0,57.0,602,04,01,  Duanai Chala,277,145,168,72,109,73,65.6,70.0,59.9,00000
33.0,32.0,57.0,602,05,01,  Durgapur,392,292,225,140,167,152,57.3,61.6,52.4,00000
33.0,32.0,57.0,602,06,01,  Fakirchala,217,160,122,77,95,83,57.6,61.3,53.4,00000
33.0,32.0,57.0,602,07,01,  Thengar Band,1140,927,626,434,514,493,55.2,59.1,51.0,00000
33.0,32.0,57.0,834,01,01,  Solahati,446,66,232,25,214,41,87.1,90.3,83.9,00000
33.0,32.0,57.0,834,02,01,  Chotalsolahati,87,60,49,25,38,35,59.2,66.2,52.1,00000
33.0,32.0,57.0,834,03,01,  Amdair,623,528,341,241,282,287,54.1,58.6,49.6,00000
33.0,32.0,57.0,834,04,01,  Haturiachala,1075,814,583,338,492,476,56.9,63.3,50.8,00000
33.0,32.0,57.0,834,05,01,  Aliar Chala,394,473,195,204,199,269,45.4,48.9,42.5,00000
33.0,32.0,57.0,834,06,01,  Gobindapur,398,412,213,185,185,227,49.1,53.5,44.9,00000
33.0,32.0,57.0,834,07,01,  Tanar Chala,140,75,72,29,68,46,65.1,71.3,59.6,00000
33.0,32.0,57.0,917,01,01,  Akulichala,66,65,36,34,30,31,50.4,51.4,49.2,00000
33.0,32.0,57.0,917,02,01,  Muradpur,758,774,415,362,343,412,49.5,53.4,45.4,00000
33.0,32.0,57.0,917,03,01,  Howriachala,357,256,195,115,162,141,58.2,62.9,53.5,00000
33.0,32.0,57.0,917,04,01,  Nakchala,214,357,112,171,102,186,37.5,39.6,35.4,00000
33.0,32.0,57.0,917,05,01,  Thakur Para,539,276,287,116,252,160,66.1,71.2,61.2,00000
33.0,32.0,57.0,917,06,01,  Jaluavita,437,507,241,232,196,275,46.3,51.0,41.6,00000
33.0,32.0,57.0,967,01,01,  Barachala,223,209,124,94,99,115,51.6,56.9,46.3,00000
33.0,32.0,57.0,967,02,01,  Zenji Chala,689,549,367,256,322,293,55.7,58.9,52.4,00000
33.0,32.0,57.0,967,03,01,  Laskarchala,182,315,98,149,84,166,36.6,39.7,33.6,00000
33.0,32.0,57.0,967,04,01,  Rayerchala,229,267,129,119,100,148,46.2,52.0,40.3,00000
33.0,32.0,57.0,967,05,01,  Kamarchala,126,82,65,34,61,48,60.6,65.7,56.0,00000
33.0,32.0,57.0,967,06,01,  Senchala,60,59,32,25,28,34,50.4,56.1,45.2,00000
33.0,32.0,57.0,967,07,01,  Naichala,104,103,55,45,49,58,50.2,55.0,45.8,00000
33.0,32.0,57.0,967,08,01,  Madhya Para,160,111,80,51,80,60,59.0,61.1,57.1,00000
33.0,32.0,66.0,121,01,01,  Banshtali,472,518,277,229,195,289,47.7,54.7,40.3,00000
33.0,32.0,66.0,121,02,01,  Muzud Banshtali,246,182,131,82,115,100,57.5,61.5,53.5,00000
33.0,32.0,66.0,149,01,01,  Baraba,2314,1234,1275,583,1039,651,65.2,68.6,61.5,00000
33.0,32.0,66.0,149,02,01,  Suyapur,742,692,374,312,368,380,51.7,54.5,49.2,00000
33.0,32.0,66.0,149,03,01,  Madhabchala,313,184,174,82,139,102,63.0,68.0,57.7,00000
33.0,32.0,66.0,215,01,01,  Bhannara,2239,870,1145,380,1094,490,72.0,75.1,69.1,00000
33.0,32.0,66.0,215,02,01,  Dhopachala,665,364,349,150,316,214,64.6,69.9,59.6,00000
33.0,32.0,66.0,215,03,01,  Kathuriachala,473,248,238,117,235,131,65.6,67.0,64.2,00000
33.0,32.0,66.0,215,04,01,  Porachala,395,240,193,119,202,121,62.2,61.9,62.5,00000
33.0,32.0,66.0,563,01,01,  Kauchakuri,243,158,136,74,107,84,60.6,64.8,56.0,00000
33.0,32.0,66.0,563,02,01,  Kubjarchala,387,219,210,99,177,120,63.9,68.0,59.6,00000
33.0,32.0,66.0,563,03,01,  Atramchala,182,111,103,47,79,64,62.1,68.7,55.2,00000
33.0,32.0,66.0,563,04,01,  Kainara,2484,1155,1276,543,1208,612,68.3,70.1,66.4,00000
33.0,32.0,66.0,563,05,01,  Bamanbagh,237,215,121,94,116,121,52.4,56.3,48.9,00000
33.0,32.0,66.0,563,06,01,  Mouchak & Novuarbagh,10954,4716,6546,2188,4408,2528,69.9,74.9,63.6,00000
33.0,32.0,66.0,563,07,01,  Nischintapur,2256,1231,1402,629,854,602,64.7,69.0,58.7,00000
33.0,32.0,66.0,563,08,01,  Kalabhanda,2184,2214,1144,988,1040,1226,49.7,53.7,45.9,00000
33.0,32.0,66.0,563,09,01,  Kamrangachala,2925,1327,1598,616,1327,711,68.8,72.2,65.1,00000
33.0,32.0,66.0,563,10,01,  Sadarchala,724,734,405,339,319,395,49.7,54.4,44.7,00000
33.0,32.0,66.0,563,11,01,  Telerchala,5638,2924,3218,1381,2420,1543,65.8,70.0,61.1,00000
33.0,32.0,66.0,563,12,01,  Rakhaliarchala,3436,3476,1778,1632,1658,1844,49.7,52.1,47.3,00000
33.0,32.0,66.0,563,13,01,  Nali Para,57,88,28,40,29,48,39.3,41.2,37.7,00000
33.0,32.0,66.0,563,14,01,  Jogirchala,1550,937,906,431,644,506,62.3,67.8,56.0,00000
33.0,32.0,66.0,563,15,01,  Andhar Manik,385,283,193,131,192,152,57.6,59.6,55.8,00000
33.0,32.0,66.0,613,01,01,  Majhukhan,252,258,148,117,104,141,49.4,55.8,42.4,00000
33.0,32.0,66.0,613,02,01,  Hazarichala,913,572,492,234,421,338,61.5,67.8,55.5,00000
33.0,32.0,66.0,613,03,01,  Barachanchala,419,187,227,73,192,114,69.1,75.7,62.7,00000
33.0,32.0,66.0,613,04,01,  Fulchala,286,148,159,63,127,85,65.9,71.6,59.9,00000
33.0,32.0,66.0,795,01,01,  Sahebabad,828,303,448,104,380,199,73.2,81.2,65.6,00000
33.0,32.0,66.0,795,02,01,  Bairagirchala,131,92,72,42,59,50,58.7,63.2,54.1,00000
33.0,34.0,15.0,178,01,01,  Betua,385,525,200,261,185,264,42.3,43.4,41.2,00000
33.0,34.0,15.0,178,02,01,  Chaygati,570,409,276,219,294,190,58.2,55.8,60.7,00000
33.0,34.0,15.0,614,01,01,  Khalapara,1611,903,829,429,782,474,64.1,65.9,62.3,00000
33.0,34.0,15.0,614,02,01,  Kakab,851,338,441,155,410,183,71.6,74.0,69.1,00000
33.0,34.0,15.0,614,03,01,  Char Para,870,436,448,201,422,235,66.6,69.0,64.2,00000
33.0,34.0,15.0,614,04,01,  Sonachora,697,303,368,157,329,146,69.7,70.1,69.3,00000
33.0,34.0,17.0,916,01,01,  Satani Para,872,420,398,202,474,218,67.5,66.3,68.5,00000
33.0,34.0,17.0,916,02,01,  Paschim Satani Para,368,81,164,35,204,46,82.0,82.4,81.6,00000
33.0,34.0,60.0,491,01,01,  Jamalpur,6866,4258,3476,2134,3390,2124,61.7,62.0,61.5,00000
33.0,34.0,60.0,491,02,01,  Mendipur,587,381,292,189,295,192,60.6,60.7,60.6,00000
33.0,34.0,96.0,103,01,01,  Bhashabhashi,296,313,153,153,143,160,48.6,50.0,47.2,00000
33.0,34.0,96.0,103,02,01,  Barakaw,698,424,367,201,331,223,62.2,64.6,59.7,00000
33.0,34.0,96.0,103,03,01,  Kalikuti,164,225,87,108,77,117,42.2,44.6,39.7,00000
33.0,34.0,96.0,220,01,01,  Birua,169,109,93,45,76,64,60.8,67.4,54.3,00000
33.0,34.0,96.0,220,02,01,  Nalchata,78,40,46,14,32,26,66.1,76.7,55.2,00000
33.0,34.0,96.0,535,01,01,  Ketun,441,185,240,91,201,94,70.4,72.5,68.1,00000
33.0,34.0,96.0,535,02,01,  Mirer Tek,123,65,61,37,62,28,65.4,62.2,68.9,00000
33.0,34.0,96.0,633,01,01,  Mathbari,278,130,135,67,143,63,68.1,66.8,69.4,00000
33.0,34.0,96.0,633,02,01,  Baghbari,246,93,125,46,121,47,72.6,73.1,72.0,00000
33.0,34.0,96.0,633,03,01,  Malla,221,52,98,24,123,28,81.0,80.3,81.5,00000
33.0,34.0,96.0,633,04,01,  Tahurdia,308,156,170,72,138,84,66.4,70.2,62.2,00000
33.0,34.0,96.0,633,05,01,  Mathail,99,81,49,43,50,38,55.0,53.3,56.8,00000
33.0,34.0,96.0,633,06,01,  Hatkhola,131,121,70,57,61,64,52.0,55.1,48.8,00000
33.0,34.0,96.0,633,07,01,  Bara Dahindi,423,168,230,76,193,92,71.6,75.2,67.7,00000
33.0,34.0,96.0,633,08,01,  Kalun,134,50,57,27,77,23,72.8,67.9,77.0,00000
33.0,34.0,96.0,633,09,01,  Chhota Dahindi,229,75,113,35,116,40,75.3,76.4,74.4,00000
33.0,34.0,96.0,685,01,01,  Nagari,474,37,304,17,170,20,92.8,94.7,89.5,00000
33.0,34.0,96.0,685,02,01,  Bhururia,756,152,364,75,392,77,83.3,82.9,83.6,00000
33.0,34.0,96.0,736,01,01,  Dakshin Panjora,1341,1058,655,514,686,544,55.9,56.0,55.8,00000
33.0,34.0,96.0,736,02,01,  Madhya Panjora,657,509,330,235,327,274,56.3,58.4,54.4,00000
33.0,34.0,96.0,736,03,01,  Sukpara,219,297,98,137,121,160,42.4,41.7,43.1,00000
33.0,34.0,96.0,736,04,01,  Banik Para,491,125,231,77,260,48,79.7,75.0,84.4,00000
33.0,34.0,96.0,736,05,01,  Bhashani,421,211,181,113,240,98,66.6,61.6,71.0,00000
33.0,34.0,96.0,736,06,01,  Chankhola,126,92,63,50,63,42,57.8,55.8,60.0,00000
33.0,34.0,96.0,736,07,01,  Kumar Para,226,136,105,71,121,65,62.4,59.7,65.1,00000
33.0,34.0,96.0,779,01,01,  Pipulia,756,408,419,191,337,217,64.9,68.7,60.8,00000
33.0,34.0,96.0,779,02,01,  Kakalia,12,126,7,61,5,65,8.7,10.3,7.1,00000
33.0,34.0,96.0,807,01,01,  Rathura,642,426,332,218,310,208,60.1,60.4,59.8,00000
33.0,34.0,96.0,807,02,01,  Belun,199,98,102,41,97,57,67.0,71.3,63.0,00000
33.0,34.0,96.0,807,03,01,  Kutarati,69,48,34,26,35,22,59.0,56.7,61.4,00000
33.0,34.0,96.0,896,01,01,  Talia,272,274,134,158,138,116,49.8,45.9,54.3,00000
33.0,34.0,96.0,896,02,01,  Karaihati,79,22,45,11,34,11,78.2,80.4,75.6,00000
33.0,34.0,96.0,985,01,01,  Ulukhola,418,207,208,108,210,99,66.9,65.8,68.0,00000
33.0,34.0,96.0,985,02,01,  Bashbari,81,58,43,27,38,31,58.3,61.4,55.1,00000
33.0,34.0,97.0,032,01,01,  Boaliar Tek,81,8,41,3,40,5,91.0,93.2,88.9,00000
33.0,34.0,97.0,032,02,01,  Ara Bandakhola,572,231,278,105,294,126,71.2,72.6,70.0,00000
33.0,34.0,97.0,032,03,01,  Puinnar Tek,256,131,124,65,132,66,66.1,65.6,66.7,00000
33.0,34.0,97.0,084,01,01,  Bandakhola,674,390,369,192,305,198,63.3,65.8,60.6,00000
33.0,34.0,97.0,084,02,01,  Dari Para,809,183,353,101,456,82,81.6,77.8,84.8,00000
33.0,34.0,97.0,084,03,01,  Madhabnagar,145,64,72,28,73,36,69.4,72.0,67.0,00000
33.0,34.0,97.0,084,04,01,  Kachurir Tek,18,7,8,5,10,2,72.0,61.5,83.3,00000
33.0,34.0,97.0,084,05,01,  Tiler Tek,78,78,48,40,30,38,50.0,54.5,44.1,00000
33.0,34.0,97.0,276,01,01,  Sanaiya,187,121,89,49,98,72,60.7,64.5,57.6,00000
33.0,34.0,97.0,276,02,01,  Bariakhali,74,37,36,14,38,23,66.7,72.0,62.3,00000
33.0,34.0,97.0,276,03,01,  Charerkhola,371,71,166,32,205,39,83.9,83.8,84.0,00000
33.0,34.0,97.0,281,01,01,  Chuariakhola(Uttar),880,731,438,367,442,364,54.6,54.4,54.8,00000
33.0,34.0,97.0,281,02,01,  Chuariakhola(Dakshin),2278,1288,1100,601,1178,687,63.9,64.7,63.2,00000
33.0,34.0,97.0,281,03,01,  Joyramber,281,145,117,81,164,64,66.0,59.1,71.9,00000
33.0,34.0,97.0,281,04,01,  Rangamatia,513,205,242,103,271,102,71.4,70.1,72.7,00000
33.0,34.0,97.0,281,05,01,  Dari Para,466,89,222,50,244,39,84.0,81.6,86.2,00000
33.0,34.0,97.0,877,01,01,  Uttar Som,1188,686,637,307,551,379,63.4,67.5,59.2,00000
33.0,34.0,97.0,877,02,01,  Dakshin Som,870,401,426,195,444,206,68.5,68.6,68.3,00000
33.0,36.0,13.0,138,01,01,  Barishaba,438,529,193,263,245,266,45.3,42.3,47.9,00000
33.0,36.0,13.0,138,02,01,  Banarkandi,618,699,259,341,359,358,46.9,43.2,50.1,00000
33.0,36.0,13.0,138,03,01,  Pingali,115,136,42,75,73,61,45.8,35.9,54.5,00000
33.0,36.0,13.0,138,04,01,  Chowkerchala,287,271,124,130,163,141,51.4,48.8,53.6,00000
33.0,36.0,13.0,186,01,01,  Bhikar Tek,325,411,134,202,191,209,44.2,39.9,47.8,00000
33.0,36.0,13.0,186,02,01,  Bagra,181,212,78,106,103,106,46.1,42.4,49.3,00000
33.0,36.0,13.0,337,01,01,  Daora,359,342,174,163,185,179,51.2,51.6,50.8,00000
33.0,36.0,13.0,337,02,01,  Banor Haola,623,539,283,270,340,269,53.6,51.2,55.8,00000
33.0,36.0,13.0,434,01,01,  Gaorar,912,1344,454,646,458,698,40.4,41.3,39.6,00000
33.0,36.0,13.0,434,02,01,  Bherarchala,670,731,328,350,342,381,47.8,48.4,47.3,00000
33.0,36.0,13.0,434,03,01,  Babirchala,169,278,79,137,90,141,37.8,36.6,39.0,00000
33.0,36.0,13.0,615,01,01,  Kirtania,471,677,208,320,263,357,41.0,39.4,42.4,00000
33.0,36.0,13.0,615,02,01,  Poirabo,450,358,206,184,244,174,55.7,52.8,58.4,00000
33.0,36.0,13.0,651,01,01,  Lohadia,1678,1216,800,564,878,652,58.0,58.7,57.4,00000
33.0,36.0,13.0,651,02,01,  Narsingpur,568,812,284,391,284,421,41.2,42.1,40.3,00000
33.0,36.0,13.0,651,03,01,  Durlabhpur,232,207,98,97,134,110,52.8,50.3,54.9,00000
33.0,36.0,13.0,717,01,01,  Narottampur,450,570,199,277,251,293,44.1,41.8,46.1,00000
33.0,36.0,13.0,717,02,01,  Batna,454,395,225,202,229,193,53.5,52.7,54.3,00000
33.0,36.0,13.0,717,03,01,  Rajabari,154,127,74,58,80,69,54.8,56.1,53.7,00000
33.0,36.0,13.0,735,01,01,  Nayanagar,813,627,414,276,399,351,56.5,60.0,53.2,00000
33.0,36.0,13.0,735,02,01,  Damuarchala,367,452,176,214,191,238,44.8,45.1,44.5,00000
33.0,36.0,17.0,627,01,01,  Kot Bajalia,648,567,299,292,349,275,53.3,50.6,55.9,00000
33.0,36.0,17.0,627,02,01,  Barpushia,508,580,237,290,271,290,46.7,45.0,48.3,00000
33.0,36.0,17.0,627,03,01,  Bhat Para,218,45,113,23,105,22,82.9,83.1,82.7,00000
33.0,36.0,25.0,361,01,01,  Daulgaon (Khilgaon),703,443,317,230,386,213,61.3,58.0,64.4,00000
33.0,36.0,25.0,361,02,01,  Rupduiar Tek,225,110,106,52,119,58,67.2,67.1,67.2,00000
33.0,36.0,25.0,476,01,01,  Gosaingaon,690,602,315,291,375,311,53.4,52.0,54.7,00000
33.0,36.0,25.0,476,02,01,  Raniganj Bazar,41,20,22,9,19,11,67.2,71.0,63.3,00000
33.0,36.0,25.0,820,01,01,  Raonat,1596,1149,768,529,828,620,58.1,59.2,57.2,00000
33.0,36.0,25.0,820,02,01,  Doaipathuri,377,359,171,175,206,184,51.2,49.4,52.8,00000
33.0,36.0,25.0,820,03,01,  Tekmerun,152,120,67,62,85,58,55.9,51.9,59.4,00000
33.0,36.0,34.0,066,01,01,  Bagua,916,890,451,424,465,466,50.7,51.5,49.9,00000
33.0,36.0,34.0,066,02,01,  Singua,779,973,365,491,414,482,44.5,42.6,46.2,00000
33.0,36.0,43.0,578,01,03,  Kapasia,1716,1911,889,958,827,953,47.3,48.1,46.5,00000
33.0,36.0,43.0,578,02,03,  Baratek,401,355,193,180,208,175,53.0,51.7,54.3,00000
33.0,36.0,43.0,928,01,01,  Surjya Narayanpur,1989,1785,876,766,1113,1019,52.7,53.3,52.2,00000
33.0,36.0,43.0,928,02,01,  Bhubanerchala,541,480,255,221,286,259,53.0,53.6,52.5,00000
33.0,36.0,51.0,428,01,01,  Paschimpara,776,441,366,208,410,233,63.8,63.8,63.8,00000
33.0,36.0,51.0,428,02,01,  Purbapara,998,678,451,323,547,355,59.5,58.3,60.6,00000
33.0,36.0,51.0,428,03,01,  Char Khamar,920,459,442,213,478,246,66.7,67.5,66.0,00000
33.0,36.0,51.0,584,01,01,  Karihata,1041,1027,462,493,579,534,50.3,48.4,52.0,00000
33.0,36.0,51.0,584,02,01,  Bagunhati,288,345,129,165,159,180,45.5,43.9,46.9,00000
33.0,36.0,51.0,584,03,01,  Sreepur,158,64,83,21,75,43,71.2,79.8,63.6,00000
33.0,36.0,51.0,753,01,01,  Pakiaba,181,591,69,292,112,299,23.4,19.1,27.3,00000
33.0,36.0,51.0,753,02,01,  Kozzaid Kiddie,206,221,83,105,123,116,48.2,44.1,51.5,00000
33.0,36.0,60.0,054,01,01,  Bagherhat,686,418,361,191,325,227,62.1,65.4,58.9,00000
33.0,36.0,60.0,054,02,01,  Mahtabpur,271,364,127,192,144,172,42.7,39.8,45.6,00000
33.0,36.0,60.0,114,01,01,  Barahar,743,742,361,367,382,375,50.0,49.6,50.5,00000
33.0,36.0,60.0,114,02,01,  Baluchara,234,270,111,149,123,121,46.4,42.7,50.4,00000
33.0,36.0,60.0,114,03,01,  Chak Barahar,578,567,286,283,292,284,50.5,50.3,50.7,00000
33.0,36.0,60.0,114,04,01,  Marulia Para,598,481,266,228,332,253,55.4,53.8,56.8,00000
33.0,36.0,60.0,174,01,01,  Belasi,1562,1195,847,562,715,633,56.7,60.1,53.0,00000
33.0,36.0,60.0,174,02,01,  Talla Para,441,292,208,155,233,137,60.2,57.3,63.0,00000
33.0,36.0,60.0,832,01,01,  Kaldaia,515,264,256,115,259,149,66.1,69.0,63.5,00000
33.0,36.0,60.0,832,02,01,  Bibadia,425,364,184,187,241,177,53.9,49.6,57.7,00000
33.0,36.0,60.0,832,03,01,  Madhyapara,883,647,402,302,481,345,57.7,57.1,58.2,00000
33.0,36.0,60.0,832,04,01,  Purbapara,1050,605,531,292,519,313,63.4,64.5,62.4,00000
33.0,36.0,60.0,832,05,01,  Bara Gartak,87,45,45,19,42,26,65.9,70.3,61.8,00000
33.0,36.0,60.0,832,06,01,  Mamu Bhaignar Tek,140,119,59,57,81,62,54.1,50.9,56.6,00000
33.0,36.0,60.0,832,07,01,  Aowlab,488,224,227,104,261,120,68.5,68.6,68.5,00000
33.0,36.0,60.0,844,01,01,  Dardaria,629,428,302,196,327,232,59.5,60.6,58.5,00000
33.0,36.0,60.0,844,02,01,  Chaura Para,404,396,187,180,217,216,50.5,51.0,50.1,00000
33.0,36.0,69.0,904,01,01,  Chandia,1075,774,494,411,581,363,58.1,54.6,61.5,00000
33.0,36.0,69.0,904,02,01,  Mamrudi,698,382,320,187,378,195,64.6,63.1,66.0,00000
33.0,36.0,69.0,904,03,01,  Joydeb Pahari,99,91,36,45,63,46,52.1,44.4,57.8,00000
33.0,36.0,77.0,898,01,01,  Kuriadi,614,630,293,312,321,318,49.4,48.4,50.2,00000
33.0,36.0,77.0,898,02,01,  Nayanagar,959,382,459,176,500,206,71.5,72.3,70.8,00000
33.0,36.0,77.0,898,03,01,  Barber,575,693,295,323,280,370,45.3,47.7,43.1,00000
33.0,36.0,77.0,898,04,01,  Jhauadi,703,610,316,294,387,316,53.5,51.8,55.0,00000
33.0,36.0,77.0,898,05,01,  Bhiti Para,1368,1674,682,799,686,875,45.0,46.0,43.9,00000
33.0,36.0,77.0,898,06,01,  Kulganga,302,155,150,66,152,89,66.1,69.4,63.1,00000
33.0,36.0,77.0,898,07,01,  Barabari,279,170,150,91,129,79,62.1,62.2,62.0,00000
33.0,36.0,77.0,898,08,01,  Bailarkandi,43,60,14,28,29,32,41.7,33.3,47.5,00000
33.0,36.0,77.0,898,09,01,  Dowain Nagar,290,133,129,61,161,72,68.6,67.9,69.1,00000
33.0,36.0,77.0,898,10,01,  Boribari,1237,709,614,332,623,377,63.6,64.9,62.3,00000
33.0,36.0,77.0,898,11,01,  Sohagpur,739,397,349,186,390,211,65.1,65.2,64.9,00000
33.0,36.0,77.0,898,12,01,  Namila,1170,575,568,263,602,312,67.0,68.4,65.9,00000
33.0,36.0,77.0,898,13,01,  Norda,279,159,143,82,136,77,63.7,63.6,63.8,00000
33.0,36.0,77.0,898,14,01,  Kapalishwar,1695,1039,817,496,878,543,62.0,62.2,61.8,00000
33.0,36.0,86.0,687,01,01,  Matikata,37,54,17,29,20,25,40.7,37.0,44.4,00000
33.0,36.0,86.0,687,02,01,  Dakshin Khamar,426,360,211,179,215,181,54.2,54.1,54.3,00000
33.0,36.0,86.0,687,03,01,  Uttar Khamar,3001,2187,1444,1072,1557,1115,57.8,57.4,58.3,00000
33.0,36.0,86.0,916,01,01,  Sonarua,272,171,127,78,145,93,61.4,62.0,60.9,00000
33.0,36.0,86.0,916,02,01,  Dusara Anjab,134,82,60,46,74,36,62.0,56.6,67.3,00000
33.0,36.0,86.0,916,03,01,  Luhuri,294,253,115,124,179,129,53.7,48.1,58.1,00000
33.0,36.0,86.0,916,04,01,  Nabipur,594,390,287,177,307,213,60.4,61.9,59.0,00000
33.0,36.0,94.0,976,01,01,  Bengurdi,291,405,139,197,152,208,41.8,41.4,42.2,00000
33.0,36.0,94.0,976,02,01,  Gooradia,312,183,154,93,158,90,63.0,62.3,63.7,00000
33.0,36.0,94.0,976,03,01,  Chhatarbar,405,365,196,180,209,185,52.6,52.1,53.0,00000
33.0,36.0,94.0,976,04,01,  Pakurdia,125,81,63,45,62,36,60.7,58.3,63.3,00000
33.0,36.0,94.0,976,05,01,  Barachala,416,350,217,170,199,180,54.3,56.1,52.5,00000
33.0,36.0,94.0,976,06,01,  Dighirpar,431,580,208,272,223,308,42.6,43.3,42.0,00000
33.0,36.0,94.0,976,07,01,  Cheurait,443,361,213,164,230,197,55.1,56.5,53.9,00000
33.0,36.0,94.0,976,08,01,  Baradia,534,823,234,399,300,424,39.4,37.0,41.4,00000
33.0,36.0,94.0,976,09,01,  Biruzali,1384,1224,693,586,691,638,53.1,54.2,52.0,00000
33.0,86.0,21.0,125,01,01,  Barmi,3866,1907,1928,944,1938,963,67.0,67.1,66.8,00000
33.0,86.0,21.0,125,02,01,  Shit Para,608,337,294,175,314,162,64.3,62.7,66.0,00000
33.0,86.0,21.0,125,03,01,  Nehalia,281,241,149,116,132,125,53.8,56.2,51.4,00000
33.0,86.0,21.0,125,04,01,  Mudibari,147,335,72,150,75,185,30.5,32.4,28.8,00000
33.0,86.0,21.0,125,05,01,  Haritakir Tek,369,285,199,124,170,161,56.4,61.6,51.4,00000
33.0,86.0,21.0,138,01,01,  Barnal,1580,1344,779,686,801,658,54.0,53.2,54.9,00000
33.0,86.0,21.0,138,02,01,  Barkul,1607,1320,813,642,794,678,54.9,55.9,53.9,00000
33.0,86.0,21.0,226,01,01,  Char Bahar,370,349,187,152,183,197,51.5,55.2,48.2,00000
33.0,86.0,21.0,226,02,01,  Durlabhpur,1471,1582,762,711,709,871,48.2,51.7,44.9,00000
33.0,86.0,21.0,327,01,01,  Gararan,1667,1957,853,969,814,988,46.0,46.8,45.2,00000
33.0,86.0,21.0,327,02,01,  Sonakar,824,468,419,219,405,249,63.8,65.7,61.9,00000
33.0,86.0,21.0,327,03,01,  Tatirsuta,450,261,244,125,206,136,63.3,66.1,60.2,00000
33.0,86.0,21.0,768,01,01,  Pathan Tek,1602,795,905,411,697,384,66.8,68.8,64.5,00000
33.0,86.0,21.0,768,02,01,  Pathanbari,389,445,196,190,193,255,46.6,50.8,43.1,00000
33.0,86.0,21.0,768,03,01,  Barmi Bazar,857,268,468,101,389,167,76.2,82.2,70.0,00000
33.0,86.0,21.0,894,01,01,  Daibarir Tek,276,327,145,152,131,175,45.8,48.8,42.8,00000
33.0,86.0,21.0,894,02,01,  Balia Para,817,868,375,374,442,494,48.5,50.1,47.2,00000
33.0,86.0,21.0,894,03,01,  Kasijhuli,466,594,234,287,232,307,44.0,44.9,43.0,00000
33.0,86.0,21.0,894,04,01,  Deduar,193,171,101,75,92,96,53.0,57.4,48.9,00000
33.0,86.0,21.0,894,05,01,  Nimaichala,148,319,75,161,73,158,31.7,31.8,31.6,00000
33.0,86.0,21.0,894,06,01,  Bhiti Para,1156,1187,581,592,575,595,49.3,49.5,49.1,00000
33.0,86.0,21.0,894,07,01,  Thakurtala,319,215,153,106,166,109,59.7,59.1,60.4,00000
33.0,86.0,21.0,894,08,01,  Maij Para,533,651,253,327,280,324,45.0,43.6,46.4,00000
33.0,86.0,21.0,894,09,01,  Satkhamair,1492,1003,779,462,713,541,59.8,62.8,56.9,00000
33.0,86.0,21.0,894,10,01,  Posaid,176,311,90,160,86,151,36.1,36.0,36.3,00000
33.0,86.0,21.0,894,11,01,  Dhargarchala,608,963,291,468,317,495,38.7,38.3,39.0,00000
33.0,86.0,21.0,894,12,01,  Dhaleshwar,400,537,205,269,195,268,42.7,43.2,42.1,00000
33.0,86.0,21.0,894,13,01,  Kalartek,72,215,33,115,39,100,25.1,22.3,28.1,00000
33.0,86.0,21.0,894,14,01,  Mulamulir Tek,56,103,26,47,30,56,35.2,35.6,34.9,00000
33.0,86.0,21.0,894,15,01,  Lakhchatal,563,522,270,248,293,274,51.9,52.1,51.7,00000
33.0,86.0,25.0,289,01,01,  Dhanua,4536,3930,2636,1822,1900,2108,53.6,59.1,47.4,00000
33.0,86.0,25.0,289,02,01,  Ajugirchala,706,988,398,447,308,541,41.7,47.1,36.3,00000
33.0,86.0,25.0,289,03,01,  Butuli,551,833,307,358,244,475,39.8,46.2,33.9,00000
33.0,86.0,25.0,289,04,01,  Nagar Haola,2773,3233,1550,1588,1223,1645,46.2,49.4,42.6,00000
33.0,86.0,25.0,289,05,01,  Faridpur,1641,1416,913,668,728,748,53.7,57.7,49.3,00000
33.0,86.0,25.0,352,01,01,  Naya Para,709,1139,389,526,320,613,38.4,42.5,34.3,00000
33.0,86.0,25.0,352,02,01,  Gazipur,3730,4090,2047,2023,1683,2067,47.7,50.3,44.9,00000
33.0,86.0,25.0,352,03,01,  Nij Mauna,3026,3866,1626,1753,1400,2113,43.9,48.1,39.9,00000
33.0,86.0,28.0,390,01,01,  Gosinga,1130,745,535,372,595,373,60.3,59.0,61.5,00000
33.0,86.0,28.0,390,02,01,  Moitagara,250,350,126,181,124,169,41.7,41.0,42.3,00000
33.0,86.0,28.0,390,03,01,  Savarchala,362,211,167,101,195,110,63.2,62.3,63.9,00000
33.0,86.0,28.0,390,04,01,  Hayat Kharchala,696,436,342,200,354,236,61.5,63.1,60.0,00000
33.0,86.0,28.0,390,05,01,  Khila Para,507,220,256,95,251,125,69.7,72.9,66.8,00000
33.0,86.0,28.0,390,06,01,  Kachabari,184,247,89,108,95,139,42.7,45.2,40.6,00000
33.0,86.0,28.0,780,01,01,  Patka,2002,1763,1068,836,934,927,53.2,56.1,50.2,00000
33.0,86.0,28.0,780,02,01,  Hara Patka,379,279,171,151,208,128,57.6,53.1,61.9,00000
33.0,86.0,38.0,277,01,01,  Bidhay,887,1359,479,663,408,696,39.5,41.9,37.0,00000
33.0,86.0,38.0,277,02,01,  Abdar,711,679,422,324,289,355,51.2,56.6,44.9,00000
33.0,86.0,38.0,277,03,01,  Naya Para,644,1137,333,553,311,584,36.2,37.6,34.7,00000
33.0,86.0,38.0,277,04,01,  Shimultali,905,1297,430,641,475,656,41.1,40.1,42.0,00000
33.0,86.0,38.0,277,05,01,  Dhamlai,1756,2519,878,1242,878,1277,41.1,41.4,40.7,00000
33.0,86.0,38.0,277,06,01,  Galda Para,1426,2317,728,1139,698,1178,38.1,39.0,37.2,00000
33.0,86.0,38.0,277,07,01,  Haydebpur,640,830,325,416,315,414,43.5,43.9,43.2,00000
33.0,86.0,38.0,277,08,01,  Jogirshit,1234,1369,685,679,549,690,47.4,50.2,44.3,00000
33.0,86.0,47.0,100,01,01,  Pathar Para,712,656,398,306,314,350,52.0,56.5,47.3,00000
33.0,86.0,47.0,100,02,01,  Singhar Dighi,1471,1765,836,824,635,941,45.5,50.4,40.3,00000
33.0,86.0,47.0,100,03,01,  Bedjuri,307,626,162,289,145,337,32.9,35.9,30.1,00000
33.0,86.0,47.0,100,04,01,  Baratopa,2297,2262,1215,981,1082,1281,50.4,55.3,45.8,00000
33.0,86.0,47.0,100,05,01,  Fulalershit,474,646,262,286,212,360,42.3,47.8,37.1,00000
33.0,86.0,47.0,100,06,01,  Barabaid,115,146,54,68,61,78,44.1,44.3,43.9,00000
33.0,86.0,47.0,100,07,01,  Hasikhali,119,227,75,88,44,139,34.4,46.0,24.0,00000
33.0,86.0,47.0,100,08,01,  Joynatali,275,532,150,239,125,293,34.1,38.6,29.9,00000
33.0,86.0,47.0,100,09,01,  Baramtali,478,358,269,136,209,222,57.2,66.4,48.5,00000
33.0,86.0,47.0,100,10,01,  Indrapur,821,924,428,422,393,502,47.0,50.4,43.9,00000
33.0,86.0,47.0,100,11,01,  Beltali,405,587,196,299,209,288,40.8,39.6,42.1,00000
33.0,86.0,47.0,100,12,01,  Kabarghata,280,305,150,133,130,172,47.9,53.0,43.0,00000
33.0,86.0,47.0,604,01,01,  Maona,4268,3605,2403,1649,1865,1956,54.2,59.3,48.8,00000
33.0,86.0,47.0,604,02,01,  Chak Para,3176,2504,1839,1201,1337,1303,55.9,60.5,50.6,00000
33.0,86.0,47.0,604,03,01,  Kapatia Para,1137,2459,607,1161,530,1298,31.6,34.3,29.0,00000
33.0,86.0,47.0,604,04,01,  Singhar Dighi,1351,2110,829,1014,522,1096,39.0,45.0,32.3,00000
33.0,86.0,47.0,604,05,01,  Aktar Para,796,1798,412,811,384,987,30.7,33.7,28.0,00000
33.0,86.0,47.0,604,06,01,  Badnibhanga,552,800,304,358,248,442,40.8,45.9,35.9,00000
33.0,86.0,47.0,604,07,01,  Simla Para,337,468,179,225,158,243,41.9,44.3,39.4,00000
33.0,86.0,47.0,604,08,01,  Sirishghuri,626,875,333,409,293,466,41.7,44.9,38.6,00000
33.0,86.0,47.0,604,09,01,  Beltail,103,316,52,153,51,163,24.6,25.4,23.8,00000
33.0,86.0,57.0,012,01,01,  Atlora,534,773,266,389,268,384,40.9,40.6,41.1,00000
33.0,86.0,57.0,012,02,01,  Karala Madhabpur,327,218,171,97,156,121,60.0,63.8,56.3,00000
33.0,86.0,57.0,239,01,01,  Damdama,759,538,354,223,405,315,58.5,61.4,56.3,00000
33.0,86.0,57.0,239,02,01,  Char Damdama,831,599,371,294,460,305,58.1,55.8,60.1,00000
33.0,86.0,57.0,541,01,01,  Kismat Nanaia,354,293,168,135,186,158,54.7,55.4,54.1,00000
33.0,86.0,57.0,541,02,01,  Naniar Char,79,47,38,22,41,25,62.7,63.3,62.1,00000
33.0,86.0,57.0,541,03,01,  Atipara,166,82,76,31,90,51,66.9,71.0,63.8,00000
33.0,86.0,57.0,591,01,01,  Lohagachhia,533,368,269,177,264,191,59.2,60.3,58.0,00000
33.0,86.0,57.0,591,02,01,  Pratappur,517,404,250,189,267,215,56.1,56.9,55.4,00000
33.0,86.0,57.0,591,03,01,  Potabari,436,291,230,119,206,172,60.0,65.9,54.5,00000
33.0,86.0,57.0,591,04,01,  Maricherchala,199,62,106,24,93,38,76.2,81.5,71.0,00000
33.0,86.0,57.0,591,05,01,  Bhiti Para,409,457,201,219,208,238,47.2,47.9,46.6,00000
33.0,86.0,57.0,591,06,01,  Ashulia Para,415,270,183,119,232,151,60.6,60.6,60.6,00000
33.0,86.0,57.0,591,07,01,  Kadma,193,96,89,34,104,62,66.8,72.4,62.7,00000
33.0,86.0,57.0,591,08,01,  Sheraliabari,196,95,103,45,93,50,67.4,69.6,65.0,00000
33.0,86.0,57.0,591,09,01,  Rakhalia,191,98,99,41,92,57,66.1,70.7,61.7,00000
33.0,86.0,57.0,591,10,01,  Uzalia,176,243,95,114,81,129,42.0,45.5,38.6,00000
33.0,86.0,57.0,617,01,01,  Marta,1275,783,628,378,647,405,62.0,62.4,61.5,00000
33.0,86.0,57.0,617,02,01,  Baghmara,281,176,137,98,144,78,61.5,58.3,64.9,00000
33.0,86.0,57.0,617,03,01,  Martar Char,106,152,58,74,48,78,41.1,43.9,38.1,00000
33.0,86.0,57.0,705,01,01,  Nimuria,171,122,87,59,84,63,58.4,59.6,57.1,00000
33.0,86.0,57.0,705,02,01,  Mendipur,248,171,110,86,138,85,59.2,56.1,61.9,00000
33.0,86.0,66.0,340,01,01,  Gazaria,1472,921,763,443,709,478,61.5,63.3,59.7,00000
33.0,86.0,66.0,340,02,01,  Kural Para,419,196,210,84,209,112,68.1,71.4,65.1,00000
33.0,86.0,66.0,340,03,01,  Paburiarchala,533,407,324,230,209,177,56.7,58.5,54.1,00000
33.0,86.0,66.0,340,04,01,  Dhaljor,339,283,166,117,173,166,54.5,58.7,51.0,00000
33.0,86.0,66.0,629,01,01,  Mitalu,758,718,377,360,381,358,51.4,51.2,51.6,00000
33.0,86.0,66.0,629,02,01,  Madhabpur,620,518,319,230,301,288,54.5,58.1,51.1,00000
33.0,86.0,66.0,629,03,01,  Biraimati,142,272,64,126,78,146,34.3,33.7,34.8,00000
33.0,86.0,66.0,730,01,01,  Noagaon,2189,1504,1130,680,1059,824,59.3,62.4,56.2,00000
33.0,86.0,66.0,730,02,01,  Rajendrapur,1446,422,760,199,686,223,77.4,79.2,75.5,00000
33.0,86.0,66.0,843,01,01,  Rajabari,867,322,458,135,409,187,72.9,77.2,68.6,00000
33.0,86.0,66.0,843,02,01,  Mali Para,763,495,384,245,379,250,60.7,61.0,60.3,00000
33.0,86.0,66.0,843,03,01,  Bhiti Para,324,314,175,157,149,157,50.8,52.7,48.7,00000
33.0,86.0,66.0,843,04,01,  Batgachhia,183,148,96,69,87,79,55.3,58.2,52.4,00000
33.0,86.0,66.0,843,05,01,  Barachala,217,138,116,61,101,77,61.1,65.5,56.7,00000
33.0,86.0,66.0,843,06,01,  China Shukhania,2260,1843,1075,884,1185,959,55.1,54.9,55.3,00000
33.0,86.0,85.0,957,01,01,  Telihati,771,663,432,285,339,378,53.8,60.3,47.3,00000
33.0,86.0,85.0,957,02,01,  Godar Chala,831,710,435,336,396,374,53.9,56.4,51.4,00000
33.0,86.0,85.0,957,03,01,  Saitalia,734,737,390,335,344,402,49.9,53.8,46.1,00000
33.0,86.0,85.0,957,04,01,  Taltali,846,955,444,457,402,498,47.0,49.3,44.7,00000
33.0,86.0,85.0,957,05,01,  Udaykhali,376,473,205,223,171,250,44.3,47.9,40.6,00000
33.0,86.0,85.0,957,06,01,  Abdar,1775,1459,927,677,848,782,54.9,57.8,52.0,00000
33.0,86.0,85.0,957,07,01,  Dewaner Chala,334,439,174,217,160,222,43.2,44.5,41.9,00000
33.0,86.0,85.0,957,08,01,  Suti Para,748,633,395,300,353,333,54.2,56.8,51.5,00000
33.0,86.0,85.0,957,09,01,  Dambari Chala,1142,995,645,473,497,522,53.4,57.7,48.8,00000
56.0,10.0,17.0,032,01,01,  Puran Para,106,456,67,187,39,269,18.9,26.4,12.7,00000
56.0,10.0,17.0,032,02,01,  Sukurmiah Para,132,435,81,183,51,252,23.3,30.7,16.8,00000
56.0,10.0,17.0,032,03,01,  Sakimer Para,230,534,139,231,91,303,30.1,37.6,23.1,00000
56.0,10.0,17.0,032,04,01,  Kachari Para,301,906,183,362,118,544,24.9,33.6,17.8,00000
56.0,10.0,17.0,032,05,01,  Hindu Para,0,8,0,4,0,4,0.0,0.0,0.0,00000
56.0,10.0,17.0,032,06,01,  Hazi Para,146,637,96,286,50,351,18.6,25.1,12.5,00000
56.0,10.0,17.0,032,07,01,  Purba Para,236,903,149,399,87,504,20.7,27.2,14.7,00000
56.0,10.0,17.0,032,08,01,  Chuadanga,116,378,76,160,40,218,23.5,32.2,15.5,00000
56.0,10.0,17.0,244,01,01,  Char Bharenga Uttar,125,1680,84,785,41,895,6.9,9.7,4.4,00000
56.0,10.0,17.0,244,02,01,  Charbharenga Moho,243,1201,160,481,83,720,16.8,25.0,10.3,00000
56.0,10.0,17.0,244,03,01,  Char Barenga Dhaskin,75,590,47,251,28,339,11.3,15.8,7.6,00000
56.0,10.0,19.0,260,01,01,  Purba Para,96,273,49,112,47,161,26.0,30.4,22.6,00000
56.0,10.0,19.0,260,02,01,  Bepari Para,118,320,76,134,42,186,26.9,36.2,18.4,00000
56.0,10.0,19.0,772,01,01,  Baghdi Para,37,60,18,25,19,35,38.1,41.9,35.2,00000
56.0,10.0,19.0,772,02,01,  Mondalpara,56,150,41,72,15,78,27.2,36.3,16.1,00000
56.0,10.0,28.0,103,01,01,  Nilua,644,637,354,294,290,343,50.3,54.6,45.8,00000
56.0,10.0,28.0,103,02,01,  Mulkandi,369,456,195,206,174,250,44.7,48.6,41.0,00000
56.0,10.0,28.0,103,03,01,  Chandrakhola,109,242,70,97,39,145,31.1,41.9,21.2,00000
56.0,10.0,28.0,630,01,01,  Baniaghona,170,138,96,64,74,74,55.2,60.0,50.0,00000
56.0,10.0,28.0,630,02,01,  Mahmudpur,88,86,47,36,41,50,50.6,56.6,45.1,00000
56.0,10.0,28.0,788,01,03,  Ramchandrapur,1152,1538,659,667,493,871,42.8,49.7,36.1,00000
56.0,10.0,28.0,788,02,03,  Daulatpur,1936,1333,1007,565,929,768,59.2,64.1,54.7,00000
56.0,10.0,38.0,255,01,01,  Monir Molla Para,193,745,132,339,61,406,20.6,28.0,13.1,00000
56.0,10.0,38.0,255,02,01,  Rostom Molla Para,478,1144,318,552,160,592,29.5,36.6,21.3,00000
56.0,10.0,38.0,255,03,01,  Baser Molla  Para,401,861,232,376,169,485,31.8,38.2,25.8,00000
56.0,10.0,38.0,255,04,01,  Kamer Para,393,671,246,282,147,389,36.9,46.6,27.4,00000
56.0,10.0,38.0,255,05,01,  Laker Molla  Para,156,453,94,203,62,250,25.6,31.6,19.9,00000
56.0,10.0,38.0,255,06,01,  Karim Molla Para,388,1023,257,445,131,578,27.5,36.6,18.5,00000
56.0,10.0,38.0,255,07,01,  Riaz Fakri  Para,219,638,141,294,78,344,25.6,32.4,18.5,00000
56.0,10.0,38.0,255,08,01,  Ahedali Para,900,2462,548,1051,352,1411,26.8,34.3,20.0,00000
56.0,10.0,57.0,173,01,01,  Bir Kakali,117,127,70,51,47,76,48.0,57.9,38.2,00000
56.0,10.0,57.0,173,02,01,  Saliabari,85,146,51,68,34,78,36.8,42.9,30.4,00000
56.0,10.0,57.0,326,01,01,  Dhamsar,693,1430,392,636,301,794,32.6,38.1,27.5,00000
56.0,10.0,57.0,326,02,01,  Mithun,56,109,32,52,24,57,33.9,38.1,29.6,00000
56.0,10.0,76.0,070,01,01,  Baora,473,925,260,407,213,518,33.8,39.0,29.1,00000
56.0,10.0,76.0,070,02,01,  Kuragasa,17,33,8,16,9,17,34.0,33.3,34.6,00000
56.0,10.0,76.0,070,03,01,  Barabila,18,8,9,3,9,5,69.2,75.0,64.3,00000
56.0,10.0,76.0,413,01,01,  Jagtala,223,225,98,100,125,125,49.8,49.5,50.0,00000
56.0,10.0,76.0,413,02,01,  Bakuail,236,485,120,211,116,274,32.7,36.3,29.7,00000
56.0,10.0,76.0,929,01,01,  Taluknagar,1150,1131,603,461,547,670,50.4,56.7,44.9,00000
56.0,10.0,76.0,929,02,01,  Garjana,135,227,72,99,63,128,37.3,42.1,33.0,00000
56.0,10.0,76.0,935,01,01,  Tepri,563,391,296,150,267,241,59.0,66.4,52.6,00000
56.0,10.0,76.0,935,02,01,  Ghona Tepri,119,125,75,48,44,77,48.8,61.0,36.4,00000
56.0,10.0,76.0,935,03,01,  Kanda Tepri,48,43,26,18,22,25,52.7,59.1,46.8,00000
56.0,10.0,76.0,951,01,01,  Ulail,369,361,196,158,173,203,50.5,55.4,46.0,00000
56.0,10.0,76.0,951,02,01,  Dakshin Ulail,87,40,48,19,39,21,68.5,71.6,65.0,00000
56.0,10.0,85.0,560,01,01,  Khalshi Bashupara,355,402,190,169,165,233,46.9,52.9,41.5,00000
56.0,10.0,85.0,560,02,01,  Khalshi Bara Jola,180,439,95,189,85,250,29.1,33.5,25.4,00000
56.0,10.0,85.0,560,03,01,  Khalshi Beldaha,56,111,36,49,20,62,33.5,42.4,24.4,00000
56.0,10.0,85.0,560,04,01,  Khalshi Dainbondar,78,245,42,108,36,137,24.1,28.0,20.8,00000
56.0,10.0,85.0,560,05,01,  Char Khalshi,80,157,41,72,39,85,33.8,36.3,31.5,00000
56.0,10.0,85.0,560,06,01,  Khalshi Daskhin Para,108,161,62,78,46,83,40.1,44.3,35.7,00000
56.0,10.0,85.0,560,07,01,  Khalshi Haldar Para,190,254,97,103,93,151,42.8,48.5,38.1,00000
56.0,10.0,85.0,560,08,01,  Khalshi Saym Baradia,45,96,23,47,22,49,31.9,32.9,31.0,00000
56.0,10.0,85.0,560,09,01,  Khalshi Tebaria,38,49,21,19,17,30,43.7,52.5,36.2,00000
56.0,10.0,85.0,560,10,01,  Khalshi Uttar Para,152,334,76,151,76,183,31.3,33.5,29.3,00000
56.0,22.0,11.0,088,01,01,  Baliakhora,719,630,388,271,331,359,53.3,58.9,48.0,00000
56.0,22.0,11.0,088,02,01,  Shodhghata,127,51,64,23,63,28,71.3,73.6,69.2,00000
56.0,22.0,11.0,170,01,01,  Joka,318,154,167,63,151,91,67.4,72.6,62.4,00000
56.0,22.0,11.0,170,02,01,  Mir Joka,132,77,60,40,72,37,63.2,60.0,66.1,00000
56.0,22.0,11.0,250,01,01,  Binora,119,112,63,43,56,69,51.5,59.4,44.8,00000
56.0,22.0,11.0,250,02,01,  Char Binora,326,224,181,93,145,131,59.3,66.1,52.5,00000
56.0,22.0,11.0,783,01,01,  Kusunda,602,347,309,144,293,203,63.4,68.2,59.1,00000
56.0,22.0,11.0,783,02,01,  Char Kasunda,488,554,243,240,245,314,46.8,50.3,43.8,00000
56.0,22.0,23.0,052,01,01,  Bahuja,134,193,78,79,56,114,41.0,49.7,32.9,00000
56.0,22.0,23.0,052,02,01,  Shailkura,308,219,174,87,134,132,58.4,66.7,50.4,00000
56.0,22.0,23.0,052,03,01,  Karcha Bada Bazar,70,64,30,27,40,37,52.2,52.6,51.9,00000
56.0,22.0,23.0,465,01,01,  Goaldangi,560,631,262,298,298,333,47.0,46.8,47.2,00000
56.0,22.0,23.0,465,02,01,  Karchabada,247,222,127,95,120,127,52.7,57.2,48.6,00000
56.0,22.0,23.0,735,01,01,  Tarail,422,29,203,10,219,19,93.6,95.3,92.0,00000
56.0,22.0,23.0,735,02,01,  Naya Char,564,539,295,258,269,281,51.1,53.3,48.9,00000
56.0,22.0,23.0,918,01,01,  Radhanagar,176,179,87,76,89,103,49.6,53.4,46.4,00000
56.0,22.0,23.0,918,02,01,  Rathora,1140,642,590,296,550,346,64.0,66.6,61.4,00000
56.0,22.0,23.0,959,01,01,  Mirzapur,393,460,187,214,206,246,46.1,46.6,45.6,00000
56.0,22.0,23.0,959,02,01,  Tara,3041,1235,1500,492,1541,743,71.1,75.3,67.5,00000
56.0,22.0,23.0,959,03,01,  Uttar Tara,577,448,301,181,276,267,56.3,62.4,50.8,00000
56.0,22.0,35.0,176,01,01,  Baratia,633,527,303,225,330,302,54.6,57.4,52.2,00000
56.0,22.0,35.0,176,02,01,  Par Baratia,173,214,95,101,78,113,44.7,48.5,40.8,00000
56.0,22.0,35.0,176,03,01,  Naya Char,123,116,61,57,62,59,51.5,51.7,51.2,00000
56.0,22.0,35.0,547,01,01,  Karjana,695,745,350,351,345,394,48.3,49.9,46.7,00000
56.0,22.0,35.0,547,02,01,  Par Karjana,245,467,136,209,109,258,34.4,39.4,29.7,00000
56.0,22.0,35.0,889,01,01,  Rahathati,85,169,38,80,47,89,33.5,32.2,34.6,00000
56.0,22.0,35.0,889,02,01,  Bahulakul,158,130,91,55,67,75,54.9,62.3,47.2,00000
56.0,22.0,35.0,889,03,01,  Negirkandi,257,361,135,163,122,198,41.6,45.3,38.1,00000
56.0,22.0,47.0,459,01,03,  Ghior,3203,1237,1721,496,1482,741,72.1,77.6,66.7,00000
56.0,22.0,47.0,459,02,03,  Char Ghior,271,219,137,105,134,114,55.3,56.6,54.0,00000
56.0,22.0,47.0,459,03,03,  Char Mailaghi,236,171,121,82,115,89,58.0,59.6,56.4,00000
56.0,22.0,47.0,647,01,01,  Kusta,1787,881,899,414,888,467,67.0,68.5,65.5,00000
56.0,22.0,47.0,647,02,01,  Kusta Bandar,582,269,299,123,283,146,68.4,70.9,66.0,00000
56.0,22.0,59.0,441,01,01,  Gachhkalta,386,395,193,186,193,209,49.4,50.9,48.0,00000
56.0,22.0,59.0,441,02,01,  Bathaimuri,104,33,42,15,62,18,75.9,73.7,77.5,00000
56.0,22.0,59.0,600,01,01,  Thatenga,52,21,30,9,22,12,71.2,76.9,64.7,00000
56.0,22.0,59.0,600,02,01,  Kallai,117,48,50,22,67,26,70.9,69.4,72.0,00000
56.0,22.0,59.0,677,01,01,  Nali,465,474,228,202,237,272,49.5,53.0,46.6,00000
56.0,22.0,59.0,677,02,01,  Tirthaghata,103,63,53,25,50,38,62.0,67.9,56.8,00000
56.0,22.0,59.0,759,01,01,  Obhajani,952,809,486,335,466,474,54.1,59.2,49.6,00000
56.0,22.0,59.0,759,02,01,  Bataimuri,269,75,138,23,131,52,78.2,85.7,71.6,00000
56.0,22.0,59.0,953,01,01,  Shyamnagar,469,248,237,109,232,139,65.4,68.5,62.5,00000
56.0,22.0,59.0,953,02,01,  Terokona,137,141,69,63,68,78,49.3,52.3,46.6,00000
56.0,22.0,59.0,953,03,01,  Bataimuri,575,203,294,69,281,134,73.9,81.0,67.7,00000
56.0,22.0,71.0,147,01,01,  Bara Kushtia,353,371,177,160,176,211,48.8,52.5,45.5,00000
56.0,22.0,71.0,147,02,01,  Kanda Kushtia,195,258,112,105,83,153,43.0,51.6,35.2,00000
56.0,22.0,71.0,300,01,01,  Sailkai,197,130,119,52,78,78,60.2,69.6,50.0,00000
56.0,22.0,71.0,300,02,01,  Payl Purbapara,201,94,109,32,92,62,68.1,77.3,59.7,00000
56.0,22.0,71.0,300,03,01,  Bailjuri,650,903,344,406,306,497,41.9,45.9,38.1,00000
56.0,22.0,71.0,300,04,01,  Sidunagar,216,234,109,110,107,124,48.0,49.8,46.3,00000
56.0,22.0,71.0,300,05,01,  Bailjure (Char),381,396,201,178,180,218,49.0,53.0,45.2,00000
56.0,22.0,71.0,300,06,01,  Sreedharnagar,231,334,121,148,110,186,40.9,45.0,37.2,00000
56.0,22.0,71.0,300,07,01,  Sreedharganj,153,281,102,122,51,159,35.3,45.5,24.3,00000
56.0,22.0,83.0,029,01,01,  Ashapur,339,587,185,260,154,327,36.6,41.6,32.0,00000
56.0,22.0,83.0,029,02,01,  Baliabandha,436,592,239,276,197,316,42.4,46.4,38.4,00000
56.0,22.0,83.0,264,01,01,  Bir Sinjuri,994,983,521,447,473,536,50.3,53.8,46.9,00000
56.0,22.0,83.0,264,02,01,  Sualp Sinjuri,151,115,91,54,60,61,56.8,62.8,49.6,00000
56.0,28.0,14.0,214,01,01,  Byasdi,190,249,97,126,93,123,43.3,43.5,43.1,00000
56.0,28.0,14.0,214,02,01,  Jhikatala,116,84,66,41,50,43,58.0,61.7,53.8,00000
56.0,28.0,14.0,452,01,01,  Jagatber,296,346,139,168,157,178,46.1,45.3,46.9,00000
56.0,28.0,14.0,452,02,01,  Alinagar,129,233,63,108,66,125,35.6,36.8,34.6,00000
56.0,28.0,14.0,466,01,01,  Thakur Para,192,334,107,174,85,160,36.5,38.1,34.7,00000
56.0,28.0,14.0,466,02,01,  Poddar Para,361,446,181,207,180,239,44.7,46.6,43.0,00000
56.0,28.0,14.0,466,03,01,  Bepari Para,196,82,94,30,102,52,70.5,75.8,66.2,00000
56.0,28.0,14.0,466,04,01,  Talahata (Kalahata),251,266,124,109,127,157,48.5,53.2,44.7,00000
56.0,28.0,14.0,466,05,01,  Dafadar Para,507,72,253,29,254,43,87.6,89.7,85.5,00000
56.0,28.0,14.0,466,06,01,  Natun Para,357,115,168,49,189,66,75.6,77.4,74.1,00000
56.0,28.0,14.0,466,07,01,  Sikdar Para,226,262,110,127,116,135,46.3,46.4,46.2,00000
56.0,28.0,14.0,466,08,01,  Madhya Para,352,390,180,174,172,216,47.4,50.8,44.3,00000
56.0,28.0,14.0,466,09,01,  Sardar Para,134,183,64,90,70,93,42.3,41.6,42.9,00000
56.0,28.0,14.0,466,10,01,  Ujan Para,183,201,95,93,88,108,47.7,50.5,44.9,00000
56.0,28.0,21.0,590,01,01,  Kukurhati,859,619,380,267,479,352,58.1,58.7,57.6,00000
56.0,28.0,21.0,590,02,01,  Maheshkhali,93,57,51,19,42,38,62.0,72.9,52.5,00000
56.0,28.0,21.0,590,03,01,  Koucha,95,73,39,28,56,45,56.5,58.2,55.4,00000
56.0,28.0,21.0,590,04,01,  Barai Char,398,367,203,162,195,205,52.0,55.6,48.8,00000
56.0,28.0,21.0,590,05,01,  Neogir Tek,26,27,10,12,16,15,49.1,45.5,51.6,00000
56.0,28.0,21.0,799,01,01,  Pipulia,788,388,338,166,450,222,67.0,67.1,67.0,00000
56.0,28.0,21.0,799,02,01,  Adasure,85,54,40,22,45,32,61.2,64.5,58.4,00000
56.0,28.0,21.0,799,03,01,  Sonargram,237,249,105,116,132,133,48.8,47.5,49.8,00000
56.0,28.0,29.0,038,01,01,  Andhar Manik,2520,1156,1210,476,1310,680,68.6,71.8,65.8,00000
56.0,28.0,29.0,038,02,01,  Darikandi,497,546,207,228,290,318,47.7,47.6,47.7,00000
56.0,28.0,29.0,090,01,03,  Daskandi Boyra,565,323,314,138,251,185,63.6,69.5,57.6,00000
56.0,28.0,29.0,090,02,03,  Karmakarkandi Boyra,368,140,163,58,205,82,72.4,73.8,71.4,00000
56.0,28.0,29.0,090,03,03,  Khalpar Boyra,276,139,167,55,109,84,66.5,75.2,56.5,00000
56.0,28.0,29.0,090,04,03,  Char Boyra,72,111,42,59,30,52,39.3,41.6,36.6,00000
56.0,28.0,36.0,009,01,01,  Agrail,205,173,82,79,123,94,54.2,50.9,56.7,00000
56.0,28.0,36.0,009,02,01,  Darikandi,51,109,21,51,30,58,31.9,29.2,34.1,00000
56.0,28.0,36.0,299,01,01,  Diabari,476,610,237,256,239,354,43.8,48.1,40.3,00000
56.0,28.0,36.0,299,02,01,  Diapar,485,437,212,195,273,242,52.6,52.1,53.0,00000
56.0,28.0,36.0,599,01,01,  Kundura,208,342,108,163,100,179,37.8,39.9,35.8,00000
56.0,28.0,36.0,599,02,01,  Pirardangi,59,51,25,27,34,24,53.6,48.1,58.6,00000
56.0,28.0,36.0,723,01,01,  Narikati,193,94,93,50,100,44,67.2,65.0,69.4,00000
56.0,28.0,36.0,723,02,01,  Taraadona,102,52,62,15,40,37,66.2,80.5,51.9,00000
56.0,28.0,36.0,985,01,01,  Uttar Chandpur,266,355,134,162,132,193,42.8,45.3,40.6,00000
56.0,28.0,36.0,985,02,01,  Pacharkanda,77,86,31,42,46,44,47.2,42.5,51.1,00000
56.0,28.0,43.0,014,01,01,  Mathurajpur,78,86,40,46,38,40,47.6,46.5,48.7,00000
56.0,28.0,43.0,014,02,01,  Boali,72,42,30,19,42,23,63.2,61.2,64.6,00000
56.0,28.0,43.0,014,03,01,  Baburhat,254,266,114,120,140,146,48.8,48.7,49.0,00000
56.0,28.0,43.0,044,01,01,  Kamlapur,153,139,79,58,74,81,52.4,57.7,47.7,00000
56.0,28.0,43.0,044,02,01,  Abidhara,344,223,162,95,182,128,60.7,63.0,58.7,00000
56.0,28.0,43.0,333,01,01,  Gangarampur,482,465,169,219,313,246,50.9,43.6,56.0,00000
56.0,28.0,43.0,333,02,01,  Narayanpur,31,36,14,12,17,24,46.3,53.8,41.5,00000
56.0,28.0,43.0,333,03,01,  Shyampur,102,114,50,47,52,67,47.2,51.5,43.7,00000
56.0,28.0,51.0,166,01,01,  Hat Basudebpur,268,240,131,119,137,121,52.8,52.4,53.1,00000
56.0,28.0,51.0,166,02,01,  Kanda Lanka,272,136,125,65,147,71,66.7,65.8,67.4,00000
56.0,28.0,51.0,290,01,01,  Dasbaria,33,30,20,15,13,15,52.4,57.1,46.4,00000
56.0,28.0,51.0,290,02,01,  Parkhola,38,45,20,21,18,24,45.8,48.8,42.9,00000
56.0,28.0,51.0,290,03,01,  Bijoynagar,569,492,298,187,271,305,53.6,61.4,47.0,00000
56.0,28.0,51.0,290,04,01,  Nayakandi,99,69,56,28,43,41,58.9,66.7,51.2,00000
56.0,28.0,51.0,290,05,01,  Shakini,243,137,113,65,130,72,63.9,63.5,64.4,00000
56.0,28.0,51.0,290,06,01,  Komargaria,66,47,30,21,36,26,58.4,58.8,58.1,00000
56.0,28.0,51.0,290,07,01,  Rajarkulta,265,523,142,250,123,273,33.6,36.2,31.1,00000
56.0,28.0,51.0,314,01,01,  Dusuria Puran,205,145,103,68,102,77,58.6,60.2,57.0,00000
56.0,28.0,51.0,314,02,01,  Madhya (Dusuria),258,199,134,81,124,118,56.5,62.3,51.2,00000
56.0,28.0,51.0,314,03,01,  Gang Dusuria,206,278,111,129,95,149,42.6,46.3,38.9,00000
56.0,28.0,51.0,323,01,01,  Soyanigala,238,169,120,75,118,94,58.5,61.5,55.7,00000
56.0,28.0,51.0,323,02,01,  Gala,270,477,121,230,149,247,36.1,34.5,37.6,00000
56.0,28.0,51.0,504,01,01,  Kalika Almadi,120,132,62,57,58,75,47.6,52.1,43.6,00000
56.0,28.0,51.0,504,02,01,  Gopalpur,174,130,93,51,81,79,57.2,64.6,50.6,00000
56.0,28.0,51.0,504,03,01,  Sunpur,254,96,124,31,130,65,72.6,80.0,66.7,00000
56.0,28.0,51.0,504,04,01,  Goalbagh,123,69,60,29,63,40,64.1,67.4,61.2,00000
56.0,28.0,51.0,504,05,01,  Sonakandar,347,237,156,112,191,125,59.4,58.2,60.4,00000
56.0,28.0,51.0,504,06,01,  Kalai,765,822,411,363,354,459,48.2,53.1,43.5,00000
56.0,28.0,51.0,504,07,01,  Basudebpur,621,225,312,91,309,134,73.4,77.4,69.8,00000
56.0,28.0,51.0,504,08,01,  Hoglakandi,96,51,36,12,60,39,65.3,75.0,60.6,00000
56.0,28.0,51.0,504,09,01,  Kadamtala,57,146,27,74,30,72,28.1,26.7,29.4,00000
56.0,28.0,58.0,061,01,01,  Bara Bahadurpur,39,226,15,105,24,121,14.7,12.5,16.6,00000
56.0,28.0,58.0,061,02,01,  Chhota Bahadurpur,120,360,57,157,63,203,25.0,26.6,23.7,00000
56.0,28.0,58.0,980,01,01,  Ujan Para,312,423,154,189,158,234,42.4,44.9,40.3,00000
56.0,28.0,58.0,980,02,01,  Uttarpara,765,781,387,366,378,415,49.5,51.4,47.7,00000
56.0,28.0,58.0,980,03,01,  Kumar Para,234,222,126,90,108,132,51.3,58.3,45.0,00000
56.0,28.0,58.0,980,04,01,  Majam Para,449,453,237,196,212,257,49.8,54.7,45.2,00000
56.0,28.0,58.0,980,05,01,  Madhyapara,583,454,297,203,286,251,56.2,59.4,53.3,00000
56.0,28.0,58.0,980,06,01,  Bhati Para,664,574,342,261,322,313,53.6,56.7,50.7,00000
56.0,28.0,58.0,980,07,01,  Char Para,1063,693,530,309,533,384,60.5,63.2,58.1,00000
56.0,28.0,58.0,980,08,01,  Kapali Para,263,202,139,84,124,118,56.6,62.3,51.2,00000
56.0,28.0,58.0,980,09,01,  Dighir Char,568,1052,266,459,302,593,35.1,36.7,33.7,00000
56.0,28.0,65.0,266,01,01,  Bhelabad,786,475,345,177,441,298,62.3,66.1,59.7,00000
56.0,28.0,65.0,266,02,01,  Dakshin Chandpur,100,146,41,70,59,76,40.7,36.9,43.7,00000
56.0,28.0,65.0,371,01,01,  Jalsha,11,98,6,51,5,47,10.1,10.5,9.6,00000
56.0,28.0,65.0,371,02,01,  Kashiakhali,11,12,4,6,7,6,47.8,40.0,53.8,00000
56.0,28.0,65.0,404,01,01,  Harukandi,26,18,15,13,11,5,59.1,53.6,68.8,00000
56.0,28.0,65.0,404,02,01,  Madhu Malir Tek,15,22,10,10,5,12,40.5,50.0,29.4,00000
56.0,28.0,65.0,404,03,01,  Kazir Tek,27,49,18,26,9,23,35.5,40.9,28.1,00000
56.0,28.0,65.0,404,04,01,  Kazir Bag,46,36,31,17,15,19,56.1,64.6,44.1,00000
56.0,28.0,65.0,404,06,01,  Narayan Kandi,45,53,21,26,24,27,45.9,44.7,47.1,00000
56.0,28.0,65.0,685,01,01,  Mikzanagar,114,167,53,85,61,82,40.6,38.4,42.7,00000
56.0,28.0,65.0,685,02,01,  Faiznagar,35,69,17,37,18,32,33.7,31.5,36.0,00000
56.0,28.0,73.0,347,01,01,  Maluchi,369,506,199,214,170,292,42.2,48.2,36.8,00000
56.0,28.0,73.0,347,02,01,  Kushiar Char,442,636,250,281,192,355,41.0,47.1,35.1,00000
56.0,28.0,73.0,347,03,01,  Kutirhat,302,505,137,251,165,254,37.4,35.3,39.4,00000
56.0,28.0,73.0,347,04,01,  Kotkandi,398,752,197,324,201,428,34.6,37.8,32.0,00000
56.0,28.0,73.0,347,05,01,  Kumarkandi,2,21,2,9,0,12,8.7,18.2,0.0,00000
56.0,28.0,73.0,347,06,01,  Sudrakandi,36,69,19,32,17,37,34.3,37.3,31.5,00000
56.0,28.0,73.0,347,07,01,  Baidakandi,35,67,19,32,16,35,34.3,37.3,31.4,00000
56.0,28.0,73.0,347,08,01,  Mohammadpur,30,39,12,19,18,20,43.5,38.7,47.4,00000
56.0,28.0,80.0,618,02,01,  Kharia,61,222,29,102,32,120,21.6,22.1,21.1,00000
56.0,28.0,87.0,852,01,01,  Ishakhabad,387,595,158,249,229,346,39.4,38.8,39.8,00000
56.0,28.0,87.0,852,02,01,  Uttar Ujankandi,199,82,105,31,94,51,70.8,77.2,64.8,00000
56.0,28.0,87.0,852,03,01,  Dakshin Ujankandi,252,425,116,183,136,242,37.2,38.8,36.0,00000
56.0,28.0,87.0,852,04,01,  Jagannathpur,68,73,28,35,40,38,48.2,44.4,51.3,00000
56.0,28.0,87.0,852,05,01,  Bakchar,140,143,53,61,87,82,49.5,46.5,51.5,00000
56.0,28.0,87.0,852,06,01,  Algir Char,80,185,29,83,51,102,30.2,25.9,33.3,00000
56.0,28.0,87.0,852,07,01,  Natun Bourdangi,85,75,45,24,40,51,53.1,65.2,44.0,00000
56.0,28.0,87.0,852,08,01,  Natunkandi,105,241,46,122,59,119,30.3,27.4,33.1,00000
56.0,28.0,94.0,956,01,01,  Sutalari,40,92,19,37,21,55,30.3,33.9,27.6,00000
56.0,28.0,94.0,956,02,01,  Brahmankanda,18,25,11,14,7,11,41.9,44.0,38.9,00000
56.0,28.0,94.0,956,03,01,  Kodalia,51,53,33,18,18,35,49.0,64.7,34.0,00000
56.0,28.0,94.0,956,04,01,  Mowlakanda,7,18,3,7,4,11,28.0,30.0,26.7,00000
56.0,46.0,13.0,680,01,01,  Purba Basai,12,48,7,17,5,31,20.0,29.2,13.9,00000
56.0,46.0,13.0,680,02,01,  Pora Para,18,81,4,44,14,37,18.2,8.3,27.5,00000
56.0,46.0,13.0,680,03,01,  Bhader Taluk,60,30,33,11,27,19,66.7,75.0,58.7,00000
56.0,46.0,13.0,680,04,01,  Mirzapur,241,240,111,102,130,138,50.1,52.1,48.5,00000
56.0,46.0,13.0,680,05,01,  Madanpur,28,38,14,15,14,23,42.4,48.3,37.8,00000
56.0,46.0,13.0,715,01,01,  Narikuli,69,69,32,35,37,34,50.0,47.8,52.1,00000
56.0,46.0,13.0,715,02,01,  Kasnarikuli,312,421,163,202,149,219,42.6,44.7,40.5,00000
56.0,46.0,13.0,715,03,01,  Sarkar Para,49,21,19,5,30,16,70.0,79.2,65.2,00000
56.0,46.0,13.0,918,01,01,  Taraf Atigram,596,541,304,237,292,304,52.4,56.2,49.0,00000
56.0,46.0,13.0,918,02,01,  Char Berati,246,670,124,312,122,358,26.9,28.4,25.4,00000
56.0,46.0,13.0,918,03,01,  Kuti,125,132,58,55,67,77,48.6,51.3,46.5,00000
56.0,46.0,13.0,918,04,01,  Chandradibpur,95,7,74,2,21,5,93.1,97.4,80.8,00000
56.0,46.0,13.0,918,05,01,  Kosabanga,261,369,134,161,127,208,41.4,45.4,37.9,00000
56.0,46.0,13.0,918,06,01,  Basai,81,188,42,94,39,94,30.1,30.9,29.3,00000
56.0,46.0,13.0,918,07,01,  Anantapur,30,200,15,99,15,101,13.0,13.2,12.9,00000
56.0,46.0,15.0,033,01,01,  Baghia,1139,598,572,266,567,332,65.6,68.3,63.1,00000
56.0,46.0,15.0,033,02,01,  Dhania (Dhalla),156,152,75,67,81,85,50.6,52.8,48.8,00000
56.0,46.0,15.0,105,01,01,  Bara Bijuri,57,20,31,7,26,13,74.0,81.6,66.7,00000
56.0,46.0,15.0,105,02,01,  Beutha Bijuri,359,219,167,91,192,128,62.1,64.7,60.0,00000
56.0,46.0,15.0,105,03,01,  Puraba Shanbanda,760,387,330,153,430,234,66.3,68.3,64.8,00000
56.0,46.0,15.0,105,04,01,  Paschim Shanbanda,744,628,380,274,364,354,54.2,58.1,50.7,00000
56.0,46.0,15.0,105,05,01,  Balirtek Hat,213,131,114,61,99,70,61.9,65.1,58.6,00000
56.0,46.0,15.0,105,06,01,  Balirtek,176,147,81,53,95,94,54.5,60.4,50.3,00000
56.0,46.0,15.0,146,01,01,  Baruna,297,296,158,126,139,170,50.1,55.6,45.0,00000
56.0,46.0,15.0,146,02,01,  Joynagar,72,49,42,15,30,34,59.5,73.7,46.9,00000
56.0,46.0,15.0,146,03,01,  Krishnanagar,4,9,3,5,1,4,30.8,37.5,20.0,00000
56.0,46.0,15.0,188,01,01,  Bhararia,1357,1011,592,419,765,592,57.3,58.6,56.4,00000
56.0,46.0,15.0,188,02,01,  Satani,471,477,223,222,248,255,49.7,50.1,49.3,00000
56.0,46.0,15.0,350,01,01,  Dakshin Chailla,145,134,69,60,76,74,52.0,53.5,50.7,00000
56.0,46.0,15.0,350,02,01,  Par Chailla,274,287,117,139,157,148,48.8,45.7,51.5,00000
56.0,46.0,15.0,365,01,01,  Dakshin Krishnapur,296,352,158,158,138,194,45.7,50.0,41.6,00000
56.0,46.0,15.0,365,02,01,  Paschim Shanbandha,37,47,18,23,19,24,44.0,43.9,44.2,00000
56.0,46.0,15.0,456,01,01,  Gangarampur,170,119,85,54,85,65,58.8,61.2,56.7,00000
56.0,46.0,15.0,456,02,01,  Bhangabaria,447,439,181,201,266,238,50.5,47.4,52.8,00000
56.0,46.0,15.0,976,01,01,  Uttar Chailla,142,114,69,52,73,62,55.5,57.0,54.1,00000
56.0,46.0,15.0,976,02,01,  Baitkara,187,96,88,40,99,56,66.1,68.8,63.9,00000
56.0,46.0,23.0,103,01,01,  Ramanpur,437,124,218,48,219,76,77.9,82.0,74.2,00000
56.0,46.0,23.0,103,02,01,  Koyra,302,222,151,94,151,128,57.6,61.6,54.1,00000
56.0,46.0,23.0,103,03,01,  Rawdaha,667,401,354,156,313,245,62.5,69.4,56.1,00000
56.0,46.0,23.0,103,04,01,  Dautia,724,521,364,213,360,308,58.2,63.1,53.9,00000
56.0,46.0,23.0,103,05,01,  Paschim Kagzinagar,106,76,52,37,54,39,58.2,58.4,58.1,00000
56.0,46.0,23.0,437,01,01,  Dighi,763,678,382,298,381,380,52.9,56.2,50.1,00000
56.0,46.0,23.0,437,02,01,  Chandura,222,184,110,88,112,96,54.7,55.6,53.8,00000
56.0,46.0,23.0,437,03,01,  Nutan Basti,261,53,133,25,128,28,83.1,84.2,82.1,00000
56.0,46.0,23.0,437,04,01,  Chandnagar,183,91,86,45,97,46,66.8,65.6,67.8,00000
56.0,46.0,23.0,629,01,01,  Lauta,177,150,100,68,77,82,54.1,59.5,48.4,00000
56.0,46.0,23.0,629,02,01,  Kotai,374,330,194,150,180,180,53.1,56.4,50.0,00000
56.0,46.0,31.0,244,01,01,  Chandar,1314,951,659,425,655,526,58.0,60.8,55.5,00000
56.0,46.0,31.0,244,02,01,  Gangulinagar,125,15,61,5,64,10,89.3,92.4,86.5,00000
56.0,46.0,31.0,750,01,01,  Panjamkhara,1635,952,782,404,853,548,63.2,65.9,60.9,00000
56.0,46.0,31.0,750,02,01,  Sadinagar,340,98,167,38,173,60,77.6,81.5,74.2,00000
56.0,46.0,39.0,082,01,01,  Bankhuri,917,583,391,265,526,318,61.1,59.6,62.3,00000
56.0,46.0,39.0,082,02,01,  Chaukighata,572,385,256,166,316,219,59.8,60.7,59.1,00000
56.0,46.0,39.0,082,03,01,  Gopalkhali,642,497,271,218,371,279,56.4,55.4,57.1,00000
56.0,46.0,39.0,505,01,01,  Durlabhdi,1100,801,477,333,623,468,57.9,58.9,57.1,00000
56.0,46.0,39.0,505,02,01,  Hatipara,872,1137,370,482,502,655,43.4,43.4,43.4,00000
56.0,46.0,39.0,505,03,01,  Kazikhola,279,283,132,123,147,160,49.6,51.8,47.9,00000
56.0,46.0,39.0,505,04,01,  Pawnan,355,537,163,248,192,289,39.8,39.7,39.9,00000
56.0,46.0,39.0,505,05,01,  Badhuti,244,170,112,73,132,97,58.9,60.5,57.6,00000
56.0,46.0,39.0,942,01,01,  Swalpa Nandapur,263,240,124,96,139,144,52.3,56.4,49.1,00000
56.0,46.0,39.0,942,02,01,  Golai,40,46,20,19,20,27,46.5,51.3,42.6,00000
56.0,46.0,71.0,124,01,01,  Madhyapara,545,695,290,319,255,376,44.0,47.6,40.4,00000
56.0,46.0,71.0,124,02,01,  Chhota Barahi,641,843,331,393,310,450,43.2,45.7,40.8,00000
56.0,46.0,71.0,124,03,01,  Jannakandi,820,1229,406,582,414,647,40.0,41.1,39.0,00000
56.0,46.0,71.0,124,04,01,  Hurar Char,64,192,23,100,41,92,25.0,18.7,30.8,00000
56.0,46.0,71.0,150,01,01,  Uttarpara,194,222,100,102,94,120,46.6,49.5,43.9,00000
56.0,46.0,71.0,150,02,01,  Dakshinpara,671,532,362,236,309,296,55.8,60.5,51.1,00000
56.0,46.0,71.0,493,01,01,  Paschimpara,142,273,73,134,69,139,34.2,35.3,33.2,00000
56.0,46.0,71.0,493,02,01,  Purbapara,210,442,114,195,96,247,32.2,36.9,28.0,00000
56.0,46.0,71.0,618,01,01,  Krishnapur(Uttarpara),620,820,320,378,300,442,43.1,45.8,40.4,00000
56.0,46.0,71.0,618,02,01,  Madhya Para,440,458,242,215,198,243,49.0,53.0,44.9,00000
56.0,46.0,71.0,618,03,01,  Kachari Kandi,309,441,163,202,146,239,41.2,44.7,37.9,00000
56.0,46.0,71.0,618,04,01,  Char Krishnapur,849,998,415,481,434,517,46.0,46.3,45.6,00000
56.0,46.0,71.0,659,01,01,  Makimpur,285,291,130,140,155,151,49.5,48.1,50.7,00000
56.0,46.0,71.0,659,02,01,  Uttar Makimpur,332,359,169,162,163,197,48.0,51.1,45.3,00000
56.0,46.0,71.0,659,03,01,  Paschim Makimpur,265,219,133,95,132,124,54.8,58.3,51.6,00000
56.0,46.0,71.0,659,04,01,  Purba Makimpur,390,410,197,203,193,207,48.8,49.3,48.3,00000
56.0,46.0,71.0,659,05,01,  Dakshin Makimpur,474,806,248,366,226,440,37.0,40.4,33.9,00000
56.0,46.0,71.0,659,06,01,  Gazipara,115,182,61,82,54,100,38.7,42.7,35.1,00000
56.0,46.0,87.0,094,01,01,  Bara Barail,234,162,128,65,106,97,59.1,66.3,52.2,00000
56.0,46.0,87.0,094,02,01,  Char Barail,397,377,179,169,218,208,51.3,51.4,51.2,00000
56.0,46.0,87.0,094,03,01,  Balia Bil,310,270,163,122,147,148,53.4,57.2,49.8,00000
56.0,46.0,87.0,471,01,01,  Gilanda,1990,805,1058,328,932,477,71.2,76.3,66.1,00000
56.0,46.0,87.0,471,02,01,  Sailakura,46,79,29,33,17,46,36.8,46.8,27.0,00000
56.0,46.0,87.0,719,01,01,  Nabagram,1017,1083,486,489,531,594,48.4,49.8,47.2,00000
56.0,46.0,87.0,719,02,01,  Nayakandi,235,181,109,78,126,103,56.5,58.3,55.0,00000
56.0,46.0,87.0,719,03,01,  Sarupai,366,268,167,99,199,169,57.7,62.8,54.1,00000
56.0,46.0,87.0,719,04,01,  Dhalai,551,401,307,153,244,248,57.9,66.7,49.6,00000
56.0,46.0,87.0,719,05,01,  Berir Char,184,77,80,35,104,42,70.5,69.6,71.2,00000
56.0,46.0,94.0,109,01,01,  Bara Ghosta,397,515,202,229,195,286,43.5,46.9,40.5,00000
56.0,46.0,94.0,109,02,01,  Kachary Nagar,440,358,229,138,211,220,55.1,62.4,49.0,00000
56.0,46.0,94.0,109,03,01,  Krsta Nagar,118,132,58,46,60,86,47.2,55.8,41.1,00000
56.0,46.0,94.0,109,04,01,  Baranagar,307,309,149,121,158,188,49.8,55.2,45.7,00000
56.0,46.0,94.0,109,05,01,  Jahangirnagar,393,397,186,176,207,221,49.7,51.4,48.4,00000
56.0,46.0,94.0,109,06,01,  Char Ghosta,209,145,112,46,97,99,59.0,70.9,49.5,00000
56.0,46.0,94.0,391,01,01,  Shimulia,196,164,101,62,95,102,54.4,62.0,48.2,00000
56.0,46.0,94.0,391,02,01,  Dakshin Shimulia,171,129,86,44,85,85,57.0,66.2,50.0,00000
56.0,46.0,94.0,670,01,01,  Manta,572,500,292,184,280,316,53.4,61.3,47.0,00000
56.0,46.0,94.0,670,02,01,  Begumnagar,48,26,27,9,21,17,64.9,75.0,55.3,00000
56.0,46.0,94.0,734,01,01,  Nulandi,186,114,94,52,92,62,62.0,64.4,59.7,00000
56.0,46.0,94.0,734,02,01,  Baliabil,249,219,120,99,129,120,53.2,54.8,51.8,00000
56.0,70.0,19.0,060,01,03,  Baliati,1457,637,773,255,684,382,69.6,75.2,64.2,00000
56.0,70.0,19.0,060,02,03,  Rashidpur,47,52,29,18,18,34,47.5,61.7,34.6,00000
56.0,70.0,19.0,060,03,03,  Char Para,62,205,30,101,32,104,23.2,22.9,23.5,00000
56.0,70.0,19.0,060,04,03,  Gopalnagar,226,320,121,143,105,177,41.4,45.8,37.2,00000
56.0,70.0,19.0,162,01,01,  Bhatara,427,581,233,289,194,292,42.4,44.6,39.9,00000
56.0,70.0,19.0,162,02,01,  Char Bhatara,138,519,69,260,69,259,21.0,21.0,21.0,00000
56.0,70.0,19.0,162,03,01,  Brajanagar,117,141,62,58,55,83,45.3,51.7,39.9,00000
56.0,70.0,19.0,162,04,01,  Munshir Char,104,98,55,44,49,54,51.5,55.6,47.6,00000
56.0,70.0,19.0,162,05,01,  Mathabhanga,36,64,19,31,17,33,36.0,38.0,34.0,00000
56.0,70.0,38.0,857,01,01,  Dakshinpara,264,438,136,196,128,242,37.6,41.0,34.6,00000
56.0,70.0,38.0,857,02,01,  Madhyapara,182,342,90,148,92,194,34.7,37.8,32.2,00000
56.0,70.0,38.0,857,03,01,  Uttarpara,492,684,260,293,232,391,41.8,47.0,37.2,00000
56.0,70.0,38.0,857,04,01,  Tebaria,508,780,262,330,246,450,39.4,44.3,35.3,00000
56.0,70.0,38.0,857,05,01,  Banbanda,362,99,188,37,174,62,78.5,83.6,73.7,00000
56.0,70.0,57.0,304,01,01,  Daspara,202,198,114,92,88,106,50.5,55.3,45.4,00000
56.0,70.0,57.0,304,02,01,  Dakshinkhali,38,57,19,28,19,29,40.0,40.4,39.6,00000
56.0,70.0,57.0,329,01,01,  Decree Naruttampur,108,113,67,46,41,67,48.9,59.3,38.0,00000
56.0,70.0,57.0,329,02,01,  Shaheb Para(P),76,84,44,33,32,51,47.5,57.1,38.6,00000
56.0,70.0,57.0,588,01,01,  Khali Dhankora,1133,439,591,199,542,240,72.1,74.8,69.3,00000
56.0,70.0,57.0,588,02,01,  Char Dhankora,248,187,123,88,125,99,57.0,58.3,55.8,00000
56.0,70.0,57.0,588,03,01,  Dewan Para,223,22,103,7,120,15,91.0,93.6,88.9,00000
56.0,70.0,57.0,588,04,01,  Naya Para,520,265,280,100,240,165,66.2,73.7,59.3,00000
56.0,70.0,57.0,588,05,01,  Tarabari,486,554,256,252,230,302,46.7,50.4,43.2,00000
56.0,70.0,57.0,588,06,01,  Farazi Para,174,253,84,115,90,138,40.7,42.2,39.5,00000
56.0,70.0,57.0,588,07,01,  Chainta,166,230,77,99,89,131,41.9,43.8,40.5,00000
56.0,70.0,57.0,588,08,01,  Goaria,347,405,188,191,159,214,46.1,49.6,42.6,00000
56.0,70.0,57.0,588,09,01,  Ruhuli,171,333,106,136,65,197,33.9,43.8,24.8,00000
56.0,70.0,57.0,731,01,01,  Paik Para,229,97,149,46,80,51,70.2,76.4,61.1,00000
56.0,70.0,57.0,731,02,01,  Nayadanga,617,378,354,175,263,203,62.0,66.9,56.4,00000
56.0,70.0,57.0,766,01,01,  Paschim Barundi Chak,162,148,81,65,81,83,52.3,55.5,49.4,00000
56.0,70.0,57.0,766,02,01,  Joykrishnapur,72,32,31,12,41,20,69.2,72.1,67.2,00000
56.0,70.0,57.0,969,01,01,  Muslim Para,202,87,108,37,94,50,69.9,74.5,65.3,00000
56.0,70.0,57.0,969,02,01,  Rishi Para,57,83,37,35,20,48,40.7,51.4,29.4,00000
56.0,70.0,57.0,969,03,01,  Datta Para,137,72,77,30,60,42,65.6,72.0,58.8,00000
56.0,70.0,66.0,010,01,01,  Airmara,226,192,124,76,102,116,54.1,62.0,46.8,00000
56.0,70.0,66.0,010,02,01,  Airmara Char,243,260,123,116,120,144,48.3,51.5,45.5,00000
56.0,70.0,66.0,152,01,01,  Uttarpara,296,356,159,155,137,201,45.4,50.6,40.5,00000
56.0,70.0,66.0,152,02,01,  Kanda Para,187,137,102,56,85,81,57.7,64.6,51.2,00000
56.0,70.0,66.0,228,01,01,  Majhi Para,407,504,216,212,191,292,44.7,50.5,39.5,00000
56.0,70.0,66.0,228,02,01,  Alinagar,299,459,159,213,140,246,39.4,42.7,36.3,00000
56.0,70.0,66.0,228,03,01,  Paschimpara,634,616,340,252,294,364,50.7,57.4,44.7,00000
56.0,70.0,66.0,228,04,01,  Purbapara,56,343,42,161,14,182,14.0,20.7,7.1,00000
56.0,70.0,66.0,411,01,01,  Kunaicha Para,205,203,110,98,95,105,50.2,52.9,47.5,00000
56.0,70.0,66.0,411,02,01,  Madhyapara,51,265,31,125,20,140,16.1,19.9,12.5,00000
56.0,70.0,66.0,411,03,01,  Purbapara,324,269,177,108,147,161,54.6,62.1,47.7,00000
56.0,70.0,66.0,411,04,01,  Khalashi Para,130,189,73,83,57,106,40.8,46.8,35.0,00000
56.0,70.0,66.0,482,01,01,  Uttarpara,513,651,260,304,253,347,44.1,46.1,42.2,00000
56.0,70.0,66.0,482,02,01,  Madhyapara,406,403,227,173,179,230,50.2,56.8,43.8,00000
56.0,70.0,66.0,482,03,01,  Dakshinpara,446,433,234,185,212,248,50.7,55.8,46.1,00000
56.0,70.0,66.0,482,04,01,  Paschimpara,155,476,79,233,76,243,24.6,25.3,23.8,00000
56.0,70.0,66.0,604,01,01,  Kanada Para,532,230,272,78,260,152,69.8,77.7,63.1,00000
56.0,70.0,66.0,604,02,01,  Shai Para,321,355,163,165,158,190,47.5,49.7,45.4,00000
56.0,70.0,76.0,431,01,01,  Balur Char,421,512,237,221,184,291,45.1,51.7,38.7,00000
56.0,70.0,76.0,431,02,01,  Bepari Para,77,32,35,13,42,19,70.6,72.9,68.9,00000
56.0,70.0,76.0,431,03,01,  Char Para,614,816,322,378,292,438,42.9,46.0,40.0,00000
56.0,70.0,76.0,431,04,01,  Hargaz Dakshin Para,258,404,138,183,120,221,39.0,43.0,35.2,00000
56.0,70.0,76.0,431,05,01,  Pachim Khalpara,234,172,116,87,118,85,57.6,57.1,58.1,00000
56.0,70.0,76.0,431,06,01,  Gosainagar,286,239,163,97,123,142,54.5,62.7,46.4,00000
56.0,70.0,76.0,431,07,01,  Naya Para,175,137,87,64,88,73,56.1,57.6,54.7,00000
56.0,70.0,76.0,431,08,01,  Khaser Char,149,137,73,72,76,65,52.1,50.3,53.9,00000
56.0,70.0,76.0,431,09,01,  Madhyakandi,536,505,278,221,258,284,51.5,55.7,47.6,00000
56.0,70.0,76.0,431,10,01,  Mollahkandi,168,134,85,69,83,65,55.6,55.2,56.1,00000
56.0,70.0,76.0,431,11,01,  Mridha Para,73,73,41,23,32,50,50.0,64.1,39.0,00000
56.0,70.0,76.0,431,12,01,  Nadir Uttarpara,501,567,240,245,261,322,46.9,49.5,44.8,00000
56.0,70.0,76.0,431,13,01,  Naya Para Mollakandi,570,389,277,152,293,237,59.4,64.6,55.3,00000
56.0,70.0,76.0,431,14,01,  Nilbhanagar Tek,93,107,54,41,39,66,46.5,56.8,37.1,00000
56.0,70.0,76.0,431,15,01,  Purba Khalpar,100,78,51,35,49,43,56.2,59.3,53.3,00000
56.0,70.0,76.0,431,16,01,  Purbanagar,474,524,248,234,226,290,47.5,51.5,43.8,00000
56.0,70.0,76.0,431,17,01,  Patnibandha,200,114,100,49,100,65,63.7,67.1,60.6,00000
56.0,70.0,76.0,431,18,01,  Shimulia,298,475,155,212,143,263,38.6,42.2,35.2,00000
56.0,70.0,76.0,431,19,01,  Sardar Para,154,152,77,63,77,89,50.3,55.0,46.4,00000
56.0,70.0,76.0,431,20,01,  Molla Kandi Dakshin Para,135,195,70,93,65,102,40.9,42.9,38.9,00000
56.0,70.0,85.0,076,01,01,  Banduri,196,110,114,41,82,69,64.1,73.5,54.3,00000
56.0,70.0,85.0,076,02,01,  Kamalpur(Part),46,73,22,28,24,45,38.7,44.0,34.8,00000
56.0,70.0,85.0,360,01,01,  Dhulla,638,442,330,203,308,239,59.1,61.9,56.3,00000
56.0,70.0,85.0,360,02,01,  Kamalpur,97,192,47,93,50,99,33.6,33.6,33.6,00000
56.0,70.0,85.0,553,01,03,  Uttar Kaonara,850,941,339,412,511,529,47.5,45.1,49.1,00000
56.0,70.0,85.0,553,02,03,  Saturia Bazar,811,119,440,41,371,78,87.2,91.5,82.6,00000
56.0,70.0,85.0,553,03,03,  Bhandari Para,503,325,268,137,235,188,60.7,66.2,55.6,00000
56.0,70.0,85.0,553,04,03,  Paschim Kaonara,400,333,239,134,161,199,54.6,64.1,44.7,00000
56.0,70.0,85.0,553,05,03,  Palpara,138,199,73,88,65,111,40.9,45.3,36.9,00000
56.0,70.0,85.0,659,01,01,  Makdum Para,40,56,23,25,17,31,41.7,47.9,35.4,00000
56.0,70.0,85.0,659,02,01,  Guchchhagram,25,124,14,60,11,64,16.8,18.9,14.7,00000
56.0,70.0,85.0,741,01,01,  Panaijuri,744,800,399,342,345,458,48.2,53.8,43.0,00000
56.0,70.0,85.0,741,02,01,  Khanirtake,96,95,55,48,41,47,50.3,53.4,46.6,00000
56.0,70.0,85.0,893,01,01,  Saturia Char,297,361,155,163,142,198,45.1,48.7,41.8,00000
56.0,70.0,85.0,893,02,01,  Mandal Para,417,84,232,37,185,47,83.2,86.2,79.7,00000
56.0,70.0,95.0,035,01,01,  Uttar Aynapur,583,998,294,429,289,569,36.9,40.7,33.7,00000
56.0,70.0,95.0,035,02,01,  Dakshin Aynapur,648,940,323,414,325,526,40.8,43.8,38.2,00000
56.0,70.0,95.0,035,03,01,  Kakali,39,53,23,25,16,28,42.4,47.9,36.4,00000
56.0,70.0,95.0,934,01,01,  Tilli,1386,2108,769,953,617,1155,39.7,44.7,34.8,00000
56.0,70.0,95.0,934,02,01,  Tilli Char,357,1216,189,549,168,667,22.7,25.6,20.1,00000
56.0,78.0,11.0,100,01,01,  Darikandi,377,256,194,115,183,141,59.6,62.8,56.5,00000
56.0,78.0,11.0,100,02,01,  Baruria,276,245,164,116,112,129,53.0,58.6,46.5,00000
56.0,78.0,11.0,100,03,01,  Lakshimpur,346,178,182,70,164,108,66.0,72.2,60.3,00000
56.0,78.0,11.0,100,04,01,  Nayakandi,391,259,202,95,189,164,60.2,68.0,53.5,00000
56.0,78.0,11.0,109,01,01,  Pur Baulikanda,112,25,54,9,58,16,81.8,85.7,78.4,00000
56.0,78.0,11.0,109,02,01,  Baulikanda,174,70,85,25,89,45,71.3,77.3,66.4,00000
56.0,78.0,11.0,109,03,01,  Purba Baulikanda,318,151,152,64,166,87,67.8,70.4,65.6,00000
56.0,78.0,11.0,109,04,01,  Paschim Baulikanda,138,81,65,42,73,39,63.0,60.7,65.2,00000
56.0,78.0,11.0,511,01,01,  Jagaddia,79,85,51,31,28,54,48.2,62.2,34.1,00000
56.0,78.0,11.0,511,02,01,  Debinagar,61,58,31,21,30,37,51.3,59.6,44.8,00000
56.0,78.0,11.0,607,01,01,  Kushtia,73,72,33,36,40,36,50.3,47.8,52.6,00000
56.0,78.0,11.0,607,02,01,  Madrakola,91,86,41,36,50,50,51.4,53.2,50.0,00000
56.0,78.0,23.0,091,01,01,  Barangail,542,340,316,158,226,182,61.5,66.7,55.4,00000
56.0,78.0,23.0,091,02,01,  Kalagharia,557,519,289,225,268,294,51.8,56.2,47.7,00000
56.0,78.0,23.0,091,03,01,  Naya Char,69,130,38,58,31,72,34.7,39.6,30.1,00000
56.0,78.0,23.0,091,04,01,  Uttar Barangail Banagram,79,170,42,80,37,90,31.7,34.4,29.1,00000
56.0,78.0,23.0,565,01,01,  Kauarbil,317,460,166,224,151,236,40.8,42.6,39.0,00000
56.0,78.0,23.0,565,02,01,  Dharikandi,27,48,13,25,14,23,36.0,34.2,37.8,00000
56.0,78.0,23.0,565,03,01,  Baher Char,91,151,48,70,43,81,37.6,40.7,34.7,00000
56.0,78.0,23.0,565,04,01,  Uttar Banagram,9,14,7,6,2,8,39.1,53.8,20.0,00000
56.0,78.0,23.0,661,01,01,  Bhakla,112,96,53,46,59,50,53.8,53.5,54.1,00000
56.0,78.0,23.0,661,02,01,  Juni (Kalsha),366,562,197,263,169,299,39.4,42.8,36.1,00000
56.0,78.0,23.0,661,03,01,  Maniknagar,278,136,144,53,134,83,67.1,73.1,61.8,00000
56.0,78.0,23.0,661,04,01,  Konabari,64,98,27,47,37,51,39.5,36.5,42.0,00000
56.0,78.0,23.0,661,05,01,  Raghunathpur,248,347,129,169,119,178,41.7,43.3,40.1,00000
56.0,78.0,23.0,675,01,01,  Mahadebpur,1891,1611,973,685,918,926,54.0,58.7,49.8,00000
56.0,78.0,23.0,675,02,01,  Singardak,40,73,20,36,20,37,35.4,35.7,35.1,00000
56.0,78.0,23.0,675,03,01,  Dubalia,501,454,247,207,254,247,52.5,54.4,50.7,00000
56.0,78.0,23.0,675,04,01,  Uttar Banagram,57,94,31,45,26,49,37.7,40.8,34.7,00000
56.0,78.0,23.0,675,05,01,  Barangail,311,352,174,163,137,189,46.9,51.6,42.0,00000
56.0,78.0,23.0,835,01,01,  Sahili (Purba),659,666,327,300,332,366,49.7,52.2,47.6,00000
56.0,78.0,23.0,835,02,01,  Sahili (Pachim),565,671,278,310,287,361,45.7,47.3,44.3,00000
56.0,78.0,35.0,178,01,01,  Butni,339,546,147,262,192,284,38.3,35.9,40.3,00000
56.0,78.0,35.0,178,02,01,  Kachhidhara,137,164,63,86,74,78,45.5,42.3,48.7,00000
56.0,78.0,35.0,178,03,01,  Bajpara,197,188,109,75,88,113,51.2,59.2,43.8,00000
56.0,78.0,35.0,178,04,01,  Baliata,98,72,49,35,49,37,57.6,58.3,57.0,00000
56.0,78.0,35.0,187,01,01,  Chalitabari,178,183,94,80,84,103,49.3,54.0,44.9,00000
56.0,78.0,35.0,187,02,01,  Dholakanda,102,166,52,78,50,88,38.1,40.0,36.2,00000
56.0,78.0,35.0,187,03,01,  Paragram,573,442,316,183,257,259,56.5,63.3,49.8,00000
56.0,78.0,35.0,397,01,01,  Purba Dhakijora,343,202,172,104,171,98,62.9,62.3,63.6,00000
56.0,78.0,35.0,397,02,01,  Paschim Dhakijora,633,637,333,298,300,339,49.8,52.8,46.9,00000
56.0,78.0,35.0,397,03,01,  Lakshmipur,308,555,158,267,150,288,35.7,37.2,34.2,00000
56.0,78.0,35.0,634,01,01,  Madhya Shimulia,75,225,43,115,32,110,25.0,27.2,22.5,00000
56.0,78.0,35.0,634,02,01,  Shimulia,17,44,8,24,9,20,27.9,25.0,31.0,00000
56.0,78.0,35.0,725,01,01,  Panchdhara,72,134,38,66,34,68,35.0,36.5,33.3,00000
56.0,78.0,35.0,725,02,01,  Khalisha,136,123,74,50,62,73,52.5,59.7,45.9,00000
56.0,78.0,35.0,725,03,01,  Khotadhara,134,168,73,87,61,81,44.4,45.6,43.0,00000
56.0,78.0,35.0,794,01,01,  Kanda Sakrail,153,184,71,87,82,97,45.4,44.9,45.8,00000
56.0,78.0,35.0,794,02,01,  Chhota Sakrail,334,243,191,104,143,139,57.9,64.7,50.7,00000
56.0,78.0,35.0,794,03,01,  Roypur,102,102,56,50,46,52,50.0,52.8,46.9,00000
56.0,78.0,35.0,839,01,01,  Sakrail,765,911,436,426,329,485,45.6,50.6,40.4,00000
56.0,78.0,35.0,839,02,01,  Diar Char Sakrail,674,551,356,267,318,284,55.0,57.1,52.8,00000
56.0,78.0,35.0,839,03,01,  Hat Sakrail,351,317,180,141,171,176,52.5,56.1,49.3,00000
56.0,78.0,35.0,839,04,01,  Puran Sakrail,135,268,75,133,60,135,33.5,36.1,30.8,00000
56.0,78.0,35.0,839,05,01,  Par Jamunabad,102,136,58,58,44,78,42.9,50.0,36.1,00000
56.0,78.0,35.0,839,06,01,  Jamunabad,331,503,165,231,166,272,39.7,41.7,37.9,00000
56.0,78.0,35.0,839,07,01,  Muktarnagar,5,11,2,5,3,6,31.3,28.6,33.3,00000
56.0,78.0,47.0,018,01,01,  Anaypur,1022,995,579,423,443,572,50.7,57.8,43.6,00000
56.0,78.0,47.0,018,02,01,  Dubliadanga,270,332,140,152,130,180,44.9,47.9,41.9,00000
56.0,78.0,47.0,018,03,01,  Hajirbadha,287,227,134,100,153,127,55.8,57.3,54.6,00000
56.0,78.0,47.0,073,01,01,  Goalkhali,584,656,316,307,268,349,47.1,50.7,43.4,00000
56.0,78.0,47.0,073,02,01,  Nabagram,562,540,311,255,251,285,51.0,54.9,46.8,00000
56.0,78.0,47.0,073,03,01,  Saidabad,79,56,38,33,41,23,58.5,53.5,64.1,00000
56.0,78.0,47.0,073,04,01,  Natun Faridpur,228,297,117,146,111,151,43.4,44.5,42.4,00000
56.0,78.0,47.0,228,01,01,  Jhariarbagh,246,262,129,120,117,142,48.4,51.8,45.2,00000
56.0,78.0,47.0,228,02,01,  Alachipur,271,155,151,63,120,92,63.6,70.6,56.6,00000
56.0,78.0,59.0,009,01,01,  Alokdia Dacter Baduri Para,345,575,205,236,140,339,37.5,46.5,29.2,00000
56.0,78.0,59.0,009,02,01,  Alokdia Sahimuddin Para,19,198,9,100,10,98,8.8,8.3,9.3,00000
56.0,78.0,59.0,009,03,01,  Alokdia Khada Bafsha Para,13,129,11,66,2,63,9.2,14.3,3.1,00000
56.0,78.0,59.0,009,04,01,  Alokdia Mangan Sk.Para,36,82,19,42,17,40,30.5,31.1,29.8,00000
56.0,78.0,59.0,009,05,01,  Alokdia Chanmia Para,79,229,47,95,32,134,25.6,33.1,19.3,00000
56.0,78.0,59.0,009,06,01,  Alokdia Batener Para,60,1014,31,528,29,486,5.6,5.5,5.6,00000
56.0,78.0,59.0,009,07,01,  Alokdia Joynal Para,70,263,42,115,28,148,21.0,26.8,15.9,00000
56.0,78.0,59.0,009,08,01,  Alokdia Motimember Para,30,156,18,88,12,68,16.1,17.0,15.0,00000
56.0,78.0,59.0,009,09,01,  Alokdia Altaf Sk Para,16,55,10,25,6,30,22.5,28.6,16.7,00000
56.0,78.0,59.0,009,10,01,  Alokdia Santosh Ali Para,75,300,48,133,27,167,20.0,26.5,13.9,00000
56.0,78.0,59.0,009,11,01,  Alokdia Esmael Madber Para,200,299,123,136,77,163,40.1,47.5,32.1,00000
56.0,78.0,59.0,009,12,01,  Alokdia Altaf Molal Para,167,514,99,237,68,277,24.5,29.5,19.7,00000
56.0,78.0,59.0,009,13,01,  Alokdia Gonir Para,145,206,82,107,63,99,41.3,43.4,38.9,00000
56.0,78.0,59.0,009,14,01,  Alokdia Mayenuddin Para,212,606,124,297,88,309,25.9,29.5,22.2,00000
56.0,78.0,59.0,009,15,01,  Alokdia Hamid Diler Para,280,251,169,109,111,142,52.7,60.8,43.9,00000
56.0,78.0,59.0,707,01,01,  Narayan Teota,752,339,377,127,375,212,68.9,74.8,63.9,00000
56.0,78.0,59.0,707,02,01,  Tubakhali,180,112,95,46,85,66,61.6,67.4,56.3,00000
56.0,78.0,59.0,707,03,01,  Jamudoara Teota,475,201,246,83,229,118,70.3,74.8,66.0,00000
56.0,78.0,59.0,739,01,01,  Paila,673,642,368,276,305,366,51.2,57.1,45.5,00000
56.0,78.0,59.0,739,02,01,  Purana Paila,252,482,150,223,102,259,34.3,40.2,28.3,00000
56.0,78.0,59.0,739,03,01,  Mirpur,125,102,71,41,54,61,55.1,63.4,47.0,00000
56.0,78.0,59.0,798,01,01,  Raghunathpur,881,449,448,187,433,262,66.2,70.6,62.3,00000
56.0,78.0,59.0,798,02,01,  Rajganj,92,33,50,11,42,22,73.6,82.0,65.6,00000
56.0,78.0,59.0,853,01,01,  Samasghar,582,224,291,102,291,122,72.2,74.0,70.5,00000
56.0,78.0,59.0,853,02,01,  Jamduara,287,153,149,65,138,88,65.2,69.6,61.1,00000
56.0,78.0,71.0,013,01,01,  Amdala,477,377,243,177,234,200,55.9,57.9,53.9,00000
56.0,78.0,71.0,013,02,01,  Bhaualkandi,366,717,191,347,175,370,33.8,35.5,32.1,00000
56.0,78.0,71.0,123,01,01,  Bhakla,480,629,260,279,220,350,43.3,48.2,38.6,00000
56.0,78.0,71.0,123,02,01,  Kamar Bhakla,254,180,138,69,116,111,58.5,66.7,51.1,00000
56.0,78.0,71.0,246,01,01,  Chari Para,531,565,332,264,199,301,48.4,55.7,39.8,00000
56.0,78.0,71.0,246,02,01,  Char Chari Para,76,125,44,54,32,71,37.8,44.9,31.1,00000
56.0,78.0,71.0,451,01,01,  Gangdhair,362,594,201,272,161,322,37.9,42.5,33.3,00000
56.0,78.0,71.0,451,02,01,  Bhaor,116,221,61,99,55,122,34.4,38.1,31.1,00000
56.0,78.0,71.0,497,01,01,  Koyra,636,709,332,316,304,393,47.3,51.2,43.6,00000
56.0,78.0,71.0,497,02,01,  Dari Koyra,555,424,281,177,274,247,56.7,61.4,52.6,00000
56.0,78.0,71.0,497,03,01,  Par Koyra,52,42,23,19,29,23,55.3,54.8,55.8,00000
56.0,78.0,71.0,497,04,01,  Gohailbari,164,266,92,122,72,144,38.1,43.0,33.3,00000
56.0,78.0,71.0,538,01,01,  Kakkol,237,184,115,78,122,106,56.3,59.6,53.5,00000
56.0,78.0,71.0,538,02,01,  Hafiznagar,78,128,43,53,35,75,37.9,44.8,31.8,00000
56.0,78.0,71.0,538,03,01,  Nayakandi,69,100,36,47,33,53,40.8,43.4,38.4,00000
56.0,78.0,71.0,556,01,01,  Kashta Sagra,137,213,79,95,58,118,39.1,45.4,33.0,00000
56.0,78.0,71.0,556,02,01,  Ulail,219,189,118,88,101,101,53.7,57.3,50.0,00000
56.0,78.0,71.0,556,03,01,  Konabari,170,190,108,85,62,105,47.2,56.0,37.1,00000
56.0,78.0,71.0,556,04,01,  Thangamara,288,190,147,82,141,108,60.3,64.2,56.6,00000
56.0,78.0,83.0,082,01,01,  Bara Shibrambari,817,445,443,202,374,243,64.7,68.7,60.6,00000
56.0,78.0,83.0,082,02,01,  Mirpur,123,46,61,22,62,24,72.8,73.5,72.1,00000
56.0,78.0,83.0,698,01,01,  Nadisukha,359,194,192,85,167,109,64.9,69.3,60.5,00000
56.0,78.0,83.0,698,02,01,  Char Payla,227,175,112,81,115,94,56.5,58.0,55.0,00000
56.0,78.0,83.0,972,01,01,  Mahidpur,576,471,321,205,255,266,55.0,61.0,48.9,00000
56.0,78.0,83.0,972,02,01,  Bahulakul,193,141,105,64,88,77,57.8,62.1,53.3,00000
56.0,82.0,17.0,050,01,01,  Uttar Golaidanga,355,290,149,137,206,153,55.0,52.1,57.4,00000
56.0,82.0,17.0,050,02,01,  Char Magra,296,303,126,133,170,170,49.4,48.6,50.0,00000
56.0,82.0,17.0,050,03,01,  Baldhara,796,1156,419,582,377,574,40.8,41.9,39.6,00000
56.0,82.0,17.0,050,04,01,  Manikdaha,354,343,265,232,89,111,50.8,53.3,44.5,00000
56.0,82.0,17.0,050,05,01,  Atkaria,134,95,73,40,61,55,58.5,64.6,52.6,00000
56.0,82.0,17.0,050,06,01,  Ramkantapur,508,384,269,173,239,211,57.0,60.9,53.1,00000
56.0,82.0,17.0,773,01,01,  Khoamuri,1031,661,504,282,527,379,60.9,64.1,58.2,00000
56.0,82.0,17.0,773,02,01,  Nawaoda,581,697,279,310,302,387,45.5,47.4,43.8,00000
56.0,82.0,17.0,773,03,01,  Nalgola,145,102,72,36,73,66,58.7,66.7,52.5,00000
56.0,82.0,17.0,773,04,01,  Dakshin Goladangi,795,644,364,272,431,372,55.2,57.2,53.7,00000
56.0,82.0,17.0,966,01,01,  Purba Jailla,389,538,184,259,205,279,42.0,41.5,42.4,00000
56.0,82.0,17.0,966,02,01,  Uttar Jailla,481,876,250,518,231,358,35.4,32.6,39.2,00000
56.0,82.0,19.0,114,01,01,  Uttar Garadia,1261,1207,651,581,610,626,51.1,52.8,49.4,00000
56.0,82.0,19.0,114,02,01,  Nayabari,587,669,275,291,312,378,46.7,48.6,45.2,00000
56.0,82.0,19.0,114,03,01,  Char Nayabari,373,521,175,243,198,278,41.7,41.9,41.6,00000
56.0,82.0,19.0,114,04,01,  Pach Para,276,203,139,87,137,116,57.6,61.5,54.2,00000
56.0,82.0,19.0,114,05,01,  Bedadangi,46,53,16,27,30,26,46.5,37.2,53.6,00000
56.0,82.0,19.0,114,06,01,  Boyra,1479,1270,755,600,724,670,53.8,55.7,51.9,00000
56.0,82.0,19.0,114,07,01,  Alinagar,216,147,112,62,104,85,59.5,64.4,55.0,00000
56.0,82.0,19.0,114,08,01,  Kalinagar,252,256,157,138,95,118,49.6,53.2,44.6,00000
56.0,82.0,19.0,114,09,01,  Guchchhagram,42,318,20,145,22,173,11.7,12.1,11.3,00000
56.0,82.0,19.0,501,01,01,  Jamalpur,784,617,398,283,386,334,56.0,58.4,53.6,00000
56.0,82.0,19.0,501,02,01,  Char Jamalpur,636,688,329,317,307,371,48.0,50.9,45.3,00000
56.0,82.0,19.0,866,01,01,  Sanail,788,901,385,437,403,464,46.7,46.8,46.5,00000
56.0,82.0,19.0,866,02,01,  Mollah Para,169,350,93,247,76,103,32.6,27.4,42.5,00000
56.0,82.0,25.0,200,01,01,  Bainna,228,576,114,288,114,288,28.4,28.4,28.4,00000
56.0,82.0,25.0,200,02,01,  Char Mulbarga,403,718,182,327,221,391,36.0,35.8,36.1,00000
56.0,82.0,25.0,214,01,01,  Char Chandhar,336,545,178,270,158,275,38.1,39.7,36.5,00000
56.0,82.0,25.0,214,02,01,  Chak Chandhar,119,338,57,164,62,174,26.0,25.8,26.3,00000
56.0,82.0,25.0,214,03,01,  Sona Tengra,248,354,118,152,130,202,41.2,43.7,39.2,00000
56.0,82.0,25.0,214,04,01,  Gangalalpur,70,102,32,41,38,61,40.7,43.8,38.4,00000
56.0,82.0,25.0,214,05,01,  Degreer Char,125,146,66,60,59,86,46.1,52.4,40.7,00000
56.0,82.0,25.0,229,01,01,  Atipara,775,687,403,308,372,379,53.0,56.7,49.5,00000
56.0,82.0,25.0,229,02,01,  Char Paltan,870,693,428,321,442,372,55.7,57.1,54.3,00000
56.0,82.0,25.0,243,01,01,  Chamta,209,240,112,111,97,129,46.5,50.2,42.9,00000
56.0,82.0,25.0,243,02,01,  Char Chamta,437,316,211,144,226,172,58.0,59.4,56.8,00000
56.0,82.0,25.0,264,01,01,  Islampur,890,384,416,178,474,206,69.9,70.0,69.7,00000
56.0,82.0,25.0,264,02,01,  Serajpur,192,221,90,107,102,114,46.5,45.7,47.2,00000
56.0,82.0,25.0,264,03,01,  Chartipara,606,501,316,245,290,256,54.7,56.3,53.1,00000
56.0,82.0,25.0,436,01,01,  Fatehpur,489,421,226,198,263,223,53.7,53.3,54.1,00000
56.0,82.0,25.0,436,02,01,  Bharar Char,201,302,92,147,109,155,40.0,38.5,41.3,00000
56.0,82.0,25.0,665,01,01,  Char Madhabpur,590,591,317,237,273,354,50.0,57.2,43.5,00000
56.0,82.0,25.0,665,02,01,  Madhabpur,1151,1263,609,543,542,720,47.7,52.9,42.9,00000
56.0,82.0,25.0,665,03,01,  Balluk Para,128,172,56,82,72,90,42.7,40.6,44.4,00000
56.0,82.0,25.0,744,01,01,  Char Palpara,406,502,205,234,201,268,44.7,46.7,42.9,00000
56.0,82.0,25.0,744,02,01,  Baghuli,982,868,485,387,497,481,53.1,55.6,50.8,00000
56.0,82.0,25.0,744,03,01,  Barta,307,366,129,182,178,184,45.6,41.5,49.2,00000
56.0,82.0,25.0,744,04,01,  Palpara,542,297,232,120,310,177,64.6,65.9,63.7,00000
56.0,82.0,25.0,744,05,01,  Chak Palpara,667,777,310,376,357,401,46.2,45.2,47.1,00000
56.0,82.0,25.0,744,06,01,  Mulbarga,189,185,84,85,105,100,50.5,49.7,51.2,00000
56.0,82.0,25.0,851,01,01,  Refaitpur,263,385,137,175,126,210,40.6,43.9,37.5,00000
56.0,82.0,25.0,851,02,01,  Chalita Para,214,259,100,130,114,129,45.2,43.5,46.9,00000
56.0,82.0,34.0,357,01,01,  Dakshin Jailla,496,606,266,279,230,327,45.0,48.8,41.3,00000
56.0,82.0,34.0,357,02,01,  Atrail,184,266,80,128,104,138,40.9,38.5,43.0,00000
56.0,82.0,34.0,357,03,01,  Uttar Jailla,358,575,163,275,195,300,38.4,37.2,39.4,00000
56.0,82.0,43.0,443,01,01,  Fordnagar,1638,2421,897,1123,741,1298,40.4,44.4,36.3,00000
56.0,82.0,43.0,443,02,01,  Gussa Gram,211,393,139,240,72,153,34.9,36.7,32.0,00000
56.0,82.0,43.0,558,01,01,  Kamura,468,480,234,245,234,235,49.4,48.9,49.9,00000
56.0,82.0,43.0,558,02,01,  Naya Para,473,592,253,283,220,309,44.4,47.2,41.6,00000
56.0,82.0,43.0,558,03,01,  Jaigir,747,947,456,470,291,477,44.1,49.2,37.9,00000
56.0,82.0,43.0,558,04,01,  Bhum Dakhin (Part-2),173,248,95,127,78,121,41.1,42.8,39.2,00000
56.0,82.0,51.0,035,01,01,  Bahadia,365,904,183,433,182,471,28.8,29.7,27.9,00000
56.0,82.0,51.0,035,02,01,  Imamnagar,118,111,67,39,51,72,51.5,63.2,41.5,00000
56.0,82.0,51.0,078,01,01,  Baniara,296,456,150,198,146,258,39.4,43.1,36.1,00000
56.0,82.0,51.0,078,02,01,  Khan Baniara,486,472,243,219,243,253,50.7,52.6,49.0,00000
56.0,82.0,51.0,078,03,01,  Moulvinagar,76,163,42,77,34,86,31.8,35.3,28.3,00000
56.0,82.0,51.0,078,04,01,  Goal Bathan,79,151,44,70,35,81,34.3,38.6,30.2,00000
56.0,82.0,51.0,078,05,01,  Dhonkhalpar,395,332,210,156,185,176,54.3,57.4,51.2,00000
56.0,82.0,51.0,078,06,01,  Khalpar,56,82,33,40,23,42,40.6,45.2,35.4,00000
56.0,82.0,51.0,107,01,01,  Bathi,261,259,133,111,128,148,50.2,54.5,46.4,00000
56.0,82.0,51.0,107,02,01,  Tanbati,60,147,26,66,34,81,29.0,28.3,29.6,00000
56.0,82.0,51.0,143,01,01,  Purba Bhakum,580,1254,315,629,265,625,31.6,33.4,29.8,00000
56.0,82.0,51.0,143,02,01,  Paschim Bhakum,511,861,272,400,239,461,37.2,40.5,34.1,00000
56.0,82.0,51.0,408,01,01,  Deuli,384,488,199,241,185,247,44.0,45.2,42.8,00000
56.0,82.0,51.0,408,02,01,  Kiting Char,395,651,210,311,185,340,37.8,40.3,35.2,00000
56.0,82.0,51.0,622,01,01,  Kheleshwar,112,226,58,114,54,112,33.1,33.7,32.5,00000
56.0,82.0,51.0,622,02,01,  Chhayani,177,401,99,197,78,204,30.6,33.4,27.7,00000
56.0,82.0,51.0,622,03,01,  Sajermura,48,78,21,37,27,41,38.1,36.2,39.7,00000
56.0,82.0,51.0,730,01,01,  Niltek,403,258,209,124,194,134,61.0,62.8,59.1,00000
56.0,82.0,51.0,730,02,01,  Lakshmidia,74,90,43,42,31,48,45.1,50.6,39.2,00000
56.0,82.0,60.0,472,01,01,  Hatni,835,388,413,175,422,213,68.3,70.2,66.5,00000
56.0,82.0,60.0,472,02,01,  Kanchan Nagar,541,795,287,368,254,427,40.5,43.8,37.3,00000
56.0,82.0,60.0,486,01,01,  Hutair,445,360,210,139,235,221,55.3,60.2,51.5,00000
56.0,82.0,60.0,486,02,01,  Bhowadi Para,50,90,33,39,17,51,35.7,45.8,25.0,00000
56.0,82.0,60.0,536,01,01,  Kahilatali,161,264,89,120,72,144,37.9,42.6,33.3,00000
56.0,82.0,60.0,536,02,01,  Chandanpur,81,212,52,103,29,109,27.6,33.5,21.0,00000
56.0,82.0,60.0,737,01,01,  Rajnagar,395,687,192,319,203,368,36.5,37.6,35.6,00000
56.0,82.0,60.0,737,02,01,  Chandan Nagar,495,738,237,358,258,380,40.1,39.8,40.4,00000
56.0,82.0,60.0,737,03,01,  Char Rajnagar,363,388,189,183,174,205,48.3,50.8,45.9,00000
56.0,82.0,60.0,737,04,01,  Dari Rajnagar,238,246,129,95,109,151,49.2,57.6,41.9,00000
56.0,82.0,60.0,894,01,01,  Sudkhira,663,801,365,371,298,430,45.3,49.6,40.9,00000
56.0,82.0,60.0,894,02,01,  Binnadangi,516,834,281,421,235,413,38.2,40.0,36.3,00000
56.0,82.0,69.0,873,01,01,  Chhota Barundi,239,196,118,73,121,123,54.9,61.8,49.6,00000
56.0,82.0,69.0,873,02,01,  Matikata,463,635,210,288,253,347,42.2,42.2,42.2,00000
56.0,82.0,69.0,873,03,01,  Dari Para,225,171,106,68,119,103,56.8,60.9,53.6,00000
56.0,82.0,69.0,873,04,01,  Sararia,1087,1049,517,457,570,592,50.9,53.1,49.1,00000
56.0,82.0,69.0,873,05,01,  Balur Char,563,557,274,236,289,321,50.3,53.7,47.4,00000
56.0,82.0,69.0,873,06,01,  Chakulia,164,106,81,39,83,67,60.7,67.5,55.3,00000
56.0,82.0,69.0,873,07,01,  Jamsha,225,146,106,60,119,86,60.6,63.9,58.0,00000
56.0,82.0,77.0,064,01,01,  Bandail,327,828,179,387,148,441,28.3,31.6,25.1,00000
56.0,82.0,77.0,064,02,01,  Patti Bandail,393,386,190,168,203,218,50.4,53.1,48.2,00000
56.0,82.0,77.0,064,03,01,  Abasan,80,223,38,109,42,114,26.4,25.9,26.9,00000
56.0,82.0,77.0,565,01,01,  Kanai Nagar,538,634,254,310,284,324,45.9,45.0,46.7,00000
56.0,82.0,77.0,565,02,01,  Dakshin Kanainagar,144,288,78,146,66,142,33.3,34.8,31.7,00000
56.0,82.0,77.0,565,03,01,  Uttar Kanainagar,88,267,50,125,38,142,24.8,28.6,21.1,00000
56.0,82.0,77.0,565,04,01,  Niltek,187,214,104,88,83,126,46.6,54.2,39.7,00000
56.0,82.0,77.0,565,05,01,  Char Kanainagar,186,225,99,97,87,128,45.3,50.5,40.5,00000
56.0,82.0,77.0,565,06,01,  Singair Niltek,262,238,135,104,127,134,52.4,56.5,48.7,00000
56.0,82.0,77.0,568,01,01,  Kharia,120,212,59,97,61,115,36.1,37.8,34.7,00000
56.0,82.0,77.0,568,02,01,  Kailandi,208,317,106,156,102,161,39.6,40.5,38.8,00000
56.0,82.0,77.0,658,01,01,  Dakshin Lakshmipur,213,278,112,131,101,147,43.4,46.1,40.7,00000
56.0,82.0,77.0,658,02,01,  Char Lakshmipur,479,811,234,390,245,421,37.1,37.5,36.8,00000
56.0,82.0,77.0,658,03,01,  Madhya Lakshmipur,149,300,81,163,68,137,33.2,33.2,33.2,00000
56.0,82.0,77.0,658,04,01,  Uttar Lakshmipur,312,255,177,110,135,145,55.0,61.7,48.2,00000
56.0,82.0,77.0,658,05,01,  Purba Lakshmipur,186,283,92,131,94,152,39.7,41.3,38.2,00000
56.0,82.0,77.0,858,01,01,  Uttar Saharail,251,208,136,95,115,113,54.7,58.9,50.4,00000
56.0,82.0,77.0,858,02,01,  Gopalnagar,635,772,329,365,306,407,45.1,47.4,42.9,00000
56.0,82.0,77.0,858,03,01,  Tan Gopalpur,337,513,176,244,161,269,39.6,41.9,37.4,00000
56.0,82.0,77.0,858,04,01,  Saista,195,436,102,216,93,220,30.9,32.1,29.7,00000
56.0,82.0,77.0,858,05,01,  Paharpur,79,158,44,82,35,76,33.3,34.9,31.5,00000
56.0,82.0,77.0,858,06,01,  Char Saharail,52,106,28,53,24,53,32.9,34.6,31.2,00000
56.0,82.0,77.0,858,07,01,  Khan Para,112,136,52,61,60,75,45.2,46.0,44.4,00000
56.0,82.0,77.0,858,08,01,  Shibpur,170,311,97,151,73,160,35.3,39.1,31.3,00000
56.0,82.0,77.0,858,09,01,  Bairagi Tek,321,230,168,96,153,134,58.3,63.6,53.3,00000
56.0,82.0,77.0,858,10,01,  Sreepur,48,212,25,106,23,106,18.5,19.1,17.8,00000
56.0,82.0,77.0,858,11,01,  Kayet Para,359,214,198,93,161,121,62.7,68.0,57.1,00000
56.0,82.0,77.0,858,12,01,  Dakshinpara,256,766,119,357,137,409,25.0,25.0,25.1,00000
56.0,82.0,77.0,858,13,01,  Malu Para,63,80,36,42,27,38,44.1,46.2,41.5,00000
56.0,82.0,77.0,858,14,01,  Munshi Para,114,169,55,75,59,94,40.3,42.3,38.6,00000
56.0,82.0,77.0,858,15,01,  Athara Paika,113,155,50,66,63,89,42.2,43.1,41.4,00000
56.0,82.0,77.0,858,16,01,  Bok Char,26,79,10,40,16,39,24.8,20.0,29.1,00000
56.0,82.0,77.0,923,01,01,  Shyamnagar,432,791,202,378,230,413,35.3,34.8,35.8,00000
56.0,82.0,77.0,923,02,01,  Char Shyamnagar,276,663,141,314,135,349,29.4,31.0,27.9,00000
56.0,82.0,77.0,923,03,01,  Gobindanagar,89,143,39,70,50,73,38.4,35.8,40.7,00000
56.0,82.0,77.0,923,04,01,  Moslemabad,470,732,226,337,244,395,39.1,40.1,38.2,00000
56.0,82.0,94.0,164,01,01,  Rajendrapur,301,639,166,303,135,336,32.0,35.4,28.7,00000
56.0,82.0,94.0,164,02,01,  Jhau Para,112,192,51,85,61,107,36.8,37.5,36.3,00000
56.0,82.0,94.0,164,03,01,  Baghar Char,276,343,120,165,156,178,44.6,42.1,46.7,00000
56.0,82.0,94.0,207,01,01,  Kashimpur,371,287,173,144,198,143,56.4,54.6,58.1,00000
56.0,82.0,94.0,207,02,01,  Irta Kashimpur,210,330,101,155,109,175,38.9,39.5,38.4,00000
56.0,82.0,94.0,522,01,01,  Joynagar,261,486,137,213,124,273,34.9,39.1,31.2,00000
56.0,82.0,94.0,522,02,01,  Natun Erata,178,314,75,129,103,185,36.2,36.8,35.8,00000
56.0,82.0,94.0,522,03,01,  Barta,143,175,65,84,78,91,45.0,43.6,46.2,00000
56.0,82.0,94.0,987,01,01,  Petkata(Islamnagar),852,882,433,395,419,487,49.1,52.3,46.2,00000
56.0,82.0,94.0,987,02,01,  Erata,973,296,438,109,535,187,76.7,80.1,74.1,00000
26.0,4.0,13.0,590,01,03,  Ananda Nagar,5931,2872,3427,1461,2504,1411,67.4,70.1,64.0,00000
26.0,4.0,13.0,590,02,03,  Chaitan Tali,2203,1449,1226,759,977,690,60.3,61.8,58.6,00000
26.0,4.0,13.0,590,03,03,  Dakshin Ananda Nagar,1562,1355,872,718,690,637,53.5,54.8,52.0,00000
26.0,4.0,13.0,590,04,03,  Tekpara,1687,1270,972,659,715,611,57.1,59.6,53.9,00000
26.0,4.0,13.0,590,05,03,  D I T Housing Area,9683,1943,5712,958,3971,985,83.3,85.6,80.1,00000
26.0,4.0,13.0,590,06,03,  Sonakatra,7518,3398,4141,1645,3377,1753,68.9,71.6,65.8,00000
26.0,4.0,13.0,590,07,03,  Purba Badda Namapara,19585,10376,11101,5359,8484,5017,65.4,67.4,62.8,00000
26.0,4.0,13.0,590,08,03,  Madhya Badda Purba,8425,2470,4773,1092,3652,1378,77.3,81.4,72.6,00000
26.0,4.0,13.0,590,09,03,  Adarsa Nagar,11457,4125,6716,1897,4741,2228,73.5,78.0,68.0,00000
26.0,4.0,13.0,590,10,03,  Satar Kul Road Mahallah,5392,1544,3143,733,2249,811,77.7,81.1,73.5,00000
26.0,4.0,13.0,590,11,03,  Sadinatha Sarani Road,13848,5965,8562,3108,5286,2857,69.9,73.4,64.9,00000
26.0,4.0,13.0,590,12,03,  Mayner Bag,5987,1619,3613,853,2374,766,78.7,80.9,75.6,00000
26.0,4.0,13.0,590,13,03,  Daukandi,344,256,184,140,160,116,57.3,56.8,58.0,00000
26.0,4.0,13.0,590,14,03,  Aftab Nagar,972,370,714,210,258,160,72.4,77.3,61.7,00000
26.0,4.0,13.0,590,15,03,  Indulia,226,166,115,89,111,77,57.7,56.4,59.0,00000
26.0,4.0,13.0,895,01,03,  Misritola,2794,1496,1529,790,1265,706,65.1,65.9,64.2,00000
26.0,4.0,13.0,895,02,03,  Hazipara,3794,1541,2240,721,1554,820,71.1,75.7,65.5,00000
26.0,4.0,13.0,895,03,03,  Abdulla Bag,4549,2252,2734,1186,1815,1066,66.9,69.7,63.0,00000
26.0,4.0,13.0,895,04,03,  Purba Chal,5171,1751,2869,905,2302,846,74.7,76.0,73.1,00000
26.0,4.0,19.0,124,01,03,  Chandar Tek,329,343,173,182,156,161,49.0,48.7,49.2,00000
26.0,4.0,19.0,124,02,03,  Moral Para,1018,516,569,231,449,285,66.4,71.1,61.2,00000
26.0,4.0,19.0,124,03,03,  Araddapura,431,324,240,172,191,152,57.1,58.3,55.7,00000
26.0,4.0,19.0,124,04,03,  Ashkertek,383,232,204,118,179,114,62.3,63.4,61.1,00000
26.0,4.0,19.0,124,05,03,  Chinadi Para,591,902,324,465,267,437,39.6,41.1,37.9,00000
26.0,4.0,19.0,124,06,03,  Purbapara,1048,897,550,429,498,468,53.9,56.2,51.6,00000
26.0,4.0,19.0,124,07,03,  Rishipara,581,789,330,376,251,413,42.4,46.7,37.8,00000
26.0,4.0,19.0,124,08,03,  Bhuiyanpara,962,454,503,223,459,231,67.9,69.3,66.5,00000
26.0,4.0,19.0,124,09,03,  Agar Para,750,447,427,212,323,235,62.7,66.8,57.9,00000
26.0,4.0,57.0,199,01,03,  Bhatara,14410,5332,8715,2596,5695,2736,73.0,77.0,67.5,00000
26.0,4.0,57.0,199,02,03,  Solamaid,11594,7102,6816,3553,4778,3549,62.0,65.7,57.4,00000
26.0,4.0,57.0,199,03,03,  Nayanagar,11326,7077,7619,3659,3707,3418,61.5,67.6,52.0,00000
26.0,4.0,57.0,199,04,03,  Nurer Chala,21395,6679,12815,3221,8580,3458,76.2,79.9,71.3,00000
26.0,4.0,57.0,199,05,03,  Khilbarir Tek,19147,5843,11680,3204,7467,2639,76.6,78.5,73.9,00000
26.0,4.0,82.0,870,01,03,  Satarkul Pukurpara,813,449,437,234,376,215,64.4,65.1,63.6,00000
26.0,4.0,82.0,870,02,03,  Satarkul Taltala,783,456,448,217,335,239,63.2,67.4,58.4,00000
26.0,4.0,82.0,870,04,03,  Satarkul Uttar Para(East Part),674,562,347,283,327,279,54.5,55.1,54.0,00000
26.0,4.0,82.0,870,05,03,  Satarkul Dakshin Para,770,531,443,248,327,283,59.2,64.1,53.6,00000
26.0,4.0,82.0,870,06,03,  Mogadia,388,575,207,275,181,300,40.3,42.9,37.6,00000
26.0,4.0,82.0,870,07,03,  Bengartek (Islambag),947,1045,533,522,414,523,47.5,50.5,44.2,00000
26.0,4.0,82.0,870,08,03,  Pachkhola,91,381,47,191,44,190,19.3,19.7,18.8,00000
26.0,4.0,82.0,870,09,03,  Merulkhola,210,72,140,40,70,32,74.5,77.8,68.6,00000
26.0,4.0,82.0,895,01,03,  Padaridia Paschim,3143,3138,1793,1482,1350,1656,50.0,54.7,44.9,00000
26.0,4.0,82.0,895,02,03,  Padaridia Purba,2659,2871,1566,1526,1093,1345,48.1,50.6,44.8,00000
26.0,6.0,38.0,348,01,03,  Kawlar(Part)C.Aviation Stf Qtr,3500,516,1899,188,1601,328,87.2,91.0,83.0,00000
26.0,6.0,38.0,348,02,03,  Askona(Part)Haji Cmp Ansr.Bark,634,374,458,255,176,119,62.9,64.2,59.7,00000
26.0,10.0,38.0,348,01,03,  Kaular (Part),13235,5253,7445,2519,5790,2734,71.6,74.7,67.9,00000
26.0,10.0,38.0,348,02,03,  Halan,2830,806,1545,340,1285,466,77.8,82.0,73.4,00000
26.0,10.0,38.0,348,03,03,  Askona (Part),19249,3819,11090,1830,8159,1989,83.4,85.8,80.4,00000
26.0,10.0,38.0,348,04,03,  Sonakhola,749,200,381,90,368,110,78.9,80.9,77.0,00000
26.0,10.0,38.0,348,05,03,  Gawair,22838,8012,13112,3845,9726,4167,74.0,77.3,70.0,00000
26.0,10.0,38.0,348,06,03,  Irshal,1192,317,786,156,406,161,79.0,83.4,71.6,00000
26.0,10.0,38.0,348,07,03,  Mollartek,10225,2446,5875,1122,4350,1324,80.7,84.0,76.7,00000
26.0,10.0,38.0,348,08,03,  Chalaband,4980,1626,2735,747,2245,879,75.4,78.5,71.9,00000
26.0,10.0,38.0,348,09,03,  Dakshinkhan,34080,9429,18518,4423,15562,5006,78.3,80.7,75.7,00000
26.0,10.0,38.0,400,01,03,  Faydabad,28343,8129,15474,3760,12869,4369,77.7,80.5,74.7,00000
26.0,10.0,38.0,400,02,03,  Goaltek,4359,2266,2507,1004,1852,1262,65.8,71.4,59.5,00000
26.0,12.0,65.0,055,01,03,  Amulia,1679,300,944,142,735,158,84.8,86.9,82.3,00000
26.0,12.0,65.0,055,02,03,  Mendipur,873,310,485,137,388,173,73.8,78.0,69.2,00000
26.0,12.0,65.0,082,01,03,  Nalchata,332,290,191,165,141,125,53.4,53.7,53.0,00000
26.0,12.0,65.0,082,02,03,  Tamburabad,242,365,141,161,101,204,39.9,46.7,33.1,00000
26.0,12.0,65.0,082,03,03,  Balu Dhitpur,549,281,303,135,246,146,66.1,69.2,62.8,00000
26.0,12.0,65.0,082,04,03,  Khalpara,409,119,231,43,178,76,77.5,84.3,70.1,00000
26.0,12.0,93.0,442,01,03,  Paschim Boxnagar,6944,2889,3535,1336,3409,1553,70.6,72.6,68.7,00000
26.0,12.0,93.0,442,02,03,  Purba Boxnagar,5224,2199,3289,1109,1935,1090,70.4,74.8,64.0,00000
26.0,12.0,93.0,442,03,03,  Sukurshi,3249,3383,1906,1775,1343,1608,49.0,51.8,45.5,00000
26.0,12.0,93.0,884,01,03,  Paschim Tengra,6340,1813,3369,864,2971,949,77.8,79.6,75.8,00000
26.0,12.0,93.0,884,02,03,  Sarulia,5277,2786,3081,1481,2196,1305,65.4,67.5,62.7,00000
26.0,12.0,93.0,884,03,03,  Madhya Tengra,7053,2301,3871,1169,3182,1132,75.4,76.8,73.8,00000
26.0,12.0,93.0,884,04,03,  Dakshin Tengra,12767,3200,6654,1487,6113,1713,80.0,81.7,78.1,00000
26.0,12.0,93.0,884,05,03,  Purba Tengra,3537,1053,2199,652,1338,401,77.1,77.1,76.9,00000
26.0,14.0,10.0,019,01,01,  Amta,422,467,223,207,199,260,47.5,51.9,43.4,00000
26.0,14.0,10.0,019,02,01,  Joar Amta,491,494,255,198,236,296,49.8,56.3,44.4,00000
26.0,14.0,10.0,097,01,01,  Bakhanda,783,949,377,442,406,507,45.2,46.0,44.5,00000
26.0,14.0,10.0,097,02,01,  Dakait Para,130,168,65,82,65,86,43.6,44.2,43.0,00000
26.0,14.0,10.0,097,03,01,  Sialo Para,119,199,62,83,57,116,37.4,42.8,32.9,00000
26.0,14.0,10.0,097,04,01,  Naya Para,137,177,61,82,76,95,43.6,42.7,44.4,00000
26.0,14.0,10.0,097,05,01,  Jagatnagar,170,294,82,144,88,150,36.6,36.3,37.0,00000
26.0,14.0,10.0,113,01,01,  Bara Narayanpur,357,496,193,222,164,274,41.9,46.5,37.4,00000
26.0,14.0,10.0,113,02,01,  Naya Char,259,284,132,128,127,156,47.7,50.8,44.9,00000
26.0,14.0,11.0,526,01,01,  Kandapatal,484,249,256,84,228,165,66.0,75.3,58.0,00000
26.0,14.0,11.0,526,02,01,  Kholabari,51,32,23,16,28,16,61.4,59.0,63.6,00000
26.0,14.0,11.0,526,03,01,  Raghunathpur,378,186,220,64,158,122,67.0,77.5,56.4,00000
26.0,14.0,11.0,526,04,01,  Madantia,193,107,96,45,97,62,64.3,68.1,61.0,00000
26.0,14.0,11.0,572,01,01,  Dakshin Khagail,497,239,257,79,240,160,67.5,76.5,60.0,00000
26.0,14.0,11.0,572,02,01,  Uttar Khagail,498,169,247,72,251,97,74.7,77.4,72.1,00000
26.0,14.0,17.0,198,01,01,  Bil Pallai,180,118,101,45,79,73,60.4,69.2,52.0,00000
26.0,14.0,17.0,198,02,01,  Nayar Char,76,107,48,46,28,61,41.5,51.1,31.5,00000
26.0,14.0,17.0,806,01,01,  Ramraban,511,1231,289,545,222,686,29.3,34.7,24.4,00000
26.0,14.0,17.0,806,02,01,  Prottsha,58,154,30,66,28,88,27.4,31.3,24.1,00000
26.0,14.0,23.0,214,01,01,  Chanda Para,162,100,88,56,74,44,61.8,61.1,62.7,00000
26.0,14.0,23.0,214,02,01,  Jogi Para,122,113,59,52,63,61,51.9,53.2,50.8,00000
26.0,14.0,23.0,214,03,01,  Diabari,47,61,24,30,23,31,43.5,44.4,42.6,00000
26.0,14.0,23.0,513,01,01,  Kakran,338,150,200,60,138,90,69.3,76.9,60.5,00000
26.0,14.0,23.0,513,02,01,  Brahman Tek,201,136,118,64,83,72,59.6,64.8,53.5,00000
26.0,14.0,23.0,513,03,01,  Haluabari,170,238,83,111,87,127,41.7,42.8,40.7,00000
26.0,14.0,23.0,513,04,01,  Palpara,343,156,176,69,167,87,68.7,71.8,65.7,00000
26.0,14.0,23.0,513,05,01,  Madhyapara,170,174,94,83,76,91,49.4,53.1,45.5,00000
26.0,14.0,23.0,513,06,01,  Bhuiyan Para,175,133,99,53,76,80,56.8,65.1,48.7,00000
26.0,14.0,23.0,513,07,01,  Majh Para,107,12,50,2,57,10,89.9,96.2,85.1,00000
26.0,14.0,23.0,513,08,01,  Gain Para,167,68,84,29,83,39,71.1,74.3,68.0,00000
26.0,14.0,23.0,513,09,01,  Paschimpara,303,116,160,48,143,68,72.3,76.9,67.8,00000
26.0,14.0,23.0,513,10,01,  Phultala,208,122,112,42,96,80,63.0,72.7,54.5,00000
26.0,14.0,23.0,552,01,01,  Katabai,261,156,155,68,106,88,62.6,69.5,54.6,00000
26.0,14.0,23.0,552,02,01,  Tanti Para,42,162,25,73,17,89,20.6,25.5,16.0,00000
26.0,14.0,23.0,552,03,01,  Dewan Para,61,238,43,101,18,137,20.4,29.9,11.6,00000
26.0,14.0,23.0,552,04,01,  Dakshin Katabai,65,215,44,103,21,112,23.2,29.9,15.8,00000
26.0,14.0,23.0,552,05,01,  Madhya Katabai,81,223,44,101,37,122,26.6,30.3,23.3,00000
26.0,14.0,23.0,650,01,01,  Malancha,332,328,160,146,172,182,50.3,52.3,48.6,00000
26.0,14.0,23.0,650,02,01,  Guntail,187,79,96,36,91,43,70.3,72.7,67.9,00000
26.0,14.0,23.0,650,03,01,  Mandar Chap,115,211,55,105,60,106,35.3,34.4,36.1,00000
26.0,14.0,23.0,972,01,01,  Uttar Dighalgaon,408,273,220,107,188,166,59.9,67.3,53.1,00000
26.0,14.0,23.0,972,02,01,  Gobindapur,62,51,28,22,34,29,54.9,56.0,54.0,00000
26.0,14.0,29.0,178,01,01,  Bara Bakulia,154,230,87,104,67,126,40.1,45.5,34.7,00000
26.0,14.0,29.0,178,02,01,  Chhota Bakulia,297,702,176,341,121,361,29.7,34.0,25.1,00000
26.0,14.0,29.0,240,01,01,  Chauhat,2496,1904,1361,825,1135,1079,56.7,62.3,51.3,00000
26.0,14.0,29.0,240,02,01,  Char Chauhat,654,562,352,252,302,310,53.8,58.3,49.3,00000
26.0,14.0,29.0,240,03,01,  Char Para (Chak Para),553,312,297,135,256,177,63.9,68.8,59.1,00000
26.0,14.0,29.0,377,01,01,  Dwimukha,557,806,296,369,261,437,40.9,44.5,37.4,00000
26.0,14.0,29.0,377,02,01,  Kanainagar,23,74,8,33,15,41,23.7,19.5,26.8,00000
26.0,14.0,29.0,377,03,01,  Bangabari,13,13,7,4,6,9,50.0,63.6,40.0,00000
26.0,14.0,29.0,702,01,01,  Munshir Char,621,970,319,444,302,526,39.0,41.8,36.5,00000
26.0,14.0,29.0,702,02,01,  Nayachar,32,37,21,14,11,23,46.4,60.0,32.4,00000
26.0,14.0,29.0,754,01,01,  Paschim Paik Para,423,129,219,58,204,71,76.6,79.1,74.2,00000
26.0,14.0,29.0,754,02,01,  Jhikatia,131,193,73,84,58,109,40.4,46.5,34.7,00000
26.0,14.0,35.0,176,01,01,  Bara Ekuria,458,134,240,44,218,90,77.4,84.5,70.8,00000
26.0,14.0,35.0,176,02,01,  Nimaitak,79,48,38,17,41,31,62.2,69.1,56.9,00000
26.0,14.0,35.0,438,01,01,  Purba Hajipur,600,401,314,163,286,238,59.9,65.8,54.6,00000
26.0,14.0,35.0,438,02,01,  Paschim Hajipur,734,315,390,102,344,213,70.0,79.3,61.8,00000
26.0,14.0,35.0,477,01,01,  Janardhan Pur,576,266,318,122,258,144,68.4,72.3,64.2,00000
26.0,14.0,35.0,477,02,01,  Sarnakhali,220,271,110,128,110,143,44.8,46.2,43.5,00000
26.0,14.0,41.0,120,01,01,  Barabaria,667,647,399,331,268,316,50.8,54.7,45.9,00000
26.0,14.0,41.0,120,02,01,  Gandulia,216,372,157,218,59,154,36.7,41.9,27.7,00000
26.0,14.0,41.0,435,01,01,  Hatkora,193,292,108,126,85,166,39.8,46.2,33.9,00000
26.0,14.0,41.0,435,02,01,  Dakshin Hatkora,473,511,284,206,189,305,48.1,58.0,38.3,00000
26.0,14.0,41.0,435,03,01,  Kauakhola,518,466,292,182,226,284,52.6,61.6,44.3,00000
26.0,14.0,41.0,533,01,01,  Uttar Kawalipara,590,640,332,331,258,309,48.0,50.1,45.5,00000
26.0,14.0,41.0,533,02,01,  Dakshin Kawalipara,177,222,96,115,81,107,44.4,45.5,43.1,00000
26.0,14.0,41.0,728,01,01,  Paruhala,551,566,347,232,204,334,49.3,59.9,37.9,00000
26.0,14.0,41.0,728,02,01,  Lalitnagar,166,418,91,220,75,198,28.4,29.3,27.5,00000
26.0,14.0,47.0,403,01,01,  Garurgaon,441,344,230,147,211,197,56.2,61.0,51.7,00000
26.0,14.0,47.0,403,02,01,  Bhatkura,271,218,149,89,122,129,55.4,62.6,48.6,00000
26.0,14.0,47.0,403,03,01,  Gajaria,65,37,25,20,40,17,63.7,55.6,70.2,00000
26.0,14.0,53.0,123,01,01,  Bara Kair,230,416,147,192,83,224,35.6,43.4,27.0,00000
26.0,14.0,53.0,123,02,01,  Chulail,203,249,113,131,90,118,44.9,46.3,43.3,00000
26.0,14.0,53.0,130,01,01,  Bardati,272,210,158,88,114,122,56.4,64.2,48.3,00000
26.0,14.0,53.0,130,02,01,  Rupnagar,258,259,130,126,128,133,49.9,50.8,49.0,00000
26.0,14.0,53.0,715,01,01,  Palli,465,346,264,135,201,211,57.3,66.2,48.8,00000
26.0,14.0,53.0,715,02,01,  Aralia,150,172,84,74,66,98,46.6,53.2,40.2,00000
26.0,14.0,59.0,091,01,01,  Bannal,411,378,235,141,176,237,52.1,62.5,42.6,00000
26.0,14.0,59.0,091,02,01,  Bucharbari,160,167,88,84,72,83,48.9,51.2,46.5,00000
26.0,14.0,59.0,091,03,01,  Bainbari,46,23,26,10,20,13,66.7,72.2,60.6,00000
26.0,14.0,59.0,091,04,01,  Chandrabri,37,39,22,20,15,19,48.7,52.4,44.1,00000
26.0,14.0,59.0,091,05,01,  Saitabari,262,119,148,51,114,68,68.8,74.4,62.6,00000
26.0,14.0,59.0,091,06,01,  Bhurbhuria,208,132,117,55,91,77,61.2,68.0,54.2,00000
26.0,14.0,59.0,091,07,01,  Maijal,57,49,34,21,23,28,53.8,61.8,45.1,00000
26.0,14.0,59.0,091,08,01,  Kulinda,183,176,94,79,89,97,51.0,54.3,47.8,00000
26.0,14.0,59.0,373,01,01,  Durgapur Garail,169,378,98,158,71,220,30.9,38.3,24.4,00000
26.0,14.0,59.0,373,02,01,  Ag Garail,235,166,131,71,104,95,58.6,64.9,52.3,00000
26.0,14.0,59.0,373,03,01,  Madhudanga,283,656,165,299,118,357,30.1,35.6,24.8,00000
26.0,14.0,59.0,373,04,01,  Radhanagar,137,206,68,92,69,114,39.9,42.5,37.7,00000
26.0,14.0,59.0,373,05,01,  Bejgaon,134,132,69,57,65,75,50.4,54.8,46.4,00000
26.0,14.0,59.0,617,01,01,  Kushira,416,410,241,251,175,159,50.4,49.0,52.4,00000
26.0,14.0,59.0,617,02,01,  Hat Kushira,447,282,239,106,208,176,61.3,69.3,54.2,00000
26.0,14.0,65.0,686,01,01,  Ghurakanda,760,762,430,391,330,371,49.9,52.4,47.1,00000
26.0,14.0,65.0,686,02,01,  Chonaau,706,568,381,228,325,340,55.4,62.6,48.9,00000
26.0,14.0,65.0,686,03,01,  Char Chonaau,319,272,165,113,154,159,54.0,59.4,49.2,00000
26.0,14.0,65.0,686,04,01,  Gopal Krishnapur,623,513,339,211,284,302,54.8,61.6,48.5,00000
26.0,14.0,65.0,686,05,01,  Nannar,1971,2718,1077,1429,894,1289,42.0,43.0,41.0,00000
26.0,14.0,65.0,809,01,01,  Raghunathpur,446,437,248,171,198,266,50.5,59.2,42.7,00000
26.0,14.0,65.0,809,02,01,  Kandakawli,183,279,93,148,90,131,39.6,38.6,40.7,00000
26.0,14.0,65.0,962,01,01,  Ulail,583,381,291,153,292,228,60.5,65.5,56.2,00000
26.0,14.0,65.0,962,02,01,  Kalidasputti,478,391,240,178,238,213,55.0,57.4,52.8,00000
26.0,14.0,71.0,227,01,01,  Char Baradail,239,219,136,97,103,122,52.2,58.4,45.8,00000
26.0,14.0,71.0,227,02,01,  Mohanpur,75,191,38,96,37,95,28.2,28.4,28.0,00000
26.0,14.0,71.0,936,01,01,  Sanghar,831,1781,484,856,347,925,31.8,36.1,27.3,00000
26.0,14.0,71.0,936,02,01,  Faringa,651,977,383,465,268,512,40.0,45.2,34.4,00000
26.0,14.0,77.0,100,01,01,  Bara Amarpur,37,114,21,57,16,57,24.5,26.9,21.9,00000
26.0,14.0,77.0,100,02,01,  Char Kunda,409,416,196,184,213,232,49.6,51.6,47.9,00000
26.0,14.0,77.0,182,01,01,  Bhalum,1086,786,617,329,469,457,58.0,65.2,50.6,00000
26.0,14.0,77.0,182,02,01,  Bathuli,332,277,163,126,169,151,54.5,56.4,52.8,00000
26.0,14.0,77.0,182,03,01,  Batulia,672,660,380,312,292,348,50.5,54.9,45.6,00000
26.0,14.0,77.0,182,04,01,  Kalampur Bazar,563,460,340,389,223,71,55.0,46.6,75.9,00000
26.0,14.0,77.0,344,01,01,  Deonai,856,1185,441,527,415,658,41.9,45.6,38.7,00000
26.0,14.0,77.0,344,02,01,  Alokdia,106,129,50,51,56,78,45.1,49.5,41.8,00000
26.0,14.0,77.0,344,03,01,  Baisal,187,296,95,142,92,154,38.7,40.1,37.4,00000
26.0,14.0,77.0,351,01,01,  Dhalkunda,170,122,92,49,78,73,58.2,65.2,51.7,00000
26.0,14.0,77.0,351,02,01,  Madhudanga,145,137,71,58,74,79,51.4,55.0,48.4,00000
26.0,14.0,77.0,637,01,01,  Mahishasi (I),884,968,474,439,410,529,47.7,51.9,43.7,00000
26.0,14.0,77.0,637,02,01,  Mahishahi (Ii),329,374,178,150,151,224,46.8,54.3,40.3,00000
26.0,14.0,77.0,741,01,01,  Paschim Basna,420,467,228,212,192,255,47.4,51.8,43.0,00000
26.0,14.0,77.0,741,02,01,  Chandakhali,220,198,117,88,103,110,52.6,57.1,48.4,00000
26.0,14.0,77.0,741,03,01,  Switchkhali,77,231,44,107,33,124,25.0,29.1,21.0,00000
26.0,14.0,77.0,978,01,01,  Uttar Naohatta,164,110,82,49,82,61,59.9,62.6,57.3,00000
26.0,14.0,77.0,978,02,01,  Uttar Naohatta Bazar,27,23,17,10,10,13,54.0,63.0,43.5,00000
26.0,14.0,83.0,042,01,01,  Bade Gadail,430,533,233,258,197,275,44.7,47.5,41.7,00000
26.0,14.0,83.0,042,02,01,  Char Dautia,86,140,51,61,35,79,38.1,45.5,30.7,00000
26.0,14.0,83.0,224,01,01,  Chapil,832,1046,454,469,378,577,44.3,49.2,39.6,00000
26.0,14.0,83.0,224,02,01,  Kanshapatti,192,262,99,123,93,139,42.3,44.6,40.1,00000
26.0,14.0,83.0,325,01,01,  Dautia,1356,1804,965,1013,391,791,42.9,48.8,33.1,00000
26.0,14.0,83.0,325,02,01,  Char Dautia,739,692,411,310,328,382,51.6,57.0,46.2,00000
26.0,14.0,83.0,325,03,01,  Goaldi,539,487,298,204,241,283,52.5,59.4,46.0,00000
26.0,14.0,83.0,396,01,01,  Gauail,1083,1433,625,648,458,785,43.0,49.1,36.8,00000
26.0,14.0,83.0,396,02,01,  Baneshwar,580,820,318,386,262,434,41.4,45.2,37.6,00000
26.0,14.0,83.0,842,01,01,  Sailain,565,336,297,141,268,195,62.7,67.8,57.9,00000
26.0,14.0,83.0,842,02,01,  Kulinda,130,153,66,58,64,95,45.9,53.2,40.3,00000
26.0,14.0,83.0,842,03,01,  Burburia,116,120,62,51,54,69,49.2,54.9,43.9,00000
26.0,14.0,83.0,842,04,01,  Karabil,135,174,71,80,64,94,43.7,47.0,40.5,00000
26.0,14.0,83.0,916,01,01,  Sombhag,372,380,212,175,160,205,49.5,54.8,43.8,00000
26.0,14.0,83.0,916,02,01,  Kandikul,66,110,37,53,29,57,37.5,41.1,33.7,00000
26.0,14.0,83.0,916,03,01,  Katakhali,76,202,38,93,38,109,27.3,29.0,25.9,00000
26.0,14.0,88.0,172,01,01,  Bhadalia,456,269,237,120,219,149,62.9,66.4,59.5,00000
26.0,14.0,88.0,172,02,01,  Bhaban Nagar,95,215,46,105,49,110,30.6,30.5,30.8,00000
26.0,14.0,88.0,328,01,01,  Lalitanagar,129,147,71,64,58,83,46.7,52.6,41.1,00000
26.0,14.0,88.0,328,02,01,  Bituail,341,416,168,201,173,215,45.0,45.5,44.6,00000
26.0,14.0,88.0,328,03,01,  Anandanagar,570,713,302,304,268,409,44.4,49.8,39.6,00000
26.0,14.0,88.0,328,04,01,  Deldha,188,339,89,170,99,169,35.7,34.4,36.9,00000
26.0,14.0,88.0,328,05,01,  Esan Nagar,706,779,346,343,360,436,47.5,50.2,45.2,00000
26.0,14.0,88.0,328,06,01,  Naya Para,65,377,48,168,17,209,14.7,22.2,7.5,00000
26.0,14.0,88.0,328,07,01,  Baikanthapur,45,59,19,30,26,29,43.3,38.8,47.3,00000
26.0,14.0,88.0,328,08,01,  Char Deldha,150,176,73,89,77,87,46.0,45.1,47.0,00000
26.0,14.0,88.0,328,09,01,  Sialkul,458,628,240,308,218,320,42.2,43.8,40.5,00000
26.0,14.0,88.0,328,10,01,  Joy Tetulia,8,46,6,21,2,25,14.8,22.2,7.4,00000
26.0,14.0,88.0,614,01,01,  Kaurangi,594,682,284,309,310,373,46.6,47.9,45.4,00000
26.0,14.0,88.0,614,02,01,  Rauhartek,297,546,150,268,147,278,35.2,35.9,34.6,00000
26.0,14.0,88.0,825,01,01,  Rauha,483,405,247,171,236,234,54.4,59.1,50.2,00000
26.0,14.0,88.0,825,02,01,  Dantistanagar,146,177,75,86,71,91,45.2,46.6,43.8,00000
26.0,14.0,88.0,926,01,01,  Suapur,1007,636,524,282,483,354,61.3,65.0,57.7,00000
26.0,14.0,88.0,926,02,01,  Atani Para,71,254,40,125,31,129,21.8,24.2,19.4,00000
26.0,14.0,88.0,926,03,01,  Kutir Char,517,620,258,285,259,335,45.5,47.5,43.6,00000
26.0,14.0,88.0,926,04,01,  Gupinathpur,77,147,35,70,42,77,34.4,33.3,35.3,00000
26.0,14.0,94.0,071,01,01,  Balitha,655,802,398,426,257,376,45.0,48.3,40.6,00000
26.0,14.0,94.0,071,02,01,  Khalpar Balitha,142,254,70,116,72,138,35.9,37.6,34.3,00000
26.0,14.0,94.0,071,03,01,  Kisarinagar,145,209,75,101,70,108,41.0,42.6,39.3,00000
26.0,14.0,94.0,136,01,01,  Barta,191,303,102,145,89,158,38.7,41.3,36.0,00000
26.0,14.0,94.0,136,02,01,  Batarkhola,227,159,126,80,101,79,58.8,61.2,56.1,00000
26.0,14.0,94.0,136,03,01,  Naogaon,64,7,35,4,29,3,90.1,89.7,90.6,00000
26.0,14.0,94.0,146,01,01,  Bathuli,568,560,306,282,262,278,50.4,52.0,48.5,00000
26.0,14.0,94.0,146,02,01,  Khal Bathuli,64,254,44,125,20,129,20.1,26.0,13.4,00000
26.0,14.0,94.0,146,03,01,  Dakshin Bathuli,178,272,99,117,79,155,39.6,45.8,33.8,00000
26.0,14.0,94.0,159,01,01,  Belishwar,1209,1155,675,530,534,625,51.1,56.0,46.1,00000
26.0,14.0,94.0,159,02,01,  Saha Belishwar,182,199,115,96,67,103,47.8,54.5,39.4,00000
26.0,14.0,94.0,286,01,01,  Dakshin Naogaon,649,1053,374,536,275,517,38.1,41.1,34.7,00000
26.0,14.0,94.0,286,02,01,  Bara Paikhta,374,503,184,226,190,277,42.6,44.9,40.7,00000
26.0,14.0,94.0,692,01,01,  Nadgaonhati,198,192,103,87,95,105,50.8,54.2,47.5,00000
26.0,14.0,94.0,692,02,01,  Makarkhola,262,251,145,112,117,139,51.1,56.4,45.7,00000
26.0,14.0,94.0,923,01,01,  Sreerampur,2243,1875,1355,881,888,994,54.5,60.6,47.2,00000
26.0,14.0,94.0,923,02,01,  Dhaia,98,105,59,49,39,56,48.3,54.6,41.1,00000
26.0,18.0,13.0,276,01,01,  Debinapur Dakshin,873,1370,404,695,469,675,38.9,36.8,41.0,00000
26.0,18.0,13.0,276,02,01,  Debinapur Uttar,218,435,105,200,113,235,33.4,34.4,32.5,00000
26.0,18.0,13.0,871,01,01,  Radhanagar Dakshin,340,497,142,246,198,251,40.6,36.6,44.1,00000
26.0,18.0,13.0,871,02,01,  Radhanagar Uttar,268,512,107,245,161,267,34.4,30.4,37.6,00000
26.0,18.0,21.0,030,01,01,  Puspa Khali (Part-1),96,127,41,63,55,64,43.0,39.4,46.2,00000
26.0,18.0,21.0,030,02,01,  Arita,303,224,126,99,177,125,57.5,56.0,58.6,00000
26.0,18.0,21.0,030,03,01,  Iman Nagar (Part-11),211,99,95,37,116,62,68.1,72.0,65.2,00000
26.0,18.0,21.0,041,01,01,  Bara Basta,1463,743,666,344,797,399,66.3,65.9,66.6,00000
26.0,18.0,21.0,041,02,01,  Char Kushai (Part-2),215,213,100,98,115,115,50.2,50.5,50.0,00000
26.0,18.0,21.0,133,01,01,  Kartikpur (Part-3),398,162,179,67,219,95,71.1,72.8,69.7,00000
26.0,18.0,21.0,133,02,01,  Char Kusai(Part-3),131,91,53,41,78,50,59.0,56.4,60.9,00000
26.0,18.0,21.0,194,01,01,  Char Kusai(Part-1),1991,1143,893,540,1098,603,63.5,62.3,64.6,00000
26.0,18.0,21.0,194,02,01,  Kartikpur (Part-2),134,43,61,21,73,22,75.7,74.4,76.8,00000
26.0,18.0,21.0,225,01,01,  Auliabad,438,323,201,136,237,187,57.6,59.6,55.9,00000
26.0,18.0,21.0,225,02,01,  Imamnagar(Part-1),93,14,39,3,54,11,86.9,92.9,83.1,00000
26.0,18.0,21.0,235,01,01,  Babur Dangi,169,240,76,128,93,112,41.3,37.3,45.4,00000
26.0,18.0,21.0,235,02,01,  Puspa Khali (Part-2),185,87,65,43,120,44,68.0,60.2,73.2,00000
26.0,18.0,21.0,461,01,01,  Kartikpur (Part-1),770,416,333,198,437,218,64.9,62.7,66.7,00000
26.0,18.0,21.0,461,02,01,  Sunduri Para (Part-2),605,320,267,150,338,170,65.4,64.0,66.5,00000
26.0,18.0,21.0,861,01,01,  Purulia,468,459,219,214,249,245,50.5,50.6,50.4,00000
26.0,18.0,21.0,861,02,01,  Sunduri Para(Part-I),258,173,114,73,144,100,59.9,61.0,59.0,00000
26.0,18.0,21.0,943,01,01,  Uttar Silakota,1032,731,481,349,551,382,58.5,58.0,59.1,00000
26.0,18.0,21.0,943,02,01,  Dakshin Silakota,1734,1014,860,471,874,543,63.1,64.6,61.7,00000
26.0,18.0,42.0,502,01,01,  Kharia,654,363,339,179,315,184,64.3,65.4,63.1,00000
26.0,18.0,42.0,502,02,01,  Ultadanga,183,140,89,52,94,88,56.7,63.1,51.6,00000
26.0,18.0,42.0,502,03,01,  Khasertek,194,146,84,70,110,76,57.1,54.5,59.1,00000
26.0,18.0,42.0,605,01,01,  Madhurkhola,615,434,235,195,380,239,58.6,54.7,61.4,00000
26.0,18.0,42.0,605,02,01,  Baniabari,242,286,116,131,126,155,45.8,47.0,44.8,00000
26.0,18.0,42.0,605,03,01,  Hariartek,194,243,92,121,102,122,44.4,43.2,45.5,00000
26.0,18.0,42.0,605,04,01,  Ruitha (Part-11),62,101,26,43,36,58,38.0,37.7,38.3,00000
26.0,18.0,42.0,635,01,01,  Mait Para,1358,542,615,227,743,315,71.5,73.0,70.2,00000
26.0,18.0,42.0,635,02,01,  Ruittha (Part-1),248,143,115,64,133,79,63.4,64.2,62.7,00000
26.0,18.0,42.0,707,01,01,  Muksudpur,2499,1161,1209,488,1290,673,68.3,71.2,65.7,00000
26.0,18.0,42.0,707,02,01,  Purbachar,388,357,165,176,223,181,52.1,48.4,55.2,00000
26.0,18.0,42.0,707,03,01,  Ghoraban,739,273,339,116,400,157,73.0,74.5,71.8,00000
26.0,18.0,42.0,707,04,01,  Dalarpar,587,328,255,147,332,181,64.2,63.4,64.7,00000
26.0,18.0,42.0,820,01,01,  Maura,1602,1344,682,625,920,719,54.4,52.2,56.1,00000
26.0,18.0,42.0,820,02,01,  Chhotrabhogh,252,188,127,90,125,98,57.3,58.5,56.1,00000
26.0,18.0,42.0,820,03,01,  Dithpur,1037,1097,458,535,579,562,48.6,46.1,50.7,00000
26.0,18.0,52.0,420,01,01,  Jhanki,2114,1150,873,483,1241,667,64.8,64.4,65.0,00000
26.0,18.0,52.0,420,02,01,  Uttar Shimulia (Part-Ii),596,286,253,125,343,161,67.6,66.9,68.1,00000
26.0,18.0,52.0,687,01,01,  Meghula,1490,1260,737,620,753,640,54.2,54.3,54.1,00000
26.0,18.0,52.0,687,02,01,  Ranipur,288,780,120,407,168,373,27.0,22.8,31.1,00000
26.0,18.0,52.0,759,01,01,  Narisha Paschimchar(P-Ii),1083,1126,460,539,623,587,49.0,46.0,51.5,00000
26.0,18.0,52.0,759,02,01,  Narisha Khalpar (Part-I),811,511,371,223,440,288,61.3,62.5,60.4,00000
26.0,18.0,52.0,923,01,01,  Satbhita,1581,723,712,329,869,394,68.6,68.4,68.8,00000
26.0,18.0,52.0,923,02,01,  Ruita,293,227,117,101,176,126,56.3,53.7,58.3,00000
26.0,18.0,52.0,923,03,01,  Narisha (Part-11),992,682,470,346,522,336,59.3,57.6,60.8,00000
26.0,18.0,52.0,923,04,01,  Chatita Batar,781,470,319,199,462,271,62.4,61.6,63.0,00000
26.0,18.0,52.0,923,05,01,  Narisha Khalpar (Part-Ii),976,402,428,163,548,239,70.8,72.4,69.6,00000
26.0,18.0,52.0,923,06,01,  Narisha Paschimchar(P-I),889,430,392,180,497,250,67.4,68.5,66.5,00000
26.0,18.0,52.0,953,01,01,  Uttar Shimulia (Part-I),1298,1004,539,515,759,489,56.4,51.1,60.8,00000
26.0,18.0,52.0,953,02,01,  Dakshin Shimulia,2442,1155,1048,512,1394,643,67.9,67.2,68.4,00000
26.0,18.0,52.0,953,03,01,  Narisha Paschimchar(P-Ii),516,664,227,323,289,341,43.7,41.3,45.9,00000
26.0,18.0,52.0,953,04,01,  Talputipara,138,330,68,188,70,142,29.5,26.6,33.0,00000
26.0,18.0,63.0,256,01,01,  Bahra,1279,979,616,445,663,534,56.6,58.1,55.4,00000
26.0,18.0,63.0,256,02,01,  Anta,1568,1026,765,437,803,589,60.4,63.6,57.7,00000
26.0,18.0,63.0,256,03,01,  Purba Dhoair,519,288,226,123,293,165,64.3,64.8,64.0,00000
26.0,18.0,63.0,512,01,01,  Uttar Awranagbad,622,424,307,183,315,241,59.5,62.7,56.7,00000
26.0,18.0,63.0,512,02,01,  Madhya Awranagbad,620,397,326,189,294,208,61.0,63.3,58.6,00000
26.0,18.0,63.0,512,03,01,  Dakshin Awrangabad,250,94,135,46,115,48,72.7,74.6,70.6,00000
26.0,18.0,63.0,512,04,01,  Pankundu (P-11),166,116,88,48,78,68,58.9,64.7,53.4,00000
26.0,18.0,63.0,810,01,01,  Pankunda (Part-1),409,249,193,114,216,135,62.2,62.9,61.5,00000
26.0,18.0,63.0,810,02,01,  Paschim Dhoair,819,540,404,263,415,277,60.3,60.6,60.0,00000
26.0,18.0,73.0,051,01,01,  Ekrasi,2895,1443,1287,636,1608,807,66.7,66.9,66.6,00000
26.0,18.0,73.0,051,02,01,  Lakshmi Prasad,607,303,230,147,377,156,66.7,61.0,70.7,00000
26.0,18.0,73.0,051,03,01,  Hatur Para,199,148,90,65,109,83,57.3,58.1,56.8,00000
26.0,18.0,73.0,051,04,01,  Palamganj,401,212,202,114,199,98,65.4,63.9,67.0,00000
26.0,18.0,73.0,492,01,01,  Khalpar,1585,1112,714,532,871,580,58.8,57.3,60.0,00000
26.0,18.0,73.0,492,02,01,  Islampur Khalpar,404,329,184,157,220,172,55.1,54.0,56.1,00000
26.0,18.0,73.0,492,03,01,  Islampur,583,604,252,287,331,317,49.1,46.8,51.1,00000
26.0,18.0,73.0,492,04,01,  Kathali Gmata,368,233,139,102,229,131,61.2,57.7,63.6,00000
26.0,18.0,73.0,584,01,01,  Biler Par,1148,679,567,305,581,374,62.8,65.0,60.8,00000
26.0,18.0,73.0,584,02,01,  Nager Kanda,679,541,306,259,373,282,55.7,54.2,56.9,00000
26.0,18.0,73.0,584,03,01,  Char Nager Kanda,98,216,50,111,48,105,31.2,31.1,31.4,00000
26.0,18.0,73.0,902,01,01,  Raghudebpur,215,107,91,53,124,54,66.8,63.2,69.7,00000
26.0,18.0,73.0,902,02,01,  Karimganj,124,115,61,51,63,64,51.9,54.5,49.6,00000
26.0,18.0,84.0,317,01,01,  Nikra,528,509,228,285,300,224,50.9,44.4,57.3,00000
26.0,18.0,84.0,317,02,01,  Dohar Ghata,2692,1701,1174,799,1518,902,61.3,59.5,62.7,00000
26.0,18.0,84.0,317,03,01,  Banaghata,1259,906,520,424,739,482,58.2,55.1,60.5,00000
26.0,18.0,84.0,317,04,01,  Katkhali,999,678,456,334,543,344,59.6,57.7,61.2,00000
26.0,18.0,84.0,677,01,01,  Ghar Maura,205,164,92,82,113,82,55.6,52.9,57.9,00000
26.0,18.0,84.0,677,02,01,  Munshikanda,518,285,204,126,314,159,64.5,61.8,66.4,00000
26.0,18.0,84.0,974,01,01,  Pachim Sutar Para,1909,821,853,369,1056,452,69.9,69.8,70.0,00000
26.0,18.0,84.0,974,02,01,  Purba Sutar Para,1106,533,488,233,618,300,67.5,67.7,67.3,00000
26.0,18.0,84.0,974,03,01,  Dohar,1160,906,508,418,652,488,56.1,54.9,57.2,00000
26.0,18.0,84.0,974,04,01,  Dairkum,587,385,227,202,360,183,60.4,52.9,66.3,00000
26.0,18.0,84.0,974,05,01,  Gazir Tek,1025,652,416,290,609,362,61.1,58.9,62.7,00000
26.0,18.0,84.0,974,06,01,  Daiya Gazaria,672,389,288,180,384,209,63.3,61.5,64.8,00000
26.0,18.0,84.0,974,07,01,  Mizan Nagar,129,297,52,139,77,158,30.3,27.2,32.8,00000
26.0,29.0,35.0,248,01,03,  Uttar Kutubkhali,2301,1176,1313,653,988,523,66.2,66.8,65.4,00000
26.0,29.0,35.0,248,02,03,  Kutubkhali,7831,2722,4427,1382,3404,1340,74.2,76.2,71.8,00000
26.0,29.0,35.0,248,03,03,  Gobindarpur,16773,5897,9229,2999,7544,2898,74.0,75.5,72.2,00000
26.0,29.0,35.0,248,04,03,  Dakshin Kutubkhali,1473,594,794,298,679,296,71.3,72.7,69.6,00000
26.0,29.0,35.0,248,05,03,  Rasulpur,9549,1037,5018,474,4531,563,90.2,91.4,88.9,00000
26.0,29.0,35.0,248,06,03,  Kazla/Dakshin Kazla,5726,1324,3232,664,2494,660,81.2,83.0,79.1,00000
26.0,29.0,35.0,248,07,03,  Kabirajbagh,2755,644,1509,309,1246,335,81.1,83.0,78.8,00000
26.0,29.0,35.0,248,08,03,  Shekhdee,15646,4726,8490,2381,7156,2345,76.8,78.1,75.3,00000
26.0,29.0,35.0,248,09,03,  Das Para,5127,1284,2899,737,2228,547,80.0,79.7,80.3,00000
26.0,29.0,35.0,248,10,03,  Naya Nagar/Kazla,5137,1476,2983,767,2154,709,77.7,79.5,75.2,00000
26.0,29.0,35.0,248,11,03,  Sontek,5684,962,3126,491,2558,471,85.5,86.4,84.5,00000
26.0,29.0,35.0,248,12,03,  Baganbari,4134,1454,2383,751,1751,703,74.0,76.0,71.4,00000
26.0,29.0,80.0,635,01,03,  Matuail (Part),20164,9486,10762,4701,9402,4785,68.0,69.6,66.3,00000
26.0,29.0,80.0,635,02,03,  Bhanga Press,2488,1802,1546,1110,942,692,58.0,58.2,57.6,00000
26.0,29.0,80.0,635,03,03,  Kajlar Par,6886,4410,3805,2290,3081,2120,61.0,62.4,59.2,00000
26.0,29.0,80.0,635,04,03,  Kajirgaon,6082,2058,3596,1175,2486,883,74.7,75.4,73.8,00000
26.0,29.0,80.0,635,05,03,  Kona Para,2392,1214,1289,605,1103,609,66.3,68.1,64.4,00000
26.0,29.0,80.0,635,06,03,  Momen Bagh(Uttar),849,311,455,152,394,159,73.2,75.0,71.2,00000
26.0,29.0,80.0,635,07,03,  Rayerbagh (Part),6029,2283,3387,1235,2642,1048,72.5,73.3,71.6,00000
26.0,29.0,80.0,635,08,03,  Moslim Nagar,3314,1202,1841,623,1473,579,73.4,74.7,71.8,00000
26.0,29.0,80.0,635,09,03,  Moghal Nagar,1376,664,818,379,558,285,67.5,68.3,66.2,00000
26.0,29.0,80.0,635,10,03,  Islam Nagar,1368,527,910,301,458,226,72.2,75.1,67.0,00000
26.0,29.0,80.0,635,11,03,  Baniar Bagh,1825,721,1077,391,748,330,71.7,73.4,69.4,00000
26.0,29.0,80.0,635,12,03,  Matuail Dakshin Para,4451,2500,2462,1270,1989,1230,64.0,66.0,61.8,00000
26.0,29.0,80.0,635,13,03,  Rahamatpur(Part),330,36,178,19,152,17,90.2,90.4,89.9,00000
26.0,29.0,80.0,635,14,03,  Khariapara,1724,996,933,514,791,482,63.4,64.5,62.1,00000
26.0,29.0,80.0,635,15,03,  Keranipara,2294,2161,1254,1078,1040,1083,51.5,53.8,49.0,00000
26.0,29.0,80.0,635,16,03,  Momen Bagh(Dakshin),726,338,381,161,345,177,68.2,70.3,66.1,00000
26.0,29.0,80.0,773,01,03,  Para Dagar (Part),9297,4386,5220,2235,4077,2151,67.9,70.0,65.5,00000
26.0,29.0,80.0,773,02,03,  Momen Bagh(Purba),6530,3345,3510,1617,3020,1728,66.1,68.5,63.6,00000
26.0,32.0,35.0,248,01,03,  Nur Bagh,4784,2022,2789,1043,1995,979,70.3,72.8,67.1,00000
26.0,32.0,35.0,248,02,03,  Puratan Dhania (Part),3467,1605,1885,810,1582,795,68.4,69.9,66.6,00000
26.0,32.0,35.0,248,03,03,  Sarai,5974,2523,3185,1223,2789,1300,70.3,72.3,68.2,00000
26.0,32.0,35.0,248,04,03,  Nur Pur,16398,4471,8801,2160,7597,2311,78.6,80.3,76.7,00000
26.0,32.0,35.0,248,05,03,  Dakshin Dhania,9066,3196,4929,1797,4137,1399,73.9,73.3,74.7,00000
26.0,32.0,35.0,248,06,03,  Pater Bagh,2077,862,1146,462,931,400,70.7,71.3,69.9,00000
26.0,32.0,35.0,248,07,03,  Mukta Dhara,939,275,507,159,432,116,77.3,76.1,78.8,00000
26.0,32.0,35.0,248,08,03,  Islam Bagh,295,191,156,97,139,94,60.7,61.7,59.7,00000
26.0,32.0,35.0,248,09,03,  Palash Pur,11164,1596,6111,777,5053,819,87.5,88.7,86.1,00000
26.0,32.0,35.0,248,10,03,  Janata Bagh,7758,1886,4323,958,3435,928,80.4,81.9,78.7,00000
26.0,32.0,35.0,248,11,03,  Dakshin Rayerbagh,4284,793,2508,457,1776,336,84.4,84.6,84.1,00000
26.0,32.0,35.0,248,12,03,  Sreeti Dhara,7898,1733,4375,922,3523,811,82.0,82.6,81.3,00000
26.0,32.0,35.0,248,13,03,  Madina Bagh,3892,825,2125,395,1767,430,82.5,84.3,80.4,00000
26.0,32.0,35.0,248,14,03,  Meraj Nagar,2269,467,1267,249,1002,218,82.9,83.6,82.1,00000
26.0,32.0,35.0,248,15,03,  Sahjalalbag,1761,652,936,305,825,347,73.0,75.4,70.4,00000
26.0,32.0,35.0,248,16,03,  Pashim Paterbag,964,640,511,328,453,312,60.1,60.9,59.2,00000
26.0,32.0,35.0,248,17,03,  Mina Bag,1816,790,969,409,847,381,69.7,70.3,69.0,00000
26.0,32.0,35.0,248,18,03,  Bandhu Nibash (R/A),280,67,142,31,138,36,80.7,82.1,79.3,00000
26.0,32.0,35.0,248,19,03,  Rahmatbag,2883,1330,1535,659,1348,671,68.4,70.0,66.8,00000
26.0,32.0,35.0,248,20,03,  Rasulbag,2500,1385,1342,759,1158,626,64.4,63.9,64.9,00000
26.0,32.0,35.0,248,21,03,  Adesh Bagicha Bag,1052,729,604,368,448,361,59.1,62.1,55.4,00000
26.0,32.0,80.0,635,01,03,  Matuail,3307,1152,1799,603,1508,549,74.2,74.9,73.3,00000
26.0,32.0,80.0,635,02,03,  Tushar Dhara,2890,1044,1723,548,1167,496,73.5,75.9,70.2,00000
26.0,32.0,80.0,635,03,03,  Shamimbagh,824,335,436,166,388,169,71.1,72.4,69.7,00000
26.0,32.0,80.0,635,04,03,  Habib Nagar,604,142,337,70,267,72,81.0,82.8,78.8,00000
26.0,32.0,95.0,027,01,03,  Ali Bahar,4171,1693,2529,937,1642,756,71.1,73.0,68.5,00000
26.0,32.0,95.0,027,02,03,  Natun Ali Bahar,760,547,544,415,216,132,58.1,56.7,62.1,00000
26.0,32.0,95.0,027,03,03,  Ali Bahar Army Staff Quater,381,13,323,8,58,5,96.7,97.6,92.1,00000
26.0,32.0,95.0,497,01,03,  Kadamtali Shilpa Elaka,9007,5185,6015,2981,2992,2204,63.5,66.9,57.6,00000
26.0,32.0,95.0,497,02,03,  Kadamtali,1494,1056,1041,690,453,366,58.6,60.1,55.3,00000
26.0,32.0,95.0,497,03,03,  Merajnagar,11641,3835,6348,1944,5293,1891,75.2,76.6,73.7,00000
26.0,32.0,95.0,497,04,03,  Bakchar,3592,3437,2667,2035,925,1402,51.1,56.7,39.8,00000
26.0,32.0,95.0,497,05,03,  Chakdah,758,355,554,233,204,122,68.1,70.4,62.6,00000
26.0,32.0,95.0,497,07,03,  Mohammadbagh,7358,3803,3809,1966,3549,1837,65.9,66.0,65.9,00000
26.0,32.0,95.0,497,08,03,  Purba Kadamtali,3681,2367,1910,1197,1771,1170,60.9,61.5,60.2,00000
26.0,32.0,95.0,912,01,03,  Shyampur Natun Basti,2743,1770,1514,979,1229,791,60.8,60.7,60.8,00000
26.0,32.0,95.0,912,02,03,  Nama Shyampur,6873,4420,3760,2192,3113,2228,60.9,63.2,58.3,00000
26.0,32.0,95.0,912,03,03,  Purba Nama Shyampur,7566,6509,4144,3329,3422,3180,53.8,55.5,51.8,00000
26.0,32.0,95.0,912,04,03,  Palpara Gulbag,3700,1927,2292,1066,1408,861,65.8,68.3,62.1,00000
26.0,36.0,60.0,690,01,03,  Rasulbag,2221,1136,1250,720,971,416,66.2,63.5,70.0,00000
26.0,36.0,60.0,690,02,03,  Paschim Nandi Para,6562,4768,3575,2466,2987,2302,57.9,59.2,56.5,00000
26.0,36.0,60.0,690,03,03,  Purba Nandi Para,2740,1480,1469,727,1271,753,64.9,66.9,62.8,00000
26.0,36.0,60.0,690,04,03,  Bank Colony,485,343,236,188,249,155,58.6,55.7,61.6,00000
26.0,36.0,60.0,690,05,03,  Newajbag,662,275,369,136,293,139,70.7,73.1,67.8,00000
26.0,36.0,60.0,690,06,03,  Maddaya Nandipara,5824,3383,3136,1654,2688,1729,63.3,65.5,60.9,00000
26.0,36.0,60.0,690,07,03,  Mahajer Colony,805,614,412,320,393,294,56.7,56.3,57.2,00000
26.0,36.0,85.0,359,01,03,  Fakirkhali,278,136,177,61,101,75,67.1,74.4,57.4,00000
26.0,36.0,85.0,359,02,03,  Edirkandi,440,148,269,62,171,86,74.8,81.3,66.5,00000
26.0,36.0,85.0,359,03,03,  Balurpar,726,269,400,115,326,154,73.0,77.7,67.9,00000
26.0,36.0,85.0,359,04,03,  Babur Jaiga,312,152,176,84,136,68,67.2,67.7,66.7,00000
26.0,36.0,85.0,359,05,03,  Daserkandi,1097,565,600,243,497,322,66.0,71.2,60.7,00000
26.0,36.0,85.0,690,01,03,  Lionhati,353,121,210,44,143,77,74.5,82.7,65.0,00000
26.0,36.0,85.0,690,02,03,  Nekdarpar,437,203,249,97,188,106,68.3,72.0,63.9,00000
26.0,36.0,85.0,690,03,03,  Shekher Jaiga,1324,720,748,344,576,376,64.8,68.5,60.5,00000
26.0,36.0,85.0,690,04,03,  Nayapara,260,94,151,43,109,51,73.4,77.8,68.1,00000
26.0,36.0,85.0,690,05,03,  Trimohani (Jorbhita/Imambhag),587,191,328,86,259,105,75.4,79.2,71.2,00000
26.0,36.0,85.0,690,06,03,  Purba Para (Trimohoni),479,207,274,92,205,115,69.8,74.9,64.1,00000
26.0,36.0,85.0,690,07,03,  Baigda,789,296,427,140,362,156,72.7,75.3,69.9,00000
26.0,36.0,85.0,690,08,03,  Tek Para (Trimohoni),568,138,307,57,261,81,80.5,84.3,76.3,00000
26.0,36.0,85.0,690,09,03,  Uttar Para (Trimohoni),1084,398,618,161,466,237,73.1,79.3,66.3,00000
26.0,36.0,85.0,690,10,03,  Maij Para (Trimohini),694,601,373,339,321,262,53.6,52.4,55.1,00000
26.0,36.0,85.0,690,11,03,  Paschim Para (Trimohini),928,393,518,216,410,177,70.2,70.6,69.8,00000
26.0,37.0,38.0,174,01,03,  Bara Barua,496,165,271,67,225,98,75.0,80.2,69.7,00000
26.0,37.0,38.0,174,02,03,  Barua Chowkidar Bari,88,24,45,8,43,16,78.6,84.9,72.9,00000
26.0,37.0,38.0,174,03,03,  Barua Dakshin Para,149,153,88,89,61,64,49.3,49.7,48.8,00000
26.0,37.0,38.0,174,04,03,  Barua Dewan Para,172,46,98,18,74,28,78.9,84.5,72.5,00000
26.0,37.0,38.0,174,05,03,  Barua Gachi Bari,203,114,108,54,95,60,64.0,66.7,61.3,00000
26.0,37.0,38.0,174,06,03,  Barua Goal Bari,255,186,133,88,122,98,57.8,60.2,55.5,00000
26.0,37.0,38.0,174,07,03,  Barua Gobaria Para,87,71,47,30,40,41,55.1,61.0,49.4,00000
26.0,37.0,38.0,174,08,03,  Barua Haji Bari,167,80,88,36,79,44,67.6,71.0,64.2,00000
26.0,37.0,38.0,174,09,03,  Barua Kazi Para,215,181,120,89,95,92,54.3,57.4,50.8,00000
26.0,37.0,38.0,174,10,03,  Barua Lahnia Para,272,104,162,53,110,51,72.3,75.3,68.3,00000
26.0,37.0,38.0,174,11,03,  Barua Langjani Para,612,286,349,125,263,161,68.2,73.6,62.0,00000
26.0,37.0,38.0,174,12,03,  Barua Maij Para,197,107,112,50,85,57,64.8,69.1,59.9,00000
26.0,37.0,38.0,174,13,03,  Barua Molla Bari,372,249,215,121,157,128,59.9,64.0,55.1,00000
26.0,37.0,38.0,174,14,03,  Barua Pach Kani,160,12,84,6,76,6,93.0,93.3,92.7,00000
26.0,37.0,38.0,174,15,03,  Barua Parulia,202,104,125,44,77,60,66.0,74.0,56.2,00000
26.0,37.0,38.0,174,16,03,  Barua Paschim Para,285,203,157,94,128,109,58.4,62.5,54.0,00000
26.0,37.0,38.0,174,17,03,  Barua Purba Para,91,29,52,16,39,13,75.8,76.5,75.0,00000
26.0,37.0,38.0,174,18,03,  Barua Raj Para,315,223,174,102,141,121,58.6,63.0,53.8,00000
26.0,37.0,38.0,174,19,03,  Barua Sabda Mara,166,82,120,46,46,36,66.9,72.3,56.1,00000
26.0,37.0,38.0,174,20,03,  Barua Shekh Bari,251,90,146,43,105,47,73.6,77.2,69.1,00000
26.0,37.0,38.0,174,21,03,  Barua Shilon Para,172,170,106,74,66,96,50.3,58.9,40.7,00000
26.0,37.0,38.0,174,22,03,  Barua Sikder Bari,484,204,272,103,212,101,70.3,72.5,67.7,00000
26.0,37.0,38.0,174,23,03,  Barua Uttar Para,481,177,265,69,216,108,73.1,79.3,66.7,00000
26.0,37.0,38.0,174,24,03,  Gayen Bari,46,36,23,20,23,16,56.1,53.5,59.0,00000
26.0,37.0,38.0,174,25,03,  Ghora Ati,83,37,38,18,45,19,69.2,67.9,70.3,00000
26.0,37.0,38.0,174,26,03,  Goda Damna,360,161,208,72,152,89,69.1,74.3,63.1,00000
26.0,37.0,38.0,174,27,03,  Jamun,129,42,80,19,49,23,75.4,80.8,68.1,00000
26.0,37.0,38.0,174,28,03,  Barua Baghan Bari,62,34,30,18,32,16,64.6,62.5,66.7,00000
26.0,37.0,49.0,373,01,03,  Dhelna Dakshin Para,151,101,89,57,62,44,59.9,61.0,58.5,00000
26.0,37.0,49.0,373,02,03,  Dhelna Purba Para,41,38,26,17,15,21,51.9,60.5,41.7,00000
26.0,37.0,49.0,373,03,03,  Dhelna Uttar Para,239,87,131,48,108,39,73.3,73.2,73.5,00000
26.0,37.0,49.0,398,01,03,  Dumni Bangla Para,574,215,305,102,269,113,72.8,74.9,70.4,00000
26.0,37.0,49.0,398,02,03,  Dumni Barudiar Tek,414,322,244,174,170,148,56.3,58.4,53.5,00000
26.0,37.0,49.0,398,03,03,  Dumni Khailad Para,206,58,113,19,93,39,78.0,85.6,70.5,00000
26.0,37.0,49.0,398,04,03,  Dumni Naya Para,686,571,411,304,275,267,54.6,57.5,50.7,00000
26.0,37.0,49.0,398,05,03,  Dumni Shialdi Para/Pink City,208,107,126,51,82,56,66.0,71.2,59.4,00000
26.0,37.0,49.0,398,06,03,  Dumni Tek Para,259,292,154,153,105,139,47.0,50.2,43.0,00000
26.0,37.0,49.0,398,07,03,  Dumni Ahabar Para/Pink City,537,321,415,241,122,80,62.6,63.3,60.4,00000
26.0,37.0,49.0,547,01,03,  Mastul Bhuiya Para(Uttar Para),489,325,269,153,220,172,60.1,63.7,56.1,00000
26.0,37.0,49.0,547,02,03,  Mastul Kha Para (Bak Para),343,218,225,104,118,114,61.1,68.4,50.9,00000
26.0,37.0,49.0,547,03,03,  Mastul Paschim Para,261,100,142,45,119,55,72.3,75.9,68.4,00000
26.0,37.0,49.0,750,01,03,  Patira Ahalia Para,211,280,116,127,95,153,43.0,47.7,38.3,00000
26.0,37.0,49.0,750,02,03,  Patira Bhuiya Para,352,338,204,181,148,157,51.0,53.0,48.5,00000
26.0,37.0,49.0,750,03,03,  Patira Jadhur Tek,88,42,45,22,43,20,67.7,67.2,68.3,00000
26.0,37.0,49.0,750,04,03,  Patira Kafila Bari,109,38,63,15,46,23,74.1,80.8,66.7,00000
26.0,37.0,49.0,750,05,03,  Patira Lengar Tek,43,28,21,14,22,14,60.6,60.0,61.1,00000
26.0,37.0,49.0,750,06,03,  Patira Maidha Para,577,593,328,308,249,285,49.3,51.6,46.6,00000
26.0,37.0,49.0,750,07,03,  Patira Paschim Para,284,372,148,190,136,182,43.3,43.8,42.8,00000
26.0,37.0,49.0,750,08,03,  Patira Purba Para,54,63,32,30,22,33,46.2,51.6,40.0,00000
26.0,37.0,49.0,750,09,03,  Patira Rishi Para,197,260,159,188,38,72,43.1,45.8,34.5,00000
26.0,37.0,49.0,750,10,03,  Patira Sonartek,87,44,49,21,38,23,66.4,70.0,62.3,00000
26.0,37.0,49.0,750,11,03,  Patira Dakshin Purba Para,333,466,178,233,155,233,41.7,43.3,39.9,00000
26.0,37.0,49.0,925,01,03,  Purba Talna/Batan Bari,84,16,51,3,33,13,84.0,94.4,71.7,00000
26.0,37.0,49.0,925,02,03,  Dhelna Mainar Tek,215,108,127,58,88,50,66.6,68.6,63.8,00000
26.0,37.0,49.0,925,03,03,  Nakuni,276,184,153,81,123,103,60.0,65.4,54.4,00000
26.0,37.0,49.0,925,04,03,  Talna Dakshin Para,170,74,90,30,80,44,69.7,75.0,64.5,00000
26.0,37.0,49.0,925,05,03,  Talna Paschim Para,141,37,89,19,52,18,79.2,82.4,74.3,00000
26.0,37.0,49.0,925,06,03,  Talna Purba Para,86,45,39,20,47,25,65.6,66.1,65.3,00000
26.0,37.0,49.0,925,07,03,  Talna Uttar Para,228,74,112,36,116,38,75.5,75.7,75.3,00000
26.0,38.0,11.0,386,01,01,  Charkutua Bagicha(Ambagicha),3243,2848,1733,1446,1510,1402,53.2,54.5,51.9,00000
26.0,38.0,11.0,386,02,01,  Nutun Subhadhya,1553,854,843,393,710,461,64.5,68.2,60.6,00000
26.0,38.0,11.0,386,03,01,  Char Kutub Uttar,733,514,395,234,338,280,58.8,62.8,54.7,00000
26.0,38.0,11.0,386,04,01,  Kadom Tali,2472,1895,1372,988,1100,907,56.6,58.1,54.8,00000
26.0,38.0,11.0,386,05,01,  Golam Bazar (Part),822,402,442,205,380,197,67.2,68.3,65.9,00000
26.0,38.0,11.0,867,01,01,  Kathura Pachim(Pachim Aganagar,2176,2005,1605,1427,571,578,52.0,52.9,49.7,00000
26.0,38.0,11.0,867,02,01,  Purba Malupara,3704,1930,2088,1025,1616,905,65.7,67.1,64.1,00000
26.0,38.0,11.0,867,03,01,  Pachimimmam Bari,891,1472,506,771,385,701,37.7,39.6,35.5,00000
26.0,38.0,11.0,867,04,01,  Purba Immambary,903,727,515,326,388,401,55.4,61.2,49.2,00000
26.0,38.0,11.0,867,05,01,  K.G.Sha Colony(Pachimaganagar),3270,2227,1919,1241,1351,986,59.5,60.7,57.8,00000
26.0,38.0,11.0,867,06,01,  Kathuria Purba(Pachim A.Nagar),3134,967,1941,527,1193,440,76.4,78.6,73.1,00000
26.0,38.0,11.0,867,07,01,  Nadidara Colony(Pachim Anagar),5513,1783,3231,1017,2282,766,75.6,76.1,74.9,00000
26.0,38.0,11.0,867,08,01,  Nagar Mohal(Pachim Aganar),2464,1417,1883,1047,581,370,63.5,64.3,61.1,00000
26.0,38.0,11.0,867,09,01,  Nama Para (Purba Aganagar),7215,3193,6134,2364,1081,829,69.3,72.2,56.6,00000
26.0,38.0,11.0,867,10,01,  Purba Aganasar (Dakhin),1365,819,818,404,547,415,62.5,66.9,56.9,00000
26.0,38.0,13.0,082,01,01,  Baghasur,1505,1440,698,687,807,753,51.1,50.4,51.7,00000
26.0,38.0,13.0,082,02,01,  Dakshin Goalkhali,1189,763,601,353,588,410,60.9,63.0,58.9,00000
26.0,38.0,13.0,172,01,01,  Uttar Goalkhali,593,213,319,93,274,120,73.6,77.4,69.5,00000
26.0,38.0,13.0,172,02,01,  Basta,514,320,311,149,203,171,61.6,67.6,54.3,00000
26.0,38.0,13.0,172,03,01,  Chhota Basta,135,168,71,84,64,84,44.6,45.8,43.2,00000
26.0,38.0,13.0,172,04,01,  Nayabari,92,45,51,17,41,28,67.2,75.0,59.4,00000
26.0,38.0,13.0,172,05,01,  Tilabari,31,13,18,6,13,7,70.5,75.0,65.0,00000
26.0,38.0,13.0,246,01,01,  Boali,197,234,96,115,101,119,45.7,45.5,45.9,00000
26.0,38.0,13.0,246,02,01,  Barta,114,88,64,52,50,36,56.4,55.2,58.1,00000
26.0,38.0,13.0,246,03,01,  Alatia,228,175,132,88,96,87,56.6,60.0,52.5,00000
26.0,38.0,13.0,320,01,01,  Rasulpur,1122,529,594,265,528,264,68.0,69.2,66.7,00000
26.0,38.0,13.0,320,02,01,  Baghapur,2118,1726,1099,784,1019,942,55.1,58.4,52.0,00000
26.0,38.0,13.0,320,03,01,  Bhauarbhiti,2414,1744,1179,822,1235,922,58.1,58.9,57.3,00000
26.0,38.0,13.0,320,04,01,  Darigaon,780,527,360,237,420,290,59.7,60.3,59.2,00000
26.0,38.0,13.0,320,05,01,  Battali,439,366,214,164,225,202,54.5,56.6,52.7,00000
26.0,38.0,13.0,320,06,01,  Malibhita (Dakshinpara),513,400,258,206,255,194,56.2,55.6,56.8,00000
26.0,38.0,13.0,452,01,01,  Dhitpur,155,195,77,96,78,99,44.3,44.5,44.1,00000
26.0,38.0,13.0,452,02,01,  Muchiasur,125,142,64,74,61,68,46.8,46.4,47.3,00000
26.0,38.0,13.0,452,03,01,  Kotlasur (Rajabari),229,200,121,94,108,106,53.4,56.3,50.5,00000
26.0,38.0,13.0,624,01,01,  Kazirgaon,246,212,132,98,114,114,53.7,57.4,50.0,00000
26.0,38.0,13.0,624,02,01,  Kumli Bhita,383,319,192,156,191,163,54.6,55.2,54.0,00000
26.0,38.0,13.0,641,01,01,  Konakhola,378,291,216,135,162,156,56.5,61.5,50.9,00000
26.0,38.0,13.0,641,02,01,  Konakhola (Barahati),298,101,169,54,129,47,74.7,75.8,73.3,00000
26.0,38.0,13.0,953,01,01,  Uttar Malibhita,415,325,205,138,210,187,56.1,59.8,52.9,00000
26.0,38.0,13.0,953,02,01,  Dakshin Rajabari,555,502,261,237,294,265,52.5,52.4,52.6,00000
26.0,38.0,13.0,953,03,01,  Uttar Rajabari,268,274,130,133,138,141,49.4,49.4,49.5,00000
26.0,38.0,17.0,287,01,01,  Alipur,547,740,301,357,246,383,42.5,45.7,39.1,00000
26.0,38.0,17.0,287,02,01,  Itabara,724,725,389,330,335,395,50.0,54.1,45.9,00000
26.0,38.0,17.0,287,03,01,  Kanar Char,687,940,384,477,303,463,42.2,44.6,39.6,00000
26.0,38.0,17.0,287,04,01,  Kadamtali,450,392,247,190,203,202,53.4,56.5,50.1,00000
26.0,38.0,17.0,287,05,01,  Sagirakandi,149,243,73,122,76,121,38.0,37.4,38.6,00000
26.0,38.0,17.0,287,06,01,  Bounakandi (Part),277,310,178,161,99,149,47.2,52.5,39.9,00000
26.0,38.0,17.0,337,01,01,  Langkar Char,416,509,227,244,189,265,45.0,48.2,41.6,00000
26.0,38.0,17.0,337,02,01,  Milkihati,252,365,129,183,123,182,40.8,41.3,40.3,00000
26.0,38.0,17.0,518,01,01,  Bounakandi (Part),561,718,318,321,243,397,43.9,49.8,38.0,00000
26.0,38.0,17.0,518,02,01,  Balur Char,1146,1820,568,810,578,1010,38.6,41.2,36.4,00000
26.0,38.0,17.0,518,03,01,  Rasulpur,370,509,168,224,202,285,42.1,42.9,41.5,00000
26.0,38.0,17.0,518,04,01,  Batarakandi,615,620,305,277,310,343,49.8,52.4,47.5,00000
26.0,38.0,17.0,518,05,01,  Algir Char,639,747,310,327,329,420,46.1,48.7,43.9,00000
26.0,38.0,17.0,518,06,01,  Bayatikandi,364,388,176,178,188,210,48.4,49.7,47.2,00000
26.0,38.0,17.0,518,07,01,  Hazratpur,412,602,222,320,190,282,40.6,41.0,40.3,00000
26.0,38.0,17.0,518,08,01,  Dalikandi,830,1276,412,585,418,691,39.4,41.3,37.7,00000
26.0,38.0,17.0,518,09,01,  Jagannathpur (Part),141,169,67,81,74,88,45.5,45.3,45.7,00000
26.0,38.0,17.0,518,10,01,  Quraishnagar (Bodhir Kandi),261,274,134,134,127,140,48.8,50.0,47.6,00000
26.0,38.0,17.0,518,11,01,  Kunihati,128,92,65,34,63,58,58.2,65.7,52.1,00000
26.0,38.0,17.0,526,01,01,  Hoglagati,323,478,159,227,164,251,40.3,41.2,39.5,00000
26.0,38.0,17.0,526,02,01,  Madhuar Char,429,328,197,149,232,179,56.7,56.9,56.4,00000
26.0,38.0,17.0,542,01,01,  Kazikandi,274,196,154,80,120,116,58.3,65.8,50.8,00000
26.0,38.0,17.0,542,02,01,  Jagannathpur,290,376,130,179,160,197,43.5,42.1,44.8,00000
26.0,38.0,17.0,698,01,01,  Maniknagar,1223,1119,595,543,628,576,52.2,52.3,52.2,00000
26.0,38.0,17.0,698,02,01,  Begamabad,493,470,243,241,250,229,51.2,50.2,52.2,00000
26.0,38.0,17.0,698,03,01,  Radhakantapur (Noorpur),506,268,259,121,247,147,65.4,68.2,62.7,00000
26.0,38.0,17.0,698,04,01,  Jagannathpur,377,663,171,333,206,330,36.3,33.9,38.4,00000
26.0,38.0,25.0,008,01,01,  Ahadipur,542,425,255,183,287,242,56.0,58.2,54.3,00000
26.0,38.0,25.0,008,02,01,  Bakshipur,320,69,144,34,176,35,82.3,80.9,83.4,00000
26.0,38.0,25.0,008,03,01,  Imandipur,99,25,45,13,54,12,79.8,77.6,81.8,00000
26.0,38.0,25.0,008,04,01,  Sadhupur,69,8,35,5,34,3,89.6,87.5,91.9,00000
26.0,38.0,25.0,008,05,01,  Badullapur,62,18,28,6,34,12,77.5,82.4,73.9,00000
26.0,38.0,25.0,008,06,01,  Ranjitpur,389,199,168,94,221,105,66.2,64.1,67.8,00000
26.0,38.0,25.0,008,07,01,  Taranagar,48,84,26,43,22,41,36.4,37.7,34.9,00000
26.0,38.0,25.0,008,08,01,  Nishanbari,306,390,153,195,153,195,44.0,44.0,44.0,00000
26.0,38.0,25.0,008,09,01,  Akchail (Shiddhapara),675,475,329,222,346,253,58.7,59.7,57.8,00000
26.0,38.0,25.0,024,01,01,  Akchail (Part-I),786,205,379,93,407,112,79.3,80.3,78.4,00000
26.0,38.0,25.0,024,02,01,  Akchail (Part-Ii),343,66,170,23,173,43,83.9,88.1,80.1,00000
26.0,38.0,25.0,024,03,01,  Char Akchail,312,241,161,116,151,125,56.4,58.1,54.7,00000
26.0,38.0,25.0,024,04,01,  Guaduri,423,296,205,120,218,176,58.8,63.1,55.3,00000
26.0,38.0,25.0,189,01,01,  Belna,835,507,410,229,425,278,62.2,64.2,60.5,00000
26.0,38.0,25.0,189,02,01,  Baburkandi,831,541,406,215,425,326,60.6,65.4,56.6,00000
26.0,38.0,25.0,189,03,01,  Kashkandi,493,394,229,172,264,222,55.6,57.1,54.3,00000
26.0,38.0,25.0,189,04,01,  Rishibari,52,176,25,87,27,89,22.8,22.3,23.3,00000
26.0,38.0,25.0,189,05,01,  Mollah Para,70,96,26,44,44,52,42.2,37.1,45.8,00000
26.0,38.0,25.0,213,01,01,  Bhandarkhola,469,359,268,265,201,94,56.6,50.3,68.1,00000
26.0,38.0,25.0,213,02,01,  Talepur,432,192,201,87,231,105,69.2,69.8,68.8,00000
26.0,38.0,25.0,213,03,01,  Rasulpur,178,27,77,12,101,15,86.8,86.5,87.1,00000
26.0,38.0,25.0,213,04,01,  Maraghona,289,37,149,11,140,26,88.7,93.1,84.3,00000
26.0,38.0,25.0,213,05,01,  Singashur,388,195,197,69,191,126,66.6,74.1,60.3,00000
26.0,38.0,25.0,213,06,01,  Niltek,306,177,156,81,150,96,63.4,65.8,61.0,00000
26.0,38.0,25.0,213,07,01,  Char Bhandarkhola,574,649,275,286,299,363,46.9,49.0,45.2,00000
26.0,38.0,25.0,213,08,01,  Kharakandi,694,623,437,352,257,271,52.7,55.4,48.7,00000
26.0,38.0,25.0,550,01,01,  Jainpur,836,312,400,126,436,186,72.8,76.0,70.1,00000
26.0,38.0,25.0,550,02,01,  Nagrasur,283,115,125,55,158,60,71.1,69.4,72.5,00000
26.0,38.0,25.0,550,03,01,  Chhota Belna,220,155,99,68,121,87,58.7,59.3,58.2,00000
26.0,38.0,25.0,550,04,01,  Chhatar Char,518,528,248,231,270,297,49.5,51.8,47.6,00000
26.0,38.0,25.0,550,05,01,  Baila (Kutibari),138,100,69,34,69,66,58.0,67.0,51.1,00000
26.0,38.0,25.0,583,01,01,  Saidpur,577,252,300,120,277,132,69.6,71.4,67.7,00000
26.0,38.0,25.0,583,02,01,  Kalatia Bazar,56,15,30,13,26,2,78.9,69.8,92.9,00000
26.0,38.0,25.0,583,03,01,  Samsherpur,382,204,191,99,191,105,65.2,65.9,64.5,00000
26.0,38.0,25.0,583,04,01,  Mithapur,765,426,364,209,401,217,64.2,63.5,64.9,00000
26.0,38.0,25.0,583,05,01,  Ashamdipur,295,211,143,105,152,106,58.3,57.7,58.9,00000
26.0,38.0,25.0,583,06,01,  Mirash Ashamdipur,181,208,90,105,91,103,46.5,46.2,46.9,00000
26.0,38.0,25.0,731,01,01,  Munshi Noadda,595,138,284,48,311,90,81.2,85.5,77.6,00000
26.0,38.0,25.0,731,02,01,  Sonartek,149,50,69,23,80,27,74.9,75.0,74.8,00000
26.0,38.0,25.0,731,03,01,  Puran Kalatia,97,26,35,13,62,13,78.9,72.9,82.7,00000
26.0,38.0,25.0,731,04,01,  Rashidpur,189,41,95,16,94,25,82.2,85.6,79.0,00000
26.0,38.0,34.0,065,01,01,  Atasur,202,199,113,97,89,102,50.4,53.8,46.6,00000
26.0,38.0,34.0,065,02,01,  Karer Dighirpar,103,95,60,42,43,53,52.0,58.8,44.8,00000
26.0,38.0,34.0,164,01,01,  Nekrose Bagh,878,412,456,197,422,215,68.1,69.8,66.2,00000
26.0,38.0,34.0,164,02,01,  Paschim Barisur,2456,1144,1315,526,1141,618,68.2,71.4,64.9,00000
26.0,38.0,34.0,164,03,01,  Purba Barisur,2081,1136,1113,566,968,570,64.7,66.3,62.9,00000
26.0,38.0,34.0,263,01,01,  Kholamora,968,623,543,315,425,308,60.8,63.3,58.0,00000
26.0,38.0,34.0,263,02,01,  Khagail,634,442,336,211,298,231,58.9,61.4,56.3,00000
26.0,38.0,34.0,263,03,01,  Deoshur,337,401,235,243,102,158,45.7,49.2,39.2,00000
26.0,38.0,34.0,263,04,01,  Paschim Brahmankritta,1384,764,794,361,590,403,64.4,68.7,59.4,00000
26.0,38.0,34.0,263,05,01,  Purba Brahmankritta,1303,557,725,284,578,273,70.1,71.9,67.9,00000
26.0,38.0,34.0,263,06,01,  Potkajore,351,204,196,100,155,104,63.2,66.2,59.8,00000
26.0,38.0,34.0,263,07,01,  Banda Potkajore,632,245,343,109,289,136,72.1,75.9,68.0,00000
26.0,38.0,34.0,263,08,01,  Madaripur,1051,189,541,87,510,102,84.8,86.1,83.3,00000
26.0,38.0,34.0,263,09,01,  Brahmankritta Malpara,355,419,191,196,164,223,45.9,49.4,42.4,00000
26.0,38.0,34.0,263,10,01,  Dhopasur,49,58,29,26,20,32,45.8,52.7,38.5,00000
26.0,38.0,34.0,263,11,01,  Brahmankritta Motilal,95,64,49,32,46,32,59.7,60.5,59.0,00000
26.0,38.0,34.0,501,01,01,  Gokpar,944,653,518,322,426,331,59.1,61.7,56.3,00000
26.0,38.0,34.0,501,02,01,  Muktirbagh,276,144,152,72,124,72,65.7,67.9,63.3,00000
26.0,38.0,34.0,501,03,01,  Bhagna,1885,1456,1017,736,868,720,56.4,58.0,54.7,00000
26.0,38.0,34.0,501,04,01,  Borhanibagh,521,576,296,295,225,281,47.5,50.1,44.5,00000
26.0,38.0,34.0,501,05,01,  Muslimbagh,350,221,182,113,168,108,61.3,61.7,60.9,00000
26.0,38.0,34.0,501,06,01,  Khalpur Charail,364,280,194,137,170,143,56.5,58.6,54.3,00000
26.0,38.0,34.0,501,07,01,  Bara Charail,741,207,412,87,329,120,78.2,82.6,73.3,00000
26.0,38.0,34.0,501,08,01,  Madhya Charail,1117,913,616,452,501,461,55.0,57.7,52.1,00000
26.0,38.0,34.0,501,09,01,  Hajibari Charail,532,322,286,167,246,155,62.3,63.1,61.3,00000
26.0,38.0,34.0,501,10,01,  Hindu Charail,502,315,276,147,226,168,61.4,65.2,57.4,00000
26.0,38.0,34.0,501,11,01,  Purba Charail,2661,1479,1437,715,1224,764,64.3,66.8,61.6,00000
26.0,38.0,43.0,016,01,01,  Paschim Ainta,1779,1514,901,741,878,773,54.0,54.9,53.2,00000
26.0,38.0,43.0,016,02,01,  Purba Ainta,941,942,493,459,448,483,50.0,51.8,48.1,00000
26.0,38.0,43.0,016,03,01,  Manurbagh,422,175,246,84,176,91,70.7,74.5,65.9,00000
26.0,38.0,43.0,041,01,01,  Mirzapur,391,166,225,62,166,104,70.2,78.4,61.5,00000
26.0,38.0,43.0,041,02,01,  Paschim Arakul,249,286,136,143,113,143,46.5,48.7,44.1,00000
26.0,38.0,43.0,041,03,01,  Purba Arakul,476,299,238,137,238,162,61.4,63.5,59.5,00000
26.0,38.0,43.0,041,04,01,  Nayamati,44,58,21,21,23,37,43.1,50.0,38.3,00000
26.0,38.0,43.0,106,01,01,  Uttar Puran Baktar Char,596,512,299,237,297,275,53.8,55.8,51.9,00000
26.0,38.0,43.0,106,02,01,  Dakshin Puran Baktar Char,441,288,231,134,210,154,60.5,63.3,57.7,00000
26.0,38.0,43.0,106,03,01,  Paschim Alikanda,545,365,271,163,274,202,59.9,62.4,57.6,00000
26.0,38.0,43.0,106,04,01,  Purba Alikanda,589,472,301,234,288,238,55.5,56.3,54.8,00000
26.0,38.0,43.0,106,05,01,  Paschim Nutan Baktar Char,796,195,400,90,396,105,80.3,81.6,79.0,00000
26.0,38.0,43.0,106,06,01,  Purba Nutan Baktar Char,576,355,299,152,277,203,61.9,66.3,57.7,00000
26.0,38.0,43.0,106,07,01,  Paschim Ghoshkanda,379,382,188,178,191,204,49.8,51.4,48.4,00000
26.0,38.0,43.0,106,08,01,  Madhya Ghoshkanda,414,307,197,146,217,161,57.4,57.4,57.4,00000
26.0,38.0,43.0,106,09,01,  Purba Ghoshkanda,604,276,324,102,280,174,68.6,76.1,61.7,00000
26.0,38.0,43.0,106,10,01,  Konder Char,318,391,160,174,158,217,44.9,47.9,42.1,00000
26.0,38.0,43.0,230,01,01,  Noadda,275,470,138,225,137,245,36.9,38.0,35.9,00000
26.0,38.0,43.0,230,02,01,  Bir Baghair,749,1574,385,885,364,689,32.2,30.3,34.6,00000
26.0,38.0,43.0,254,01,01,  Purba Brahmangaon,467,682,252,356,215,326,40.6,41.4,39.7,00000
26.0,38.0,43.0,254,02,01,  Paschim Brahmangaon,308,687,172,347,136,340,31.0,33.1,28.6,00000
26.0,38.0,43.0,460,01,01,  Paschim Doleshwar,3124,2374,1693,1237,1431,1137,56.8,57.8,55.7,00000
26.0,38.0,43.0,460,02,01,  Purba Doleshwar,1691,1292,951,659,740,633,56.7,59.1,53.9,00000
26.0,38.0,43.0,559,01,01,  Madhyer Char,140,160,85,84,55,76,46.7,50.3,42.0,00000
26.0,38.0,43.0,559,02,01,  Purba Janjira,321,397,172,205,149,192,44.7,45.6,43.7,00000
26.0,38.0,43.0,559,03,01,  Paschim Janjira,329,490,178,241,151,249,40.2,42.5,37.8,00000
26.0,38.0,43.0,616,01,01,  Katuail,2230,1438,1252,669,978,769,60.8,65.2,56.0,00000
26.0,38.0,43.0,616,02,01,  Katuail Shilpa Elaka,716,607,439,398,277,209,54.1,52.4,57.0,00000
26.0,38.0,43.0,616,03,01,  Kandar Para,675,534,365,266,310,268,55.8,57.8,53.6,00000
26.0,38.0,43.0,616,04,01,  Dighali Para,245,202,131,87,114,115,54.8,60.1,49.8,00000
26.0,38.0,43.0,797,01,01,  Kazirgaon,986,1011,543,494,443,517,49.4,52.4,46.1,00000
26.0,38.0,43.0,797,02,01,  Uttar Pangaon,2418,1987,1297,987,1121,1000,54.9,56.8,52.9,00000
26.0,38.0,43.0,797,03,01,  Dakshin Pangaon,1133,1017,617,510,516,507,52.7,54.7,50.4,00000
26.0,38.0,51.0,444,01,01,  Dharnasur,979,1033,466,500,513,533,48.7,48.2,49.0,00000
26.0,38.0,51.0,444,02,01,  Ruhitpur Kacha Bazar,956,381,501,183,455,198,71.5,73.2,69.7,00000
26.0,38.0,51.0,723,01,01,  Mugar Char,1867,1778,925,847,942,931,51.2,52.2,50.3,00000
26.0,38.0,51.0,723,02,01,  Char Ruhitpur,773,1060,400,522,373,538,42.2,43.4,40.9,00000
26.0,38.0,51.0,723,03,01,  Porahati,406,422,194,188,212,234,49.0,50.8,47.5,00000
26.0,38.0,51.0,723,04,01,  Char Dharmasur,1732,964,876,438,856,526,64.2,66.7,61.9,00000
26.0,38.0,51.0,723,05,01,  Lakir Char (Part),564,975,306,498,258,477,36.6,38.1,35.1,00000
26.0,38.0,51.0,863,01,01,  Ruhitpur,1531,693,812,319,719,374,68.8,71.8,65.8,00000
26.0,38.0,51.0,863,02,01,  Anarpur,448,318,249,177,199,141,58.5,58.5,58.5,00000
26.0,38.0,51.0,863,03,01,  Mohanpur,361,214,172,109,189,105,62.8,61.2,64.3,00000
26.0,38.0,51.0,912,01,01,  Sonakanda,1769,1639,861,722,908,917,51.9,54.4,49.8,00000
26.0,38.0,51.0,912,02,01,  Nutan Sonakanda,463,513,241,238,222,275,47.4,50.3,44.7,00000
26.0,38.0,51.0,912,03,01,  Sahapur,762,350,465,173,297,177,68.5,72.9,62.7,00000
26.0,38.0,51.0,912,04,01,  Bhasan Char,486,214,255,92,231,122,69.4,73.5,65.4,00000
26.0,38.0,51.0,912,05,01,  Baluatek,608,555,280,240,328,315,52.3,53.8,51.0,00000
26.0,38.0,51.0,912,06,01,  Lakir Char,743,609,350,283,393,326,55.0,55.3,54.7,00000
26.0,38.0,51.0,912,07,01,  Char Sonakhanda,253,393,122,202,131,191,39.2,37.7,40.7,00000
26.0,38.0,60.0,057,01,01,  Atigram,1156,603,606,280,550,323,65.7,68.4,63.0,00000
26.0,38.0,60.0,057,02,01,  Dari Para,792,451,435,215,357,236,63.7,66.9,60.2,00000
26.0,38.0,60.0,057,03,01,  Hijla,1106,718,591,336,515,382,60.6,63.8,57.4,00000
26.0,38.0,60.0,057,04,01,  Kanargaon,196,210,102,108,94,102,48.3,48.6,48.0,00000
26.0,38.0,60.0,057,05,01,  Purana Panchadana,313,187,174,92,139,95,62.6,65.4,59.4,00000
26.0,38.0,60.0,057,06,01,  Yousub Khangram,556,480,298,230,258,250,53.7,56.4,50.8,00000
26.0,38.0,60.0,057,07,01,  Atikuti,276,965,164,553,112,412,22.2,22.9,21.4,00000
26.0,38.0,60.0,057,08,01,  Mal Quadir Mastergram,443,364,231,187,212,177,54.9,55.3,54.5,00000
26.0,38.0,60.0,057,09,01,  Mobrk Beparir Gram,508,276,262,130,246,146,64.8,66.8,62.8,00000
26.0,38.0,60.0,057,10,01,  Tebargram,503,249,257,128,246,121,66.9,66.8,67.0,00000
26.0,38.0,60.0,057,11,01,  Anamatgaon,216,138,114,68,102,70,61.0,62.6,59.3,00000
26.0,38.0,60.0,057,12,01,  Hani Bepari Fgram,238,133,124,53,114,80,64.2,70.1,58.8,00000
26.0,38.0,60.0,057,13,01,  Karim Hazigram,939,389,503,171,436,218,70.7,74.6,66.7,00000
26.0,38.0,60.0,057,14,01,  Kolchar,643,231,343,107,300,124,73.6,76.2,70.8,00000
26.0,38.0,60.0,057,15,01,  Joal Char,554,419,302,208,252,211,56.9,59.2,54.4,00000
26.0,38.0,60.0,057,16,01,  Bamansur,1464,525,776,202,688,323,73.6,79.3,68.1,00000
26.0,38.0,60.0,057,17,01,  Baher Char,354,117,193,50,161,67,75.2,79.4,70.6,00000
26.0,38.0,60.0,057,18,01,  Royer Char,543,705,286,346,257,359,43.5,45.3,41.7,00000
26.0,38.0,60.0,057,19,01,  Nurar Char,302,151,159,64,143,87,66.7,71.3,62.2,00000
26.0,38.0,60.0,115,01,01,  Balsata,1034,827,579,406,455,421,55.6,58.8,51.9,00000
26.0,38.0,60.0,115,02,01,  Narandi,458,425,253,221,205,204,51.9,53.4,50.1,00000
26.0,38.0,60.0,115,03,01,  Bainatala,107,263,67,142,40,121,28.9,32.1,24.8,00000
26.0,38.0,60.0,115,04,01,  Kashi Malta,117,275,81,143,36,132,29.8,36.2,21.4,00000
26.0,38.0,60.0,115,05,01,  Mekail,114,350,58,206,56,144,24.6,22.0,28.0,00000
26.0,38.0,60.0,115,06,01,  Agrakhola,365,69,194,32,171,37,84.1,85.8,82.2,00000
26.0,38.0,60.0,139,01,01,  Gaurisingha,294,162,181,74,113,88,64.5,71.0,56.2,00000
26.0,38.0,60.0,139,02,01,  Sikaritala,950,625,529,300,421,325,60.3,63.8,56.4,00000
26.0,38.0,60.0,139,03,01,  Baburgaon,564,170,317,62,247,108,76.8,83.6,69.6,00000
26.0,38.0,60.0,222,01,01,  Bharalia (Puran),1389,479,761,212,628,267,74.4,78.2,70.2,00000
26.0,38.0,60.0,222,02,01,  Kholamura,943,546,506,270,437,276,63.3,65.2,61.3,00000
26.0,38.0,60.0,222,03,01,  Natun Bharalia,621,432,330,196,291,236,59.0,62.7,55.2,00000
26.0,38.0,60.0,238,01,01,  Birtail,193,133,92,64,101,69,59.2,59.0,59.4,00000
26.0,38.0,60.0,238,02,01,  Balarampur,122,206,68,109,54,97,37.2,38.4,35.8,00000
26.0,38.0,60.0,575,01,01,  Kakalia,115,112,68,49,47,63,50.7,58.1,42.7,00000
26.0,38.0,60.0,575,02,01,  Goalkhali,288,218,142,92,146,126,56.9,60.7,53.7,00000
26.0,38.0,60.0,666,01,01,  Madhyer Char,1022,861,555,412,467,449,54.3,57.4,51.0,00000
26.0,38.0,60.0,666,02,01,  Balur Char,821,395,444,190,377,205,67.5,70.0,64.8,00000
26.0,38.0,60.0,666,03,01,  Jhau Char,781,122,432,50,349,72,86.5,89.6,82.9,00000
26.0,38.0,60.0,666,04,01,  Nabab Char,1118,590,608,277,510,313,65.5,68.7,62.0,00000
26.0,38.0,60.0,879,01,01,  Sakta,1381,587,785,323,596,264,70.2,70.8,69.3,00000
26.0,38.0,60.0,879,02,01,  Narayan Patti,684,404,329,179,355,225,62.9,64.8,61.2,00000
26.0,38.0,60.0,879,03,01,  Bagh Ramerkanda,209,142,116,64,93,78,59.5,64.4,54.4,00000
26.0,38.0,60.0,879,04,01,  Uttar Ramerkanda,1194,533,622,256,572,277,69.1,70.8,67.4,00000
26.0,38.0,60.0,879,05,01,  Dakshin Ramerkanda,1277,997,619,489,658,508,56.2,55.9,56.4,00000
26.0,38.0,60.0,879,06,01,  Kamarta,763,555,365,270,398,285,57.9,57.5,58.3,00000
26.0,38.0,69.0,386,01,01,  Begunbari,874,737,485,365,389,372,54.3,57.1,51.1,00000
26.0,38.0,69.0,386,02,01,  Paschimpara,2095,1936,1091,1019,1004,917,52.0,51.7,52.3,00000
26.0,38.0,69.0,386,03,01,  Nazirerbagh,852,633,475,336,377,297,57.4,58.6,55.9,00000
26.0,38.0,69.0,386,04,01,  Char Kutub,4512,3572,2463,1843,2049,1729,55.8,57.2,54.2,00000
26.0,38.0,69.0,386,05,01,  Jaubari,1973,1475,1131,784,842,691,57.2,59.1,54.9,00000
26.0,38.0,69.0,386,06,01,  Madhyapara,1985,1018,1068,500,917,518,66.1,68.1,63.9,00000
26.0,38.0,69.0,386,07,01,  Chowdhury Para,1877,1360,1023,718,854,642,58.0,58.8,57.1,00000
26.0,38.0,69.0,386,08,01,  Hindu Para(Kalibari),1405,1311,786,662,619,649,51.7,54.3,48.8,00000
26.0,38.0,69.0,386,09,01,  Chunkutia Purbapara,4476,3178,2401,1592,2075,1586,58.5,60.1,56.7,00000
26.0,38.0,69.0,534,01,01,  Ikuria Uttarpara,913,338,505,162,408,176,73.0,75.7,69.9,00000
26.0,38.0,69.0,534,02,01,  Ikuria Bepari Para,590,281,302,123,288,158,67.7,71.1,64.6,00000
26.0,38.0,69.0,534,03,01,  Ikuria Khal Para,3945,2863,2169,1451,1776,1412,57.9,59.9,55.7,00000
26.0,38.0,69.0,534,04,01,  Sardar Para,562,653,318,349,244,304,46.3,47.7,44.5,00000
26.0,38.0,69.0,534,05,01,  Madhyapara,382,401,203,199,179,202,48.8,50.5,47.0,00000
26.0,38.0,69.0,534,06,01,  Paschimpara,502,397,280,182,222,215,55.8,60.6,50.8,00000
26.0,38.0,69.0,534,07,01,  Purbapara,363,284,214,142,149,142,56.1,60.1,51.2,00000
26.0,38.0,69.0,534,08,01,  Tila Para,700,679,370,348,330,331,50.8,51.5,49.9,00000
26.0,38.0,69.0,604,01,01,  Kaliganj,17167,8996,11079,5406,6088,3590,65.6,67.2,62.9,00000
26.0,38.0,69.0,604,02,01,  Kaybabtapara,6177,4694,3612,2449,2565,2245,56.8,59.6,53.3,00000
26.0,38.0,69.0,706,01,01,  Khajurbagh,15180,9859,8170,5053,7010,4806,60.6,61.8,59.3,00000
26.0,38.0,69.0,706,02,01,  Mirerbagh,5164,4313,2884,2319,2280,1994,54.5,55.4,53.3,00000
26.0,38.0,69.0,706,03,01,  Bastohara Colony,1257,1765,744,929,513,836,41.6,44.5,38.0,00000
26.0,38.0,69.0,706,04,01,  Par Gendaria,6419,5271,3455,2694,2964,2577,54.9,56.2,53.5,00000
26.0,38.0,69.0,706,05,01,  Char Khajurbagh,4138,4292,2473,2395,1665,1897,49.1,50.8,46.7,00000
26.0,38.0,69.0,706,06,01,  Rishi Para,540,496,301,243,239,253,52.1,55.3,48.6,00000
26.0,38.0,69.0,706,07,01,  Balu Char,525,207,333,99,192,108,71.7,77.1,64.0,00000
26.0,38.0,69.0,748,01,01,  Hasnabad,8635,3356,4723,1696,3912,1660,72.0,73.6,70.2,00000
26.0,38.0,69.0,748,02,01,  Mokam Para,1811,1366,1006,669,805,697,57.0,60.1,53.6,00000
26.0,38.0,69.0,929,01,01,  Uttarpara,7092,5818,3872,2985,3220,2833,54.9,56.5,53.2,00000
26.0,38.0,69.0,929,02,01,  Purbapara,5432,5354,2962,2727,2470,2627,50.4,52.1,48.5,00000
26.0,38.0,69.0,929,03,01,  Kachari Para,270,170,159,80,111,90,61.4,66.5,55.2,00000
26.0,38.0,69.0,929,04,01,  Nayahati,307,148,169,77,138,71,67.5,68.7,66.0,00000
26.0,38.0,69.0,929,05,01,  Bathanbari,272,359,152,196,120,163,43.1,43.7,42.4,00000
26.0,38.0,69.0,929,06,01,  Madhyapara,856,327,452,152,404,175,72.4,74.8,69.8,00000
26.0,38.0,69.0,929,07,01,  Paschimpara,2143,1495,1153,756,990,739,58.9,60.4,57.3,00000
26.0,38.0,69.0,929,08,01,  Bil Katuria,196,79,115,38,81,41,71.3,75.2,66.4,00000
26.0,38.0,69.0,929,09,01,  Dighirpar,220,286,125,136,95,150,43.5,47.9,38.8,00000
26.0,38.0,69.0,929,10,01,  Phakhalia Para,216,366,116,199,100,167,37.1,36.8,37.5,00000
26.0,38.0,77.0,123,01,01,  Dakshin Joynagar,1299,810,677,397,622,413,61.6,63.0,60.1,00000
26.0,38.0,77.0,123,02,01,  Uttar Joynagar,574,393,303,198,271,195,59.4,60.5,58.2,00000
26.0,38.0,77.0,131,01,01,  Bhaual Rishi Para,192,321,109,156,83,165,37.4,41.1,33.5,00000
26.0,38.0,77.0,131,02,01,  Bhaual Purba Para,487,303,260,127,227,176,61.6,67.2,56.3,00000
26.0,38.0,77.0,131,03,01,  Bhaual Paschim Para,494,244,262,109,232,135,66.9,70.6,63.2,00000
26.0,38.0,77.0,131,04,01,  Chhota Bhaual,472,248,249,125,223,123,65.6,66.6,64.5,00000
26.0,38.0,77.0,131,05,01,  Bara Manoharia,605,248,316,114,289,134,70.9,73.5,68.3,00000
26.0,38.0,77.0,131,06,01,  Khanbari,226,117,124,52,102,65,65.9,70.5,61.1,00000
26.0,38.0,77.0,148,01,01,  Baraikandi,718,558,391,264,327,294,56.3,59.7,52.7,00000
26.0,38.0,77.0,148,02,01,  Battoli,908,881,480,428,428,453,50.8,52.9,48.6,00000
26.0,38.0,77.0,148,03,01,  Itkhola,386,206,211,94,175,112,65.2,69.2,61.0,00000
26.0,38.0,77.0,197,01,01,  Beuta Muslim Para,718,609,409,278,309,331,54.1,59.5,48.3,00000
26.0,38.0,77.0,197,02,01,  Beuta Hindu Para,316,247,156,126,160,121,56.1,55.3,56.9,00000
26.0,38.0,77.0,197,03,01,  Balughata,145,106,76,41,69,65,57.8,65.0,51.5,00000
26.0,38.0,77.0,419,01,01,  Deuli,212,211,131,90,81,121,50.1,59.3,40.1,00000
26.0,38.0,77.0,419,02,01,  Nimtali,211,389,106,180,105,209,35.2,37.1,33.4,00000
26.0,38.0,77.0,485,01,01,  Naya Para,910,493,483,243,427,250,64.9,66.5,63.1,00000
26.0,38.0,77.0,485,02,01,  Khal Para,311,217,153,113,158,104,58.9,57.5,60.3,00000
26.0,38.0,77.0,485,03,01,  Hindu Para,617,304,341,138,276,166,67.0,71.2,62.4,00000
26.0,38.0,77.0,485,04,01,  Tanpara,640,291,351,126,289,165,68.7,73.6,63.7,00000
26.0,38.0,77.0,485,05,01,  Shahidnagar,709,474,377,235,332,239,59.9,61.6,58.1,00000
26.0,38.0,77.0,485,06,01,  Ololmanagar,778,445,415,196,363,249,63.6,67.9,59.3,00000
26.0,38.0,77.0,937,01,01,  Katal Tali,1533,1053,808,482,725,571,59.3,62.6,55.9,00000
26.0,38.0,77.0,937,02,01,  Guita,320,114,166,49,154,65,73.7,77.2,70.3,00000
26.0,38.0,77.0,937,03,01,  Krishnanagar,284,235,143,108,141,127,54.7,57.0,52.6,00000
26.0,38.0,77.0,962,01,01,  Paschim Emargaon,250,154,142,63,108,91,61.9,69.3,54.3,00000
26.0,38.0,77.0,962,02,01,  Purba Emargaon,424,178,230,86,194,92,70.4,72.8,67.8,00000
26.0,38.0,77.0,970,01,01,  Banglanagar,587,325,315,157,272,168,64.4,66.7,61.8,00000
26.0,38.0,77.0,970,02,01,  Kanargaon,133,221,65,107,68,114,37.6,37.8,37.4,00000
26.0,38.0,86.0,004,01,01,  Purba Abdullapur,384,365,213,175,171,190,51.3,54.9,47.4,00000
26.0,38.0,86.0,004,02,01,  Paschim Abdullapur,1209,1159,633,560,576,599,51.1,53.1,49.0,00000
26.0,38.0,86.0,004,03,01,  Hazi Para,320,166,167,75,153,91,65.8,69.0,62.7,00000
26.0,38.0,86.0,004,04,01,  Nasir Para,231,140,128,66,103,74,62.3,66.0,58.2,00000
26.0,38.0,86.0,004,05,01,  Malihati,264,172,153,83,111,89,60.6,64.8,55.5,00000
26.0,38.0,86.0,004,06,01,  Kalakandi,593,337,329,174,264,163,63.8,65.4,61.8,00000
26.0,38.0,86.0,004,07,01,  Kadampur,659,288,367,129,292,159,69.6,74.0,64.7,00000
26.0,38.0,86.0,004,08,01,  Sasta,170,98,96,52,74,46,63.4,64.9,61.7,00000
26.0,38.0,86.0,004,09,01,  Char Kadampur,231,260,123,129,108,131,47.0,48.8,45.2,00000
26.0,38.0,86.0,074,01,01,  Goalpara (Baghair),157,245,96,136,61,109,39.1,41.4,35.9,00000
26.0,38.0,86.0,074,02,01,  Gaishta,266,253,127,127,139,126,51.3,50.0,52.5,00000
26.0,38.0,86.0,074,03,01,  Majherhati,231,78,118,31,113,47,74.8,79.2,70.6,00000
26.0,38.0,86.0,074,04,01,  Dakshinhati,213,95,99,40,114,55,69.2,71.2,67.5,00000
26.0,38.0,86.0,074,05,01,  Sardar Para,262,97,146,36,116,61,73.0,80.2,65.5,00000
26.0,38.0,86.0,074,06,01,  Malakar Para,86,29,47,15,39,14,74.8,75.8,73.6,00000
26.0,38.0,86.0,074,07,01,  Betbuniahati,165,76,90,31,75,45,68.5,74.4,62.5,00000
26.0,38.0,86.0,074,08,01,  Khayrati Para,246,216,132,112,114,104,53.2,54.1,52.3,00000
26.0,38.0,86.0,074,09,01,  Talgachhiahati,156,102,74,49,82,53,60.5,60.2,60.7,00000
26.0,38.0,86.0,074,10,01,  Rishi Para,190,516,102,265,88,251,26.9,27.8,26.0,00000
26.0,38.0,86.0,074,11,01,  Kapuriahati,62,43,30,23,32,20,59.0,56.6,61.5,00000
26.0,38.0,86.0,074,12,01,  Chowdhury Para,391,164,215,78,176,86,70.5,73.4,67.2,00000
26.0,38.0,86.0,074,13,01,  Nagar,538,279,292,129,246,150,65.9,69.4,62.1,00000
26.0,38.0,86.0,074,14,01,  Aleya Para,363,261,184,129,179,132,58.2,58.8,57.6,00000
26.0,38.0,86.0,074,15,01,  Hatkhola,173,110,100,64,73,46,61.1,61.0,61.3,00000
26.0,38.0,86.0,074,16,01,  Bagbari,328,163,192,78,136,85,66.8,71.1,61.5,00000
26.0,38.0,86.0,074,17,01,  Porahati,162,49,77,22,85,27,76.8,77.8,75.9,00000
26.0,38.0,86.0,074,18,01,  Malo Para,113,120,63,57,50,63,48.5,52.5,44.2,00000
26.0,38.0,86.0,180,01,01,  Beara Radhanagar(M.Nagar),354,419,216,169,138,250,45.8,56.1,35.6,00000
26.0,38.0,86.0,180,02,01,  Beara,351,679,229,315,122,364,34.1,42.1,25.1,00000
26.0,38.0,86.0,180,03,01,  Beara Bagbari,157,174,80,90,77,84,47.4,47.1,47.8,00000
26.0,38.0,86.0,180,04,01,  Gupta Para,147,162,92,68,55,94,47.6,57.5,36.9,00000
26.0,38.0,86.0,180,05,01,  Telirbagh,127,163,65,82,62,81,43.8,44.2,43.4,00000
26.0,38.0,86.0,180,06,01,  Pathan Para,98,118,63,49,35,69,45.4,56.3,33.7,00000
26.0,38.0,86.0,180,07,01,  Goal Para,31,77,26,32,5,45,28.7,44.8,10.0,00000
26.0,38.0,86.0,674,01,01,  Majid Beara,329,695,169,356,160,339,32.1,32.2,32.1,00000
26.0,38.0,86.0,674,02,01,  Bonagram,130,111,75,55,55,56,53.9,57.7,49.5,00000
26.0,38.0,86.0,674,03,01,  Datta Para,51,15,28,10,23,5,77.3,73.7,82.1,00000
26.0,38.0,86.0,805,01,01,  Paschimdi,364,225,199,108,165,117,61.8,64.8,58.5,00000
26.0,38.0,86.0,805,02,01,  Nazirpur,59,189,34,88,25,101,23.8,27.9,19.8,00000
26.0,38.0,86.0,805,03,01,  Shyampur,220,123,119,59,101,64,64.1,66.9,61.2,00000
26.0,38.0,86.0,805,04,01,  Muslim Para,167,283,80,141,87,142,37.1,36.2,38.0,00000
26.0,38.0,86.0,805,05,01,  Gobindapur,168,179,80,85,88,94,48.4,48.5,48.4,00000
26.0,38.0,86.0,805,06,01,  Jalkhola,201,193,100,93,101,100,51.0,51.8,50.2,00000
26.0,38.0,86.0,805,07,01,  Baburai Para,25,147,13,73,12,74,14.5,15.1,14.0,00000
26.0,38.0,86.0,805,08,01,  Malanish Para,180,213,87,101,93,112,45.8,46.3,45.4,00000
26.0,38.0,86.0,805,09,01,  Burirdanga,69,154,37,77,32,77,30.9,32.5,29.4,00000
26.0,38.0,86.0,805,10,01,  Krishnanagar,241,214,118,97,123,117,53.0,54.9,51.3,00000
26.0,38.0,86.0,805,11,01,  Radhanagar,73,52,44,20,29,32,58.4,68.8,47.5,00000
26.0,38.0,86.0,805,12,01,  Paina Khalpar,311,186,177,85,134,101,62.6,67.6,57.0,00000
26.0,38.0,86.0,805,13,01,  Khalpar,171,152,100,75,71,77,52.9,57.1,48.0,00000
26.0,38.0,86.0,805,14,01,  Paina Nayagaon,132,302,70,140,62,162,30.4,33.3,27.7,00000
26.0,38.0,86.0,805,15,01,  Bhairabnagar,185,86,99,37,86,49,68.3,72.8,63.7,00000
26.0,38.0,86.0,945,01,01,  Tegharia,1230,612,678,274,552,338,66.8,71.2,62.0,00000
26.0,38.0,86.0,945,02,01,  Shailla,429,124,313,64,116,60,77.6,83.0,65.9,00000
26.0,38.0,94.0,345,01,01,  Char Raghunathpur,3140,1387,1752,664,1388,723,69.4,72.5,65.8,00000
26.0,38.0,94.0,345,02,01,  Gulzarbagh,1148,380,603,183,545,197,75.1,76.7,73.5,00000
26.0,38.0,94.0,345,03,01,  Lasmonganj,1175,499,692,257,483,242,70.2,72.9,66.6,00000
26.0,38.0,94.0,409,01,01,  Dakpara,1897,1125,1043,550,854,575,62.8,65.5,59.8,00000
26.0,38.0,94.0,409,02,01,  Banda Dakpara,7908,7395,4452,3881,3456,3514,51.7,53.4,49.6,00000
26.0,38.0,94.0,690,01,01,  Amirabagh,2080,757,1123,394,957,363,73.3,74.0,72.5,00000
26.0,38.0,94.0,690,02,01,  Chhatgaon,1816,619,1016,283,800,336,74.6,78.2,70.4,00000
26.0,38.0,94.0,690,03,01,  Kushirabagh,3713,1720,1956,818,1757,902,68.3,70.5,66.1,00000
26.0,38.0,94.0,690,04,01,  Mandail,8947,6496,4934,3272,4013,3224,57.9,60.1,55.5,00000
26.0,38.0,94.0,690,05,01,  Rasulpur,4998,2751,2673,1358,2325,1393,64.5,66.3,62.5,00000
26.0,38.0,94.0,690,06,01,  Banda Chhatgaon,1527,1351,852,723,675,628,53.1,54.1,51.8,00000
26.0,38.0,94.0,690,07,01,  Kashai Bhita,440,130,263,58,177,72,77.2,81.9,71.1,00000
26.0,38.0,94.0,690,08,01,  Nazarganj,3064,1485,1650,723,1414,762,67.4,69.5,65.0,00000
26.0,38.0,94.0,867,01,01,  Hukka Patti (Hafaz Road),1886,1023,1046,561,840,462,64.8,65.1,64.5,00000
26.0,38.0,94.0,867,02,01,  Zinjira Bazar (Tin Potti),864,1091,567,657,297,434,44.2,46.3,40.6,00000
26.0,38.0,94.0,867,05,01,  Paschim Malo Para (Towa Patti),1376,940,890,588,486,352,59.4,60.2,58.0,00000
26.0,38.0,94.0,867,06,01,  Kaybarta Para (Islamabad),1313,1377,754,707,559,670,48.8,51.6,45.5,00000
26.0,38.0,94.0,867,07,01,  Namabari (Hafaz Road&Kat Potti,1914,1073,1038,589,876,484,64.1,63.8,64.4,00000
26.0,38.0,94.0,867,08,01,  Baroghartala,1162,482,644,226,518,256,70.7,74.0,66.9,00000
26.0,38.0,94.0,867,09,01,  Howli Vila (Bara Bag),2924,1293,1682,642,1242,651,69.3,72.4,65.6,00000
26.0,38.0,94.0,867,10,01,  Amritapur (Shaid Nagar),4267,3263,2281,1614,1986,1649,56.7,58.6,54.6,00000
26.0,62.0,11.0,642,01,01,  Majh Para,951,623,424,274,527,349,60.4,60.7,60.2,00000
26.0,62.0,11.0,642,02,01,  Kazihati,74,121,33,56,41,65,37.9,37.1,38.7,00000
26.0,62.0,13.0,077,01,01,  Bara Bakshanagar,690,382,297,164,393,218,64.4,64.4,64.3,00000
26.0,62.0,13.0,077,02,01,  Chawra Hati,367,268,167,97,200,171,57.8,63.3,53.9,00000
26.0,62.0,13.0,077,03,01,  Shabok Hati,283,191,137,83,146,108,59.7,62.3,57.5,00000
26.0,62.0,13.0,077,04,01,  Kristanhati,233,95,91,42,142,53,71.0,68.4,72.8,00000
26.0,62.0,13.0,077,05,01,  Chota Rajpara,402,245,189,112,213,133,62.1,62.8,61.6,00000
26.0,62.0,13.0,077,06,01,  Chak Bakshanagar,77,106,32,59,45,47,42.1,35.2,48.9,00000
26.0,62.0,13.0,139,01,01,  Bardhan Para,1718,940,812,436,906,504,64.6,65.1,64.3,00000
26.0,62.0,13.0,139,02,01,  Chorta Rajpara (Gayan Hati),185,122,85,50,100,72,60.3,63.0,58.1,00000
26.0,62.0,13.0,357,01,01,  Dighirpar,2577,1252,1152,563,1425,689,67.3,67.2,67.4,00000
26.0,62.0,13.0,357,02,01,  Balur Char,404,187,174,88,230,99,68.4,66.4,69.9,00000
26.0,62.0,13.0,564,01,01,  Gazikhali,238,57,128,25,110,32,80.7,83.7,77.5,00000
26.0,62.0,13.0,564,02,01,  Kumarganj,1029,579,579,278,450,301,64.0,67.6,59.9,00000
26.0,62.0,13.0,564,03,01,  Pathankanda,597,233,260,121,337,112,71.9,68.2,75.1,00000
26.0,62.0,13.0,958,01,01,  Tuknikanda,555,364,255,165,300,199,60.4,60.7,60.1,00000
26.0,62.0,13.0,958,02,01,  Soarganj,122,104,70,39,52,65,54.0,64.2,44.4,00000
26.0,62.0,20.0,098,01,01,  Bara Hanrikanda,401,195,178,93,223,102,67.3,65.7,68.6,00000
26.0,62.0,20.0,098,02,01,  Sayad Pur (Part),195,104,88,49,107,55,65.2,64.2,66.0,00000
26.0,62.0,20.0,098,03,01,  Kathali Ghata (Part),29,31,11,16,18,15,48.3,40.7,54.5,00000
26.0,62.0,20.0,098,04,01,  Mridharkandi (Part),24,75,8,32,16,43,24.2,20.0,27.1,00000
26.0,62.0,20.0,730,01,01,  Nutan Bandura,2221,1571,1096,676,1125,895,58.6,61.9,55.7,00000
26.0,62.0,20.0,730,02,01,  Mirdangi,126,79,49,37,77,42,61.5,57.0,64.7,00000
26.0,62.0,20.0,777,01,01,  Nayanagar,1154,534,512,222,642,312,68.4,69.8,67.3,00000
26.0,62.0,20.0,777,02,01,  Champanagar,169,118,63,56,106,62,58.9,52.9,63.1,00000
26.0,62.0,20.0,777,03,01,  Baraduari,248,190,116,90,132,100,56.6,56.3,56.9,00000
26.0,62.0,20.0,777,04,01,  Nurnagar,497,365,227,195,270,170,57.7,53.8,61.4,00000
26.0,62.0,20.0,782,01,01,  Puratan Bandura,2457,1138,1156,514,1301,624,68.3,69.2,67.6,00000
26.0,62.0,20.0,782,02,01,  Molasi Kanda,621,118,263,60,358,58,84.0,81.4,86.1,00000
26.0,62.0,27.0,072,01,01,  Bara Bahra,4641,3616,2164,1709,2477,1907,56.2,55.9,56.5,00000
26.0,62.0,27.0,072,02,01,  Naopara,195,252,80,111,115,141,43.6,41.9,44.9,00000
26.0,62.0,27.0,476,01,01,  Kahur,233,136,99,65,134,71,63.1,60.4,65.4,00000
26.0,62.0,27.0,476,02,01,  Bagbari,60,62,25,27,35,35,49.2,48.1,50.0,00000
26.0,62.0,27.0,974,01,01,  Ulman Chandra,126,193,50,104,76,89,39.5,32.5,46.1,00000
26.0,62.0,27.0,974,02,01,  Purba Chakbarrah,156,188,68,88,88,100,45.3,43.6,46.8,00000
26.0,62.0,33.0,020,01,01,  Uttar Alalpur,281,156,143,61,138,95,64.3,70.1,59.2,00000
26.0,62.0,33.0,020,02,01,  Dakshin Alalpur,406,299,215,175,191,124,57.6,55.1,60.6,00000
26.0,62.0,33.0,051,01,01,  Baher Char,323,435,114,210,209,225,42.6,35.2,48.2,00000
26.0,62.0,33.0,051,02,01,  Brahmankhali,397,537,180,249,217,288,42.5,42.0,43.0,00000
26.0,62.0,33.0,051,03,01,  Daktarkanda,41,33,18,17,23,16,55.4,51.4,59.0,00000
26.0,62.0,33.0,150,01,01,  Uttar Baruakhali,164,226,76,105,88,121,42.1,42.0,42.1,00000
26.0,62.0,33.0,150,02,01,  Dakshin Baruakhali,776,415,354,169,422,246,65.2,67.7,63.2,00000
26.0,62.0,33.0,150,03,01,  Madla,222,224,110,104,112,120,49.8,51.4,48.3,00000
26.0,62.0,40.0,093,01,01,  Gobindapur,1615,1297,780,630,835,667,55.5,55.3,55.6,00000
26.0,62.0,40.0,093,02,01,  Muslimhati,1070,1030,430,498,640,532,51.0,46.3,54.6,00000
26.0,62.0,40.0,093,03,01,  Sonatala,505,316,217,132,288,184,61.5,62.2,61.0,00000
26.0,62.0,40.0,093,04,01,  Sankarkhali,364,331,146,155,218,176,52.4,48.5,55.3,00000
26.0,62.0,40.0,093,05,01,  Sonahajra,178,57,113,33,65,24,75.7,77.4,73.0,00000
26.0,62.0,40.0,093,06,01,  Paiksa,165,193,68,91,97,102,46.1,42.8,48.7,00000
26.0,62.0,40.0,093,07,01,  Chanhati,44,25,22,11,22,14,63.8,66.7,61.1,00000
26.0,62.0,40.0,093,08,01,  Chawrahati,354,182,151,77,203,105,66.0,66.2,65.9,00000
26.0,62.0,40.0,321,01,01,  Purba Churain,949,880,436,401,513,479,51.9,52.1,51.7,00000
26.0,62.0,40.0,321,02,01,  Paschim Churain,1464,832,728,388,736,444,63.8,65.2,62.4,00000
26.0,62.0,40.0,367,01,01,  Durgapur,1037,708,472,313,565,395,59.4,60.1,58.9,00000
26.0,62.0,40.0,367,02,01,  Kamar Khola,360,293,175,146,185,147,55.1,54.5,55.7,00000
26.0,62.0,40.0,668,01,01,  Purba Munsurnagar,939,435,354,196,585,239,68.3,64.4,71.0,00000
26.0,62.0,40.0,668,02,01,  Paschim Munsurnagar,670,304,269,150,401,154,68.8,64.2,72.3,00000
26.0,62.0,40.0,668,03,01,  Madankhali,298,34,134,11,164,23,89.8,92.4,87.7,00000
26.0,62.0,47.0,373,01,01,  Joynagar,344,297,161,173,183,124,53.7,48.2,59.6,00000
26.0,62.0,47.0,373,02,01,  Anderkota,679,261,291,116,388,145,72.2,71.5,72.8,00000
26.0,62.0,47.0,373,03,01,  Miahati,283,121,131,59,152,62,70.0,68.9,71.0,00000
26.0,62.0,47.0,373,04,01,  Kutibari,198,124,91,52,107,72,61.5,63.6,59.8,00000
26.0,62.0,47.0,373,05,01,  Noadha,632,340,288,157,344,183,65.0,64.7,65.3,00000
26.0,62.0,47.0,373,06,01,  Baragaon,751,416,330,189,421,227,64.4,63.6,65.0,00000
26.0,62.0,47.0,373,07,01,  Surjakhali,657,289,353,142,304,147,69.5,71.3,67.4,00000
26.0,62.0,47.0,373,08,01,  Ramnathpur,281,117,128,44,153,73,70.6,74.4,67.7,00000
26.0,62.0,47.0,373,09,01,  Nagar,171,155,77,78,94,77,52.5,49.7,55.0,00000
26.0,62.0,47.0,373,10,01,  Shabad,334,110,157,53,177,57,75.2,74.8,75.6,00000
26.0,62.0,47.0,373,11,01,  Khanhati,594,382,302,173,292,209,60.9,63.6,58.3,00000
26.0,62.0,47.0,373,12,01,  Chanhati,228,109,102,50,126,59,67.7,67.1,68.1,00000
26.0,62.0,47.0,373,13,01,  Sonahajara,947,514,398,251,549,263,64.8,61.3,67.6,00000
26.0,62.0,47.0,373,14,01,  Sankarkhali,434,150,187,60,247,90,74.3,75.7,73.3,00000
26.0,62.0,47.0,373,15,01,  Paiksa,274,126,104,54,170,72,68.5,65.8,70.2,00000
26.0,62.0,47.0,373,16,01,  Adarsha Gram,61,211,27,96,34,115,22.4,22.0,22.8,00000
26.0,62.0,54.0,114,01,01,  Nabagram,211,246,99,109,112,137,46.2,47.6,45.0,00000
26.0,62.0,54.0,114,02,01,  Nalgora,323,259,156,109,167,150,55.5,58.9,52.7,00000
26.0,62.0,54.0,114,03,01,  Barkhalshi (Char Khalshi),659,685,313,304,346,381,49.0,50.7,47.6,00000
26.0,62.0,54.0,217,01,01,  Chandrakhola,936,613,468,251,468,362,60.4,65.1,56.4,00000
26.0,62.0,54.0,217,02,01,  Debukhali,106,137,62,58,44,79,43.6,51.7,35.8,00000
26.0,62.0,54.0,274,01,01,  Gobindapur,1506,1094,665,436,841,658,57.9,60.4,56.1,00000
26.0,62.0,54.0,274,02,01,  Balidior,282,43,118,13,164,30,86.8,90.1,84.5,00000
26.0,62.0,54.0,461,01,01,  Azizpur,438,290,217,123,221,167,60.2,63.8,57.0,00000
26.0,62.0,54.0,461,02,01,  Jantrail,2400,1059,1117,514,1283,545,69.4,68.5,70.2,00000
26.0,62.0,54.0,461,03,01,  Bhawlia,388,392,192,176,196,216,49.7,52.2,47.6,00000
26.0,62.0,61.0,388,01,01,  Ghoshail,401,346,161,159,240,187,53.7,50.3,56.2,00000
26.0,62.0,61.0,388,02,01,  Are Ghoshail,295,203,122,87,173,116,59.2,58.4,59.9,00000
26.0,62.0,61.0,818,01,01,  Rajapur,568,495,219,232,349,263,53.4,48.6,57.0,00000
26.0,62.0,61.0,818,02,01,  Balanga,555,450,229,200,326,250,55.2,53.4,56.6,00000
26.0,62.0,61.0,818,03,01,  Doair,86,97,26,43,60,54,47.0,37.7,52.6,00000
26.0,62.0,61.0,818,04,01,  Nayadangi,85,42,35,13,50,29,66.9,72.9,63.3,00000
26.0,62.0,61.0,818,05,01,  Kantartek,168,139,81,54,87,85,54.7,60.0,50.6,00000
26.0,62.0,61.0,834,01,01,  Roypur,358,288,143,127,215,161,55.4,53.0,57.2,00000
26.0,62.0,61.0,834,02,01,  Khat Bazar,75,58,34,23,41,35,56.4,59.6,53.9,00000
26.0,62.0,61.0,855,01,01,  Sankardia,271,280,121,126,150,154,49.2,49.0,49.3,00000
26.0,62.0,61.0,855,02,01,  Shampur,106,52,51,27,55,25,67.1,65.4,68.8,00000
26.0,62.0,61.0,855,03,01,  Gojaria,83,77,36,35,47,42,51.9,50.7,52.8,00000
26.0,62.0,61.0,917,01,01,  Sonabazu,1276,1350,508,659,768,691,48.6,43.5,52.6,00000
26.0,62.0,61.0,917,02,01,  Kalyansree,260,301,131,131,129,170,46.3,50.0,43.1,00000
26.0,62.0,67.0,342,01,01,  Daulatpur,1493,1225,726,607,767,618,54.9,54.5,55.4,00000
26.0,62.0,67.0,342,02,01,  Bhangabhita,1204,826,629,408,575,418,59.3,60.7,57.9,00000
26.0,62.0,67.0,352,01,01,  Dignara,250,559,125,286,125,273,30.9,30.4,31.4,00000
26.0,62.0,67.0,352,02,01,  Roypur,324,391,143,192,181,199,45.3,42.7,47.6,00000
26.0,62.0,67.0,352,03,01,  Mollahkanda,293,232,156,95,137,137,55.8,62.2,50.0,00000
26.0,62.0,67.0,487,01,01,  Kailail,1308,1667,601,745,707,922,44.0,44.7,43.4,00000
26.0,62.0,67.0,487,02,01,  Telengha,292,732,130,392,162,340,28.5,24.9,32.3,00000
26.0,62.0,67.0,487,03,01,  Sonargaon,127,281,49,138,78,143,31.1,26.2,35.3,00000
26.0,62.0,67.0,673,01,01,  Masail,380,207,201,83,179,124,64.7,70.8,59.1,00000
26.0,62.0,67.0,673,02,01,  Darikanda,1164,1227,527,575,637,652,48.7,47.8,49.4,00000
26.0,62.0,67.0,673,03,01,  Modhupur,341,312,152,138,189,174,52.2,52.4,52.1,00000
26.0,62.0,67.0,673,04,01,  Nayakanda,975,725,441,364,534,361,57.4,54.8,59.7,00000
26.0,62.0,67.0,673,05,01,  Malikanda,884,746,409,350,475,396,54.2,53.9,54.5,00000
26.0,62.0,67.0,689,01,01,  Meleng,769,482,358,245,411,237,61.5,59.4,63.4,00000
26.0,62.0,67.0,689,02,01,  Khalpar,644,591,318,277,326,314,52.1,53.4,50.9,00000
26.0,62.0,67.0,689,03,01,  Nama Meleng,223,147,93,62,130,85,60.3,60.0,60.5,00000
26.0,62.0,67.0,746,01,01,  Paragaon,562,402,273,183,289,219,58.3,59.9,56.9,00000
26.0,62.0,67.0,746,02,01,  Matabpur,503,511,215,234,288,277,49.6,47.9,51.0,00000
26.0,62.0,74.0,041,01,03,  Baghmara,421,235,221,143,200,92,64.2,60.7,68.5,00000
26.0,62.0,74.0,041,02,03,  Surganj,481,305,230,149,251,156,61.2,60.7,61.7,00000
26.0,62.0,74.0,041,03,03,  Baikantapur,182,74,88,35,94,39,71.1,71.5,70.7,00000
26.0,62.0,74.0,103,01,01,  Jalalpur,618,472,318,219,300,253,56.7,59.2,54.2,00000
26.0,62.0,74.0,103,02,01,  Amirpur,678,384,295,203,383,181,63.8,59.2,67.9,00000
26.0,62.0,74.0,103,03,01,  Bara Rajpara,795,447,332,220,463,227,64.0,60.1,67.1,00000
26.0,62.0,74.0,124,01,03,  Purba Samshabad,783,394,388,160,395,234,66.5,70.8,62.8,00000
26.0,62.0,74.0,124,02,03,  Paschim Samshabad,712,401,362,202,350,199,64.0,64.2,63.8,00000
26.0,62.0,74.0,481,01,03,  Gopalpur,333,154,182,59,151,95,68.4,75.5,61.4,00000
26.0,62.0,74.0,481,02,03,  Bhuiya Hati,51,19,25,9,26,10,72.9,73.5,72.2,00000
26.0,62.0,74.0,481,03,03,  Goalnagar,144,71,76,33,68,38,67.0,69.7,64.2,00000
26.0,62.0,74.0,481,04,03,  Ray Hati,38,39,18,21,20,18,49.4,46.2,52.6,00000
26.0,62.0,74.0,481,05,03,  Madhyanagar,151,60,78,17,73,43,71.6,82.1,62.9,00000
26.0,62.0,74.0,481,06,03,  Mohazan Pur,87,56,49,28,38,28,60.8,63.6,57.6,00000
26.0,62.0,74.0,481,07,03,  Pukur Par,170,112,84,53,86,59,60.3,61.3,59.3,00000
26.0,62.0,74.0,481,08,03,  Khandakar Nowadda,108,69,52,39,56,30,61.0,57.1,65.1,00000
26.0,62.0,74.0,481,09,03,  Baghhati,117,81,52,40,65,41,59.1,56.5,61.3,00000
26.0,62.0,74.0,481,10,03,  Baranagar,291,65,138,24,153,41,81.7,85.2,78.9,00000
26.0,62.0,74.0,481,11,03,  Baghbibir Char,176,163,76,78,100,85,51.9,49.4,54.1,00000
26.0,62.0,74.0,481,12,03,  Gopikanta Pur,161,89,80,34,81,55,64.4,70.2,59.6,00000
26.0,62.0,74.0,481,13,03,  Khandakarhati,266,167,132,81,134,86,61.4,62.0,60.9,00000
26.0,62.0,74.0,481,14,03,  Bhayra Hati,188,112,93,62,95,50,62.7,60.0,65.5,00000
26.0,62.0,74.0,481,15,03,  Purba Samshabad (Part),65,51,36,21,29,30,56.0,63.2,49.2,00000
26.0,62.0,74.0,481,16,03,  Paschim Samshabad (Part),58,32,27,13,31,19,64.4,67.5,62.0,00000
26.0,62.0,74.0,528,01,03,  Nababganj,745,450,434,292,311,158,62.3,59.8,66.3,00000
26.0,62.0,74.0,528,02,03,  Kasimpur,2282,969,1114,434,1168,535,70.2,72.0,68.6,00000
26.0,62.0,74.0,528,03,03,  Purba Samshabad (Part),45,26,20,11,25,15,63.4,64.5,62.5,00000
26.0,62.0,74.0,616,01,01,  Madhabpur,732,218,325,86,407,132,77.1,79.1,75.5,00000
26.0,62.0,74.0,616,02,01,  Khandakar Hati,364,61,154,24,210,37,85.6,86.5,85.0,00000
26.0,62.0,74.0,813,01,03,  Rajarampur,285,118,140,68,145,50,70.7,67.3,74.4,00000
26.0,62.0,74.0,813,02,03,  Panalia,631,598,321,293,310,305,51.3,52.3,50.4,00000
26.0,62.0,81.0,199,01,01,  Bipra Tasulla,386,452,158,206,228,246,46.1,43.4,48.1,00000
26.0,62.0,81.0,199,02,01,  Char Bagori,75,71,32,36,43,35,51.4,47.1,55.1,00000
26.0,62.0,81.0,347,01,01,  Deotala,686,197,290,84,396,113,77.7,77.5,77.8,00000
26.0,62.0,81.0,347,02,01,  Dari Deotala,191,40,87,17,104,23,82.7,83.7,81.9,00000
26.0,62.0,81.0,347,03,01,  Padri Kanda,125,18,60,10,65,8,87.4,85.7,89.0,00000
26.0,62.0,81.0,404,01,01,  Chhota Golla,366,73,131,31,235,42,83.4,80.9,84.8,00000
26.0,62.0,81.0,404,02,01,  Bara Golla,399,58,134,28,265,30,87.3,82.7,89.8,00000
26.0,62.0,81.0,404,03,01,  Krishnanagar,190,137,73,55,117,82,58.1,57.0,58.8,00000
26.0,62.0,81.0,404,04,01,  Kumar Golla,372,164,171,53,201,111,69.4,76.3,64.4,00000
26.0,62.0,81.0,404,05,01,  Matabbor Tak,26,22,12,9,14,13,54.2,57.1,51.9,00000
26.0,62.0,81.0,549,01,01,  Kanda Khanepur,668,428,307,178,361,250,60.9,63.3,59.1,00000
26.0,62.0,81.0,549,02,01,  Chak Khanepur,414,224,216,106,198,118,64.9,67.1,62.7,00000
26.0,62.0,81.0,606,01,01,  Sahajadpur,221,117,104,51,117,66,65.4,67.1,63.9,00000
26.0,62.0,81.0,606,02,01,  Kashinagar,87,12,43,3,44,9,87.9,93.5,83.0,00000
26.0,62.0,81.0,963,01,01,  Afzalnagar,220,107,107,44,113,63,67.3,70.9,64.2,00000
26.0,62.0,81.0,963,02,01,  Tutiail,1022,759,413,338,609,421,57.4,55.0,59.1,00000
26.0,62.0,81.0,963,03,01,  Char Tutiail,309,159,141,74,168,85,66.0,65.6,66.4,00000
26.0,62.0,81.0,963,04,01,  Natun Tutail,89,12,37,3,52,9,88.1,92.5,85.2,00000
26.0,62.0,88.0,409,01,01,  Hagradi,651,535,282,249,369,286,54.9,53.1,56.3,00000
26.0,62.0,88.0,409,02,01,  Narsingpur,109,118,58,53,51,65,48.0,52.3,44.0,00000
26.0,62.0,88.0,663,01,01,  Manikanda,672,516,304,227,368,289,56.6,57.3,56.0,00000
26.0,62.0,88.0,663,02,01,  Anandanagar,230,300,112,137,118,163,43.4,45.0,42.0,00000
26.0,62.0,88.0,715,01,01,  Narayanpur,365,303,145,150,220,153,54.6,49.2,59.0,00000
26.0,62.0,88.0,715,02,01,  Daudpur,369,447,178,190,191,257,45.2,48.4,42.6,00000
26.0,62.0,88.0,725,01,01,  Bhadrakanda,109,58,41,27,68,31,65.3,60.3,68.7,00000
26.0,62.0,88.0,725,02,01,  Natti,175,117,67,53,108,64,59.9,55.8,62.8,00000
26.0,62.0,88.0,725,03,01,  Nurpur,142,137,63,62,79,75,50.9,50.4,51.3,00000
26.0,62.0,88.0,741,01,01,  Panjipahari,426,605,197,282,229,323,41.3,41.1,41.5,00000
26.0,62.0,88.0,741,02,01,  Garibpur,401,367,166,159,235,208,52.2,51.1,53.0,00000
26.0,62.0,88.0,741,03,01,  Bakternagar,752,550,347,232,405,318,57.8,59.9,56.0,00000
26.0,62.0,88.0,896,01,01,  Shikari Para,1156,516,545,222,611,294,69.1,71.1,67.5,00000
26.0,62.0,88.0,896,02,01,  Kandarpapur,104,179,46,82,58,97,36.7,35.9,37.4,00000
26.0,62.0,88.0,896,03,01,  Laskarkanda,188,195,83,99,105,96,49.1,45.6,52.2,00000
26.0,62.0,94.0,031,01,01,  Aona,451,236,203,92,248,144,65.6,68.8,63.3,00000
26.0,62.0,94.0,031,02,01,  Ulain Vita,463,422,200,184,263,238,52.3,52.1,52.5,00000
26.0,62.0,94.0,031,03,01,  Chak Aona,197,146,100,62,97,84,57.4,61.7,53.6,00000
26.0,62.0,94.0,031,04,01,  Haetkanda,231,289,92,132,139,157,44.4,41.1,47.0,00000
26.0,62.0,94.0,031,05,01,  Chak Matabpur,168,189,76,85,92,104,47.1,47.2,46.9,00000
26.0,62.0,94.0,031,06,01,  Mollapara,126,156,57,66,69,90,44.7,46.3,43.4,00000
26.0,62.0,94.0,062,01,01,  Dudghata,420,410,207,176,213,234,50.6,54.0,47.7,00000
26.0,62.0,94.0,062,02,01,  Dakshin Balukhanda,1033,853,542,406,491,447,54.8,57.2,52.3,00000
26.0,62.0,94.0,062,03,01,  Atkahunia,561,446,253,214,308,232,55.7,54.2,57.0,00000
26.0,62.0,94.0,062,04,01,  Uttar Balukhanda,723,765,327,316,396,449,48.6,50.9,46.9,00000
26.0,62.0,94.0,570,01,01,  Konda,365,382,178,185,187,197,48.9,49.0,48.7,00000
26.0,62.0,94.0,570,02,01,  Kartikpur,58,104,24,46,34,58,35.8,34.3,37.0,00000
26.0,62.0,94.0,580,01,01,  Khatia (Fulkara),670,641,321,294,349,347,51.1,52.2,50.1,00000
26.0,62.0,94.0,580,02,01,  Majh Para,207,201,98,97,109,104,50.7,50.3,51.2,00000
26.0,62.0,94.0,580,03,01,  Rupar Char,109,301,52,144,57,157,26.6,26.5,26.6,00000
26.0,62.0,94.0,580,04,01,  Sadotkarhati,22,12,13,4,9,8,64.7,76.5,52.9,00000
26.0,62.0,94.0,580,05,01,  Karigar Para,69,55,38,29,31,26,55.6,56.7,54.4,00000
26.0,62.0,94.0,580,06,01,  Ghosh Para,153,159,71,82,82,77,49.0,46.4,51.6,00000
26.0,62.0,94.0,761,01,01,  Sholangar,419,272,193,131,226,141,60.6,59.6,61.6,00000
26.0,62.0,94.0,761,02,01,  Patiljhap,630,1014,302,465,328,549,38.3,39.4,37.4,00000
26.0,62.0,94.0,761,03,01,  Bais Nal,224,234,117,90,107,144,48.9,56.5,42.6,00000
26.0,62.0,94.0,901,01,01,  Chak Barisanghata,338,625,187,291,151,334,35.1,39.1,31.1,00000
26.0,62.0,94.0,901,02,01,  Chakuria,496,723,254,325,242,398,40.7,43.9,37.8,00000
26.0,62.0,94.0,901,03,01,  Singhara,1501,867,700,383,801,484,63.4,64.6,62.3,00000
26.0,62.0,94.0,901,04,01,  Abdani,220,106,85,52,135,54,67.5,62.0,71.4,00000
26.0,62.0,94.0,901,05,01,  Para Sura,236,146,104,67,132,79,61.8,60.8,62.6,00000
26.0,62.0,94.0,901,06,01,  Jhanjhania,154,92,75,42,79,50,62.6,64.1,61.2,00000
26.0,62.0,94.0,901,07,01,  Nayahati,255,249,101,95,154,154,50.6,51.5,50.0,00000
26.0,62.0,94.0,906,01,01,  Singjor,1003,990,457,446,546,544,50.3,50.6,50.1,00000
26.0,62.0,94.0,906,02,01,  Chak Singjor,136,132,60,66,76,66,50.7,47.6,53.5,00000
26.0,62.0,94.0,906,03,01,  Sonapur,516,358,256,165,260,193,59.0,60.8,57.4,00000
26.0,62.0,94.0,912,01,01,  Sholla,586,664,262,314,324,350,46.9,45.5,48.1,00000
26.0,62.0,94.0,912,02,01,  Chandra Para,224,213,120,86,104,127,51.3,58.3,45.0,00000
26.0,62.0,94.0,912,03,01,  Dakshin Sholla,399,260,219,137,180,123,60.5,61.5,59.4,00000
26.0,62.0,94.0,912,04,01,  Boali,273,379,122,182,151,197,41.9,40.1,43.4,00000
26.0,62.0,94.0,969,01,01,  Ulail,7,3,3,1,4,2,70.0,75.0,66.7,00000
26.0,62.0,94.0,969,02,01,  Madan Mohanpur,779,647,364,293,415,354,54.6,55.4,54.0,00000
26.0,62.0,94.0,969,03,01,  Sultanpur,154,294,68,156,86,138,34.4,30.4,38.4,00000
26.0,68.0,60.0,193,01,03,  Dakshingaon,8297,4116,4363,2010,3934,2106,66.8,68.5,65.1,00000
26.0,68.0,60.0,193,02,03,  Begunbari,849,362,467,161,382,201,70.1,74.4,65.5,00000
26.0,68.0,60.0,193,03,03,  Manikdia,1716,887,933,387,783,500,65.9,70.7,61.0,00000
26.0,68.0,60.0,193,04,03,  Shahibhag,1940,1344,1023,650,917,694,59.1,61.1,56.9,00000
26.0,68.0,60.0,193,05,03,  Daspara,585,462,328,205,257,257,55.9,61.5,50.0,00000
26.0,68.0,60.0,193,06,03,  Nayabhag,1728,890,959,480,769,410,66.0,66.6,65.2,00000
26.0,68.0,60.0,193,07,03,  Kusumbhag,1902,792,1006,467,896,325,70.6,68.3,73.4,00000
26.0,68.0,60.0,193,08,03,  Purba Nandipara,1378,613,718,322,660,291,69.2,69.0,69.4,00000
26.0,68.0,60.0,193,09,03,  Naajbag,111,107,53,46,58,61,50.9,53.5,48.7,00000
26.0,68.0,82.0,608,01,03,  Dakshin Manda,18376,14911,10351,7727,8025,7184,55.2,57.3,52.8,00000
26.0,68.0,82.0,608,02,03,  Uttar Manda,11569,8266,6477,4203,5092,4063,58.3,60.6,55.6,00000
26.0,72.0,18.0,022,01,01,  Aukpara,4302,1904,2636,872,1666,1032,69.3,75.1,61.7,00000
26.0,72.0,18.0,022,02,01,  Aukpara Adarshagram,2824,1824,1585,818,1239,1006,60.8,66.0,55.2,00000
26.0,72.0,18.0,070,01,01,  Ashulia,15496,6343,9221,3031,6275,3312,71.0,75.3,65.5,00000
26.0,72.0,18.0,070,02,01,  Tengarari,5833,4869,3715,2598,2118,2271,54.5,58.8,48.3,00000
26.0,72.0,18.0,090,01,01,  Bara Paragaon,1981,1891,1093,932,888,959,51.2,54.0,48.1,00000
26.0,72.0,18.0,090,02,01,  Naya Para,661,650,417,334,244,316,50.4,55.5,43.6,00000
26.0,72.0,18.0,090,03,01,  Shaolateki,182,254,100,121,82,133,41.7,45.2,38.1,00000
26.0,72.0,18.0,125,01,01,  Dusaid,1485,927,833,436,652,491,61.6,65.6,57.0,00000
26.0,72.0,18.0,125,02,01,  Basaid,1704,616,988,274,716,342,73.4,78.3,67.7,00000
26.0,72.0,18.0,125,03,01,  Charabagh,1665,830,963,417,702,413,66.7,69.8,63.0,00000
26.0,72.0,18.0,125,04,01,  Kumkumari,3075,2404,1752,1182,1323,1222,56.1,59.7,52.0,00000
26.0,72.0,18.0,125,05,01,  Aragaon,842,946,493,477,349,469,47.1,50.8,42.7,00000
26.0,72.0,18.0,141,01,01,  Belma,355,374,196,178,159,196,48.7,52.4,44.8,00000
26.0,72.0,18.0,141,02,01,  Jaharchanda,276,163,152,76,124,87,62.9,66.7,58.8,00000
26.0,72.0,18.0,386,01,01,  Naya Para,1005,573,537,249,468,324,63.7,68.3,59.1,00000
26.0,72.0,18.0,386,02,01,  Kandail,1017,283,566,117,451,166,78.2,82.9,73.1,00000
26.0,72.0,18.0,386,03,01,  Khatgara,7572,3132,4399,1411,3173,1721,70.7,75.7,64.8,00000
26.0,72.0,22.0,064,01,01,  Banagram,480,710,264,344,216,366,40.3,43.4,37.1,00000
26.0,72.0,22.0,064,02,01,  Panch Banagram,473,1610,293,805,180,805,22.7,26.7,18.3,00000
26.0,72.0,22.0,602,01,01,  Balighata,145,164,70,78,75,86,46.9,47.3,46.6,00000
26.0,72.0,22.0,602,02,01,  Jamadar Para,993,683,519,348,474,335,59.2,59.9,58.6,00000
26.0,72.0,22.0,602,03,01,  Beraid,870,547,484,272,386,275,61.4,64.0,58.4,00000
26.0,72.0,22.0,602,04,01,  Kotapara,1877,1550,1025,764,852,786,54.8,57.3,52.0,00000
26.0,72.0,22.0,602,05,01,  Nayanagar,775,623,418,293,357,330,55.4,58.8,52.0,00000
26.0,72.0,22.0,602,06,01,  Madaipara,553,216,302,91,251,125,71.9,76.8,66.8,00000
26.0,72.0,22.0,602,07,01,  Daspara,761,380,417,191,344,189,66.7,68.6,64.5,00000
26.0,72.0,22.0,602,08,01,  Dargahpara,627,404,334,187,293,217,60.8,64.1,57.5,00000
26.0,72.0,22.0,602,09,01,  Bazarpara,748,384,430,172,318,212,66.1,71.4,60.0,00000
26.0,72.0,22.0,827,01,01,  Sadha Pur,567,540,314,277,253,263,51.2,53.1,49.0,00000
26.0,72.0,22.0,827,02,01,  Puranbari,389,855,211,439,178,416,31.3,32.5,30.0,00000
26.0,72.0,22.0,827,03,01,  Goperbari,152,342,73,163,79,179,30.8,30.9,30.6,00000
26.0,72.0,22.0,827,04,01,  Kazi Para,327,547,168,261,159,286,37.4,39.2,35.7,00000
26.0,72.0,22.0,827,05,01,  Boktertek,101,167,50,77,51,90,37.7,39.4,36.2,00000
26.0,72.0,27.0,148,01,01,  Bhakurta(Muslem),957,637,480,294,477,343,60.0,62.0,58.2,00000
26.0,72.0,27.0,148,02,01,  Hindu Bhakurta,1099,1080,600,495,499,585,50.4,54.8,46.0,00000
26.0,72.0,27.0,148,03,01,  Kandi Bhakurta,1144,1149,641,566,503,583,49.9,53.1,46.3,00000
26.0,72.0,27.0,202,01,01,  Chaira,931,934,520,450,411,484,49.9,53.6,45.9,00000
26.0,72.0,27.0,202,02,01,  Khaguria,867,721,456,338,411,383,54.6,57.4,51.8,00000
26.0,72.0,27.0,202,03,01,  3sola Para,65,71,30,34,35,37,47.8,46.9,48.6,00000
26.0,72.0,27.0,280,01,01,  Chunar Char,658,1003,355,497,303,506,39.6,41.7,37.5,00000
26.0,72.0,27.0,280,02,01,  Nalagaria,465,596,236,289,229,307,43.8,45.0,42.7,00000
26.0,72.0,27.0,280,03,01,  Domrakanoa,370,391,201,172,169,219,48.6,53.9,43.6,00000
26.0,72.0,27.0,280,04,01,  Kaisar Char,374,158,213,73,161,85,70.3,74.5,65.4,00000
26.0,72.0,27.0,280,05,01,  Purba Chhaglakandi,72,88,42,55,30,33,45.0,43.3,47.6,00000
26.0,72.0,27.0,486,01,01,  Haruria,716,574,449,323,267,251,55.5,58.2,51.5,00000
26.0,72.0,27.0,486,02,01,  Naliasur,232,174,132,79,100,95,57.1,62.6,51.3,00000
26.0,72.0,27.0,685,01,01,  Musurikhola,482,253,263,131,219,122,65.6,66.8,64.2,00000
26.0,72.0,27.0,685,02,01,  Ferengikanda,831,1351,448,663,383,688,38.1,40.3,35.8,00000
26.0,72.0,27.0,685,03,01,  Bahir Char,572,707,318,355,254,352,44.7,47.3,41.9,00000
26.0,72.0,27.0,685,04,01,  Paschim Purba Chhaglakandi,339,428,191,214,148,214,44.2,47.2,40.9,00000
26.0,72.0,27.0,685,05,01,  Tulatuli,312,221,179,97,133,124,58.5,64.9,51.8,00000
26.0,72.0,27.0,685,06,01,  Jhau Char,322,351,178,179,144,172,47.8,49.9,45.6,00000
26.0,72.0,27.0,685,07,01,  Char Tulatuli,239,256,133,126,106,130,48.3,51.4,44.9,00000
26.0,72.0,27.0,685,08,01,  Nandar Khasmar,138,131,73,50,65,81,51.3,59.3,44.5,00000
26.0,72.0,27.0,924,01,01,  Bharalia Para,384,1028,228,687,156,341,27.2,24.9,31.4,00000
26.0,72.0,27.0,924,02,01,  Shyamalashir Baher Char,1802,1775,976,852,826,923,50.4,53.4,47.2,00000
26.0,72.0,27.0,924,03,01,  Luter Char,1308,488,708,220,600,268,72.8,76.3,69.1,00000
26.0,72.0,27.0,924,04,01,  Kalatia Para,1489,1488,831,782,658,706,50.0,51.5,48.2,00000
26.0,72.0,27.0,924,05,01,  Totalia Para,467,942,251,616,216,326,33.1,29.0,39.9,00000
26.0,72.0,33.0,009,01,01,  Akran,1866,1923,1204,937,662,986,49.2,56.2,40.2,00000
26.0,72.0,33.0,009,02,01,  Kanijnagar,178,61,105,20,73,41,74.5,84.0,64.0,00000
26.0,72.0,33.0,083,01,01,  Kakar,879,629,489,292,390,337,58.3,62.6,53.6,00000
26.0,72.0,33.0,083,02,01,  Nairadi,140,174,75,83,65,91,44.6,47.5,41.7,00000
26.0,72.0,33.0,083,03,01,  Khewaghat,342,147,177,64,165,83,69.9,73.4,66.5,00000
26.0,72.0,33.0,615,01,01,  Shyampur,982,1034,540,488,442,546,48.7,52.5,44.7,00000
26.0,72.0,33.0,615,02,01,  Khonda,70,94,41,50,29,44,42.7,45.1,39.7,00000
26.0,72.0,39.0,051,01,01,  Baipail,13775,3485,8058,1547,5717,1938,79.8,83.9,74.7,00000
26.0,72.0,39.0,051,02,01,  Dakshin Gazir Chat,28755,10074,15555,4605,13200,5469,74.1,77.2,70.7,00000
26.0,72.0,39.0,051,03,01,  Uttar Gazir Chat (Part-1),30997,8398,17888,3831,13109,4567,78.7,82.4,74.2,00000
26.0,72.0,39.0,051,04,01,  Uttar Gazir Chat (Part-2),2273,937,1189,423,1084,514,70.8,73.8,67.8,00000
26.0,72.0,39.0,067,01,01,  Bashbari,902,619,492,279,410,340,59.3,63.8,54.7,00000
26.0,72.0,39.0,067,02,01,  Kaisabari,4423,2577,2545,1203,1878,1374,63.2,67.9,57.7,00000
26.0,72.0,39.0,067,03,01,  Dagartali,240,206,149,117,91,89,53.8,56.0,50.6,00000
26.0,72.0,39.0,357,01,01,  Kanda,584,879,335,437,249,442,39.9,43.4,36.0,00000
26.0,72.0,39.0,357,02,01,  Chunteki,452,561,264,254,188,307,44.6,51.0,38.0,00000
26.0,72.0,39.0,357,03,01,  Alokdi,58,119,35,57,23,62,32.8,38.0,27.1,00000
26.0,72.0,39.0,357,04,01,  Nayatek,303,355,162,175,141,180,46.0,48.1,43.9,00000
26.0,72.0,39.0,357,05,01,  Nutun Nagar,4162,2056,2273,904,1889,1152,66.9,71.5,62.1,00000
26.0,72.0,39.0,357,06,01,  Sitbari,1096,446,640,209,456,237,71.1,75.4,65.8,00000
26.0,72.0,39.0,421,01,01,  Madhupur,4434,1410,2291,612,2143,798,75.9,78.9,72.9,00000
26.0,72.0,39.0,421,02,01,  Sreepur,18435,5008,9773,2286,8662,2722,78.6,81.0,76.1,00000
26.0,72.0,39.0,421,03,01,  Bhadail,32614,8123,17848,3770,14766,4353,80.1,82.6,77.2,00000
26.0,72.0,39.0,421,04,01,  Pabnertek,4678,2647,2498,1191,2180,1456,63.9,67.7,60.0,00000
26.0,72.0,39.0,421,05,01,  Ganakbari,1281,102,779,41,502,61,92.6,95.0,89.2,00000
26.0,72.0,39.0,421,06,01,  Faruknagar,5618,2359,3386,1132,2232,1227,70.4,74.9,64.5,00000
26.0,72.0,39.0,718,01,01,  Palashbari,12305,4558,6816,2129,5489,2429,73.0,76.2,69.3,00000
26.0,72.0,39.0,718,02,01,  Dendarbar,28322,7201,15291,3174,13031,4027,79.7,82.8,76.4,00000
26.0,72.0,39.0,901,01,01,  Purba Subandi,623,571,328,250,295,321,52.2,56.7,47.9,00000
26.0,72.0,39.0,901,02,01,  Paschim Subandi,493,622,285,290,208,332,44.2,49.6,38.5,00000
26.0,72.0,39.0,959,01,01,  Unail,442,491,257,217,185,274,47.4,54.2,40.3,00000
26.0,72.0,39.0,959,02,01,  Gopalbari,575,546,329,236,246,310,51.3,58.2,44.2,00000
26.0,72.0,50.0,460,01,01,  Paharibari,236,224,117,107,119,117,51.3,52.2,50.4,00000
26.0,72.0,50.0,460,02,01,  Goailbari,208,167,112,77,96,90,55.5,59.3,51.6,00000
26.0,72.0,50.0,502,01,01,  Jadu Gopalertek,245,170,132,67,113,103,59.0,66.3,52.3,00000
26.0,72.0,50.0,502,02,01,  Mohanpur,177,81,93,40,84,41,68.6,69.9,67.2,00000
26.0,72.0,50.0,824,01,01,  Sadarbari,218,228,98,114,120,114,48.9,46.2,51.3,00000
26.0,72.0,50.0,824,02,01,  Tikalar Tek,190,274,90,134,100,140,40.9,40.2,41.7,00000
26.0,72.0,72.0,028,01,01,  Amgachhia,291,443,157,209,134,234,39.6,42.9,36.4,00000
26.0,72.0,72.0,028,02,01,  Bagdhania,649,544,382,266,267,278,54.4,59.0,49.0,00000
26.0,72.0,72.0,028,03,01,  Nayarhat Bazar,115,172,68,77,47,95,40.1,46.9,33.1,00000
26.0,72.0,72.0,103,01,01,  Gokulnagar,876,532,464,227,412,305,62.2,67.1,57.5,00000
26.0,72.0,72.0,103,02,01,  Pandhoa,2480,1174,1309,524,1171,650,67.9,71.4,64.3,00000
26.0,72.0,72.0,103,03,01,  Oalia,2039,1200,1120,550,919,650,63.0,67.1,58.6,00000
26.0,72.0,72.0,103,04,01,  Boalia Para,142,158,76,69,66,89,47.3,52.4,42.6,00000
26.0,72.0,72.0,209,01,01,  Chakalgaon,2775,1682,1452,794,1323,888,62.3,64.6,59.8,00000
26.0,72.0,72.0,209,02,01,  Gopinathpur,781,696,420,312,361,384,52.9,57.4,48.5,00000
26.0,72.0,72.0,228,01,01,  Charigaon,1818,1130,1030,520,788,610,61.7,66.5,56.4,00000
26.0,72.0,72.0,228,02,01,  Munudia,77,166,43,77,34,89,31.7,35.8,27.6,00000
26.0,72.0,72.0,309,01,01,  Dakshin Krok,697,76,336,24,361,52,90.2,93.3,87.4,00000
26.0,72.0,72.0,309,02,01,  Kalabagon R.Area,1072,339,600,130,472,209,76.0,82.2,69.3,00000
26.0,72.0,72.0,309,03,01,  Jahangir Un. Hall,4722,65,3218,47,1504,18,98.6,98.6,98.8,00000
26.0,72.0,72.0,354,01,01,  Decreertek,196,99,120,46,76,53,66.4,72.3,58.9,00000
26.0,72.0,72.0,389,01,01,  Dhania,3074,1798,1674,879,1400,919,63.1,65.6,60.4,00000
26.0,72.0,72.0,389,02,01,  Kohinoor Mill,88,13,44,2,44,11,87.1,95.7,80.0,00000
26.0,72.0,72.0,399,01,01,  Diabari,92,71,56,31,36,40,56.4,64.4,47.4,00000
26.0,72.0,72.0,399,02,01,  Khaser Tek,51,54,26,31,25,23,48.6,45.6,52.1,00000
26.0,72.0,72.0,399,03,01,  Char Sinduria,278,117,152,43,126,74,70.4,77.9,63.0,00000
26.0,72.0,72.0,399,04,01,  Muktertek,25,16,10,7,15,9,61.0,58.8,62.5,00000
26.0,72.0,72.0,621,01,01,  Kurgaon,4632,3644,2503,1749,2129,1895,56.0,58.9,52.9,00000
26.0,72.0,72.0,621,02,01,  Natun Para,7671,3852,4145,1950,3526,1902,66.6,68.0,65.0,00000
26.0,72.0,72.0,679,01,01,  Mohanpur,184,152,92,71,92,81,54.8,56.4,53.2,00000
26.0,72.0,72.0,679,02,01,  Chauri Para,106,110,60,49,46,61,49.1,55.0,43.0,00000
26.0,72.0,72.0,679,03,01,  Kashimpur,83,89,44,41,39,48,48.3,51.8,44.8,00000
26.0,72.0,72.0,750,01,01,  Pathalia,365,335,199,148,166,187,52.1,57.3,47.0,00000
26.0,72.0,72.0,750,02,01,  Rahimpur,189,398,102,184,87,214,32.2,35.7,28.9,00000
26.0,72.0,72.0,750,03,01,  Ramarbagh,548,538,289,249,259,289,50.5,53.7,47.3,00000
26.0,72.0,72.0,750,04,01,  Kalartek,266,162,151,79,115,83,62.1,65.7,58.1,00000
26.0,72.0,72.0,750,05,01,  Khejurtek,3545,1397,1932,659,1613,738,71.7,74.6,68.6,00000
26.0,72.0,72.0,750,06,01,  Madhabganj(Smritisaudha),134,202,58,102,76,100,39.9,36.3,43.2,00000
26.0,72.0,72.0,933,01,01,  Taksur,401,265,264,118,137,147,60.2,69.1,48.2,00000
26.0,72.0,72.0,933,02,01,  Ganashastha Kendra,407,26,196,12,211,14,94.0,94.2,93.8,00000
26.0,72.0,72.0,969,01,01,  Dairy Firm,519,73,326,29,193,44,87.7,91.8,81.4,00000
26.0,72.0,72.0,969,02,01,  Rangamati,1483,365,784,168,699,197,80.2,82.4,78.0,00000
26.0,72.0,78.0,006,01,01,  Chapain,6147,3551,3263,1725,2884,1826,63.4,65.4,61.2,00000
26.0,72.0,78.0,006,02,01,  Lal Tek,1905,801,997,384,908,417,70.4,72.2,68.5,00000
26.0,72.0,78.0,235,01,01,  Mitan,1050,504,591,201,459,303,67.6,74.6,60.2,00000
26.0,72.0,78.0,235,02,01,  P A T C,1610,203,979,72,631,131,88.8,93.1,82.8,00000
26.0,72.0,83.0,331,01,01,  Dakshin Rangamati,87,31,62,17,25,14,73.7,78.5,64.1,00000
26.0,72.0,83.0,331,02,01,  Anail Bari,120,105,63,45,57,60,53.3,58.3,48.7,00000
26.0,72.0,83.0,334,01,01,  Lalartek,279,259,165,111,114,148,51.9,59.8,43.5,00000
26.0,72.0,83.0,334,02,01,  Daspara,116,262,79,112,37,150,30.7,41.4,19.8,00000
26.0,72.0,83.0,334,03,01,  Amodia Para,30,61,20,27,10,34,33.0,42.6,22.7,00000
26.0,72.0,83.0,334,04,01,  Chakrabarti Para,95,25,51,11,44,14,79.2,82.3,75.9,00000
26.0,72.0,83.0,334,05,01,  Tati Para Khal Para,48,151,23,70,25,81,24.1,24.7,23.6,00000
26.0,72.0,83.0,334,06,01,  Kalikapur,267,396,156,188,111,208,40.3,45.3,34.8,00000
26.0,72.0,83.0,334,07,01,  Kantha Para,56,128,38,60,18,68,30.4,38.8,20.9,00000
26.0,72.0,83.0,334,08,01,  Bara Rishi Para Chotta Rishi P,151,588,110,321,41,267,20.4,25.5,13.3,00000
26.0,72.0,83.0,334,09,01,  Badoyarkar Para Duli Para,6,118,2,59,4,59,4.8,3.3,6.3,00000
26.0,72.0,83.0,334,10,01,  Baranagar,72,98,36,39,36,59,42.4,48.0,37.9,00000
26.0,72.0,83.0,334,11,01,  Tirthaghat,116,38,67,16,49,22,75.3,80.7,69.0,00000
26.0,72.0,83.0,334,12,01,  Madhyapara,155,235,92,113,63,122,39.7,44.9,34.1,00000
26.0,72.0,83.0,334,13,01,  Bhatiacharia Para,47,93,25,46,22,47,33.6,35.2,31.9,00000
26.0,72.0,83.0,334,14,01,  Khamar Para,262,132,144,55,118,77,66.5,72.4,60.5,00000
26.0,72.0,83.0,334,15,01,  Chandra Para,17,7,8,3,9,4,70.8,72.7,69.2,00000
26.0,72.0,83.0,334,16,01,  Ghosh Para,23,3,13,0,10,3,88.5,100.0,76.9,00000
26.0,72.0,83.0,334,17,01,  Chala Para,138,64,106,40,32,24,68.3,72.6,57.1,00000
26.0,72.0,83.0,334,18,01,  Adhikari Para,56,22,30,8,26,14,71.8,78.9,65.0,00000
26.0,72.0,83.0,334,19,01,  Narpara,136,182,57,82,79,100,42.8,41.0,44.1,00000
26.0,72.0,83.0,334,20,01,  Karmakar Para,75,57,48,24,27,33,56.8,66.7,45.0,00000
26.0,72.0,83.0,334,21,01,  Roypara,200,123,101,52,99,71,61.9,66.0,58.2,00000
26.0,72.0,83.0,334,22,01,  Shanti Para,78,102,43,49,35,53,43.3,46.7,39.8,00000
26.0,72.0,83.0,334,23,01,  Nutan Bandar,289,203,159,100,130,103,58.7,61.4,55.8,00000
26.0,72.0,83.0,334,24,01,  Shimulia Bazar,101,24,94,15,7,9,80.8,86.2,43.8,00000
26.0,72.0,83.0,444,01,01,  Gazibari,819,778,457,330,362,448,51.3,58.1,44.7,00000
26.0,72.0,83.0,444,02,01,  Shamertek,431,268,233,127,198,141,61.7,64.7,58.4,00000
26.0,72.0,83.0,444,03,01,  Mansurbag,209,203,131,82,78,121,50.7,61.5,39.2,00000
26.0,72.0,83.0,473,01,01,  Gohailbari,4041,2719,2267,1324,1774,1395,59.8,63.1,56.0,00000
26.0,72.0,83.0,473,02,01,  Sardar Para Asia Tek+Bazar,233,179,127,94,106,85,56.6,57.5,55.5,00000
26.0,72.0,83.0,473,03,01,  Kona Para,1249,684,669,305,580,379,64.6,68.7,60.5,00000
26.0,72.0,83.0,473,04,01,  Dighirpar,433,439,253,206,180,233,49.7,55.1,43.6,00000
26.0,72.0,83.0,473,05,01,  Samvar Guchchhagram+Bomehin,155,382,83,204,72,178,28.9,28.9,28.8,00000
26.0,72.0,83.0,540,01,01,  Hindu Para/Bagbari,254,224,156,92,98,132,53.1,62.9,42.6,00000
26.0,72.0,83.0,540,02,01,  Bagertal,185,299,104,123,81,176,38.2,45.8,31.5,00000
26.0,72.0,83.0,540,03,01,  Naya Para,124,229,95,81,29,148,35.1,54.0,16.4,00000
26.0,72.0,83.0,540,04,01,  Uttarpara,158,241,98,99,60,142,39.6,49.7,29.7,00000
26.0,72.0,83.0,540,05,01,  Masjid Para,329,241,211,111,118,130,57.7,65.5,47.6,00000
26.0,72.0,83.0,692,01,01,  Gopinpur,183,213,96,95,87,118,46.2,50.3,42.4,00000
26.0,72.0,83.0,692,02,01,  Chanteki Karigar Para,375,273,200,115,175,158,57.9,63.5,52.6,00000
26.0,72.0,83.0,692,03,01,  Hindu Para,395,367,205,170,190,197,51.8,54.7,49.1,00000
26.0,72.0,83.0,692,04,01,  Musalman Para,198,200,106,92,92,108,49.7,53.5,46.0,00000
26.0,72.0,83.0,692,05,01,  Kodalteki,114,155,77,113,37,42,42.4,40.5,46.8,00000
26.0,72.0,83.0,692,06,01,  Rishi Para,41,269,27,125,14,144,13.2,17.8,8.9,00000
26.0,72.0,83.0,698,01,01,  Uttar Nallapolla,791,668,419,249,372,419,54.2,62.7,47.0,00000
26.0,72.0,83.0,698,02,01,  Dakshin Nallapolla,549,409,285,186,264,223,57.3,60.5,54.2,00000
26.0,72.0,83.0,737,01,01,  Panta Para,55,60,30,27,25,33,47.8,52.6,43.1,00000
26.0,72.0,83.0,737,02,01,  Bandartek,83,165,49,77,34,88,33.5,38.9,27.9,00000
26.0,72.0,83.0,739,01,01,  Ranasthal+Korwokar Para,144,162,77,78,67,84,47.1,49.7,44.4,00000
26.0,72.0,83.0,739,02,01,  Vikompur,128,144,61,72,67,72,47.1,45.9,48.2,00000
26.0,72.0,83.0,739,03,01,  Bepari Para,83,351,40,177,43,174,19.1,18.4,19.8,00000
26.0,72.0,83.0,739,04,01,  Gaidertek,12,135,6,54,6,81,8.2,10.0,6.9,00000
26.0,72.0,83.0,739,05,01,  Bainteki,213,392,119,187,94,205,35.2,38.9,31.4,00000
26.0,72.0,83.0,739,06,01,  Darji Para+Molla Para+Khankr P,324,350,177,155,147,195,48.1,53.3,43.0,00000
26.0,72.0,83.0,739,07,01,  Muchirtek,47,98,22,48,25,50,32.4,31.4,33.3,00000
26.0,72.0,89.0,167,01,01,  Maitka,1250,905,751,473,499,432,58.0,61.4,53.6,00000
26.0,72.0,89.0,167,02,01,  Jhauchar,1319,1400,741,717,578,683,48.5,50.8,45.8,00000
26.0,72.0,89.0,180,01,01,  Hemayetpur,4080,1639,2332,780,1748,859,71.3,74.9,67.1,00000
26.0,72.0,89.0,180,02,01,  Jadurchar,5333,3440,3083,1702,2250,1738,60.8,64.4,56.4,00000
26.0,72.0,89.0,341,01,01,  Shyampur,2290,1522,1215,753,1075,769,60.1,61.7,58.3,00000
26.0,72.0,89.0,341,02,01,  Purbahati,2507,1649,1454,826,1053,823,60.3,63.8,56.1,00000
26.0,72.0,89.0,341,03,01,  Notunpara,372,652,241,333,131,319,36.3,42.0,29.1,00000
26.0,72.0,89.0,511,01,01,  Jamur,1962,845,1071,378,891,467,69.9,73.9,65.6,00000
26.0,72.0,89.0,511,02,01,  Nimertek,751,824,458,421,293,403,47.7,52.1,42.1,00000
26.0,72.0,89.0,515,01,01,  Bharari,1707,558,938,261,769,297,75.4,78.2,72.1,00000
26.0,72.0,89.0,515,02,01,  Naya Para,230,130,121,61,109,69,63.9,66.5,61.2,00000
26.0,72.0,89.0,734,01,01,  Bhaoalia Para,681,514,369,223,312,291,57.0,62.3,51.7,00000
26.0,72.0,89.0,734,02,01,  Kuthibari,480,594,268,284,212,310,44.7,48.6,40.6,00000
26.0,72.0,89.0,734,03,01,  Panpara,1843,1138,985,530,858,608,61.8,65.0,58.5,00000
26.0,72.0,89.0,734,04,01,  Naya Para,1360,736,717,343,643,393,64.9,67.6,62.1,00000
26.0,72.0,89.0,734,05,01,  Krishnanagar,780,641,428,314,352,327,54.9,57.7,51.8,00000
26.0,72.0,89.0,792,01,01,  Taraf Rajaghat,770,1567,433,850,337,717,32.9,33.7,32.0,00000
26.0,72.0,89.0,792,02,01,  Rajaghat,3269,1253,2384,631,885,622,72.3,79.1,58.7,00000
26.0,72.0,89.0,792,03,01,  Kharta Para,756,536,482,270,274,266,58.5,64.1,50.7,00000
26.0,72.0,94.0,402,01,01,  Diakhali,805,609,423,282,382,327,56.9,60.0,53.9,00000
26.0,72.0,94.0,402,02,01,  Gorat,2142,1069,1330,506,812,563,66.7,72.4,59.1,00000
26.0,72.0,94.0,402,03,01,  Jamgara,13404,4280,7479,1959,5925,2321,75.8,79.2,71.9,00000
26.0,72.0,94.0,402,04,01,  Gumail,4704,1687,2702,784,2002,903,73.6,77.5,68.9,00000
26.0,72.0,94.0,402,05,01,  Buri Para,1499,1184,863,540,636,644,55.9,61.5,49.7,00000
26.0,72.0,94.0,402,06,01,  Beran,5929,3434,3368,1561,2561,1873,63.3,68.3,57.8,00000
26.0,72.0,94.0,660,01,01,  Nischintapur,9303,2376,5251,1074,4052,1302,79.7,83.0,75.7,00000
26.0,72.0,94.0,660,02,01,  Yearpur,2017,1628,1114,754,903,874,55.3,59.6,50.8,00000
26.0,72.0,94.0,927,01,01,  Taiyabpur,2474,1873,1602,1084,872,789,56.9,59.6,52.5,00000
26.0,72.0,94.0,927,02,01,  Ghoshbagh,6301,1736,3516,788,2785,948,78.4,81.7,74.6,00000
26.0,72.0,94.0,927,03,01,  Kundolbagh,3931,1417,2313,658,1618,759,73.5,77.9,68.1,00000
26.0,93.0,51.0,118,01,03,  Pakuria,3239,3343,1751,1665,1488,1678,49.2,51.3,47.0,00000
26.0,93.0,51.0,118,02,03,  Khan Tak,1278,831,748,417,530,414,60.6,64.2,56.1,00000
26.0,93.0,51.0,118,03,03,  Jatrabari,2726,854,1676,397,1050,457,76.1,80.8,69.7,00000
26.0,93.0,51.0,174,01,03,  Sholahati,333,186,230,92,103,94,64.2,71.4,52.3,00000
26.0,93.0,51.0,174,02,03,  Chandura (Mandura),248,251,146,120,102,131,49.7,54.9,43.8,00000
26.0,93.0,51.0,174,03,03,  Tapalia,369,288,219,124,150,164,56.2,63.8,47.8,00000
26.0,93.0,51.0,174,04,03,  Uludaha,568,609,310,316,258,293,48.3,49.5,46.8,00000
26.0,93.0,51.0,174,05,03,  Badaldi,1458,1097,838,554,620,543,57.1,60.2,53.3,00000
26.0,93.0,51.0,174,06,03,  Dhalipara,3893,800,2313,394,1580,406,83.0,85.4,79.6,00000
26.0,93.0,51.0,174,07,03,  Ahalia,1158,881,616,418,542,463,56.8,59.6,53.9,00000
26.0,93.0,51.0,174,08,03,  Baunia,10792,4573,5763,2093,5029,2480,70.2,73.4,67.0,00000
26.0,93.0,51.0,174,09,03,  Mandura,114,99,65,42,49,57,53.5,60.7,46.2,00000
26.0,93.0,51.0,696,01,03,  Nalbhog,3109,2722,1981,1441,1128,1281,53.3,57.9,46.8,00000
26.0,93.0,51.0,696,02,03,  Nayanagar,2292,1786,1255,899,1037,887,56.2,58.3,53.9,00000
26.0,93.0,51.0,696,03,03,  Dhorongar Tek,1770,1150,1009,624,761,526,60.6,61.8,59.1,00000
26.0,93.0,51.0,895,01,03,  Ranabhola (Part),10143,8221,6023,4693,4120,3528,55.2,56.2,53.9,00000
26.0,93.0,51.0,895,02,03,  Fullbaria,5840,4803,3548,2535,2292,2268,54.9,58.3,50.3,00000
26.0,96.0,76.0,019,01,03,  Amaia,180,87,101,43,79,44,67.4,70.1,64.2,00000
26.0,96.0,76.0,019,02,03,  Barabari,868,249,456,103,412,146,77.7,81.6,73.8,00000
26.0,96.0,76.0,099,01,03,  Baothar,489,229,272,110,217,119,68.1,71.2,64.6,00000
26.0,96.0,76.0,099,02,03,  Chinudi,321,113,185,42,136,71,74.0,81.5,65.7,00000
26.0,96.0,76.0,422,01,03,  Kumadkhola,131,120,73,59,58,61,52.2,55.3,48.7,00000
26.0,96.0,76.0,422,02,03,  Sewrartek,19,6,12,3,7,3,76.0,80.0,70.0,00000
26.0,96.0,76.0,422,03,03,  Khunjordia,123,205,62,109,61,96,37.5,36.3,38.9,00000
26.0,96.0,76.0,422,04,03,  Gobindapur,2059,847,1364,448,695,399,70.9,75.3,63.5,00000
26.0,96.0,76.0,600,01,03,  Ninni,514,354,290,164,224,190,59.2,63.9,54.1,00000
26.0,96.0,76.0,600,02,03,  Ninnir Chak,45,79,32,55,13,24,36.3,36.8,35.1,00000
26.0,96.0,76.0,995,01,03,  Ratuti,354,156,190,66,164,90,69.4,74.2,64.6,00000
26.0,96.0,76.0,995,02,03,  Barardi,690,340,377,169,313,171,67.0,69.0,64.7,00000
26.0,96.0,76.0,995,03,03,  Poradia,475,213,270,104,205,109,69.0,72.2,65.3,00000
26.0,96.0,76.0,995,04,03,  Atkar Tek,254,156,134,72,120,84,62.0,65.0,58.8,00000
26.0,96.0,76.0,995,05,03,  Batuli,592,225,316,85,276,140,72.5,78.8,66.3,00000
26.0,96.0,76.0,995,06,03,  Karimarbagh,321,108,164,53,157,55,74.8,75.6,74.1,00000
26.0,96.0,76.0,995,07,03,  Dobadia,2930,1273,1597,616,1333,657,69.7,72.2,67.0,00000
26.0,96.0,76.0,995,08,03,  Chand Para,2428,892,1319,460,1109,432,73.1,74.1,72.0,00000
26.0,96.0,76.0,995,09,03,  Mainar Tek,462,267,290,131,172,136,63.4,68.9,55.8,00000
26.0,96.0,76.0,995,10,03,  Munda,1485,597,794,267,691,330,71.3,74.8,67.7,00000
26.0,96.0,76.0,995,11,03,  Pular Tek,465,170,248,76,217,94,73.2,76.5,69.8,00000
26.0,96.0,76.0,995,12,03,  Ujapara (Masterpara),1405,511,779,246,626,265,73.3,76.0,70.3,00000
26.0,96.0,76.0,995,13,03,  Barabagh,3009,1223,1600,566,1409,657,71.1,73.9,68.2,00000
26.0,96.0,76.0,995,14,03,  Batulia,220,91,118,39,102,52,70.7,75.2,66.2,00000
26.0,96.0,76.0,995,15,03,  Rajabari,1894,1030,1016,481,878,549,64.8,67.9,61.5,00000
26.0,96.0,76.0,995,16,03,  Uttar Khan,15077,6938,8190,3340,6887,3598,68.5,71.0,65.7,00000
26.0,96.0,76.0,995,17,03,  Dargah Para,2555,1161,1358,532,1197,629,68.8,71.9,65.6,00000
26.0,96.0,76.0,995,18,03,  Babur Para,836,468,473,219,363,249,64.1,68.4,59.3,00000
86.0,14.0,12.0,229,01,01,  Maijher Char,104,144,50,73,54,71,41.9,40.7,43.2,00000
86.0,14.0,12.0,229,02,01,  Sadarali Amin Khandi,84,85,34,41,50,44,49.7,45.3,53.2,00000
86.0,14.0,12.0,229,03,01,  Abdul Aziz Bala Kandi,239,157,104,75,135,82,60.4,58.1,62.2,00000
86.0,14.0,12.0,229,04,01,  Joynal Balb Kandi,98,94,45,33,53,61,51.0,57.7,46.5,00000
86.0,14.0,12.0,229,05,01,  Abdul Jabbar Kandi,51,89,14,46,37,43,36.4,23.3,46.3,00000
86.0,14.0,12.0,229,06,01,  Yusuf Matber Kandi,44,88,19,45,25,43,33.3,29.7,36.8,00000
86.0,14.0,12.0,229,07,01,  Nur Mohammad Halder Kandi,46,139,21,65,25,74,24.9,24.4,25.3,00000
86.0,14.0,12.0,229,08,01,  Kashem Sarker Kandi,26,84,11,37,15,47,23.6,22.9,24.2,00000
86.0,14.0,12.0,229,09,01,  Abdur Razzak Balar Kandi,124,209,58,96,66,113,37.2,37.7,36.9,00000
86.0,14.0,12.0,229,10,01,  Gani Munshir Kandi,196,244,95,110,101,134,44.5,46.3,43.0,00000
86.0,14.0,12.0,229,11,01,  Abdus Salamat Kandi,15,133,9,62,6,71,10.1,12.7,7.8,00000
86.0,14.0,12.0,229,12,01,  Dhali Kandi (Chan Miah),140,433,60,209,80,224,24.4,22.3,26.3,00000
86.0,14.0,12.0,229,13,01,  Wahab Balar Kandi,19,24,11,10,8,14,44.2,52.4,36.4,00000
86.0,14.0,12.0,229,14,01,  Gafur Mridher Kandi,213,352,102,153,111,199,37.7,40.0,35.8,00000
86.0,14.0,12.0,229,15,01,  Subed Balar Kandi,100,193,38,94,62,99,34.1,28.8,38.5,00000
86.0,14.0,12.0,229,16,01,  Aziz Daroger Kandi,85,130,44,56,41,74,39.5,44.0,35.7,00000
86.0,14.0,12.0,229,17,01,  Balal Hossain Balar Kandi,32,82,14,40,18,42,28.1,25.9,30.0,00000
86.0,14.0,12.0,229,18,01,  Yunus Ali Sarder Kandi,17,84,4,37,13,47,16.8,9.8,21.7,00000
86.0,14.0,12.0,229,19,01,  Hazrat Ali Munshir Kandi,46,46,16,19,30,27,50.0,45.7,52.6,00000
86.0,14.0,12.0,229,20,01,  Suab Ali Sarder Kandi,65,112,35,57,30,55,36.7,38.0,35.3,00000
86.0,14.0,12.0,229,21,01,  Wahab Sarder Kandi,63,48,27,18,36,30,56.8,60.0,54.5,00000
86.0,14.0,12.0,229,22,01,  Mirchand Sikder Kandi,63,177,27,81,36,96,26.3,25.0,27.3,00000
86.0,14.0,12.0,229,23,01,  Nur Mohammad Master Kandi,62,180,25,84,37,96,25.6,22.9,27.8,00000
86.0,14.0,12.0,229,24,01,  Afajoddin Howladar Kandi,87,283,46,125,41,158,23.5,26.9,20.6,00000
86.0,14.0,12.0,229,25,01,  Mizan Howlader Kandi,25,24,11,12,14,12,51.0,47.8,53.8,00000
86.0,14.0,12.0,229,26,01,  Kalu Baler Kandi,35,171,18,77,17,94,17.0,18.9,15.3,00000
86.0,14.0,12.0,229,27,01,  Montaj Uddin Sarder Kandi,212,339,96,155,116,184,38.5,38.2,38.7,00000
86.0,14.0,12.0,229,28,01,  Gafur Molla Kandi,56,58,31,23,25,35,49.1,57.4,41.7,00000
86.0,14.0,12.0,260,01,01,  Abdul Khair Halder Kandi,200,470,93,234,107,236,29.9,28.4,31.2,00000
86.0,14.0,12.0,260,02,01,  Yakub Balar Kandi,82,40,36,19,46,21,67.2,65.5,68.7,00000
86.0,14.0,12.0,260,03,01,  Bukal Kandi,80,106,37,47,43,59,43.0,44.0,42.2,00000
86.0,14.0,12.0,260,04,01,  Joynal Matbar Kandi,32,11,12,3,20,8,74.4,80.0,71.4,00000
86.0,14.0,12.0,260,05,01,  Kachiruddin Bepary Kandi,151,113,65,46,86,67,57.2,58.6,56.2,00000
86.0,14.0,12.0,260,06,01,  Sikdar Kandi,100,97,52,44,48,53,50.8,54.2,47.5,00000
86.0,14.0,12.0,260,07,01,  Abdul Latif Maji Kandi,28,54,11,29,17,25,34.1,27.5,40.5,00000
86.0,14.0,12.0,260,08,01,  Sona Mollar Kandi,38,70,19,32,19,38,35.2,37.3,33.3,00000
86.0,14.0,12.0,260,09,01,  Khaler Gajir Kandi,79,95,35,48,44,47,45.4,42.2,48.4,00000
86.0,14.0,12.0,260,10,01,  Ismahil Hawladar Kandi,29,18,11,10,18,8,61.7,52.4,69.2,00000
86.0,14.0,12.0,260,11,01,  Kala Chand Sarder Kandi,48,114,22,50,26,64,29.6,30.6,28.9,00000
86.0,14.0,12.0,260,12,01,  Nayan Sarder Kandi,27,98,14,53,13,45,21.6,20.9,22.4,00000
86.0,14.0,12.0,260,13,01,  Fazal Balar Kandi,59,78,28,36,31,42,43.1,43.8,42.5,00000
86.0,14.0,12.0,260,14,01,  Ahad Ali Matbar Kandi,279,599,134,266,145,333,31.8,33.5,30.3,00000
86.0,14.0,12.0,260,15,01,  Jafar Ali Sarker Kandi,71,166,31,78,40,88,30.0,28.4,31.3,00000
86.0,14.0,12.0,260,16,01,  Fazlul Haque Malat Kandi,150,161,71,70,79,91,48.2,50.4,46.5,00000
86.0,14.0,12.0,260,17,01,  Shamsul Haque Sarder Kandi,261,470,127,229,134,241,35.7,35.7,35.7,00000
86.0,14.0,12.0,260,18,01,  Kadir Mollar Kandi,24,31,11,15,13,16,43.6,42.3,44.8,00000
86.0,14.0,12.0,260,19,01,  Abdul Aziz Hawlader Kandi,108,116,50,62,58,54,48.2,44.6,51.8,00000
86.0,14.0,12.0,260,21,01,  Kafiluddin Kabiraj Kandi,54,217,21,90,33,127,19.9,18.9,20.6,00000
86.0,14.0,12.0,260,22,01,  Johirul Haque Bala Kandi,60,330,24,160,36,170,15.4,13.0,17.5,00000
86.0,14.0,12.0,260,23,01,  Danu Miah Hawlader Kandi,111,243,51,101,60,142,31.4,33.6,29.7,00000
86.0,14.0,12.0,260,24,01,  Lalchan Bapere Kandi,70,77,25,35,45,42,47.6,41.7,51.7,00000
86.0,14.0,12.0,260,25,01,  Chitokhar Kandi,31,30,16,13,15,17,50.8,55.2,46.9,00000
86.0,14.0,12.0,260,26,01,  Nur Mohammad Mollar Kandi,77,208,35,112,42,96,27.0,23.8,30.4,00000
86.0,14.0,12.0,260,27,01,  Muslem Dargar Kandi,46,187,26,88,20,99,19.7,22.8,16.8,00000
86.0,14.0,12.0,260,28,01,  Mongal Mazhir Kandi,42,129,18,62,24,67,24.6,22.5,26.4,00000
86.0,14.0,12.0,260,29,01,  Nantu Malot Kandi,140,146,65,64,75,82,49.0,50.4,47.8,00000
86.0,14.0,12.0,260,30,01,  Hazrat Mollar Kandi,35,53,11,24,24,29,39.8,31.4,45.3,00000
86.0,14.0,15.0,164,01,01,  Bhua Kandi,322,334,153,144,169,190,49.1,51.5,47.1,00000
86.0,14.0,15.0,164,02,01,  Pradhaniakandi,328,531,152,270,176,261,38.2,36.0,40.3,00000
86.0,14.0,15.0,164,03,01,  Purba Mridhakandi,127,274,61,143,66,131,31.7,29.9,33.5,00000
86.0,14.0,15.0,164,04,01,  Malek Beparirkandi,146,140,63,71,83,69,51.0,47.0,54.6,00000
86.0,14.0,15.0,164,05,01,  Paschim Mridhakandi,201,312,100,153,101,159,39.2,39.5,38.8,00000
86.0,14.0,15.0,164,06,01,  Purba Dhalikandi,277,66,134,29,143,37,80.8,82.2,79.4,00000
86.0,14.0,15.0,164,07,01,  Paschim Dhalikandi,421,1052,205,490,216,562,28.6,29.5,27.8,00000
86.0,14.0,15.0,164,08,01,  Manai Hawladarkandi,225,413,108,193,117,220,35.3,35.9,34.7,00000
86.0,14.0,15.0,164,09,01,  Sonikandi,606,472,302,223,304,249,56.2,57.5,55.0,00000
86.0,14.0,15.0,164,10,01,  Shabuddin Mollarkandi,109,94,57,47,52,47,53.7,54.8,52.5,00000
86.0,14.0,15.0,164,11,01,  Manai Hawladar Bazar,150,3,148,3,2,0,98.0,98.0,100.0,00000
86.0,14.0,15.0,164,12,01,  Palkandi,98,246,50,116,48,130,28.5,30.1,27.0,00000
86.0,14.0,15.0,164,13,01,  Azgarhaw. Kandi,265,505,142,245,123,260,34.4,36.7,32.1,00000
86.0,14.0,15.0,164,14,01,  Paidakandi,185,668,102,319,83,349,21.7,24.2,19.2,00000
86.0,14.0,15.0,164,15,01,  Khunikandi,282,656,133,326,149,330,30.1,29.0,31.1,00000
86.0,14.0,15.0,164,16,01,  Chairman Bazar,189,37,180,32,9,5,83.6,84.9,64.3,00000
86.0,14.0,15.0,164,17,01,  Kazikandi,177,171,94,78,83,93,50.9,54.7,47.2,00000
86.0,14.0,15.0,164,18,01,  Dewankandi,123,227,58,102,65,125,35.1,36.3,34.2,00000
86.0,14.0,15.0,164,19,01,  Osman Kharkandi,192,278,91,127,101,151,40.9,41.7,40.1,00000
86.0,14.0,15.0,164,20,01,  Deara Chowkidarkandi,73,294,31,142,42,152,19.9,17.9,21.6,00000
86.0,14.0,15.0,164,21,01,  Bokaulkandi,189,264,83,117,106,147,41.7,41.5,41.9,00000
86.0,14.0,15.0,164,22,01,  Paidkandi,373,322,195,151,178,171,53.7,56.4,51.0,00000
86.0,14.0,15.0,164,23,01,  Momin Ali Mollar Bazar,121,0,120,0,1,0,100.0,100.0,100.0,00000
86.0,14.0,15.0,164,24,01,  Bokaullahkandi,260,241,136,112,124,129,51.9,54.8,49.0,00000
86.0,14.0,15.0,164,25,01,  Gouranga Bazar,108,3,104,3,4,0,97.3,97.2,100.0,00000
86.0,14.0,15.0,164,26,01,  Paschim Manihowaladar Kandi,224,632,102,303,122,329,26.2,25.2,27.1,00000
86.0,14.0,15.0,164,27,01,  Radikandi,142,306,76,162,66,144,31.7,31.9,31.4,00000
86.0,14.0,15.0,164,28,01,  Ezafia Patna,148,243,74,125,74,118,37.9,37.2,38.5,00000
86.0,14.0,15.0,164,29,01,  Mani Howladar  Patna,196,472,103,229,93,243,29.3,31.0,27.7,00000
86.0,14.0,15.0,164,30,01,  Mallik Kandi,146,262,68,135,78,127,35.8,33.5,38.0,00000
86.0,14.0,15.0,164,31,01,  Hanifa Mollar Kandi,129,180,68,93,61,87,41.7,42.2,41.2,00000
86.0,14.0,15.0,196,01,01,  Gazikandi,159,220,79,112,80,108,42.0,41.4,42.6,00000
86.0,14.0,15.0,196,02,01,  Char Gopalpur Malotkandi,299,453,136,226,163,227,39.8,37.6,41.8,00000
86.0,14.0,15.0,470,01,01,  Miar Char Mollahkandi,23,69,8,31,15,38,25.0,20.5,28.3,00000
86.0,14.0,15.0,470,02,01,  Miar Malotkandi,149,165,76,74,73,91,47.5,50.7,44.5,00000
86.0,14.0,15.0,470,03,01,  Gopalpur Patna & Malotkandi,187,452,87,220,100,232,29.3,28.3,30.1,00000
86.0,14.0,15.0,470,04,01,  Chowkidarkandi,292,350,124,168,168,182,45.5,42.5,48.0,00000
86.0,14.0,15.0,470,05,01,  Soyalkandi,96,233,56,116,40,117,29.2,32.6,25.5,00000
86.0,14.0,15.0,470,06,01,  Majhikandi,246,433,112,205,134,228,36.2,35.3,37.0,00000
86.0,14.0,17.0,054,01,01,  Rahim Beparirkandi,208,210,104,93,104,117,49.8,52.8,47.1,00000
86.0,14.0,17.0,054,02,01,  Gani Munshirkandi,106,225,61,105,45,120,32.0,36.7,27.3,00000
86.0,14.0,17.0,054,03,01,  Nazim Uddin Mollarkandi,211,248,90,120,121,128,46.0,42.9,48.6,00000
86.0,14.0,17.0,054,04,01,  Gani Mollarkandi,97,274,47,130,50,144,26.1,26.6,25.8,00000
86.0,14.0,17.0,054,05,01,  Haji Makbul Mollarkandi,108,92,56,44,52,48,54.0,56.0,52.0,00000
86.0,14.0,17.0,054,06,01,  Osman Munshirkandi,75,149,31,67,44,82,33.5,31.6,34.9,00000
86.0,14.0,17.0,054,07,01,  Azizul Mollarkandi,117,139,47,70,70,69,45.7,40.2,50.4,00000
86.0,14.0,17.0,054,08,01,  Nurmohammad Mollarkandi,12,39,3,22,9,17,23.5,12.0,34.6,00000
86.0,14.0,17.0,328,01,01,  Haji Gafur Ali Mollarkandi,222,234,87,113,135,121,48.7,43.5,52.7,00000
86.0,14.0,17.0,328,02,01,  Haji Alimullahkandi,39,2,18,1,21,1,95.1,94.7,95.5,00000
86.0,14.0,17.0,328,03,01,  Char Kumaria Bazar,163,360,76,185,87,175,31.2,29.1,33.2,00000
86.0,14.0,17.0,328,04,01,  Hawladerkandi,109,169,43,82,66,87,39.2,34.4,43.1,00000
86.0,14.0,17.0,426,01,01,  Yakub Hawladarkandi,176,232,86,102,90,130,43.1,45.7,40.9,00000
86.0,14.0,17.0,426,02,01,  Chandu Sardarkandi,230,565,103,283,127,282,28.9,26.7,31.1,00000
86.0,14.0,17.0,426,03,01,  Soab Ali Sardarkandi,155,395,60,185,95,210,28.2,24.5,31.1,00000
86.0,14.0,17.0,579,01,01,  Subud Ali Mollarkandi,379,464,195,223,184,241,45.0,46.7,43.3,00000
86.0,14.0,17.0,579,02,01,  Faizuiddin Mollarkandi,157,243,74,112,83,131,39.3,39.8,38.8,00000
86.0,14.0,17.0,623,01,01,  Kajal Mollarkandi,195,235,89,109,106,126,45.3,44.9,45.7,00000
86.0,14.0,17.0,623,02,01,  Khalek Sardarkandi,75,94,31,43,44,51,44.4,41.9,46.3,00000
86.0,14.0,17.0,623,03,01,  Azizul Sarkarkandi,67,173,32,84,35,89,27.9,27.6,28.2,00000
86.0,14.0,17.0,688,01,01,  Majid Ali Mollarkandi,48,214,20,103,28,111,18.3,16.3,20.1,00000
86.0,14.0,17.0,688,02,01,  Makbul Sikdarkandi,16,80,6,44,10,36,16.7,12.0,21.7,00000
86.0,14.0,17.0,688,03,01,  Kalu Dewankandi,57,310,26,158,31,152,15.5,14.1,16.9,00000
86.0,14.0,17.0,688,04,01,  Solaiman Mollarkandi,54,123,29,62,25,61,30.5,31.9,29.1,00000
86.0,14.0,17.0,688,05,01,  Chan Miarkandi,28,88,11,44,17,44,24.1,20.0,27.9,00000
86.0,14.0,17.0,743,01,01,  Kalai Dewankandi,67,234,34,112,33,122,22.3,23.3,21.3,00000
86.0,14.0,17.0,743,02,01,  Ukilkandi,21,62,11,32,10,30,25.3,25.6,25.0,00000
86.0,14.0,17.0,743,03,01,  Soleman Malerkandi,103,156,49,66,54,90,39.8,42.6,37.5,00000
86.0,14.0,17.0,743,04,01,  Paidakandi,38,59,18,26,20,33,39.2,40.9,37.7,00000
86.0,14.0,17.0,994,01,01,  Hawladarkandi,602,926,262,422,340,504,39.4,38.3,40.3,00000
86.0,14.0,17.0,994,02,01,  Wahab Masterkandi,34,147,12,76,22,71,18.8,13.6,23.7,00000
86.0,14.0,17.0,994,03,01,  Dhalikandi,139,192,67,84,72,108,42.0,44.4,40.0,00000
86.0,14.0,17.0,994,04,01,  Gani Beparikandi,33,226,16,109,17,117,12.7,12.8,12.7,00000
86.0,14.0,17.0,994,05,01,  Raju Munshirkandi,76,189,29,85,47,104,28.7,25.4,31.1,00000
86.0,14.0,17.0,994,06,01,  Ayub Ali Malerkandi,72,126,28,54,44,72,36.4,34.1,37.9,00000
86.0,14.0,17.0,994,08,01,  Lalu Beparikandi,213,154,100,72,113,82,58.0,58.1,57.9,00000
86.0,14.0,17.0,994,09,01,  Gafur Mollarkandi,121,162,59,75,62,87,42.8,44.0,41.6,00000
86.0,14.0,17.0,994,10,01,  Harun Soialkandi,77,116,38,50,39,66,39.9,43.2,37.1,00000
86.0,14.0,17.0,994,11,01,  Kalai Sardarkandi,115,277,51,121,64,156,29.3,29.7,29.1,00000
86.0,14.0,17.0,994,12,01,  Ketab Uddinkandi,181,133,87,52,94,81,57.6,62.6,53.7,00000
86.0,14.0,17.0,994,13,01,  Ismail Majhirkandi,118,343,55,151,63,192,25.6,26.7,24.7,00000
86.0,14.0,28.0,284,01,01,  Char Census Balakandi,869,1552,418,723,451,829,35.9,36.6,35.2,00000
86.0,14.0,28.0,284,02,01,  Majher Char,133,197,68,102,65,95,40.3,40.0,40.6,00000
86.0,14.0,28.0,284,03,01,  Zia Kandi,118,485,52,234,66,251,19.6,18.2,20.8,00000
86.0,14.0,28.0,306,01,01,  Sikder Kandi,199,265,83,130,116,135,42.9,39.0,46.2,00000
86.0,14.0,28.0,306,02,01,  Magon Pudu Bepari Kandi,21,107,8,53,13,54,16.4,13.1,19.4,00000
86.0,14.0,28.0,306,03,01,  Tara Bonia Majher Char,184,160,127,80,57,80,53.5,61.4,41.6,00000
86.0,14.0,28.0,306,04,01,  Ali Mal Kandi,213,676,100,303,113,373,24.0,24.8,23.3,00000
86.0,14.0,28.0,306,05,01,  Matbar Kandi,164,318,67,135,97,183,34.0,33.2,34.6,00000
86.0,14.0,28.0,306,06,01,  Whab Bala Kandi,95,127,41,58,54,69,42.8,41.4,43.9,00000
86.0,14.0,28.0,306,07,01,  Nomo Kandi,125,159,64,64,61,95,44.0,50.0,39.1,00000
86.0,14.0,28.0,306,08,01,  Bala Kandi,273,232,126,117,147,115,54.1,51.9,56.1,00000
86.0,14.0,28.0,306,09,01,  Juto Beparikand,109,164,54,67,55,97,39.9,44.6,36.2,00000
86.0,14.0,28.0,721,01,01,  Chakder Kandi,88,362,42,177,46,185,19.6,19.2,19.9,00000
86.0,14.0,28.0,721,02,01,  Karim Munsir Kandi,170,653,70,329,100,324,20.7,17.5,23.6,00000
86.0,14.0,28.0,721,03,01,  Satter) Molla Kand,178,273,94,121,84,152,39.5,43.7,35.6,00000
86.0,14.0,28.0,721,04,01,  Amir Didar Kandi,446,723,207,410,239,313,38.2,33.5,43.3,00000
86.0,14.0,28.0,721,05,01,  Gazi Kandi (Mona),224,981,129,502,95,479,18.6,20.4,16.6,00000
86.0,14.0,28.0,721,06,01,  Azahar Bala Kandi,156,728,67,363,89,365,17.6,15.6,19.6,00000
86.0,14.0,28.0,721,07,01,  Khalasi Kandi,119,791,58,382,61,409,13.1,13.2,13.0,00000
86.0,14.0,32.0,295,01,01,  Chhota Khar Kandi,92,551,45,282,47,269,14.3,13.8,14.9,00000
86.0,14.0,32.0,295,02,01,  Nawab Ali Majhi Kandi,127,690,55,344,72,346,15.5,13.8,17.2,00000
86.0,14.0,32.0,306,01,01,  Sekh & Molla Kandi,56,346,24,170,32,176,13.9,12.4,15.4,00000
86.0,14.0,32.0,306,02,01,  Mahabbat Ali Molla Kandi,201,917,88,434,113,483,18.0,16.9,19.0,00000
86.0,14.0,32.0,306,03,01,  Sayed Bepari Kandi,51,210,25,99,26,111,19.5,20.2,19.0,00000
86.0,14.0,32.0,306,04,01,  Zafar Maler Kandi,57,286,24,139,33,147,16.6,14.7,18.3,00000
86.0,14.0,32.0,306,05,01,  Ali Akbar Molla Kandi,64,166,28,87,36,79,27.8,24.3,31.3,00000
86.0,14.0,32.0,306,06,01,  Dudu Miah Bepari Kandi,199,347,82,174,117,173,36.4,32.0,40.3,00000
86.0,14.0,32.0,306,07,01,  Monu Miah Chowdury Kandi,81,326,31,144,50,182,19.9,17.7,21.6,00000
86.0,14.0,32.0,306,08,01,  Sarif Prodhania Kandi,10,38,4,20,6,18,20.8,16.7,25.0,00000
86.0,14.0,32.0,306,09,01,  Miah & Dhali Kandi,140,314,64,156,76,158,30.8,29.1,32.5,00000
86.0,14.0,32.0,306,10,01,  Kader Molla Kandi,23,160,10,64,13,96,12.6,13.5,11.9,00000
86.0,14.0,32.0,306,11,01,  Afa Molla Kandi,177,687,63,331,114,356,20.5,16.0,24.3,00000
86.0,14.0,32.0,306,12,01,  Kader Bukaul Kandi,159,332,71,165,88,167,32.4,30.1,34.5,00000
86.0,14.0,32.0,306,13,01,  Hasem Bukaul Kandi,170,249,78,133,92,116,40.6,37.0,44.2,00000
86.0,14.0,32.0,306,14,01,  Khalil Mal Kandi,294,379,130,170,164,209,43.7,43.3,44.0,00000
86.0,14.0,32.0,306,15,01,  Siraj Halder Kandi,201,196,107,95,94,101,50.6,53.0,48.2,00000
86.0,14.0,32.0,306,16,01,  Auzit Mal Kandi,130,220,56,105,74,115,37.1,34.8,39.2,00000
86.0,14.0,32.0,306,17,01,  Rahmat Prodhania Kandi,64,375,22,167,42,208,14.6,11.6,16.8,00000
86.0,14.0,32.0,306,18,01,  Sekandar Mazi Kandi,40,205,22,93,18,112,16.3,19.1,13.8,00000
86.0,14.0,32.0,306,19,01,  Dorgi Kandi,90,187,31,90,59,97,32.5,25.6,37.8,00000
86.0,14.0,32.0,459,01,01,  Bepari Kandi,63,409,26,188,37,221,13.3,12.1,14.3,00000
86.0,14.0,32.0,459,02,01,  Mal Kandi,104,369,41,182,63,187,22.0,18.4,25.2,00000
86.0,14.0,32.0,568,01,01,  Lalu Bepari Kandi,119,474,54,220,65,254,20.1,19.7,20.4,00000
86.0,14.0,32.0,568,02,01,  Keramat Prodhania Kandi,157,562,69,266,88,296,21.8,20.6,22.9,00000
86.0,14.0,32.0,590,01,01,  Ebrahim Majir Kandi,62,253,19,118,43,135,19.7,13.9,24.2,00000
86.0,14.0,32.0,590,02,01,  Manzil Dali Kandi,96,264,40,132,56,132,26.7,23.3,29.8,00000
86.0,14.0,32.0,590,03,01,  Akram Maji Kandi,104,193,42,89,62,104,35.0,32.1,37.3,00000
86.0,14.0,43.0,174,01,01,  Mokbul Munshirkandi,525,483,221,207,304,276,52.1,51.6,52.4,00000
86.0,14.0,43.0,174,02,01,  Dewankandi,198,70,96,33,102,37,73.9,74.4,73.4,00000
86.0,14.0,43.0,174,03,01,  Ukilkandi,172,202,75,97,97,105,46.0,43.6,48.0,00000
86.0,14.0,43.0,174,04,01,  Hawladarkandi,239,64,105,30,134,34,78.9,77.8,79.8,00000
86.0,14.0,43.0,174,05,01,  Ukiluddin Dhalirkandi,157,183,71,82,86,101,46.2,46.4,46.0,00000
86.0,14.0,43.0,174,06,01,  Kalu Beparikandi,125,84,57,37,68,47,59.8,60.6,59.1,00000
86.0,14.0,43.0,174,07,01,  Malkandi,268,189,118,85,150,104,58.6,58.1,59.1,00000
86.0,14.0,43.0,174,08,01,  Khasmahal Eman Beparikandi,253,110,112,56,141,54,69.7,66.7,72.3,00000
86.0,14.0,43.0,174,09,01,  Nurul Haq Hawlader Kandi,97,34,47,12,50,22,74.0,79.7,69.4,00000
86.0,14.0,43.0,174,10,01,  Kalu Munsir Kandi,146,204,67,95,79,109,41.7,41.4,42.0,00000
86.0,14.0,43.0,174,11,01,  Bakaul Kandi,205,154,94,68,111,86,57.1,58.0,56.3,00000
86.0,14.0,43.0,174,12,01,  Momin Hawlader Kandi,156,159,74,75,82,84,49.5,49.7,49.4,00000
86.0,14.0,43.0,207,01,01,  Abul Hossain Sarkarkandi,202,120,101,54,101,66,62.7,65.2,60.5,00000
86.0,14.0,43.0,207,02,01,  Gazikandi,354,381,182,185,172,196,48.2,49.6,46.7,00000
86.0,14.0,43.0,251,01,01,  Belayet Hossain Sardarkandi,747,405,344,173,403,232,64.8,66.5,63.5,00000
86.0,14.0,43.0,251,02,01,  Aftabuddin Sardarkandi,57,111,27,57,30,54,33.9,32.1,35.7,00000
86.0,14.0,43.0,251,03,01,  Yakub Munshirkandi,104,168,49,82,55,86,38.2,37.4,39.0,00000
86.0,14.0,43.0,251,04,01,  Ali Hossain Sardarkandi,275,147,142,71,133,76,65.2,66.7,63.6,00000
86.0,14.0,43.0,251,05,01,  Hajikandi,191,170,91,83,100,87,52.9,52.3,53.5,00000
86.0,14.0,43.0,251,06,01,  Rarikandi,230,330,121,155,109,175,41.1,43.8,38.4,00000
86.0,14.0,43.0,251,07,01,  Mollahkandi,259,165,107,69,152,96,61.1,60.8,61.3,00000
86.0,14.0,43.0,251,08,01,  Surjya Mollarkandi,70,62,32,26,38,36,53.0,55.2,51.4,00000
86.0,14.0,43.0,251,09,01,  Idrish Ali Kandi,80,79,31,35,49,44,50.3,47.0,52.7,00000
86.0,14.0,43.0,251,10,01,  Dhali Kandi,148,136,60,62,88,74,52.1,49.2,54.3,00000
86.0,14.0,43.0,360,01,01,  Munshikandi,139,168,58,72,81,96,45.3,44.6,45.8,00000
86.0,14.0,43.0,360,02,01,  Ukilkandi,254,183,120,90,134,93,58.1,57.1,59.0,00000
86.0,14.0,43.0,360,03,01,  Sardarkandi,135,141,57,64,78,77,48.9,47.1,50.3,00000
86.0,14.0,43.0,360,04,01,  Afiruddin Madbarkandi,159,92,70,41,89,51,63.3,63.1,63.6,00000
86.0,14.0,43.0,360,05,01,  Hawladarkandi,139,93,51,45,88,48,59.9,53.1,64.7,00000
86.0,14.0,43.0,360,06,01,  Mollahkandi,222,110,102,36,120,74,66.9,73.9,61.9,00000
86.0,14.0,43.0,360,07,01,  Wahab Dhalirkandi,277,301,116,136,161,165,47.9,46.0,49.4,00000
86.0,14.0,43.0,360,08,01,  Yakub Beparikandi,280,426,114,198,166,228,39.7,36.5,42.1,00000
86.0,14.0,43.0,360,09,01,  Kader Sarkarkandi,121,267,52,123,69,144,31.2,29.7,32.4,00000
86.0,14.0,43.0,360,10,01,  Majhikandi Paschimpara,143,200,58,88,85,112,41.7,39.7,43.1,00000
86.0,14.0,43.0,360,11,01,  Majhikandi Purbapara,133,175,59,76,74,99,43.2,43.7,42.8,00000
86.0,14.0,43.0,360,12,01,  Kadali Matbarkandi,188,166,89,65,99,101,53.1,57.8,49.5,00000
86.0,14.0,43.0,360,13,01,  Momen Ali Matbarkandi,118,222,47,101,71,121,34.7,31.8,37.0,00000
86.0,14.0,43.0,360,14,01,  Digar Mahishkhali Bazar,52,69,33,49,19,20,43.0,40.2,48.7,00000
86.0,14.0,43.0,360,15,01,  Musalmankandi,76,75,30,35,46,40,50.3,46.2,53.5,00000
86.0,14.0,43.0,360,16,01,  Musay Sarkarkandi,144,106,65,47,79,59,57.6,58.0,57.2,00000
86.0,14.0,43.0,360,17,01,  Malotkandi,229,26,104,11,125,15,89.8,90.4,89.3,00000
86.0,14.0,43.0,360,18,01,  Akonkandi,33,95,11,46,22,49,25.8,19.3,31.0,00000
86.0,14.0,43.0,360,19,01,  Hajikandi,42,85,13,40,29,45,33.1,24.5,39.2,00000
86.0,14.0,43.0,360,20,01,  Hazrat Alikandi,61,19,29,8,32,11,76.3,78.4,74.4,00000
86.0,14.0,43.0,360,21,01,  Gazikandi,154,259,73,118,81,141,37.3,38.2,36.5,00000
86.0,14.0,43.0,360,22,01,  Dawan Kandi,133,135,55,63,78,72,49.6,46.6,52.0,00000
86.0,14.0,43.0,360,23,01,  Kashem Pur,147,165,79,72,68,93,47.1,52.3,42.2,00000
86.0,14.0,51.0,070,01,01,  Karimdia Uttar & Dakshin,229,676,121,353,108,323,25.3,25.5,25.1,00000
86.0,14.0,51.0,070,02,01,  Yakub Sardarkandi,212,883,124,456,88,427,19.4,21.4,17.1,00000
86.0,14.0,51.0,382,01,01,  Kashem Dewankandi,246,23,136,11,110,12,91.4,92.5,90.2,00000
86.0,14.0,51.0,382,03,01,  Rob Beparikandi,210,279,129,135,81,144,42.9,48.9,36.0,00000
86.0,14.0,51.0,382,04,01,  Aziz Ali Beparikandi,197,342,111,171,86,171,36.5,39.4,33.5,00000
86.0,14.0,51.0,382,05,01,  S.Ali Hawladarkandi & K.Bakul,146,326,78,158,68,168,30.9,33.1,28.8,00000
86.0,14.0,51.0,382,06,01,  Madua Mollarkandi,147,266,77,141,70,125,35.6,35.3,35.9,00000
86.0,14.0,51.0,382,09,01,  Hashem Hawladarkandi,279,240,140,127,139,113,53.8,52.4,55.2,00000
86.0,14.0,51.0,382,11,01,  Sardarkandi,219,294,118,145,101,149,42.7,44.9,40.4,00000
86.0,14.0,51.0,518,01,01,  Yunus Hawladarkandi,59,250,28,129,31,121,19.1,17.8,20.4,00000
86.0,14.0,51.0,518,02,01,  Sadim Ali Hawladarkandi,190,214,113,110,77,104,47.0,50.7,42.5,00000
86.0,14.0,51.0,518,03,01,  Salam Munshirkandi,383,381,223,193,160,188,50.1,53.6,46.0,00000
86.0,14.0,51.0,518,04,01,  Meser Ali Sardarkandi,261,595,142,301,119,294,30.5,32.1,28.8,00000
86.0,14.0,86.0,273,01,01,  Bahauddin Munshikandi,281,428,125,202,156,226,39.6,38.2,40.8,00000
86.0,14.0,86.0,273,02,01,  Talukakandi,436,321,190,145,246,176,57.6,56.7,58.3,00000
86.0,14.0,86.0,273,03,01,  Naimuddin Sardarkandi,520,435,253,194,267,241,54.5,56.6,52.6,00000
86.0,14.0,86.0,273,05,01,  Sarkar And Mallik Kandi,235,232,113,94,122,138,50.3,54.6,46.9,00000
86.0,14.0,86.0,273,06,01,  Nayan Sarkarkandi,562,333,258,158,304,175,62.8,62.0,63.5,00000
86.0,14.0,86.0,273,07,01,  Sayalkandi,441,221,209,86,232,135,66.6,70.8,63.2,00000
86.0,14.0,86.0,273,08,01,  Bepari Para,710,371,318,154,392,217,65.7,67.4,64.4,00000
86.0,14.0,86.0,273,09,01,  Bepari Para Patna,212,308,91,135,121,173,40.8,40.3,41.2,00000
86.0,14.0,86.0,273,10,01,  Mayer Chand Sardarkandi,189,200,84,89,105,111,48.6,48.6,48.6,00000
86.0,14.0,86.0,273,11,01,  Haji Yusuf Sarkarkandi,146,305,63,146,83,159,32.4,30.1,34.3,00000
86.0,14.0,86.0,273,12,01,  Hajikandi,206,181,98,80,108,101,53.2,55.1,51.7,00000
86.0,14.0,86.0,273,13,01,  Rarikandi,350,271,163,108,187,163,56.4,60.1,53.4,00000
86.0,14.0,86.0,273,14,01,  Madbarkandi,373,526,185,243,188,283,41.5,43.2,39.9,00000
86.0,14.0,86.0,273,15,01,  Ayub Ali Sardarpara,384,221,181,105,203,116,63.5,63.3,63.6,00000
86.0,14.0,86.0,273,16,01,  Sakhipur Bazar,296,68,208,41,88,27,81.3,83.5,76.5,00000
86.0,14.0,86.0,273,17,01,  Nur Mohammad Masterkandi,149,274,70,123,79,151,35.2,36.3,34.3,00000
86.0,14.0,86.0,273,18,01,  Rashid Bepari Bazar,26,9,26,9,0,0,74.3,74.3,0.0,00000
86.0,14.0,86.0,273,19,01,  Mozaffar Matbor Patan,130,130,65,59,65,71,50.0,52.4,47.8,00000
86.0,14.0,86.0,273,20,01,  Madhu Sarkarkandi,566,569,241,251,325,318,49.9,49.0,50.5,00000
86.0,14.0,86.0,273,21,01,  Kabir Howladarkandi,156,208,68,91,88,117,42.9,42.8,42.9,00000
86.0,14.0,86.0,273,22,01,  Station Bazar,17,10,17,10,0,0,63.0,63.0,0.0,00000
86.0,14.0,86.0,273,23,01,  Abdul Rashid Beparirkandi,535,612,275,277,260,335,46.6,49.8,43.7,00000
86.0,14.0,86.0,273,24,01,  Sonabuddin Munshirkandi,122,323,46,146,76,177,27.4,24.0,30.0,00000
86.0,14.0,86.0,273,25,01,  Kalai Majhikandi,137,187,55,78,82,109,42.3,41.4,42.9,00000
86.0,14.0,86.0,273,26,01,  Malotkandi,251,355,110,151,141,204,41.4,42.1,40.9,00000
86.0,14.0,86.0,273,27,01,  Arif Ali Beparikandi,260,129,108,64,152,65,66.8,62.8,70.0,00000
86.0,14.0,86.0,273,28,01,  Eman Ali Mollahkandi,336,209,160,89,176,120,61.7,64.3,59.5,00000
86.0,14.0,86.0,273,29,01,  Jamir Dhalikandi,271,232,134,96,137,136,53.9,58.3,50.2,00000
86.0,14.0,86.0,273,30,01,  Ayub Ali Sarkar Patna,145,242,66,115,79,127,37.5,36.5,38.3,00000
86.0,14.0,86.0,273,31,01,  Rostom Majhikandi,248,223,118,108,130,115,52.7,52.2,53.1,00000
86.0,14.0,86.0,273,32,01,  Majhi Mollahkandi,130,90,66,40,64,50,59.1,62.3,56.1,00000
86.0,14.0,86.0,273,33,01,  Anu Sarkarkandi,699,599,335,288,364,311,53.9,53.8,53.9,00000
86.0,14.0,86.0,273,35,01,  Sonamia Prodania Kandi,246,236,125,104,121,132,51.0,54.6,47.8,00000
86.0,14.0,86.0,273,37,01,  Sakhipur Kanchi Katakandi,212,169,81,74,131,95,55.6,52.3,58.0,00000
86.0,14.0,86.0,273,38,01,  Dewan Kandi,137,136,57,63,80,73,50.2,47.5,52.3,00000
86.0,14.0,86.0,273,39,01,  Hazrat Ali Munshik,224,206,99,96,125,110,52.1,50.8,53.2,00000
86.0,14.0,86.0,273,40,01,  Nur Mohd.Master Patna,117,213,56,103,61,110,35.5,35.2,35.7,00000
86.0,14.0,86.0,273,41,01,  Hamid Munshi Kandi,101,180,46,93,55,87,35.9,33.1,38.7,00000
86.0,14.0,86.0,273,42,01,  Alam Chand Kandi,56,299,18,146,38,153,15.8,11.0,19.9,00000
86.0,14.0,86.0,273,43,01,  Kanchi Kata Patan,137,205,50,96,87,109,40.1,34.2,44.4,00000
86.0,14.0,94.0,306,01,01,  Reju Haldarkandi,189,598,97,293,92,305,24.0,24.9,23.2,00000
86.0,14.0,94.0,306,02,01,  Nawab Sarkarkandi,196,403,93,201,103,202,32.7,31.6,33.8,00000
86.0,14.0,94.0,306,03,01,  Rahim Beparikandi,107,190,52,91,55,99,36.0,36.4,35.7,00000
86.0,14.0,94.0,306,04,01,  Montaz Uddinkandi,110,236,47,102,63,134,31.8,31.5,32.0,00000
86.0,14.0,94.0,306,05,01,  Keramat Beparikandi,150,451,74,198,76,253,25.0,27.2,23.1,00000
86.0,14.0,94.0,306,06,01,  Rahim Boxkandi,193,282,84,130,109,152,40.6,39.3,41.8,00000
86.0,14.0,94.0,306,07,01,  Baghkandi,29,334,15,174,14,160,8.0,7.9,8.0,00000
86.0,14.0,94.0,306,08,01,  Rashid Majhikandi,171,230,95,107,76,123,42.6,47.0,38.2,00000
86.0,14.0,94.0,306,10,01,  Saheb Uddin Mollahkandi,136,206,70,99,66,107,39.8,41.4,38.2,00000
86.0,14.0,94.0,306,11,01,  Habibur Rahmankandi,89,196,47,92,42,104,31.2,33.8,28.8,00000
86.0,14.0,94.0,306,12,01,  Aroub Ali Mollahkandi,116,344,53,171,63,173,25.2,23.7,26.7,00000
86.0,14.0,94.0,306,13,01,  A.Rahman Dhalikandi,203,365,89,172,114,193,35.7,34.1,37.1,00000
86.0,14.0,94.0,306,14,01,  Kalu Dewankandi,75,181,26,85,49,96,29.3,23.4,33.8,00000
86.0,14.0,94.0,306,15,01,  Namokandi,173,290,62,148,111,142,37.4,29.5,43.9,00000
86.0,14.0,94.0,306,16,01,  Madan Dhalikandi,191,299,93,147,98,152,39.0,38.8,39.2,00000
86.0,14.0,94.0,306,17,01,  Ansar Ali Masterkandi,183,456,72,211,111,245,28.6,25.4,31.2,00000
86.0,14.0,94.0,306,18,01,  Asmanikandi,125,579,60,271,65,308,17.8,18.1,17.4,00000
86.0,14.0,94.0,306,19,01,  Beparikandi,101,196,43,91,58,105,34.0,32.1,35.6,00000
86.0,14.0,94.0,306,20,01,  Lelu Gazikandi,84,202,40,96,44,106,29.4,29.4,29.3,00000
86.0,14.0,94.0,306,21,01,  Kala Miah Sarkarkandi,149,360,65,176,84,184,29.3,27.0,31.3,00000
86.0,14.0,94.0,306,22,01,  Tantikandi,489,574,230,248,259,326,46.0,48.1,44.3,00000
86.0,14.0,94.0,306,24,01,  Khas Kandi,396,668,181,290,215,378,37.2,38.4,36.3,00000
86.0,14.0,94.0,306,26,01,  Gayenkandi,139,427,63,189,76,238,24.6,25.0,24.2,00000
86.0,14.0,94.0,306,27,01,  Chairmankandi,143,293,72,146,71,147,32.8,33.0,32.6,00000
86.0,14.0,94.0,306,28,01,  Pradhaniakandi,140,261,61,113,79,148,34.9,35.1,34.8,00000
86.0,14.0,94.0,306,29,01,  Rouf Beparikandi,282,1002,129,470,153,532,22.0,21.5,22.3,00000
86.0,14.0,94.0,306,30,01,  Akram Rari Bazar,103,220,43,100,60,120,31.9,30.1,33.3,00000
86.0,14.0,94.0,306,31,01,  Rari And Mollahkandi,22,353,9,184,13,169,5.9,4.7,7.1,00000
86.0,14.0,94.0,306,32,01,  Manu Mazarkandi,115,563,45,247,70,316,17.0,15.4,18.1,00000
86.0,14.0,94.0,306,33,01,  Matbarkandi,152,376,66,167,86,209,28.8,28.3,29.2,00000
86.0,14.0,94.0,306,34,01,  Mona Pradhaniakandi,239,720,109,349,130,371,24.9,23.8,25.9,00000
86.0,14.0,94.0,306,35,01,  Sarker Kandi,166,234,78,105,88,129,41.5,42.6,40.6,00000
86.0,25.0,35.0,232,01,01,  Baidyakandi,33,28,18,13,15,15,54.1,58.1,50.0,00000
86.0,25.0,35.0,232,02,01,  Howladarkandi,159,178,83,80,76,98,47.2,50.9,43.7,00000
86.0,25.0,35.0,232,03,01,  Chaihisa,138,137,75,56,63,81,50.2,57.3,43.8,00000
86.0,25.0,35.0,232,04,01,  Haldarkandi,413,555,204,255,209,300,42.7,44.4,41.1,00000
86.0,25.0,35.0,232,05,01,  Talukdarkandi,156,227,71,108,85,119,40.7,39.7,41.7,00000
86.0,25.0,35.0,232,06,01,  Biswaskandi,216,282,101,137,115,145,43.4,42.4,44.2,00000
86.0,25.0,35.0,232,07,01,  Balakandi,152,137,79,68,73,69,52.6,53.7,51.4,00000
86.0,25.0,35.0,232,08,01,  Bhadurkandi,152,645,71,307,81,338,19.1,18.8,19.3,00000
86.0,25.0,35.0,232,09,01,  Mollahkandi,332,639,179,285,153,354,34.2,38.6,30.2,00000
86.0,25.0,35.0,232,10,01,  Matherkandi,224,286,138,139,86,147,43.9,49.8,36.9,00000
86.0,25.0,35.0,232,11,01,  Baraikandi,217,212,112,97,105,115,50.6,53.6,47.7,00000
86.0,25.0,35.0,232,12,01,  Kazikandi,42,119,22,66,20,53,26.1,25.0,27.4,00000
86.0,25.0,35.0,232,13,01,  Baliakandi,33,96,23,48,10,48,25.6,32.4,17.2,00000
86.0,25.0,59.0,149,01,01,  Sattar Bepari Kandi,148,174,76,78,72,96,46.0,49.4,42.9,00000
86.0,25.0,59.0,149,02,01,  Karim Shibkandi,78,352,33,159,45,193,18.1,17.2,18.9,00000
86.0,25.0,59.0,149,03,01,  Hakim Mollarkandi,10,80,4,39,6,41,11.1,9.3,12.8,00000
86.0,25.0,59.0,149,04,01,  Ayub Beparikandi,177,258,76,115,101,143,40.7,39.8,41.4,00000
86.0,25.0,59.0,149,05,01,  Gafur Beparikandi,118,127,67,67,51,60,48.2,50.0,45.9,00000
86.0,25.0,59.0,149,06,01,  Faju Sardarerkandi,170,375,74,179,96,196,31.2,29.2,32.9,00000
86.0,25.0,59.0,149,07,01,  Majid Dewanerkandi,90,156,48,80,42,76,36.6,37.5,35.6,00000
86.0,25.0,59.0,149,08,01,  Younus Sardarerkandi,104,126,48,51,56,75,45.2,48.5,42.7,00000
86.0,25.0,59.0,149,09,01,  Badshah Beparikandi,62,115,36,49,26,66,35.0,42.4,28.3,00000
86.0,25.0,59.0,149,10,01,  Ukilkandi,95,143,48,68,47,75,39.9,41.4,38.5,00000
86.0,25.0,59.0,149,11,01,  Ochan Sardarerkandi,87,151,39,69,48,82,36.6,36.1,36.9,00000
86.0,25.0,59.0,149,12,01,  Nuruzzaman Ukilkandi,73,197,36,96,37,101,27.0,27.3,26.8,00000
86.0,25.0,59.0,149,13,01,  Sekandar Majhikandi,188,241,83,118,105,123,43.8,41.3,46.1,00000
86.0,25.0,59.0,149,14,01,  Badshah Miah Sardarkandi,33,75,17,29,16,46,30.6,37.0,25.8,00000
86.0,25.0,59.0,149,15,01,  Gani Malerkandi,17,92,6,38,11,54,15.6,13.6,16.9,00000
86.0,25.0,59.0,248,01,01,  Abdul Karim Hawladarkandi,176,526,85,247,91,279,25.1,25.6,24.6,00000
86.0,25.0,59.0,248,02,01,  Abdul Karim Ukilkandi,155,82,77,42,78,40,65.4,64.7,66.1,00000
86.0,25.0,59.0,248,03,01,  Pedakandi,170,392,101,181,69,211,30.2,35.8,24.6,00000
86.0,25.0,59.0,248,04,01,  Punu Howladarkandi,180,83,91,36,89,47,68.4,71.7,65.4,00000
86.0,25.0,59.0,248,05,01,  Sailkandi,37,60,17,27,20,33,38.1,38.6,37.7,00000
86.0,25.0,59.0,248,06,01,  Faju Madbarerkandi,240,368,92,190,148,178,39.5,32.6,45.4,00000
86.0,25.0,59.0,248,07,01,  Katu Beparikandi,107,223,51,112,56,111,32.4,31.3,33.5,00000
86.0,25.0,59.0,248,08,01,  Fazal Haque Masterkandi,53,201,22,98,31,103,20.9,18.3,23.1,00000
86.0,25.0,59.0,248,09,01,  Shamsul Haque Hawladarkandi,187,381,79,181,108,200,32.9,30.4,35.1,00000
86.0,25.0,59.0,248,10,01,  Fazlul Haque Dafadarkandi,77,170,37,74,40,96,31.2,33.3,29.4,00000
86.0,25.0,59.0,331,01,01,  Gafur Beparikandi,111,102,58,47,53,55,52.1,55.2,49.1,00000
86.0,25.0,59.0,331,02,01,  Meher Ali Kharkandi,112,32,64,17,48,15,77.8,79.0,76.2,00000
86.0,25.0,59.0,414,01,01,  Abdul Aziz Mollahkandi,87,220,39,94,48,126,28.3,29.3,27.6,00000
86.0,25.0,59.0,414,02,01,  Ahim Ali Mollahkandi,86,59,47,29,39,30,59.3,61.8,56.5,00000
86.0,25.0,59.0,414,03,01,  Ayub Ali Sardarkandi,35,51,14,20,21,31,40.7,41.2,40.4,00000
86.0,25.0,59.0,414,04,01,  Sekandar Paikerkandi,51,27,24,11,27,16,65.4,68.6,62.8,00000
86.0,25.0,59.0,514,01,01,  Jahur Mollarkandi,82,124,36,58,46,66,39.8,38.3,41.1,00000
86.0,25.0,59.0,514,02,01,  Ayub Ali Majhirkandi,60,106,24,52,36,54,36.1,31.6,40.0,00000
86.0,25.0,59.0,514,03,01,  Somar Hawladarkandi,94,159,37,73,57,86,37.2,33.6,39.9,00000
86.0,25.0,59.0,514,04,01,  Alomsha Majhirkandi,138,86,53,39,85,47,61.6,57.6,64.4,00000
86.0,25.0,59.0,514,05,01,  Jalil Chowkidarkandi,82,101,33,45,49,56,44.8,42.3,46.7,00000
86.0,25.0,59.0,514,06,01,  Subed Ali Beparirkandi,50,84,25,40,25,44,37.3,38.5,36.2,00000
86.0,25.0,59.0,762,01,01,  Abdul Khaleque Majhirkandi,239,140,119,71,120,69,63.1,62.6,63.5,00000
86.0,25.0,59.0,762,02,01,  Mangal Beparikandi,241,603,103,282,138,321,28.6,26.8,30.1,00000
86.0,25.0,59.0,762,03,01,  Asrab Ali Malerkandi,125,161,55,71,70,90,43.7,43.7,43.8,00000
86.0,25.0,59.0,762,04,01,  Pandit Ali Mollahkandi,99,63,43,27,56,36,61.1,61.4,60.9,00000
86.0,25.0,59.0,762,05,01,  Shahar Beparirkandi,93,227,48,96,45,131,29.1,33.3,25.6,00000
86.0,25.0,59.0,762,06,01,  Sabar Ali Majhikandi,60,61,32,30,28,31,49.6,51.6,47.5,00000
86.0,25.0,59.0,762,07,01,  Abdul Aziz Beparirkandi,93,68,45,31,48,37,57.8,59.2,56.5,00000
86.0,25.0,59.0,762,08,01,  Masterkandi,75,89,32,37,43,52,45.7,46.4,45.3,00000
86.0,25.0,59.0,762,09,01,  Chan Miah Gazikandi,29,32,13,12,16,20,47.5,52.0,44.4,00000
86.0,25.0,59.0,762,10,01,  Ali Akbar Malkandi,106,159,44,67,62,92,40.0,39.6,40.3,00000
86.0,25.0,59.0,762,11,01,  Yakub Gazikandi,238,171,92,78,146,93,58.2,54.1,61.1,00000
86.0,25.0,59.0,762,12,01,  Shiraj Prodhania Kandi,74,33,36,14,38,19,69.2,72.0,66.7,00000
86.0,25.0,59.0,878,01,01,  Fakirkandi,236,158,112,73,124,85,59.9,60.5,59.3,00000
86.0,25.0,59.0,878,02,01,  Musa Bokaulkandi,93,108,54,55,39,53,46.3,49.5,42.4,00000
86.0,25.0,59.0,878,03,01,  Abdur Rahim Masterkandi,131,179,60,86,71,93,42.3,41.1,43.3,00000
86.0,25.0,59.0,878,04,01,  Younus Mollarkandi,91,168,37,79,54,89,35.1,31.9,37.8,00000
86.0,25.0,59.0,878,05,01,  Sabar Ali Mollarkandi,35,84,19,39,16,45,29.4,32.8,26.2,00000
86.0,25.0,59.0,929,01,01,  Abdul Dafadarkandi,146,226,71,107,75,119,39.2,39.9,38.7,00000
86.0,25.0,59.0,929,02,01,  Abdul Beparikandi,260,152,123,73,137,79,63.1,62.8,63.4,00000
86.0,25.0,71.0,082,01,01,  Bara Sidulkura,898,758,411,320,487,438,54.2,56.2,52.6,00000
86.0,25.0,71.0,082,02,01,  No.8 Bara Sidulkura,727,750,329,337,398,413,49.2,49.4,49.1,00000
86.0,25.0,83.0,895,01,01,  Uttar Sidya,1140,844,491,376,649,468,57.5,56.6,58.1,00000
86.0,25.0,83.0,895,02,01,  Madhya Sidya,1521,842,696,346,825,496,64.4,66.8,62.5,00000
86.0,25.0,83.0,895,03,01,  Dakshin Sidya,1014,1037,434,500,580,537,49.4,46.5,51.9,00000
86.0,36.0,11.0,198,01,01,  Siddik Dali,175,645,94,294,81,351,21.3,24.2,18.8,00000
86.0,36.0,11.0,198,02,01,  Mostafa Dhalirkandi,211,324,99,156,112,168,39.4,38.8,40.0,00000
86.0,36.0,11.0,198,03,01,  Char Jalalpur,96,301,53,132,43,169,24.2,28.6,20.3,00000
86.0,36.0,11.0,198,04,01,  Moran Chakider Kandi,68,220,36,120,32,100,23.6,23.1,24.2,00000
86.0,36.0,11.0,198,05,01,  Majer Char,73,352,29,191,44,161,17.2,13.2,21.5,00000
86.0,36.0,11.0,198,06,01,  Salam Hawlader Kandi,91,192,42,91,49,101,32.2,31.6,32.7,00000
86.0,36.0,11.0,198,07,01,  Kabirhawlader Kandi,82,132,42,54,40,78,38.3,43.8,33.9,00000
86.0,36.0,11.0,198,08,01,  Zakir Gazir Kandi,41,75,19,41,22,34,35.3,31.7,39.3,00000
86.0,36.0,11.0,198,09,01,  Nanu Munshir Kandi,61,157,22,79,39,78,28.0,21.8,33.3,00000
86.0,36.0,11.0,198,10,01,  Moti Gainer Kandi,31,80,22,36,9,44,27.9,37.9,17.0,00000
86.0,36.0,11.0,198,11,01,  Siddik Dhali Kandi,526,147,276,58,250,89,78.2,82.6,73.7,00000
86.0,36.0,11.0,198,12,01,  Aziz Khar Kandi,27,132,16,66,11,66,17.0,19.5,14.3,00000
86.0,36.0,11.0,354,01,01,  Lal Miah Beparikandi,29,165,14,79,15,86,14.9,15.1,14.9,00000
86.0,36.0,11.0,354,02,01,  Sadim Ali Majhikandi,45,142,24,64,21,78,24.1,27.3,21.2,00000
86.0,36.0,11.0,354,03,01,  Haydar Ali Daktarkandi,21,51,8,24,13,27,29.2,25.0,32.5,00000
86.0,36.0,11.0,354,04,01,  Mollah Kandi,12,71,8,33,4,38,14.5,19.5,9.5,00000
86.0,36.0,11.0,354,05,01,  Lalmia Bapery Kandi,148,299,72,133,76,166,33.1,35.1,31.4,00000
86.0,36.0,11.0,654,01,01,  Malek Sardarkandi (Khaleque),126,280,57,136,69,144,31.0,29.5,32.4,00000
86.0,36.0,11.0,654,02,01,  Abul Darzi,41,30,19,17,22,13,57.7,52.8,62.9,00000
86.0,36.0,11.0,654,03,01,  Yasin Gazikandi,21,112,10,62,11,50,15.8,13.9,18.0,00000
86.0,36.0,11.0,654,04,01,  Razzak Syalkati,7,19,5,7,2,12,26.9,41.7,14.3,00000
86.0,36.0,11.0,654,05,01,  Alimuddin Khan,39,63,19,29,20,34,38.2,39.6,37.0,00000
86.0,36.0,11.0,654,06,01,  Michan Bapari,72,153,35,73,37,80,32.0,32.4,31.6,00000
86.0,36.0,11.0,994,01,01,  Osman Dhalikandi,185,387,86,187,99,200,32.3,31.5,33.1,00000
86.0,36.0,11.0,994,02,01,  Rahmat Ali Mirerkandi,30,36,18,13,12,23,45.5,58.1,34.3,00000
86.0,36.0,11.0,994,03,01,  Yasin Peadar Howladarkandi,70,82,37,37,33,45,46.1,50.0,42.3,00000
86.0,36.0,11.0,994,04,01,  Rashid Howlader,96,315,52,148,44,167,23.4,26.0,20.9,00000
86.0,36.0,11.0,994,05,01,  Alim Uddin Gazi Kandi,144,230,72,104,72,126,38.5,40.9,36.4,00000
86.0,36.0,11.0,994,06,01,  Majid Beparirkandi,7,45,3,21,4,24,13.5,12.5,14.3,00000
86.0,36.0,11.0,994,08,01,  Fazlul Haque Howladarkandi,96,184,41,81,55,103,34.3,33.6,34.8,00000
86.0,36.0,11.0,994,09,01,  Rahim Ali Darjikandi,67,189,29,79,38,110,26.2,26.9,25.7,00000
86.0,36.0,11.0,994,10,01,  Wahab Dhalirkandi,71,81,37,40,34,41,46.7,48.1,45.3,00000
86.0,36.0,11.0,994,11,01,  Hafiz Sardarkandi,103,231,48,97,55,134,30.8,33.1,29.1,00000
86.0,36.0,11.0,994,12,01,  Rashid Kazirkandi,126,385,65,190,61,195,24.7,25.5,23.8,00000
86.0,36.0,11.0,994,13,01,  Gazikandi,108,131,63,59,45,72,45.2,51.6,38.5,00000
86.0,36.0,11.0,994,14,01,  Gain Para(Hanifa Bepar),163,275,81,137,82,138,37.2,37.2,37.3,00000
86.0,36.0,11.0,994,15,01,  Salu Dhalirkandi(Sanu Dhali),72,216,24,102,48,114,25.0,19.0,29.6,00000
86.0,36.0,11.0,994,16,01,  Harun Sardarkandi,48,91,25,40,23,51,34.5,38.5,31.1,00000
86.0,36.0,11.0,994,17,01,  Fazlul Haque Munsh,160,157,84,67,76,90,50.5,55.6,45.8,00000
86.0,36.0,11.0,994,18,01,  Hakim Alirkandi,34,57,18,32,16,25,37.4,36.0,39.0,00000
86.0,36.0,11.0,994,19,01,  Siraj Gainkandi,19,26,9,11,10,15,42.2,45.0,40.0,00000
86.0,36.0,11.0,994,20,01,  Kalai Beparikandi,112,149,44,66,68,83,42.9,40.0,45.0,00000
86.0,36.0,11.0,994,22,01,  Sabar Ali Kazikandi,45,159,21,71,24,88,22.1,22.8,21.4,00000
86.0,36.0,11.0,994,24,01,  Jamiruddin Dhalirkandi,56,118,29,59,27,59,32.2,33.0,31.4,00000
86.0,36.0,11.0,994,25,01,  Mohammad Dewankandi(Mollah),33,192,16,92,17,100,14.7,14.8,14.5,00000
86.0,36.0,11.0,994,26,01,  Wahab Howladarkandi(Sarder),49,70,19,34,30,36,41.2,35.8,45.5,00000
86.0,36.0,11.0,994,27,01,  Kalai Dhalirkandi,36,182,19,92,17,90,16.5,17.1,15.9,00000
86.0,36.0,11.0,994,28,01,  Bahauddin Gazi Kandi,34,50,14,19,20,31,40.5,42.4,39.2,00000
86.0,36.0,11.0,994,29,01,  Abul Dhalirkandi,108,319,52,170,56,149,25.3,23.4,27.3,00000
86.0,36.0,11.0,994,30,01,  Razzaque Sayalkandi,17,36,12,17,5,19,32.1,41.4,20.8,00000
86.0,36.0,11.0,994,31,01,  Gafur Masterkandi,104,199,47,94,57,105,34.3,33.3,35.2,00000
86.0,36.0,11.0,994,32,01,  Latif Pazalinkandi,62,191,25,92,37,99,24.5,21.4,27.2,00000
86.0,36.0,11.0,994,33,01,  Hanifa Mal,13,58,5,28,8,30,18.3,15.2,21.1,00000
86.0,36.0,11.0,994,34,01,  Haji Sadim Ali Bepari Kandi,154,161,77,82,77,79,48.9,48.4,49.4,00000
86.0,36.0,11.0,994,36,01,  Serajal Ali Dhalirkandi,33,40,17,18,16,22,45.2,48.6,42.1,00000
86.0,36.0,11.0,994,37,01,  Salim Dhali,41,85,23,41,18,44,32.5,35.9,29.0,00000
86.0,36.0,11.0,994,38,01,  Rashid Khankandi,51,60,24,28,27,32,45.9,46.2,45.8,00000
86.0,36.0,47.0,387,01,01,  Ali Akbar Sardarkandi,112,152,51,72,61,80,42.4,41.5,43.3,00000
86.0,36.0,47.0,387,02,01,  Latu Khan Para,43,117,26,63,17,54,26.9,29.2,23.9,00000
86.0,36.0,47.0,387,03,01,  Mugbil Khan Para,8,33,5,20,3,13,19.5,20.0,18.8,00000
86.0,36.0,47.0,387,04,01,  Ananda Bazar,25,48,14,22,11,26,34.2,38.9,29.7,00000
86.0,36.0,47.0,387,05,01,  Sarker Khan Para,48,205,22,103,26,102,19.0,17.6,20.3,00000
86.0,36.0,47.0,387,06,01,  Gain Kandi,46,171,25,75,21,96,21.2,25.0,17.9,00000
86.0,36.0,47.0,387,07,01,  Monta Dayan Para,88,211,43,111,45,100,29.4,27.9,31.0,00000
86.0,36.0,47.0,387,08,01,  Said Beparikandi,40,108,17,57,23,51,27.0,23.0,31.1,00000
86.0,36.0,47.0,387,09,01,  Sayel Kandi,62,128,32,61,30,67,32.6,34.4,30.9,00000
86.0,36.0,47.0,387,10,01,  Abul Sayal Para,136,213,75,104,61,109,39.0,41.9,35.9,00000
86.0,36.0,47.0,387,11,01,  Sayeu Nandi,170,224,85,109,85,115,43.1,43.8,42.5,00000
86.0,36.0,47.0,387,12,01,  Pazzal Para,37,86,15,45,22,41,30.1,25.0,34.9,00000
86.0,36.0,47.0,387,14,01,  Rain Para,22,41,11,22,11,19,34.9,33.3,36.7,00000
86.0,36.0,47.0,387,15,01,  Sabr Para,141,267,73,131,68,136,34.6,35.8,33.3,00000
86.0,36.0,47.0,387,16,01,  Chan Khar Char,40,75,21,42,19,33,34.8,33.3,36.5,00000
86.0,36.0,47.0,387,17,01,  Syed Nasir,73,241,42,115,31,126,23.2,26.8,19.7,00000
86.0,36.0,47.0,387,18,01,  Purba Bakul Para,109,364,48,183,61,181,23.0,20.8,25.2,00000
86.0,36.0,47.0,387,19,01,  Bala Dayan Para,49,92,19,47,30,45,34.8,28.8,40.0,00000
86.0,36.0,47.0,387,20,01,  Kalu Khan Para,7,11,3,6,4,5,38.9,33.3,44.4,00000
86.0,36.0,47.0,387,21,01,  Purba Hazi Para,105,184,50,85,55,99,36.3,37.0,35.7,00000
86.0,36.0,47.0,387,22,01,  Khar Saed Para,26,39,13,22,13,17,40.0,37.1,43.3,00000
86.0,36.0,47.0,387,23,01,  Pondit Khan Para,105,164,47,86,58,78,39.0,35.3,42.6,00000
86.0,36.0,47.0,429,01,01,  Hawladarkandi(Ismil),178,111,93,45,85,66,61.6,67.4,56.3,00000
86.0,36.0,47.0,429,02,01,  Mollahkandi,129,134,75,67,54,67,49.0,52.8,44.6,00000
86.0,36.0,47.0,429,03,01,  Sayalkandi,132,169,70,71,62,98,43.9,49.6,38.8,00000
86.0,36.0,47.0,429,04,01,  Mirda,48,55,27,29,21,26,46.6,48.2,44.7,00000
86.0,36.0,47.0,429,05,01,  Kalirchar,98,394,52,190,46,204,19.9,21.5,18.4,00000
86.0,36.0,47.0,994,02,01,  Purba Dewankandi(Wohab),78,355,47,154,31,201,18.0,23.4,13.4,00000
86.0,36.0,47.0,994,03,01,  Hossain How Kandi,202,225,107,99,95,126,47.3,51.9,43.0,00000
86.0,36.0,47.0,994,04,01,  Modhya Dewankandi,86,146,39,68,47,78,37.1,36.4,37.6,00000
86.0,36.0,47.0,994,05,01,  Saydur Khan Para,33,73,13,27,20,46,31.1,32.5,30.3,00000
86.0,36.0,47.0,994,06,01,  Wahab Dewankandi,141,354,52,155,89,199,28.5,25.1,30.9,00000
86.0,36.0,47.0,994,07,01,  Nody Uttar Mal Para,9,32,3,17,6,15,22.0,15.0,28.6,00000
86.0,36.0,47.0,994,08,01,  Abu Beparikandi,17,67,10,29,7,38,20.2,25.6,15.6,00000
86.0,36.0,47.0,994,09,01,  Purba Ikil Para,53,82,24,40,29,42,39.3,37.5,40.8,00000
86.0,36.0,47.0,994,10,01,  Kazikandi,108,117,51,55,57,62,48.0,48.1,47.9,00000
86.0,36.0,47.0,994,11,01,  Ukilkandi,109,75,58,35,51,40,59.2,62.4,56.0,00000
86.0,36.0,47.0,994,12,01,  Purba Hajikandi,94,125,41,57,53,68,42.9,41.8,43.8,00000
86.0,36.0,47.0,994,13,01,  Kalachan Malerkandi,52,111,28,54,24,57,31.9,34.1,29.6,00000
86.0,36.0,47.0,994,14,01,  Dakshin Khan Para,61,111,28,49,33,62,35.5,36.4,34.7,00000
86.0,36.0,47.0,994,15,01,  Hossain Hangkandi,44,48,18,17,26,31,47.8,51.4,45.6,00000
86.0,36.0,47.0,994,16,01,  Uttaar Khan Para,121,251,48,113,73,138,32.5,29.8,34.6,00000
86.0,36.0,47.0,994,17,01,  Jakir Ali Munshirkandi,143,223,67,97,76,126,39.1,40.9,37.6,00000
86.0,36.0,47.0,994,18,01,  Subed Bapari Para,128,289,54,138,74,151,30.7,28.1,32.9,00000
86.0,36.0,47.0,994,19,01,  Meser Mollahkandi,78,163,42,80,36,83,32.4,34.4,30.3,00000
86.0,36.0,47.0,994,20,01,  Kalashi Para,131,292,49,127,82,165,31.0,27.8,33.2,00000
86.0,36.0,47.0,994,21,01,  Matbarkandi,19,32,8,19,11,13,37.3,29.6,45.8,00000
86.0,36.0,47.0,994,22,01,  Mredha Para,242,270,119,131,123,139,47.3,47.6,46.9,00000
86.0,36.0,47.0,994,23,01,  Balu Char Bazar,53,232,23,104,30,128,18.6,18.1,19.0,00000
86.0,36.0,47.0,994,24,01,  Balu Sardar Para(2),408,280,214,116,194,164,59.3,64.8,54.2,00000
86.0,36.0,47.0,994,25,01,  Kalai Mal Para,57,125,30,55,27,70,31.3,35.3,27.8,00000
86.0,36.0,47.0,994,26,01,  Rashid Sardar Para,396,184,206,81,190,103,68.3,71.8,64.8,00000
86.0,36.0,47.0,994,27,01,  Asrab Ali Bapari Para(Purba),164,293,71,141,93,152,35.9,33.5,38.0,00000
86.0,36.0,47.0,994,28,01,  Bazzar Alaka,30,17,17,9,13,8,63.8,65.4,61.9,00000
86.0,36.0,47.0,994,29,01,  Purba Asrab Ali Bapari Kandi,23,59,18,18,5,41,28.0,50.0,10.9,00000
86.0,36.0,47.0,994,30,01,  Hazirali Dayan,98,107,48,45,50,62,47.8,51.6,44.6,00000
86.0,36.0,47.0,994,31,01,  Hajikandi,102,95,56,34,46,61,51.8,62.2,43.0,00000
86.0,36.0,47.0,994,32,01,  Dhali Para,40,303,25,148,15,155,11.7,14.5,8.8,00000
86.0,36.0,47.0,994,33,01,  Uttar Mal Para,28,140,15,68,13,72,16.7,18.1,15.3,00000
86.0,36.0,47.0,994,34,01,  Purba Dhali Para,24,97,16,49,8,48,19.8,24.6,14.3,00000
86.0,36.0,47.0,994,35,01,  Madbar Para,87,271,38,117,49,154,24.3,24.5,24.1,00000
86.0,36.0,47.0,994,36,01,  Uttar Sayel Para,101,306,45,142,56,164,24.8,24.1,25.5,00000
86.0,36.0,47.0,994,37,01,  Bokal Para (Purba),83,108,38,50,45,58,43.5,43.2,43.7,00000
86.0,36.0,47.0,994,38,01,  Bokaul Para (Pachim),16,45,7,23,9,22,26.2,23.3,29.0,00000
86.0,36.0,47.0,994,39,01,  Bridgh Alaka,46,86,20,37,26,49,34.8,35.1,34.7,00000
86.0,65.0,18.0,653,01,01,  Uttar Magar,460,212,195,97,265,115,68.5,66.8,69.7,00000
86.0,65.0,18.0,653,02,01,  Dakshin Magar,570,368,227,165,343,203,60.8,57.9,62.8,00000
86.0,65.0,44.0,372,01,01,  Fateh Jangapur,432,278,201,125,231,153,60.8,61.7,60.2,00000
86.0,65.0,44.0,372,02,01,  Fateh Sirangal,187,112,93,45,94,67,62.5,67.4,58.4,00000
86.0,65.0,44.0,372,03,01,  Nagar,284,216,127,114,157,102,56.8,52.7,60.6,00000
86.0,65.0,44.0,372,04,01,  Kharkara,394,235,188,110,206,125,62.6,63.1,62.2,00000
86.0,65.0,44.0,372,05,01,  Banerbari,94,65,37,25,57,40,59.1,59.7,58.8,00000
86.0,65.0,50.0,926,01,01,  Singhalmuri,1013,692,462,324,551,368,59.4,58.8,60.0,00000
86.0,65.0,50.0,926,02,01,  Sujabad,531,279,254,114,277,165,65.6,69.0,62.7,00000
86.0,65.0,56.0,121,01,01,  Mollahkandi,343,337,163,165,180,172,50.4,49.7,51.1,00000
86.0,65.0,56.0,121,02,01,  Saikpurkandi,76,292,36,142,40,150,20.7,20.2,21.1,00000
86.0,65.0,56.0,364,01,01,  Howladarkandi,188,44,83,19,105,25,81.0,81.4,80.8,00000
86.0,65.0,56.0,364,02,01,  Mollik Kandi,188,46,76,24,112,22,80.3,76.0,83.6,00000
86.0,65.0,56.0,364,03,01,  Karikarkandi,162,191,79,105,83,86,45.9,42.9,49.1,00000
86.0,65.0,56.0,364,04,01,  Mir Kanda Para (Part),120,190,49,80,71,110,38.7,38.0,39.2,00000
86.0,65.0,56.0,410,01,01,  Gourail,488,355,237,184,251,171,57.9,56.3,59.5,00000
86.0,65.0,56.0,410,02,01,  Padakandi,114,114,57,55,57,59,50.0,50.9,49.1,00000
86.0,65.0,56.0,478,01,01,  Karibajkandi,63,222,18,103,45,119,22.1,14.9,27.4,00000
86.0,65.0,56.0,478,02,01,  Asman Khankandi,97,226,45,98,52,128,30.0,31.5,28.9,00000
86.0,65.0,56.0,478,03,01,  Dasai Howladarkandi,101,102,38,40,63,62,49.8,48.7,50.4,00000
86.0,65.0,56.0,478,04,01,  Shahkandi,85,93,34,42,51,51,47.8,44.7,50.0,00000
86.0,65.0,56.0,478,05,01,  Shitu Matbarerkandi,263,273,124,121,139,152,49.1,50.6,47.8,00000
86.0,65.0,56.0,478,06,01,  Kobbas Matbarerkandi,136,299,59,132,77,167,31.3,30.9,31.6,00000
86.0,65.0,56.0,478,07,01,  Asamikandi,129,147,65,66,64,81,46.7,49.6,44.1,00000
86.0,65.0,56.0,478,08,01,  Dhalikandi,116,132,48,60,68,72,46.8,44.4,48.6,00000
86.0,65.0,56.0,478,09,01,  Molla Kandi,113,65,52,33,61,32,63.5,61.2,65.6,00000
86.0,65.0,56.0,668,01,01,  Rarikandi,311,163,162,58,149,105,65.6,73.6,58.7,00000
86.0,65.0,56.0,668,02,01,  Namakandi,283,260,140,122,143,138,52.1,53.4,50.9,00000
86.0,65.0,56.0,668,03,01,  Sardarkandi,131,165,66,75,65,90,44.3,46.8,41.9,00000
86.0,65.0,56.0,668,04,01,  Charerkandi,99,215,39,98,60,117,31.5,28.5,33.9,00000
86.0,65.0,56.0,668,05,01,  Melkarkandi,138,169,62,79,76,90,45.0,44.0,45.8,00000
86.0,65.0,56.0,668,06,01,  Maijpara Bagali Kasdi,108,66,50,34,58,32,62.1,59.5,64.4,00000
86.0,65.0,69.0,660,01,01,  Mollahkandi,527,801,259,365,268,436,39.7,41.5,38.1,00000
86.0,65.0,69.0,660,02,01,  Boyrakandi,104,232,48,113,56,119,31.0,29.8,32.0,00000
86.0,65.0,69.0,721,01,01,  Cherag Ali Beparikandi,827,850,406,377,421,473,49.3,51.9,47.1,00000
86.0,65.0,69.0,721,02,01,  Saher Ali Madborer Kandi,743,701,351,317,392,384,51.5,52.5,50.5,00000
86.0,65.0,69.0,721,03,01,  Saborali Bepari Kandi,194,272,96,133,98,139,41.6,41.9,41.4,00000
86.0,65.0,69.0,721,04,01,  Mirda Kandi,149,280,70,126,79,154,34.7,35.7,33.9,00000
86.0,65.0,69.0,850,02,01,  Laskermad Boer Kandi,247,208,120,88,127,120,54.3,57.7,51.4,00000
86.0,65.0,69.0,850,03,01,  Patailla Kandi,261,211,122,94,139,117,55.3,56.5,54.3,00000
86.0,65.0,69.0,850,04,01,  Bepari Kandi,271,180,132,70,139,110,60.1,65.3,55.8,00000
86.0,65.0,82.0,265,01,01,  Mochan Dhalikandi,355,252,182,130,173,122,58.5,58.3,58.6,00000
86.0,65.0,82.0,265,02,01,  Matbarkandi,249,112,146,48,103,64,69.0,75.3,61.7,00000
86.0,65.0,82.0,265,03,01,  Mollahkandi,112,126,58,63,54,63,47.1,47.9,46.2,00000
86.0,65.0,82.0,379,01,01,  Farajikandi,146,132,85,68,61,64,52.5,55.6,48.8,00000
86.0,65.0,82.0,379,02,01,  Abdul Sardarerkandi,250,228,147,89,103,139,52.3,62.3,42.6,00000
86.0,65.0,82.0,379,03,01,  Kalai Kazirkandi,62,42,33,15,29,27,59.6,68.8,51.8,00000
86.0,65.0,82.0,706,01,01,  Beparikandi,74,247,24,120,50,127,23.1,16.7,28.2,00000
86.0,65.0,82.0,706,02,01,  Mollahkandi,49,196,18,107,31,89,20.0,14.4,25.8,00000
86.0,65.0,82.0,774,01,01,  Sagir Dhalikandi,304,294,154,142,150,152,50.8,52.0,49.7,00000
86.0,65.0,82.0,774,02,01,  Karikarkandi,72,67,48,35,24,32,51.8,57.8,42.9,00000
86.0,65.0,82.0,774,03,01,  Situ Beparikandi,262,234,132,122,130,112,52.8,52.0,53.7,00000
86.0,65.0,82.0,774,04,01,  Gazikandi/Malat Kandi,123,142,60,74,63,68,46.4,44.8,48.1,00000
86.0,65.0,82.0,774,05,01,  Emamuddin Howladarkandi,42,90,16,47,26,43,31.8,25.4,37.7,00000
86.0,65.0,82.0,774,06,01,  Nalikandi,95,133,45,73,50,60,41.7,38.1,45.5,00000
86.0,65.0,82.0,774,07,01,  Akonkandi,193,229,98,121,95,108,45.7,44.7,46.8,00000
86.0,65.0,82.0,774,08,01,  Namokandi,126,81,68,39,58,42,60.9,63.6,58.0,00000
86.0,65.0,82.0,774,09,01,  Puratan Majhikandi,447,245,235,117,212,128,64.6,66.8,62.4,00000
86.0,65.0,82.0,774,10,01,  Nutan Majhikandi,233,238,119,111,114,127,49.5,51.7,47.3,00000
86.0,65.0,82.0,774,11,01,  Sardarkandi,283,272,133,125,150,147,51.0,51.6,50.5,00000
86.0,65.0,82.0,774,12,01,  Baorkandi,108,84,61,49,47,35,56.3,55.5,57.3,00000
86.0,65.0,82.0,774,13,01,  Malkandi,208,163,110,88,98,75,56.1,55.6,56.6,00000
86.0,65.0,82.0,827,01,01,  Kalai Akan Kandi,109,161,63,91,46,70,40.4,40.9,39.7,00000
86.0,65.0,82.0,827,02,01,  Lakshai Beparikandi,52,77,29,32,23,45,40.3,47.5,33.8,00000
86.0,65.0,94.0,432,01,01,  Malatkandi,456,326,230,134,226,192,58.3,63.2,54.1,00000
86.0,65.0,94.0,432,02,01,  Thakurkandi,85,179,41,78,44,101,32.2,34.5,30.3,00000
86.0,65.0,94.0,432,03,01,  Kazikandi,239,311,121,150,118,161,43.5,44.6,42.3,00000
86.0,65.0,94.0,600,01,01,  Chowkidarkandi,274,497,144,220,130,277,35.5,39.6,31.9,00000
86.0,65.0,94.0,600,02,01,  Porakandi,166,59,85,29,81,30,73.8,74.6,73.0,00000
86.0,65.0,94.0,600,03,01,  Thakurkandi,122,184,63,82,59,102,39.9,43.4,36.6,00000
86.0,65.0,94.0,600,04,01,  Malatkandi,100,235,36,124,64,111,29.9,22.5,36.6,00000
86.0,65.0,94.0,600,05,01,  Kazi Kandi,224,101,131,41,93,60,68.9,76.2,60.8,00000
86.0,65.0,94.0,767,01,01,  Satghariakandi,212,391,92,186,120,205,35.2,33.1,36.9,00000
86.0,65.0,94.0,767,02,01,  Jamiruddin Matbarerkandi,272,289,140,135,132,154,48.5,50.9,46.2,00000
86.0,65.0,94.0,858,01,01,  Punia Kharkandi,319,407,170,186,149,221,43.9,47.8,40.3,00000
86.0,65.0,94.0,858,02,01,  Putia Kandi,162,206,91,100,71,106,44.0,47.6,40.1,00000
86.0,65.0,94.0,873,01,01,  Punai Sardar Kandi,305,370,152,189,153,181,45.2,44.6,45.8,00000
86.0,65.0,94.0,873,02,01,  Darbesh Khar Kandi,260,213,128,96,132,117,55.0,57.1,53.0,00000
86.0,65.0,94.0,873,03,01,  Thanarkandi,181,193,86,95,95,98,48.4,47.5,49.2,00000
86.0,65.0,94.0,873,04,01,  Putiakandi,98,106,69,48,29,58,48.0,59.0,33.3,00000
86.0,65.0,94.0,873,05,01,  Rajnagar Punairkandi,260,260,143,109,117,151,50.0,56.7,43.7,00000
86.0,65.0,94.0,873,06,01,  Kazi Kandi,34,40,15,18,19,22,45.9,45.5,46.3,00000
86.0,65.0,94.0,873,07,01,  Kalay Bhuyer Kandi,206,243,112,124,94,119,45.9,47.5,44.1,00000
86.0,69.0,17.0,153,01,01,  Dakshin Bhasan Char,676,1875,385,953,291,922,26.5,28.8,24.0,00000
86.0,69.0,17.0,153,02,01,  Uttar Bhasan Char,1073,1154,583,568,490,586,48.2,50.7,45.5,00000
86.0,69.0,17.0,153,03,01,  Paschim Bhasan Char,1066,1369,576,692,490,677,43.8,45.4,42.0,00000
86.0,69.0,17.0,727,01,01,  Niamatpur,408,325,202,171,206,154,55.7,54.2,57.2,00000
86.0,69.0,17.0,727,02,01,  Char Niamatpur,264,337,129,157,135,180,43.9,45.1,42.9,00000
86.0,69.0,19.0,095,01,01,  Dhalikandi,484,715,210,358,274,357,40.4,37.0,43.4,00000
86.0,69.0,19.0,095,02,01,  Kacharikandi,944,759,445,333,499,426,55.4,57.2,53.9,00000
86.0,69.0,19.0,095,03,01,  Kazikandi,325,396,152,173,173,223,45.1,46.8,43.7,00000
86.0,69.0,19.0,095,04,01,  Subedarkandi,552,665,285,310,267,355,45.4,47.9,42.9,00000
86.0,69.0,19.0,095,05,01,  Munshikandi,289,304,145,141,144,163,48.7,50.7,46.9,00000
86.0,69.0,19.0,095,06,01,  Chatanikandi,159,213,65,110,94,103,42.7,37.1,47.7,00000
86.0,69.0,19.0,095,07,01,  Mirdhakandi,155,150,67,75,88,75,50.8,47.2,54.0,00000
86.0,69.0,19.0,095,08,01,  Namakandi,84,166,44,73,40,93,33.6,37.6,30.1,00000
86.0,69.0,19.0,095,09,01,  Chabbish Rashi,423,187,210,89,213,98,69.3,70.2,68.5,00000
86.0,69.0,19.0,774,01,01,  Charerkandi,363,477,173,219,190,258,43.2,44.1,42.4,00000
86.0,69.0,19.0,774,02,01,  Maulvikandi,312,624,143,313,169,311,33.3,31.4,35.2,00000
86.0,69.0,19.0,774,03,01,  Zainullah Matbarerkandi,345,571,148,290,197,281,37.7,33.8,41.2,00000
86.0,69.0,19.0,774,04,01,  Bachharkandi,363,597,145,284,218,313,37.8,33.8,41.1,00000
86.0,69.0,19.0,774,05,01,  Uttarpara,218,424,82,206,136,218,34.0,28.5,38.4,00000
86.0,69.0,19.0,774,06,01,  Khalasikandi,272,723,128,317,144,406,27.3,28.8,26.2,00000
86.0,69.0,28.0,191,01,01,  Uttar Chandrapur,233,372,119,180,114,192,38.5,39.8,37.3,00000
86.0,69.0,28.0,191,02,01,  Dakshin Chandrapur,555,825,266,387,289,438,40.2,40.7,39.8,00000
86.0,69.0,28.0,813,01,01,  Ranakhola,377,542,163,261,214,281,41.0,38.4,43.2,00000
86.0,69.0,28.0,813,02,01,  Darikandi,241,240,117,120,124,120,50.1,49.4,50.8,00000
86.0,69.0,38.0,009,01,01,  Abura,341,495,162,240,179,255,40.8,40.3,41.2,00000
86.0,69.0,38.0,009,02,01,  Char Abura,177,228,79,112,98,116,43.7,41.4,45.8,00000
86.0,69.0,38.0,038,01,01,  Paschim Atpara Matbarkandi,161,194,68,93,93,101,45.4,42.2,47.9,00000
86.0,69.0,38.0,038,02,01,  Paschim Atpara Khankandi,119,202,55,85,64,117,37.1,39.3,35.4,00000
86.0,69.0,38.0,038,03,01,  Paschim Atpara Khalasikandi,248,488,122,228,126,260,33.7,34.9,32.6,00000
86.0,69.0,38.0,038,04,01,  Purba Atpara Matbarkandi,72,253,38,108,34,145,22.2,26.0,19.0,00000
86.0,69.0,38.0,038,05,01,  Purba Atpara Sardarkandi,131,181,58,82,73,99,42.0,41.4,42.4,00000
86.0,69.0,38.0,038,06,01,  Namokandi,35,58,17,27,18,31,37.6,38.6,36.7,00000
86.0,69.0,38.0,038,07,01,  Torakandi,40,25,19,12,21,13,61.5,61.3,61.8,00000
86.0,69.0,38.0,038,08,01,  Moral Kandi,84,141,44,65,40,76,37.3,40.4,34.5,00000
86.0,69.0,38.0,047,01,01,  Purba Bagadi,472,636,201,298,271,338,42.6,40.3,44.5,00000
86.0,69.0,38.0,047,02,01,  Paschim Bagadi,416,278,182,133,234,145,59.9,57.8,61.7,00000
86.0,69.0,38.0,114,01,01,  Paschim Bara Sandwip,246,365,116,163,130,202,40.3,41.6,39.2,00000
86.0,69.0,38.0,114,02,01,  Purba Bara Sandwip,265,386,116,165,149,221,40.7,41.3,40.3,00000
86.0,69.0,38.0,344,01,01,  Chhota Sandwip Dhalakandi,136,134,72,50,64,84,50.4,59.0,43.2,00000
86.0,69.0,38.0,344,02,01,  Chhota Sandwip,228,188,131,88,97,100,54.8,59.8,49.2,00000
86.0,69.0,38.0,401,01,01,  Dhalikandi,169,193,80,81,89,112,46.7,49.7,44.3,00000
86.0,69.0,38.0,401,02,01,  Munshikandi,165,258,82,124,83,134,39.0,39.8,38.2,00000
86.0,69.0,38.0,401,03,01,  Tastarkandi,28,47,7,23,21,24,37.3,23.3,46.7,00000
86.0,69.0,38.0,401,04,01,  Bokterkandi,130,189,58,98,72,91,40.8,37.2,44.2,00000
86.0,69.0,38.0,401,05,01,  Kabirajkandi,162,263,75,115,87,148,38.1,39.5,37.0,00000
86.0,69.0,38.0,401,06,01,  Akondkandi,252,170,133,71,119,99,59.7,65.2,54.6,00000
86.0,69.0,38.0,401,07,01,  Madbarkandi,108,254,49,134,59,120,29.8,26.8,33.0,00000
86.0,69.0,38.0,401,08,01,  Sikdarkandi,234,141,124,50,110,91,62.4,71.3,54.7,00000
86.0,69.0,38.0,401,09,01,  Namokandi,26,46,14,22,12,24,36.1,38.9,33.3,00000
86.0,69.0,38.0,870,01,01,  Uttar Saula,124,258,49,142,75,116,32.5,25.7,39.3,00000
86.0,69.0,38.0,870,02,01,  Dakshin Saula,687,640,310,285,377,355,51.8,52.1,51.5,00000
86.0,69.0,38.0,870,03,01,  Town Saula,260,95,143,44,117,51,73.2,76.5,69.6,00000
86.0,69.0,38.0,899,01,01,  Beparikandi,240,195,130,88,110,107,55.2,59.6,50.7,00000
86.0,69.0,38.0,899,02,01,  Moralkandi,138,51,62,17,76,34,73.0,78.5,69.1,00000
86.0,69.0,47.0,363,01,01,  Chitalia,573,478,300,212,273,266,54.5,58.6,50.6,00000
86.0,69.0,47.0,363,02,01,  Mirakandi,306,308,147,139,159,169,49.8,51.4,48.5,00000
86.0,69.0,47.0,363,03,01,  Mazumdarkandi,369,437,194,219,175,218,45.8,47.0,44.5,00000
86.0,69.0,47.0,363,04,01,  Dakshinkandi,229,423,114,204,115,219,35.1,35.8,34.4,00000
86.0,69.0,47.0,363,05,01,  Tumchar,323,398,167,177,156,221,44.8,48.5,41.4,00000
86.0,69.0,47.0,363,06,01,  Jhau Char,333,507,171,238,162,269,39.6,41.8,37.6,00000
86.0,69.0,47.0,602,01,01,  Uttarpara,615,485,317,219,298,266,55.9,59.1,52.8,00000
86.0,69.0,47.0,602,02,01,  Dakshinpara,917,590,511,283,406,307,60.8,64.4,56.9,00000
86.0,69.0,47.0,602,03,01,  Hindu Para,481,335,260,151,221,184,58.9,63.3,54.6,00000
86.0,69.0,57.0,641,01,01,  Sabek Koarpur,1789,2174,841,1050,948,1124,45.1,44.5,45.8,00000
86.0,69.0,57.0,641,02,01,  Char Koarpur,870,884,425,407,445,477,49.6,51.1,48.3,00000
86.0,69.0,57.0,908,01,01,  Sabek Sujandhali,692,664,339,312,353,352,51.0,52.1,50.1,00000
86.0,69.0,57.0,908,02,01,  Char Sujandhali,502,684,230,315,272,369,42.3,42.2,42.4,00000
86.0,69.0,62.0,679,01,01,  Kazi Mamuderkandi,209,299,113,134,96,165,41.1,45.7,36.8,00000
86.0,69.0,62.0,679,02,01,  Paschim Mamuderkandi,401,243,207,100,194,143,62.3,67.4,57.6,00000
86.0,69.0,62.0,679,03,01,  Hindu Para,170,154,96,76,74,78,52.5,55.8,48.7,00000
86.0,69.0,62.0,679,04,01,  Raman Ander Howlakandi,135,187,71,98,64,89,41.9,42.0,41.8,00000
86.0,69.0,62.0,679,05,01,  Sipahi Para,195,371,110,179,85,192,34.5,38.1,30.7,00000
86.0,69.0,62.0,679,06,01,  Khan Para,167,222,77,108,90,114,42.9,41.6,44.1,00000
86.0,69.0,62.0,679,07,01,  Purba Mohammadpur,189,324,93,158,96,166,36.8,37.1,36.6,00000
86.0,69.0,62.0,679,08,01,  Dakshin Mohammadpur,320,481,152,221,168,260,40.0,40.8,39.3,00000
86.0,69.0,62.0,679,09,01,  Kadamtali,319,306,164,120,155,186,51.0,57.7,45.5,00000
86.0,69.0,85.0,353,01,01,  Gram Chikandi,482,565,247,285,235,280,46.0,46.4,45.6,00000
86.0,69.0,85.0,353,02,01,  Char Chikandi,662,856,334,415,328,441,43.6,44.6,42.7,00000
86.0,69.0,85.0,516,01,01,  Mollahkandi,274,309,129,148,145,161,47.0,46.6,47.4,00000
86.0,69.0,85.0,516,02,01,  Chowkidarkandi,332,416,175,202,157,214,44.4,46.4,42.3,00000
86.0,69.0,85.0,516,03,01,  Dhalikandi,365,555,195,268,170,287,39.7,42.1,37.2,00000
86.0,69.0,85.0,516,04,01,  Daikandi,191,154,111,71,80,83,55.4,61.0,49.1,00000
86.0,69.0,85.0,516,05,01,  Khalifakandi,672,556,331,260,341,296,54.7,56.0,53.5,00000
86.0,69.0,85.0,516,06,01,  Hindu Para,627,226,342,100,285,126,73.5,77.4,69.3,00000
86.0,69.0,85.0,516,07,01,  Uttar Gramchikandi,424,275,199,116,225,159,60.7,63.2,58.6,00000
86.0,69.0,85.0,861,01,01,  Sabek Sarenga,532,571,258,265,274,306,48.2,49.3,47.2,00000
86.0,69.0,85.0,861,02,01,  Char Sarenga,416,335,190,147,226,188,55.4,56.4,54.6,00000
86.0,69.0,85.0,880,01,01,  Beparikandi,282,563,112,272,170,291,33.4,29.2,36.9,00000
86.0,69.0,85.0,880,02,01,  Khankandi,173,246,71,120,102,126,41.3,37.2,44.7,00000
86.0,94.0,12.0,081,01,01,  Helaluddin Rarikandi,273,225,141,114,132,111,54.8,55.3,54.3,00000
86.0,94.0,12.0,081,02,01,  Kacharikandi,202,384,104,202,98,182,34.5,34.0,35.0,00000
86.0,94.0,12.0,081,03,01,  Kamaruddin Madbarkandi,245,339,136,182,109,157,42.0,42.8,41.0,00000
86.0,94.0,12.0,081,04,01,  Dewankandi,200,315,97,163,103,152,38.8,37.3,40.4,00000
86.0,94.0,12.0,081,05,01,  Baliakandi,152,207,85,88,67,119,42.3,49.1,36.0,00000
86.0,94.0,12.0,081,06,01,  Ijuddin Sikdarkandi,70,104,33,54,37,50,40.2,37.9,42.5,00000
86.0,94.0,12.0,081,07,01,  Tekkandi,132,237,73,111,59,126,35.8,39.7,31.9,00000
86.0,94.0,12.0,081,08,01,  Balia Sikdarkandi,244,242,122,115,122,127,50.2,51.5,49.0,00000
86.0,94.0,12.0,081,09,01,  Kabirajkandi,234,217,126,106,108,111,51.9,54.3,49.3,00000
86.0,94.0,12.0,081,10,01,  Bara Gopal Sardarkandi,161,183,77,90,84,93,46.8,46.1,47.5,00000
86.0,94.0,12.0,081,11,01,  Faju & Masud Matbarkandi,416,554,218,279,198,275,42.9,43.9,41.9,00000
86.0,94.0,12.0,081,12,01,  Kalai Rarikandi,270,456,139,241,131,215,37.2,36.6,37.9,00000
86.0,94.0,12.0,081,13,01,  Pashu Madbarkandi,172,185,88,96,84,89,48.2,47.8,48.6,00000
86.0,94.0,12.0,081,14,01,  Chowkidarkandi,350,341,172,164,178,177,50.7,51.2,50.1,00000
86.0,94.0,12.0,081,15,01,  Korban Hajikandi,166,76,82,36,84,40,68.6,69.5,67.7,00000
86.0,94.0,12.0,081,16,01,  Bara Gopal Dakshin Sikdarkandi,96,79,57,44,39,35,54.9,56.4,52.7,00000
86.0,94.0,12.0,081,17,01,  Uttar Sikdarkandi,388,513,197,261,191,252,43.1,43.0,43.1,00000
86.0,94.0,12.0,081,18,01,  Talukdarkandi,155,150,66,76,89,74,50.8,46.5,54.6,00000
86.0,94.0,12.0,081,19,01,  Khankandi,120,108,56,50,64,58,52.6,52.8,52.5,00000
86.0,94.0,14.0,111,01,01,  Barakandi,352,970,187,464,165,506,26.6,28.7,24.6,00000
86.0,94.0,14.0,111,02,01,  Pachim Bara Kandi,200,1072,94,521,106,551,15.7,15.3,16.1,00000
86.0,94.0,14.0,111,03,01,  Mirdha Kandi,98,319,43,142,55,177,23.5,23.2,23.7,00000
86.0,94.0,21.0,089,01,01,  Paschim Kazikandi,638,590,362,280,276,310,52.0,56.4,47.1,00000
86.0,94.0,21.0,089,02,01,  Purba Kazikandi,573,667,293,298,280,369,46.2,49.6,43.1,00000
86.0,94.0,21.0,089,03,01,  Moralkandi,355,335,192,157,163,178,51.4,55.0,47.8,00000
86.0,94.0,21.0,089,04,01,  Mirdhakandi,498,354,258,167,240,187,58.5,60.7,56.2,00000
86.0,94.0,21.0,089,05,01,  Munshikandi,196,283,120,138,76,145,40.9,46.5,34.4,00000
86.0,94.0,21.0,089,06,01,  Namasudrakandi,337,300,184,143,153,157,52.9,56.3,49.4,00000
86.0,94.0,21.0,089,07,01,  Sadar Ali Madbarkandi,199,159,104,77,95,82,55.6,57.5,53.7,00000
86.0,94.0,21.0,089,08,01,  Beparikandi,164,91,81,37,83,54,64.3,68.6,60.6,00000
86.0,94.0,21.0,089,09,01,  Sardarkandi,186,186,85,81,101,105,50.0,51.2,49.0,00000
86.0,94.0,21.0,089,10,01,  Subandi Madbarkandi,484,1165,236,572,248,593,29.4,29.2,29.5,00000
86.0,94.0,21.0,089,11,01,  Kinaul Madbarkandi,409,439,225,201,184,238,48.2,52.8,43.6,00000
86.0,94.0,21.0,089,12,01,  Kadam Ali Madbarkandi,125,383,65,188,60,195,24.6,25.7,23.5,00000
86.0,94.0,21.0,089,13,01,  Khankandi,148,175,64,75,84,100,45.8,46.0,45.7,00000
86.0,94.0,21.0,089,14,01,  Howldarkandi,488,800,254,381,234,419,37.9,40.0,35.8,00000
86.0,94.0,21.0,089,15,01,  Afsar Hawladarkandi,133,215,75,104,58,111,38.2,41.9,34.3,00000
86.0,94.0,29.0,141,01,01,  Mahar Ali Madbar Kandi,789,1048,349,493,440,555,43.0,41.4,44.2,00000
86.0,94.0,29.0,141,02,01,  Sharang Kandi,654,579,308,266,346,313,53.0,53.7,52.5,00000
86.0,94.0,29.0,141,03,01,  Pachukar Kandi,490,785,221,348,269,437,38.4,38.8,38.1,00000
86.0,94.0,29.0,282,01,01,  Daimuddin Khalifarkandi,198,313,94,162,104,151,38.7,36.7,40.8,00000
86.0,94.0,29.0,282,02,01,  Alimuddin Matabar Kandi,166,221,94,103,72,118,42.9,47.7,37.9,00000
86.0,94.0,43.0,512,01,01,  Joynagar Sarder Kandi,421,352,218,151,203,201,54.5,59.1,50.2,00000
86.0,94.0,43.0,512,02,01,  Joy Nagar Khankandi U.Para,489,322,252,143,237,179,60.3,63.8,57.0,00000
86.0,94.0,43.0,512,03,01,  Joy Nagar Khankandi D.Para,639,746,311,340,328,406,46.1,47.8,44.7,00000
86.0,94.0,43.0,994,01,01,  Khankandi,435,407,227,186,208,221,51.7,55.0,48.5,00000
86.0,94.0,43.0,994,02,01,  Kazikandi,636,695,309,320,327,375,47.8,49.1,46.6,00000
86.0,94.0,51.0,571,01,01,  Eakub Bepari Kandi,290,342,143,160,147,182,45.9,47.2,44.7,00000
86.0,94.0,51.0,571,02,01,  Chokder Kandi,247,336,128,167,119,169,42.4,43.4,41.3,00000
86.0,94.0,51.0,571,03,01,  Dangar Mallikkandi,229,356,107,172,122,184,39.1,38.4,39.9,00000
86.0,94.0,65.0,363,01,01,  Sahar Ali Bapari Kandi,150,278,80,143,70,135,35.0,35.9,34.1,00000
86.0,94.0,65.0,363,02,01,  Karim Howlader Kandi,248,156,106,74,142,82,61.4,58.9,63.4,00000
86.0,94.0,65.0,363,03,01,  Janab Ali Talukder Kandi,147,311,61,142,86,169,32.1,30.0,33.7,00000
86.0,94.0,65.0,363,04,01,  Kadir Mina Kandi,294,553,130,266,164,287,34.7,32.8,36.4,00000
86.0,94.0,65.0,363,05,01,  Mozid Howlader Kandi,133,210,54,107,79,103,38.8,33.5,43.4,00000
86.0,94.0,65.0,363,06,01,  Toraf Ali Matbar Kandi,59,519,31,268,28,251,10.2,10.4,10.0,00000
86.0,94.0,65.0,363,07,01,  Joynal Ali Matbar Kandi,385,389,184,180,201,209,49.7,50.5,49.0,00000
86.0,94.0,65.0,363,08,01,  Bayati Kandi,113,327,68,164,45,163,25.7,29.3,21.6,00000
86.0,94.0,65.0,363,09,01,  Mirdha Kandi,141,183,60,104,81,79,43.5,36.6,50.6,00000
86.0,94.0,65.0,363,10,01,  Gofur Molla Kandi,125,248,66,136,59,112,33.5,32.7,34.5,00000
86.0,94.0,65.0,363,11,01,  Sala Momatubar Kandi,202,220,100,110,102,110,47.9,47.6,48.1,00000
86.0,94.0,65.0,742,01,01,  Saral Khan Kandi,156,249,75,124,81,125,38.5,37.7,39.3,00000
86.0,94.0,65.0,742,02,01,  Ramijuddin Moulabir Kandi,327,470,166,221,161,249,41.0,42.9,39.3,00000
86.0,94.0,65.0,742,03,01,  Sadar  Ali Moll. Kandi,131,211,54,95,77,116,38.3,36.2,39.9,00000
86.0,94.0,65.0,742,04,01,  Minuddin Jamadder Kandi,361,409,197,186,164,223,46.9,51.4,42.4,00000
86.0,94.0,65.0,742,05,01,  Mazid Moral Kandi,442,454,245,216,197,238,49.3,53.1,45.3,00000
86.0,94.0,65.0,742,06,01,  Safder Fakir Kandi,121,178,52,89,69,89,40.5,36.9,43.7,00000
86.0,94.0,65.0,742,07,01,  Taher Dali Kandi,368,350,183,144,185,206,51.3,56.0,47.3,00000
86.0,94.0,65.0,742,08,01,  Mazid Dalikandi,416,740,196,357,220,383,36.0,35.4,36.5,00000
86.0,94.0,65.0,742,09,01,  Pansayd Kandi,154,220,80,102,74,118,41.2,44.0,38.5,00000
86.0,94.0,65.0,742,10,01,  Balea Kandi,140,129,67,62,73,67,52.0,51.9,52.1,00000
86.0,94.0,65.0,742,11,01,  Kalu Bapary Kandi,47,241,23,122,24,119,16.3,15.9,16.8,00000
86.0,94.0,65.0,742,12,01,  Gayzuddin Dili Kandi,181,191,79,98,102,93,48.7,44.6,52.3,00000
86.0,94.0,65.0,794,01,01,  Sahed Ali Gomosta Kandi,490,533,240,252,250,281,47.9,48.8,47.1,00000
86.0,94.0,65.0,794,02,01,  Abdul Ali Munshi Kandi,479,490,268,225,211,265,49.4,54.4,44.3,00000
86.0,94.0,65.0,794,03,01,  Thar Mallik Kandi,293,419,147,184,146,235,41.2,44.4,38.3,00000
86.0,94.0,65.0,794,04,01,  Haran Tuni Kandi,229,232,129,96,100,136,49.7,57.3,42.4,00000
86.0,94.0,65.0,794,05,01,  Alimoddin Mollik Kandi,330,669,149,337,181,332,33.0,30.7,35.3,00000
86.0,94.0,73.0,326,01,01,  Hamij Uddin Fakirkandi,182,729,101,325,81,404,20.0,23.7,16.7,00000
86.0,94.0,73.0,326,02,01,  Dhangirkandi,265,580,144,285,121,295,31.4,33.6,29.1,00000
86.0,94.0,73.0,326,03,01,  Goni Matbar Kandi,261,452,129,228,132,224,36.6,36.1,37.1,00000
86.0,94.0,73.0,601,01,01,  Mohan Fakirkandi,203,80,92,31,111,49,71.7,74.8,69.4,00000
86.0,94.0,73.0,601,02,01,  Dawirkandi,220,295,120,155,100,140,42.7,43.6,41.7,00000
86.0,94.0,73.0,601,03,01,  Haji Rahimuddin Matbar,144,149,69,64,75,85,49.1,51.9,46.9,00000
86.0,94.0,73.0,601,04,01,  Madhu Madbarkandi,340,359,179,161,161,198,48.6,52.6,44.8,00000
86.0,94.0,73.0,601,05,01,  Yasin Akan Kandi,148,280,66,132,82,148,34.6,33.3,35.7,00000
86.0,94.0,73.0,861,01,01,  Rarikandi,160,208,90,117,70,91,43.5,43.5,43.5,00000
86.0,94.0,73.0,861,02,01,  Hukum Ali Sikdarkandi,213,372,125,183,88,189,36.4,40.6,31.8,00000
86.0,94.0,73.0,943,01,01,  Dewankandi,207,188,105,84,102,104,52.4,55.6,49.5,00000
86.0,94.0,73.0,943,02,01,  Golap Khan Hajirkandi,192,571,105,275,87,296,25.2,27.6,22.7,00000
86.0,94.0,73.0,943,03,01,  Juhuruddin Munshirkandi,152,279,71,134,81,145,35.3,34.6,35.8,00000
86.0,94.0,73.0,943,04,01,  Faizuddin Matbarkandi,209,214,106,88,103,126,49.4,54.6,45.0,00000
86.0,94.0,80.0,824,01,01,  Kalymoral Kandi,228,491,112,247,116,244,31.7,31.2,32.2,00000
86.0,94.0,80.0,824,02,01,  Purba Naodoba,2842,3581,1478,1694,1364,1887,44.2,46.6,42.0,00000
86.0,94.0,80.0,824,03,01,  Okaluddin Munsir Kandi,208,549,91,261,117,288,27.5,25.9,28.9,00000
86.0,94.0,87.0,170,01,01,  Mollahkandi,202,329,89,156,113,173,38.0,36.3,39.5,00000
86.0,94.0,87.0,170,02,01,  Sardarkandi,289,201,148,94,141,107,59.0,61.2,56.9,00000
86.0,94.0,87.0,170,03,01,  Akandkandi,164,197,85,101,79,96,45.4,45.7,45.1,00000
86.0,94.0,87.0,170,04,01,  Baliakandi,328,544,183,266,145,278,37.6,40.8,34.3,00000
86.0,94.0,87.0,170,05,01,  Sakim Ali Matbar Kandi,132,199,67,89,65,110,39.9,42.9,37.1,00000
86.0,94.0,87.0,170,06,01,  Bholai Munshikandi,176,248,94,121,82,127,41.5,43.7,39.2,00000
86.0,94.0,87.0,170,07,01,  Charkandi,350,603,180,296,170,307,36.7,37.8,35.6,00000
86.0,94.0,87.0,170,08,01,  Kacharikandi,432,600,232,301,200,299,41.9,43.5,40.1,00000
86.0,94.0,87.0,913,01,01,  Mahiuddin Hajikandi Mozidkandi,201,241,97,120,104,121,45.5,44.7,46.2,00000
86.0,94.0,87.0,913,02,01,  Rajab Ali Sikder Kandi,225,121,127,56,98,65,65.0,69.4,60.1,00000
86.0,94.0,87.0,913,03,01,  Khankandi,121,124,54,58,67,66,49.4,48.2,50.4,00000
86.0,94.0,87.0,913,04,01,  Sener Char Dakhinkandi,401,405,191,177,210,228,49.8,51.9,47.9,00000
86.0,94.0,87.0,913,05,01,  Dagud Hali Kandi,153,211,82,81,71,130,42.0,50.3,35.3,00000
86.0,94.0,87.0,913,06,01,  Dhalikandi,161,201,76,90,85,111,44.5,45.8,43.4,00000
86.0,94.0,87.0,913,07,01,  Howladarkandi & Bayti Kandi,281,475,136,244,145,231,37.2,35.8,38.6,00000
86.0,94.0,87.0,913,08,01,  Afazuddin Munshikandi,455,366,241,193,214,173,55.4,55.5,55.3,00000
86.0,94.0,87.0,913,09,01,  Razab Ali Munshikandi,81,217,51,109,30,108,27.2,31.9,21.7,00000
86.0,94.0,87.0,913,10,01,  Molla Kandi,155,251,86,127,69,124,38.2,40.4,35.8,00000
86.0,94.0,87.0,913,11,01,  Momin Matabbarkandi& Ah.Mat.K.,155,299,76,144,79,155,34.1,34.5,33.8,00000
86.0,94.0,87.0,913,12,01,  Kariuddin Matabbarkandi,287,698,124,329,163,369,29.1,27.4,30.6,00000
86.0,94.0,87.0,913,13,01,  Mallik Kandi,189,248,94,119,95,129,43.2,44.1,42.4,00000
86.0,94.0,87.0,913,14,01,  P.Howlader Ka.(S.C.P.H.Kandi),159,219,74,99,85,120,42.1,42.8,41.5,00000
86.0,94.0,87.0,913,15,01,  A.A.Munshirkandi,175,191,72,100,103,91,47.8,41.9,53.1,00000
54.0,40.0,18.0,092,01,01,  Banshgari,223,859,115,449,108,410,20.6,20.4,20.8,00000
54.0,40.0,18.0,092,02,01,  Bhata Bali,67,326,41,143,26,183,17.0,22.3,12.4,00000
54.0,40.0,18.0,319,01,01,  Paripathar,535,459,260,206,275,253,53.8,55.8,52.1,00000
54.0,40.0,18.0,319,02,01,  Mydah Char,219,368,107,186,112,182,37.3,36.5,38.1,00000
54.0,40.0,18.0,319,03,01,  Bhaduri Maidan,621,633,316,270,305,363,49.5,53.9,45.7,00000
54.0,40.0,18.0,319,04,01,  Ghanibepari,450,431,249,170,201,261,51.1,59.4,43.5,00000
54.0,40.0,18.0,319,05,01,  Palarabad,93,130,38,57,55,73,41.7,40.0,43.0,00000
54.0,40.0,25.0,184,01,01,  Mathabhanga,531,1036,232,496,299,540,33.9,31.9,35.6,00000
54.0,40.0,25.0,184,02,01,  Uttarkandi,208,164,99,71,109,93,55.9,58.2,54.0,00000
54.0,40.0,25.0,184,03,01,  Dakshinkandi,494,546,221,250,273,296,47.5,46.9,48.0,00000
54.0,40.0,25.0,184,04,01,  Nutan Char Daulat Khan,886,1223,413,600,473,623,42.0,40.8,43.2,00000
54.0,40.0,25.0,184,05,01,  Dimchar,226,978,115,483,111,495,18.8,19.2,18.3,00000
54.0,40.0,25.0,184,06,01,  Garubatam,116,32,58,8,58,24,78.4,87.9,70.7,00000
54.0,40.0,25.0,184,07,01,  Maddair Char,432,647,244,316,188,331,40.0,43.6,36.2,00000
54.0,40.0,25.0,184,08,01,  Uttar Char Daulat Khan(Hindu P,418,517,213,245,205,272,44.7,46.5,43.0,00000
54.0,40.0,25.0,190,01,01,  Shakarikandi,82,77,38,36,44,41,51.6,51.4,51.8,00000
54.0,40.0,25.0,190,02,01,  Gangkandi,35,46,16,19,19,27,43.2,45.7,41.3,00000
54.0,40.0,25.0,190,03,01,  Dhakikandi,178,311,83,161,95,150,36.4,34.0,38.8,00000
54.0,40.0,25.0,190,04,01,  Dakshin Databali,70,24,36,7,34,17,74.5,83.7,66.7,00000
54.0,40.0,25.0,190,05,01,  Tafadirkandi,70,70,37,30,33,40,50.0,55.2,45.2,00000
54.0,40.0,25.0,190,06,01,  Madhyapara,188,122,106,52,82,70,60.6,67.1,53.9,00000
54.0,40.0,25.0,190,07,01,  Dakshin Nawakandi,175,128,87,63,88,65,57.8,58.0,57.5,00000
54.0,40.0,37.0,024,01,01,  Purba Alipur,1175,1653,637,742,538,911,41.5,46.2,37.1,00000
54.0,40.0,37.0,024,02,01,  Paschim Alipur,693,1686,409,791,284,895,29.1,34.1,24.1,00000
54.0,40.0,44.0,779,01,01,  Purba Puali,790,583,397,288,393,295,57.5,58.0,57.1,00000
54.0,40.0,44.0,779,02,01,  Paschim Puali,670,377,339,167,331,210,64.0,67.0,61.2,00000
54.0,40.0,56.0,104,01,01,  Bara Char Kayaria,618,542,275,240,343,302,53.3,53.4,53.2,00000
54.0,40.0,56.0,104,02,01,  Majher Kandi,676,472,301,212,375,260,58.9,58.7,59.1,00000
54.0,40.0,56.0,104,03,01,  Takra Kandi,290,306,141,146,149,160,48.7,49.1,48.2,00000
54.0,40.0,56.0,104,04,01,  Jamadar  Kandi,214,169,100,77,114,92,55.9,56.5,55.3,00000
54.0,40.0,56.0,104,05,01,  Majer Char Taluk,748,323,383,128,365,195,69.8,75.0,65.2,00000
54.0,40.0,56.0,104,06,01,  Uttar Kayaria,320,61,158,15,162,46,84.0,91.3,77.9,00000
54.0,40.0,69.0,614,01,01,  Jalalpur,199,524,99,234,100,290,27.5,29.7,25.6,00000
54.0,40.0,69.0,614,02,01,  Narakandi,350,528,194,255,156,273,39.9,43.2,36.4,00000
54.0,40.0,69.0,614,03,01,  Dakshinkandi,279,440,132,197,147,243,38.8,40.1,37.7,00000
54.0,40.0,69.0,614,04,01,  Madhya Lakshmipur,436,706,230,351,206,355,38.2,39.6,36.7,00000
54.0,40.0,69.0,614,05,01,  Paschimkandi,315,555,185,287,130,268,36.2,39.2,32.7,00000
54.0,40.0,69.0,614,06,01,  Karikarkandi,637,319,314,118,323,201,66.6,72.7,61.6,00000
54.0,40.0,88.0,036,01,01,  Nutan Andhar Char,1254,740,629,339,625,401,62.9,65.0,60.9,00000
54.0,40.0,88.0,036,02,01,  Puran Andhar Char,2130,1607,1031,768,1099,839,57.0,57.3,56.7,00000
54.0,40.0,88.0,036,03,01,  Utter Under Char,498,460,256,215,242,245,52.0,54.4,49.7,00000
54.0,40.0,88.0,884,01,01,  Dakshin Sahebrampur,735,900,349,392,386,508,45.0,47.1,43.2,00000
54.0,40.0,88.0,884,02,01,  Uttar Sahebrampur,764,791,353,384,411,407,49.1,47.9,50.2,00000
54.0,40.0,94.0,184,01,01,  Kachikandi,297,381,135,179,162,202,43.8,43.0,44.5,00000
54.0,40.0,94.0,184,02,01,  Merdakandi,344,267,161,122,183,145,56.3,56.9,55.8,00000
54.0,40.0,94.0,184,03,01,  Sardarkandi,622,203,311,88,311,115,75.4,77.9,73.0,00000
54.0,54.0,10.0,056,01,01,  Paschim Bahadurpur,400,391,204,207,196,184,50.6,49.6,51.6,00000
54.0,54.0,10.0,056,02,01,  Purba Bahadurpur,529,502,285,227,244,275,51.3,55.7,47.0,00000
54.0,54.0,10.0,289,01,01,  Char Birangal,448,892,226,426,222,466,33.4,34.7,32.3,00000
54.0,54.0,10.0,289,02,01,  Bringal (Birangal),384,894,197,420,187,474,30.0,31.9,28.3,00000
54.0,54.0,10.0,289,03,01,  Radharbari,295,129,172,59,123,70,69.6,74.5,63.7,00000
54.0,54.0,10.0,289,04,01,  Rakhalhati,270,90,160,36,110,54,75.0,81.6,67.1,00000
54.0,54.0,17.0,283,01,01,  Itkhola Bajitpur,351,755,181,350,170,405,31.7,34.1,29.6,00000
54.0,54.0,17.0,283,02,01,  Char Bajitpur,417,411,204,179,213,232,50.4,53.3,47.9,00000
54.0,54.0,17.0,346,01,01,  Khalashikandi,665,880,364,384,301,496,43.0,48.7,37.8,00000
54.0,54.0,17.0,346,02,01,  Sardarkandi,357,595,173,254,184,341,37.5,40.5,35.0,00000
54.0,54.0,17.0,346,03,01,  Dasher Char,335,697,190,349,145,348,32.5,35.3,29.4,00000
54.0,54.0,23.0,490,01,01,  Purba Hausdi,544,499,268,218,276,281,52.2,55.1,49.6,00000
54.0,54.0,23.0,490,02,01,  Madhya Hausdi,437,267,238,113,199,154,62.1,67.8,56.4,00000
54.0,54.0,23.0,490,03,01,  Patiladi,382,253,179,115,203,138,60.2,60.9,59.5,00000
54.0,54.0,23.0,969,01,01,  Uttar Dudkhali,907,264,492,105,415,159,77.5,82.4,72.3,00000
54.0,54.0,23.0,969,02,01,  Sikdarkandi,655,847,324,369,331,478,43.6,46.8,40.9,00000
54.0,54.0,23.0,969,03,01,  Barakandi,858,941,415,465,443,476,47.7,47.2,48.2,00000
54.0,54.0,41.0,226,01,01,  Paschim Char Nachna,151,280,87,142,64,138,35.0,38.0,31.7,00000
54.0,54.0,41.0,226,02,01,  Purba Char Nachna,268,138,146,56,122,82,66.0,72.3,59.8,00000
54.0,54.0,41.0,226,03,01,  Char Nachna,911,596,461,273,450,323,60.5,62.8,58.2,00000
54.0,54.0,41.0,522,01,01,  Purba Kalikapur,1038,1304,493,631,545,673,44.3,43.9,44.7,00000
54.0,54.0,41.0,522,02,01,  Paschim Kalikapur,1988,2202,1160,1090,828,1112,47.4,51.6,42.7,00000
54.0,54.0,59.0,623,01,01,  Dakshinpara,694,951,346,476,348,475,42.2,42.1,42.3,00000
54.0,54.0,59.0,623,02,01,  Kunia,230,213,122,107,108,106,51.9,53.3,50.5,00000
54.0,54.0,59.0,623,03,01,  Bangram,208,144,117,60,91,84,59.1,66.1,52.0,00000
54.0,54.0,59.0,623,04,01,  Bharua Para,341,213,163,71,178,142,61.6,69.7,55.6,00000
54.0,54.0,59.0,623,05,01,  Mahmudshi,480,188,262,85,218,103,71.9,75.5,67.9,00000
54.0,54.0,71.0,138,01,01,  Bara Mehair,1456,1331,798,636,658,695,52.2,55.6,48.6,00000
54.0,54.0,71.0,138,02,01,  Chapatali,393,937,196,482,197,455,29.5,28.9,30.2,00000
54.0,54.0,71.0,478,01,01,  Jayair,624,1158,334,591,290,567,35.0,36.1,33.8,00000
54.0,54.0,71.0,478,02,01,  Ambari,343,548,191,280,152,268,38.5,40.6,36.2,00000
54.0,54.0,77.0,088,01,01,  Mulabikandi,326,185,178,85,148,100,63.8,67.7,59.7,00000
54.0,54.0,77.0,088,02,01,  Sikdarkandi,471,259,235,114,236,145,64.5,67.3,61.9,00000
54.0,54.0,77.0,088,03,01,  Badshahkandi,450,597,261,265,189,332,43.0,49.6,36.3,00000
54.0,54.0,77.0,466,01,01,  Purba Jafrabad,302,373,138,188,164,185,44.7,42.3,47.0,00000
54.0,54.0,77.0,466,02,01,  Paschim Jafrabad,603,589,292,291,311,298,50.6,50.1,51.1,00000
54.0,54.0,77.0,472,01,01,  Janjira,1044,950,534,467,510,483,52.4,53.3,51.4,00000
54.0,54.0,77.0,472,02,01,  Char Kalikapur,1106,893,548,407,558,486,55.3,57.4,53.4,00000
54.0,54.0,77.0,994,01,01,  Uttar Panchkhola,1334,798,712,363,622,435,62.6,66.2,58.8,00000
54.0,54.0,77.0,994,02,01,  Middel Panchkhola,661,729,319,363,342,366,47.6,46.8,48.3,00000
54.0,54.0,77.0,994,03,01,  Purba Panchkhola,209,611,100,314,109,297,25.5,24.2,26.8,00000
54.0,54.0,83.0,006,01,01,  Adampur,478,416,224,180,254,236,53.5,55.4,51.8,00000
54.0,54.0,83.0,006,02,01,  Barailbari,431,387,227,150,204,237,52.7,60.2,46.3,00000
54.0,54.0,83.0,617,01,01,  Kumrakhali,519,530,272,244,247,286,49.5,52.7,46.3,00000
54.0,54.0,83.0,617,02,01,  Naya Char,841,1213,426,557,415,656,40.9,43.3,38.7,00000
54.0,54.0,89.0,421,01,01,  Paschim Hajrapur,756,870,393,443,363,427,46.5,47.0,45.9,00000
54.0,54.0,89.0,421,02,01,  Purba Hajrapur,240,451,124,214,116,237,34.7,36.7,32.9,00000
54.0,54.0,89.0,856,01,01,  Rasti Uttarpara,1193,1441,612,675,581,766,45.3,47.6,43.1,00000
54.0,54.0,89.0,856,02,01,  Rasti Dakshinpara,2646,2285,1388,1140,1258,1145,53.7,54.9,52.4,00000
54.0,54.0,94.0,081,01,01,  Bahir Char Sreenadi,339,365,175,186,164,179,48.2,48.5,47.8,00000
54.0,54.0,94.0,081,02,01,  Paschimmad,478,515,194,232,284,283,48.1,45.5,50.1,00000
54.0,54.0,94.0,132,01,01,  Gunasi,373,1016,180,486,193,530,26.9,27.0,26.7,00000
54.0,54.0,94.0,132,02,01,  Char Gunasi,628,888,316,386,312,502,41.4,45.0,38.3,00000
54.0,54.0,94.0,887,01,01,  Uttar Sirkhara,638,390,326,161,312,229,62.1,66.9,57.7,00000
54.0,54.0,94.0,887,02,01,  Dakshin Sirkhara,583,381,285,181,298,200,60.5,61.2,59.8,00000
54.0,54.0,94.0,887,03,01,  Saidpur (Syednur),164,347,86,178,78,169,32.1,32.6,31.6,00000
54.0,54.0,94.0,887,04,01,  Sonapara,129,162,78,76,51,86,44.3,50.6,37.2,00000
54.0,54.0,94.0,894,01,01,  Sreenadi,572,732,314,354,258,378,43.9,47.0,40.6,00000
54.0,54.0,94.0,894,02,01,  Roykandi,525,805,290,412,235,393,39.5,41.3,37.4,00000
54.0,54.0,94.0,894,03,01,  Kotbari,376,375,163,156,213,219,50.1,51.1,49.3,00000
54.0,54.0,94.0,894,04,01,  Alamkhar Charkandi (Alammirer),122,178,53,77,69,101,40.7,40.8,40.6,00000
54.0,80.0,13.0,320,01,01,  Mollahkandi,559,574,309,258,250,316,49.3,54.5,44.2,00000
54.0,80.0,13.0,320,02,01,  Nararkandi,697,1096,386,535,311,561,38.9,41.9,35.7,00000
54.0,80.0,13.0,320,03,01,  Basabari,258,700,152,349,106,351,26.9,30.3,23.2,00000
54.0,80.0,13.0,320,04,01,  Matbari,527,335,270,146,257,189,61.1,64.9,57.6,00000
54.0,80.0,13.0,320,05,01,  Baradia,78,80,46,33,32,47,49.4,58.2,40.5,00000
54.0,80.0,13.0,320,06,01,  Purba Talikandi,512,988,256,489,256,499,34.1,34.4,33.9,00000
54.0,80.0,13.0,320,07,01,  Paschim Talikandi,152,313,89,146,63,167,32.7,37.9,27.4,00000
54.0,80.0,13.0,320,08,01,  Uttar Hogla,344,377,169,177,175,200,47.7,48.8,46.7,00000
54.0,80.0,13.0,320,09,01,  Dakshin Hogla,608,453,333,217,275,236,57.3,60.5,53.8,00000
54.0,80.0,13.0,438,01,01,  Kandia,508,477,280,234,228,243,51.6,54.5,48.4,00000
54.0,80.0,13.0,438,02,01,  Naya Char,126,278,77,129,49,149,31.2,37.4,24.7,00000
54.0,80.0,19.0,042,01,01,  Badar Pasha,2091,1981,1055,966,1036,1015,51.4,52.2,50.5,00000
54.0,80.0,19.0,042,02,01,  Purba Badar Pasha,513,477,263,229,250,248,51.8,53.5,50.2,00000
54.0,80.0,19.0,213,01,01,  Purba Daradia,326,671,173,294,153,377,32.7,37.0,28.9,00000
54.0,80.0,19.0,213,02,01,  Naya Kandi Daraia,84,222,48,92,36,130,27.5,34.3,21.7,00000
54.0,80.0,19.0,246,01,01,  Omarkhali,252,258,129,106,123,152,49.4,54.9,44.7,00000
54.0,80.0,19.0,246,02,01,  Krishnapur,433,717,215,309,218,408,37.7,41.0,34.8,00000
54.0,80.0,19.0,246,03,01,  Patankandi,76,273,45,132,31,141,21.8,25.4,18.0,00000
54.0,80.0,19.0,246,04,01,  Hujuri,130,87,70,38,60,49,59.9,64.8,55.0,00000
54.0,80.0,19.0,246,05,01,  Galakata,55,78,28,34,27,44,41.4,45.2,38.0,00000
54.0,80.0,19.0,288,01,01,  Gopalganj,770,835,364,389,406,446,48.0,48.3,47.7,00000
54.0,80.0,19.0,288,02,01,  Nayanagar,489,443,202,206,287,237,52.5,49.5,54.8,00000
54.0,80.0,19.0,288,03,01,  Majhkandi,123,93,60,43,63,50,56.9,58.3,55.8,00000
54.0,80.0,28.0,427,01,01,  Karaibari,359,541,233,255,126,286,39.9,47.7,30.6,00000
54.0,80.0,28.0,427,02,01,  Kamlapur,390,991,254,465,136,526,28.2,35.3,20.5,00000
54.0,80.0,28.0,427,03,01,  Churasi,956,671,532,306,424,365,58.8,63.5,53.7,00000
54.0,80.0,28.0,427,04,01,  Pakhulla,95,215,53,88,42,127,30.6,37.6,24.9,00000
54.0,80.0,38.0,331,01,01,  Hossainpur,786,483,422,212,364,271,61.9,66.6,57.3,00000
54.0,80.0,38.0,331,02,01,  Uttar Hossainpur,422,347,198,154,224,193,54.9,56.3,53.7,00000
54.0,80.0,38.0,588,01,01,  Nagardi,666,857,361,395,305,462,43.7,47.8,39.8,00000
54.0,80.0,38.0,588,02,01,  Tatikanda,1059,1326,551,604,508,722,44.4,47.7,41.3,00000
54.0,80.0,47.0,021,01,01,  Dakshin Arai Para,316,183,155,72,161,111,63.3,68.3,59.2,00000
54.0,80.0,47.0,021,02,01,  Uttar Arai Para,239,438,129,217,110,221,35.3,37.3,33.2,00000
54.0,80.0,47.0,363,01,01,  Isibpur,392,346,191,160,201,186,53.1,54.4,51.9,00000
54.0,80.0,47.0,363,02,01,  Majhkanda,258,214,124,86,134,128,54.7,59.0,51.1,00000
54.0,80.0,47.0,770,01,01,  Sakharpar,1789,2478,872,1095,917,1383,41.9,44.3,39.9,00000
54.0,80.0,47.0,770,02,01,  Mucharkandi,303,231,161,90,142,141,56.7,64.1,50.2,00000
54.0,80.0,47.0,770,03,01,  Lundi,1043,597,503,241,540,356,63.6,67.6,60.3,00000
54.0,80.0,47.0,813,01,01,  Satbaria,582,845,270,381,312,464,40.8,41.5,40.2,00000
54.0,80.0,47.0,813,02,01,  Goaldi,359,475,176,221,183,254,43.0,44.3,41.9,00000
54.0,80.0,47.0,813,03,01,  Nagar Goali,348,271,176,103,172,168,56.2,63.1,50.6,00000
54.0,80.0,57.0,898,01,01,  Solpur,346,383,153,182,193,201,47.5,45.7,49.0,00000
54.0,80.0,57.0,898,02,01,  Kasimnagar,138,200,74,81,64,119,40.8,47.7,35.0,00000
54.0,80.0,57.0,898,03,01,  Muzarkandi,273,247,157,118,116,129,52.5,57.1,47.3,00000
54.0,80.0,57.0,898,04,01,  Razaramerkhalpar,244,421,123,209,121,212,36.7,37.0,36.3,00000
54.0,80.0,57.0,920,01,01,  Sreekrishnadi,1250,1896,621,909,629,987,39.7,40.6,38.9,00000
54.0,80.0,57.0,920,02,01,  Panthapara,203,282,102,126,101,156,41.9,44.7,39.3,00000
54.0,80.0,66.0,032,01,01,  Aruakandi,878,789,512,366,366,423,52.7,58.3,46.4,00000
54.0,80.0,66.0,032,02,01,  Natakhola,304,412,169,181,135,231,42.5,48.3,36.9,00000
54.0,80.0,66.0,032,03,01,  Anadapur,85,47,46,21,39,26,64.4,68.7,60.0,00000
54.0,80.0,66.0,032,04,01,  Kalpur,95,109,59,50,36,59,46.6,54.1,37.9,00000
54.0,80.0,66.0,267,01,01,  Phulbari,553,445,312,202,241,243,55.4,60.7,49.8,00000
54.0,80.0,66.0,267,02,01,  Gazaria,136,335,63,159,73,176,28.9,28.4,29.3,00000
54.0,80.0,66.0,267,03,01,  Bholar Chak,176,182,89,83,87,99,49.2,51.7,46.8,00000
54.0,80.0,66.0,267,04,01,  Mridhabari,730,358,415,136,315,222,67.1,75.3,58.7,00000
54.0,80.0,66.0,353,01,01,  Ikarbari Dighirpar,284,271,140,128,144,143,51.2,52.2,50.2,00000
54.0,80.0,66.0,353,02,01,  Hijalbari,390,474,213,227,177,247,45.1,48.4,41.7,00000
54.0,80.0,66.0,406,01,01,  Kadambari,1748,867,928,371,820,496,66.8,71.4,62.3,00000
54.0,80.0,66.0,406,02,01,  Dighirpar,1037,750,584,346,453,404,58.0,62.8,52.9,00000
54.0,80.0,66.0,406,03,01,  Rathbari,887,593,490,262,397,331,59.9,65.2,54.5,00000
54.0,80.0,66.0,620,01,01,  Narayanpur,517,617,264,314,253,303,45.6,45.7,45.5,00000
54.0,80.0,66.0,620,02,01,  Lakshmipur,509,605,270,295,239,310,45.7,47.8,43.5,00000
54.0,80.0,66.0,738,01,01,  Pukuria,861,587,468,241,393,346,59.5,66.0,53.2,00000
54.0,80.0,66.0,738,02,01,  Golabari,240,282,133,140,107,142,46.0,48.7,43.0,00000
54.0,80.0,66.0,834,01,01,  Barakhola (Satpar Dumuria),1070,434,576,196,494,238,71.1,74.6,67.5,00000
54.0,80.0,66.0,834,02,01,  Harinagar,247,155,137,75,110,80,61.4,64.6,57.9,00000
54.0,80.0,76.0,085,01,01,  Chekondi,100,123,55,56,45,67,44.8,49.5,40.2,00000
54.0,80.0,76.0,085,02,01,  Baulgram Muslimpara,590,1070,312,561,278,509,35.5,35.7,35.3,00000
54.0,80.0,76.0,085,03,01,  Kanaipur,135,322,67,165,68,157,29.5,28.9,30.2,00000
54.0,80.0,76.0,085,04,01,  Macharang,459,503,228,231,231,272,47.7,49.7,45.9,00000
54.0,80.0,76.0,085,05,01,  Baulgramhindupara,710,1080,367,546,343,534,39.7,40.2,39.1,00000
54.0,80.0,76.0,460,01,01,  Khalia,455,395,228,192,227,203,53.5,54.3,52.8,00000
54.0,80.0,76.0,460,02,01,  Palpara,43,77,23,38,20,39,35.8,37.7,33.9,00000
54.0,80.0,76.0,460,03,01,  Talbari,238,222,130,102,108,120,51.7,56.0,47.4,00000
54.0,80.0,76.0,460,04,01,  Khalia Gangarampur,227,289,121,136,106,153,44.0,47.1,40.9,00000
54.0,80.0,76.0,460,05,01,  Khalia Dakshinpara,441,388,238,176,203,212,53.2,57.5,48.9,00000
54.0,80.0,76.0,460,06,01,  Batanbari,170,360,94,177,76,183,32.1,34.7,29.3,00000
54.0,80.0,76.0,460,07,01,  Uttar Satpar,598,671,333,303,265,368,47.1,52.4,41.9,00000
54.0,80.0,76.0,460,08,01,  Dakshin Khalia,392,382,211,160,181,222,50.6,56.9,44.9,00000
54.0,80.0,76.0,641,01,01,  Nayakandi,831,657,415,313,416,344,55.8,57.0,54.7,00000
54.0,80.0,76.0,641,02,01,  Takerhat,1591,549,836,289,755,260,74.3,74.3,74.4,00000
54.0,80.0,76.0,791,01,01,  Purba Sarmangal,1361,1219,663,585,698,634,52.8,53.1,52.4,00000
54.0,80.0,76.0,791,02,01,  Sarmangal Hingpara,720,304,390,132,330,172,70.3,74.7,65.7,00000
54.0,80.0,76.0,791,03,01,  Paschim Sarmangal,921,988,461,481,460,507,48.2,48.9,47.6,00000
54.0,80.0,76.0,791,04,01,  Ghosalkandi,1603,1266,862,624,741,642,55.9,58.0,53.6,00000
54.0,80.0,76.0,823,01,01,  Satpar,816,828,463,350,353,478,49.6,56.9,42.5,00000
54.0,80.0,76.0,823,02,01,  Nurpur,92,292,49,168,43,124,24.0,22.6,25.7,00000
54.0,80.0,76.0,855,01,01,  Sendia,328,358,198,133,130,225,47.8,59.8,36.6,00000
54.0,80.0,76.0,855,02,01,  Palita,340,240,179,90,161,150,58.6,66.5,51.8,00000
54.0,80.0,76.0,855,03,01,  Naora,444,134,229,48,215,86,76.8,82.7,71.4,00000
54.0,80.0,76.0,855,04,01,  Ullahbari,780,434,412,217,368,217,64.3,65.5,62.9,00000
54.0,80.0,76.0,855,05,01,  Satianbari,270,205,145,90,125,115,56.8,61.7,52.1,00000
54.0,80.0,85.0,064,01,01,  Basudebpur,582,983,280,473,302,510,37.2,37.2,37.2,00000
54.0,80.0,85.0,064,02,01,  Katurakanda,150,256,69,117,81,139,36.9,37.1,36.8,00000
54.0,80.0,85.0,599,01,01,  Nazir Khan,95,163,39,72,56,91,36.8,35.1,38.1,00000
54.0,80.0,85.0,599,02,01,  Ranir Pukurpar,124,150,72,75,52,75,45.3,49.0,40.9,00000
54.0,80.0,85.0,599,03,01,  Matbari,25,79,15,38,10,41,24.0,28.3,19.6,00000
54.0,80.0,85.0,609,01,01,  Naora,102,90,46,39,56,51,53.1,54.1,52.3,00000
54.0,80.0,85.0,609,02,01,  Bajikara,60,44,29,20,31,24,57.7,59.2,56.4,00000
54.0,80.0,85.0,609,03,01,  Deuliabari,44,84,20,47,24,37,34.4,29.9,39.3,00000
54.0,80.0,85.0,695,01,01,  Paik Para,269,422,131,208,138,214,38.9,38.6,39.2,00000
54.0,80.0,85.0,695,02,01,  Nayakandi,435,821,189,383,246,438,34.6,33.0,36.0,00000
54.0,80.0,85.0,695,03,01,  Char Kashimpur,365,760,199,332,166,428,32.4,37.5,27.9,00000
54.0,80.0,85.0,727,01,01,  Prathar Char,82,300,34,134,48,166,21.5,20.2,22.4,00000
54.0,80.0,85.0,727,02,01,  Khoajiakhalpar,110,154,55,74,55,80,41.7,42.6,40.7,00000
54.0,80.0,85.0,930,01,01,  Sreephaltali,130,323,53,140,77,183,28.7,27.5,29.6,00000
54.0,80.0,85.0,930,02,01,  Char Saristabad,91,361,43,189,48,172,20.1,18.5,21.8,00000
54.0,80.0,95.0,128,01,01,  Chauaribari,598,712,353,333,245,379,45.6,51.5,39.3,00000
54.0,80.0,95.0,128,02,01,  Bhennabari,392,375,228,176,164,199,51.1,56.4,45.2,00000
54.0,80.0,95.0,748,01,03,  Gobandapur,541,701,268,328,273,373,43.6,45.0,42.3,00000
54.0,80.0,95.0,748,02,03,  Senerpar,47,24,27,11,20,13,66.2,71.1,60.6,00000
54.0,80.0,95.0,748,03,03,  Tentulia,161,184,87,86,74,98,46.7,50.3,43.0,00000
54.0,80.0,95.0,748,04,03,  Paschim Rajair Dakshinpara,998,847,517,412,481,435,54.1,55.7,52.5,00000
54.0,80.0,95.0,748,05,03,  Paschim Rajair Uttarpara,1018,832,547,389,471,443,55.0,58.4,51.5,00000
54.0,80.0,95.0,748,06,03,  Poaschim Rajair Kundu Para,309,68,181,26,128,42,82.0,87.4,75.3,00000
54.0,80.0,95.0,748,07,03,  Kunda Para,425,175,248,74,177,101,70.8,77.0,63.7,00000
54.0,80.0,95.0,748,08,03,  Shapara,366,80,191,36,175,44,82.1,84.1,79.9,00000
54.0,80.0,95.0,748,09,03,  Daipara,126,51,68,23,58,28,71.2,74.7,67.4,00000
54.0,80.0,95.0,748,10,03,  Dighirpar,336,146,180,60,156,86,69.7,75.0,64.5,00000
54.0,80.0,95.0,748,11,03,  Bepari Para,483,289,213,134,270,155,62.6,61.4,63.5,00000
54.0,80.0,95.0,748,12,03,  Kutibari,1432,694,713,317,719,377,67.4,69.2,65.6,00000
54.0,80.0,95.0,748,13,03,  Dakshin Rajair,423,539,231,264,192,275,44.0,46.7,41.1,00000
54.0,80.0,95.0,748,14,03,  Alam Dastar,1177,1174,661,577,516,597,50.1,53.4,46.4,00000
54.0,80.0,95.0,748,15,03,  Majumdarkandi,1044,1610,562,756,482,854,39.3,42.6,36.1,00000
54.0,80.0,95.0,748,16,03,  Sakharikandi,45,54,23,33,22,21,45.5,41.1,51.2,00000
54.0,80.0,95.0,748,17,03,  Bajerbari,181,266,91,136,90,130,40.5,40.1,40.9,00000
54.0,80.0,95.0,748,18,03,  Sundikuri,272,467,155,240,117,227,36.8,39.2,34.0,00000
54.0,80.0,95.0,748,19,03,  Rajair Bazar,637,69,318,24,319,45,90.2,93.0,87.6,00000
54.0,87.0,11.0,152,01,01,  Achim Bepary Kandi,142,335,79,145,63,190,29.8,35.3,24.9,00000
54.0,87.0,11.0,152,02,01,  Ramatullah Hajirkandi,13,18,9,11,4,7,41.9,45.0,36.4,00000
54.0,87.0,11.0,152,03,01,  Basat Khar Kandi,47,53,26,22,21,31,47.0,54.2,40.4,00000
54.0,87.0,11.0,152,04,01,  Mominuddin Hawlader,3,62,2,35,1,27,4.6,5.4,3.6,00000
54.0,87.0,11.0,152,05,01,  Bhelu Mollarkandi,31,77,18,34,13,43,28.7,34.6,23.2,00000
54.0,87.0,11.0,152,06,01,  Chokder Kandi,36,56,20,24,16,32,39.1,45.5,33.3,00000
54.0,87.0,11.0,152,07,01,  Maijuddin Madbakandi,28,45,16,19,12,26,38.4,45.7,31.6,00000
54.0,87.0,11.0,152,08,01,  Kachari Kandi,219,300,109,138,110,162,42.2,44.1,40.4,00000
54.0,87.0,11.0,152,09,01,  Munsi Kandi,120,292,50,147,70,145,29.1,25.4,32.6,00000
54.0,87.0,11.0,152,10,01,  Moral Kandi,54,263,29,134,25,129,17.0,17.8,16.2,00000
54.0,87.0,11.0,152,11,01,  Mafitullah Hawladrkandi,363,533,204,260,159,273,40.5,44.0,36.8,00000
54.0,87.0,11.0,152,12,01,  Mollik Kandi,107,120,46,60,61,60,47.1,43.4,50.4,00000
54.0,87.0,11.0,152,13,01,  Izzatullah Madbarkandi,51,169,22,90,29,79,23.2,19.6,26.9,00000
54.0,87.0,11.0,152,14,01,  Hamid Kandi Moulvi Kandi,35,326,20,167,15,159,9.7,10.7,8.6,00000
54.0,87.0,11.0,152,15,01,  Chattay Mollakandi,205,149,118,50,87,99,57.9,70.2,46.8,00000
54.0,87.0,11.0,152,16,01,  Taher Sikdarkandi,370,599,167,283,203,316,38.2,37.1,39.1,00000
54.0,87.0,11.0,152,17,01,  Nuruddin Madbarkandi,75,125,34,69,41,56,37.5,33.0,42.3,00000
54.0,87.0,11.0,152,18,01,  Rajuddin Madbar Kandi,86,121,43,52,43,69,41.5,45.3,38.4,00000
54.0,87.0,11.0,152,19,01,  Situ Hawlader Kandi,98,125,62,60,36,65,43.9,50.8,35.6,00000
54.0,87.0,11.0,152,20,01,  Akon Kandi,25,49,8,24,17,25,33.8,25.0,40.5,00000
54.0,87.0,11.0,152,21,01,  Sadak Ali M.K.,110,29,62,13,48,16,79.1,82.7,75.0,00000
54.0,87.0,11.0,152,22,01,  Korban Sikdar Kandi,48,53,23,27,25,26,47.5,46.0,49.0,00000
54.0,87.0,11.0,152,23,01,  Goer Sikdar Kandi,12,33,7,18,5,15,26.7,28.0,25.0,00000
54.0,87.0,11.0,152,24,01,  Shak Kandi,38,84,19,39,19,45,31.1,32.8,29.7,00000
54.0,87.0,11.0,340,01,01,  Rahmatulla Morol Kandi,66,69,36,30,30,39,48.9,54.5,43.5,00000
54.0,87.0,11.0,340,02,01,  Mahajan Bepari Kandi,75,52,47,20,28,32,59.1,70.1,46.7,00000
54.0,87.0,11.0,340,03,01,  Yousuf Khar Hajikandi,32,77,19,45,13,32,29.4,29.7,28.9,00000
54.0,87.0,11.0,340,04,01,  Jainuddin Shek Kandi,80,136,48,71,32,65,37.0,40.3,33.0,00000
54.0,87.0,13.0,107,01,01,  Uttar Banshkandi,385,656,192,294,193,362,37.0,39.5,34.8,00000
54.0,87.0,13.0,107,02,01,  Dakshin Banshkandi,1086,1277,597,598,489,679,46.0,50.0,41.9,00000
54.0,87.0,13.0,645,01,01,  Mirzarkandi,735,858,372,383,363,475,46.1,49.3,43.3,00000
54.0,87.0,13.0,645,02,01,  Mirzanagar,1308,1040,637,487,671,553,55.7,56.7,54.8,00000
54.0,87.0,13.0,645,03,01,  Purba Mirzarkandi,838,936,410,431,428,505,47.2,48.8,45.9,00000
54.0,87.0,13.0,645,04,01,  Beparikandi,477,645,222,305,255,340,42.5,42.1,42.9,00000
54.0,87.0,13.0,645,05,01,  Panchagram,222,114,117,54,105,60,66.1,68.4,63.6,00000
54.0,87.0,13.0,815,01,01,  Sambhuk,357,418,186,190,171,228,46.1,49.5,42.9,00000
54.0,87.0,13.0,815,02,01,  Khalifakandi,106,333,59,152,47,181,24.1,28.0,20.6,00000
54.0,87.0,13.0,824,01,01,  Sankir Char,343,313,157,134,186,179,52.3,54.0,51.0,00000
54.0,87.0,13.0,824,02,01,  Bhourkandi,240,163,111,81,129,82,59.6,57.8,61.1,00000
54.0,87.0,13.0,824,03,01,  Kazikandi,179,167,103,74,76,93,51.7,58.2,45.0,00000
54.0,87.0,13.0,896,01,01,  Sekhpur,255,505,111,230,144,275,33.6,32.6,34.4,00000
54.0,87.0,13.0,896,02,01,  Nayamara,203,257,107,112,96,145,44.1,48.9,39.8,00000
54.0,87.0,15.0,125,01,01,  Matabbar Kandi,437,708,211,328,226,380,38.2,39.1,37.3,00000
54.0,87.0,15.0,125,02,01,  Dhon Kandi,306,499,127,239,179,260,38.0,34.7,40.8,00000
54.0,87.0,15.0,125,03,01,  Sunakhar Kandi,128,278,54,133,74,145,31.5,28.9,33.8,00000
54.0,87.0,15.0,125,04,01,  Namar Kandi,81,167,31,72,50,95,32.7,30.1,34.5,00000
54.0,87.0,15.0,125,05,01,  Kalatala,91,182,38,90,53,92,33.3,29.7,36.6,00000
54.0,87.0,15.0,125,06,01,  Yasin Faraji Kandi,112,341,45,160,67,181,24.7,22.0,27.0,00000
54.0,87.0,15.0,313,01,01,  Mamin Munshir Kandi,113,91,69,56,44,35,55.4,55.2,55.7,00000
54.0,87.0,15.0,313,02,01,  Mulla Kandi,80,47,45,20,35,27,63.0,69.2,56.5,00000
54.0,87.0,15.0,313,03,01,  Kazi Kandi,115,165,59,87,56,78,41.1,40.4,41.8,00000
54.0,87.0,15.0,869,01,01,  Fazlul Bari Kandi,133,161,63,72,70,89,45.2,46.7,44.0,00000
54.0,87.0,15.0,869,02,01,  Ukil Kandi,133,172,65,72,68,100,43.6,47.4,40.5,00000
54.0,87.0,15.0,869,03,01,  Hawla Kandi,180,194,86,84,94,110,48.1,50.6,46.1,00000
54.0,87.0,15.0,869,04,01,  Sikdar Kandi,57,74,25,35,32,39,43.5,41.7,45.1,00000
54.0,87.0,15.0,869,05,01,  Chaddaghar,78,203,33,92,45,111,27.8,26.4,28.8,00000
54.0,87.0,15.0,869,06,01,  Dakshin Kandi,177,154,87,72,90,82,53.5,54.7,52.3,00000
54.0,87.0,15.0,869,07,01,  Bepari Kandi,101,100,46,51,55,49,50.2,47.4,52.9,00000
54.0,87.0,15.0,869,08,01,  Munshi Kandi,72,75,34,38,38,37,49.0,47.2,50.7,00000
54.0,87.0,15.0,869,09,01,  Rames Fakir Kandi,56,155,29,70,27,85,26.5,29.3,24.1,00000
54.0,87.0,15.0,869,10,01,  Wahed Hazi Kandi,41,65,23,23,18,42,38.7,50.0,30.0,00000
54.0,87.0,15.0,869,11,01,  Momen Khalasi Kandi,33,104,15,36,18,68,24.1,29.4,20.9,00000
54.0,87.0,15.0,869,12,01,  Khalasi Kandi,49,63,22,29,27,34,43.8,43.1,44.3,00000
54.0,87.0,15.0,869,13,01,  Naptar Char,235,591,99,276,136,315,28.5,26.4,30.2,00000
54.0,87.0,15.0,869,14,01,  Fakir Para,56,115,25,61,31,54,32.7,29.1,36.5,00000
54.0,87.0,15.0,869,15,01,  Joynal Munsi Kandi,6,9,3,6,3,3,40.0,33.3,50.0,00000
54.0,87.0,18.0,161,01,03,  Jadur Char,2035,2122,1028,979,1007,1143,49.0,51.2,46.8,00000
54.0,87.0,18.0,161,02,03,  Vennatala,443,933,199,419,244,514,32.2,32.2,32.2,00000
54.0,87.0,18.0,161,03,03,  Purartek,137,297,61,145,76,152,31.6,29.6,33.3,00000
54.0,87.0,18.0,412,01,01,  Sardar Kandi,47,237,24,121,23,116,16.5,16.6,16.5,00000
54.0,87.0,18.0,412,02,01,  Bepari Kandi,97,282,50,143,47,139,25.6,25.9,25.3,00000
54.0,87.0,18.0,412,03,01,  Meser Matbar Kandi,272,599,136,281,136,318,31.2,32.6,30.0,00000
54.0,87.0,18.0,412,04,01,  Shotar Par,337,512,147,230,190,282,39.7,39.0,40.3,00000
54.0,87.0,18.0,430,01,01,  Jaduar Char,370,554,172,256,198,298,40.0,40.2,39.9,00000
54.0,87.0,18.0,430,02,01,  Senerbat,357,681,179,311,178,370,34.4,36.5,32.5,00000
54.0,87.0,21.0,044,01,01,  Khankandi,131,116,63,49,68,67,53.0,56.3,50.4,00000
54.0,87.0,21.0,044,02,01,  Palkandi,136,249,71,121,65,128,35.3,37.0,33.7,00000
54.0,87.0,21.0,044,03,01,  Karigarkandi,337,394,174,171,163,223,46.1,50.4,42.2,00000
54.0,87.0,21.0,044,04,01,  Shaharkandi,260,99,142,42,118,57,72.4,77.2,67.4,00000
54.0,87.0,21.0,044,05,01,  Patkandi,102,99,51,50,51,49,50.7,50.5,51.0,00000
54.0,87.0,21.0,044,06,01,  Bolaisikder Kandi,195,179,113,86,82,93,52.1,56.8,46.9,00000
54.0,87.0,21.0,457,01,01,  Menakandi,255,274,109,127,146,147,48.2,46.2,49.8,00000
54.0,87.0,21.0,457,02,01,  Hamid Matbarkandi,293,390,139,160,154,230,42.9,46.5,40.1,00000
54.0,87.0,21.0,457,03,01,  Baniakandi,106,179,52,79,54,100,37.2,39.7,35.1,00000
54.0,87.0,21.0,457,04,01,  Khetis Sardarkandi,206,185,107,81,99,104,52.7,56.9,48.8,00000
54.0,87.0,21.0,457,05,01,  Abdul Haque Matbar Kandi,223,181,104,101,119,80,55.2,50.7,59.8,00000
54.0,87.0,21.0,457,06,01,  Char Para Rahman Doctor Kandi,183,295,81,147,102,148,38.3,35.5,40.8,00000
54.0,87.0,21.0,457,07,01,  Taher Matbar Kandi,170,202,87,84,83,118,45.7,50.9,41.3,00000
54.0,87.0,21.0,457,08,01,  Nadu Bepari Kandi,332,482,172,238,160,244,40.8,42.0,39.6,00000
54.0,87.0,21.0,457,09,01,  Mollar Kandi,122,299,54,131,68,168,29.0,29.2,28.8,00000
54.0,87.0,21.0,457,10,01,  Sardar Kandi,43,100,16,42,27,58,30.1,27.6,31.8,00000
54.0,87.0,21.0,457,11,01,  Talukdar Kandi,92,178,47,85,45,93,34.1,35.6,32.6,00000
54.0,87.0,21.0,457,12,01,  Rare Kandi,154,237,93,111,61,126,39.4,45.6,32.6,00000
54.0,87.0,21.0,457,13,01,  Daspara,184,161,85,86,99,75,53.3,49.7,56.9,00000
54.0,87.0,21.0,457,14,01,  Idris Khalish Kandi,40,139,17,69,23,70,22.3,19.8,24.7,00000
54.0,87.0,21.0,457,15,01,  Nuru Master Kandi,200,218,103,96,97,122,47.8,51.8,44.3,00000
54.0,87.0,21.0,457,16,01,  Babul Matbar Kandi,159,236,82,109,77,127,40.3,42.9,37.7,00000
54.0,87.0,26.0,188,01,01,  Purbba Bhandarikandi,82,249,44,113,38,136,24.8,28.0,21.8,00000
54.0,87.0,26.0,188,02,01,  Yasin Sardarkandi,96,192,47,85,49,107,33.3,35.6,31.4,00000
54.0,87.0,26.0,188,03,01,  Daranikandi,117,220,55,103,62,117,34.7,34.8,34.6,00000
54.0,87.0,26.0,188,04,01,  Dalikandi,93,216,39,103,54,113,30.1,27.5,32.3,00000
54.0,87.0,26.0,188,05,01,  Haji Majid Khalasi Kandi,84,284,37,147,47,137,22.8,20.1,25.5,00000
54.0,87.0,26.0,188,06,01,  Hawladarkandi,68,231,35,110,33,121,22.7,24.1,21.4,00000
54.0,87.0,26.0,188,07,01,  Baparikandi,383,228,178,97,205,131,62.7,64.7,61.0,00000
54.0,87.0,26.0,188,08,01,  Goura Kandi,148,223,67,101,81,122,39.9,39.9,39.9,00000
54.0,87.0,26.0,188,09,01,  Tengramari,699,645,325,272,374,373,52.0,54.4,50.1,00000
54.0,87.0,26.0,224,01,01,  Bishawdhanikandi,370,532,209,233,161,299,41.0,47.3,35.0,00000
54.0,87.0,26.0,224,02,01,  Horo Kumar Roykandi,158,172,79,71,79,101,47.9,52.7,43.9,00000
54.0,87.0,26.0,224,03,01,  Balakandi,140,165,63,78,77,87,45.9,44.7,47.0,00000
54.0,87.0,26.0,224,04,01,  Altaj Matbarkandi,124,157,46,73,78,84,44.1,38.7,48.1,00000
54.0,87.0,26.0,224,05,01,  Chokder Kandi,42,176,21,78,21,98,19.3,21.2,17.6,00000
54.0,87.0,26.0,224,06,01,  Moulvikandi,139,67,62,26,77,41,67.5,70.5,65.3,00000
54.0,87.0,26.0,224,07,01,  Amjad Hawlader Kandi,202,308,91,148,111,160,39.6,38.1,41.0,00000
54.0,87.0,26.0,224,08,01,  Hawladarkandi,352,316,174,139,178,177,52.7,55.6,50.1,00000
54.0,87.0,26.0,224,09,01,  Sardarkandi,187,291,83,123,104,168,39.1,40.3,38.2,00000
54.0,87.0,26.0,224,10,01,  Gafur Munshikandi,70,179,31,84,39,95,28.1,27.0,29.1,00000
54.0,87.0,26.0,224,11,01,  Sarif Kandi,124,92,63,41,61,51,57.4,60.6,54.5,00000
54.0,87.0,31.0,263,01,01,  Alauddin Sarkar Kandi,23,312,7,166,16,146,6.9,4.0,9.9,00000
54.0,87.0,31.0,263,02,01,  Hazisabar Minakandi,241,339,123,166,118,173,41.6,42.6,40.5,00000
54.0,87.0,31.0,263,03,01,  Mollakandi,55,80,31,40,24,40,40.7,43.7,37.5,00000
54.0,87.0,31.0,263,04,01,  Mazid Shake Kandi,33,113,16,58,17,55,22.6,21.6,23.6,00000
54.0,87.0,31.0,263,05,01,  Fakir Kandi,55,138,31,61,24,77,28.5,33.7,23.8,00000
54.0,87.0,31.0,263,06,01,  A Samad Sarker Kandi,48,214,27,119,21,95,18.3,18.5,18.1,00000
54.0,87.0,31.0,263,07,01,  Bazlur Khan Kandi,39,37,25,20,14,17,51.3,55.6,45.2,00000
54.0,87.0,31.0,263,08,01,  Nazir Mollah Kandi,99,86,51,41,48,45,53.5,55.4,51.6,00000
54.0,87.0,31.0,263,09,01,  Dafadar,131,132,68,68,63,64,49.8,50.0,49.6,00000
54.0,87.0,31.0,263,10,01,  Muktar Khar Kandi,50,49,28,25,22,24,50.5,52.8,47.8,00000
54.0,87.0,31.0,263,11,01,  Sirajul Islam Chowdhury Kandi,41,145,22,72,19,73,22.0,23.4,20.7,00000
54.0,87.0,31.0,263,12,01,  Aziz Talukdar Kandi,45,91,20,51,25,40,33.1,28.2,38.5,00000
54.0,87.0,31.0,263,13,01,  Jalal Uddin Sarker Kandi-1,102,259,56,113,46,146,28.3,33.1,24.0,00000
54.0,87.0,31.0,263,14,01,  Nasaruddin Sarkar Kandi,83,169,42,88,41,81,32.9,32.3,33.6,00000
54.0,87.0,31.0,263,15,01,  Insan Uddin Bepari Kandi,32,93,16,43,16,50,25.6,27.1,24.2,00000
54.0,87.0,31.0,263,16,01,  Rustom Bepari Kandi,82,212,43,102,39,110,27.9,29.7,26.2,00000
54.0,87.0,31.0,263,17,01,  Samad Ali Chowdhury Kandi,75,87,40,37,35,50,46.3,51.9,41.2,00000
54.0,87.0,31.0,263,18,01,  Joynal Sarker Kandi,146,173,77,94,69,79,45.8,45.0,46.6,00000
54.0,87.0,31.0,263,19,01,  Mazid Sarker Kandi,38,78,19,37,19,41,32.8,33.9,31.7,00000
54.0,87.0,31.0,263,20,01,  Monor Uddin Bepari Kandi,36,44,16,19,20,25,45.0,45.7,44.4,00000
54.0,87.0,31.0,263,21,01,  Mazid Bepari Kandi,99,213,57,105,42,108,31.7,35.2,28.0,00000
54.0,87.0,31.0,263,22,01,  Rahim Uddin Bepari Kandi,88,275,49,136,39,139,24.2,26.5,21.9,00000
54.0,87.0,31.0,263,23,01,  Adel Howalader Kandi,29,99,15,51,14,48,22.7,22.7,22.6,00000
54.0,87.0,31.0,263,24,01,  Kuti Hawlader Kandi,64,126,30,66,34,60,33.7,31.3,36.2,00000
54.0,87.0,31.0,263,25,01,  Munshi Madan Kharkandi,111,163,56,81,55,82,40.5,40.9,40.1,00000
54.0,87.0,31.0,263,26,01,  Kanai Sarkerkandi,63,136,31,63,32,73,31.7,33.0,30.5,00000
54.0,87.0,31.0,263,27,01,  Taher Hawlader Kandi,32,96,20,42,12,54,25.0,32.3,18.2,00000
54.0,87.0,31.0,263,28,01,  Mannan Bepari Kandi,38,152,18,65,20,87,20.0,21.7,18.7,00000
54.0,87.0,31.0,263,29,01,  Golap Khar Kandi,67,125,37,57,30,68,34.9,39.4,30.6,00000
54.0,87.0,31.0,263,30,01,  Meher Gasi Kandi,68,144,36,76,32,68,32.1,32.1,32.0,00000
54.0,87.0,31.0,263,31,01,  Safi Sarker Kandi,50,129,23,71,27,58,27.9,24.5,31.8,00000
54.0,87.0,31.0,263,32,01,  Alim Uddin Hawlader Kandi,75,208,36,103,39,105,26.5,25.9,27.1,00000
54.0,87.0,31.0,263,33,01,  Fazlu Sarkar Kandi,109,723,52,361,57,362,13.1,12.6,13.6,00000
54.0,87.0,31.0,263,34,01,  Kaoys Dhuali Kandi,38,85,26,40,12,45,30.9,39.4,21.1,00000
54.0,87.0,31.0,263,35,01,  Komor Uddin Bepari Khandi,117,309,59,155,58,154,27.5,27.6,27.4,00000
54.0,87.0,31.0,263,36,01,  Isak Sikder Kandi,35,139,17,73,18,66,20.1,18.9,21.4,00000
54.0,87.0,31.0,263,37,01,  Azid Sarker Kandi,181,7,98,4,83,3,96.3,96.1,96.5,00000
54.0,87.0,31.0,263,38,01,  Hazi Amjad Ali Bepari Kandi,64,71,32,39,32,32,47.4,45.1,50.0,00000
54.0,87.0,31.0,263,39,01,  Dalil Uddin Sarker Kandi,154,55,89,20,65,35,73.7,81.7,65.0,00000
54.0,87.0,31.0,263,40,01,  Jalal Uddin Sarker Kandi-2,23,96,14,43,9,53,19.3,24.6,14.5,00000
54.0,87.0,31.0,263,41,01,  Ahmed Matbar Kandi,60,150,29,68,31,82,28.6,29.9,27.4,00000
54.0,87.0,31.0,263,42,01,  Abul Hasem Shake Kandi,18,63,9,37,9,26,22.2,19.6,25.7,00000
54.0,87.0,31.0,263,43,01,  Jamir Matbar Kandi,55,89,30,42,25,47,38.2,41.7,34.7,00000
54.0,87.0,31.0,263,44,01,  Chowdhury A Samad Kandi,91,270,44,140,47,130,25.2,23.9,26.6,00000
54.0,87.0,31.0,263,45,01,  Baser Halader Kandi,89,101,40,58,49,43,46.8,40.8,53.3,00000
54.0,87.0,31.0,263,46,01,  Nurul Islam Sarker Kandi,145,251,85,131,60,120,36.6,39.4,33.3,00000
54.0,87.0,31.0,752,01,01,  Mollarkandi,37,77,17,37,20,40,32.5,31.5,33.3,00000
54.0,87.0,31.0,752,02,01,  Ukilkandi,57,199,22,94,35,105,22.3,19.0,25.0,00000
54.0,87.0,31.0,752,03,01,  Farajikandi,42,81,18,38,24,43,34.1,32.1,35.8,00000
54.0,87.0,31.0,752,04,01,  Maijuddin Hajikandi,247,156,149,62,98,94,61.3,70.6,51.0,00000
54.0,87.0,31.0,752,05,01,  Dalikandi,146,166,75,72,71,94,46.8,51.0,43.0,00000
54.0,87.0,31.0,752,06,01,  Yasin Hawladar Kandi,32,64,18,32,14,32,33.3,36.0,30.4,00000
54.0,87.0,31.0,752,07,01,  Amir Bepari Kandi,3,33,0,15,3,18,8.3,0.0,14.3,00000
54.0,87.0,31.0,752,08,01,  Lal Miah Bepari Kandi,22,78,11,37,11,41,22.0,22.9,21.2,00000
54.0,87.0,31.0,752,09,01,  Sadullah Bepari Kandi,181,182,99,83,82,99,49.9,54.4,45.3,00000
54.0,87.0,31.0,752,10,01,  Karim Uddin Matbar Kandi,29,45,10,24,19,21,39.2,29.4,47.5,00000
54.0,87.0,31.0,752,11,01,  Katibdi Bepari Kandi,21,86,11,43,10,43,19.6,20.4,18.9,00000
54.0,87.0,31.0,752,12,01,  Chand Bepari Kandi,32,69,16,34,16,35,31.7,32.0,31.4,00000
54.0,87.0,31.0,752,13,01,  Kanai Sarker Kandi,10,8,7,4,3,4,55.6,63.6,42.9,00000
54.0,87.0,31.0,752,14,01,  Basiruddin Matbar Kandi,36,53,17,26,19,27,40.4,39.5,41.3,00000
54.0,87.0,31.0,752,15,01,  Rahimuddin Morol Kandi,28,86,12,49,16,37,24.6,19.7,30.2,00000
54.0,87.0,31.0,752,16,01,  Mvl.Abdul Samad Khan Kandi,54,157,30,76,24,81,25.6,28.3,22.9,00000
54.0,87.0,31.0,752,17,01,  Delu Bepari Kandi,21,37,6,20,15,17,36.2,23.1,46.9,00000
54.0,87.0,31.0,752,18,01,  Baser Bepari Kandi,97,201,52,100,45,101,32.6,34.2,30.8,00000
54.0,87.0,31.0,752,19,01,  Majid Fakir Kandi,16,38,5,17,11,21,29.6,22.7,34.4,00000
54.0,87.0,31.0,752,20,01,  Safi Khalishi Kandi,40,43,23,21,17,22,48.2,52.3,43.6,00000
54.0,87.0,31.0,752,21,01,  Manuddin Shaker Kandi,22,79,11,38,11,41,21.8,22.4,21.2,00000
54.0,87.0,36.0,017,01,01,  Haji Ramimuddin Matabbark,264,225,133,109,131,116,54.0,55.0,53.0,00000
54.0,87.0,36.0,017,02,01,  Haji Paban Matabbarkandi,147,187,72,86,75,101,44.0,45.6,42.6,00000
54.0,87.0,36.0,017,03,01,  Haji Falu Matabbarkandi,197,244,97,116,100,128,44.7,45.5,43.9,00000
54.0,87.0,36.0,017,04,01,  Joynal Matbarkandi,199,235,112,141,87,94,45.9,44.3,48.1,00000
54.0,87.0,36.0,017,05,01,  Majid Beparikandi,254,167,117,77,137,90,60.3,60.3,60.4,00000
54.0,87.0,36.0,017,06,01,  Momtajuddin Kharkandi,159,115,78,48,81,67,58.0,61.9,54.7,00000
54.0,87.0,36.0,080,01,01,  Abdul Hamed Sikdarkandi,164,198,82,89,82,109,45.3,48.0,42.9,00000
54.0,87.0,36.0,080,03,01,  Haji Sabder Hangkandi,149,161,70,70,79,91,48.1,50.0,46.5,00000
54.0,87.0,36.0,080,04,01,  Dudan Hangkandi,152,205,85,95,67,110,42.6,47.2,37.9,00000
54.0,87.0,36.0,080,05,01,  Khalaskandi,197,280,105,150,92,130,41.3,41.2,41.4,00000
54.0,87.0,36.0,215,01,01,  Badshahkandi,223,442,104,219,119,223,33.5,32.2,34.8,00000
54.0,87.0,36.0,215,02,01,  Maulvikandi,218,297,114,154,104,143,42.3,42.5,42.1,00000
54.0,87.0,36.0,215,03,01,  Khojkandi,26,31,11,17,15,14,45.6,39.3,51.7,00000
54.0,87.0,36.0,215,04,01,  Haji Maizuddin Mangkandi,217,547,92,267,125,280,28.4,25.6,30.9,00000
54.0,87.0,36.0,215,05,01,  Namasudrakandi,88,197,33,92,55,105,30.9,26.4,34.4,00000
54.0,87.0,36.0,215,06,01,  Haji Kayemuddinkandi,495,498,248,242,247,256,49.8,50.6,49.1,00000
54.0,87.0,36.0,215,07,01,  Basiruddin Matabbarkandi,111,279,65,141,46,138,28.5,31.6,25.0,00000
54.0,87.0,36.0,215,08,01,  Dulat Hajirkandi,99,283,52,154,47,129,25.9,25.2,26.7,00000
54.0,87.0,36.0,215,09,01,  Khalifakandi,40,114,24,53,16,61,26.0,31.2,20.8,00000
54.0,87.0,36.0,215,10,01,  Jaher Muhurirkandi,128,131,66,56,62,75,49.4,54.1,45.3,00000
54.0,87.0,36.0,215,11,01,  Haji Mafizuddin Akandkandi,110,348,53,168,57,180,24.0,24.0,24.1,00000
54.0,87.0,36.0,215,12,01,  Talukdarkandi,246,340,119,155,127,185,42.0,43.4,40.7,00000
54.0,87.0,36.0,215,13,01,  Budai Munshirkandi,114,145,50,70,64,75,44.0,41.7,46.0,00000
54.0,87.0,36.0,215,14,01,  Haji Taher Khar Kandi,86,21,37,13,49,8,80.4,74.0,86.0,00000
54.0,87.0,36.0,215,15,01,  Karam Ali Hajikandi,193,46,91,18,102,28,80.8,83.5,78.5,00000
54.0,87.0,36.0,215,16,01,  Adel Hajikandi,180,200,89,89,91,111,47.4,50.0,45.0,00000
54.0,87.0,36.0,215,17,01,  8 No.Char Bachamara,360,662,176,338,184,324,35.2,34.2,36.2,00000
54.0,87.0,36.0,215,18,01,  Haji Arfan Kazikandi,38,182,17,101,21,81,17.3,14.4,20.6,00000
54.0,87.0,36.0,215,19,01,  Jaher Munsir Kandi,186,184,95,84,91,100,50.3,53.1,47.6,00000
54.0,87.0,36.0,242,01,01,  Chowdhurykandi,446,486,232,218,214,268,47.9,51.6,44.4,00000
54.0,87.0,36.0,242,02,01,  Mridhakandi,92,200,42,96,50,104,31.5,30.4,32.5,00000
54.0,87.0,36.0,242,03,01,  Majhikandi,86,292,34,148,52,144,22.8,18.7,26.5,00000
54.0,87.0,36.0,385,01,01,  Duati Khalifakandi,227,329,121,145,106,184,40.8,45.5,36.6,00000
54.0,87.0,36.0,385,02,01,  Beparikandi,252,129,125,56,127,73,66.1,69.1,63.5,00000
54.0,87.0,36.0,385,03,01,  Aurjo Datta Para,378,441,207,211,171,230,46.2,49.5,42.6,00000
54.0,87.0,36.0,385,04,01,  Kharakandi,383,606,186,317,197,289,38.7,37.0,40.5,00000
54.0,87.0,36.0,385,05,01,  Mridhakandi,153,66,73,25,80,41,69.9,74.5,66.1,00000
54.0,87.0,36.0,448,01,01,  Haji Jaran Kharkandi,204,175,99,98,105,77,53.8,50.3,57.7,00000
54.0,87.0,36.0,448,02,01,  Namasudrakandi,176,273,86,152,90,121,39.2,36.1,42.7,00000
54.0,87.0,36.0,448,03,01,  Kachir Matabbarkandi,41,17,21,12,20,5,70.7,63.6,80.0,00000
54.0,87.0,36.0,582,01,01,  Pukurpar,150,170,80,76,70,94,46.9,51.3,42.7,00000
54.0,87.0,36.0,582,02,01,  Magra,252,239,115,105,137,134,51.3,52.3,50.6,00000
54.0,87.0,36.0,887,01,01,  Haji Kajim Madabbarkandi,131,77,55,36,76,41,63.0,60.4,65.0,00000
54.0,87.0,36.0,887,02,01,  Zaminderkandi,214,116,98,44,116,72,64.8,69.0,61.7,00000
54.0,87.0,36.0,977,01,01,  Tajpur,304,549,138,265,166,284,35.6,34.2,36.9,00000
54.0,87.0,36.0,977,02,01,  Goagachhia,298,349,147,161,151,188,46.1,47.7,44.5,00000
54.0,87.0,36.0,977,03,01,  Maulvikandi,21,31,9,12,12,19,40.4,42.9,38.7,00000
54.0,87.0,36.0,977,04,01,  8 No.Char Ghamil,114,109,60,51,54,58,51.1,54.1,48.2,00000
54.0,87.0,42.0,250,01,03,  Char Guatala,120,220,59,121,61,99,35.3,32.8,38.1,00000
54.0,87.0,42.0,250,02,03,  Kajikandi,205,260,120,143,85,117,44.1,45.6,42.1,00000
54.0,87.0,42.0,690,01,01,  Neamatkandi,342,293,190,137,152,156,53.9,58.1,49.4,00000
54.0,87.0,42.0,690,02,01,  Hawladarkandi,106,158,55,69,51,89,40.2,44.4,36.4,00000
54.0,87.0,42.0,690,03,01,  Moral Kandi,106,263,41,117,65,146,28.7,25.9,30.8,00000
54.0,87.0,47.0,618,01,01,  Manik Masterkandi,178,276,82,116,96,160,39.2,41.4,37.5,00000
54.0,87.0,47.0,618,02,01,  Masir Mollarkandi,103,279,39,135,64,144,27.0,22.4,30.8,00000
54.0,87.0,47.0,618,03,01,  Haji A.Wahab Beparikandi,208,401,106,192,102,209,34.2,35.6,32.8,00000
54.0,87.0,47.0,618,04,01,  Safi Hawladarkandi,191,283,112,145,79,138,40.3,43.6,36.4,00000
54.0,87.0,47.0,618,05,01,  Ukiluddin Munshirkandi,268,571,132,290,136,281,31.9,31.3,32.6,00000
54.0,87.0,47.0,618,06,01,  Haji Sonamiah Matbarkandi,220,227,112,110,108,117,49.2,50.5,48.0,00000
54.0,87.0,47.0,618,07,01,  Fakirkandi,59,148,33,69,26,79,28.5,32.4,24.8,00000
54.0,87.0,47.0,618,08,01,  Ismail Beparikandi,200,214,109,94,91,120,48.3,53.7,43.1,00000
54.0,87.0,47.0,618,09,01,  Shekim Ali Matbarkandi,155,194,69,88,86,106,44.4,43.9,44.8,00000
54.0,87.0,47.0,618,10,01,  Shaijuddin Beparikandi,180,303,82,148,98,155,37.3,35.7,38.7,00000
54.0,87.0,47.0,618,11,01,  Gharamikandi,70,147,37,63,33,84,32.3,37.0,28.2,00000
54.0,87.0,47.0,654,01,01,  Taher Akondkandi,248,354,110,173,138,181,41.2,38.9,43.3,00000
54.0,87.0,47.0,654,02,01,  Mazid Fakirkandi,46,55,20,27,26,28,45.5,42.6,48.1,00000
54.0,87.0,47.0,654,03,01,  Kachi Matabbarkandi,147,232,71,115,76,117,38.8,38.2,39.4,00000
54.0,87.0,47.0,654,04,01,  Kadir Munshirkandi,578,630,291,310,287,320,47.8,48.4,47.3,00000
54.0,87.0,47.0,654,05,01,  Gachhi Charkandi,148,143,78,75,70,68,50.9,51.0,50.7,00000
54.0,87.0,47.0,654,06,01,  Paban Moralkandi,206,212,109,104,97,108,49.3,51.2,47.3,00000
54.0,87.0,47.0,654,07,01,  Gachhikandi,274,100,140,29,134,71,73.3,82.8,65.4,00000
54.0,87.0,47.0,654,08,01,  Chitu Moralkandi,79,198,38,103,41,95,28.5,27.0,30.1,00000
54.0,87.0,47.0,654,09,01,  Kadir Munshi Charkandi,80,214,47,99,33,115,27.2,32.2,22.3,00000
54.0,87.0,47.0,654,10,01,  Yasin Haji Charkandi,143,259,79,120,64,139,35.6,39.7,31.5,00000
54.0,87.0,47.0,654,11,01,  Taher Fakirkandi,74,124,38,54,36,70,37.4,41.3,34.0,00000
54.0,87.0,47.0,654,12,01,  Hujjatali Beparikandi,99,222,46,98,53,124,30.8,31.9,29.9,00000
54.0,87.0,47.0,654,13,01,  Kalu Beparikandi,134,248,54,117,80,131,35.1,31.6,37.9,00000
54.0,87.0,47.0,654,14,01,  Haji Sonamiahkandi,90,175,40,91,50,84,34.0,30.5,37.3,00000
54.0,87.0,47.0,654,15,01,  Majid Beparikandi,68,175,35,81,33,94,28.0,30.2,26.0,00000
54.0,87.0,47.0,654,16,01,  Yusub Beparikandi,108,174,44,89,64,85,38.3,33.1,43.0,00000
54.0,87.0,47.0,654,17,01,  Chowkderkandi,95,139,45,59,50,80,40.6,43.3,38.5,00000
54.0,87.0,47.0,663,01,01,  Gharamikandi,117,112,76,50,41,62,51.1,60.3,39.8,00000
54.0,87.0,47.0,663,03,01,  Haji Yusuf Dalirkandi,98,114,48,59,50,55,46.2,44.9,47.6,00000
54.0,87.0,47.0,663,04,01,  Digreer Char,177,101,96,37,81,64,63.7,72.2,55.9,00000
54.0,87.0,47.0,663,05,01,  Wahed Ali Matbarkandi,111,68,60,28,51,40,62.0,68.2,56.0,00000
54.0,87.0,47.0,663,06,01,  Mridhakandi,146,353,66,176,80,177,29.3,27.3,31.1,00000
54.0,87.0,52.0,026,01,01,  Modon Fakir Khan,64,58,43,26,21,32,52.5,62.3,39.6,00000
54.0,87.0,52.0,026,02,01,  Mv.A.Karim Hawlader Kandi,179,160,83,65,96,95,52.8,56.1,50.3,00000
54.0,87.0,52.0,026,03,01,  Akber Sikder Kandi,154,134,66,56,88,78,53.5,54.1,53.0,00000
54.0,87.0,52.0,026,04,01,  Abul Hossain Hawladar,170,245,98,128,72,117,41.0,43.4,38.1,00000
54.0,87.0,52.0,026,05,01,  Hazi Kachai Khar Kandi,262,499,130,235,132,264,34.4,35.6,33.3,00000
54.0,87.0,52.0,026,06,01,  Saiuddin Hajirgram,142,152,68,64,74,88,48.3,51.5,45.7,00000
54.0,87.0,52.0,026,07,01,  Amiruddin Nazir Kandi,174,170,111,105,63,65,50.6,51.4,49.2,00000
54.0,87.0,52.0,233,01,01,  Char Chandra Haji J.Munshigram,484,454,223,204,261,250,51.6,52.2,51.1,00000
54.0,87.0,52.0,233,02,01,  Jabbar Hawlazar Kandi,109,219,49,104,60,115,33.2,32.0,34.3,00000
54.0,87.0,52.0,233,03,01,  Naim Uddin Munshi Kandi,173,193,91,80,82,113,47.3,53.2,42.1,00000
54.0,87.0,52.0,233,04,01,  Adomali Fakir Kandi,189,475,90,224,99,251,28.5,28.7,28.3,00000
54.0,87.0,52.0,233,05,01,  Jamir Munshir Char Kandi,160,335,77,160,83,175,32.3,32.5,32.2,00000
54.0,87.0,52.0,233,06,01,  Jamir Hawladar Kandi,42,64,22,32,20,32,39.6,40.7,38.5,00000
54.0,87.0,52.0,233,07,01,  Bsai Chokder Kandi,158,231,77,108,81,123,40.6,41.6,39.7,00000
54.0,87.0,52.0,403,01,01,  Yasin Mollarkandi,403,547,200,267,203,280,42.4,42.8,42.0,00000
54.0,87.0,52.0,403,02,01,  Madan Khargram,119,216,44,114,75,102,35.5,27.8,42.4,00000
54.0,87.0,52.0,466,01,01,  Haku Dhali Kandi,81,241,52,141,29,100,25.2,26.9,22.5,00000
54.0,87.0,52.0,466,02,01,  Fakir Kandi,27,130,12,72,15,58,17.2,14.3,20.5,00000
54.0,87.0,52.0,519,01,01,  Babu Mollarghar,106,114,53,51,53,63,48.2,51.0,45.7,00000
54.0,87.0,52.0,519,02,01,  Haji Omar Ali Bapari Kandi,183,223,89,102,94,121,45.1,46.6,43.7,00000
54.0,87.0,52.0,519,03,01,  Haji Nedu Chowkider Kandi,107,166,48,76,59,90,39.2,38.7,39.6,00000
54.0,87.0,52.0,519,04,01,  Khalek Bepari Kandi,136,293,68,141,68,152,31.7,32.5,30.9,00000
54.0,87.0,52.0,519,05,01,  Abul Hasem Fakir Kandi,111,134,54,76,57,58,45.3,41.5,49.6,00000
54.0,87.0,52.0,519,06,01,  Dewan Kandi,97,159,53,77,44,82,37.9,40.8,34.9,00000
54.0,87.0,52.0,519,07,01,  Hazi Modan Moral Kandi,105,130,50,57,55,73,44.7,46.7,43.0,00000
54.0,87.0,52.0,519,08,01,  Monor Uddin Hajir Kandi,111,116,54,52,57,64,48.9,50.9,47.1,00000
54.0,87.0,52.0,519,09,01,  Latif Beper Kandi,141,381,81,187,60,194,27.0,30.2,23.6,00000
54.0,87.0,52.0,519,10,01,  Haji A. Jabbar Hawlader Kandi,169,276,90,124,79,152,38.0,42.1,34.2,00000
54.0,87.0,52.0,519,11,01,  Golap Sikder Kandi,63,330,25,172,38,158,16.0,12.7,19.4,00000
54.0,87.0,52.0,519,12,01,  Kuddus Bapari Kandi,142,360,62,188,80,172,28.3,24.8,31.7,00000
54.0,87.0,52.0,519,13,01,  Atahar Bepari Kandi,98,434,54,221,44,213,18.4,19.6,17.1,00000
54.0,87.0,52.0,519,14,01,  Hazi Sabarali Bapari Kandi,171,569,65,283,106,286,23.1,18.7,27.0,00000
54.0,87.0,52.0,519,15,01,  Babu Mollik Kandi,36,265,12,135,24,130,12.0,8.2,15.6,00000
54.0,87.0,52.0,519,16,01,  Mojibor Fakir Kandi,36,55,17,29,19,26,39.6,37.0,42.2,00000
54.0,87.0,52.0,523,01,01,  Munser Khar Kandi,103,316,36,171,67,145,24.6,17.4,31.6,00000
54.0,87.0,52.0,523,02,01,  Motiur Rahman Fakir Kandi,15,98,7,49,8,49,13.3,12.5,14.0,00000
54.0,87.0,52.0,591,01,01,  Amin Uddin Bepari Kandi,47,215,19,99,28,116,17.9,16.1,19.4,00000
54.0,87.0,52.0,591,02,01,  Ainuddin Hawlader Kandi,26,223,12,104,14,119,10.4,10.3,10.5,00000
54.0,87.0,52.0,591,03,01,  Haji Munser Khar Kandi,75,486,34,241,41,245,13.4,12.4,14.3,00000
54.0,87.0,52.0,591,04,01,  Aziz Fakkir Kandi,77,748,34,388,43,360,9.3,8.1,10.7,00000
54.0,87.0,58.0,143,01,01,  Rahman Mollarkandi,146,134,76,72,70,62,52.1,51.4,53.0,00000
54.0,87.0,58.0,143,02,01,  Tajuddin Hazir Kandi,18,157,11,74,7,83,10.3,12.9,7.8,00000
54.0,87.0,58.0,143,03,01,  Hazi Monoruddin Bepari Kandi,64,76,33,39,31,37,45.7,45.8,45.6,00000
54.0,87.0,58.0,143,04,01,  Emanuddin Matbarkandi,25,89,9,46,16,43,21.9,16.4,27.1,00000
54.0,87.0,58.0,143,05,01,  Haji Kalu Munshikandi,115,333,63,171,52,162,25.7,26.9,24.3,00000
54.0,87.0,58.0,143,06,01,  Abed Ali Munsir Kandi,57,237,31,132,26,105,19.4,19.0,19.8,00000
54.0,87.0,58.0,143,07,01,  Subdar Ali Fakirkandi,47,103,20,62,27,41,31.3,24.4,39.7,00000
54.0,87.0,58.0,143,08,01,  Hakim Ali Hawlader Kandi,73,116,35,56,38,60,38.6,38.5,38.8,00000
54.0,87.0,58.0,143,09,01,  Mollikandi,63,126,33,61,30,65,33.3,35.1,31.6,00000
54.0,87.0,58.0,143,10,01,  Sahar Ali Matbar Kandi,59,81,24,40,35,41,42.1,37.5,46.1,00000
54.0,87.0,58.0,143,11,01,  Jaher Madbarkandi,38,30,20,16,18,14,55.9,55.6,56.3,00000
54.0,87.0,58.0,143,12,01,  Hossain Khalifakandi,17,34,7,17,10,17,33.3,29.2,37.0,00000
54.0,87.0,58.0,143,13,01,  Adel Munshikandi,163,241,91,114,72,127,40.3,44.4,36.2,00000
54.0,87.0,58.0,143,14,01,  Ainuddin Mollakandi,205,259,100,138,105,121,44.2,42.0,46.5,00000
54.0,87.0,58.0,143,15,01,  Sirajuddin Masterkandi,22,14,9,6,13,8,61.1,60.0,61.9,00000
54.0,87.0,58.0,143,16,01,  Majid Munsi Kandi,43,77,15,37,28,40,35.8,28.8,41.2,00000
54.0,87.0,58.0,143,17,01,  Charu  Matbarkandi,129,280,60,148,69,132,31.5,28.8,34.3,00000
54.0,87.0,58.0,143,18,01,  Babar Ali Madbar Kandi,87,287,40,135,47,152,23.3,22.9,23.6,00000
54.0,87.0,58.0,143,19,01,  Arshed Talukdarkandi,79,153,46,69,33,84,34.1,40.0,28.2,00000
54.0,87.0,58.0,143,20,01,  Jobed Ali Hazir Kandi,50,74,29,31,21,43,40.3,48.3,32.8,00000
54.0,87.0,58.0,143,21,01,  Sokol Uddin Moulovi Kandi,70,152,34,67,36,85,31.5,33.7,29.8,00000
54.0,87.0,58.0,573,01,01,  Jahar Fakirakandi,21,99,16,42,5,57,17.5,27.6,8.1,00000
54.0,87.0,58.0,573,02,01,  Karim Howladarkandi,110,111,63,59,47,52,49.8,51.6,47.5,00000
54.0,87.0,58.0,573,03,01,  Abdul Majid Fakirkandi,100,88,61,44,39,44,53.2,58.1,47.0,00000
54.0,87.0,58.0,573,04,01,  Abdur Rahman Sikdarkandi,92,91,51,42,41,49,50.3,54.8,45.6,00000
54.0,87.0,58.0,573,05,01,  Haji Kalu Baherakandi,160,125,92,59,68,66,56.1,60.9,50.7,00000
54.0,87.0,58.0,573,06,01,  Hadu Mollarkandi,104,229,56,116,48,113,31.2,32.6,29.8,00000
54.0,87.0,58.0,573,07,01,  Hadu Mollar Charkandi,58,125,30,65,28,60,31.7,31.6,31.8,00000
54.0,87.0,58.0,573,08,01,  Masalchekandi,20,131,10,59,10,72,13.2,14.5,12.2,00000
54.0,87.0,58.0,573,09,01,  Abdul Jabbar Sikdarkandi,237,707,114,365,123,342,25.1,23.8,26.5,00000
54.0,87.0,58.0,573,10,01,  Samsuddin Maulvirkandi,384,219,200,98,184,121,63.7,67.1,60.3,00000
54.0,87.0,58.0,573,11,01,  Haji Emanuddin Beparikandi,212,177,128,73,84,104,54.5,63.7,44.7,00000
54.0,87.0,58.0,573,12,01,  Gharamikandi,27,68,12,28,15,40,28.4,30.0,27.3,00000
54.0,87.0,58.0,573,13,01,  Sujauddin Matbarkandi,18,100,6,51,12,49,15.3,10.5,19.7,00000
54.0,87.0,58.0,573,14,01,  Fazil Mollarkandi,122,272,58,140,64,132,31.0,29.3,32.7,00000
54.0,87.0,58.0,573,15,01,  Kacharikandi,46,67,24,38,22,29,40.7,38.7,43.1,00000
54.0,87.0,58.0,573,16,01,  Fakirkandi,58,98,25,53,33,45,37.2,32.1,42.3,00000
54.0,87.0,58.0,573,17,01,  Lalu Bapari Kandi,81,204,45,101,36,103,28.4,30.8,25.9,00000
54.0,87.0,58.0,573,18,01,  Aijuddin Moral Kandi,68,204,37,112,31,92,25.0,24.8,25.2,00000
54.0,87.0,58.0,573,19,01,  Kazikandi,27,32,15,15,12,17,45.8,50.0,41.4,00000
54.0,87.0,58.0,573,20,01,  Akondkandi,50,292,23,140,27,152,14.6,14.1,15.1,00000
54.0,87.0,58.0,573,21,01,  Dhalikandi,68,118,37,51,31,67,36.6,42.0,31.6,00000
54.0,87.0,58.0,573,22,01,  Emanuddin Matbarkandi,169,149,98,69,71,80,53.1,58.7,47.0,00000
54.0,87.0,58.0,573,23,01,  Mazikandi,47,120,21,62,26,58,28.1,25.3,31.0,00000
54.0,87.0,58.0,573,24,01,  Sonu Khalifakandi,135,174,74,79,61,95,43.7,48.4,39.1,00000
54.0,87.0,58.0,573,25,01,  Abdur Rahman Beparikandi,88,104,38,53,50,51,45.8,41.8,49.5,00000
54.0,87.0,58.0,573,26,01,  Besai Beparikandi,89,91,36,44,53,47,49.4,45.0,53.0,00000
54.0,87.0,58.0,573,27,01,  Joyenuddin Beparikandi,79,164,42,76,37,88,32.5,35.6,29.6,00000
54.0,87.0,58.0,573,28,01,  Hossain Matbarkandi,58,266,33,136,25,130,17.9,19.5,16.1,00000
54.0,87.0,58.0,573,29,01,  Fazlu Karim Bepari Kandi,246,321,115,163,131,158,43.4,41.4,45.3,00000
54.0,87.0,58.0,573,30,01,  Situ Munsir Kandi,361,270,188,141,173,129,57.2,57.1,57.3,00000
54.0,87.0,58.0,573,31,01,  Punai Hazir Kandi,158,176,88,93,70,83,47.3,48.6,45.8,00000
54.0,87.0,58.0,573,32,01,  Haji Char Akali Khlifakamdi,74,84,29,46,45,38,46.8,38.7,54.2,00000
54.0,87.0,58.0,573,33,01,  Haji Ainuddin Matbarkandi,66,75,35,40,31,35,46.8,46.7,47.0,00000
54.0,87.0,58.0,573,34,01,  Abdul Karim Maulvikandi,56,104,34,47,22,57,35.0,42.0,27.8,00000
54.0,87.0,58.0,573,35,01,  Karim Hawlader Char Kandi,38,123,18,58,20,65,23.6,23.7,23.5,00000
54.0,87.0,58.0,573,36,01,  Mofizuddin Moralerkandi,65,102,28,47,37,55,38.9,37.3,40.2,00000
54.0,87.0,58.0,573,37,01,  Zamadder Kandi,26,28,17,23,9,5,48.1,42.5,64.3,00000
54.0,87.0,63.0,089,01,01,  Moralkandi,709,862,345,441,364,421,45.1,43.9,46.4,00000
54.0,87.0,63.0,089,02,01,  Haji Nadu Kharkandi,422,416,216,192,206,224,50.4,52.9,47.9,00000
54.0,87.0,63.0,089,03,01,  Sarajuddin Fakirkandi,146,230,70,111,76,119,38.8,38.7,39.0,00000
54.0,87.0,63.0,089,04,01,  Osamuddin Matbarkandi,393,357,180,170,213,187,52.4,51.4,53.3,00000
54.0,87.0,63.0,089,05,01,  Khalifakandi,333,671,147,351,186,320,33.2,29.5,36.8,00000
54.0,87.0,63.0,089,06,01,  Haji Munsur Ali Matbarkandi,129,233,71,121,58,112,35.6,37.0,34.1,00000
54.0,87.0,63.0,089,07,01,  Khallar Char,39,40,21,21,18,19,49.4,50.0,48.6,00000
54.0,87.0,63.0,349,01,01,  Sardarkandi,299,185,142,87,157,98,61.8,62.0,61.6,00000
54.0,87.0,63.0,349,02,01,  Basar Malu Para,522,256,267,120,255,136,67.1,69.0,65.2,00000
54.0,87.0,63.0,349,03,01,  Daiar Char,242,192,142,90,100,102,55.8,61.2,49.5,00000
54.0,87.0,63.0,367,01,01,  Sukkur Hawladarkandi,623,1201,297,617,326,584,34.2,32.5,35.8,00000
54.0,87.0,63.0,367,02,01,  Hazi Kandi,193,164,101,85,92,79,54.1,54.3,53.8,00000
54.0,87.0,63.0,367,03,01,  Talukder Kandi,144,81,71,38,73,43,64.0,65.1,62.9,00000
54.0,87.0,63.0,367,04,01,  Salu Beparirkandi,462,699,237,344,225,355,39.8,40.8,38.8,00000
54.0,87.0,63.0,367,05,01,  Namakandi,117,175,53,88,64,87,40.1,37.6,42.4,00000
54.0,87.0,63.0,367,06,01,  Natun Kandi,585,386,301,180,284,206,60.2,62.6,58.0,00000
54.0,87.0,63.0,367,07,01,  Kadir Moralerkandi,270,136,146,66,124,70,66.5,68.9,63.9,00000
54.0,87.0,63.0,546,01,01,  Kharakandi,225,572,100,296,125,276,28.2,25.3,31.2,00000
54.0,87.0,63.0,546,02,01,  Fakir Kandi,702,518,332,255,370,263,57.5,56.6,58.5,00000
54.0,87.0,63.0,546,03,01,  Hajikandi,123,242,58,125,65,117,33.7,31.7,35.7,00000
54.0,87.0,63.0,546,04,01,  Kala Hajirkandi,77,96,33,44,44,52,44.5,42.9,45.8,00000
54.0,87.0,63.0,627,01,01,  Mazad Madbar Kandi,57,163,22,90,35,73,25.9,19.6,32.4,00000
54.0,87.0,63.0,627,02,01,  Chowduri Kandi,89,511,36,256,53,255,14.8,12.3,17.2,00000
54.0,87.0,63.0,765,01,01,  Afsar Sikdarkandi,202,199,100,89,102,110,50.4,52.9,48.1,00000
54.0,87.0,63.0,765,02,01,  Charkandi,259,278,139,122,120,156,48.2,53.3,43.5,00000
54.0,87.0,63.0,765,03,01,  Rahimuddin Munshir Charkandi,161,134,88,58,73,76,54.6,60.3,49.0,00000
54.0,87.0,63.0,851,01,01,  Ainuddin Howladarkandi,200,153,108,64,92,89,56.7,62.8,50.8,00000
54.0,87.0,63.0,851,02,01,  Abbas Fakirkandi,107,249,54,122,53,127,30.1,30.7,29.4,00000
54.0,87.0,63.0,851,03,01,  Ainuddin Matbarerkandi,156,227,83,102,73,125,40.7,44.9,36.9,00000
54.0,87.0,63.0,851,04,01,  Manaruddin Munshirkandi,83,233,49,123,34,110,26.3,28.5,23.6,00000
54.0,87.0,63.0,851,05,01,  Sharifkandi,53,67,30,33,23,34,44.2,47.6,40.4,00000
54.0,87.0,63.0,851,06,01,  Nazu Matbarerkandi,96,255,38,121,58,134,27.4,23.9,30.2,00000
54.0,87.0,63.0,851,07,01,  Anaz Fakir Kandi,53,164,23,78,30,86,24.4,22.8,25.9,00000
54.0,87.0,63.0,860,01,01,  Nokti Kandi,268,618,136,306,132,312,30.2,30.8,29.7,00000
54.0,87.0,63.0,860,02,01,  Pachu Matbarkandi,281,100,144,38,137,62,73.8,79.1,68.8,00000
54.0,87.0,63.0,860,03,01,  Boyatikandi,61,218,23,120,38,98,21.9,16.1,27.9,00000
54.0,87.0,63.0,860,04,01,  Ojut Kharkandi,40,196,11,106,29,90,16.9,9.4,24.4,00000
54.0,87.0,68.0,123,01,01,  Dakshin Char Kamarkandi,680,1079,325,489,355,590,38.7,39.9,37.6,00000
54.0,87.0,68.0,123,02,01,  Uttar Kamarkandi,220,305,106,144,114,161,41.9,42.4,41.5,00000
54.0,87.0,68.0,123,03,01,  Paschim Kamarkandi,746,1397,331,617,415,780,34.8,34.9,34.7,00000
54.0,87.0,73.0,053,01,01,  Haji Nimuddinkandi,528,516,277,269,251,247,50.6,50.7,50.4,00000
54.0,87.0,73.0,053,02,01,  Alauddin Matabberkandi,200,218,91,107,109,111,47.8,46.0,49.5,00000
54.0,87.0,73.0,098,01,01,  Falu Dalikandi,41,298,17,142,24,156,12.1,10.7,13.3,00000
54.0,87.0,73.0,098,02,01,  Chan Beparikandi,466,498,226,214,240,284,48.3,51.4,45.8,00000
54.0,87.0,73.0,098,03,01,  Majikandi,351,584,177,278,174,306,37.5,38.9,36.3,00000
54.0,87.0,73.0,098,04,01,  Yakub Beparikandi,207,365,108,176,99,189,36.2,38.0,34.4,00000
54.0,87.0,73.0,098,05,01,  Ghani Matbarkandi,83,149,41,73,42,76,35.8,36.0,35.6,00000
54.0,87.0,73.0,116,01,01,  Pir Shabir Para,349,22,282,7,67,15,94.1,97.6,81.7,00000
54.0,87.0,73.0,116,02,01,  Khana Kandi,190,105,107,36,83,69,64.4,74.8,54.6,00000
54.0,87.0,73.0,116,03,01,  Muzaffar Hossain Sikdarkandi,223,276,106,126,117,150,44.7,45.7,43.8,00000
54.0,87.0,73.0,116,04,01,  Hawladarkandi,205,227,118,106,87,121,47.5,52.7,41.8,00000
54.0,87.0,73.0,116,05,01,  Ahsan Khalifarkandi,108,162,53,79,55,83,40.0,40.2,39.9,00000
54.0,87.0,73.0,134,01,01,  Ismail Sikdar Kandi,225,378,119,176,106,202,37.3,40.3,34.4,00000
54.0,87.0,73.0,134,02,01,  Mati Sikdar Kandi,220,551,114,260,106,291,28.5,30.5,26.7,00000
54.0,87.0,73.0,134,03,01,  Dalikandi,233,184,106,70,127,114,55.9,60.2,52.7,00000
54.0,87.0,73.0,134,04,01,  Afsar Hajirkandi,135,231,76,121,59,110,36.9,38.6,34.9,00000
54.0,87.0,73.0,179,01,01,  Alauddin Munshir Kandi,322,245,153,108,169,137,56.8,58.6,55.2,00000
54.0,87.0,73.0,179,02,01,  Nimuddinkandi,140,194,65,97,75,97,41.9,40.1,43.6,00000
54.0,87.0,73.0,179,03,01,  Abdul Karim Munsir Kandi,60,204,37,96,23,108,22.7,27.8,17.6,00000
54.0,87.0,73.0,179,04,01,  Purba Benchara,171,176,85,80,86,96,49.3,51.5,47.3,00000
54.0,87.0,73.0,179,05,01,  Faizuddin Hawladarkandi,117,153,65,62,52,91,43.3,51.2,36.4,00000
54.0,87.0,73.0,421,01,01,  Abdul Hashim Bepari Kandi,843,574,401,257,442,317,59.5,60.9,58.2,00000
54.0,87.0,73.0,421,02,01,  Hawladarkandi,97,309,36,150,61,159,23.9,19.4,27.7,00000
54.0,87.0,73.0,421,03,01,  Medhakandi,407,409,172,183,235,226,49.9,48.5,51.0,00000
54.0,87.0,79.0,259,01,01,  Lalmiah Munshirkandi,101,208,36,105,65,103,32.7,25.5,38.7,00000
54.0,87.0,79.0,259,02,01,  Hossain Hajirkandi,35,238,12,111,23,127,12.8,9.8,15.3,00000
54.0,87.0,79.0,394,01,01,  Daulatpur,143,274,73,138,70,136,34.3,34.6,34.0,00000
54.0,87.0,79.0,394,02,01,  Baher Char,150,203,75,96,75,107,42.5,43.9,41.2,00000
54.0,87.0,79.0,394,03,01,  Mono Kandi,3,9,1,4,2,5,25.0,20.0,28.6,00000
54.0,87.0,79.0,555,01,01,  Mollakandi,68,184,24,99,44,85,27.0,19.5,34.1,00000
54.0,87.0,79.0,555,02,01,  Beparikandi,135,174,75,86,60,88,43.7,46.6,40.5,00000
54.0,87.0,79.0,555,03,01,  Bachamara Shatghar,14,15,6,7,8,8,48.3,46.2,50.0,00000
54.0,87.0,79.0,600,01,01,  Sharifkandi,151,432,86,209,65,223,25.9,29.2,22.6,00000
54.0,87.0,79.0,600,02,01,  Dhalikandi,63,256,31,117,32,139,19.7,20.9,18.7,00000
54.0,87.0,79.0,600,03,01,  Bhutikandi,11,24,6,10,5,14,31.4,37.5,26.3,00000
54.0,87.0,79.0,600,04,01,  Kazikandi,124,403,55,186,69,217,23.5,22.8,24.1,00000
54.0,87.0,79.0,730,01,01,  Mridhakandi,156,185,88,84,68,101,45.7,51.2,40.2,00000
54.0,87.0,79.0,730,02,01,  Nomokandi,230,205,133,96,97,109,52.9,58.1,47.1,00000
54.0,87.0,79.0,770,01,01,  Gobinda Madbarkandi,258,317,116,135,142,182,44.9,46.2,43.8,00000
54.0,87.0,79.0,770,02,01,  Mollakandi,605,664,289,285,316,379,47.7,50.3,45.5,00000
54.0,87.0,79.0,770,03,01,  Munshikandi,180,120,83,60,97,60,60.0,58.0,61.8,00000
54.0,87.0,79.0,770,04,01,  Matbarkandi,127,137,66,57,61,80,48.1,53.7,43.3,00000
54.0,87.0,79.0,770,05,01,  Malerkandi,292,303,129,122,163,181,49.1,51.4,47.4,00000
54.0,87.0,79.0,770,06,01,  Maulvikandi,192,142,93,58,99,84,57.5,61.6,54.1,00000
54.0,87.0,79.0,770,07,01,  Farazikandi,271,255,131,103,140,152,51.5,56.0,47.9,00000
54.0,87.0,79.0,770,08,01,  Azgar Hawladarkandi,829,683,575,319,254,364,54.8,64.3,41.1,00000
54.0,87.0,79.0,770,09,01,  Fairadikandi,70,174,36,79,34,95,28.7,31.3,26.4,00000
54.0,87.0,79.0,833,01,01,  Munshikandi,189,155,95,65,94,90,54.9,59.4,51.1,00000
54.0,87.0,79.0,833,02,01,  Chakdarkandi,120,164,58,82,62,82,42.3,41.4,43.1,00000
54.0,87.0,79.0,833,03,01,  Maulvikandi,110,144,62,67,48,77,43.3,48.1,38.4,00000
54.0,87.0,79.0,833,04,01,  Najim Bepary Kandi,140,164,64,70,76,94,46.1,47.8,44.7,00000
54.0,87.0,79.0,833,05,01,  Hasandi Munshirkandi,135,179,67,78,68,101,43.0,46.2,40.2,00000
54.0,87.0,79.0,833,06,01,  Adukharkandi,86,210,47,114,39,96,29.1,29.2,28.9,00000
54.0,87.0,79.0,833,07,01,  Haji Panchu Matbarkandi,108,207,56,89,52,118,34.3,38.6,30.6,00000
54.0,87.0,79.0,833,08,01,  Madhu Mridharkandi,102,99,49,46,53,53,50.7,51.6,50.0,00000
54.0,87.0,79.0,833,09,01,  Daliluddin Munshirkandi,180,175,94,73,86,102,50.7,56.3,45.7,00000
54.0,87.0,79.0,833,10,01,  Khalifakandi,110,143,61,65,49,78,43.5,48.4,38.6,00000
54.0,87.0,79.0,833,11,01,  Bishoy Mridharkandi,126,351,59,169,67,182,26.4,25.9,26.9,00000
54.0,87.0,84.0,806,01,01,  Samail,643,1035,302,504,341,531,38.3,37.5,39.1,00000
54.0,87.0,84.0,806,02,01,  Purba Samail,329,587,161,275,168,312,35.9,36.9,35.0,00000
54.0,87.0,94.0,475,01,01,  Kabilpur,197,243,85,105,112,138,44.8,44.7,44.8,00000
54.0,87.0,94.0,475,02,01,  Kadamtoli,323,366,142,182,181,184,46.9,43.8,49.6,00000
54.0,87.0,94.0,475,03,01,  Shabak Kamlapur (Part),106,113,47,49,59,64,48.4,49.0,48.0,00000
54.0,87.0,94.0,475,04,01,  Jakdahermat,696,770,371,369,325,401,47.5,50.1,44.8,00000
54.0,87.0,94.0,475,05,01,  Alipur(Part),338,665,146,327,192,338,33.7,30.9,36.2,00000
54.0,87.0,94.0,475,06,01,  Satvagheia,623,916,303,419,320,497,40.5,42.0,39.2,00000
54.0,87.0,94.0,493,01,01,  Kumarpar (Part),304,171,136,73,168,98,64.0,65.1,63.2,00000
54.0,87.0,94.0,493,02,01,  Char Kamlapur,407,757,191,375,216,382,35.0,33.7,36.1,00000
54.0,87.0,94.0,717,01,01,  Char Kanchikata (Part),455,681,231,342,224,339,40.1,40.3,39.8,00000
54.0,87.0,94.0,717,02,01,  Paschim Kanchikata,277,507,148,253,129,254,35.3,36.9,33.7,00000
54.0,87.0,94.0,717,03,01,  Kumarpar (Part),548,506,264,267,284,239,52.0,49.7,54.3,00000
54.0,87.0,94.0,950,01,01,  Umedpur,1311,1086,709,510,602,576,54.7,58.2,51.1,00000
54.0,87.0,94.0,950,02,01,  Char Ramrayer Kandi,572,351,299,156,273,195,62.0,65.7,58.3,00000
54.0,87.0,94.0,950,03,01,  Digreyer Char,690,625,363,323,327,302,52.5,52.9,52.0,00000
54.0,87.0,94.0,950,04,01,  Char Kanchikata (Part),316,431,168,247,148,184,42.3,40.5,44.6,00000
54.0,87.0,94.0,950,05,01,  Ramrayer Kandi,1033,400,516,185,517,215,72.1,73.6,70.6,00000
54.0,87.0,94.0,950,06,01,  Alipur (Part),476,421,249,188,227,233,53.1,57.0,49.3,00000
54.0,87.0,94.0,950,07,01,  Khoskandi,358,405,174,182,184,223,46.9,48.9,45.2,00000
93.0,9.0,11.0,234,01,03,  Basail,5812,4666,3010,2117,2802,2549,55.5,58.7,52.4,00000
93.0,9.0,11.0,234,02,03,  Andha Para,554,702,278,322,276,380,44.1,46.3,42.1,00000
93.0,9.0,11.0,704,01,01,  Mirikpur,542,1010,293,457,249,553,34.9,39.1,31.0,00000
93.0,9.0,11.0,704,02,01,  Naikanibari,1305,1530,655,659,650,871,46.0,49.8,42.7,00000
93.0,9.0,35.0,122,01,01,  Uttarpara,318,335,154,134,164,201,48.7,53.5,44.9,00000
93.0,9.0,35.0,122,02,01,  Dakshinpara,236,274,113,115,123,159,46.3,49.6,43.6,00000
93.0,9.0,35.0,391,01,01,  Paschimpara,912,861,459,371,453,490,51.4,55.3,48.0,00000
93.0,9.0,35.0,391,02,01,  Madhyapara,177,365,86,164,91,201,32.7,34.4,31.2,00000
93.0,9.0,35.0,391,03,01,  Dakshinpara,445,627,229,306,216,321,41.5,42.8,40.2,00000
93.0,9.0,35.0,447,01,01,  Jasihati,1172,821,569,344,603,477,58.8,62.3,55.8,00000
93.0,9.0,35.0,447,02,01,  Hakimpur,200,156,97,59,103,97,56.2,62.2,51.5,00000
93.0,9.0,35.0,659,01,01,  Maitha Uttar Para,616,569,302,232,314,337,52.0,56.6,48.2,00000
93.0,9.0,35.0,659,02,01,  Kusti Para,119,150,52,77,67,73,44.2,40.3,47.9,00000
93.0,9.0,35.0,659,03,01,  Gass Para,630,682,306,312,324,370,48.0,49.5,46.7,00000
93.0,9.0,35.0,659,04,01,  Kamala Para,356,263,168,117,188,146,57.5,58.9,56.3,00000
93.0,9.0,35.0,659,05,01,  Aik Para,251,527,133,222,118,305,32.3,37.5,27.9,00000
93.0,9.0,35.0,659,06,01,  Char Para,266,358,132,162,134,196,42.6,44.9,40.6,00000
93.0,9.0,35.0,659,07,01,  Suna Para,228,245,113,111,115,134,48.2,50.4,46.2,00000
93.0,9.0,35.0,659,08,01,  Saduli Para,300,470,136,213,164,257,39.0,39.0,39.0,00000
93.0,9.0,47.0,424,01,01,  Bilpara,344,297,169,126,175,171,53.7,57.3,50.6,00000
93.0,9.0,47.0,424,02,01,  Habla Tengari Para,1171,749,626,307,545,442,61.0,67.1,55.2,00000
93.0,9.0,47.0,424,03,01,  Purbapara,537,471,257,164,280,307,53.3,61.0,47.7,00000
93.0,9.0,47.0,424,04,01,  Dakshinpara,1512,824,732,334,780,490,64.7,68.7,61.4,00000
93.0,9.0,47.0,424,05,01,  Uttarpara,584,202,287,68,297,134,74.3,80.8,68.9,00000
93.0,9.0,47.0,424,06,01,  Gosakhali,286,321,131,135,155,186,47.1,49.2,45.5,00000
93.0,9.0,47.0,793,01,01,  Dakshinpara,801,545,414,212,387,333,59.5,66.1,53.8,00000
93.0,9.0,47.0,793,02,01,  Uttarpara,412,228,198,89,214,139,64.4,69.0,60.6,00000
93.0,9.0,59.0,547,01,01,  Bilpara,123,205,56,89,67,116,37.5,38.6,36.6,00000
93.0,9.0,59.0,547,02,01,  Kazi Para,776,610,342,262,434,348,56.0,56.6,55.5,00000
93.0,9.0,59.0,547,03,01,  Sakria Char,343,571,173,245,170,326,37.5,41.4,34.3,00000
93.0,9.0,59.0,547,04,01,  Dakshinpara,910,750,444,316,466,434,54.8,58.4,51.8,00000
93.0,9.0,59.0,547,05,01,  Tarabari,199,347,99,140,100,207,36.4,41.4,32.6,00000
93.0,9.0,59.0,547,06,01,  Kodalia Para,219,189,87,77,132,112,53.7,53.0,54.1,00000
93.0,9.0,59.0,547,07,01,  Chanka Para,523,446,228,201,295,245,54.0,53.1,54.6,00000
93.0,9.0,59.0,547,08,01,  Jahangirnagar,195,133,89,57,106,76,59.5,61.0,58.2,00000
93.0,9.0,59.0,547,09,01,  Karmaker Para,229,189,98,94,131,95,54.8,51.0,58.0,00000
93.0,9.0,59.0,547,10,01,  Halur Para,346,362,195,165,151,197,48.9,54.2,43.4,00000
93.0,9.0,59.0,547,11,01,  Jigatala Para,118,309,67,144,51,165,27.6,31.8,23.6,00000
93.0,9.0,59.0,547,12,01,  Dang Para,674,834,336,374,338,460,44.7,47.3,42.4,00000
93.0,9.0,59.0,547,13,01,  Purbapara,405,349,208,137,197,212,53.7,60.3,48.2,00000
93.0,9.0,59.0,547,14,01,  Paschimpara,775,825,362,354,413,471,48.4,50.6,46.7,00000
93.0,9.0,83.0,595,01,01,  Kaoaljani,2373,2276,1166,980,1207,1296,51.0,54.3,48.2,00000
93.0,9.0,83.0,595,02,01,  Bil Chikni,73,178,31,73,42,105,29.1,29.8,28.6,00000
93.0,9.0,83.0,595,03,01,  Mandarjani,551,458,257,182,294,276,54.6,58.5,51.6,00000
93.0,9.0,83.0,595,04,01,  Mailanpur,159,358,76,157,83,201,30.8,32.6,29.2,00000
93.0,19.0,13.0,488,01,01,  Jagatpura,1107,1297,524,575,583,722,46.0,47.7,44.7,00000
93.0,19.0,13.0,488,02,01,  Char Jagatpura,216,594,104,284,112,310,26.7,26.8,26.5,00000
93.0,19.0,27.0,035,01,01,  Aloa,420,540,207,234,213,306,43.8,46.9,41.0,00000
93.0,19.0,27.0,035,02,01,  Char Aloa,410,772,218,346,192,426,34.7,38.7,31.1,00000
93.0,19.0,27.0,524,01,01,  Kadim Nikla,202,277,100,127,102,150,42.2,44.1,40.5,00000
93.0,19.0,27.0,524,02,01,  Nikla Joyram Para,74,72,37,37,37,35,50.7,50.0,51.4,00000
93.0,19.0,27.0,710,01,01,  Nikla Naya Para,122,321,63,155,59,166,27.5,28.9,26.2,00000
93.0,19.0,27.0,710,02,01,  Bilkaya,37,45,20,23,17,22,45.1,46.5,43.6,00000
93.0,19.0,27.0,710,03,01,  Char Nikla,621,1113,347,511,274,602,35.8,40.4,31.3,00000
93.0,19.0,27.0,710,04,01,  Barkatpur,300,286,158,122,142,164,51.2,56.4,46.4,00000
93.0,19.0,27.0,710,05,01,  Bil Nikla,182,163,80,73,102,90,52.8,52.3,53.1,00000
93.0,19.0,27.0,710,06,01,  Khod Nikla,446,465,216,209,230,256,49.0,50.8,47.3,00000
93.0,19.0,27.0,746,01,01,  Nikla Gopal,166,451,91,211,75,240,26.9,30.1,23.8,00000
93.0,19.0,27.0,746,02,01,  Roypara,103,325,52,148,51,177,24.1,26.0,22.4,00000
93.0,19.0,27.0,746,03,01,  Chan Amula,119,171,60,84,59,87,41.0,41.7,40.4,00000
93.0,19.0,40.0,008,01,01,  Ag Teilla,906,1168,494,522,412,646,43.7,48.6,38.9,00000
93.0,19.0,40.0,008,02,01,  Sanak Boyra,282,560,145,245,137,315,33.5,37.2,30.3,00000
93.0,19.0,40.0,390,01,01,  Dobolia,1197,1370,573,617,624,753,46.6,48.2,45.3,00000
93.0,19.0,40.0,390,02,01,  Gabrabari,348,181,164,71,184,110,65.8,69.8,62.6,00000
93.0,19.0,40.0,648,01,01,  Maijbari,223,343,108,163,115,180,39.4,39.9,39.0,00000
93.0,19.0,40.0,648,02,01,  Madaria,395,400,201,180,194,220,49.7,52.8,46.9,00000
93.0,19.0,40.0,648,03,01,  Jhanjania,341,254,177,108,164,146,57.3,62.1,52.9,00000
93.0,19.0,40.0,781,01,01,  Pachh Teilla,906,1292,473,600,433,692,41.2,44.1,38.5,00000
93.0,19.0,40.0,781,02,01,  Ballah Bari,70,94,36,46,34,48,42.7,43.9,41.5,00000
93.0,19.0,40.0,808,01,01,  Falda,2744,2904,1461,1356,1283,1548,48.6,51.9,45.3,00000
93.0,19.0,40.0,808,02,01,  Debakandi,434,340,226,141,208,199,56.1,61.6,51.1,00000
93.0,19.0,54.0,310,01,01,  Nikna Para,245,740,109,321,136,419,24.9,25.3,24.5,00000
93.0,19.0,54.0,310,02,01,  Joardar Para,60,141,38,70,22,71,29.9,35.2,23.7,00000
93.0,19.0,54.0,310,03,01,  Bil Charpar,59,144,34,75,25,69,29.1,31.2,26.6,00000
93.0,19.0,54.0,310,04,01,  Rehai Chandani,47,232,24,107,23,125,16.8,18.3,15.5,00000
93.0,19.0,54.0,310,05,01,  Chhota Nalisa Para,96,1285,56,587,40,698,7.0,8.7,5.4,00000
93.0,19.0,54.0,310,06,01,  Bara Nalsia Para,73,529,38,235,35,294,12.1,13.9,10.6,00000
93.0,19.0,54.0,310,07,01,  Shohagipara,116,502,69,230,47,272,18.8,23.1,14.7,00000
93.0,19.0,54.0,319,01,01,  Degreer Char,49,270,29,132,20,138,15.4,18.0,12.7,00000
93.0,19.0,54.0,319,02,01,  Rajapur,175,370,94,158,81,212,32.1,37.3,27.6,00000
93.0,19.0,54.0,319,03,01,  Falda Para,52,82,22,34,30,48,38.8,39.3,38.5,00000
93.0,19.0,54.0,319,04,01,  Ruli Para,262,681,105,303,157,378,27.8,25.7,29.3,00000
93.0,19.0,54.0,319,05,01,  Gobindaganj,82,194,30,74,52,120,29.7,28.8,30.2,00000
93.0,19.0,54.0,319,06,01,  Gopalganj Para,80,468,45,217,35,251,14.6,17.2,12.2,00000
93.0,19.0,54.0,319,07,01,  Chandipur,220,487,101,210,119,277,31.1,32.5,30.1,00000
93.0,19.0,54.0,319,08,01,  Jongipur,124,239,69,99,55,140,34.2,41.1,28.2,00000
93.0,19.0,54.0,319,09,01,  Beltia Para,143,271,63,109,80,162,34.5,36.6,33.1,00000
93.0,19.0,54.0,319,10,01,  Bhayan Para,67,109,37,49,30,60,38.1,43.0,33.3,00000
93.0,19.0,54.0,319,11,01,  Khandakar Para,35,61,18,17,17,44,36.5,51.4,27.9,00000
93.0,19.0,54.0,319,12,01,  Bishwanathpur,152,330,71,125,81,205,31.5,36.2,28.3,00000
93.0,19.0,54.0,319,13,01,  Gopinathpur,263,402,127,185,136,217,39.5,40.7,38.5,00000
93.0,19.0,54.0,319,14,01,  Rampur,288,771,138,333,150,438,27.2,29.3,25.5,00000
93.0,19.0,54.0,319,15,01,  Gobindapur,36,202,22,81,14,121,15.1,21.4,10.4,00000
93.0,19.0,54.0,319,16,01,  Sarai Para,57,165,31,71,26,94,25.7,30.4,21.7,00000
93.0,19.0,54.0,319,17,01,  Chhota Joypur,2,27,0,11,2,16,6.9,0.0,11.1,00000
93.0,19.0,54.0,319,18,01,  Bara Joypur,84,385,49,186,35,199,17.9,20.9,15.0,00000
93.0,19.0,54.0,319,19,01,  Pungle Para,308,636,138,282,170,354,32.6,32.9,32.4,00000
93.0,19.0,54.0,319,20,01,  Kalipur,167,419,89,199,78,220,28.5,30.9,26.2,00000
93.0,19.0,54.0,675,01,01,  Meghar Patal,223,806,82,315,141,491,21.7,20.7,22.3,00000
93.0,19.0,54.0,675,02,01,  Changanj,121,396,64,151,57,245,23.4,29.8,18.9,00000
93.0,19.0,67.0,071,01,01,  Baghbari,1395,894,707,427,688,467,60.9,62.3,59.6,00000
93.0,19.0,67.0,071,02,01,  Khupibari,367,382,174,180,193,202,49.0,49.2,48.9,00000
93.0,19.0,67.0,204,01,01,  Bhalkutia,472,621,233,294,239,327,43.2,44.2,42.2,00000
93.0,19.0,67.0,204,02,01,  Chithawapara,438,1084,242,489,196,595,28.8,33.1,24.8,00000
93.0,19.0,81.0,621,01,01,  Konabari,146,617,80,332,66,285,19.1,19.4,18.8,00000
93.0,19.0,81.0,621,02,01,  Bhahadur Tukna,66,229,38,109,28,120,22.4,25.9,18.9,00000
93.0,19.0,81.0,772,01,01,  Sirajkandi,1463,2273,763,1100,700,1173,39.2,41.0,37.4,00000
93.0,19.0,81.0,772,02,01,  Palsia,869,1623,490,822,379,801,34.9,37.3,32.1,00000
93.0,19.0,81.0,772,03,01,  Punarbason,1086,1637,593,730,493,907,39.9,44.8,35.2,00000
53.9,46.0,93.0,019,81,988,Cantonment,514,0,514,0,0,0,100.0,100.0,0.0,00000
93.0,23.0,11.0,293,01,01,  Chala Atia,609,594,350,273,259,321,50.6,56.2,44.7,00000
93.0,23.0,11.0,293,02,01,  Manat Atia,320,337,173,159,147,178,48.7,52.1,45.2,00000
93.0,23.0,11.0,459,01,01,  Goaria,800,776,457,361,343,415,50.8,55.9,45.3,00000
93.0,23.0,11.0,459,02,01,  Nalla Para,2457,1604,1310,731,1147,873,60.5,64.2,56.8,00000
93.0,23.0,11.0,482,01,01,  Char Para,485,402,251,191,234,211,54.7,56.8,52.6,00000
93.0,23.0,11.0,482,02,01,  Bepari Para,232,121,122,48,110,73,65.7,71.8,60.1,00000
93.0,23.0,11.0,482,03,01,  Goshai Para,252,222,152,75,100,147,53.2,67.0,40.5,00000
93.0,23.0,11.0,482,04,01,  Kamanna Para,564,455,359,144,205,311,55.3,71.4,39.7,00000
93.0,23.0,11.0,482,05,01,  Barabari,157,108,84,46,73,62,59.2,64.6,54.1,00000
93.0,23.0,11.0,482,06,01,  Kaibat Para,158,227,88,108,70,119,41.0,44.9,37.0,00000
93.0,23.0,11.0,482,07,01,  Saha Para,224,111,125,49,99,62,66.9,71.8,61.5,00000
93.0,23.0,11.0,587,01,01,  Kanda Para,235,422,127,199,108,223,35.8,39.0,32.6,00000
93.0,23.0,11.0,587,02,01,  Kathalia,254,375,129,166,125,209,40.4,43.7,37.4,00000
93.0,23.0,11.0,587,03,01,  Mosha Kathalia,247,239,135,116,112,123,50.8,53.8,47.7,00000
93.0,23.0,23.0,354,01,03,  Delduar,2833,2310,1438,1083,1395,1227,55.1,57.0,53.2,00000
93.0,23.0,23.0,354,02,03,  Char Para,404,377,187,171,217,206,51.7,52.2,51.3,00000
93.0,23.0,23.0,354,03,03,  Tuknikhola,563,773,273,339,290,434,42.1,44.6,40.1,00000
93.0,23.0,23.0,354,04,03,  Shanbari,115,170,64,77,51,93,40.4,45.4,35.4,00000
93.0,23.0,41.0,357,01,01,  Deng Dubail,216,168,102,82,114,86,56.3,55.4,57.0,00000
93.0,23.0,41.0,357,02,01,  Dubail,1634,1256,823,581,811,675,56.5,58.6,54.6,00000
93.0,23.0,41.0,357,03,01,  Natia Para,550,353,268,168,282,185,60.9,61.5,60.4,00000
93.0,23.0,41.0,626,01,01,  Kopakhi,1101,880,527,382,574,498,55.6,58.0,53.5,00000
93.0,23.0,41.0,626,02,01,  Paraikhali,1045,665,476,295,569,370,61.1,61.7,60.6,00000
93.0,23.0,41.0,905,01,01,  Seharatail,559,476,286,221,273,255,54.0,56.4,51.7,00000
93.0,23.0,41.0,905,02,01,  Islampur,554,436,280,183,274,253,56.0,60.5,52.0,00000
93.0,23.0,47.0,670,01,01,  Momin Nagar,120,71,56,33,64,38,62.8,62.9,62.7,00000
93.0,23.0,47.0,670,02,01,  Abatpur,1179,1015,603,438,576,577,53.7,57.9,50.0,00000
93.0,23.0,47.0,670,03,01,  Chowbaria Para,109,146,63,62,46,84,42.7,50.4,35.4,00000
93.0,23.0,47.0,670,04,01,  Madhyapara,367,328,177,139,190,189,52.8,56.0,50.1,00000
93.0,23.0,47.0,670,05,01,  Dari Para,462,282,232,112,230,170,62.1,67.4,57.5,00000
93.0,23.0,47.0,670,06,01,  Naya Char,466,333,236,143,230,190,58.3,62.3,54.8,00000
93.0,23.0,59.0,391,01,01,  Fazilhati,428,401,238,176,190,225,51.6,57.5,45.8,00000
93.0,23.0,59.0,391,02,01,  Dakshin Elachipur,250,297,106,148,144,149,45.7,41.7,49.1,00000
93.0,23.0,59.0,391,03,01,  Tok Chandpur,561,817,261,372,300,445,40.7,41.2,40.3,00000
93.0,23.0,59.0,391,04,01,  Munshinagar,135,71,69,28,66,43,65.5,71.1,60.6,00000
93.0,23.0,59.0,391,05,01,  Goal Bathan,189,135,76,63,113,72,58.3,54.7,61.1,00000
93.0,23.0,59.0,391,06,01,  Battala,106,135,55,72,51,63,44.0,43.3,44.7,00000
93.0,23.0,59.0,391,07,01,  Jan Mahmudabid,103,35,54,10,49,25,74.6,84.4,66.2,00000
93.0,23.0,59.0,391,08,01,  Putiajani,771,877,414,388,357,489,46.8,51.6,42.2,00000
93.0,23.0,59.0,391,09,01,  Kumarjani,493,404,259,179,234,225,55.0,59.1,51.0,00000
93.0,23.0,59.0,557,01,01,  Shadhari Para,359,377,166,166,193,211,48.8,50.0,47.8,00000
93.0,23.0,59.0,557,02,01,  Meruaghona,472,483,237,218,235,265,49.4,52.1,47.0,00000
93.0,23.0,59.0,557,03,01,  Char Para,310,229,144,92,166,137,57.5,61.0,54.8,00000
93.0,23.0,59.0,557,04,01,  Gachh Para,496,765,266,340,230,425,39.3,43.9,35.1,00000
93.0,23.0,59.0,557,05,01,  Malpara,79,70,40,33,39,37,53.0,54.8,51.3,00000
93.0,23.0,59.0,557,06,01,  Sardar Para,181,161,84,66,97,95,52.9,56.0,50.5,00000
93.0,23.0,59.0,557,07,01,  Sikdar Para,631,499,298,209,333,290,55.8,58.8,53.5,00000
93.0,23.0,59.0,557,08,01,  Gurguriata,220,184,111,90,109,94,54.5,55.2,53.7,00000
93.0,23.0,59.0,557,09,01,  Battali,130,199,56,93,74,106,39.5,37.6,41.1,00000
93.0,23.0,59.0,648,01,01,  Lalhara,831,783,394,352,437,431,51.5,52.8,50.3,00000
93.0,23.0,59.0,648,02,01,  Munshi Nagar,114,160,61,75,53,85,41.6,44.9,38.4,00000
93.0,23.0,59.0,829,01,01,  Phultara,657,1006,345,472,312,534,39.5,42.2,36.9,00000
93.0,23.0,59.0,829,02,01,  Bedbari,288,364,144,168,144,196,44.2,46.2,42.4,00000
93.0,23.0,59.0,829,03,01,  Elachipur Uttarpara,369,207,166,89,203,118,64.1,65.1,63.2,00000
93.0,23.0,65.0,643,01,01,  Herendra Para,692,834,364,379,328,455,45.3,49.0,41.9,00000
93.0,23.0,65.0,643,02,01,  Barni,553,307,307,123,246,184,64.3,71.4,57.2,00000
93.0,23.0,65.0,643,03,01,  Lauhati,1476,1973,763,898,713,1075,42.8,45.9,39.9,00000
93.0,23.0,65.0,643,04,01,  Majhi Para,96,289,49,132,47,157,24.9,27.1,23.0,00000
93.0,25.0,21.0,037,01,01,  Bagua,471,405,229,170,242,235,53.8,57.4,50.7,00000
93.0,25.0,21.0,037,02,01,  Pankata,578,377,287,174,291,203,60.5,62.3,58.9,00000
93.0,25.0,21.0,037,03,01,  Panchpotol,926,1355,457,636,469,719,40.6,41.8,39.5,00000
93.0,25.0,21.0,037,04,01,  Kakniata,122,169,63,80,59,89,41.9,44.1,39.9,00000
93.0,25.0,25.0,111,01,01,  Baniajan,1075,2030,532,965,543,1065,34.6,35.5,33.8,00000
93.0,25.0,25.0,111,02,01,  Kamar Para,725,845,393,381,332,464,46.2,50.8,41.7,00000
93.0,25.0,25.0,111,03,01,  Jangalia,419,199,200,94,219,105,67.8,68.0,67.6,00000
93.0,25.0,25.0,798,01,01,  Panchashi,154,228,94,102,60,126,40.3,48.0,32.3,00000
93.0,25.0,25.0,798,02,01,  Chandpur,462,805,229,371,233,434,36.5,38.2,34.9,00000
93.0,25.0,25.0,798,03,01,  Kawamara,189,115,101,46,88,69,62.2,68.7,56.1,00000
93.0,25.0,38.0,072,01,01,  Bajitpur,389,363,200,151,189,212,51.7,57.0,47.1,00000
93.0,25.0,38.0,072,02,01,  Shamlar Char,129,223,71,106,58,117,36.6,40.1,33.1,00000
93.0,25.0,38.0,222,01,01,  Birtara,651,1067,345,498,306,569,37.9,40.9,35.0,00000
93.0,25.0,38.0,222,02,01,  Pachankhali,877,1588,456,750,421,838,35.6,37.8,33.4,00000
93.0,25.0,38.0,222,03,01,  Gonarbanda,273,341,134,147,139,194,44.5,47.7,41.7,00000
93.0,25.0,38.0,222,04,01,  Khara Para,176,389,91,193,85,196,31.2,32.0,30.2,00000
93.0,25.0,38.0,222,05,01,  Kadamtali,493,691,250,320,243,371,41.6,43.9,39.6,00000
93.0,25.0,38.0,222,06,01,  Palishar Para,234,367,124,164,110,203,38.9,43.1,35.1,00000
93.0,25.0,47.0,119,01,01,  Baola,347,382,192,174,155,208,47.6,52.5,42.7,00000
93.0,25.0,47.0,119,02,01,  Par Baola,76,340,47,161,29,179,18.3,22.6,13.9,00000
93.0,25.0,47.0,123,01,01,  Pathlar Char,278,441,149,201,129,240,38.7,42.6,35.0,00000
93.0,25.0,47.0,123,02,01,  Sreeharpur,367,244,178,115,189,129,60.1,60.8,59.4,00000
93.0,25.0,47.0,123,03,01,  Barai Para,510,823,273,375,237,448,38.3,42.1,34.6,00000
93.0,25.0,47.0,414,01,01,  Ghagra,477,581,252,256,225,325,45.1,49.6,40.9,00000
93.0,25.0,47.0,414,02,01,  Nichanpur,135,75,62,33,73,42,64.3,65.3,63.5,00000
93.0,25.0,47.0,499,01,01,  Islampur,501,452,263,203,238,249,52.6,56.4,48.9,00000
93.0,25.0,47.0,499,02,01,  Chowrati,99,145,49,62,50,83,40.6,44.1,37.6,00000
93.0,25.0,47.0,713,01,01,  Mominpur,371,840,172,406,199,434,30.6,29.8,31.4,00000
93.0,25.0,47.0,713,02,01,  Jagira Chala,373,481,187,239,186,242,43.7,43.9,43.5,00000
93.0,25.0,47.0,713,03,01,  Chak Mominpur,29,38,16,22,13,16,43.3,42.1,44.8,00000
93.0,25.0,57.0,768,01,01,  Narilla Radhakrishnapur,1380,1893,672,887,708,1006,42.2,43.1,41.3,00000
93.0,25.0,57.0,768,02,01,  Shibpur,134,288,62,145,72,143,31.8,30.0,33.5,00000
93.0,25.0,57.0,768,03,01,  Sandalpur,326,568,169,276,157,292,36.5,38.0,35.0,00000
93.0,25.0,80.0,730,01,01,  Musuddi,2896,4753,1434,2183,1462,2570,37.9,39.6,36.3,00000
93.0,25.0,80.0,730,02,01,  Banda Char Para,723,960,366,456,357,504,43.0,44.5,41.5,00000
93.0,25.0,85.0,183,01,01,  Bhatkura,390,717,190,337,200,380,35.2,36.1,34.5,00000
93.0,25.0,85.0,183,02,01,  Uttar Bhatkura,153,218,69,112,84,106,41.2,38.1,44.2,00000
93.0,25.0,85.0,183,03,01,  Paiska Bazar,102,49,68,21,34,28,67.5,76.4,54.8,00000
93.0,25.0,85.0,183,04,01,  Bari Patal,70,64,38,28,32,36,52.2,57.6,47.1,00000
93.0,25.0,85.0,209,01,01,  Bil Paiska,139,162,73,77,66,85,46.2,48.7,43.7,00000
93.0,25.0,85.0,209,02,01,  Haripur,395,224,188,116,207,108,63.8,61.8,65.7,00000
93.0,25.0,85.0,277,01,01,  Char Dhali,264,377,132,170,132,207,41.2,43.7,38.9,00000
93.0,25.0,85.0,277,02,01,  Khas Para,189,407,86,196,103,211,31.7,30.5,32.8,00000
93.0,25.0,85.0,952,01,01,  Saidar Para,268,377,136,154,132,223,41.6,46.9,37.2,00000
93.0,25.0,85.0,952,02,01,  Sonamai Baduria,279,514,141,232,138,282,35.2,37.8,32.9,00000
93.0,28.0,15.0,019,01,01,  Anehola,694,745,343,339,351,406,48.2,50.3,46.4,00000
93.0,28.0,15.0,019,02,01,  Patitakandi,261,502,146,226,115,276,34.2,39.2,29.4,00000
93.0,28.0,15.0,419,01,01,  Hatkura,701,819,349,384,352,435,46.1,47.6,44.7,00000
93.0,28.0,15.0,419,02,01,  Kayer Para,419,581,209,278,210,303,41.9,42.9,40.9,00000
93.0,28.0,15.0,419,03,01,  Char Para,204,388,112,187,92,201,34.5,37.5,31.4,00000
93.0,28.0,15.0,959,01,01,  Singuria,1504,1920,759,864,745,1056,43.9,46.8,41.4,00000
93.0,28.0,15.0,959,02,01,  Gokulnagar,272,345,127,171,145,174,44.1,42.6,45.5,00000
93.0,28.0,15.0,959,03,01,  Dubla Patal,146,156,68,75,78,81,48.3,47.6,49.1,00000
93.0,28.0,17.0,760,01,01,  Purba Pakutia,1386,949,723,425,663,524,59.4,63.0,55.9,00000
93.0,28.0,17.0,760,02,01,  Paschim Pakutia,1129,1258,622,617,507,641,47.3,50.2,44.2,00000
93.0,28.0,25.0,286,01,01,  Deopara,693,1254,362,560,331,694,35.6,39.3,32.3,00000
93.0,28.0,25.0,286,02,01,  Solaki Para,227,591,109,261,118,330,27.8,29.5,26.3,00000
93.0,28.0,34.0,084,01,01,  Nama Para,160,284,88,121,72,163,36.0,42.1,30.6,00000
93.0,28.0,34.0,084,02,01,  Hindu Para,242,217,145,103,97,114,52.7,58.5,46.0,00000
93.0,28.0,34.0,084,03,01,  Sharisha Ata,178,347,87,171,91,176,33.9,33.7,34.1,00000
93.0,28.0,34.0,084,04,01,  Tanpara,396,452,196,200,200,252,46.7,49.5,44.2,00000
93.0,28.0,34.0,334,01,01,  Madhyapara,183,347,95,150,88,197,34.5,38.8,30.9,00000
93.0,28.0,34.0,334,02,01,  Ghona Para,155,118,77,52,78,66,56.8,59.7,54.2,00000
93.0,28.0,34.0,334,03,01,  Dakshinpara,414,752,214,340,200,412,35.5,38.6,32.7,00000
93.0,28.0,34.0,334,04,01,  Chak Para,162,257,89,101,73,156,38.7,46.8,31.9,00000
93.0,28.0,34.0,334,05,01,  Nama Para,135,291,83,120,52,171,31.7,40.9,23.3,00000
93.0,28.0,34.0,334,06,01,  Uttarpara,457,773,221,353,236,420,37.2,38.5,36.0,00000
93.0,28.0,34.0,334,07,01,  Banna Para,131,238,69,105,62,133,35.5,39.7,31.8,00000
93.0,28.0,34.0,669,01,01,  Chulabar,335,1287,196,584,139,703,20.7,25.1,16.5,00000
93.0,28.0,34.0,669,02,01,  Gabtali,109,289,60,137,49,152,27.4,30.5,24.4,00000
93.0,28.0,34.0,669,03,01,  Paharia,64,553,38,272,26,281,10.4,12.3,8.5,00000
93.0,28.0,34.0,669,04,01,  Gorbanda,39,345,20,161,19,184,10.2,11.0,9.4,00000
93.0,28.0,34.0,757,01,01,  Uttarpara,90,673,53,299,37,374,11.8,15.1,9.0,00000
93.0,28.0,34.0,757,02,01,  Dakshinpara,121,395,66,190,55,205,23.4,25.8,21.2,00000
93.0,28.0,34.0,812,01,01,  Bara Baid,423,1304,234,611,189,693,24.5,27.7,21.4,00000
93.0,28.0,34.0,812,02,01,  Naya Para,151,417,84,198,67,219,26.6,29.8,23.4,00000
93.0,28.0,34.0,812,03,01,  Gayaria Para,375,1192,219,563,156,629,23.9,28.0,19.9,00000
93.0,28.0,34.0,812,04,01,  Bheail Para,182,597,81,266,101,331,23.4,23.3,23.4,00000
93.0,28.0,34.0,812,05,01,  Jor Dighi,135,283,67,129,68,154,32.3,34.2,30.6,00000
93.0,28.0,34.0,812,06,01,  Tebaidda Para,44,266,22,135,22,131,14.2,14.0,14.4,00000
93.0,28.0,34.0,812,07,01,  Ichali Para,194,535,103,258,91,277,26.6,28.5,24.7,00000
93.0,28.0,34.0,812,08,01,  Bara Chala,73,285,43,126,30,159,20.4,25.4,15.9,00000
93.0,28.0,34.0,848,01,01,  Tanpara,153,529,89,223,64,306,22.4,28.5,17.3,00000
93.0,28.0,34.0,848,02,01,  Nama Para,253,461,128,201,125,260,35.4,38.9,32.5,00000
93.0,28.0,34.0,848,03,01,  Aseria Chala,115,355,68,162,47,193,24.5,29.6,19.6,00000
93.0,28.0,34.0,848,04,01,  Henger Chala,80,297,47,127,33,170,21.2,27.0,16.3,00000
93.0,28.0,34.0,848,05,01,  Joal Bhanga,47,275,34,127,13,148,14.6,21.1,8.1,00000
93.0,28.0,34.0,848,07,01,  Shiris Chala,126,327,77,146,49,181,27.8,34.5,21.3,00000
93.0,28.0,34.0,848,08,01,  Bhabanipur,159,575,67,267,92,308,21.7,20.1,23.0,00000
93.0,28.0,34.0,848,09,01,  Sundar Fakir,260,616,138,275,122,341,29.7,33.4,26.3,00000
93.0,28.0,34.0,848,10,01,  Pora Pasha,105,517,69,230,36,287,16.9,23.1,11.1,00000
93.0,28.0,34.0,848,11,01,  Mutha Juri,124,260,60,110,64,150,32.3,35.3,29.9,00000
93.0,28.0,34.0,875,01,01,  Sagar Dighi,978,678,532,348,446,330,59.1,60.5,57.5,00000
93.0,28.0,34.0,875,02,01,  Sulakura,559,953,285,450,274,503,37.0,38.8,35.3,00000
93.0,28.0,34.0,875,03,01,  Betua Para,415,831,231,398,184,433,33.3,36.7,29.8,00000
93.0,28.0,34.0,875,04,01,  Jalal Pur,240,868,146,406,94,462,21.7,26.4,16.9,00000
93.0,28.0,34.0,875,05,01,  Hatimara,535,948,275,459,260,489,36.1,37.5,34.7,00000
93.0,28.0,34.0,903,01,01,  Asaria Chala,162,256,88,116,74,140,38.8,43.1,34.6,00000
93.0,28.0,34.0,903,02,01,  Dighalia Chala,531,934,282,408,249,526,36.2,40.9,32.1,00000
93.0,28.0,34.0,903,03,01,  Chambal Chari Battala,23,239,14,110,9,129,8.8,11.3,6.5,00000
93.0,28.0,34.0,903,04,01,  Bhuiyar Chala,196,459,99,218,97,241,29.9,31.2,28.7,00000
93.0,28.0,34.0,903,05,01,  Bheolatel,113,357,70,162,43,195,24.0,30.2,18.1,00000
93.0,28.0,34.0,903,06,01,  Shamchala Tentulia,188,563,96,259,92,304,25.0,27.0,23.2,00000
93.0,28.0,34.0,903,07,01,  Sahar Gobindapur,346,766,192,341,154,425,31.1,36.0,26.6,00000
93.0,28.0,34.0,903,08,01,  Unaner Chala,429,851,217,380,212,471,33.5,36.3,31.0,00000
93.0,28.0,34.0,994,01,01,  Purbapara,415,495,230,244,185,251,45.6,48.5,42.4,00000
93.0,28.0,34.0,994,02,01,  Uttarpara,94,254,50,124,44,130,27.0,28.7,25.3,00000
93.0,28.0,34.0,994,03,01,  Madhyapara,229,534,114,263,115,271,30.0,30.2,29.8,00000
93.0,28.0,43.0,718,01,01,  Mujahati,270,345,131,162,139,183,43.9,44.7,43.2,00000
93.0,28.0,43.0,718,02,01,  Natshala,392,665,194,295,198,370,37.1,39.7,34.9,00000
93.0,28.0,69.0,536,01,01,  Karna,387,477,213,202,174,275,44.8,51.3,38.8,00000
93.0,28.0,69.0,536,02,01,  Kalidas Para,128,115,67,56,61,59,52.7,54.5,50.8,00000
93.0,28.0,69.0,536,03,01,  Naba Ratnabari,265,315,138,143,127,172,45.7,49.1,42.5,00000
93.0,28.0,69.0,640,01,01,  Madhya Karna,725,639,362,294,363,345,53.2,55.2,51.3,00000
93.0,28.0,69.0,640,02,01,  Konabari Karna,230,199,129,79,101,120,53.6,62.0,45.7,00000
93.0,28.0,69.0,640,03,01,  Kochbari Karna,195,218,96,106,99,112,47.2,47.5,46.9,00000
93.0,28.0,77.0,162,01,01,  Bir Singha,689,636,359,288,330,348,52.0,55.5,48.7,00000
93.0,28.0,77.0,162,02,01,  Char Bir Singha,377,379,186,182,191,197,49.9,50.5,49.2,00000
93.0,28.0,77.0,230,01,01,  Chhayani Baksia,834,967,427,438,407,529,46.3,49.4,43.5,00000
93.0,28.0,77.0,230,02,01,  Char Baksia,305,560,174,259,131,301,35.3,40.2,30.3,00000
93.0,28.0,77.0,770,01,01,  Panch Tikari,2043,3273,1091,1589,952,1684,38.4,40.7,36.1,00000
93.0,28.0,77.0,770,02,01,  Laksmi Pur,279,166,144,73,135,93,62.7,66.4,59.2,00000
93.0,28.0,86.0,367,01,01,  Ghonar Deuli,260,364,118,182,142,182,41.7,39.3,43.8,00000
93.0,28.0,86.0,367,02,01,  Chander Deuli,242,455,103,228,139,227,34.7,31.1,38.0,00000
93.0,28.0,86.0,367,03,01,  Jhupibari Patal,294,415,139,196,155,219,41.5,41.5,41.4,00000
93.0,28.0,86.0,630,01,01,  Lakshmindar,999,1489,562,684,437,805,40.2,45.1,35.2,00000
93.0,28.0,86.0,630,02,01,  Faytamari,499,1053,282,484,217,569,32.2,36.8,27.6,00000
93.0,28.0,86.0,630,03,01,  Akandar Baid,1048,1677,589,732,459,945,38.5,44.6,32.7,00000
93.0,28.0,86.0,630,04,01,  Harongchala,214,674,106,321,108,353,24.1,24.8,23.4,00000
93.0,28.0,86.0,689,01,01,  Mantala,589,1301,291,644,298,657,31.2,31.1,31.2,00000
93.0,28.0,86.0,689,02,01,  Sukter Baid,305,616,157,301,148,315,33.1,34.3,32.0,00000
93.0,28.0,86.0,689,03,01,  Taltala,476,1104,226,526,250,578,30.1,30.1,30.2,00000
93.0,28.0,86.0,725,01,01,  Muraid,507,951,278,445,229,506,34.8,38.5,31.2,00000
93.0,28.0,86.0,725,02,01,  Siddikulla,262,514,134,258,128,256,33.8,34.2,33.3,00000
93.0,28.0,86.0,725,03,01,  Shapla,137,497,73,238,64,259,21.6,23.5,19.8,00000
93.0,28.0,86.0,725,04,01,  Madhupur Chala,224,508,126,229,98,279,30.6,35.5,26.0,00000
93.0,28.0,86.0,725,05,01,  Charia Baid,97,528,52,256,45,272,15.5,16.9,14.2,00000
93.0,28.0,86.0,725,06,01,  Singha Chala,276,748,154,353,122,395,27.0,30.4,23.6,00000
93.0,28.0,86.0,725,07,01,  Chak Para,487,751,262,356,225,395,39.3,42.4,36.3,00000
93.0,28.0,86.0,725,08,01,  Dulali,804,1501,448,702,356,799,34.9,39.0,30.8,00000
93.0,28.0,86.0,725,09,01,  Kaikar Chala,167,317,78,159,89,158,34.5,32.9,36.0,00000
93.0,28.0,86.0,725,10,01,  Baghda,694,1216,350,605,344,611,36.3,36.6,36.0,00000
93.0,28.0,86.0,868,01,01,  Rasulpur,433,781,227,377,206,404,35.7,37.6,33.8,00000
93.0,28.0,86.0,868,02,01,  Dilderpur,107,206,60,104,47,102,34.2,36.6,31.5,00000
93.0,28.0,86.0,868,03,01,  Dhalua Para,232,230,127,105,105,125,50.2,54.7,45.7,00000
93.0,28.0,86.0,868,04,01,  Hanskura Tanpara,492,1199,268,549,224,650,29.1,32.8,25.6,00000
93.0,28.0,86.0,868,05,01,  Goran Chala,381,485,211,209,170,276,44.0,50.2,38.1,00000
93.0,28.0,86.0,916,01,01,  Saliabaha,395,633,216,263,179,370,38.4,45.1,32.6,00000
93.0,28.0,86.0,916,02,01,  Karbari,90,248,44,113,46,135,26.6,28.0,25.4,00000
93.0,28.0,86.0,916,03,01,  Saliabaha Sipterbaid,417,511,209,229,208,282,44.9,47.7,42.4,00000
93.0,28.0,86.0,916,04,01,  Fairadi Ata,132,193,65,87,67,106,40.6,42.8,38.7,00000
93.0,28.0,86.0,916,05,01,  Chiring Chala,376,799,197,371,179,428,32.0,34.7,29.5,00000
93.0,28.0,86.0,962,01,01,  Sarabari,272,417,152,188,120,229,39.5,44.7,34.4,00000
93.0,28.0,86.0,962,02,01,  Madhyapara,106,270,62,118,44,152,28.2,34.4,22.4,00000
93.0,28.0,86.0,962,03,01,  Katalia Ata,189,490,119,203,70,287,27.8,37.0,19.6,00000
93.0,28.0,86.0,962,04,01,  Khajnagara,735,1611,366,699,369,912,31.3,34.4,28.8,00000
93.0,28.0,86.0,962,05,01,  Kajla,529,1034,310,454,219,580,33.8,40.6,27.4,00000
93.0,28.0,86.0,962,06,01,  Gorarteki,172,436,103,193,69,243,28.3,34.8,22.1,00000
93.0,28.0,86.0,962,07,01,  Bhasa Baid,177,431,83,191,94,240,29.1,30.3,28.1,00000
93.0,28.0,86.0,962,08,01,  Atheka Para,275,745,139,330,136,415,27.0,29.6,24.7,00000
93.0,28.0,86.0,975,01,01,  Maita Ata (Khushi Ata),186,243,96,125,90,118,43.4,43.4,43.3,00000
93.0,28.0,86.0,975,02,01,  Noabari,200,448,106,200,94,248,30.9,34.6,27.5,00000
93.0,28.0,94.0,048,01,01,  Baga,769,1497,372,714,397,783,33.9,34.3,33.6,00000
93.0,28.0,94.0,048,02,01,  Biduria,120,235,58,114,62,121,33.8,33.7,33.9,00000
93.0,28.0,94.0,048,03,01,  Khagrata,608,1456,292,732,316,724,29.5,28.5,30.4,00000
93.0,28.0,94.0,048,04,01,  Gopal,95,195,49,92,46,103,32.8,34.8,30.9,00000
93.0,28.0,94.0,048,05,01,  Satorbari,347,558,163,264,184,294,38.3,38.2,38.5,00000
93.0,28.0,94.0,318,01,01,  Egara Kahania,180,344,90,160,90,184,34.4,36.0,32.8,00000
93.0,28.0,94.0,318,02,01,  Amuma Baid,608,1038,302,481,306,557,36.9,38.6,35.5,00000
93.0,28.0,94.0,318,03,01,  Kamar Chala,387,655,161,329,226,326,37.1,32.9,40.9,00000
93.0,28.0,94.0,318,04,01,  Fulbari,109,193,58,85,51,108,36.1,40.6,32.1,00000
93.0,28.0,94.0,318,05,01,  Bahula Chala,100,201,45,102,55,99,33.2,30.6,35.7,00000
93.0,28.0,94.0,318,06,01,  Mulbari,210,317,103,151,107,166,39.8,40.6,39.2,00000
93.0,28.0,94.0,318,07,01,  Daojana,152,287,83,135,69,152,34.6,38.1,31.2,00000
93.0,28.0,94.0,318,08,01,  Boyali Chala,126,181,71,80,55,101,41.0,47.0,35.3,00000
93.0,28.0,94.0,318,09,01,  Fakir Chala,305,445,162,212,143,233,40.7,43.3,38.0,00000
93.0,28.0,94.0,318,10,01,  Baluya Taka,217,301,120,137,97,164,41.9,46.7,37.2,00000
93.0,28.0,94.0,318,11,01,  Kuralia,119,148,54,69,65,79,44.6,43.9,45.1,00000
93.0,28.0,94.0,318,12,01,  Naluya,416,750,237,339,179,411,35.7,41.1,30.3,00000
93.0,28.0,94.0,318,13,01,  Barchala,171,237,90,112,81,125,41.9,44.6,39.3,00000
93.0,28.0,94.0,357,01,01,  Gaurishwar,368,877,201,391,167,486,29.6,34.0,25.6,00000
93.0,28.0,94.0,357,02,01,  Batpara,381,638,197,299,184,339,37.4,39.7,35.2,00000
93.0,28.0,94.0,357,03,01,  Choydal,94,196,47,94,47,102,32.4,33.3,31.5,00000
93.0,28.0,94.0,357,04,01,  Cukuri,102,171,54,89,48,82,37.4,37.8,36.9,00000
93.0,28.0,94.0,617,01,01,  Kusaria,556,637,288,299,268,338,46.6,49.1,44.2,00000
93.0,28.0,94.0,617,02,01,  Para Kusaria,223,301,119,125,104,176,42.6,48.8,37.1,00000
93.0,28.0,94.0,617,03,01,  Tapi Kusaria,450,764,238,338,212,426,37.1,41.3,33.2,00000
93.0,28.0,94.0,617,04,01,  Kokarbari,119,206,61,93,58,113,36.6,39.6,33.9,00000
93.0,28.0,94.0,617,05,01,  Guya Gambhir,467,746,247,341,220,405,38.5,42.0,35.2,00000
93.0,28.0,94.0,624,01,01,  Lahiribari,365,230,209,93,156,137,61.3,69.2,53.2,00000
93.0,28.0,94.0,624,02,01,  Fashal,125,239,62,103,63,136,34.3,37.6,31.7,00000
93.0,28.0,94.0,923,01,01,  Sandhanpur,176,653,91,303,85,350,21.2,23.1,19.5,00000
93.0,28.0,94.0,923,02,01,  Monar Para,7,14,5,6,2,8,33.3,45.5,20.0,00000
93.0,28.0,94.0,923,03,01,  Shapuya Chala,64,96,35,42,29,54,40.0,45.5,34.9,00000
93.0,28.0,94.0,923,04,01,  Nayan Chala,148,307,64,142,84,165,32.5,31.1,33.7,00000
93.0,28.0,94.0,923,05,01,  Chinga Baid,36,86,20,40,16,46,29.5,33.3,25.8,00000
93.0,28.0,94.0,923,06,01,  Satkuya Baid,155,550,84,254,71,296,22.0,24.9,19.3,00000
93.0,28.0,94.0,923,07,01,  Islampur,79,271,33,125,46,146,22.6,20.9,24.0,00000
93.0,38.0,17.0,012,01,01,  Alamnagar,960,1739,500,812,460,927,35.6,38.1,33.2,00000
93.0,38.0,17.0,012,02,01,  Joynagar,422,669,217,307,205,362,38.7,41.4,36.2,00000
93.0,38.0,17.0,012,03,01,  Mantala,156,394,67,190,89,204,28.4,26.1,30.4,00000
93.0,38.0,17.0,012,04,01,  Bharabhita,239,295,129,135,110,160,44.8,48.9,40.7,00000
93.0,38.0,17.0,012,05,01,  Baguata,556,690,274,302,282,388,44.6,47.6,42.1,00000
93.0,38.0,17.0,012,06,01,  Baira Para,324,494,153,229,171,265,39.6,40.1,39.2,00000
93.0,38.0,17.0,736,01,01,  Nabagram,1250,1419,635,651,615,768,46.8,49.4,44.5,00000
93.0,38.0,17.0,736,02,01,  Chora Bari,254,182,126,77,128,105,58.3,62.1,54.9,00000
93.0,38.0,17.0,749,01,01,  Char Nalhara,396,434,193,209,203,225,47.7,48.0,47.4,00000
93.0,38.0,17.0,749,02,01,  Bir Nalhara,218,638,119,306,99,332,25.5,28.0,23.0,00000
93.0,38.0,21.0,119,01,01,  Baruria,447,419,269,196,178,223,51.6,57.8,44.4,00000
93.0,38.0,21.0,119,02,01,  Betbari,244,297,129,139,115,158,45.1,48.1,42.1,00000
93.0,38.0,21.0,119,03,01,  Sukderbari,157,227,78,114,79,113,40.9,40.6,41.1,00000
93.0,38.0,58.0,006,01,01,  Ajgara,590,449,312,206,278,243,56.8,60.2,53.4,00000
93.0,38.0,58.0,006,02,01,  Gohatra,310,282,173,134,137,148,52.4,56.4,48.1,00000
93.0,38.0,58.0,069,01,01,  Banda Ajgara,245,379,118,174,127,205,39.3,40.4,38.3,00000
93.0,38.0,58.0,069,02,01,  Betal Ajgar,61,137,30,63,31,74,30.8,32.3,29.5,00000
93.0,38.0,58.0,069,03,01,  Bali Ajgar,46,77,22,36,24,41,37.4,37.9,36.9,00000
93.0,38.0,58.0,239,01,01,  Chatutia,1543,1855,790,861,753,994,45.4,47.8,43.1,00000
93.0,38.0,58.0,239,02,01,  Hawal Bhanga,351,466,171,211,180,255,43.0,44.8,41.4,00000
93.0,38.0,58.0,239,03,01,  Kariata,1405,1853,747,882,658,971,43.1,45.9,40.4,00000
93.0,38.0,58.0,239,04,01,  Chak Kashi,297,607,168,288,129,319,32.9,36.8,28.8,00000
93.0,38.0,58.0,245,01,01,  Chatarkandi,530,349,301,174,229,175,60.3,63.4,56.7,00000
93.0,38.0,58.0,245,02,01,  Char Chatarkandi,295,243,147,111,148,132,54.8,57.0,52.9,00000
93.0,38.0,58.0,245,03,01,  Habibpur,240,262,124,116,116,146,47.8,51.7,44.3,00000
93.0,38.0,58.0,396,01,01,  Banda Hadira,510,627,278,306,232,321,44.9,47.6,42.0,00000
93.0,38.0,58.0,396,02,01,  Chowka Hadira,178,181,91,83,87,98,49.6,52.3,47.0,00000
93.0,38.0,58.0,396,03,01,  Hadira,960,1425,486,656,474,769,40.3,42.6,38.1,00000
93.0,38.0,58.0,396,04,01,  Gohatra,301,209,153,101,148,108,59.0,60.2,57.8,00000
93.0,38.0,58.0,768,01,01,  Niamatpur,901,883,446,414,455,469,50.5,51.9,49.2,00000
93.0,38.0,58.0,768,02,01,  Bhadurir Char,1145,1033,599,481,546,552,52.6,55.5,49.7,00000
93.0,38.0,58.0,768,03,01,  Ganipur,113,111,52,49,61,62,50.4,51.5,49.6,00000
93.0,38.0,65.0,764,01,01,  Naruchi,1287,1692,618,767,669,925,43.2,44.6,42.0,00000
93.0,38.0,65.0,764,02,01,  Nalin,969,1276,522,597,447,679,43.2,46.6,39.7,00000
93.0,38.0,65.0,764,03,01,  Oriabari,281,309,123,139,158,170,47.6,46.9,48.2,00000
93.0,38.0,65.0,764,04,01,  Gulipacha,676,595,345,260,331,335,53.2,57.0,49.7,00000
93.0,38.0,65.0,932,01,01,  Simla Para,1625,1723,808,825,817,898,48.5,49.5,47.6,00000
93.0,38.0,65.0,932,02,01,  Hemnagar,519,334,263,147,256,187,60.8,64.1,57.8,00000
93.0,38.0,73.0,952,01,01,  Soyani Para,205,178,95,85,110,93,53.5,52.8,54.2,00000
93.0,38.0,73.0,952,02,01,  Patila Doba,53,26,24,14,29,12,67.1,63.2,70.7,00000
93.0,38.0,80.0,113,01,01,  Bara Shila,383,585,194,272,189,313,39.6,41.6,37.6,00000
93.0,38.0,80.0,113,02,01,  Badai Ata,207,670,91,318,116,352,23.6,22.2,24.8,00000
93.0,38.0,80.0,113,03,01,  Chak Para,167,329,77,143,90,186,33.7,35.0,32.6,00000
93.0,38.0,80.0,113,04,01,  Degreepar,59,177,33,91,26,86,25.0,26.6,23.2,00000
93.0,38.0,80.0,270,01,01,  Dakshin Mandia,893,1079,431,523,462,556,45.3,45.2,45.4,00000
93.0,38.0,80.0,270,02,01,  Madhya Mandia,444,599,208,272,236,327,42.6,43.3,41.9,00000
93.0,38.0,80.0,302,01,01,  Daulatpur,591,507,281,208,310,299,53.8,57.5,50.9,00000
93.0,38.0,80.0,302,02,01,  Sharif Pur,242,426,143,197,99,229,36.2,42.1,30.2,00000
93.0,38.0,80.0,321,01,01,  Dhulatia Digar,304,487,165,239,139,248,38.4,40.8,35.9,00000
93.0,38.0,80.0,321,02,01,  Kaguchi Ata,212,324,107,166,105,158,39.6,39.2,39.9,00000
93.0,38.0,80.0,321,03,01,  Chandpur,74,65,44,28,30,37,53.2,61.1,44.8,00000
93.0,38.0,80.0,686,01,01,  Mirzapur Uttarpara,575,768,297,348,278,420,42.8,46.0,39.8,00000
93.0,38.0,80.0,686,02,01,  Mirzapur Natonpara,214,300,108,139,106,161,41.6,43.7,39.7,00000
93.0,38.0,80.0,686,03,01,  Paschim Natur Char,328,550,144,258,184,292,37.4,35.8,38.7,00000
93.0,38.0,80.0,686,04,01,  Purba Natur Char,410,431,196,216,214,215,48.8,47.6,49.9,00000
93.0,38.0,80.0,686,05,01,  Majh Para,449,340,215,158,234,182,56.9,57.6,56.3,00000
93.0,38.0,80.0,686,06,01,  Saha Para,277,412,140,196,137,216,40.2,41.7,38.8,00000
93.0,38.0,80.0,686,07,01,  Goal Para,132,182,68,91,64,91,42.0,42.8,41.3,00000
93.0,38.0,80.0,686,08,01,  Khamar Para,332,338,161,156,171,182,49.6,50.8,48.4,00000
93.0,38.0,80.0,686,09,01,  Khan Para,530,585,259,272,271,313,47.5,48.8,46.4,00000
93.0,38.0,80.0,686,10,01,  Barakhali,310,351,141,160,169,191,46.9,46.8,46.9,00000
93.0,38.0,80.0,686,11,01,  Dighal Ata,920,1426,471,686,449,740,39.2,40.7,37.8,00000
93.0,38.0,94.0,856,01,01,  Rayer Makulla,773,971,428,443,345,528,44.3,49.1,39.5,00000
93.0,38.0,94.0,856,02,01,  Chandpur,168,253,103,119,65,134,39.9,46.4,32.7,00000
93.0,38.0,94.0,994,01,01,  Uttar Pathalia,369,459,202,209,167,250,44.6,49.1,40.0,00000
93.0,38.0,94.0,994,02,01,  Lakshmipur,214,147,109,72,105,75,59.3,60.2,58.3,00000
93.0,38.0,94.0,994,03,01,  Padda Pur,99,146,51,68,48,78,40.4,42.9,38.1,00000
93.0,47.0,12.0,060,01,01,  Balla,1275,1182,727,626,548,556,51.9,53.7,49.6,00000
93.0,47.0,12.0,060,02,01,  Dakshin Balla,1358,953,818,500,540,453,58.8,62.1,54.4,00000
93.0,47.0,12.0,060,03,01,  Paschim Balla,1125,1831,694,1137,431,694,38.1,37.9,38.3,00000
93.0,47.0,12.0,060,04,01,  Uttar Balla,2098,1415,1157,700,941,715,59.7,62.3,56.8,00000
93.0,47.0,12.0,829,01,01,  Kokrail,380,602,268,380,112,222,38.7,41.4,33.5,00000
93.0,47.0,12.0,829,02,01,  Momin Nagar,512,935,334,574,178,361,35.4,36.8,33.0,00000
93.0,47.0,12.0,829,03,01,  Uttar Rampur,537,1108,315,639,222,469,32.6,33.0,32.1,00000
93.0,47.0,12.0,829,04,01,  Dakshin Rampur,1011,1866,582,884,429,982,35.1,39.7,30.4,00000
93.0,47.0,12.0,829,05,01,  P.Rampur,1257,2674,723,1307,534,1367,32.0,35.6,28.1,00000
93.0,47.0,14.0,071,01,01,  Bangra,632,219,333,87,299,132,74.3,79.3,69.4,00000
93.0,47.0,14.0,071,02,01,  Bil Barni,484,574,269,265,215,309,45.7,50.4,41.0,00000
93.0,47.0,14.0,337,01,01,  Bhubalia,52,79,29,34,23,45,39.7,46.0,33.8,00000
93.0,47.0,14.0,337,02,01,  Purabi Maijbari,86,127,47,49,39,78,40.4,49.0,33.3,00000
93.0,47.0,14.0,750,01,01,  Pathalia,309,499,177,231,132,268,38.2,43.4,33.0,00000
93.0,47.0,14.0,750,02,01,  Darem Nuhuria,93,171,57,71,36,100,35.2,44.5,26.5,00000
93.0,47.0,21.0,161,01,01,  Noabari,516,435,246,188,270,247,54.3,56.7,52.2,00000
93.0,47.0,21.0,161,02,01,  Marichkura,416,509,192,219,224,290,45.0,46.7,43.6,00000
93.0,47.0,21.0,473,01,01,  Joair,536,1440,268,640,268,800,27.1,29.5,25.1,00000
93.0,47.0,21.0,473,02,01,  Naya Para,145,570,68,250,77,320,20.3,21.4,19.4,00000
93.0,47.0,21.0,818,01,01,  Rajafair Khurda,637,958,318,444,319,514,39.9,41.7,38.3,00000
93.0,47.0,21.0,818,02,01,  Rajafair Bhiti,297,195,151,79,146,116,60.4,65.7,55.7,00000
93.0,47.0,25.0,617,01,01,  Tuni Magra,1027,901,560,417,467,484,53.3,57.3,49.1,00000
93.0,47.0,25.0,617,02,01,  Khash Magra,414,259,244,96,170,163,61.5,71.8,51.1,00000
93.0,47.0,29.0,488,01,01,  Kadim Hamjani,748,1218,403,599,345,619,38.0,40.2,35.8,00000
93.0,47.0,29.0,488,02,01,  Char Hamjani,796,1233,387,588,409,645,39.2,39.7,38.8,00000
93.0,47.0,36.0,090,01,01,  Dhalatia,115,169,61,81,54,88,40.5,43.0,38.0,00000
93.0,47.0,36.0,090,02,01,  Khoaria,123,197,53,96,70,101,38.4,35.6,40.9,00000
93.0,47.0,36.0,090,03,01,  Char Banshi,566,1293,286,614,280,679,30.4,31.8,29.2,00000
93.0,47.0,36.0,360,01,01,  Saya Para,824,772,427,334,397,438,51.6,56.1,47.5,00000
93.0,47.0,36.0,360,02,01,  Khokshabari,169,196,85,93,84,103,46.3,47.8,44.9,00000
93.0,47.0,36.0,765,01,01,  Pauli,890,1067,469,503,421,564,45.5,48.3,42.7,00000
93.0,47.0,36.0,765,02,01,  Fatikjani,291,226,152,104,139,122,56.3,59.4,53.3,00000
55.9,50.4,93.0,047,43,988,Cantonment,428,5,422,5,6,0,98.8,98.8,100.0,00000
93.0,47.0,58.0,082,01,01,  Banira,447,933,218,417,229,516,32.4,34.3,30.7,00000
93.0,47.0,58.0,082,02,01,  Kaguji Para,137,245,76,139,61,106,35.9,35.3,36.5,00000
93.0,47.0,58.0,270,01,01,  Ag Charan,555,710,281,310,274,400,43.9,47.5,40.7,00000
93.0,47.0,58.0,270,02,01,  Pachh Charan,1236,866,621,346,615,520,58.8,64.2,54.2,00000
93.0,47.0,58.0,458,01,01,  Jainabari,232,430,111,205,121,225,35.0,35.1,35.0,00000
93.0,47.0,58.0,458,02,01,  Gaturiabari,72,311,39,158,33,153,18.8,19.8,17.7,00000
93.0,47.0,58.0,570,01,01,  Dakshin Kok Dahara,147,561,76,264,71,297,20.8,22.4,19.3,00000
93.0,47.0,58.0,570,02,01,  Jhatibari,148,475,75,222,73,253,23.8,25.3,22.4,00000
93.0,47.0,58.0,570,03,01,  Uttar Kok Dahara,580,805,301,388,279,417,41.9,43.7,40.1,00000
93.0,47.0,58.0,623,01,01,  Mahish Jora,459,673,261,285,198,388,40.5,47.8,33.8,00000
93.0,47.0,58.0,623,02,01,  Ranihati,114,326,68,147,46,179,25.9,31.6,20.4,00000
93.0,47.0,58.0,690,01,01,  Langoljora,406,782,216,369,190,413,34.2,36.9,31.5,00000
93.0,47.0,58.0,690,02,01,  Hati Para,426,540,217,248,209,292,44.1,46.7,41.7,00000
93.0,47.0,65.0,728,01,01,  Pakutia,297,617,159,268,138,349,32.5,37.2,28.3,00000
93.0,47.0,65.0,728,02,01,  Bir Pakutia,324,432,165,213,159,219,42.9,43.7,42.1,00000
93.0,47.0,65.0,728,03,01,  Hindu Pakutia,283,746,148,352,135,394,27.5,29.6,25.5,00000
93.0,47.0,65.0,882,01,01,  Bhar Sarai,291,324,135,122,156,202,47.3,52.5,43.6,00000
93.0,47.0,65.0,882,02,01,  Chala Sarai,236,360,118,139,118,221,39.6,45.9,34.8,00000
93.0,47.0,73.0,007,01,01,  Adabari,280,474,135,223,145,251,37.1,37.7,36.6,00000
93.0,47.0,73.0,007,02,01,  Madari Para,141,126,70,67,71,59,52.8,51.1,54.6,00000
93.0,47.0,73.0,311,01,01,  Kazi Para,187,331,98,156,89,175,36.1,38.6,33.7,00000
93.0,47.0,73.0,311,02,01,  Daulatpur,474,409,238,172,236,237,53.7,58.0,49.9,00000
93.0,47.0,73.0,375,01,01,  Purba Gharia,205,398,107,177,98,221,34.0,37.7,30.7,00000
93.0,47.0,73.0,375,02,01,  Paschim Gharia,731,623,356,278,375,345,54.0,56.2,52.1,00000
93.0,47.0,73.0,390,01,01,  Gilabari,150,216,60,116,90,100,41.0,34.1,47.4,00000
93.0,47.0,73.0,390,02,01,  Gainabari,49,107,24,51,25,56,31.4,32.0,30.9,00000
93.0,47.0,73.0,390,03,01,  Gram Kachina,103,118,53,55,50,63,46.6,49.1,44.2,00000
93.0,47.0,73.0,630,01,01,  Dari Maista,102,103,51,43,51,60,49.8,54.3,45.9,00000
93.0,47.0,73.0,630,02,01,  Naya Maista,340,221,169,103,171,118,60.6,62.1,59.2,00000
93.0,47.0,73.0,630,03,01,  Kadim Maista,318,241,146,102,172,139,56.9,58.9,55.3,00000
93.0,47.0,73.0,630,04,01,  Tarabwi,168,268,92,107,76,161,38.5,46.2,32.1,00000
93.0,47.0,73.0,634,01,01,  Malati,1150,1786,571,865,579,921,39.2,39.8,38.6,00000
93.0,47.0,73.0,634,02,01,  Dakshin Malati,216,234,116,117,100,117,48.0,49.8,46.1,00000
93.0,47.0,73.0,668,01,01,  Naga Doga,24,38,8,16,16,22,38.7,33.3,42.1,00000
93.0,47.0,73.0,668,02,01,  Naga Selim,142,103,57,51,85,52,58.0,52.8,62.0,00000
93.0,47.0,73.0,668,03,01,  Par Naga,150,143,86,51,64,92,51.2,62.8,41.0,00000
93.0,47.0,73.0,668,04,01,  Saya,69,57,39,24,30,33,54.8,61.9,47.6,00000
93.0,47.0,73.0,672,01,01,  Rishi Para,86,152,47,72,39,80,36.1,39.5,32.8,00000
93.0,47.0,73.0,672,02,01,  Char Nagarbari,309,131,177,54,132,77,70.2,76.6,63.2,00000
93.0,47.0,73.0,672,03,01,  Bir Nagarbari,680,588,329,266,351,322,53.6,55.3,52.2,00000
93.0,47.0,73.0,672,04,01,  Modak Para,261,151,132,52,129,99,63.3,71.7,56.6,00000
93.0,47.0,73.0,672,05,01,  Panch Kaonia,47,48,23,21,24,27,49.5,52.3,47.1,00000
93.0,47.0,73.0,702,01,01,  Lakshmi Narandia,246,399,139,181,107,218,38.1,43.4,32.9,00000
93.0,47.0,73.0,702,02,01,  Kadam Ali,273,349,145,159,128,190,43.9,47.7,40.3,00000
93.0,47.0,83.0,161,01,01,  Bhandeshwar,1783,1934,894,851,889,1083,48.0,51.2,45.1,00000
93.0,47.0,83.0,161,02,01,  Gang Gaita,109,149,50,67,59,82,42.2,42.7,41.8,00000
93.0,47.0,83.0,161,03,01,  Naopara,205,287,107,122,98,165,41.7,46.7,37.3,00000
93.0,47.0,83.0,180,01,01,  Bhial,535,834,292,372,243,462,39.1,44.0,34.5,00000
93.0,47.0,83.0,180,02,01,  Ghoni Para,110,191,58,80,52,111,36.5,42.0,31.9,00000
93.0,47.0,83.0,799,01,01,  Purba Sunda,514,662,259,266,255,396,43.7,49.3,39.2,00000
93.0,47.0,83.0,799,02,01,  Kurata,127,226,64,145,63,81,36.0,30.6,43.8,00000
93.0,47.0,87.0,450,01,01,  Char Jabrajan,155,717,93,336,62,381,17.8,21.7,14.0,00000
93.0,47.0,87.0,450,02,01,  Par Jabrajan,79,167,35,79,44,88,32.1,30.7,33.3,00000
93.0,47.0,87.0,450,03,01,  Meher Jabrajan,97,66,48,20,49,46,59.5,70.6,51.6,00000
93.0,47.0,94.0,229,01,01,  Binnauri,209,154,96,65,113,89,57.6,59.6,55.9,00000
93.0,47.0,94.0,229,02,01,  Gopinathpur,68,227,38,98,30,129,23.1,27.9,18.9,00000
93.0,47.0,94.0,296,01,01,  Dakshin Chamoria,768,1179,401,556,367,623,39.4,41.9,37.1,00000
93.0,47.0,94.0,296,02,01,  Manduria,173,267,92,121,81,146,39.3,43.2,35.7,00000
93.0,47.0,94.0,852,01,01,  Sahadebpur-1,611,1158,341,574,270,584,34.5,37.3,31.6,00000
93.0,47.0,94.0,852,02,01,  Damunda,72,258,33,129,39,129,21.8,20.4,23.2,00000
93.0,47.0,94.0,852,03,01,  Chantia,357,486,183,225,174,261,42.3,44.9,40.0,00000
93.0,57.0,24.0,042,01,01,  Kamar Chala,203,275,106,136,97,139,42.5,43.8,41.1,00000
93.0,57.0,24.0,042,02,01,  Aronakhola,590,1118,301,524,289,594,34.5,36.5,32.7,00000
93.0,57.0,24.0,042,03,01,  Bhutia,974,1064,522,524,452,540,47.8,49.9,45.6,00000
93.0,57.0,24.0,042,04,01,  Amlitala,594,854,308,410,286,444,41.0,42.9,39.2,00000
93.0,57.0,24.0,042,05,01,  Gayra,261,191,138,95,123,96,57.7,59.2,56.2,00000
93.0,57.0,24.0,042,06,01,  Jouli,324,371,173,185,151,186,46.6,48.3,44.8,00000
93.0,57.0,24.0,162,01,01,  Jangalia,1495,1376,850,684,645,692,52.1,55.4,48.2,00000
93.0,57.0,24.0,162,02,01,  Gachua,207,203,107,111,100,92,50.5,49.1,52.1,00000
93.0,57.0,24.0,162,03,01,  Rajabari,147,246,82,122,65,124,37.4,40.2,34.4,00000
93.0,57.0,24.0,162,04,01,  Bari Baid,1615,2468,856,1208,759,1260,39.6,41.5,37.6,00000
93.0,57.0,24.0,298,01,01,  Gobudia,675,1332,329,658,346,674,33.6,33.3,33.9,00000
93.0,57.0,24.0,298,02,01,  Jater Baid,107,168,59,77,48,91,38.9,43.4,34.5,00000
93.0,57.0,24.0,298,03,01,  Polat Para,101,152,54,77,47,75,39.9,41.2,38.5,00000
93.0,57.0,24.0,298,04,01,  Dighal Baid,78,149,41,74,37,75,34.4,35.7,33.0,00000
93.0,57.0,24.0,298,05,01,  Tabe Baid,25,83,7,39,18,44,23.1,15.2,29.0,00000
93.0,57.0,24.0,298,06,01,  Faitamari,133,212,60,105,73,107,38.6,36.4,40.6,00000
93.0,57.0,24.0,298,07,01,  Mayurmara,97,167,49,79,48,88,36.7,38.3,35.3,00000
93.0,57.0,24.0,298,08,01,  Dhanukbadha,511,803,256,417,255,386,38.9,38.0,39.8,00000
93.0,57.0,24.0,298,09,01,  Magundinagar,161,498,86,247,75,251,24.4,25.8,23.0,00000
93.0,57.0,24.0,298,10,01,  Chunia,644,999,330,499,314,500,39.2,39.8,38.6,00000
93.0,57.0,24.0,384,01,01,  Gachhabari,1278,823,617,393,661,430,60.8,61.1,60.6,00000
93.0,57.0,24.0,384,02,01,  Bejurguna,1299,1883,694,907,605,976,40.8,43.3,38.3,00000
93.0,57.0,24.0,384,03,01,  Bangshi Baid,585,1270,302,613,283,657,31.5,33.0,30.1,00000
93.0,57.0,24.0,824,01,01,  Angaria,598,895,303,437,295,458,40.1,40.9,39.2,00000
93.0,57.0,24.0,824,02,01,  Malaid,205,169,105,80,100,89,54.8,56.8,52.9,00000
93.0,57.0,24.0,824,03,01,  Mominpur,403,1042,192,529,211,513,27.9,26.6,29.1,00000
93.0,57.0,24.0,824,04,01,  Darati,651,729,334,390,317,339,47.2,46.1,48.3,00000
93.0,57.0,24.0,824,05,01,  Pirgacha,382,777,201,389,181,388,33.0,34.1,31.8,00000
93.0,57.0,24.0,824,06,01,  Deogacha,160,555,78,286,82,269,22.4,21.4,23.4,00000
93.0,57.0,24.0,824,07,01,  Bhabantaki,194,275,93,156,101,119,41.4,37.3,45.9,00000
93.0,57.0,24.0,824,08,01,  Sainamari(Part-01),179,648,93,344,86,304,21.6,21.3,22.1,00000
93.0,57.0,24.0,828,01,01,  Purba Pirojpur,1157,2163,605,1083,552,1080,34.8,35.8,33.8,00000
93.0,57.0,24.0,828,02,01,  Paschim Pirojpur,1054,1863,534,921,520,942,36.1,36.7,35.6,00000
93.0,57.0,28.0,055,01,01,  Shah Para,506,915,255,447,251,468,35.6,36.3,34.9,00000
93.0,57.0,28.0,055,02,01,  Lain Para,545,939,283,449,262,490,36.7,38.7,34.8,00000
93.0,57.0,28.0,055,03,01,  Motpara,650,762,293,380,357,382,46.0,43.5,48.3,00000
93.0,57.0,28.0,055,04,01,  Bokar Baid,1018,1686,501,822,517,864,37.6,37.9,37.4,00000
93.0,57.0,28.0,687,01,01,  Sherpur,493,1386,258,662,235,724,26.2,28.0,24.5,00000
93.0,57.0,28.0,687,02,01,  Sing Chala,1352,2204,662,1022,690,1182,38.0,39.3,36.9,00000
93.0,57.0,28.0,687,03,01,  Bechuagani,924,1737,506,797,418,940,34.7,38.8,30.8,00000
93.0,57.0,28.0,687,04,01,  Dighal Baid,1081,2255,568,1069,513,1186,32.4,34.7,30.2,00000
93.0,57.0,92.0,042,01,01,  Katajany,181,788,80,410,101,378,18.7,16.3,21.1,00000
93.0,57.0,92.0,042,02,01,  Kajai,71,186,40,94,31,92,27.6,29.9,25.2,00000
93.0,57.0,92.0,042,03,01,  Ponamary,158,384,68,184,90,200,29.2,27.0,31.0,00000
93.0,57.0,92.0,042,04,01,  Harindara,126,559,68,283,58,276,18.4,19.4,17.4,00000
93.0,57.0,92.0,042,05,01,  Baduria,107,172,59,81,48,91,38.4,42.1,34.5,00000
93.0,57.0,92.0,042,06,01,  Bondora,71,224,31,111,40,113,24.1,21.8,26.1,00000
93.0,57.0,92.0,042,07,01,  Jalabada,104,179,52,99,52,80,36.7,34.4,39.4,00000
93.0,57.0,92.0,042,08,01,  Kakraguni,191,218,110,113,81,105,46.7,49.3,43.5,00000
93.0,57.0,92.0,042,09,01,  Joyanagachha,199,388,92,216,107,172,33.9,29.9,38.4,00000
93.0,57.0,92.0,042,10,01,  Sadhu Para,116,232,62,123,54,109,33.3,33.5,33.1,00000
93.0,57.0,92.0,042,11,01,  Chonia,409,239,254,121,155,118,63.1,67.7,56.8,00000
93.0,57.0,92.0,042,12,01,  Gilagachha,101,232,42,122,59,110,30.3,25.6,34.9,00000
93.0,57.0,92.0,217,01,01,  Pirgachha,501,537,199,261,302,276,48.3,43.3,52.2,00000
93.0,57.0,92.0,217,02,01,  Thanarbaid,281,262,151,121,130,141,51.7,55.5,48.0,00000
93.0,57.0,92.0,217,03,01,  Jalichera,153,148,75,76,78,72,50.8,49.7,52.0,00000
93.0,57.0,92.0,217,04,01,  Banaria,89,114,46,63,43,51,43.8,42.2,45.7,00000
93.0,57.0,92.0,217,05,01,  Mahismara,262,525,136,248,126,277,33.3,35.4,31.3,00000
93.0,57.0,92.0,217,06,01,  Sainamari (Part-02),132,132,70,69,62,63,50.0,50.4,49.6,00000
93.0,57.0,92.0,375,01,01,  Ramkrishnapur,289,347,145,163,144,184,45.4,47.1,43.9,00000
93.0,57.0,92.0,375,02,01,  Baratal,98,241,48,124,50,117,28.9,27.9,29.9,00000
93.0,57.0,92.0,375,03,01,  Hialer Chala,188,447,91,227,97,220,29.6,28.6,30.6,00000
93.0,57.0,92.0,375,04,01,  Jamgaichha,195,474,83,243,112,231,29.1,25.5,32.7,00000
93.0,57.0,92.0,375,05,01,  Baidar Chala,105,569,56,274,49,295,15.6,17.0,14.2,00000
93.0,57.0,92.0,375,06,01,  Chandpur,151,444,74,232,77,212,25.4,24.2,26.6,00000
93.0,57.0,92.0,375,07,01,  Ragamary,118,246,56,116,62,130,32.4,32.6,32.3,00000
93.0,57.0,92.0,375,08,01,  Baghadoba,134,212,68,109,66,103,38.7,38.4,39.1,00000
93.0,57.0,92.0,533,01,01,  Hagurakuri,233,538,132,263,101,275,30.2,33.4,26.9,00000
93.0,57.0,92.0,533,02,01,  Kailakuri,257,737,131,361,126,376,25.9,26.6,25.1,00000
93.0,57.0,92.0,533,03,01,  Sabakchana,387,721,190,359,197,362,34.9,34.6,35.2,00000
93.0,57.0,92.0,533,04,01,  Mantala,202,500,101,254,101,246,28.8,28.5,29.1,00000
93.0,57.0,92.0,533,05,01,  Sheristal,160,296,64,144,96,152,35.1,30.8,38.7,00000
93.0,57.0,92.0,533,06,01,  Sonatan,92,259,47,120,45,139,26.2,28.1,24.5,00000
93.0,57.0,92.0,533,07,01,  Hatimara,79,275,38,144,41,131,22.3,20.9,23.8,00000
93.0,57.0,92.0,939,01,01,  Sholakuri,1224,2109,635,996,589,1113,36.7,38.9,34.6,00000
93.0,57.0,92.0,939,02,01,  Baraikuri,421,624,226,300,195,324,40.3,43.0,37.6,00000
93.0,57.0,92.0,939,03,01,  Dawar Chala,335,549,179,260,156,289,37.9,40.8,35.1,00000
93.0,57.0,92.0,939,04,01,  Dighirpar,323,683,158,328,165,355,32.1,32.5,31.7,00000
93.0,57.0,92.0,939,05,01,  Mominbag,288,598,141,277,147,321,32.5,33.7,31.4,00000
93.0,57.0,92.0,939,06,01,  Kuralia,181,269,81,128,100,141,40.2,38.8,41.5,00000
93.0,57.0,92.0,939,07,01,  Garovita,87,283,39,139,48,144,23.5,21.9,25.0,00000
93.0,57.0,92.0,939,08,01,  Gazirvita,72,319,30,154,42,165,18.4,16.3,20.3,00000
93.0,66.0,23.0,105,01,01,  Bahuria,1698,1485,865,661,833,824,53.3,56.7,50.3,00000
93.0,66.0,23.0,105,02,01,  Budir  Para,417,395,216,172,201,223,51.4,55.7,47.4,00000
93.0,66.0,23.0,105,03,01,  Mandira Para,490,268,232,114,258,154,64.6,67.1,62.6,00000
93.0,66.0,23.0,105,04,01,  Bahuria Char Para,214,123,93,63,121,60,63.5,59.6,66.9,00000
93.0,66.0,23.0,105,05,01,  Atharadana,133,138,61,61,72,77,49.1,50.0,48.3,00000
93.0,66.0,39.0,211,01,01,  Bhatgram,985,1036,550,421,435,615,48.7,56.6,41.4,00000
93.0,66.0,39.0,211,02,01,  Ruhitpur,148,195,71,80,77,115,43.1,47.0,40.1,00000
93.0,66.0,47.0,918,01,01,  Subhulla,947,773,446,324,501,449,55.1,57.9,52.7,00000
93.0,66.0,47.0,918,02,01,  Sayednga,153,153,74,65,79,88,50.0,53.2,47.3,00000
93.0,66.0,47.0,975,01,01,  Thal Para,1722,1500,828,655,894,845,53.4,55.8,51.4,00000
93.0,66.0,47.0,975,02,01,  Bailan Pur,226,99,113,33,113,66,69.5,77.4,63.1,00000
93.0,66.0,47.0,975,03,01,  Bankata,157,522,82,247,75,275,23.1,24.9,21.4,00000
93.0,66.0,67.0,427,01,03,  Bandar Mara,260,277,120,115,140,162,48.4,51.1,46.4,00000
93.0,66.0,67.0,427,02,03,  Trimohan,622,445,315,190,307,255,58.3,62.4,54.6,00000
93.0,66.0,67.0,466,01,01,  Gorakhi (Garaki),533,477,271,203,262,274,52.8,57.2,48.9,00000
93.0,66.0,67.0,466,02,01,  Garaki,322,546,160,244,162,302,37.1,39.6,34.9,00000
93.0,66.0,71.0,523,01,01,  Hilora,992,797,498,359,494,438,55.4,58.1,53.0,00000
93.0,66.0,71.0,523,02,01,  Hilora Adabari,837,1010,424,480,413,530,45.3,46.9,43.8,00000
93.0,66.0,71.0,677,01,01,  Mahera,580,837,270,374,310,463,40.9,41.9,40.1,00000
93.0,66.0,71.0,677,02,01,  Swalpa Mahera,814,597,375,258,439,339,57.7,59.2,56.4,00000
93.0,66.0,71.0,677,03,01,  Mahera Police Training Center,1438,2,1418,0,20,2,99.9,100.0,90.9,00000
93.0,66.0,94.0,567,01,01,  Old Kahela,440,267,210,113,230,154,62.2,65.0,59.9,00000
93.0,66.0,94.0,567,02,01,  Natun Kahela,558,291,287,122,271,169,65.7,70.2,61.6,00000
93.0,66.0,94.0,740,01,01,  Nagar Bhadgram,792,475,418,210,374,265,62.5,66.6,58.5,00000
93.0,66.0,94.0,740,02,01,  Andi Para,226,95,123,36,103,59,70.4,77.4,63.6,00000
93.0,66.0,94.0,740,03,01,  Kanda Para,299,171,159,80,140,91,63.6,66.5,60.6,00000
93.0,66.0,94.0,740,04,01,  Naya Para,472,312,241,121,231,191,60.2,66.6,54.7,00000
93.0,76.0,14.0,011,01,01,  Paschim Ag Dighalia,337,919,189,428,148,491,26.8,30.6,23.2,00000
93.0,76.0,14.0,011,02,01,  Purba Ag Dighalia,632,1626,351,751,281,875,28.0,31.9,24.3,00000
93.0,76.0,14.0,194,01,01,  Bharra,700,776,348,358,352,418,47.4,49.3,45.7,00000
93.0,76.0,14.0,194,02,01,  Char Bharra,566,1076,271,482,295,594,34.5,36.0,33.2,00000
93.0,76.0,14.0,368,01,01,  Deojan Salil,233,439,118,191,115,248,34.7,38.2,31.7,00000
93.0,76.0,14.0,368,02,01,  Rehai Mirkutia,113,306,64,133,49,173,27.0,32.5,22.1,00000
93.0,76.0,14.0,368,03,01,  Adajan,49,127,32,47,17,80,27.8,40.5,17.5,00000
93.0,76.0,14.0,681,01,01,  Mirkutia,253,579,125,254,128,325,30.4,33.0,28.3,00000
93.0,76.0,14.0,681,02,01,  Subarnatali,250,323,131,155,119,168,43.6,45.8,41.5,00000
93.0,76.0,21.0,208,01,01,  Rehi Bhugolhat,204,377,111,175,93,202,35.1,38.8,31.5,00000
93.0,76.0,21.0,208,02,01,  Khas Bhugolhat,324,723,169,325,155,398,30.9,34.2,28.0,00000
93.0,76.0,21.0,400,01,01,  Duptiair,815,1176,462,516,353,660,40.9,47.2,34.8,00000
93.0,76.0,21.0,400,02,01,  Hat Kakna,15,10,7,4,8,6,60.0,63.6,57.1,00000
93.0,76.0,21.0,507,01,01,  Jalai,347,737,203,322,144,415,32.0,38.7,25.8,00000
93.0,76.0,21.0,507,02,01,  Char Jalai,121,195,61,86,60,109,38.3,41.5,35.5,00000
93.0,76.0,21.0,731,01,01,  Nischintapur,507,1425,287,634,220,791,26.2,31.2,21.8,00000
93.0,76.0,21.0,731,02,01,  Bazuartak,148,437,99,175,49,262,25.3,36.1,15.8,00000
93.0,76.0,21.0,731,03,01,  Tanti Nischintapur,119,218,79,93,40,125,35.3,45.9,24.2,00000
93.0,76.0,21.0,731,04,01,  Fayezpur,260,779,164,357,96,422,25.0,31.5,18.5,00000
93.0,76.0,21.0,736,01,01,  Pachh Arra,359,430,210,197,149,233,45.5,51.6,39.0,00000
93.0,76.0,21.0,736,02,01,  Balia Bandar,157,167,80,74,77,93,48.5,51.9,45.3,00000
93.0,76.0,43.0,429,01,01,  Gayhata Naya Para,515,397,244,170,271,227,56.5,58.9,54.4,00000
93.0,76.0,43.0,429,02,01,  Purba Gayhata,1029,501,511,216,518,285,67.3,70.3,64.5,00000
93.0,76.0,43.0,429,03,01,  Agar Gayhata,940,643,464,301,476,342,59.4,60.7,58.2,00000
93.0,76.0,43.0,429,04,01,  Paschim Gayhata,866,790,440,344,426,446,52.3,56.1,48.9,00000
93.0,76.0,43.0,429,05,01,  Shantinagar,524,340,229,130,295,210,60.6,63.8,58.4,00000
93.0,76.0,58.0,667,01,01,  Mamudnagar,2159,4450,1087,1995,1072,2455,32.7,35.3,30.4,00000
93.0,76.0,58.0,667,02,01,  Sreebartia,339,890,172,414,167,476,27.6,29.4,26.0,00000
93.0,76.0,58.0,667,03,01,  Charabagh,198,487,99,220,99,267,28.9,31.0,27.0,00000
93.0,76.0,73.0,029,01,01,  Andhibari,482,380,252,169,230,211,55.9,59.9,52.2,00000
93.0,76.0,73.0,029,02,01,  Kalsi Para,85,381,53,170,32,211,18.2,23.8,13.2,00000
93.0,76.0,73.0,069,01,03,  Babna Para,2409,1330,1245,605,1164,725,64.4,67.3,61.6,00000
93.0,76.0,73.0,069,02,03,  Mirnagar,446,523,243,234,203,289,46.0,50.9,41.3,00000
93.0,76.0,73.0,568,01,01,  Char Kathuri,118,315,55,139,63,176,27.3,28.4,26.4,00000
93.0,76.0,73.0,568,02,01,  Shib Kathuri,233,568,119,267,114,301,29.1,30.8,27.5,00000
93.0,76.0,73.0,568,03,01,  Senchikata,242,229,124,96,118,133,51.4,56.4,47.0,00000
93.0,76.0,73.0,568,04,01,  Khamar Kathuri,107,100,58,43,49,57,51.7,57.4,46.2,00000
93.0,76.0,73.0,786,01,01,  Panan,589,957,315,422,274,535,38.1,42.7,33.9,00000
93.0,76.0,73.0,786,02,01,  Char Panan,208,474,109,203,99,271,30.5,34.9,26.8,00000
93.0,76.0,87.0,342,01,01,  Chowdhurydanga,348,533,170,240,178,293,39.5,41.5,37.8,00000
93.0,76.0,87.0,342,02,01,  Char Danga,369,453,184,214,185,239,44.9,46.2,43.6,00000
93.0,76.0,87.0,342,03,01,  Danga Salin Para,160,734,87,331,73,403,17.9,20.8,15.3,00000
93.0,76.0,87.0,342,04,01,  Danga Dhala Para (D),191,324,89,150,102,174,37.1,37.2,37.0,00000
93.0,76.0,87.0,612,01,01,  Kokadair,817,879,381,393,436,486,48.2,49.2,47.3,00000
93.0,76.0,87.0,612,02,01,  Batra,716,679,377,288,339,391,51.3,56.7,46.4,00000
93.0,76.0,87.0,710,01,01,  Nalsandhya,239,334,123,149,116,185,41.7,45.2,38.5,00000
93.0,76.0,87.0,710,02,01,  Baddakar Para,44,243,32,112,12,131,15.3,22.2,8.4,00000
93.0,76.0,87.0,713,01,01,  Purba Nanda Para,952,625,483,261,469,364,60.4,64.9,56.3,00000
93.0,76.0,87.0,713,02,01,  Paschim Nanda Para,476,552,225,256,251,296,46.3,46.8,45.9,00000
93.0,76.0,87.0,864,01,01,  Palpara,321,392,155,177,166,215,45.0,46.7,43.6,00000
93.0,76.0,87.0,864,02,01,  Sahabatpur,669,655,368,278,301,377,50.5,57.0,44.4,00000
93.0,76.0,87.0,962,01,01,  Noapara,76,42,36,16,40,26,64.4,69.2,60.6,00000
93.0,76.0,87.0,962,02,01,  Puratan Para,390,516,178,232,212,284,43.0,43.4,42.7,00000
93.0,85.0,27.0,342,01,01,  Dariapur,2400,2880,1159,1226,1241,1654,45.5,48.6,42.9,00000
93.0,85.0,27.0,342,02,01,  Akanda Para,443,418,235,180,208,238,51.5,56.6,46.6,00000
93.0,85.0,27.0,388,01,03,  Kalian Para,879,1332,457,592,422,740,39.8,43.6,36.3,00000
93.0,85.0,27.0,388,02,03,  Gazaria,665,876,333,375,332,501,43.2,47.0,39.9,00000
93.0,85.0,27.0,388,03,03,  Kirtankhila,1127,1381,579,601,548,780,44.9,49.1,41.3,00000
93.0,85.0,27.0,792,01,01,  Mocharia Pathar,1980,3031,1051,1315,929,1716,39.5,44.4,35.1,00000
93.0,85.0,27.0,792,02,01,  Isa Dighi,591,1031,314,421,277,610,36.4,42.7,31.2,00000
93.0,85.0,27.0,792,03,01,  Dabail Para,186,478,81,207,105,271,28.0,28.1,27.9,00000
93.0,85.0,54.0,823,01,01,  Pahar Kanchanpur,441,681,221,301,220,380,39.3,42.3,36.7,00000
93.0,85.0,54.0,823,02,01,  Bimanbahini Ghati,465,63,292,26,173,37,88.1,91.8,82.4,00000
93.0,85.0,67.0,373,01,01,  Dhandhania,54,110,36,56,18,54,32.9,39.1,25.0,00000
93.0,85.0,67.0,373,02,01,  Jitashari,398,869,199,373,199,496,31.4,34.8,28.6,00000
93.0,85.0,67.0,373,03,01,  Binnakharia,13,94,8,45,5,49,12.1,15.1,9.3,00000
93.0,85.0,67.0,373,04,01,  Sirir Chala,150,171,77,73,73,98,46.7,51.3,42.7,00000
93.0,85.0,67.0,373,05,01,  Bara Baid,199,249,103,112,96,137,44.4,47.9,41.2,00000
93.0,85.0,67.0,373,06,01,  Marichkuri,52,91,21,40,31,51,36.4,34.4,37.8,00000
93.0,85.0,67.0,373,07,01,  Chhota Chauna,280,710,159,313,121,397,28.3,33.7,23.4,00000
93.0,85.0,67.0,373,08,01,  Payna Baid,51,92,22,38,29,54,35.7,36.7,34.9,00000
93.0,85.0,67.0,419,01,01,  Garbari,172,173,85,71,87,102,49.9,54.5,46.0,00000
93.0,85.0,67.0,419,02,01,  Fuldanir Chala,333,411,169,176,164,235,44.8,49.0,41.1,00000
93.0,85.0,67.0,419,03,01,  Badgarbari,297,516,144,212,153,304,36.5,40.4,33.5,00000
93.0,85.0,67.0,419,04,01,  Bara Mandalia,147,204,80,86,67,118,41.9,48.2,36.2,00000
93.0,85.0,67.0,419,05,01,  Taildara,233,399,110,166,123,233,36.9,39.9,34.6,00000
93.0,85.0,67.0,419,06,01,  Dighir Chala,337,593,156,246,181,347,36.2,38.8,34.3,00000
93.0,85.0,67.0,419,07,01,  Naindabhanga,114,130,61,59,53,71,46.7,50.8,42.7,00000
93.0,85.0,67.0,419,08,01,  Chak Para,148,186,75,88,73,98,44.3,46.0,42.7,00000
93.0,85.0,67.0,419,09,01,  Bara Chala,99,220,57,95,42,125,31.0,37.5,25.1,00000
93.0,85.0,67.0,419,10,01,  Uttar Bagherbari,350,661,169,287,181,374,34.6,37.1,32.6,00000
93.0,85.0,67.0,528,01,01,  Indrajani,872,1819,458,818,414,1001,32.4,35.9,29.3,00000
93.0,85.0,67.0,528,02,01,  Gobar Chak,393,756,187,325,206,431,34.2,36.5,32.3,00000
93.0,85.0,67.0,609,01,01,  Kakrajan,247,783,120,352,127,431,24.0,25.4,22.8,00000
93.0,85.0,67.0,609,02,01,  Noali Chala,172,307,80,125,92,182,35.9,39.0,33.6,00000
93.0,85.0,67.0,609,03,01,  Ambagh,228,609,106,272,122,337,27.2,28.0,26.6,00000
93.0,85.0,67.0,609,04,01,  Burir Chala,176,489,78,223,98,266,26.5,25.9,26.9,00000
93.0,85.0,67.0,609,05,01,  Durgapur,266,677,143,309,123,368,28.2,31.6,25.1,00000
93.0,85.0,67.0,609,06,01,  Haringa Chala,274,738,149,315,125,423,27.1,32.1,22.8,00000
93.0,85.0,67.0,609,07,01,  Berikhola,550,574,269,231,281,343,48.9,53.8,45.0,00000
93.0,85.0,67.0,609,08,01,  Sapia Chala,210,215,101,82,109,133,49.4,55.2,45.0,00000
93.0,85.0,67.0,777,01,01,  Mahnandapur,565,865,316,370,249,495,39.5,46.1,33.5,00000
93.0,85.0,67.0,777,02,01,  Bashar Chala,252,386,127,166,125,220,39.5,43.3,36.2,00000
93.0,85.0,81.0,139,01,01,  Bara Chowna,1337,1181,731,529,606,652,53.1,58.0,48.2,00000
93.0,85.0,81.0,139,02,01,  Chatan Para,373,678,179,324,194,354,35.5,35.6,35.4,00000
93.0,85.0,81.0,139,03,01,  Jamal Hatkora,603,963,296,439,307,524,38.5,40.3,36.9,00000
93.0,85.0,81.0,139,04,01,  Chambaltala,355,703,181,334,174,369,33.6,35.1,32.0,00000
93.0,85.0,81.0,139,05,01,  Daripaka,964,1920,482,833,482,1087,33.4,36.7,30.7,00000
93.0,85.0,81.0,139,06,01,  Sonatala,239,308,125,132,114,176,43.7,48.6,39.3,00000
93.0,85.0,81.0,139,07,01,  Bannakhaira,411,943,182,432,229,511,30.4,29.6,30.9,00000
93.0,85.0,81.0,621,01,01,  Aripara,720,1669,369,735,351,934,30.1,33.4,27.3,00000
93.0,85.0,81.0,621,02,01,  Machia,292,541,155,244,137,297,35.1,38.8,31.6,00000
93.0,85.0,81.0,621,03,01,  Baniar Shit,711,856,335,411,376,445,45.4,44.9,45.8,00000
93.0,85.0,81.0,621,04,01,  Debraj,557,781,283,345,274,436,41.6,45.1,38.6,00000
93.0,85.0,81.0,621,05,01,  Khaliar Baid,330,1041,160,465,170,576,24.1,25.6,22.8,00000
93.0,85.0,81.0,621,06,01,  Nischintapur,349,623,153,286,196,337,35.9,34.9,36.8,00000
93.0,85.0,81.0,621,07,01,  Daria Purba Para,316,464,159,183,157,281,40.5,46.5,35.8,00000
93.0,85.0,81.0,621,08,01,  Dakatia Para,192,305,98,129,94,176,38.6,43.2,34.8,00000
93.0,85.0,81.0,621,09,01,  Damia,221,413,101,190,120,223,34.9,34.7,35.0,00000
93.0,85.0,81.0,652,01,01,  Sharasia,448,661,227,293,221,368,40.4,43.7,37.5,00000
93.0,85.0,81.0,652,02,01,  Nayar Chala,87,415,35,185,52,230,17.3,15.9,18.4,00000
93.0,85.0,81.0,652,03,01,  Baoikhola,280,488,139,220,141,268,36.5,38.7,34.5,00000
93.0,85.0,81.0,652,04,01,  Dhali Para,395,544,181,249,214,295,42.1,42.1,42.0,00000
93.0,85.0,81.0,652,05,01,  Kachua Para,181,405,76,193,105,212,30.9,28.3,33.1,00000
93.0,85.0,81.0,652,06,01,  Ramkha Para,173,330,87,146,86,184,34.4,37.3,31.9,00000
93.0,85.0,81.0,652,07,01,  Bandeshwar Para,423,427,198,187,225,240,49.8,51.4,48.4,00000
93.0,85.0,81.0,652,08,01,  Jowar Para,374,592,187,258,187,334,38.7,42.0,35.9,00000
93.0,85.0,81.0,652,09,01,  Bashar Chala,293,586,139,264,154,322,33.3,34.5,32.4,00000
93.0,85.0,81.0,652,10,01,  Ghonar Chala,431,565,202,233,229,332,43.3,46.4,40.8,00000
93.0,85.0,81.0,652,11,01,  Debal Chala,327,434,158,177,169,257,43.0,47.2,39.7,00000
93.0,85.0,81.0,746,01,01,  Kutubpur,556,942,305,438,251,504,37.1,41.0,33.2,00000
93.0,85.0,81.0,746,02,01,  Suknar Shit,186,308,89,136,97,172,37.7,39.6,36.1,00000
93.0,85.0,81.0,746,03,01,  Isamari,824,1141,452,510,372,631,41.9,47.0,37.1,00000
93.0,85.0,81.0,746,04,01,  Ekuira,192,679,86,296,106,383,22.0,22.5,21.7,00000
93.0,85.0,81.0,746,05,01,  Binnauri,136,281,70,141,66,140,32.6,33.2,32.0,00000
93.0,85.0,81.0,746,06,01,  Sreepur,259,637,138,289,121,348,28.9,32.3,25.8,00000
93.0,85.0,81.0,746,07,01,  Charibaida,327,399,165,173,162,226,45.0,48.8,41.8,00000
93.0,85.0,81.0,746,08,01,  Chitar Chala,189,284,95,131,94,153,40.0,42.0,38.1,00000
93.0,85.0,81.0,746,09,01,  Shaplar Para,441,809,234,368,207,441,35.3,38.9,31.9,00000
93.0,95.0,37.0,228,01,01,  Uttar Bil Muril,403,379,224,150,179,229,51.5,59.9,43.9,00000
93.0,95.0,37.0,228,02,01,  Dakshin Bil Muril,213,150,120,60,93,90,58.7,66.7,50.8,00000
93.0,95.0,37.0,487,01,01,  Gopalpur,1492,1812,793,814,699,998,45.2,49.3,41.2,00000
93.0,95.0,39.0,142,01,01,  Bausa,1453,1194,764,536,689,658,54.9,58.8,51.2,00000
93.0,95.0,39.0,142,02,01,  Bashar Char,212,284,123,115,89,169,42.7,51.7,34.5,00000
93.0,95.0,39.0,416,01,01,  Fatehpur,1579,1744,850,736,729,1008,47.5,53.6,42.0,00000
93.0,95.0,39.0,416,02,01,  Char Fatehpur,311,655,171,306,140,349,32.2,35.8,28.6,00000
93.0,95.0,39.0,416,03,01,  Maisakanda,454,552,251,236,203,316,45.1,51.5,39.1,00000
93.0,95.0,41.0,706,01,01,  Batchanda,570,669,299,301,271,368,46.0,49.8,42.4,00000
93.0,95.0,41.0,706,02,01,  Magur Ata,287,353,144,162,143,191,44.8,47.1,42.8,00000
93.0,95.0,41.0,706,03,01,  Kasta Para (Vill),124,64,70,31,54,33,66.0,69.3,62.1,00000
93.0,95.0,41.0,706,04,01,  Shunya Tek (Vill),18,24,8,12,10,12,42.9,40.0,45.5,00000
93.0,95.0,41.0,899,01,01,  Sadullapur,1038,852,564,411,474,441,54.9,57.8,51.8,00000
93.0,95.0,41.0,899,02,01,  Bil Magur Ata,394,458,226,203,168,255,46.2,52.7,39.7,00000
93.0,95.0,47.0,966,01,01,  Surancha,1258,2117,637,972,621,1145,37.3,39.6,35.2,00000
93.0,95.0,47.0,966,02,01,  Khupipara,112,231,60,108,52,123,32.7,35.7,29.7,00000
93.0,95.0,53.0,521,01,01,  Hugra Uttar,1038,2058,609,951,429,1107,33.5,39.0,27.9,00000
93.0,95.0,53.0,521,02,01,  Daskhin Hugra,263,351,157,156,106,195,42.8,50.2,35.2,00000
93.0,95.0,53.0,521,03,01,  Purba Hugra,822,1083,456,455,366,628,43.1,50.1,36.8,00000
93.0,95.0,65.0,295,01,01,  Chaubaria,1063,1616,579,743,484,873,39.7,43.8,35.7,00000
93.0,95.0,65.0,295,02,01,  Chakdia,42,127,21,61,21,66,24.9,25.6,24.1,00000
93.0,95.0,65.0,471,01,01,  Ghosh Para,184,191,89,85,95,106,49.1,51.1,47.3,00000
93.0,95.0,65.0,471,02,01,  Hatgaria,61,79,30,34,31,45,43.6,46.9,40.8,00000
93.0,95.0,65.0,880,01,01,  Rashidpur,292,634,155,270,137,364,31.5,36.5,27.3,00000
93.0,95.0,65.0,880,02,01,  Bujrak Baruh,73,128,36,57,37,71,36.3,38.7,34.3,00000
93.0,95.0,71.0,038,01,01,  Amarpur,518,1114,298,549,220,565,31.7,35.2,28.0,00000
93.0,95.0,71.0,038,02,01,  Jawgara,91,213,48,113,43,100,29.9,29.8,30.1,00000
93.0,95.0,71.0,290,01,01,  Char Pauli Uttar Para,1270,2569,708,1214,562,1355,33.1,36.8,29.3,00000
93.0,95.0,71.0,290,02,01,  Purbapara,243,1275,144,640,99,635,16.0,18.4,13.5,00000
93.0,95.0,71.0,290,03,01,  Madhyapara,746,1713,390,853,356,860,30.3,31.4,29.3,00000
93.0,95.0,71.0,290,04,01,  Dakshinpara,414,912,234,447,180,465,31.2,34.4,27.9,00000
93.0,95.0,71.0,571,01,01,  Kakua,405,653,231,307,174,346,38.3,42.9,33.5,00000
93.0,95.0,71.0,571,02,01,  Kalikeutil,572,846,341,388,231,458,40.3,46.8,33.5,00000
93.0,95.0,77.0,102,01,01,  Bara Basalia,1895,2431,1010,1139,885,1292,43.8,47.0,40.7,00000
93.0,95.0,77.0,102,02,01,  Dighibil,198,193,108,81,90,112,50.6,57.1,44.6,00000
93.0,95.0,77.0,199,01,01,  Bhayeta,482,273,242,113,240,160,63.8,68.2,60.0,00000
93.0,95.0,77.0,199,02,01,  Char Bhayeta,85,64,50,26,35,38,57.0,65.8,47.9,00000
93.0,95.0,77.0,202,01,01,  Bhitar Shimul,257,445,134,204,123,241,36.6,39.6,33.8,00000
93.0,95.0,77.0,202,02,01,  Joykrishnapur,62,97,32,43,30,54,39.0,42.7,35.7,00000
93.0,95.0,77.0,649,01,01,  Char Khaidair,446,581,249,254,197,327,43.4,49.5,37.6,00000
93.0,95.0,77.0,649,02,01,  Khaidair,436,414,254,181,182,233,51.3,58.4,43.9,00000
93.0,95.0,80.0,629,01,01,  Hasanabad,1384,1476,756,633,628,843,48.4,54.4,42.7,00000
93.0,95.0,80.0,629,02,01,  Sehartail,418,1006,232,459,186,547,29.4,33.6,25.4,00000
93.0,95.0,80.0,642,01,01,  Khas Chand Bayra,13,17,8,6,5,11,43.3,57.1,31.3,00000
93.0,95.0,80.0,642,02,01,  Chand Bayra,53,73,32,34,21,39,42.1,48.5,35.0,00000
93.0,95.0,80.0,825,01,01,  Par Bahuli,663,1432,378,660,285,772,31.6,36.4,27.0,00000
93.0,95.0,80.0,825,02,01,  Chakbedani,2,67,2,34,0,33,2.9,5.6,0.0,00000
93.0,95.0,90.0,180,01,01,  Belta Sarai,1877,2961,971,1409,906,1552,38.8,40.8,36.9,00000
93.0,95.0,90.0,180,02,01,  Paniabanda,418,684,220,328,198,356,37.9,40.1,35.7,00000
93.0,95.0,90.0,180,03,01,  Santosh Matbari,42,16,21,4,21,12,72.4,84.0,63.6,00000
48.0,2.0,11.0,033,01,01,  Nurpur,1094,1803,512,889,582,914,37.8,36.5,38.9,00000
48.0,2.0,11.0,033,02,01,  Balur Char,239,696,120,335,119,361,25.6,26.4,24.8,00000
48.0,2.0,11.0,033,03,01,  Adampur,371,1023,179,490,192,533,26.6,26.8,26.5,00000
48.0,2.0,11.0,050,01,01,  Ayanarkandi,303,462,161,218,142,244,39.6,42.5,36.8,00000
48.0,2.0,11.0,050,02,01,  Bairagikandi,1055,2239,566,1031,489,1208,32.0,35.4,28.8,00000
48.0,2.0,11.0,050,03,01,  Tokarkandi,192,914,101,432,91,482,17.4,18.9,15.9,00000
48.0,2.0,11.0,050,04,01,  Nayahati,239,652,128,315,111,337,26.8,28.9,24.8,00000
48.0,2.0,11.0,050,05,01,  Laura,218,634,134,276,84,358,25.6,32.7,19.0,00000
48.0,2.0,11.0,050,06,01,  Jabbar Langha,119,318,57,164,62,154,27.2,25.8,28.7,00000
48.0,2.0,11.0,050,07,01,  Chikna Kandi,40,104,19,53,21,51,27.8,26.4,29.2,00000
48.0,2.0,11.0,252,01,01,  Bhatura,334,372,170,155,164,217,47.3,52.3,43.0,00000
48.0,2.0,11.0,252,02,01,  Isapur,523,431,295,210,228,221,54.8,58.4,50.8,00000
48.0,2.0,11.0,252,03,01,  Sitarampur,35,150,19,80,16,70,18.9,19.2,18.6,00000
48.0,2.0,11.0,387,01,01,  Chaudanta,721,745,386,305,335,440,49.2,55.9,43.2,00000
48.0,2.0,11.0,387,02,01,  Islam Pur,188,699,98,363,90,336,21.2,21.3,21.1,00000
48.0,2.0,35.0,151,01,01,  Bangal Para,777,708,398,313,379,395,52.3,56.0,49.0,00000
48.0,2.0,35.0,151,02,01,  Rathani,527,1071,268,506,259,565,33.0,34.6,31.4,00000
48.0,2.0,35.0,151,03,01,  Anwarpur,273,1011,141,487,132,524,21.3,22.5,20.1,00000
48.0,2.0,35.0,742,01,01,  Laura,411,601,237,310,174,291,40.6,43.3,37.4,00000
48.0,2.0,35.0,742,02,01,  Nazir Pur,90,585,47,279,43,306,13.3,14.4,12.3,00000
48.0,2.0,35.0,843,01,01,  Osmanpur,524,1167,264,544,260,623,31.0,32.7,29.4,00000
48.0,2.0,35.0,843,02,01,  Manoharpur,367,978,207,457,160,521,27.3,31.2,23.5,00000
48.0,2.0,47.0,421,01,01,  Deoghar,1196,2465,526,1171,670,1294,32.7,31.0,34.1,00000
48.0,2.0,47.0,421,02,01,  Alinagar,1507,3717,869,1765,638,1952,28.8,33.0,24.6,00000
48.0,2.0,47.0,876,01,01,  Paon,266,395,111,179,155,216,40.2,38.3,41.8,00000
48.0,2.0,47.0,876,02,01,  Saday Nagar,75,481,38,223,37,258,13.5,14.6,12.5,00000
48.0,2.0,47.0,876,03,01,  Kagadigram,695,1241,350,577,345,664,35.9,37.8,34.2,00000
48.0,2.0,59.0,337,01,01,  Dhalarkandi,194,545,112,264,82,281,26.3,29.8,22.6,00000
48.0,2.0,59.0,337,02,01,  Shibla,108,519,56,234,52,285,17.2,19.3,15.4,00000
48.0,2.0,59.0,573,01,01,  Kalma,200,198,110,85,90,113,50.3,56.4,44.3,00000
48.0,2.0,59.0,573,02,01,  Halalpur,613,832,332,368,281,464,42.4,47.4,37.7,00000
48.0,2.0,59.0,994,01,01,  Sapanta,712,703,392,284,320,419,50.3,58.0,43.3,00000
48.0,2.0,59.0,994,02,01,  Shantipur,122,232,75,93,47,139,34.5,44.6,25.3,00000
48.0,2.0,71.0,623,01,01,  Kastail,1005,3437,469,1686,536,1751,22.6,21.8,23.4,00000
48.0,2.0,71.0,623,02,01,  Bahadurppur,81,151,41,86,40,65,34.9,32.3,38.1,00000
48.0,2.0,83.0,134,01,01,  Bajuka,582,1441,286,668,296,773,28.8,30.0,27.7,00000
48.0,2.0,83.0,134,02,01,  Baligaon,204,654,101,340,103,314,23.8,22.9,24.7,00000
48.0,2.0,83.0,725,01,01,  Khayerpur,1038,1938,591,908,447,1030,34.9,39.4,30.3,00000
48.0,2.0,83.0,725,02,01,  Kadamchal,564,1754,329,822,235,932,24.3,28.6,20.1,00000
48.0,2.0,83.0,725,03,01,  Anwarpur,39,259,27,113,12,146,13.1,19.3,7.6,00000
48.0,2.0,83.0,725,04,01,  Kadirpur,346,701,207,359,139,342,33.0,36.6,28.9,00000
48.0,2.0,91.0,286,01,01,  Birgaon,1784,3301,817,1604,967,1697,35.1,33.7,36.3,00000
48.0,2.0,91.0,286,02,01,  Islampur,173,491,83,233,90,258,26.1,26.3,25.9,00000
48.0,2.0,91.0,708,01,01,  Khasal,1261,1915,611,953,650,962,39.7,39.1,40.3,00000
48.0,2.0,91.0,708,02,01,  Ekhurdia,308,531,195,257,113,274,36.7,43.1,29.2,00000
48.0,6.0,17.0,078,01,01,  Baliardi,711,1564,317,704,394,860,31.3,31.0,31.4,00000
48.0,6.0,17.0,078,02,01,  Aynarkandi,34,177,22,66,12,111,16.1,25.0,9.8,00000
48.0,6.0,17.0,078,03,01,  Mathun Shapur,64,326,23,154,41,172,16.4,13.0,19.2,00000
48.0,6.0,17.0,335,01,01,  Ghoradara,216,366,100,174,116,192,37.1,36.5,37.7,00000
48.0,6.0,17.0,335,02,01,  Sagar Fena,298,674,125,324,173,350,30.7,27.8,33.1,00000
48.0,6.0,17.0,335,03,01,  Baraichapa,134,182,63,84,71,98,42.4,42.9,42.0,00000
48.0,6.0,17.0,335,04,01,  Gopinathpur,70,176,37,80,33,96,28.5,31.6,25.6,00000
48.0,6.0,17.0,939,01,01,  Adarsha Gram,39,301,17,170,22,131,11.5,9.1,14.4,00000
48.0,6.0,17.0,939,02,01,  Atkapara,52,170,24,84,28,86,23.4,22.2,24.6,00000
48.0,6.0,17.0,939,03,01,  Osman Pur,449,513,204,262,245,251,46.7,43.8,49.4,00000
48.0,6.0,17.0,939,04,01,  Paschim Noahata,349,367,179,164,170,203,48.7,52.2,45.6,00000
48.0,6.0,17.0,939,05,01,  Rajnagar,20,59,7,23,13,36,25.3,23.3,26.5,00000
48.0,6.0,17.0,939,06,01,  Shaplanja,212,164,92,85,120,79,56.4,52.0,60.3,00000
48.0,6.0,17.0,966,01,01,  Baniahat,73,365,40,173,33,192,16.7,18.8,14.7,00000
48.0,6.0,17.0,966,02,01,  Ghonahati,257,510,128,242,129,268,33.5,34.6,32.5,00000
48.0,6.0,17.0,966,03,01,  Shahpur,309,271,156,131,153,140,53.3,54.4,52.2,00000
48.0,6.0,17.0,966,04,01,  Dayarampur,66,172,31,83,35,89,27.7,27.2,28.2,00000
48.0,6.0,17.0,966,05,01,  Babunagar,28,81,16,33,12,48,25.7,32.7,20.0,00000
48.0,6.0,17.0,966,06,01,  Dattagram,58,55,36,21,22,34,51.3,63.2,39.3,00000
48.0,6.0,17.0,966,07,01,  Purba Noahata,130,284,70,136,60,148,31.4,34.0,28.8,00000
48.0,6.0,17.0,966,08,01,  Tup Baliardi,25,54,14,26,11,28,31.6,35.0,28.2,00000
48.0,6.0,25.0,279,01,01,  Patuli,1258,2645,634,1222,624,1423,32.2,34.2,30.5,00000
48.0,6.0,25.0,279,02,01,  Dighirpar Sialdi,178,485,104,236,74,249,26.8,30.6,22.9,00000
48.0,6.0,25.0,279,03,01,  Dighirpar,1255,2069,621,947,634,1122,37.8,39.6,36.1,00000
48.0,6.0,25.0,279,04,01,  Subharampur,900,1018,466,487,434,531,46.9,48.9,45.0,00000
48.0,6.0,25.0,279,05,01,  Rishi Para,365,853,173,386,192,467,30.0,30.9,29.1,00000
48.0,6.0,25.0,279,06,01,  Ghangahati,280,967,148,453,132,514,22.5,24.6,20.4,00000
48.0,6.0,25.0,279,07,01,  Lalkhar Char,81,199,44,89,37,110,28.9,33.1,25.2,00000
48.0,6.0,25.0,279,08,01,  Assanpur,482,1286,254,622,228,664,27.3,29.0,25.6,00000
48.0,6.0,25.0,279,09,01,  Shatani,294,651,143,326,151,325,31.1,30.5,31.7,00000
48.0,6.0,25.0,279,10,01,  Chaichira,145,497,68,242,77,255,22.6,21.9,23.2,00000
48.0,6.0,25.0,279,11,01,  Noagaon,151,195,73,89,78,106,43.6,45.1,42.4,00000
48.0,6.0,25.0,279,12,01,  Dighirpar Nadirghat,20,22,20,22,0,0,47.6,47.6,0.0,00000
48.0,6.0,25.0,279,13,01,  Chan Pur,140,208,65,102,75,106,40.2,38.9,41.4,00000
48.0,6.0,34.0,156,01,01,  Bahernagar,949,2455,462,1178,487,1277,27.9,28.2,27.6,00000
48.0,6.0,34.0,156,02,01,  Pachim Tatalchar,305,550,150,260,155,290,35.7,36.6,34.8,00000
48.0,6.0,34.0,290,01,01,  Mohamirer Bag,127,16,64,9,63,7,88.8,87.7,90.0,00000
48.0,6.0,34.0,290,02,01,  Nagar,204,130,112,52,92,78,61.1,68.3,54.1,00000
48.0,6.0,34.0,290,03,01,  Fulbaria,226,96,117,54,109,42,70.2,68.4,72.2,00000
48.0,6.0,34.0,290,04,01,  Mirer Mahallah,132,113,67,45,65,68,53.9,59.8,48.9,00000
48.0,6.0,34.0,290,05,01,  Shahnagar,25,135,13,76,12,59,15.6,14.6,16.9,00000
48.0,6.0,34.0,290,06,01,  Utathiakandi,214,383,132,171,82,212,35.8,43.6,27.9,00000
48.0,6.0,34.0,290,07,01,  Sonakanda,131,172,65,78,66,94,43.2,45.5,41.3,00000
48.0,6.0,34.0,290,08,01,  Gaur Nagar,115,112,68,57,47,55,50.7,54.4,46.1,00000
48.0,6.0,34.0,290,09,01,  Dariakanda,220,104,115,56,105,48,67.9,67.3,68.6,00000
48.0,6.0,34.0,290,10,01,  Jalla Para,123,184,51,92,72,92,40.1,35.7,43.9,00000
48.0,6.0,34.0,290,11,01,  Kholahati,197,400,88,193,109,207,33.0,31.3,34.5,00000
48.0,6.0,34.0,290,12,01,  Kamaria Bhita,65,188,36,101,29,87,25.7,26.3,25.0,00000
48.0,6.0,34.0,290,13,01,  Barkatala,280,618,117,299,163,319,31.2,28.1,33.8,00000
48.0,6.0,34.0,290,14,01,  Katera,98,186,41,98,57,88,34.5,29.5,39.3,00000
48.0,6.0,34.0,290,15,01,  Pathanhati,98,154,44,85,54,69,38.9,34.1,43.9,00000
48.0,6.0,34.0,290,16,01,  Bagh Para,126,331,49,159,77,172,27.6,23.6,30.9,00000
48.0,6.0,34.0,290,17,01,  Dilalpur Bazar,52,27,50,25,2,2,65.8,66.7,50.0,00000
48.0,6.0,34.0,849,01,01,  Ratanpur,94,157,57,73,37,84,37.5,43.8,30.6,00000
48.0,6.0,34.0,849,02,01,  Tatal Char,547,889,256,449,291,440,38.1,36.3,39.8,00000
48.0,6.0,34.0,849,03,01,  Santerkanda,38,318,21,158,17,160,10.7,11.7,9.6,00000
48.0,6.0,34.0,894,01,01,  Saser Dighi,391,518,189,248,202,270,43.0,43.2,42.8,00000
48.0,6.0,34.0,894,02,01,  Mollah Para,173,412,85,200,88,212,29.6,29.8,29.3,00000
48.0,6.0,34.0,894,03,01,  Maij Para,243,328,110,167,133,161,42.6,39.7,45.2,00000
48.0,6.0,34.0,894,04,01,  Noapara,578,390,276,169,302,221,59.7,62.0,57.7,00000
48.0,6.0,43.0,313,01,01,  Purba Gazir Char,174,339,91,150,83,189,33.9,37.8,30.5,00000
48.0,6.0,43.0,313,02,01,  Paschim Gazir Char,558,527,271,230,287,297,51.4,54.1,49.1,00000
48.0,6.0,43.0,313,03,01,  Dakshin Duljan,176,241,79,104,97,137,42.2,43.2,41.5,00000
48.0,6.0,43.0,313,04,01,  Uttar Duljan,184,288,88,152,96,136,39.0,36.7,41.4,00000
48.0,6.0,43.0,313,05,01,  Babunagar,150,164,68,89,82,75,47.8,43.3,52.2,00000
48.0,6.0,43.0,313,06,01,  Tulakandi,122,133,52,71,70,62,47.8,42.3,53.0,00000
48.0,6.0,43.0,860,01,01,  Sadir Char,352,710,171,346,181,364,33.1,33.1,33.2,00000
48.0,6.0,43.0,860,02,01,  Latibpur,156,186,80,96,76,90,45.6,45.5,45.8,00000
48.0,6.0,51.0,022,01,01,  Sujatpur,127,166,59,78,68,88,43.3,43.1,43.6,00000
48.0,6.0,51.0,022,02,01,  Kashimnagar,135,89,62,34,73,55,60.3,64.6,57.0,00000
48.0,6.0,51.0,190,01,01,  Uttar Chhaypaika,270,365,127,154,143,211,42.5,45.2,40.4,00000
48.0,6.0,51.0,190,02,01,  Dari Chhaipaika,157,224,66,105,91,119,41.2,38.6,43.3,00000
48.0,6.0,51.0,547,01,01,  Paschim Kutubpur,488,465,250,204,238,261,51.2,55.1,47.7,00000
48.0,6.0,51.0,547,02,01,  Purba Kutubpur,411,592,157,273,254,319,41.0,36.5,44.3,00000
48.0,6.0,60.0,089,01,01,  Baligaon,881,1988,473,928,408,1060,30.7,33.8,27.8,00000
48.0,6.0,60.0,089,02,01,  Pudda,263,1001,145,522,118,479,20.8,21.7,19.8,00000
48.0,6.0,60.0,380,01,01,  Hilacha,1070,2192,537,1029,533,1163,32.8,34.3,31.4,00000
48.0,6.0,60.0,380,02,01,  Noakandi,92,521,62,232,30,289,15.0,21.1,9.4,00000
48.0,6.0,60.0,603,01,01,  Maitpur,259,322,108,153,151,169,44.6,41.4,47.2,00000
48.0,6.0,60.0,603,02,01,  Atargaon,291,190,153,81,138,109,60.5,65.4,55.9,00000
48.0,6.0,69.0,413,01,01,  Gosaipur,404,1255,226,607,178,648,24.4,27.1,21.5,00000
48.0,6.0,69.0,413,02,01,  Lama Gosaipur,298,1418,168,693,130,725,17.4,19.5,15.2,00000
48.0,6.0,69.0,760,01,01,  Chaitanpur,352,721,182,344,170,377,32.8,34.6,31.1,00000
48.0,6.0,69.0,760,02,01,  Hossainpur,399,656,189,318,210,338,37.8,37.3,38.3,00000
48.0,6.0,69.0,760,03,01,  Ujaikhali,135,612,72,294,63,318,18.1,19.7,16.5,00000
48.0,6.0,69.0,760,04,01,  Anwarpur,222,809,126,377,96,432,21.5,25.0,18.2,00000
48.0,6.0,72.0,536,01,01,  Kokrail,1594,4282,818,2076,776,2206,27.1,28.3,26.0,00000
48.0,6.0,72.0,536,02,01,  Kachuakhala,229,403,131,201,98,202,36.2,39.5,32.7,00000
48.0,6.0,77.0,011,01,01,  Aynar Gop,337,1553,182,731,155,822,17.8,19.9,15.9,00000
48.0,6.0,77.0,011,02,01,  Purba Porakanda,121,181,71,77,50,104,40.1,48.0,32.5,00000
48.0,6.0,77.0,681,01,01,  Purakanda,179,1040,84,521,95,519,14.7,13.9,15.5,00000
48.0,6.0,77.0,681,02,01,  Shibpur,10,80,7,38,3,42,11.1,15.6,6.7,00000
48.0,6.0,77.0,681,03,01,  Boali,195,387,110,190,85,197,33.5,36.7,30.1,00000
48.0,6.0,86.0,201,01,01,  Gazaria,1226,1816,603,875,623,941,40.3,40.8,39.8,00000
48.0,6.0,86.0,201,02,01,  Bilpar Gazaria,398,403,195,178,203,225,49.7,52.3,47.4,00000
48.0,6.0,86.0,301,01,01,  Duaigaon,514,722,238,331,276,391,41.6,41.8,41.4,00000
48.0,6.0,86.0,301,02,01,  Ujan Char,476,452,240,198,236,254,51.3,54.8,48.2,00000
48.0,6.0,86.0,301,03,01,  Bilpar Duaigaon,116,309,43,145,73,164,27.3,22.9,30.8,00000
48.0,6.0,86.0,301,04,01,  Khashila,277,427,124,213,153,214,39.3,36.8,41.7,00000
48.0,6.0,86.0,693,01,01,  Nilakhi,797,647,384,310,413,337,55.2,55.3,55.1,00000
48.0,6.0,86.0,693,02,01,  Nayagaon,963,1281,474,625,489,656,42.9,43.1,42.7,00000
48.0,6.0,86.0,693,03,01,  Nayahati,154,166,72,77,82,89,48.1,48.3,48.0,00000
48.0,6.0,86.0,704,01,01,  Nilakhi Hapania,394,354,182,163,212,191,52.7,52.8,52.6,00000
48.0,6.0,86.0,704,02,01,  Rustampur,202,228,84,117,118,111,47.0,41.8,51.5,00000
48.0,6.0,86.0,804,01,01,  Paschim Pirijpur,1173,1793,568,861,605,932,39.5,39.7,39.4,00000
48.0,6.0,86.0,804,02,01,  Purba Pirijpur,574,934,295,448,279,486,38.1,39.7,36.5,00000
48.0,6.0,86.0,804,03,01,  Jauria,728,1349,343,664,385,685,35.1,34.1,36.0,00000
48.0,6.0,86.0,804,04,01,  Kekuri,143,203,75,102,68,101,41.3,42.4,40.2,00000
48.0,6.0,86.0,804,05,01,  Bajegaon,520,937,263,436,257,501,35.7,37.6,33.9,00000
48.0,6.0,86.0,804,06,01,  Joynagar,187,485,101,243,86,242,27.8,29.4,26.2,00000
48.0,6.0,86.0,804,07,01,  Goyeshpur,150,266,101,117,49,149,36.1,46.3,24.7,00000
48.0,6.0,86.0,804,08,01,  Mirakandi,186,380,101,190,85,190,32.9,34.7,30.9,00000
48.0,6.0,86.0,804,09,01,  Sultanpur,641,813,322,381,319,432,44.1,45.8,42.5,00000
48.0,6.0,86.0,804,10,01,  Bhalukbar,110,209,46,113,64,96,34.5,28.9,40.0,00000
48.0,6.0,94.0,514,01,01,  Kalekhar Bhanda,621,662,305,304,316,358,48.4,50.1,46.9,00000
48.0,6.0,94.0,514,02,01,  Mirergaon,247,221,127,106,120,115,52.8,54.5,51.1,00000
48.0,6.0,94.0,514,03,01,  Burikanda,242,178,133,80,109,98,57.6,62.4,52.7,00000
48.0,6.0,94.0,514,04,01,  Jahar Para,265,188,140,82,125,106,58.5,63.1,54.1,00000
48.0,6.0,94.0,614,01,01,  Majlispur,260,192,139,135,121,57,57.5,50.7,68.0,00000
48.0,6.0,94.0,614,02,01,  Sararchar Bazar,630,376,343,177,287,199,62.6,66.0,59.1,00000
48.0,6.0,94.0,626,01,01,  Dakshin Mirapur,539,358,280,193,259,165,60.1,59.2,61.1,00000
48.0,6.0,94.0,626,02,01,  Madhya Mirapur,711,393,379,191,332,202,64.4,66.5,62.2,00000
48.0,6.0,94.0,626,03,01,  Uttar Mirapur,135,21,64,10,71,11,86.5,86.5,86.6,00000
48.0,6.0,94.0,726,01,01,  Uttar Kamalpur,302,111,157,46,145,65,73.1,77.3,69.0,00000
48.0,6.0,94.0,726,02,01,  Dakshin Kamalpur,789,485,374,237,415,248,61.9,61.2,62.6,00000
48.0,6.0,94.0,726,03,01,  Beki,362,409,188,181,174,228,47.0,50.9,43.3,00000
48.0,6.0,94.0,726,04,01,  Bhagalpur,275,194,147,90,128,104,58.6,62.0,55.2,00000
48.0,6.0,94.0,838,01,01,  Machimpur,815,712,440,329,375,383,53.4,57.2,49.5,00000
48.0,6.0,94.0,838,02,01,  Atka Para,400,295,210,134,190,161,57.6,61.0,54.1,00000
48.0,6.0,94.0,838,03,01,  Dash Para,145,319,76,152,69,167,31.3,33.3,29.2,00000
48.0,6.0,94.0,883,01,01,  Uttar Sarar Char,1104,1076,568,533,536,543,50.6,51.6,49.7,00000
48.0,6.0,94.0,883,02,01,  Dakshin Sarar Char,1216,766,610,347,606,419,61.4,63.7,59.1,00000
48.0,6.0,94.0,883,03,01,  Purangaon,885,1116,414,501,471,615,44.2,45.2,43.4,00000
48.0,6.0,94.0,883,04,01,  Purankhala,85,353,46,177,39,176,19.4,20.6,18.1,00000
48.0,6.0,94.0,883,05,01,  Kekuri,301,268,151,130,150,138,52.9,53.7,52.1,00000
48.0,6.0,94.0,961,01,01,  Tegharia,483,524,219,239,264,285,48.0,47.8,48.1,00000
48.0,6.0,94.0,961,02,01,  Balla,328,502,165,229,163,273,39.5,41.9,37.4,00000
48.0,6.0,94.0,961,03,01,  Patharikandi,169,135,79,58,90,77,55.6,57.7,53.9,00000
48.0,6.0,94.0,961,04,01,  Nurpur,366,465,184,204,182,261,44.0,47.4,41.1,00000
48.0,6.0,94.0,961,05,01,  Gobindapur,241,72,122,29,119,43,77.0,80.8,73.5,00000
48.0,11.0,21.0,031,01,01,  Hara Krishnapur,31,111,22,47,9,64,21.8,31.9,12.3,00000
48.0,11.0,21.0,031,02,01,  Maharampur,25,145,8,74,17,71,14.7,9.8,19.3,00000
48.0,11.0,21.0,031,03,01,  Radhanagar,214,807,114,377,100,430,21.0,23.2,18.9,00000
48.0,11.0,21.0,031,04,01,  Jagamohanpur,810,1907,396,869,414,1038,29.8,31.3,28.5,00000
48.0,11.0,21.0,031,05,01,  Aganagar,1985,3554,950,1689,1035,1865,35.8,36.0,35.7,00000
48.0,11.0,21.0,031,06,01,  Sampur,118,450,58,231,60,219,20.8,20.1,21.5,00000
48.0,11.0,21.0,217,01,01,  Kalikapur,160,320,68,154,92,166,33.3,30.6,35.7,00000
48.0,11.0,21.0,217,02,01,  Nabipur,837,2138,395,1002,442,1136,28.1,28.3,28.0,00000
48.0,11.0,21.0,217,03,01,  Gokulnagar,338,605,183,249,155,356,35.8,42.4,30.3,00000
48.0,11.0,21.0,217,04,01,  Santi Nagar,78,321,28,158,50,163,19.5,15.1,23.5,00000
48.0,11.0,21.0,217,05,01,  Hasimpur,38,115,21,58,17,57,24.8,26.6,23.0,00000
48.0,11.0,21.0,217,06,01,  Chhatiyantala,106,390,65,183,41,207,21.4,26.2,16.5,00000
48.0,11.0,21.0,217,07,01,  Puran Chhagaia,313,564,146,260,167,304,35.7,36.0,35.5,00000
48.0,11.0,21.0,217,08,01,  Chhagaia,762,1327,356,654,406,673,36.5,35.2,37.6,00000
48.0,11.0,21.0,217,09,01,  Omnathpur,228,321,108,157,120,164,41.5,40.8,42.3,00000
48.0,11.0,21.0,621,01,01,  Lundia,714,2018,323,989,391,1029,26.1,24.6,27.5,00000
48.0,11.0,21.0,621,02,01,  Khala Para,117,398,60,194,57,204,22.7,23.6,21.8,00000
48.0,11.0,21.0,621,03,01,  Char Para,220,938,147,481,73,457,19.0,23.4,13.8,00000
48.0,11.0,21.0,963,01,01,  Tukchandpur,57,473,30,236,27,237,10.8,11.3,10.2,00000
48.0,11.0,21.0,963,02,01,  Puran Char,67,245,33,134,34,111,21.5,19.8,23.4,00000
48.0,11.0,35.0,093,01,01,  Banshgari Paschimpara,663,1163,297,565,366,598,36.3,34.5,38.0,00000
48.0,11.0,35.0,093,02,01,  Madhyapara,624,1345,245,625,379,720,31.7,28.2,34.5,00000
48.0,11.0,35.0,093,03,01,  Purbapara,756,1257,285,559,471,698,37.6,33.8,40.3,00000
48.0,11.0,35.0,248,01,01,  Uttarpara,523,983,178,463,345,520,34.7,27.8,39.9,00000
48.0,11.0,35.0,248,02,01,  Nama Para,469,1118,165,512,304,606,29.6,24.4,33.4,00000
48.0,11.0,35.0,684,01,01,  Barakanda,145,291,75,165,70,126,33.3,31.3,35.7,00000
48.0,11.0,35.0,684,02,01,  Parikhar Par,202,264,97,136,105,128,43.3,41.6,45.1,00000
48.0,11.0,35.0,684,03,01,  Naya Hati,281,1100,123,509,158,591,20.3,19.5,21.1,00000
48.0,11.0,35.0,684,04,01,  Paratala,367,866,180,402,187,464,29.8,30.9,28.7,00000
48.0,11.0,35.0,684,05,01,  Tatal Char,516,1076,237,495,279,581,32.4,32.4,32.4,00000
48.0,11.0,35.0,684,06,01,  Purangaon,301,1371,139,675,162,696,18.0,17.1,18.9,00000
48.0,11.0,35.0,684,07,01,  Madhyapara,575,782,294,377,281,405,42.4,43.8,41.0,00000
48.0,11.0,35.0,684,08,01,  Dakshinpara,421,720,189,305,232,415,36.9,38.3,35.9,00000
48.0,11.0,35.0,684,09,01,  Purbakanda,392,1126,169,517,223,609,25.8,24.6,26.8,00000
48.0,11.0,47.0,435,01,01,  Sreematir Char,104,305,34,151,70,154,25.4,18.4,31.3,00000
48.0,11.0,47.0,435,02,01,  Atka Para,338,841,154,398,184,443,28.7,27.9,29.3,00000
48.0,11.0,47.0,435,03,01,  Jagrar Char,570,1760,228,852,342,908,24.5,21.1,27.4,00000
48.0,11.0,47.0,435,04,01,  Kumirmara,289,670,113,326,176,344,30.1,25.7,33.8,00000
48.0,11.0,47.0,435,05,01,  Nayahati,179,737,71,381,108,356,19.5,15.7,23.3,00000
48.0,11.0,47.0,435,06,01,  Charerkanda,369,1126,159,575,210,551,24.7,21.7,27.6,00000
48.0,11.0,47.0,435,07,01,  Paschimpara,1217,1927,565,958,652,969,38.7,37.1,40.2,00000
48.0,11.0,47.0,435,08,01,  Dakshinpara,1050,2130,520,1112,530,1018,33.0,31.9,34.2,00000
48.0,11.0,47.0,435,09,01,  Uttarpara,1175,1857,538,953,637,904,38.8,36.1,41.3,00000
48.0,11.0,47.0,435,10,01,  Adarsha Para,703,1288,307,657,396,631,35.3,31.8,38.6,00000
48.0,11.0,47.0,435,11,01,  Pultakandi,269,413,143,205,126,208,39.4,41.1,37.7,00000
48.0,11.0,47.0,435,12,01,  Gazir Tek,158,410,83,191,75,219,27.8,30.3,25.5,00000
48.0,11.0,59.0,839,01,01,  Mandipur,174,705,99,339,75,366,19.8,22.6,17.0,00000
48.0,11.0,59.0,839,02,01,  Mutupi,783,2355,381,1049,402,1306,25.0,26.6,23.5,00000
48.0,11.0,59.0,839,03,01,  Sadakpur,944,1709,441,768,503,941,35.6,36.5,34.8,00000
48.0,11.0,71.0,559,01,01,  Tan Krishnanagar,816,1552,359,729,457,823,34.5,33.0,35.7,00000
48.0,11.0,71.0,559,02,01,  Chanchara,469,1329,224,661,245,668,26.1,25.3,26.8,00000
48.0,11.0,71.0,559,03,01,  Bati Krishnanagar,497,1064,220,531,277,533,31.8,29.3,34.2,00000
48.0,11.0,71.0,870,01,01,  Panaullar Char,303,451,146,230,157,221,40.2,38.8,41.5,00000
48.0,11.0,71.0,870,02,01,  Shibpur,677,1200,312,583,365,617,36.1,34.9,37.2,00000
48.0,11.0,71.0,870,03,01,  Raghunathpur,582,1064,263,541,319,523,35.4,32.7,37.9,00000
48.0,11.0,71.0,870,04,01,  Fari Raghunathpur,925,919,470,437,455,482,50.2,51.8,48.6,00000
48.0,11.0,71.0,870,05,01,  Sambhupur,2575,3048,1292,1448,1283,1600,45.8,47.2,44.5,00000
48.0,11.0,83.0,404,01,01,  Daulatpur,326,645,163,306,163,339,33.6,34.8,32.5,00000
48.0,11.0,83.0,404,02,01,  Chandpur,1492,1675,748,768,744,907,47.1,49.3,45.1,00000
48.0,11.0,83.0,901,01,01,  Imamer Char,464,456,220,213,244,243,50.4,50.8,50.1,00000
48.0,11.0,83.0,901,02,01,  Shimulkandi,1098,1585,537,749,561,836,40.9,41.8,40.2,00000
48.0,11.0,83.0,901,03,01,  Kandi Para,601,1120,306,509,295,611,34.9,37.5,32.6,00000
48.0,11.0,83.0,901,04,01,  Rajakata,675,840,326,428,349,412,44.6,43.2,45.9,00000
48.0,11.0,83.0,994,01,01,  Tulakandi,886,951,450,451,436,500,48.2,49.9,46.6,00000
48.0,11.0,83.0,994,02,01,  Baghaikandi,236,668,109,310,127,358,26.1,26.0,26.2,00000
48.0,11.0,85.0,808,01,01,  Bhabanipur,1568,1777,776,831,792,946,46.9,48.3,45.6,00000
48.0,11.0,85.0,808,02,01,  Tiarir Char,224,1181,102,529,122,652,15.9,16.2,15.8,00000
48.0,11.0,85.0,839,01,01,  Badhunagar,731,758,365,324,366,434,49.1,53.0,45.8,00000
48.0,11.0,85.0,839,02,01,  Jafarnagar,1051,1289,507,577,544,712,44.9,46.8,43.3,00000
48.0,11.0,85.0,932,01,01,  Sulmanpur,278,485,140,251,138,234,36.4,35.8,37.1,00000
48.0,11.0,85.0,932,02,01,  Baushmara,299,161,155,71,144,90,65.0,68.6,61.5,00000
48.0,11.0,85.0,932,03,01,  Sonarampur,44,96,24,52,20,44,31.4,31.6,31.3,00000
48.0,11.0,85.0,932,04,01,  Kamarkanda,187,655,92,303,95,352,22.2,23.3,21.3,00000
48.0,11.0,85.0,932,05,01,  Sreenagar,2129,3308,1005,1540,1124,1768,39.2,39.5,38.9,00000
48.0,27.0,27.0,476,01,01,  Uttar Gobindapur,1449,2364,696,1189,753,1175,38.0,36.9,39.1,00000
48.0,27.0,27.0,476,02,01,  Paschim Gobindapur,697,1597,348,793,349,804,30.4,30.5,30.3,00000
48.0,27.0,27.0,476,03,01,  Madhya Gobindapur,1025,2025,542,978,483,1047,33.6,35.7,31.6,00000
48.0,27.0,27.0,476,04,01,  Dakhin Gobindapur,1578,2336,739,1067,839,1269,40.3,40.9,39.8,00000
48.0,27.0,27.0,476,05,01,  Boaliar Char,486,883,238,442,248,441,35.5,35.0,36.0,00000
48.0,27.0,27.0,658,01,01,  Lakhuhati,842,1647,433,808,409,839,33.8,34.9,32.8,00000
48.0,27.0,27.0,658,02,01,  Dangri,858,1039,427,479,431,560,45.2,47.1,43.5,00000
48.0,27.0,40.0,182,01,01,  Uttat Char Hajipur,729,1474,370,723,359,751,33.1,33.9,32.3,00000
48.0,27.0,40.0,182,02,01,  Dakshin Char Hajipur,592,955,293,474,299,481,38.3,38.2,38.3,00000
48.0,27.0,40.0,294,01,01,  Dhakuria,290,298,153,143,137,155,49.3,51.7,46.9,00000
48.0,27.0,40.0,294,02,01,  Beltuli,87,219,45,112,42,107,28.4,28.7,28.2,00000
48.0,27.0,40.0,294,03,01,  Tetulia,243,130,136,80,107,50,65.1,63.0,68.2,00000
48.0,27.0,54.0,238,01,01,  Uttarchar Pumdi,1177,1717,535,847,642,870,40.7,38.7,42.5,00000
48.0,27.0,54.0,238,02,01,  Dakshin Char Pumdi,999,1145,480,561,519,584,46.6,46.1,47.1,00000
48.0,27.0,54.0,560,01,01,  Jagdal,657,587,289,289,368,298,52.8,50.0,55.3,00000
48.0,27.0,54.0,560,02,01,  Kandi Para,206,488,90,233,116,255,29.7,27.9,31.3,00000
48.0,27.0,54.0,560,03,01,  Para Baria,115,318,55,159,60,159,26.6,25.7,27.4,00000
48.0,27.0,54.0,826,01,01,  Uttar Pumdi,1220,1448,606,650,614,798,45.7,48.2,43.5,00000
48.0,27.0,54.0,826,02,01,  Dakshin Pumdi,1452,1436,706,696,746,740,50.3,50.4,50.2,00000
48.0,27.0,54.0,980,01,01,  Tegharia,148,320,79,155,69,165,31.6,33.8,29.5,00000
48.0,27.0,54.0,980,02,01,  Chawalia,208,631,95,325,113,306,24.8,22.6,27.0,00000
48.0,27.0,67.0,042,01,01,  Galachipa,383,384,170,184,213,200,49.9,48.0,51.6,00000
48.0,27.0,67.0,042,02,01,  Gokulnagar,472,808,220,386,252,422,36.9,36.3,37.4,00000
48.0,27.0,81.0,252,01,01,  Chaudar,600,793,286,384,314,409,43.1,42.7,43.4,00000
48.0,27.0,81.0,252,02,01,  Rani Khamar,165,203,77,97,88,106,44.8,44.3,45.4,00000
48.0,27.0,81.0,490,01,01,  Harenja,863,1410,434,690,429,720,38.0,38.6,37.3,00000
48.0,27.0,81.0,490,02,01,  Harenja (Binna Para),243,621,135,292,108,329,28.1,31.6,24.7,00000
48.0,27.0,81.0,700,01,01,  Atka Para Mesera,653,973,342,456,311,517,40.2,42.9,37.6,00000
48.0,27.0,81.0,700,02,01,  Teka Para Kismat Mesera,130,496,77,230,53,266,20.8,25.1,16.6,00000
48.0,27.0,81.0,700,03,01,  Kona Para Mesera,269,445,154,200,115,245,37.7,43.5,31.9,00000
48.0,27.0,81.0,938,01,01,  Tan Sidhla,767,1696,374,841,393,855,31.1,30.8,31.5,00000
48.0,27.0,81.0,938,02,01,  Lama Sidhla,658,858,322,415,336,443,43.4,43.7,43.1,00000
48.0,33.0,25.0,777,01,01,  Panch Kahania,668,1535,324,796,344,739,30.3,28.9,31.8,00000
48.0,33.0,25.0,777,02,01,  Darkandi,41,243,29,118,12,125,14.4,19.7,8.8,00000
48.0,33.0,25.0,777,03,01,  Saha Para,48,300,27,146,21,154,13.8,15.6,12.0,00000
48.0,33.0,26.0,292,01,01,  Chauganga,236,439,125,231,111,208,35.0,35.1,34.8,00000
48.0,33.0,26.0,292,02,01,  Karuala,376,428,207,204,169,224,46.8,50.4,43.0,00000
48.0,33.0,26.0,292,03,01,  Bibar Bhita,442,846,232,425,210,421,34.3,35.3,33.3,00000
48.0,33.0,26.0,292,04,01,  Krishnapur,385,1060,195,551,190,509,26.6,26.1,27.2,00000
48.0,33.0,43.0,234,01,01,  Bishnupur,142,225,81,95,61,130,38.7,46.0,31.9,00000
48.0,33.0,43.0,234,02,01,  Fenani,71,178,37,76,34,102,28.5,32.7,25.0,00000
48.0,33.0,43.0,234,03,01,  Subhadrapur,197,246,113,113,84,133,44.5,50.0,38.7,00000
48.0,33.0,43.0,234,04,01,  Ramnathpur,205,424,115,222,90,202,32.6,34.1,30.8,00000
48.0,33.0,43.0,242,01,01,  Mathurapur,72,371,50,171,22,200,16.3,22.6,9.9,00000
48.0,33.0,43.0,242,02,01,  Barahati,164,381,82,188,82,193,30.1,30.4,29.8,00000
48.0,33.0,43.0,242,03,01,  Chhotahati,64,119,35,50,29,69,35.0,41.2,29.6,00000
48.0,33.0,43.0,334,01,03,  Denashpur,136,345,79,168,57,177,28.3,32.0,24.4,00000
48.0,33.0,43.0,334,02,03,  Dhanpur (Ghose Para),244,429,119,218,125,211,36.3,35.3,37.2,00000
48.0,33.0,43.0,334,03,03,  Dhanpur Bazar,130,87,121,76,9,11,59.9,61.4,45.0,00000
48.0,33.0,43.0,459,01,01,  Bukshai,315,460,167,198,148,262,40.6,45.8,36.1,00000
48.0,33.0,43.0,459,02,01,  Kamalpur,103,116,57,64,46,52,47.0,47.1,46.9,00000
48.0,33.0,43.0,459,03,01,  Rajnagar,50,168,26,80,24,88,22.9,24.5,21.4,00000
48.0,33.0,43.0,459,04,01,  Sahila,239,1050,112,519,127,531,18.5,17.7,19.3,00000
48.0,33.0,43.0,459,05,01,  Char Para,131,458,84,241,47,217,22.2,25.8,17.8,00000
48.0,33.0,43.0,551,01,01,  Barahati,104,235,61,110,43,125,30.7,35.7,25.6,00000
48.0,33.0,43.0,551,02,01,  Chhotahati,45,81,27,30,18,51,35.7,47.4,26.1,00000
48.0,33.0,43.0,827,01,01,  Ramanpur,55,55,31,24,24,31,50.0,56.4,43.6,00000
48.0,33.0,43.0,827,02,01,  Narayanpur,42,159,25,63,17,96,20.9,28.4,15.0,00000
48.0,33.0,47.0,501,01,01,  Kaktengar,382,473,203,227,179,246,44.7,47.2,42.1,00000
48.0,33.0,47.0,501,02,01,  Nurpur,151,271,77,122,74,149,35.8,38.7,33.2,00000
48.0,33.0,51.0,050,01,03,  Purbagram,1617,3419,811,1704,806,1715,32.1,32.2,32.0,00000
48.0,33.0,51.0,050,02,03,  Udearpar,391,1087,224,540,167,547,26.5,29.3,23.4,00000
48.0,33.0,60.0,016,01,01,  Patharia Para,113,235,55,107,58,128,32.5,34.0,31.2,00000
48.0,33.0,60.0,016,02,01,  Chhota Alga Para,174,192,82,89,92,103,47.5,48.0,47.2,00000
48.0,33.0,60.0,016,03,01,  Bara Alga Para,252,577,140,258,112,319,30.4,35.2,26.0,00000
48.0,33.0,60.0,468,01,01,  Duiyerpar,431,723,228,332,203,391,37.3,40.7,34.2,00000
48.0,33.0,60.0,468,02,01,  Singguahati,38,126,22,64,16,62,23.2,25.6,20.5,00000
48.0,33.0,60.0,468,03,01,  Barahati,177,136,83,63,94,73,56.5,56.8,56.3,00000
48.0,33.0,60.0,468,04,01,  Sampur,123,225,68,102,55,123,35.3,40.0,30.9,00000
48.0,33.0,60.0,468,05,01,  Santipur,19,113,11,60,8,53,14.4,15.5,13.1,00000
48.0,33.0,60.0,468,06,01,  Lalitpur,44,60,26,30,18,30,42.3,46.4,37.5,00000
48.0,33.0,60.0,468,07,01,  Royhati,277,540,146,269,131,271,33.9,35.2,32.6,00000
48.0,33.0,60.0,468,08,01,  Mollah Hati,71,100,32,51,39,49,41.5,38.6,44.3,00000
48.0,33.0,60.0,468,09,01,  Dattapara,16,73,8,45,8,28,18.0,15.1,22.2,00000
48.0,33.0,60.0,560,01,01,  Jadabpur,126,580,67,286,59,294,17.8,19.0,16.7,00000
48.0,33.0,60.0,560,02,01,  Chankanda,20,184,10,96,10,88,9.8,9.4,10.2,00000
48.0,33.0,60.0,560,03,01,  Karancha,72,172,24,79,48,93,29.5,23.3,34.0,00000
48.0,33.0,86.0,167,01,01,  Bhati Rajibpur,310,793,162,380,148,413,28.1,29.9,26.4,00000
48.0,33.0,86.0,167,02,01,  Laim Pasha,811,1931,448,921,363,1010,29.6,32.7,26.4,00000
48.0,33.0,86.0,167,03,01,  Alam Pasa,212,249,112,114,100,135,46.0,49.6,42.6,00000
48.0,33.0,86.0,476,01,01,  Jhorkandi,154,382,76,183,78,199,28.7,29.3,28.2,00000
48.0,33.0,86.0,476,02,01,  Jagannathpur,98,157,53,70,45,87,38.4,43.1,34.1,00000
48.0,33.0,86.0,660,01,01,  Prajarkanda,362,1782,217,865,145,917,16.9,20.1,13.7,00000
48.0,33.0,86.0,660,02,01,  Shantipur,135,656,102,325,33,331,17.1,23.9,9.1,00000
48.0,33.0,86.0,660,03,01,  Andhair,32,453,22,224,10,229,6.6,8.9,4.2,00000
48.0,33.0,86.0,660,04,01,  Barabari,299,615,176,283,123,332,32.7,38.3,27.0,00000
48.0,33.0,86.0,660,05,01,  Gazaria,553,1923,317,924,236,999,22.3,25.5,19.1,00000
48.0,33.0,86.0,660,06,01,  Katiarkanda,113,623,72,304,41,319,15.4,19.1,11.4,00000
48.0,33.0,86.0,660,07,01,  Kalipur,81,1021,54,498,27,523,7.4,9.8,4.9,00000
48.0,33.0,86.0,986,01,01,  Ujan Rajibpur,148,378,84,172,64,206,28.1,32.8,23.7,00000
48.0,33.0,86.0,986,02,01,  Ramkrishnapur,74,166,43,71,31,95,30.8,37.7,24.6,00000
48.0,33.0,86.0,986,03,01,  Pathabhoka,112,627,63,318,49,309,15.2,16.5,13.7,00000
48.0,33.0,94.0,819,01,01,  Uttar Raji,238,1068,135,525,103,543,18.2,20.5,15.9,00000
48.0,33.0,94.0,819,02,01,  Dakshin Raji,488,1553,271,736,217,817,23.9,26.9,21.0,00000
48.0,42.0,13.0,093,01,01,  Tolsia,286,212,139,110,147,102,57.4,55.8,59.0,00000
48.0,42.0,13.0,093,02,01,  Chatil,390,489,200,222,190,267,44.4,47.4,41.6,00000
48.0,42.0,13.0,093,03,01,  Jahirabad,344,489,179,233,165,256,41.3,43.4,39.2,00000
48.0,42.0,13.0,093,04,01,  Gajaria,164,319,85,153,79,166,34.0,35.7,32.2,00000
48.0,42.0,13.0,093,05,01,  Madarikala,210,475,98,228,112,247,30.7,30.1,31.2,00000
48.0,42.0,13.0,093,06,01,  Faturgop,215,311,108,136,107,175,40.9,44.3,37.9,00000
48.0,42.0,13.0,093,07,01,  Barbarta,348,761,167,325,181,436,31.4,33.9,29.3,00000
48.0,42.0,13.0,093,08,01,  Hasanpur,529,639,283,290,246,349,45.3,49.4,41.3,00000
48.0,42.0,13.0,093,09,01,  Ditpur,338,977,167,443,171,534,25.7,27.4,24.3,00000
48.0,42.0,13.0,093,10,01,  Bhushakanda,203,393,104,176,99,217,34.1,37.1,31.3,00000
48.0,42.0,13.0,093,11,01,  Maniyapur,38,137,25,76,13,61,21.7,24.8,17.6,00000
48.0,42.0,13.0,093,12,01,  Baragoria,907,1786,451,811,456,975,33.7,35.7,31.9,00000
48.0,42.0,17.0,140,01,01,  Bhatia Purbapara,991,1358,531,619,460,739,42.2,46.2,38.4,00000
48.0,42.0,17.0,140,02,01,  Bhatia Zahirkona,656,1154,334,529,322,625,36.2,38.7,34.0,00000
48.0,42.0,17.0,140,03,01,  Moralpara,330,546,152,264,178,282,37.7,36.5,38.7,00000
48.0,42.0,17.0,140,04,01,  Gangpara,300,1071,140,520,160,551,21.9,21.2,22.5,00000
48.0,42.0,17.0,140,05,01,  Namapara,85,186,48,92,37,94,31.4,34.3,28.2,00000
48.0,42.0,17.0,198,01,01,  Char Dehunda Uttarpara,464,492,238,227,226,265,48.5,51.2,46.0,00000
48.0,42.0,17.0,198,02,01,  Munshipara,296,512,153,252,143,260,36.6,37.8,35.5,00000
48.0,42.0,17.0,198,03,01,  Char Dehunda Dakshinpara,521,585,254,264,267,321,47.1,49.0,45.4,00000
48.0,42.0,17.0,198,04,01,  Chardehunda Masterpara,156,219,75,97,81,122,41.6,43.6,39.9,00000
48.0,42.0,17.0,198,05,01,  Chardehunda Baytahkhali,145,418,77,199,68,219,25.8,27.9,23.7,00000
48.0,42.0,17.0,491,01,01,  Narsundanadi Uttarpara,399,579,188,258,211,321,40.8,42.2,39.7,00000
48.0,42.0,17.0,491,02,01,  Narsundanadi Dakshinpara,354,653,160,305,194,348,35.2,34.4,35.8,00000
48.0,42.0,17.0,491,03,01,  Khamar Dehunda Nama Para,460,1012,211,497,249,515,31.3,29.8,32.6,00000
48.0,42.0,17.0,854,01,01,  Purbapara,295,1136,151,562,144,574,20.6,21.2,20.1,00000
48.0,42.0,17.0,854,02,01,  Paschimpara,430,1079,224,495,206,584,28.5,31.2,26.1,00000
48.0,42.0,25.0,257,01,01,  Dari Gangatia,155,591,74,300,81,291,20.8,19.8,21.8,00000
48.0,42.0,25.0,257,02,01,  Nayahati,87,281,49,134,38,147,23.6,26.8,20.5,00000
48.0,42.0,25.0,316,01,01,  Gundhar,343,556,139,266,204,290,38.2,34.3,41.3,00000
48.0,42.0,25.0,316,02,01,  Batourgop,166,398,79,210,87,188,29.4,27.3,31.6,00000
48.0,42.0,25.0,339,01,01,  Indachulli,341,895,167,423,174,472,27.6,28.3,26.9,00000
48.0,42.0,25.0,339,02,01,  Chuli,368,660,189,319,179,341,35.8,37.2,34.4,00000
48.0,42.0,25.0,339,03,01,  Khanorakhali,79,258,35,129,44,129,23.4,21.3,25.4,00000
48.0,42.0,25.0,901,01,01,  Sudhi,681,1120,360,573,321,547,37.8,38.6,37.0,00000
48.0,42.0,25.0,901,02,01,  Salumakanda,170,188,91,90,79,98,47.5,50.3,44.6,00000
48.0,42.0,25.0,948,01,01,  Ujan Baratia,136,291,73,150,63,141,31.9,32.7,30.9,00000
48.0,42.0,25.0,948,02,01,  Jalbhanga,243,532,129,256,114,276,31.4,33.5,29.2,00000
48.0,42.0,25.0,948,03,01,  Sankanda,139,566,65,282,74,284,19.7,18.7,20.7,00000
48.0,42.0,25.0,971,01,01,  Urdighi,1157,1383,604,672,553,711,45.6,47.3,43.8,00000
48.0,42.0,25.0,971,02,01,  Mokambari,319,453,171,209,148,244,41.3,45.0,37.8,00000
48.0,42.0,34.0,081,01,01,  Banda Gomara,560,383,271,194,289,189,59.4,58.3,60.5,00000
48.0,42.0,34.0,081,02,01,  Borni,138,166,63,73,75,93,45.4,46.3,44.6,00000
48.0,42.0,34.0,210,01,01,  Purba Char Karansi,388,1051,182,520,206,531,27.0,25.9,28.0,00000
48.0,42.0,34.0,210,02,01,  Paschim Char Karansi,474,819,241,405,233,414,36.7,37.3,36.0,00000
48.0,42.0,34.0,304,01,01,  Gopinathpur,505,692,251,326,254,366,42.2,43.5,41.0,00000
48.0,42.0,34.0,304,02,01,  Siripur,420,546,214,244,206,302,43.5,46.7,40.6,00000
48.0,42.0,34.0,304,03,01,  Jatia Para,727,1186,366,590,361,596,38.0,38.3,37.7,00000
48.0,42.0,34.0,304,04,01,  Charaikhali,104,281,60,149,44,132,27.0,28.7,25.0,00000
48.0,42.0,34.0,304,05,01,  Kharithati,384,432,208,195,176,237,47.1,51.6,42.6,00000
48.0,42.0,34.0,304,06,01,  Barakanda,311,639,165,305,146,334,32.7,35.1,30.4,00000
48.0,42.0,34.0,304,07,01,  Hidankhali,900,1812,489,835,411,977,33.2,36.9,29.6,00000
48.0,42.0,34.0,304,08,01,  Tarmanigujadia,168,219,77,107,91,112,43.4,41.8,44.8,00000
48.0,42.0,34.0,304,09,01,  Khailakuri,271,556,130,236,141,320,32.8,35.5,30.6,00000
48.0,42.0,34.0,304,10,01,  Paloikanda,394,930,198,419,196,511,29.8,32.1,27.7,00000
48.0,42.0,34.0,304,11,01,  Hatimara,173,530,102,263,71,267,24.6,27.9,21.0,00000
48.0,42.0,34.0,304,12,01,  Asotya Para,315,403,164,185,151,218,43.9,47.0,40.9,00000
48.0,42.0,34.0,304,13,01,  Pathria Para,173,784,94,407,79,377,18.1,18.8,17.3,00000
48.0,42.0,34.0,304,14,01,  Chandpur,239,746,114,339,125,407,24.3,25.2,23.5,00000
48.0,42.0,34.0,304,15,01,  Dalar Para,367,568,191,288,176,280,39.3,39.9,38.6,00000
48.0,42.0,34.0,304,16,01,  Ramnagar,482,776,234,365,248,411,38.3,39.1,37.6,00000
48.0,42.0,34.0,304,17,01,  Atka Para,372,788,184,407,188,381,32.1,31.1,33.0,00000
48.0,42.0,34.0,304,18,01,  Tanpara,311,273,181,122,130,151,53.3,59.7,46.3,00000
48.0,42.0,34.0,304,19,01,  Nama Para,263,330,138,153,125,177,44.4,47.4,41.4,00000
48.0,42.0,34.0,304,20,01,  Boiratia Para,259,371,142,175,117,196,41.1,44.8,37.4,00000
48.0,42.0,34.0,936,01,01,  Tamni Pitua,634,681,337,285,297,396,48.2,54.2,42.9,00000
48.0,42.0,34.0,936,02,01,  Akanda Para,729,506,312,234,417,272,59.0,57.1,60.5,00000
48.0,42.0,34.0,936,03,01,  Islampur,598,560,269,231,329,329,51.6,53.8,50.0,00000
48.0,42.0,34.0,936,04,01,  Kona Para,291,297,139,140,152,157,49.5,49.8,49.2,00000
48.0,42.0,34.0,936,05,01,  Naya Para,506,459,232,208,274,251,52.4,52.7,52.2,00000
48.0,42.0,43.0,351,01,01,  Dakshinpara,532,564,259,255,273,309,48.5,50.4,46.9,00000
48.0,42.0,43.0,351,02,01,  Uttarpara,512,409,266,199,246,210,55.6,57.2,53.9,00000
48.0,42.0,43.0,772,01,01,  Radhar Char,168,307,88,145,80,162,35.4,37.8,33.1,00000
48.0,42.0,43.0,772,02,01,  Sadar Jangal,661,630,287,265,374,365,51.2,52.0,50.6,00000
48.0,42.0,51.0,386,01,01,  Joyka,664,945,329,439,335,506,41.3,42.8,39.8,00000
48.0,42.0,51.0,386,02,01,  Kalabagh,406,1075,216,522,190,553,27.4,29.3,25.6,00000
48.0,42.0,51.0,386,03,01,  Ram Nagar,713,823,382,386,331,437,46.4,49.7,43.1,00000
48.0,42.0,51.0,444,01,01,  Kandail,1257,1595,647,810,610,785,44.1,44.4,43.7,00000
48.0,42.0,51.0,444,02,01,  Khidirpur,337,693,159,345,178,348,32.7,31.5,33.8,00000
48.0,42.0,51.0,444,03,01,  Shimulgara,354,731,182,377,172,354,32.6,32.6,32.7,00000
48.0,42.0,51.0,444,04,01,  Kokimadal,507,552,264,258,243,294,47.9,50.6,45.3,00000
48.0,42.0,51.0,444,05,01,  Sankanda,122,392,62,182,60,210,23.7,25.4,22.2,00000
48.0,42.0,51.0,444,06,01,  Bankanda,188,233,94,118,94,115,44.7,44.3,45.0,00000
48.0,42.0,51.0,444,07,01,  Bakpara,132,470,69,239,63,231,21.9,22.4,21.4,00000
48.0,42.0,51.0,612,01,01,  Mathura Para Purba,746,1509,388,747,358,762,33.1,34.2,32.0,00000
48.0,42.0,51.0,612,02,01,  Paschim Mathura Para,416,1086,196,567,220,519,27.7,25.7,29.8,00000
48.0,42.0,51.0,655,01,01,  Nansri,1063,1715,577,840,486,875,38.3,40.7,35.7,00000
48.0,42.0,51.0,655,02,01,  Golapiahat,381,759,197,401,184,358,33.4,32.9,33.9,00000
48.0,42.0,51.0,655,03,01,  Kadamtala,441,923,242,466,199,457,32.3,34.2,30.3,00000
48.0,42.0,51.0,655,04,01,  Mtala,156,518,73,262,83,256,23.1,21.8,24.5,00000
48.0,42.0,51.0,655,05,01,  Gobindpur,204,351,101,176,103,175,36.8,36.5,37.1,00000
48.0,42.0,51.0,655,06,01,  Uttar Nansree,356,784,182,382,174,402,31.2,32.3,30.2,00000
48.0,42.0,51.0,655,07,01,  Garuakanda,59,232,25,129,34,103,20.3,16.2,24.8,00000
48.0,42.0,51.0,655,08,01,  Alamdi Para,478,248,234,113,244,135,65.8,67.4,64.4,00000
48.0,42.0,51.0,655,09,01,  Hatiakore,104,359,50,196,54,163,22.5,20.3,24.9,00000
48.0,42.0,51.0,655,10,01,  Chakerbari,53,93,32,47,21,46,36.3,40.5,31.3,00000
48.0,42.0,60.0,175,01,01,  Chandpur,584,1072,287,494,297,578,35.3,36.7,33.9,00000
48.0,42.0,60.0,175,02,01,  Satar Daria,855,1231,383,563,472,668,41.0,40.5,41.4,00000
48.0,42.0,60.0,292,01,01,  Pathan Para,566,1327,289,646,277,681,29.9,30.9,28.9,00000
48.0,42.0,60.0,292,02,01,  Gangail,620,979,299,471,321,508,38.8,38.8,38.7,00000
48.0,42.0,60.0,292,03,01,  Satirpur,1119,854,570,382,549,472,56.7,59.9,53.8,00000
48.0,42.0,60.0,292,04,01,  Bara Char,518,871,252,386,266,485,37.3,39.5,35.4,00000
48.0,42.0,60.0,292,05,01,  Jangal,353,266,179,116,174,150,57.0,60.7,53.7,00000
48.0,42.0,60.0,292,06,01,  Banjir Char,291,418,133,187,158,231,41.0,41.6,40.6,00000
48.0,42.0,60.0,292,07,01,  Bhiskaniya,208,338,100,147,108,191,38.1,40.5,36.1,00000
48.0,42.0,60.0,409,01,01,  Kurshakhali,699,501,293,201,406,300,58.3,59.3,57.5,00000
48.0,42.0,60.0,409,02,01,  Jangalbari,359,275,168,117,191,158,56.6,58.9,54.7,00000
48.0,42.0,60.0,409,03,01,  Muslim Para,653,327,252,121,401,206,66.6,67.6,66.1,00000
48.0,42.0,60.0,409,04,01,  Nama Para,441,588,209,287,232,301,42.9,42.1,43.5,00000
48.0,42.0,60.0,409,05,01,  Rahimpur,53,302,23,141,30,161,14.9,14.0,15.7,00000
48.0,42.0,60.0,409,06,01,  Islam Para,722,363,341,148,381,215,66.5,69.7,63.9,00000
48.0,42.0,60.0,737,01,01,  Patuair,389,336,201,166,188,170,53.7,54.8,52.5,00000
48.0,42.0,60.0,737,02,01,  Galimgazi,248,632,113,316,135,316,28.2,26.3,29.9,00000
48.0,42.0,60.0,749,01,01,  Hatra Para,1721,1929,859,867,862,1062,47.2,49.8,44.8,00000
48.0,42.0,60.0,749,02,01,  Khirarchar,210,366,101,181,109,185,36.5,35.8,37.1,00000
48.0,42.0,60.0,749,03,01,  Islampur,314,601,159,285,155,316,34.3,35.8,32.9,00000
48.0,42.0,71.0,526,01,01,  Gang Para,83,168,41,81,42,87,33.1,33.6,32.6,00000
48.0,42.0,71.0,526,02,01,  Fakir Para,277,440,128,199,149,241,38.6,39.1,38.2,00000
48.0,42.0,71.0,526,03,01,  Majpara,538,927,252,423,286,504,36.7,37.3,36.2,00000
48.0,42.0,71.0,526,04,01,  Bilpara,503,790,237,392,266,398,38.9,37.7,40.1,00000
48.0,42.0,71.0,526,05,01,  Katlamari,146,191,66,87,80,104,43.3,43.1,43.5,00000
48.0,42.0,71.0,526,06,01,  Gauragop,325,749,170,337,155,412,30.3,33.5,27.3,00000
48.0,42.0,71.0,526,07,01,  Hasmal,200,192,102,80,98,112,51.0,56.0,46.7,00000
48.0,42.0,71.0,526,08,01,  Bicharkanda,273,415,138,201,135,214,39.7,40.7,38.7,00000
48.0,42.0,71.0,561,01,01,  Dakshin Lakhpur,164,484,90,222,74,262,25.3,28.8,22.0,00000
48.0,42.0,71.0,561,02,01,  Uttar Lakhpur,230,596,118,285,112,311,27.8,29.3,26.5,00000
48.0,42.0,77.0,667,01,01,  Dawpur,1577,1246,819,568,758,678,55.9,59.0,52.8,00000
48.0,42.0,77.0,667,02,01,  Niamatpur,299,697,154,322,145,375,30.0,32.4,27.9,00000
48.0,42.0,77.0,667,03,01,  Dalakanda,362,498,172,263,190,235,42.1,39.5,44.7,00000
48.0,42.0,77.0,667,04,01,  Morikanda,706,941,366,460,340,481,42.9,44.3,41.4,00000
48.0,42.0,77.0,667,05,01,  Angurkanda,82,257,38,132,44,125,24.2,22.4,26.0,00000
48.0,42.0,77.0,667,06,01,  Nihirazpara,521,923,269,434,252,489,36.1,38.3,34.0,00000
48.0,42.0,77.0,667,07,01,  Hazipara,268,515,128,232,140,283,34.2,35.6,33.1,00000
48.0,42.0,77.0,667,08,01,  Gonapara,108,225,53,110,55,115,32.4,32.5,32.4,00000
48.0,42.0,77.0,667,09,01,  Bharchar,156,795,77,415,79,380,16.4,15.7,17.2,00000
48.0,42.0,77.0,994,01,01,  Uttar Mansantosh,319,535,155,269,164,266,37.4,36.6,38.1,00000
48.0,42.0,77.0,994,02,01,  Danshin Mansatosh,938,1226,466,605,472,621,43.3,43.5,43.2,00000
48.0,42.0,94.0,983,01,01,  Uttar Ganeshpur,1255,2145,648,1086,607,1059,36.9,37.4,36.4,00000
48.0,45.0,13.0,207,01,01,  Bhitadia,701,1113,301,538,400,575,38.6,35.9,41.0,00000
48.0,45.0,13.0,207,02,01,  Agrirkona,136,279,67,129,69,150,32.8,34.2,31.5,00000
48.0,45.0,13.0,207,03,01,  Khagal,136,208,58,94,78,114,39.5,38.2,40.6,00000
48.0,45.0,13.0,207,04,01,  Jallabad,68,159,31,78,37,81,30.0,28.4,31.4,00000
48.0,45.0,13.0,435,01,01,  Ganergaon,721,1352,345,638,376,714,34.8,35.1,34.5,00000
48.0,45.0,13.0,435,02,01,  Taltala,177,443,83,207,94,236,28.5,28.6,28.5,00000
48.0,45.0,19.0,114,01,01,  Banagram,788,1179,402,585,386,594,40.1,40.7,39.4,00000
48.0,45.0,19.0,114,02,01,  Nandipur,462,479,248,218,214,261,49.1,53.2,45.1,00000
48.0,45.0,19.0,124,01,01,  Paschimpara,842,1571,384,753,458,818,34.9,33.8,35.9,00000
48.0,45.0,19.0,124,02,01,  Kataltali,365,743,169,354,196,389,32.9,32.3,33.5,00000
48.0,45.0,19.0,373,01,01,  Dasergaon,460,446,210,193,250,253,50.8,52.1,49.7,00000
48.0,45.0,19.0,373,02,01,  Tilkanda,84,266,36,121,48,145,24.0,22.9,24.9,00000
48.0,45.0,19.0,518,01,01,  Purbapara,504,749,220,347,284,402,40.2,38.8,41.4,00000
48.0,45.0,19.0,518,02,01,  Paschimpara,699,621,332,300,367,321,53.0,52.5,53.3,00000
48.0,45.0,19.0,766,01,01,  Purbapara,792,1644,349,776,443,868,32.5,31.0,33.8,00000
48.0,45.0,19.0,766,02,01,  Paschimpara,429,887,204,412,225,475,32.6,33.1,32.1,00000
48.0,45.0,19.0,829,01,01,  Noapara,487,613,206,281,281,332,44.3,42.3,45.8,00000
48.0,45.0,19.0,829,02,01,  Kuria Para,428,1065,208,526,220,539,28.7,28.3,29.0,00000
48.0,45.0,19.0,974,01,01,  Simuha,580,1356,253,676,327,680,30.0,27.2,32.5,00000
48.0,45.0,19.0,974,02,01,  Bhiti Para Purbapara,309,443,134,215,175,228,41.1,38.4,43.4,00000
48.0,45.0,19.0,974,03,01,  Bhiti Para Paschimpara,669,1309,339,618,330,691,33.8,35.4,32.3,00000
48.0,45.0,28.0,165,01,01,  Tan Bhanga Nadi,253,392,104,184,149,208,39.2,36.1,41.7,00000
48.0,45.0,28.0,165,02,01,  Bhanga Nadi Naya Para,229,792,97,363,132,429,22.4,21.1,23.5,00000
48.0,45.0,28.0,269,01,01,  Balibarpar,220,284,110,122,110,162,43.7,47.4,40.4,00000
48.0,45.0,28.0,269,02,01,  Paschim Boratia,172,268,78,141,94,127,39.1,35.6,42.5,00000
48.0,45.0,28.0,269,03,01,  Dhuparbagh,56,53,30,23,26,30,51.4,56.6,46.4,00000
48.0,45.0,28.0,269,04,01,  Nimak Purura,436,575,189,251,247,324,43.1,43.0,43.3,00000
48.0,45.0,28.0,269,05,01,  Dash Kahania,169,436,91,204,78,232,27.9,30.8,25.2,00000
48.0,45.0,28.0,269,06,01,  Shimuliakanda,110,127,51,59,59,68,46.4,46.4,46.5,00000
48.0,45.0,28.0,269,07,01,  Chatorkanda,36,78,21,37,15,41,31.6,36.2,26.8,00000
48.0,45.0,28.0,269,08,01,  Purba Baratia,75,205,29,88,46,117,26.8,24.8,28.2,00000
48.0,45.0,28.0,269,09,01,  Kazi Para,30,76,14,32,16,44,28.3,30.4,26.7,00000
48.0,45.0,28.0,269,10,01,  Durgapur,649,1401,311,658,338,743,31.7,32.1,31.3,00000
48.0,45.0,28.0,269,11,01,  Uttar Chandpur,344,339,160,146,184,193,50.4,52.3,48.8,00000
48.0,45.0,28.0,269,12,01,  Madhya Chandpur,476,773,213,345,263,428,38.1,38.2,38.1,00000
48.0,45.0,28.0,269,13,01,  Kurerpar,350,365,153,150,197,215,49.0,50.5,47.8,00000
48.0,45.0,28.0,269,14,01,  Galimkharbagh,146,127,58,59,88,68,53.5,49.6,56.4,00000
48.0,45.0,28.0,269,15,01,  Tentultala,57,363,21,171,36,192,13.6,10.9,15.8,00000
48.0,45.0,28.0,269,16,01,  Easapura,19,136,8,60,11,76,12.3,11.8,12.6,00000
48.0,45.0,28.0,269,17,01,  Naya Para,96,403,52,191,44,212,19.2,21.4,17.2,00000
48.0,45.0,28.0,269,18,01,  Panch Para,129,295,56,140,73,155,30.4,28.6,32.0,00000
48.0,45.0,28.0,269,19,01,  Dewalerkanda,55,164,20,86,35,78,25.1,18.9,31.0,00000
48.0,45.0,28.0,269,20,01,  Manzilerkanda,349,502,167,238,182,264,41.0,41.2,40.8,00000
48.0,45.0,28.0,269,21,01,  Sekher Para,222,376,112,173,110,203,37.1,39.3,35.1,00000
48.0,45.0,28.0,269,22,01,  Kona Para,298,460,134,204,164,256,39.3,39.6,39.0,00000
48.0,45.0,28.0,269,23,01,  Baburchi Para,54,73,22,33,32,40,42.5,40.0,44.4,00000
48.0,45.0,28.0,269,24,01,  Hajibari,86,53,45,20,41,33,61.9,69.2,55.4,00000
48.0,45.0,28.0,269,25,01,  Purbapara,229,417,118,201,111,216,35.4,37.0,33.9,00000
48.0,45.0,28.0,269,26,01,  Madinaj Para,167,624,91,301,76,323,21.1,23.2,19.0,00000
48.0,45.0,28.0,269,27,01,  Bara Para,256,253,120,98,136,155,50.3,55.0,46.7,00000
48.0,45.0,28.0,269,28,01,  Goalia Para,198,424,100,200,98,224,31.8,33.3,30.4,00000
48.0,45.0,28.0,269,29,01,  Mirer Para,466,748,206,344,260,404,38.4,37.5,39.2,00000
48.0,45.0,28.0,269,30,01,  Bhabanipur,86,91,45,40,41,51,48.6,52.9,44.6,00000
48.0,45.0,28.0,269,31,01,  Jaruarpar,38,85,16,45,22,40,30.9,26.2,35.5,00000
48.0,45.0,28.0,269,32,01,  Nagdorar Par,66,86,34,37,32,49,43.4,47.9,39.5,00000
48.0,45.0,28.0,269,33,01,  Dangurdia,44,125,15,59,29,66,26.0,20.3,30.5,00000
48.0,45.0,28.0,269,34,01,  Bhodrashon,23,86,11,37,12,49,21.1,22.9,19.7,00000
48.0,45.0,28.0,269,35,01,  Tatail,46,167,16,80,30,87,21.6,16.7,25.6,00000
48.0,45.0,28.0,715,01,01,  Paschim Mandalbhog,143,831,76,423,67,408,14.7,15.2,14.1,00000
48.0,45.0,28.0,715,02,01,  Purba Mandalbhog,367,949,163,450,204,499,27.9,26.6,29.0,00000
48.0,45.0,28.0,715,03,01,  Para Mandalbhog,159,353,59,167,100,186,31.1,26.1,35.0,00000
48.0,45.0,47.0,217,01,01,  Bhuna,914,1023,399,456,515,567,47.2,46.7,47.6,00000
48.0,45.0,47.0,217,02,01,  Kura Para,274,201,131,74,143,127,57.7,63.9,53.0,00000
48.0,45.0,47.0,217,03,01,  Katurdia,93,462,43,226,50,236,16.8,16.0,17.5,00000
48.0,45.0,47.0,590,01,01,  Kaona Mamudpur,201,206,100,92,101,114,49.4,52.1,47.0,00000
48.0,45.0,47.0,590,02,01,  Kauna,163,348,83,164,80,184,31.9,33.6,30.3,00000
48.0,45.0,47.0,590,03,01,  Kauna Para,371,696,185,337,186,359,34.8,35.4,34.1,00000
48.0,45.0,47.0,590,04,01,  Dhokhin Hati,290,469,152,208,138,261,38.2,42.2,34.6,00000
48.0,45.0,47.0,611,01,01,  Kargaon Kona Para,154,218,89,99,65,119,41.4,47.3,35.3,00000
48.0,45.0,47.0,611,02,01,  Bazzar Hati,80,280,37,127,43,153,22.2,22.6,21.9,00000
48.0,45.0,47.0,611,03,01,  Nelam Hati,169,139,93,62,76,77,54.9,60.0,49.7,00000
48.0,45.0,47.0,611,04,01,  Fukkar Par,111,355,49,187,62,168,23.8,20.8,27.0,00000
48.0,45.0,47.0,611,05,01,  Kumar Hati,186,223,105,109,81,114,45.5,49.1,41.5,00000
48.0,45.0,47.0,611,06,01,  Palwan Kha Hazi,505,433,236,213,269,220,53.8,52.6,55.0,00000
48.0,45.0,47.0,611,07,01,  Kargan.P.Para,366,810,188,366,178,444,31.1,33.9,28.6,00000
48.0,45.0,47.0,611,08,01,  Bastar Par,602,1031,270,490,332,541,36.9,35.5,38.0,00000
48.0,45.0,66.0,673,01,01,  Lohajuri Uttar,1264,1458,660,670,604,788,46.4,49.6,43.4,00000
48.0,45.0,66.0,673,02,01,  Lohajuri Dakhin,1350,1652,634,807,716,845,45.0,44.0,45.9,00000
48.0,45.0,66.0,673,03,01,  Baher Char,855,759,379,360,476,399,53.0,51.3,54.4,00000
48.0,45.0,66.0,673,04,01,  Uttar Jirir Par,517,1115,248,516,269,599,31.7,32.5,31.0,00000
48.0,45.0,66.0,673,05,01,  Jirir Par,540,1121,250,545,290,576,32.5,31.4,33.5,00000
48.0,45.0,66.0,901,01,01,  Uttar Char Paratala,921,1105,429,543,492,562,45.5,44.1,46.7,00000
48.0,45.0,66.0,901,02,01,  Dakshin Char Paratala,550,1165,254,557,296,608,32.1,31.3,32.7,00000
48.0,45.0,66.0,901,03,01,  Daspaki,612,840,267,403,345,437,42.1,39.9,44.1,00000
48.0,45.0,76.0,145,01,01,  Betal,1143,1376,566,658,577,718,45.4,46.2,44.6,00000
48.0,45.0,76.0,145,02,01,  Char Betal,737,877,379,399,358,478,45.7,48.7,42.8,00000
48.0,45.0,76.0,145,03,01,  Simul Kandi,187,261,88,131,99,130,41.7,40.2,43.2,00000
48.0,45.0,76.0,559,01,01,  Kaziar Char,962,718,423,354,539,364,57.3,54.4,59.7,00000
48.0,45.0,76.0,559,02,01,  Pramar Char,419,347,194,180,225,167,54.7,51.9,57.4,00000
48.0,45.0,76.0,601,01,01,  Kareha,473,328,211,138,262,190,59.1,60.5,58.0,00000
48.0,45.0,76.0,601,02,01,  Fuldi,415,567,181,292,234,275,42.3,38.3,46.0,00000
48.0,45.0,76.0,601,03,01,  Meratala,337,198,158,86,179,112,63.0,64.8,61.5,00000
48.0,45.0,76.0,601,04,01,  Char Algi,382,314,175,145,207,169,54.9,54.7,55.1,00000
48.0,45.0,76.0,746,01,01,  Mugdia,763,930,335,457,428,473,45.1,42.3,47.5,00000
48.0,45.0,76.0,746,02,01,  Char Algi,1366,1723,590,780,776,943,44.2,43.1,45.1,00000
48.0,45.0,85.0,304,01,01,  Uttar Mumurdia,778,1391,362,720,416,671,35.9,33.5,38.3,00000
48.0,45.0,85.0,304,02,01,  Dokhin Murdia,948,1589,440,722,508,867,37.4,37.9,36.9,00000
48.0,45.0,95.0,404,01,01,  Diakul,701,614,291,265,410,349,53.3,52.3,54.0,00000
48.0,45.0,95.0,404,02,01,  Pardiakul,502,417,204,195,298,222,54.6,51.1,57.3,00000
48.0,45.0,95.0,787,01,01,  Naobaria,742,480,327,220,415,260,60.7,59.8,61.5,00000
48.0,45.0,95.0,787,02,01,  Phulbaria,191,289,75,149,116,140,39.8,33.5,45.3,00000
48.0,49.0,16.0,195,01,01,  Binnati,659,1201,314,591,345,610,35.4,34.7,36.1,00000
48.0,49.0,16.0,195,02,01,  Burir Char,97,570,44,286,53,284,14.5,13.3,15.7,00000
48.0,49.0,16.0,195,03,01,  Atra Para,253,173,125,84,128,89,59.4,59.8,59.0,00000
48.0,49.0,16.0,195,04,01,  Jogi Khali,858,388,404,197,454,191,68.9,67.2,70.4,00000
48.0,49.0,16.0,195,05,01,  Dari Binnati,198,78,111,25,87,53,71.7,81.6,62.1,00000
48.0,49.0,16.0,316,01,01,  Shyamnagar,194,227,95,117,99,110,46.1,44.8,47.4,00000
48.0,49.0,16.0,316,02,01,  Giria Para,341,386,141,198,200,188,46.9,41.6,51.5,00000
48.0,49.0,16.0,316,03,01,  Danail,591,556,286,279,305,277,51.5,50.6,52.4,00000
48.0,49.0,17.0,520,01,01,  Sayana Madinagar,477,643,227,313,250,330,42.6,42.0,43.1,00000
48.0,49.0,17.0,520,02,01,  Terhashia,328,802,173,378,155,424,29.0,31.4,26.8,00000
48.0,49.0,17.0,520,03,01,  Dhakin Rakzkuti,691,1406,367,651,324,755,33.0,36.1,30.0,00000
48.0,49.0,17.0,520,04,01,  Uttar Razkuti,602,747,320,336,282,411,44.6,48.8,40.7,00000
48.0,49.0,17.0,781,01,01,  Mocharbaid,319,655,149,328,170,327,32.8,31.2,34.2,00000
48.0,49.0,17.0,781,02,01,  Korerpar,916,2925,446,1469,470,1456,23.8,23.3,24.4,00000
48.0,49.0,17.0,781,03,01,  Naya Para,424,1291,203,612,221,679,24.7,24.9,24.6,00000
48.0,49.0,17.0,781,04,01,  Gabtala,220,528,111,259,109,269,29.4,30.0,28.8,00000
48.0,49.0,17.0,781,05,01,  Moishakhali,559,1023,240,476,319,547,35.3,33.5,36.8,00000
48.0,49.0,17.0,781,06,01,  Kathalia,473,1141,257,560,216,581,29.3,31.5,27.1,00000
48.0,49.0,17.0,781,07,01,  Dikrikanda,283,363,140,170,143,193,43.8,45.2,42.6,00000
48.0,49.0,17.0,781,08,01,  Kalika Prasad,190,239,91,106,99,133,44.3,46.2,42.7,00000
48.0,49.0,17.0,781,09,01,  Purba Patdha,594,734,300,335,294,399,44.7,47.2,42.4,00000
48.0,49.0,17.0,781,10,01,  Goranierper (Moishakhali),142,436,75,199,67,237,24.6,27.4,22.0,00000
48.0,49.0,17.0,781,11,01,  Patariapara (Kathalia),88,536,44,268,44,268,14.1,14.1,14.1,00000
48.0,49.0,25.0,111,01,01,  Batail,236,368,108,176,128,192,39.1,38.0,40.0,00000
48.0,49.0,25.0,111,02,01,  Totiar Char,212,237,102,126,110,111,47.2,44.7,49.8,00000
48.0,49.0,25.0,260,01,01,  Uttarpara,631,1083,296,551,335,532,36.8,34.9,38.6,00000
48.0,49.0,25.0,260,02,01,  Paschimpara,580,547,276,255,304,292,51.5,52.0,51.0,00000
48.0,49.0,25.0,260,03,01,  Noapara,376,387,176,169,200,218,49.3,51.0,47.8,00000
48.0,49.0,25.0,260,04,01,  Brindagore,408,267,191,129,217,138,60.4,59.7,61.1,00000
48.0,49.0,25.0,260,05,01,  Jalia Para,186,236,87,117,99,119,44.1,42.6,45.4,00000
48.0,49.0,25.0,260,08,01,  Bara Khalerpar,229,401,102,197,127,204,36.3,34.1,38.4,00000
48.0,49.0,25.0,371,01,01,  Gop Jinaroy,329,742,156,378,173,364,30.7,29.2,32.2,00000
48.0,49.0,25.0,371,02,01,  Baklar Char,222,239,103,112,119,127,48.2,47.9,48.4,00000
48.0,49.0,25.0,371,03,01,  Sherpur,256,297,112,148,144,149,46.3,43.1,49.1,00000
48.0,49.0,25.0,371,04,01,  Barkhalerpar,433,550,205,275,228,275,44.0,42.7,45.3,00000
48.0,49.0,25.0,390,01,01,  Jalua Para,1124,1163,553,570,571,593,49.1,49.2,49.1,00000
48.0,49.0,25.0,390,02,01,  Naherdia,193,140,89,64,104,76,58.0,58.2,57.8,00000
48.0,49.0,25.0,390,03,01,  Gobindapur Gopthary Kanda,239,440,106,235,133,205,35.2,31.1,39.3,00000
48.0,49.0,25.0,669,01,01,  Matlabpur,372,513,175,246,197,267,42.0,41.6,42.5,00000
48.0,49.0,25.0,669,02,01,  Matlab Darbarpur,514,444,245,228,269,216,53.7,51.8,55.5,00000
48.0,49.0,25.0,706,01,01,  Nandla,1123,1465,536,718,587,747,43.4,42.7,44.0,00000
48.0,49.0,25.0,706,02,01,  Matikata,84,267,42,128,42,139,23.9,24.7,23.2,00000
48.0,49.0,25.0,706,03,01,  Madhurdia,186,569,93,259,93,310,24.6,26.4,23.1,00000
48.0,49.0,25.0,706,04,01,  Nandla Jalia,142,239,64,103,78,136,37.3,38.3,36.4,00000
48.0,49.0,25.0,716,01,01,  Nohar,375,1131,167,562,208,569,24.9,22.9,26.8,00000
48.0,49.0,25.0,716,02,01,  Darbarpur,476,637,230,319,246,318,42.8,41.9,43.6,00000
48.0,49.0,25.0,753,01,01,  Pankalima,269,199,120,97,149,102,57.5,55.3,59.4,00000
48.0,49.0,25.0,753,02,01,  Kajergaon,602,1044,285,529,317,515,36.6,35.0,38.1,00000
48.0,49.0,25.0,753,03,01,  Botkhela,75,234,43,108,32,126,24.3,28.5,20.3,00000
48.0,49.0,25.0,762,01,01,  Paramananda,348,456,161,220,187,236,43.3,42.3,44.2,00000
48.0,49.0,25.0,762,02,01,  Paglarkanda,257,529,115,281,142,248,32.7,29.0,36.4,00000
48.0,49.0,25.0,948,01,01,  Sultanpur,367,434,183,229,184,205,45.8,44.4,47.3,00000
48.0,49.0,25.0,948,02,01,  Paglar Kanda,421,632,204,337,217,295,40.0,37.7,42.4,00000
48.0,49.0,25.0,948,03,01,  Dolear Char,307,213,145,99,162,114,59.0,59.4,58.7,00000
48.0,49.0,34.0,306,01,01,  Kaliakanda,725,1097,330,532,395,565,39.8,38.3,41.1,00000
48.0,49.0,34.0,306,02,01,  Baher Hour,46,190,30,89,16,101,19.5,25.2,13.7,00000
48.0,49.0,34.0,306,03,01,  Hajipur,429,500,229,235,200,265,46.2,49.4,43.0,00000
48.0,49.0,34.0,306,04,01,  Danapatuli,347,1106,158,507,189,599,23.9,23.8,24.0,00000
48.0,49.0,34.0,344,01,01,  Rahimpur,83,227,25,124,58,103,26.8,16.8,36.0,00000
48.0,49.0,34.0,344,02,01,  Balakapur,128,451,70,215,58,236,22.1,24.6,19.7,00000
48.0,49.0,34.0,344,03,01,  Chader Hasi,221,331,100,151,121,180,40.0,39.8,40.2,00000
48.0,49.0,34.0,344,04,01,  Gaglail,601,1032,289,522,312,510,36.8,35.6,38.0,00000
48.0,49.0,34.0,678,01,01,  Manoharpur,115,182,46,99,69,83,38.7,31.7,45.4,00000
48.0,49.0,34.0,678,02,01,  Chariakandi,126,254,64,132,62,122,33.2,32.7,33.7,00000
48.0,49.0,34.0,678,03,01,  Sutarkunda,116,449,47,204,69,245,20.5,18.7,22.0,00000
48.0,49.0,43.0,409,01,01,  Manipurighat,582,642,293,310,289,332,47.5,48.6,46.5,00000
48.0,49.0,43.0,409,02,01,  Katakhali,700,787,380,392,320,395,47.1,49.2,44.8,00000
48.0,49.0,43.0,409,03,01,  Baniakandi,610,519,309,262,301,257,54.0,54.1,53.9,00000
48.0,49.0,43.0,409,04,01,  Muslim Para,305,450,170,200,135,250,40.4,45.9,35.1,00000
48.0,49.0,43.0,409,05,01,  Mirpara,269,163,158,90,111,73,62.3,63.7,60.3,00000
48.0,49.0,43.0,409,06,01,  Madhyapara,839,1132,418,532,421,600,42.6,44.0,41.2,00000
48.0,49.0,43.0,409,07,01,  Goalapara,148,667,73,331,75,336,18.2,18.1,18.2,00000
48.0,49.0,43.0,409,08,01,  Ray Para,226,407,115,198,111,209,35.7,36.7,34.7,00000
48.0,49.0,43.0,902,01,01,  Dolia Char,424,705,190,358,234,347,37.6,34.7,40.3,00000
48.0,49.0,43.0,902,02,01,  Nodar,833,801,420,379,413,422,51.0,52.6,49.5,00000
48.0,49.0,43.0,902,03,01,  Bhubir Char,877,1182,416,581,461,601,42.6,41.7,43.4,00000
48.0,49.0,43.0,902,04,01,  Babundia,328,629,170,301,158,328,34.3,36.1,32.5,00000
48.0,49.0,43.0,902,05,01,  Bagh Para,201,163,97,84,104,79,55.2,53.6,56.8,00000
48.0,49.0,43.0,902,06,01,  Isasoure,468,589,226,298,242,291,44.3,43.1,45.4,00000
48.0,49.0,43.0,902,07,01,  Kunamati,227,499,111,244,116,255,31.3,31.3,31.3,00000
48.0,49.0,43.0,902,08,01,  Nowa Para Khas Para,244,408,129,197,115,211,37.4,39.6,35.3,00000
48.0,49.0,51.0,483,01,01,  Karsha Karail,1430,1430,666,688,764,742,50.0,49.2,50.7,00000
48.0,49.0,51.0,483,02,01,  Kankati,246,478,126,225,120,253,34.0,35.9,32.2,00000
48.0,49.0,51.0,483,03,01,  Chiknir Char,908,1365,415,623,493,742,39.9,40.0,39.9,00000
48.0,49.0,51.0,483,04,01,  Monakosa,531,1045,216,478,315,567,33.7,31.1,35.7,00000
48.0,49.0,60.0,065,01,01,  Barabhag,1085,1857,495,894,590,963,36.9,35.6,38.0,00000
48.0,49.0,60.0,065,02,01,  Sadullar Char,985,1381,482,703,503,678,41.6,40.7,42.6,00000
48.0,49.0,60.0,576,01,01,  Purba Latibabad,1555,2700,765,1353,790,1347,36.5,36.1,37.0,00000
48.0,49.0,60.0,576,02,01,  Paschim Latibabad,954,1164,451,573,503,591,45.0,44.0,46.0,00000
48.0,49.0,69.0,520,01,01,  Bade Sholakia,314,682,153,337,161,345,31.5,31.2,31.8,00000
48.0,49.0,69.0,520,02,01,  Gangail,350,1040,162,520,188,520,25.2,23.8,26.6,00000
48.0,49.0,69.0,539,01,01,  Chong Sholakia,544,1284,256,626,288,658,29.8,29.0,30.4,00000
48.0,49.0,69.0,539,02,01,  Kotsholakia,218,293,112,142,106,151,42.7,44.1,41.2,00000
48.0,49.0,69.0,604,01,01,  Char Para,235,190,116,102,119,88,55.3,53.2,57.5,00000
48.0,49.0,69.0,604,02,01,  Uttarpara,721,836,395,421,326,415,46.3,48.4,44.0,00000
48.0,49.0,69.0,604,03,01,  Naya Para,239,548,126,268,113,280,30.4,32.0,28.8,00000
48.0,49.0,69.0,604,04,01,  Maje Para,263,349,142,160,121,189,43.0,47.0,39.0,00000
48.0,49.0,69.0,604,05,01,  Goala Para,181,243,89,119,92,124,42.7,42.8,42.6,00000
48.0,49.0,69.0,604,06,01,  Bhadra Para,348,418,183,205,165,213,45.4,47.2,43.7,00000
48.0,49.0,69.0,604,07,01,  Kasurar Char,666,946,346,442,320,504,41.3,43.9,38.8,00000
48.0,49.0,69.0,604,08,01,  Nath Para,96,240,42,118,54,122,28.6,26.3,30.7,00000
48.0,49.0,69.0,604,09,01,  Agpara,194,136,89,63,105,73,58.8,58.6,59.0,00000
48.0,49.0,69.0,604,10,01,  Galim Gazi,655,375,339,174,316,201,63.6,66.1,61.1,00000
48.0,49.0,69.0,604,11,01,  Bhatuar Para,386,664,194,349,192,315,36.8,35.7,37.9,00000
48.0,49.0,69.0,929,01,01,  Sholakia,282,291,145,141,137,150,49.2,50.7,47.7,00000
48.0,49.0,69.0,929,02,01,  Kala Para,1744,1125,881,568,863,557,60.8,60.8,60.8,00000
48.0,49.0,77.0,632,01,01,  Kachari Para,600,834,319,390,281,444,41.8,45.0,38.8,00000
48.0,49.0,77.0,632,02,01,  Bashania Para,276,629,137,292,139,337,30.5,31.9,29.2,00000
48.0,49.0,77.0,632,03,01,  Islampur,218,453,112,209,106,244,32.5,34.9,30.3,00000
48.0,49.0,77.0,632,04,01,  Majumder Para,297,557,156,265,141,292,34.8,37.1,32.6,00000
48.0,49.0,77.0,632,05,01,  Chowdhuryhati,564,673,261,328,303,345,45.6,44.3,46.8,00000
48.0,49.0,77.0,632,06,01,  Patuakandi,143,233,65,107,78,126,38.0,37.8,38.2,00000
48.0,49.0,77.0,632,07,01,  Bazari Para,476,585,244,259,232,326,44.9,48.5,41.6,00000
48.0,49.0,77.0,632,08,01,  Bepari Para,478,838,226,395,252,443,36.3,36.4,36.3,00000
48.0,49.0,77.0,632,09,01,  Hajirgal,756,1136,333,548,423,588,40.0,37.8,41.8,00000
48.0,49.0,77.0,632,10,01,  Bade Maijkapar,157,248,62,120,95,128,38.8,34.1,42.6,00000
48.0,49.0,77.0,743,01,01,  Panchdha,861,1618,424,797,437,821,34.7,34.7,34.7,00000
48.0,49.0,77.0,743,02,01,  Soundir Band,608,773,290,340,318,433,44.0,46.0,42.3,00000
48.0,49.0,77.0,743,03,01,  Bakharnagar,235,336,129,159,106,177,41.2,44.8,37.5,00000
48.0,49.0,86.0,185,01,01,  Pathankandi,638,474,326,228,312,246,57.4,58.8,55.9,00000
48.0,49.0,86.0,185,02,01,  Katiar Char,2218,3326,1080,1704,1138,1622,40.0,38.8,41.2,00000
48.0,49.0,86.0,185,03,01,  Jatasira,287,140,148,67,139,73,67.2,68.8,65.6,00000
48.0,49.0,86.0,185,04,01,  Khil Para,803,1323,368,676,435,647,37.8,35.2,40.2,00000
48.0,49.0,86.0,185,05,01,  Bourungar Char,323,520,141,249,182,271,38.3,36.2,40.2,00000
48.0,49.0,86.0,185,06,01,  Mollah Para,823,895,422,455,401,440,47.9,48.1,47.7,00000
48.0,49.0,86.0,185,07,01,  Bagadia,1475,1447,735,705,740,742,50.5,51.0,49.9,00000
48.0,49.0,86.0,185,08,01,  Karmuli,54,64,27,31,27,33,45.8,46.6,45.0,00000
48.0,49.0,86.0,650,01,01,  Maria,2048,1844,965,853,1083,991,52.6,53.1,52.2,00000
48.0,49.0,86.0,650,02,01,  Char Maria,846,1522,378,767,468,755,35.7,33.0,38.3,00000
48.0,54.0,11.0,259,01,01,  Chhaysuti,970,997,473,459,497,538,49.3,50.8,48.0,00000
48.0,54.0,11.0,259,02,01,  Bara Chhaysuti,1047,1483,470,706,577,777,41.4,40.0,42.6,00000
48.0,54.0,11.0,259,03,01,  Nijgaon,86,362,35,161,51,201,19.2,17.9,20.2,00000
48.0,54.0,11.0,259,04,01,  Dhupakhali,441,765,192,338,249,427,36.6,36.2,36.8,00000
48.0,54.0,11.0,259,05,01,  Hajarinagar,232,804,116,395,116,409,22.4,22.7,22.1,00000
48.0,54.0,11.0,259,06,01,  Noagaon,501,790,249,387,252,403,38.8,39.2,38.5,00000
48.0,54.0,11.0,259,07,01,  Shola Rashi,433,590,209,297,224,293,42.3,41.3,43.3,00000
48.0,54.0,11.0,259,08,01,  Nalabaid,133,238,52,92,81,146,35.8,36.1,35.7,00000
48.0,54.0,11.0,259,09,01,  Nasirakandi,344,375,153,186,191,189,47.8,45.1,50.3,00000
48.0,54.0,11.0,259,10,01,  Lakshmipur,118,345,59,150,59,195,25.5,28.2,23.2,00000
48.0,54.0,11.0,281,01,01,  Chhota Chhaysuti,462,645,219,283,243,362,41.7,43.6,40.2,00000
48.0,54.0,11.0,281,02,01,  Chand Mandalerkandi,84,104,50,50,34,54,44.7,50.0,38.6,00000
48.0,54.0,11.0,367,01,01,  Dariakandi,737,1332,359,633,378,699,35.6,36.2,35.1,00000
48.0,54.0,11.0,367,02,01,  Kandigram,623,1008,258,478,365,530,38.2,35.1,40.8,00000
48.0,54.0,11.0,497,01,01,  Kalakopa,322,706,148,317,174,389,31.3,31.8,30.9,00000
48.0,54.0,11.0,497,02,01,  Madhuar Char,106,89,55,44,51,45,54.4,55.6,53.1,00000
48.0,54.0,11.0,692,01,01,  Madhabdi,729,1094,337,515,392,579,40.0,39.6,40.4,00000
48.0,54.0,11.0,692,02,01,  Lalpur,625,507,306,225,319,282,55.2,57.6,53.1,00000
48.0,54.0,11.0,713,01,01,  Matikata,571,1140,223,521,348,619,33.4,30.0,36.0,00000
48.0,54.0,11.0,713,02,01,  Hapania,181,447,74,210,107,237,28.8,26.1,31.1,00000
48.0,54.0,11.0,757,01,01,  Uttar Nandarampur,283,321,128,156,155,165,46.9,45.1,48.4,00000
48.0,54.0,11.0,757,02,01,  Dakshin Nandarampur,446,734,192,357,254,377,37.8,35.0,40.3,00000
48.0,54.0,23.0,043,01,01,  Alalpur,530,405,231,166,299,239,56.7,58.2,55.6,00000
48.0,54.0,23.0,043,02,01,  Alinagar,170,332,89,159,81,173,33.9,35.9,31.9,00000
48.0,54.0,23.0,043,03,01,  Khidirpur,378,767,149,358,229,409,33.0,29.4,35.9,00000
48.0,54.0,23.0,389,01,01,  Faridpur,1277,1809,606,845,671,964,41.4,41.8,41.0,00000
48.0,54.0,23.0,389,02,01,  Amadpur,386,341,158,155,228,186,53.1,50.5,55.1,00000
48.0,54.0,23.0,778,01,01,  Napiter Char,660,756,345,347,315,409,46.6,49.9,43.5,00000
48.0,54.0,23.0,778,02,01,  Char Para,154,473,91,216,63,257,24.6,29.6,19.7,00000
48.0,54.0,23.0,778,03,01,  Nalbaid,771,1008,363,449,408,559,43.3,44.7,42.2,00000
48.0,54.0,35.0,432,01,01,  Lakshmipur,4338,4795,2052,2232,2286,2563,47.5,47.9,47.1,00000
48.0,54.0,35.0,432,02,01,  Gobaria,4679,3239,2311,1452,2368,1787,59.1,61.4,57.0,00000
48.0,54.0,35.0,432,03,01,  Daskahunia,794,604,409,276,385,328,56.8,59.7,54.0,00000
48.0,54.0,35.0,432,04,01,  Algir Char,231,283,113,137,118,146,44.9,45.2,44.7,00000
48.0,54.0,35.0,432,05,01,  Bara Char,1805,1080,881,493,924,587,62.6,64.1,61.2,00000
48.0,54.0,35.0,432,06,01,  Paschim Abdullapur,977,840,430,385,547,455,53.8,52.8,54.6,00000
48.0,54.0,35.0,432,07,01,  Purba Abdullapur,1510,755,742,339,768,416,66.7,68.6,64.9,00000
48.0,54.0,35.0,432,08,01,  Bhati Jagat Char,849,390,421,179,428,211,68.5,70.2,67.0,00000
48.0,54.0,35.0,432,09,01,  Jafrabad,489,191,245,85,244,106,71.9,74.2,69.7,00000
48.0,54.0,59.0,086,01,01,  Alir Char,298,393,158,187,140,206,43.1,45.8,40.5,00000
48.0,54.0,59.0,086,02,01,  Royer Char,108,126,54,55,54,71,46.2,49.5,43.2,00000
48.0,54.0,59.0,540,01,01,  Kapashatia,464,611,251,294,213,317,43.2,46.1,40.2,00000
48.0,54.0,59.0,540,02,01,  Uttardia,53,226,25,118,28,108,19.0,17.5,20.6,00000
48.0,54.0,59.0,800,01,01,  Nazir Dighi,683,1176,350,577,333,599,36.7,37.8,35.7,00000
48.0,54.0,59.0,800,02,01,  Noapara,240,266,103,117,137,149,47.4,46.8,47.9,00000
48.0,54.0,59.0,800,03,01,  Khailajuri,49,420,21,203,28,217,10.4,9.4,11.4,00000
48.0,54.0,59.0,800,04,01,  Chouhardi,140,603,71,284,69,319,18.8,20.0,17.8,00000
48.0,54.0,59.0,821,01,01,  Osmanpur,931,1301,462,595,469,706,41.7,43.7,39.9,00000
48.0,54.0,59.0,821,02,01,  Khilirband,368,573,169,275,199,298,39.1,38.1,40.0,00000
48.0,54.0,71.0,021,01,01,  Agarpur Paschimpara,329,540,167,240,162,300,37.9,41.0,35.1,00000
48.0,54.0,71.0,021,02,01,  Temoni Para,170,108,86,45,84,63,61.2,65.6,57.1,00000
48.0,54.0,71.0,021,03,01,  Bagh Para,313,695,178,326,135,369,31.1,35.3,26.8,00000
48.0,54.0,71.0,021,04,01,  Khan Para (Khalpar),396,504,200,248,196,256,44.0,44.6,43.4,00000
48.0,54.0,71.0,021,05,01,  Kona Para,408,426,225,197,183,229,48.9,53.3,44.4,00000
48.0,54.0,71.0,021,06,01,  Atka Para,140,143,65,73,75,70,49.5,47.1,51.7,00000
48.0,54.0,71.0,021,07,01,  Barkanda,255,130,141,48,114,82,66.2,74.6,58.2,00000
48.0,54.0,71.0,021,08,01,  Daspara,94,312,53,144,41,168,23.2,26.9,19.6,00000
48.0,54.0,71.0,021,09,01,  Modak Para,132,115,73,51,59,64,53.4,58.9,48.0,00000
48.0,54.0,71.0,021,10,01,  Hariakanda,470,623,252,293,218,330,43.0,46.2,39.8,00000
48.0,54.0,71.0,454,01,01,  Mujrai,553,685,268,337,285,348,44.7,44.3,45.0,00000
48.0,54.0,71.0,454,02,01,  Jagat Char Paschimpara,860,525,484,255,376,270,62.1,65.5,58.2,00000
48.0,54.0,71.0,454,03,01,  Kalakupa,236,279,113,124,123,155,45.8,47.7,44.2,00000
48.0,54.0,71.0,454,04,01,  Jagat Char Purbapara,426,482,225,210,201,272,46.9,51.7,42.5,00000
48.0,54.0,71.0,454,05,01,  Zafrabad,277,406,136,199,141,207,40.6,40.6,40.5,00000
48.0,54.0,71.0,865,01,01,  Khudra Bhagalpur,103,96,58,39,45,57,51.8,59.8,44.1,00000
48.0,54.0,71.0,865,02,01,  Purba Bhagalpur,125,109,64,52,61,57,53.4,55.2,51.7,00000
48.0,54.0,71.0,865,03,01,  Pirpur,1048,813,533,369,515,444,56.3,59.1,53.7,00000
48.0,54.0,71.0,886,01,01,  Ananta Manoharpur,113,28,63,11,50,17,80.1,85.1,74.6,00000
48.0,54.0,71.0,886,02,01,  Tatakanda,54,195,23,93,31,102,21.7,19.8,23.3,00000
48.0,54.0,71.0,886,03,01,  Ramdi,478,1206,237,549,241,657,28.4,30.2,26.8,00000
48.0,54.0,71.0,886,04,01,  Bara Char,567,1037,259,484,308,553,35.3,34.9,35.8,00000
48.0,54.0,71.0,886,05,01,  Balu Char,149,318,68,150,81,168,31.9,31.2,32.5,00000
48.0,54.0,71.0,886,06,01,  Agarpur Purbapara,320,342,167,156,153,186,48.3,51.7,45.1,00000
48.0,54.0,71.0,886,07,01,  Agarpur Uttarpara,345,356,166,164,179,192,49.2,50.3,48.2,00000
48.0,54.0,71.0,886,08,01,  Agarpur Madhyapara,127,153,53,65,74,88,45.4,44.9,45.7,00000
48.0,54.0,71.0,973,01,01,  Kamaliakandi,265,170,126,84,139,86,60.9,60.0,61.8,00000
48.0,54.0,71.0,973,02,01,  Amuderkandi,181,92,73,42,108,50,66.3,63.5,68.4,00000
48.0,54.0,71.0,973,03,01,  Tarakandi,1107,1466,561,712,546,754,43.0,44.1,42.0,00000
48.0,54.0,83.0,216,01,01,  Bir Kashimnagar,847,1556,381,720,466,836,35.2,34.6,35.8,00000
48.0,54.0,83.0,216,03,01,  Char Pingle,31,63,15,26,16,37,33.0,36.6,30.2,00000
48.0,54.0,83.0,519,01,01,  Kandulia,662,686,313,304,349,382,49.1,50.7,47.7,00000
48.0,54.0,83.0,519,02,01,  Maij Para,495,624,216,278,279,346,44.2,43.7,44.6,00000
48.0,54.0,83.0,908,01,01,  Uttar Salua,1397,1882,673,848,724,1034,42.6,44.2,41.2,00000
48.0,54.0,83.0,908,02,01,  Madhyam Salua,1006,1407,475,701,531,706,41.7,40.4,42.9,00000
48.0,54.0,83.0,908,03,01,  Dakshin Salua,841,1260,402,576,439,684,40.0,41.1,39.1,00000
48.0,59.0,11.0,192,01,01,  Chargaon,51,153,33,71,18,82,25.0,31.7,18.0,00000
48.0,59.0,11.0,192,02,01,  Daudpur,44,63,27,29,17,34,41.1,48.2,33.3,00000
48.0,59.0,11.0,192,03,01,  Emamangar,201,730,122,340,79,390,21.6,26.4,16.8,00000
48.0,59.0,11.0,192,04,01,  Bhurbhuri,344,323,188,165,156,158,51.6,53.3,49.7,00000
48.0,59.0,11.0,451,01,01,  Jadabpur,280,762,194,358,86,404,26.9,35.1,17.6,00000
48.0,59.0,11.0,451,02,01,  Bairati,517,1414,322,667,195,747,26.8,32.6,20.7,00000
48.0,59.0,11.0,451,03,01,  Masumnagar,39,291,27,157,12,134,11.8,14.7,8.2,00000
48.0,59.0,11.0,852,01,01,  Biram Char,372,937,234,450,138,487,28.4,34.2,22.1,00000
48.0,59.0,11.0,852,02,01,  Baher Char,398,1104,258,504,140,600,26.5,33.9,18.9,00000
48.0,59.0,11.0,852,03,01,  Noabad,93,161,64,73,29,88,36.6,46.7,24.8,00000
48.0,59.0,11.0,852,04,01,  Charhati,13,61,11,28,2,33,17.6,28.2,5.7,00000
48.0,59.0,11.0,852,05,01,  Maij Char,89,437,63,212,26,225,16.9,22.9,10.4,00000
48.0,59.0,13.0,008,01,01,  Munshihati,122,167,61,82,61,85,42.2,42.7,41.8,00000
48.0,59.0,13.0,008,02,01,  Purbahati,141,302,64,143,77,159,31.8,30.9,32.6,00000
48.0,59.0,13.0,041,01,01,  Atpasha,169,504,102,234,67,270,25.1,30.4,19.9,00000
48.0,59.0,13.0,041,02,01,  Santipur,182,307,109,147,73,160,37.2,42.6,31.3,00000
48.0,59.0,13.0,041,03,01,  Mamudpur,476,760,280,353,196,407,38.5,44.2,32.5,00000
48.0,59.0,13.0,041,04,01,  Chakeshwar,209,233,117,109,92,124,47.3,51.8,42.6,00000
48.0,59.0,13.0,041,05,01,  Gobindapur,515,1220,290,596,225,624,29.7,32.7,26.5,00000
48.0,59.0,13.0,041,06,01,  Kolahani,277,735,159,370,118,365,27.4,30.1,24.4,00000
48.0,59.0,13.0,066,01,01,  Rajibpur,100,255,67,113,33,142,28.2,37.2,18.9,00000
48.0,59.0,13.0,066,02,01,  Char Para,60,234,39,102,21,132,20.4,27.7,13.7,00000
48.0,59.0,13.0,066,03,01,  Baghaia Para,132,238,58,110,74,128,35.7,34.5,36.6,00000
48.0,59.0,13.0,066,04,01,  Dargahati,66,340,38,151,28,189,16.3,20.1,12.9,00000
48.0,59.0,13.0,066,05,01,  Jogihati,113,164,56,76,57,88,40.8,42.4,39.3,00000
48.0,59.0,13.0,075,01,01,  Khondakarhati,148,99,69,44,79,55,59.9,61.1,59.0,00000
48.0,59.0,13.0,075,02,01,  Maddyaherhati,314,301,152,149,162,152,51.1,50.5,51.6,00000
48.0,59.0,13.0,075,03,01,  Paschimhati,95,249,52,112,43,137,27.6,31.7,23.9,00000
48.0,59.0,13.0,326,01,01,  Radhapur,201,193,110,69,91,124,51.0,61.5,42.3,00000
48.0,59.0,13.0,326,02,01,  Barahati,191,212,105,99,86,113,47.4,51.5,43.2,00000
48.0,59.0,13.0,326,03,01,  Ghos Para,76,36,37,12,39,24,67.9,75.5,61.9,00000
48.0,59.0,13.0,326,04,01,  Thakur Para,86,127,46,63,40,64,40.4,42.2,38.5,00000
48.0,59.0,13.0,326,05,01,  Malihati,43,68,27,35,16,33,38.7,43.5,32.7,00000
48.0,59.0,13.0,326,06,01,  Swtarhati,83,54,45,32,38,22,60.6,58.4,63.3,00000
48.0,59.0,13.0,802,01,01,  Patharkandi,161,330,87,175,74,155,32.8,33.2,32.3,00000
48.0,59.0,13.0,802,02,01,  Durgapur,248,479,126,232,122,247,34.1,35.2,33.1,00000
48.0,59.0,13.0,869,01,01,  Silimpur,79,389,58,187,21,202,16.9,23.7,9.4,00000
48.0,59.0,13.0,869,02,01,  Banuakandi,75,334,46,163,29,171,18.3,22.0,14.5,00000
48.0,59.0,13.0,869,03,01,  Barakanda,157,601,99,310,58,291,20.7,24.2,16.6,00000
48.0,59.0,13.0,869,04,01,  Sonapur,77,301,46,143,31,158,20.4,24.3,16.4,00000
48.0,59.0,13.0,944,01,01,  Tegharia,164,228,83,115,81,113,41.8,41.9,41.8,00000
48.0,59.0,13.0,944,02,01,  Sikdarhati,203,139,105,60,98,79,59.4,63.6,55.4,00000
48.0,59.0,27.0,336,01,01,  Ghagra,1128,2629,528,1309,600,1320,30.0,28.7,31.3,00000
48.0,59.0,27.0,336,02,01,  Chamakpur,901,1822,476,897,425,925,33.1,34.7,31.5,00000
48.0,59.0,27.0,336,03,01,  Jangal Para,182,430,106,213,76,217,29.7,33.2,25.9,00000
48.0,59.0,27.0,560,01,01,  Khala Para,517,1193,264,577,253,616,30.2,31.4,29.1,00000
48.0,59.0,27.0,560,02,01,  Maliund,394,988,202,495,192,493,28.5,29.0,28.0,00000
48.0,59.0,27.0,910,01,01,  Shihara,242,375,128,173,114,202,39.2,42.5,36.1,00000
48.0,59.0,27.0,910,02,01,  Dhopajora,499,1026,267,520,232,506,32.7,33.9,31.4,00000
48.0,59.0,40.0,014,01,01,  Alua,313,929,190,409,123,520,25.2,31.7,19.1,00000
48.0,59.0,40.0,014,02,01,  Singa,45,171,26,69,19,102,20.8,27.4,15.7,00000
48.0,59.0,40.0,056,01,01,  Nutan Bagadia,41,55,17,25,24,30,42.7,40.5,44.4,00000
48.0,59.0,40.0,056,02,01,  Puratan Bagadia,60,390,36,184,24,206,13.3,16.4,10.4,00000
48.0,59.0,40.0,196,01,01,  Chandpur,391,693,225,306,166,387,36.1,42.4,30.0,00000
48.0,59.0,40.0,196,02,01,  Natun Chandpur,86,220,56,100,30,120,28.1,35.9,20.0,00000
48.0,59.0,40.0,350,01,01,  Gopedighi,1337,2389,644,1186,693,1203,35.9,35.2,36.6,00000
48.0,59.0,40.0,350,02,01,  Khasapur,419,793,185,404,234,389,34.6,31.4,37.6,00000
48.0,59.0,40.0,350,03,01,  Fkkusa,21,165,7,85,14,80,11.3,7.6,14.9,00000
48.0,59.0,40.0,700,01,01,  Shampur,444,743,244,354,200,389,37.4,40.8,34.0,00000
48.0,59.0,40.0,700,02,01,  Dholai,202,451,111,204,91,247,30.9,35.2,26.9,00000
48.0,59.0,40.0,700,03,01,  Musuria,249,436,135,198,114,238,36.4,40.5,32.4,00000
48.0,59.0,40.0,700,04,01,  Gopalpur,62,234,40,110,22,124,20.9,26.7,15.1,00000
48.0,59.0,40.0,700,05,01,  Nutun Bagadia,106,265,64,110,42,155,28.6,36.8,21.3,00000
48.0,59.0,54.0,175,01,01,  Kakua,367,772,232,363,135,409,32.2,39.0,24.8,00000
48.0,59.0,54.0,175,02,01,  Biswarikona,240,630,131,315,109,315,27.6,29.4,25.7,00000
48.0,59.0,54.0,175,03,01,  Biswarikona Nayahti,29,526,23,275,6,251,5.2,7.7,2.3,00000
48.0,59.0,54.0,175,04,01,  Delhir Akara,19,45,13,24,6,21,29.7,35.1,22.2,00000
48.0,59.0,54.0,301,01,01,  Chhatrish,69,310,39,166,30,144,18.2,19.0,17.2,00000
48.0,59.0,54.0,301,02,01,  Hashimpur,61,393,37,183,24,210,13.4,16.8,10.3,00000
48.0,59.0,54.0,602,01,01,  Hasimpur,57,416,40,208,17,208,12.1,16.1,7.6,00000
48.0,59.0,54.0,602,02,01,  Khaisar,223,1285,148,615,75,670,14.8,19.4,10.1,00000
48.0,59.0,54.0,610,01,01,  Khatkhal,144,300,91,144,53,156,32.4,38.7,25.4,00000
48.0,59.0,54.0,610,02,01,  Char Khatkhal,25,771,20,405,5,366,3.1,4.7,1.3,00000
48.0,59.0,54.0,627,01,01,  Khoramara Sahebnagar,142,666,79,307,63,359,17.6,20.5,14.9,00000
48.0,59.0,54.0,627,02,01,  Sahebnagar Purbapara,46,320,25,159,21,161,12.6,13.6,11.5,00000
48.0,59.0,54.0,627,03,01,  Sahebnagar Munsihati,180,273,92,142,88,131,39.7,39.3,40.2,00000
48.0,59.0,67.0,033,01,01,  Asupur,48,129,23,67,25,62,27.1,25.6,28.7,00000
48.0,59.0,67.0,033,02,01,  Garania,17,142,10,74,7,68,10.7,11.9,9.3,00000
48.0,59.0,67.0,593,01,01,  Keorjori,1089,1217,572,592,517,625,47.2,49.1,45.3,00000
48.0,59.0,67.0,593,02,01,  Kazirkhala,150,485,94,246,56,239,23.6,27.6,19.0,00000
48.0,59.0,67.0,593,03,01,  Dakshin Keorjori,112,469,63,221,49,248,19.3,22.2,16.5,00000
48.0,59.0,67.0,593,04,01,  Mafizgaon,18,118,10,58,8,60,13.2,14.7,11.8,00000
48.0,59.0,67.0,643,01,01,  Korakandi,260,745,161,352,99,393,25.9,31.4,20.1,00000
48.0,59.0,67.0,643,02,01,  Natun Kura,31,522,21,262,10,260,5.6,7.4,3.7,00000
48.0,59.0,67.0,668,01,01,  Laukura,108,82,64,39,44,43,56.8,62.1,50.6,00000
48.0,59.0,67.0,668,02,01,  Chandipur,107,268,59,130,48,138,28.5,31.2,25.8,00000
48.0,59.0,67.0,668,03,01,  Hemantaganj,162,708,99,338,63,370,18.6,22.7,14.5,00000
48.0,59.0,67.0,668,04,01,  Raniganj,54,568,40,291,14,277,8.7,12.1,4.8,00000
48.0,59.0,67.0,953,01,01,  Telikhai,309,661,163,317,146,344,31.9,34.0,29.8,00000
48.0,59.0,67.0,953,02,01,  Kandi Para,162,277,89,140,73,137,36.9,38.9,34.8,00000
48.0,59.0,81.0,168,01,01,  Boranpur,148,406,84,193,64,213,26.7,30.3,23.1,00000
48.0,59.0,81.0,168,02,01,  Nowabpur,350,759,201,363,149,396,31.6,35.6,27.3,00000
48.0,59.0,81.0,574,01,01,  Nowabpur Natunhati,84,337,46,158,38,179,20.0,22.5,17.5,00000
48.0,59.0,81.0,574,02,01,  Kazi Para,238,257,130,107,108,150,48.1,54.9,41.9,00000
48.0,59.0,81.0,574,03,01,  Ashapur,21,146,10,78,11,68,12.6,11.4,13.9,00000
48.0,59.0,81.0,686,01,03,  Mitamain,208,115,97,63,111,52,64.4,60.6,68.1,00000
48.0,59.0,81.0,686,02,03,  Barahati,348,532,185,250,163,282,39.5,42.5,36.6,00000
48.0,59.0,81.0,686,03,03,  Bazarhati,277,44,226,31,51,13,86.3,87.9,79.7,00000
48.0,59.0,81.0,686,04,03,  Khuila Para,484,386,270,174,214,212,55.6,60.8,50.2,00000
48.0,59.0,81.0,686,05,03,  Kalipur,82,181,37,93,45,88,31.2,28.5,33.8,00000
48.0,59.0,81.0,686,06,03,  Kamalpur,459,872,259,422,200,450,34.5,38.0,30.8,00000
48.0,59.0,81.0,686,07,03,  Islampur,951,1325,522,684,429,641,41.8,43.3,40.1,00000
48.0,59.0,81.0,686,08,03,  Natunhati,254,621,137,300,117,321,29.0,31.4,26.7,00000
48.0,59.0,81.0,686,09,03,  Khidirpur,90,268,46,142,44,126,25.1,24.5,25.9,00000
48.0,59.0,81.0,686,10,03,  Girishpur,263,88,145,34,118,54,74.9,81.0,68.6,00000
48.0,59.0,81.0,686,11,03,  Moulvi Para,233,338,106,161,127,177,40.8,39.7,41.8,00000
48.0,59.0,81.0,686,12,03,  Sarkar Para,453,328,232,143,221,185,58.0,61.9,54.4,00000
48.0,59.0,81.0,686,13,03,  Algahati,80,386,34,206,46,180,17.2,14.2,20.4,00000
48.0,59.0,81.0,686,14,03,  Santipur,93,325,49,169,44,156,22.2,22.5,22.0,00000
48.0,59.0,81.0,686,15,03,  Mohisarkandi,131,305,66,159,65,146,30.0,29.3,30.8,00000
48.0,76.0,27.0,042,01,01,  Babaria,10,50,6,20,4,30,16.7,23.1,11.8,00000
48.0,76.0,27.0,042,02,01,  Noagaon,132,114,78,55,54,59,53.7,58.6,47.8,00000
48.0,76.0,27.0,266,01,01,  Alia Para,525,889,243,445,282,444,37.1,35.3,38.8,00000
48.0,76.0,27.0,266,02,01,  Barakanda,279,617,135,287,144,330,31.1,32.0,30.4,00000
48.0,76.0,27.0,266,03,01,  Gobindapur,29,159,15,73,14,86,15.4,17.0,14.0,00000
48.0,76.0,27.0,266,04,01,  Ahsanpur,319,503,176,243,143,260,38.8,42.0,35.5,00000
48.0,76.0,27.0,266,05,01,  Kanthalkandi,99,232,50,118,49,114,29.9,29.8,30.1,00000
48.0,76.0,27.0,266,06,01,  Saheberhati,189,627,97,303,92,324,23.2,24.3,22.1,00000
48.0,76.0,27.0,266,07,01,  Tantkhana,44,145,20,72,24,73,23.3,21.7,24.7,00000
48.0,76.0,27.0,266,08,01,  Purbapara,253,872,134,444,119,428,22.5,23.2,21.8,00000
48.0,76.0,27.0,266,09,01,  Datta Para,55,100,31,40,24,60,35.5,43.7,28.6,00000
48.0,76.0,27.0,266,10,01,  Goalhati,74,116,37,60,37,56,38.9,38.1,39.8,00000
48.0,76.0,27.0,266,11,01,  Mistari Para,152,91,82,41,70,50,62.6,66.7,58.3,00000
48.0,76.0,27.0,266,12,01,  Karmakar Para,112,38,53,20,59,18,74.7,72.6,76.6,00000
48.0,76.0,27.0,266,13,01,  Saha Para,67,132,31,69,36,63,33.7,31.0,36.4,00000
48.0,76.0,27.0,266,14,01,  Uttarhati,87,115,43,53,44,62,43.1,44.8,41.5,00000
48.0,76.0,27.0,266,15,01,  Jalmahmudarhati-Bashir Pradhan,97,300,55,138,42,162,24.4,28.5,20.6,00000
48.0,76.0,27.0,266,16,01,  Uttar Golhati,22,53,12,24,10,29,29.3,33.3,25.6,00000
48.0,76.0,27.0,266,17,01,  Barahati-Pirerhati,129,342,75,162,54,180,27.4,31.6,23.1,00000
48.0,76.0,27.0,266,18,01,  Nawarhati,110,238,68,109,42,129,31.6,38.4,24.6,00000
48.0,76.0,27.0,266,19,01,  Bhuyanhati,31,79,20,31,11,48,28.2,39.2,18.6,00000
48.0,76.0,27.0,266,20,01,  Malpara,144,122,77,53,67,69,54.1,59.2,49.3,00000
48.0,76.0,27.0,266,21,01,  Nagarchihati,111,211,64,102,47,109,34.5,38.6,30.1,00000
48.0,76.0,27.0,266,22,01,  Mirzapur,60,84,35,41,25,43,41.7,46.1,36.8,00000
48.0,76.0,27.0,266,23,01,  Purbahati,230,288,106,133,124,155,44.4,44.4,44.4,00000
48.0,76.0,27.0,266,24,01,  Maijhati,62,244,34,135,28,109,20.3,20.1,20.4,00000
48.0,76.0,27.0,266,25,01,  Paschimhati,83,110,46,51,37,59,43.0,47.4,38.5,00000
48.0,76.0,27.0,266,26,01,  Moral Para,50,39,25,18,25,21,56.2,58.1,54.3,00000
48.0,76.0,27.0,266,27,01,  Chowdhuryhati,124,198,69,109,55,89,38.5,38.8,38.2,00000
48.0,76.0,27.0,266,28,01,  Shekarhati,238,504,139,216,99,288,32.1,39.2,25.6,00000
48.0,76.0,27.0,266,29,01,  Uttar Kamalpur,281,615,134,296,147,319,31.4,31.2,31.5,00000
48.0,76.0,27.0,266,30,01,  Daskhin Kamalpur,89,340,45,181,44,159,20.7,19.9,21.7,00000
48.0,76.0,27.0,266,31,01,  D.Gulhati,20,23,11,9,9,14,46.5,55.0,39.1,00000
48.0,76.0,27.0,266,32,01,  Hajibari,25,39,10,18,15,21,39.1,35.7,41.7,00000
48.0,76.0,27.0,266,33,01,  Porabari,42,17,22,6,20,11,71.2,78.6,64.5,00000
48.0,76.0,38.0,378,01,01,  Gurai,1422,3519,761,1695,661,1824,28.8,31.0,26.6,00000
48.0,76.0,38.0,378,02,01,  Chhetra,472,1541,260,757,212,784,23.4,25.6,21.3,00000
48.0,76.0,38.0,378,03,01,  Daulatpur,862,1946,418,943,444,1003,30.7,30.7,30.7,00000
48.0,76.0,38.0,756,01,01,  Para Bajitpur,552,1646,287,801,265,845,25.1,26.4,23.9,00000
48.0,76.0,38.0,756,02,01,  Noagaon,141,984,75,502,66,482,12.5,13.0,12.0,00000
48.0,76.0,47.0,028,01,01,  Atarabaria,320,1244,183,594,137,650,20.5,23.6,17.4,00000
48.0,76.0,47.0,028,02,01,  Kawalikandi,42,172,21,85,21,87,19.6,19.8,19.4,00000
48.0,76.0,47.0,028,03,01,  Banamalipur,83,291,46,158,37,133,22.2,22.5,21.8,00000
48.0,76.0,47.0,448,01,01,  Uttar Jallabad,309,1015,137,485,172,530,23.3,22.0,24.5,00000
48.0,76.0,47.0,448,02,01,  Dakshin Jallabad,359,745,164,334,195,411,32.5,32.9,32.2,00000
48.0,76.0,47.0,868,01,01,  Sajanpur,465,2678,243,1296,222,1382,14.8,15.8,13.8,00000
48.0,76.0,47.0,868,02,01,  Cheetra,45,128,20,63,25,65,26.0,24.1,27.8,00000
48.0,76.0,57.0,532,01,01,  Karpasha,338,1115,180,516,158,599,23.3,25.9,20.9,00000
48.0,76.0,57.0,532,02,01,  Gauripur,192,437,102,199,90,238,30.5,33.9,27.4,00000
48.0,76.0,57.0,532,03,01,  Majlishpur,1455,2856,778,1310,677,1546,33.8,37.3,30.5,00000
48.0,76.0,57.0,714,01,01,  Nansree,502,1226,273,597,229,629,29.1,31.4,26.7,00000
48.0,76.0,57.0,714,02,01,  Gabarbhita,71,193,40,98,31,95,26.9,29.0,24.6,00000
48.0,76.0,57.0,714,03,01,  Baghuakhali,164,432,83,220,81,212,27.5,27.4,27.6,00000
48.0,76.0,57.0,840,01,01,  Jalalpur,200,489,113,225,87,264,29.0,33.4,24.8,00000
48.0,76.0,57.0,840,02,01,  Chaterkandi,115,199,59,99,56,100,36.6,37.3,35.9,00000
48.0,76.0,57.0,840,03,01,  Shaharmul,492,1524,263,730,229,794,24.4,26.5,22.4,00000
48.0,76.0,76.0,476,01,01,  Mirzapur,157,231,95,119,62,112,40.5,44.4,35.6,00000
48.0,76.0,76.0,476,02,01,  Keshabpur,8,134,5,63,3,71,5.6,7.4,4.1,00000
48.0,76.0,76.0,476,03,01,  Moharkona,571,1722,293,856,278,866,24.9,25.5,24.3,00000
48.0,76.0,76.0,476,04,01,  Imamganj,151,166,69,78,82,88,47.6,46.9,48.2,00000
48.0,76.0,76.0,476,05,01,  Bhati Para,100,253,52,118,48,135,28.3,30.6,26.2,00000
48.0,76.0,76.0,476,06,01,  Saotalibhita,108,381,54,188,54,193,22.1,22.3,21.9,00000
48.0,76.0,76.0,476,07,01,  Anandanagar,85,143,41,68,44,75,37.3,37.6,37.0,00000
48.0,76.0,76.0,476,08,01,  Office Para,119,232,68,113,51,119,33.9,37.6,30.0,00000
48.0,76.0,76.0,616,01,01,  Purba Kursa,556,1491,296,721,260,770,27.2,29.1,25.2,00000
48.0,76.0,76.0,616,02,01,  Paschim Kursa,602,1094,330,502,272,592,35.5,39.7,31.5,00000
48.0,76.0,76.0,616,03,01,  Panchrukhi,329,1126,163,561,166,565,22.6,22.5,22.7,00000
48.0,76.0,76.0,616,04,01,  Atrampur,66,174,31,87,35,87,27.5,26.3,28.7,00000
48.0,76.0,76.0,616,05,01,  Gobindapur,140,177,69,88,71,89,44.2,43.9,44.4,00000
48.0,76.0,76.0,742,01,03,  Tikkalhati,233,780,131,380,102,400,23.0,25.6,20.3,00000
48.0,76.0,76.0,742,02,03,  Nagar,137,188,73,88,64,100,42.2,45.3,39.0,00000
48.0,76.0,76.0,742,03,03,  Nagarchihati,138,545,67,275,71,270,20.2,19.6,20.8,00000
48.0,76.0,76.0,742,04,03,  Chontihati,59,302,32,146,27,156,16.3,18.0,14.8,00000
48.0,76.0,76.0,742,05,03,  Lawarhati,27,91,18,48,9,43,22.9,27.3,17.3,00000
48.0,76.0,76.0,742,07,03,  Mirhati,197,209,101,98,96,111,48.5,50.8,46.4,00000
48.0,76.0,76.0,742,08,03,  Goalhati,84,139,43,69,41,70,37.7,38.4,36.9,00000
48.0,76.0,76.0,742,09,03,  Bara Pukurpar,221,353,117,171,104,182,38.5,40.6,36.4,00000
48.0,76.0,76.0,742,10,03,  Telihati,102,127,56,62,46,65,44.5,47.5,41.4,00000
48.0,76.0,76.0,742,11,03,  Doarhati,62,216,30,106,32,110,22.3,22.1,22.5,00000
48.0,76.0,76.0,742,12,03,  Dhopahati,294,154,143,73,151,81,65.6,66.2,65.1,00000
48.0,76.0,76.0,742,13,03,  Baniahati,208,156,114,66,94,90,57.1,63.3,51.1,00000
48.0,76.0,76.0,742,14,03,  Kamarhati,162,119,88,48,74,71,57.7,64.7,51.0,00000
48.0,76.0,76.0,742,15,03,  Pukurpar,131,360,68,177,63,183,26.7,27.8,25.6,00000
48.0,76.0,76.0,742,16,03,  Nayahati,59,262,27,132,32,130,18.4,17.0,19.8,00000
48.0,76.0,76.0,742,17,03,  Barahati,395,147,205,69,190,78,72.9,74.8,70.9,00000
48.0,76.0,76.0,742,18,03,  Bara Malhati,285,163,141,70,144,93,63.6,66.8,60.8,00000
48.0,76.0,76.0,742,19,03,  Dargah Hati,175,708,96,353,79,355,19.8,21.4,18.2,00000
48.0,76.0,76.0,742,20,03,  Bazar Hati,225,839,134,400,91,439,21.1,25.1,17.2,00000
48.0,76.0,76.0,742,21,03,  Manzil Hati,149,207,63,92,86,115,41.9,40.6,42.8,00000
48.0,76.0,76.0,742,22,03,  Kaibarta Hati,144,352,82,171,62,181,29.0,32.4,25.5,00000
48.0,76.0,76.0,742,23,03,  Kumarchara,84,243,38,116,46,127,25.7,24.7,26.6,00000
48.0,76.0,76.0,742,24,03,  Dakshinhati,161,415,84,198,77,217,28.0,29.8,26.2,00000
48.0,76.0,76.0,742,25,03,  Jafrabad,55,118,35,51,20,67,31.8,40.7,23.0,00000
48.0,76.0,76.0,742,26,03,  Purbagram,183,1152,98,574,85,578,13.7,14.6,12.8,00000
48.0,76.0,76.0,742,27,03,  Majhihati,135,302,74,143,61,159,30.9,34.1,27.7,00000
48.0,76.0,76.0,742,28,03,  Khalishar Hati,166,274,93,123,73,151,37.7,43.1,32.6,00000
48.0,76.0,76.0,742,29,03,  Gouranga Saheber Purkurpar,109,209,60,104,49,105,34.3,36.6,31.8,00000
48.0,76.0,76.0,742,30,03,  Bhabanipur,12,86,5,36,7,50,12.2,12.2,12.3,00000
48.0,76.0,76.0,854,01,03,  Shaha Para,279,303,145,136,134,167,47.9,51.6,44.5,00000
48.0,76.0,76.0,854,02,03,  Chamartola,176,353,109,176,67,177,33.3,38.2,27.5,00000
48.0,76.0,76.0,854,03,03,  Dakshinhati,85,122,45,56,40,66,41.1,44.6,37.7,00000
48.0,76.0,76.0,854,04,03,  Paschimhati,190,216,99,100,91,116,46.8,49.7,44.0,00000
48.0,76.0,76.0,854,05,03,  Purbahati,78,114,44,50,34,64,40.6,46.8,34.7,00000
48.0,79.0,15.0,143,01,01,  Bejurdia,419,576,175,274,244,302,42.1,39.0,44.7,00000
48.0,79.0,15.0,143,02,01,  Barakhil,165,233,70,110,95,123,41.5,38.9,43.6,00000
48.0,79.0,15.0,512,01,01,  Kagar Char,902,1331,365,638,537,693,40.4,36.4,43.7,00000
48.0,79.0,15.0,512,02,01,  Lama Kagar Char,129,77,56,40,73,37,62.6,58.3,66.4,00000
48.0,79.0,15.0,677,01,01,  Char Mandarkandi,450,518,196,267,254,251,46.5,42.3,50.3,00000
48.0,79.0,15.0,677,02,01,  Maddhyam Mandarkandi,879,608,389,288,490,320,59.1,57.5,60.5,00000
48.0,79.0,15.0,677,03,01,  Mandarkandi,443,210,198,100,245,110,67.8,66.4,69.0,00000
48.0,79.0,15.0,851,01,01,  Putia,260,219,120,95,140,124,54.3,55.8,53.0,00000
48.0,79.0,15.0,851,02,01,  Lama Putia,377,485,173,235,204,250,43.7,42.4,44.9,00000
48.0,79.0,15.0,851,03,01,  Nagar Hajradi,571,1008,217,524,354,484,36.2,29.3,42.2,00000
48.0,79.0,15.0,902,01,01,  Tan Saluadi,469,568,211,269,258,299,45.2,44.0,46.3,00000
48.0,79.0,15.0,902,02,01,  Nama Saluadi,730,1084,300,539,430,545,40.2,35.8,44.1,00000
48.0,79.0,19.0,594,01,01,  Shailjani,696,703,301,337,395,366,49.7,47.2,51.9,00000
48.0,79.0,19.0,594,02,01,  Kodalia,1932,2692,894,1347,1038,1345,41.8,39.9,43.6,00000
48.0,79.0,28.0,123,01,01,  Barshagati,336,246,140,115,196,131,57.7,54.9,59.9,00000
48.0,79.0,28.0,123,02,01,  Kanda Para,90,85,38,43,52,42,51.4,46.9,55.3,00000
48.0,79.0,28.0,256,01,01,  Char Faradi,1112,627,529,321,583,306,63.9,62.2,65.6,00000
48.0,79.0,28.0,256,02,01,  Gandar Char,428,375,201,182,227,193,53.3,52.5,54.0,00000
48.0,79.0,28.0,256,03,01,  Jhaugar Char,874,756,396,400,478,356,53.6,49.7,57.3,00000
48.0,79.0,28.0,328,01,01,  Char Teroteki,1243,796,560,400,683,396,61.0,58.3,63.3,00000
48.0,79.0,28.0,328,02,01,  Char Paratala,1473,863,676,457,797,406,63.1,59.7,66.3,00000
48.0,79.0,28.0,328,03,01,  Char Algi,235,379,114,182,121,197,38.3,38.5,38.1,00000
48.0,79.0,28.0,328,04,01,  Goluar Char,297,65,139,33,158,32,82.0,80.8,83.2,00000
48.0,79.0,28.0,328,05,01,  Char Taki,840,793,360,411,480,382,51.4,46.7,55.7,00000
48.0,79.0,28.0,738,01,01,  Mirzapur,1950,821,984,387,966,434,70.4,71.8,69.0,00000
48.0,79.0,28.0,738,02,01,  Nama Mirzapur,538,243,256,103,282,140,68.9,71.3,66.8,00000
48.0,79.0,38.0,071,01,01,  Barabar,371,476,172,224,199,252,43.8,43.4,44.1,00000
48.0,79.0,38.0,071,02,01,  Angiadi,712,703,318,371,394,332,50.3,46.2,54.3,00000
48.0,79.0,38.0,707,01,01,  Char Tengabar,123,792,56,386,67,406,13.4,12.7,14.2,00000
48.0,79.0,38.0,707,02,01,  Mazidpur,610,625,259,307,351,318,49.4,45.8,52.5,00000
48.0,79.0,47.0,461,01,01,  Paschimpara,186,110,82,46,104,64,62.8,64.1,61.9,00000
48.0,79.0,47.0,461,02,01,  Char Para,477,244,204,119,273,125,66.2,63.2,68.6,00000
48.0,79.0,47.0,461,03,01,  Madhyampara,425,213,197,107,228,106,66.6,64.8,68.3,00000
48.0,79.0,47.0,461,04,01,  Mirpara,421,211,181,102,240,109,66.6,64.0,68.8,00000
48.0,79.0,47.0,461,05,01,  Purbapara,870,482,384,220,486,262,64.3,63.6,65.0,00000
48.0,79.0,47.0,461,06,01,  Dari Para,171,96,73,45,98,51,64.0,61.9,65.8,00000
48.0,79.0,47.0,461,07,01,  Nama Para,820,477,360,231,460,246,63.2,60.9,65.2,00000
48.0,79.0,47.0,461,08,01,  Mokam Para,186,157,75,72,111,85,54.2,51.0,56.6,00000
48.0,79.0,47.0,461,09,01,  Atka Para,839,579,353,277,486,302,59.2,56.0,61.7,00000
48.0,79.0,57.0,266,01,01,  Uttar Char Kaona,767,671,341,364,426,307,53.3,48.4,58.1,00000
48.0,79.0,57.0,266,02,01,  Madhya Para,1223,897,578,450,645,447,57.7,56.2,59.1,00000
48.0,79.0,57.0,266,03,01,  Nama Para,623,848,279,437,344,411,42.4,39.0,45.6,00000
48.0,79.0,57.0,266,04,01,  Decreer Char,410,150,205,68,205,82,73.2,75.1,71.4,00000
48.0,79.0,57.0,266,05,01,  Bara Ghar,942,667,436,316,506,351,58.5,58.0,59.0,00000
48.0,79.0,57.0,266,06,01,  Maishakanda,1086,832,494,427,592,405,56.6,53.6,59.4,00000
48.0,79.0,57.0,266,07,01,  Muniari Kanda,1031,1159,480,584,551,575,47.1,45.1,48.9,00000
48.0,79.0,57.0,266,08,01,  Paschim Para,431,465,214,247,217,218,48.1,46.4,49.9,00000
48.0,79.0,57.0,317,01,01,  Char Teki,1516,1181,749,571,767,610,56.2,56.7,55.7,00000
48.0,79.0,57.0,317,02,01,  Char Teki Nama Para,621,649,287,304,334,345,48.9,48.6,49.2,00000
48.0,79.0,66.0,020,01,01,  Agar Patta,260,455,130,211,130,244,36.4,38.1,34.8,00000
48.0,79.0,66.0,020,02,01,  Chhota Ajaldi,538,912,249,439,289,473,37.1,36.2,37.9,00000
48.0,79.0,66.0,759,01,01,  Narandi,2766,2066,1307,1007,1459,1059,57.2,56.5,57.9,00000
48.0,79.0,66.0,759,02,01,  Nurpur,891,598,401,290,490,308,59.8,58.0,61.4,00000
48.0,79.0,85.0,030,01,01,  Balia,435,414,208,191,227,223,51.2,52.1,50.4,00000
48.0,79.0,85.0,030,02,01,  Pabankhali,122,217,53,117,69,100,36.0,31.2,40.8,00000
48.0,79.0,85.0,030,03,01,  Mahishabar,182,222,81,110,101,112,45.0,42.4,47.4,00000
48.0,79.0,85.0,030,04,01,  Agar Ahutia,126,213,57,97,69,116,37.2,37.0,37.3,00000
48.0,79.0,85.0,030,05,01,  Ahutia,521,657,229,315,292,342,44.2,42.1,46.1,00000
48.0,79.0,85.0,502,01,01,  Juniail,404,538,189,270,215,268,42.9,41.2,44.5,00000
48.0,79.0,85.0,502,02,01,  Jaitra,100,115,54,58,46,57,46.5,48.2,44.7,00000
48.0,79.0,85.0,543,01,01,  Kaladia,507,1091,218,522,289,569,31.7,29.5,33.7,00000
48.0,79.0,85.0,543,02,01,  Chandi Para,154,136,86,58,68,78,53.1,59.7,46.6,00000
48.0,79.0,85.0,543,03,01,  Shimulia,452,357,214,160,238,197,55.9,57.2,54.7,00000
48.0,79.0,85.0,543,04,01,  Bandigaon,25,15,10,8,15,7,62.5,55.6,68.2,00000
48.0,79.0,85.0,543,05,01,  Masimpur,81,128,31,67,50,61,38.8,31.6,45.0,00000
48.0,79.0,85.0,615,01,01,  Kumri,355,382,177,195,178,187,48.2,47.6,48.8,00000
48.0,79.0,85.0,615,02,01,  Kona Para,219,177,105,74,114,103,55.3,58.7,52.5,00000
48.0,79.0,85.0,615,03,01,  Bandigah,107,106,52,47,55,59,50.2,52.5,48.2,00000
48.0,79.0,85.0,666,01,01,  Maijhati,872,1178,431,617,441,561,42.5,41.1,44.0,00000
48.0,79.0,85.0,666,02,01,  Adarsha Para,615,625,323,315,292,310,49.6,50.6,48.5,00000
48.0,79.0,85.0,666,03,01,  Katabag,152,205,71,89,81,116,42.6,44.4,41.1,00000
48.0,79.0,85.0,666,04,01,  Pulerghat,297,189,191,109,106,80,61.1,63.7,57.0,00000
48.0,79.0,85.0,800,01,01,  Pachalgota,308,435,136,216,172,219,41.5,38.6,44.0,00000
48.0,79.0,85.0,800,02,01,  Bandigah,49,120,25,55,24,65,29.0,31.3,27.0,00000
48.0,79.0,85.0,800,03,01,  Paria Para,71,131,26,63,45,68,35.1,29.2,39.8,00000
48.0,79.0,85.0,800,04,01,  Jarirpar,290,380,134,172,156,208,43.3,43.8,42.9,00000
48.0,79.0,85.0,800,05,01,  Shimulia,375,536,175,257,200,279,41.2,40.5,41.8,00000
48.0,79.0,85.0,830,01,01,  Ulla Para,587,638,276,303,311,335,47.9,47.7,48.1,00000
48.0,79.0,85.0,830,02,01,  Bhiti Para,555,794,258,368,297,426,41.1,41.2,41.1,00000
48.0,79.0,85.0,830,03,01,  Chak Digha,624,808,301,399,323,409,43.6,43.0,44.1,00000
48.0,79.0,85.0,830,04,01,  Bagh Para,591,464,276,226,315,238,56.0,55.0,57.0,00000
48.0,79.0,85.0,830,05,01,  Shatiadi,1042,915,456,441,586,474,53.2,50.8,55.3,00000
48.0,79.0,85.0,830,06,01,  Mahishkanda,129,287,55,146,74,141,31.0,27.4,34.4,00000
48.0,79.0,85.0,830,07,01,  Naya Para,189,145,84,67,105,78,56.6,55.6,57.4,00000
48.0,79.0,85.0,830,08,01,  Parkanda,318,204,150,103,168,101,60.9,59.3,62.5,00000
48.0,79.0,85.0,830,09,01,  Mahishber,307,326,145,161,162,165,48.5,47.4,49.5,00000
48.0,79.0,85.0,861,01,01,  Rupsa,232,459,103,215,129,244,33.6,32.4,34.6,00000
48.0,79.0,85.0,861,02,01,  Atka Para,92,321,42,163,50,158,22.3,20.5,24.0,00000
48.0,79.0,85.0,861,03,01,  Bhater Para,28,110,8,54,20,56,20.3,12.9,26.3,00000
48.0,79.0,85.0,861,04,01,  Masuakanda,68,121,32,60,36,61,36.0,34.8,37.1,00000
48.0,79.0,95.0,635,01,01,  Kushakanda,1121,909,507,443,614,466,55.2,53.4,56.9,00000
48.0,79.0,95.0,635,02,01,  Bahramkhan Para,339,149,168,71,171,78,69.5,70.3,68.7,00000
48.0,79.0,95.0,635,03,01,  Bami Para,226,224,94,118,132,106,50.2,44.3,55.5,00000
48.0,79.0,95.0,943,01,01,  Sukhia,1683,1217,816,632,867,585,58.0,56.4,59.7,00000
48.0,79.0,95.0,943,02,01,  Char Palash,1123,1317,491,655,632,662,46.0,42.8,48.8,00000
48.0,79.0,95.0,943,03,01,  Khalishakhali,290,312,134,158,156,154,48.2,45.9,50.3,00000
48.0,79.0,95.0,943,04,01,  Ashutia,789,367,391,167,398,200,68.3,70.1,66.6,00000
48.0,79.0,95.0,943,05,01,  Kawali Kamuk,384,533,174,285,210,248,41.9,37.9,45.9,00000
48.0,79.0,95.0,943,06,01,  Chachir,619,170,268,86,351,84,78.5,75.7,80.7,00000
48.0,92.0,13.0,278,01,01,  Damiha,825,1586,441,791,384,795,34.2,35.8,32.6,00000
48.0,92.0,13.0,278,02,01,  Maugri,334,1194,163,599,171,595,21.9,21.4,22.3,00000
48.0,92.0,13.0,278,03,01,  Gazaria,253,1330,132,685,121,645,16.0,16.2,15.8,00000
48.0,92.0,13.0,278,04,01,  Barma,153,566,77,286,76,280,21.3,21.2,21.3,00000
48.0,92.0,13.0,490,01,01,  Madhypara,474,699,238,326,236,373,40.4,42.2,38.8,00000
48.0,92.0,13.0,490,02,01,  Anowarpur,564,1196,286,600,278,596,32.0,32.3,31.8,00000
48.0,92.0,13.0,490,03,01,  Atkajla,343,712,169,332,174,380,32.5,33.7,31.4,00000
48.0,92.0,13.0,490,04,01,  Bagar Baid,414,568,199,277,215,291,42.2,41.8,42.5,00000
48.0,92.0,13.0,490,05,01,  Syani Para,117,209,61,95,56,114,35.9,39.1,32.9,00000
48.0,92.0,13.0,490,06,01,  Chak Para,374,877,193,409,181,468,29.9,32.1,27.9,00000
48.0,92.0,13.0,490,07,01,  Uttar Khal Para,158,164,80,71,78,93,49.1,53.0,45.6,00000
48.0,92.0,13.0,490,08,01,  Dakshin Khal Para,50,296,27,146,23,150,14.5,15.6,13.3,00000
48.0,92.0,13.0,490,09,01,  Sing Guarpar,370,918,179,457,191,461,28.7,28.1,29.3,00000
48.0,92.0,13.0,490,10,01,  Sechuya Kandi,30,306,14,143,16,163,8.9,8.9,8.9,00000
48.0,92.0,13.0,490,11,01,  Bhabuti Kandi,5,251,1,126,4,125,2.0,0.8,3.1,00000
48.0,92.0,27.0,358,01,01,  Dhala,1424,2239,728,1056,696,1183,38.9,40.8,37.0,00000
48.0,92.0,27.0,358,02,01,  Tauria,452,708,206,342,246,366,39.0,37.6,40.2,00000
48.0,92.0,40.0,371,01,01,  Digdair Paschim,341,789,191,391,150,398,30.2,32.8,27.4,00000
48.0,92.0,40.0,371,02,01,  Digdair Purba,396,840,192,437,204,403,32.0,30.5,33.6,00000
48.0,92.0,40.0,371,03,01,  Garuail,122,148,56,74,66,74,45.2,43.1,47.1,00000
48.0,92.0,40.0,371,04,01,  Chak Para Mohanpur,193,457,92,221,101,236,29.7,29.4,30.0,00000
48.0,92.0,40.0,504,01,01,  Kalla,633,1265,311,633,322,632,33.4,32.9,33.8,00000
48.0,92.0,40.0,504,02,01,  Dakshin Nagar,307,381,165,183,142,198,44.6,47.4,41.8,00000
48.0,92.0,40.0,504,03,01,  Kaura,271,395,145,174,126,221,40.7,45.5,36.3,00000
48.0,92.0,40.0,504,04,01,  Badera,687,879,353,397,334,482,43.9,47.1,40.9,00000
48.0,92.0,40.0,504,05,01,  Jaterkanda,197,290,106,122,91,168,40.5,46.5,35.1,00000
48.0,92.0,40.0,504,06,01,  Saruakanda,208,595,98,286,110,309,25.9,25.5,26.3,00000
48.0,92.0,40.0,557,01,01,  Karati,260,487,126,233,134,254,34.8,35.1,34.5,00000
48.0,92.0,40.0,557,02,01,  Lakshmipur,232,456,113,240,119,216,33.7,32.0,35.5,00000
48.0,92.0,40.0,557,03,01,  Nayansuk,256,481,132,229,124,252,34.7,36.6,33.0,00000
48.0,92.0,54.0,198,01,01,  Jawar Purba,621,1892,310,994,311,898,24.7,23.8,25.7,00000
48.0,92.0,54.0,198,02,01,  Jawar Moddy,407,1468,211,708,196,760,21.7,23.0,20.5,00000
48.0,92.0,54.0,198,03,01,  Jawar Paschi,507,881,259,436,248,445,36.5,37.3,35.8,00000
48.0,92.0,67.0,331,01,01,  Daudpur,322,903,148,436,174,467,26.3,25.3,27.1,00000
48.0,92.0,67.0,331,02,01,  Basati,247,531,134,270,113,261,31.7,33.2,30.2,00000
48.0,92.0,67.0,331,03,01,  Noagaon,115,598,64,310,51,288,16.1,17.1,15.0,00000
48.0,92.0,67.0,331,04,01,  Duria,149,214,78,99,71,115,41.0,44.1,38.2,00000
48.0,92.0,67.0,331,05,01,  Kauti,147,171,69,83,78,88,46.2,45.4,47.0,00000
48.0,92.0,67.0,331,06,01,  Para Banail,245,260,114,130,131,130,48.5,46.7,50.2,00000
48.0,92.0,67.0,331,07,01,  Pubail,29,76,16,39,13,37,27.6,29.1,26.0,00000
48.0,92.0,67.0,543,01,01,  Karanka,167,339,83,152,84,187,33.0,35.3,31.0,00000
48.0,92.0,67.0,543,02,01,  Jamira,54,72,31,39,23,33,42.9,44.3,41.1,00000
48.0,92.0,67.0,610,01,01,  Kona Bhawal,176,351,98,150,78,201,33.4,39.5,28.0,00000
48.0,92.0,67.0,610,02,01,  Changuria,168,157,77,64,91,93,51.7,54.6,49.5,00000
48.0,92.0,67.0,676,01,01,  Mechhgaon,227,1134,106,567,121,567,16.7,15.8,17.6,00000
48.0,92.0,67.0,676,02,01,  Murarkandi,134,293,68,154,66,139,31.4,30.6,32.2,00000
48.0,92.0,81.0,265,01,01,  Chikni,134,430,75,211,59,219,23.8,26.2,21.2,00000
48.0,92.0,81.0,265,02,01,  Auzia,280,657,147,321,133,336,29.9,31.4,28.4,00000
48.0,92.0,81.0,849,01,01,  Shahbagh,873,1084,400,491,473,593,44.6,44.9,44.4,00000
48.0,92.0,81.0,849,02,01,  Akubpur,803,716,379,329,424,387,52.9,53.5,52.3,00000
48.0,92.0,94.0,769,01,01,  Pang Pachiha,628,1081,305,516,323,565,36.7,37.1,36.4,00000
48.0,92.0,94.0,769,02,01,  Jaldoha,17,84,9,37,8,47,16.8,19.6,14.5,00000
48.0,92.0,94.0,769,03,01,  Purba Dari Jahangirpur,81,35,41,11,40,24,69.8,78.8,62.5,00000
48.0,92.0,94.0,835,01,03,  Pascim Sachail,1439,1311,744,641,695,670,52.3,53.7,50.9,00000
48.0,92.0,94.0,835,02,03,  Purba Sachail,1268,1062,661,475,607,587,54.4,58.2,50.8,00000
48.0,92.0,94.0,835,03,03,  Tarail Bazar,1579,622,852,325,727,297,71.7,72.4,71.0,00000
48.0,92.0,94.0,888,01,01,  Samukjani,283,763,144,372,139,391,27.1,27.9,26.2,00000
48.0,92.0,94.0,888,02,01,  Atka Para,106,338,57,175,49,163,23.9,24.6,23.1,00000
89.0,37.0,12.0,265,01,01,  Uttar Dariar Para,383,847,200,405,183,442,31.1,33.1,29.3,00000
89.0,37.0,12.0,265,02,01,  Dakhin Dariar Para,245,653,123,329,122,324,27.3,27.2,27.4,00000
89.0,37.0,12.0,265,03,01,  Naya Para,461,315,243,135,218,180,59.4,64.3,54.8,00000
89.0,37.0,12.0,291,01,01,  Chakpara,596,928,308,460,288,468,39.1,40.1,38.1,00000
89.0,37.0,12.0,291,02,01,  Dhanshail,1202,1764,639,830,563,934,40.5,43.5,37.6,00000
89.0,37.0,12.0,291,03,01,  Madarpur,127,408,66,191,61,217,23.7,25.7,21.9,00000
89.0,37.0,12.0,623,01,01,  Bagervita,685,1236,346,581,339,655,35.7,37.3,34.1,00000
89.0,37.0,12.0,623,02,01,  Kanduli,960,2147,504,1021,456,1126,30.9,33.0,28.8,00000
89.0,37.0,15.0,066,01,01,  Bangaon Purba Para,493,968,239,484,254,484,33.7,33.1,34.4,00000
89.0,37.0,15.0,066,02,01,  Bangaon Naya Para,158,409,85,200,73,209,27.9,29.8,25.9,00000
89.0,37.0,15.0,066,03,01,  Bangaon Paschim Para,443,807,229,375,214,432,35.4,37.9,33.1,00000
89.0,37.0,15.0,066,04,01,  Choutul (Bangaon),196,426,101,214,95,212,31.5,32.1,30.9,00000
89.0,37.0,15.0,066,05,01,  Khapara,528,789,265,370,263,419,40.1,41.7,38.6,00000
89.0,37.0,15.0,066,06,01,  Gegatala,343,1035,179,506,164,529,24.9,26.1,23.7,00000
89.0,37.0,17.0,411,01,01,  Ghagra Laskar,128,206,68,98,60,108,38.3,41.0,35.7,00000
89.0,37.0,17.0,411,02,01,  Dakhin  Para,305,509,151,233,154,276,37.5,39.3,35.8,00000
89.0,37.0,17.0,411,03,01,  Dargar Para,125,246,69,115,56,131,33.7,37.5,29.9,00000
89.0,37.0,17.0,411,04,01,  Darji Para,149,105,81,47,68,58,58.7,63.3,54.0,00000
89.0,37.0,17.0,411,05,01,  Kamar Para,312,396,158,200,154,196,44.1,44.1,44.0,00000
89.0,37.0,17.0,411,06,01,  Kabiraj Para,260,567,148,260,112,307,31.4,36.3,26.7,00000
89.0,37.0,17.0,411,07,01,  Kona Para,148,281,73,126,75,155,34.5,36.7,32.6,00000
89.0,37.0,17.0,411,08,01,  Khamar Para,43,171,28,75,15,96,20.1,27.2,13.5,00000
89.0,37.0,17.0,411,09,01,  Marua Para,323,529,176,248,147,281,37.9,41.5,34.3,00000
89.0,37.0,17.0,411,10,01,  Mulla Para,142,206,72,105,70,101,40.8,40.7,40.9,00000
89.0,37.0,17.0,411,11,01,  Mondal Para,347,355,170,156,177,199,49.4,52.1,47.1,00000
89.0,37.0,17.0,411,12,01,  Malipara,19,110,8,50,11,60,14.7,13.8,15.5,00000
89.0,37.0,17.0,411,13,01,  Putal Para,130,169,63,85,67,84,43.5,42.6,44.4,00000
89.0,37.0,17.0,411,14,01,  Pradhan Para,409,147,201,64,208,83,73.6,75.8,71.5,00000
89.0,37.0,17.0,411,15,01,  Sarkar Para,386,288,195,118,191,170,57.3,62.3,52.9,00000
89.0,37.0,17.0,411,16,01,  Sonar Para,61,254,39,127,22,127,19.4,23.5,14.8,00000
89.0,37.0,17.0,504,01,01,  Kaibatrya Para,297,386,162,174,135,212,43.5,48.2,38.9,00000
89.0,37.0,17.0,504,02,01,  Purba Para,147,208,88,93,59,115,41.4,48.6,33.9,00000
89.0,37.0,17.0,504,03,01,  Mir Para,85,212,48,116,37,96,28.6,29.3,27.8,00000
89.0,37.0,17.0,504,04,01,  Mona Kusha,231,156,115,80,116,76,59.7,59.0,60.4,00000
89.0,37.0,17.0,504,05,01,  Chak Para,116,364,70,171,46,193,24.2,29.0,19.2,00000
89.0,37.0,17.0,504,06,01,  Khamer Para,65,294,35,143,30,151,18.1,19.7,16.6,00000
89.0,37.0,17.0,504,07,01,  Paglar Para,57,466,30,239,27,227,10.9,11.2,10.6,00000
89.0,37.0,25.0,026,01,01,  Bankali,331,454,175,212,156,242,42.2,45.2,39.2,00000
89.0,37.0,25.0,026,02,01,  Khailkura,832,567,377,245,455,322,59.5,60.6,58.6,00000
89.0,37.0,25.0,026,03,01,  Dighirpar,968,924,518,417,450,507,51.2,55.4,47.0,00000
89.0,37.0,25.0,026,04,01,  Bhat Para,146,102,83,48,63,54,58.9,63.4,53.8,00000
89.0,37.0,25.0,026,05,01,  Bairagi Para,221,137,131,56,90,81,61.7,70.1,52.6,00000
89.0,37.0,25.0,026,06,01,  Banda Bhat Para-Part-1,452,535,230,247,222,288,45.8,48.2,43.5,00000
89.0,37.0,25.0,026,07,01,  Banda Bhat Para Part-2,558,1084,270,520,288,564,34.0,34.2,33.8,00000
89.0,37.0,25.0,610,01,01,  Dari Kalinagar,303,1472,159,713,144,759,17.1,18.2,15.9,00000
89.0,37.0,25.0,610,02,01,  Sari Kalinagar,1137,2134,611,1004,526,1130,34.8,37.8,31.8,00000
89.0,37.0,50.0,490,01,01,  Hasligaon,765,973,403,482,362,491,44.0,45.5,42.4,00000
89.0,37.0,50.0,490,02,01,  Batiagaon,564,1519,309,715,255,804,27.1,30.2,24.1,00000
89.0,37.0,60.0,477,01,01,  Haldigram (Uttarpara),473,405,250,189,223,216,53.9,56.9,50.8,00000
89.0,37.0,60.0,477,02,01,  Haldigram,378,317,197,144,181,173,54.4,57.8,51.1,00000
89.0,37.0,60.0,928,01,01,  Rangatia,624,1098,304,517,320,581,36.2,37.0,35.5,00000
89.0,37.0,60.0,928,02,01,  Nalkura,278,284,150,128,128,156,49.5,54.0,45.1,00000
89.0,37.0,60.0,928,03,01,  Gazari Para,128,156,73,70,55,86,45.1,51.0,39.0,00000
89.0,67.0,17.0,045,01,01,  Khondakar Para,565,775,274,367,291,408,42.2,42.7,41.6,00000
89.0,67.0,17.0,045,02,01,  Baneshwardi,953,949,488,437,465,512,50.1,52.8,47.6,00000
89.0,67.0,17.0,045,03,01,  Puladeshi,375,822,185,400,190,422,31.3,31.6,31.0,00000
89.0,67.0,17.0,045,04,01,  Mujarkanda,269,452,128,217,141,235,37.3,37.1,37.5,00000
89.0,67.0,17.0,045,05,01,  Ariakanda,329,529,169,237,160,292,38.3,41.6,35.4,00000
89.0,67.0,17.0,587,01,01,  Kaida,277,298,134,145,143,153,48.2,48.0,48.3,00000
89.0,67.0,17.0,587,02,01,  Mochar Char,154,298,79,144,75,154,34.1,35.4,32.8,00000
89.0,67.0,19.0,361,01,01,  Char Madhua,993,1340,516,653,477,687,42.6,44.1,41.0,00000
89.0,67.0,19.0,361,02,01,  Huzurikanda,649,570,310,244,339,326,53.2,56.0,51.0,00000
89.0,67.0,19.0,361,03,01,  Bandateki,308,316,164,156,144,160,49.4,51.3,47.4,00000
89.0,67.0,19.0,361,04,01,  Rehar Char,139,590,69,296,70,294,19.1,18.9,19.2,00000
89.0,67.0,19.0,361,05,01,  Nama Para,581,729,286,372,295,357,44.4,43.5,45.2,00000
89.0,67.0,28.0,260,01,01,  Purba Narayankhola,461,796,220,369,241,427,36.7,37.4,36.1,00000
89.0,67.0,28.0,260,02,01,  Dakshin Narayankhola,447,995,230,460,217,535,31.0,33.3,28.9,00000
89.0,67.0,28.0,260,03,01,  Paschim Narayankhola,362,368,148,167,214,201,49.6,47.0,51.6,00000
89.0,67.0,28.0,260,04,01,  Narayankhola Bazar,210,82,108,40,102,42,71.9,73.0,70.8,00000
89.0,67.0,28.0,260,05,01,  Madrasa Para,111,213,53,101,58,112,34.3,34.4,34.1,00000
89.0,67.0,28.0,260,06,01,  Bepari Para,29,146,17,67,12,79,16.6,20.2,13.2,00000
89.0,67.0,28.0,260,07,01,  Darbar Char,232,270,118,115,114,155,46.2,50.6,42.4,00000
89.0,67.0,28.0,260,08,01,  Rehai Ashtadhar,555,1826,280,873,275,953,23.3,24.3,22.4,00000
89.0,67.0,28.0,373,01,01,  Bhatkandi,338,233,166,119,172,114,59.2,58.2,60.1,00000
89.0,67.0,28.0,373,02,01,  Kotar Char,196,346,98,159,98,187,36.2,38.1,34.4,00000
89.0,67.0,28.0,373,03,01,  Kazaikata,838,832,437,373,401,459,50.2,54.0,46.6,00000
89.0,67.0,38.0,169,01,01,  Bihirirpar,472,540,250,241,222,299,46.6,50.9,42.6,00000
89.0,67.0,38.0,169,02,01,  Baraitar,424,821,198,429,226,392,34.1,31.6,36.6,00000
89.0,67.0,38.0,508,01,01,  Ganapaddi,1186,1221,636,566,550,655,49.3,52.9,45.6,00000
89.0,67.0,38.0,508,02,01,  Chithalia,1078,1858,537,870,541,988,36.7,38.2,35.4,00000
89.0,67.0,38.0,508,03,01,  Krishtapur,607,643,284,292,323,351,48.6,49.3,47.9,00000
89.0,67.0,57.0,734,01,01,  Nakhla,887,1196,467,593,420,603,42.6,44.1,41.1,00000
89.0,67.0,57.0,734,02,01,  Dakatiakanda,781,1086,405,515,376,571,41.8,44.0,39.7,00000
89.0,67.0,66.0,474,01,01,  Goalerkanda,183,291,92,138,91,153,38.6,40.0,37.3,00000
89.0,67.0,66.0,474,02,01,  Jangirarrar,225,86,120,34,105,52,72.3,77.9,66.9,00000
89.0,67.0,66.0,474,03,01,  Dudher Char,645,836,292,392,353,444,43.6,42.7,44.3,00000
89.0,67.0,66.0,802,01,01,  Koiyakuri Nama Para,450,540,237,245,213,295,45.5,49.2,41.9,00000
89.0,67.0,66.0,802,02,01,  Koiyakuri Kanda Para,699,868,343,426,356,442,44.6,44.6,44.6,00000
89.0,67.0,66.0,802,03,01,  Dashkania,367,336,182,149,185,187,52.2,55.0,49.7,00000
89.0,67.0,66.0,802,04,01,  Barar Char,321,530,148,236,173,294,37.7,38.5,37.0,00000
89.0,67.0,66.0,802,05,01,  Pathakata,1981,2752,956,1295,1025,1457,41.9,42.5,41.3,00000
89.0,67.0,85.0,655,01,01,  Hasankhila,816,1553,406,752,410,801,34.4,35.1,33.9,00000
89.0,67.0,85.0,655,02,01,  Laykha,783,1134,416,549,367,585,40.8,43.1,38.6,00000
89.0,70.0,30.0,333,01,01,  Dakshin Kalinagar,112,259,51,116,61,143,30.2,30.5,29.9,00000
89.0,70.0,30.0,333,02,01,  Paschim Kalinagar,261,334,133,155,128,179,43.9,46.2,41.7,00000
89.0,70.0,30.0,333,03,01,  Uttar Kalinagar,99,221,44,114,55,107,30.9,27.8,34.0,00000
89.0,70.0,30.0,863,01,01,  Ranigaon,158,200,76,95,82,105,44.1,44.4,43.9,00000
89.0,70.0,30.0,863,02,01,  Dakshin Ranigaon,910,1579,463,784,447,795,36.6,37.1,36.0,00000
89.0,70.0,30.0,863,03,01,  Uttar Ranigaon,629,814,326,370,303,444,43.6,46.8,40.6,00000
89.0,70.0,34.0,481,01,01,  Jogania,705,1375,351,702,354,673,33.9,33.3,34.5,00000
89.0,70.0,34.0,481,02,01,  Chak Jogania,535,1313,282,652,253,661,29.0,30.2,27.7,00000
89.0,70.0,34.0,481,03,01,  Purba Jogania,802,1410,390,677,412,733,36.3,36.6,36.0,00000
89.0,70.0,34.0,535,01,01,  Kapasia,1118,1612,564,792,554,820,41.0,41.6,40.3,00000
89.0,70.0,34.0,535,02,01,  Jamirakanda,198,245,97,115,101,130,44.7,45.8,43.7,00000
89.0,70.0,38.0,497,01,01,  Kakarkandi,807,700,410,333,397,367,53.6,55.2,52.0,00000
89.0,70.0,38.0,497,02,01,  Madhamkura,197,402,96,195,101,207,32.9,33.0,32.8,00000
89.0,70.0,38.0,497,03,01,  Hatibanoha,82,375,46,183,36,192,17.9,20.1,15.8,00000
89.0,70.0,38.0,497,04,01,  Rashaitala,363,710,194,334,169,376,33.8,36.7,31.0,00000
89.0,70.0,38.0,497,05,01,  Benu Para,479,538,229,255,250,283,47.1,47.3,46.9,00000
89.0,70.0,41.0,071,01,01,  Balughata,441,712,231,322,210,390,38.2,41.8,35.0,00000
89.0,70.0,41.0,071,02,01,  Gonapara,165,328,95,178,70,150,33.5,34.8,31.8,00000
89.0,70.0,41.0,071,03,01,  Gullarpar,559,1243,263,637,296,606,31.0,29.2,32.8,00000
89.0,70.0,41.0,071,04,01,  Tarakandi,138,624,61,310,77,314,18.1,16.4,19.7,00000
89.0,70.0,41.0,672,01,01,  Naksi,859,1771,476,863,383,908,32.7,35.5,29.7,00000
89.0,70.0,41.0,672,02,01,  Shimulgara,492,779,252,372,240,407,38.7,40.4,37.1,00000
89.0,70.0,41.0,672,03,01,  Pepalshar,170,699,100,347,70,352,19.6,22.4,16.6,00000
89.0,70.0,41.0,759,01,01,  Panchgaon,1127,2423,605,1175,522,1248,31.7,34.0,29.5,00000
89.0,70.0,41.0,759,02,01,  Doheri Para,563,942,288,474,275,468,37.4,37.8,37.0,00000
89.0,70.0,51.0,579,01,01,  Khujiura,136,111,72,54,64,57,55.1,57.1,52.9,00000
89.0,70.0,51.0,579,02,01,  Sanuatala,455,1336,237,657,218,679,25.4,26.5,24.3,00000
89.0,70.0,51.0,579,03,01,  Gerapacha,703,1007,360,489,343,518,41.1,42.4,39.8,00000
89.0,70.0,51.0,579,04,01,  Andharia Gop,231,537,121,264,110,273,30.1,31.4,28.7,00000
89.0,70.0,51.0,579,05,01,  Sktlarpar,147,75,78,35,69,40,66.2,69.0,63.3,00000
89.0,70.0,51.0,683,01,01,  Kenduapara,585,493,313,221,272,272,54.3,58.6,50.0,00000
89.0,70.0,51.0,683,02,01,  Nalitabari Nijpara,263,314,129,157,134,157,45.6,45.1,46.0,00000
89.0,70.0,51.0,683,03,01,  Kharkhariakanda,359,711,185,347,174,364,33.6,34.8,32.3,00000
89.0,70.0,51.0,683,04,01,  Sheoratali,300,421,159,174,141,247,41.6,47.7,36.3,00000
89.0,70.0,51.0,683,05,01,  Khalbhanga,130,317,70,158,60,159,29.1,30.7,27.4,00000
89.0,70.0,69.0,727,01,01,  Nunni,1117,1902,570,896,547,1006,37.0,38.9,35.2,00000
89.0,70.0,69.0,727,02,01,  Nunni Uttar Bond,967,1271,486,594,481,677,43.2,45.0,41.5,00000
89.0,70.0,72.0,344,01,01,  Gajakura,1600,2274,847,1079,753,1195,41.3,44.0,38.7,00000
89.0,70.0,72.0,344,02,01,  Kayarpar,830,1413,415,679,415,734,37.0,37.9,36.1,00000
89.0,70.0,72.0,344,03,01,  Shehratali,216,176,121,78,95,98,55.1,60.8,49.2,00000
89.0,70.0,94.0,601,01,01,  Gopalpur,143,448,74,211,69,237,24.2,26.0,22.5,00000
89.0,70.0,94.0,601,02,01,  Debipur,403,949,207,463,196,486,29.8,30.9,28.7,00000
89.0,70.0,94.0,601,03,01,  Krishnapur,379,738,188,350,191,388,33.9,34.9,33.0,00000
89.0,70.0,94.0,732,01,01,  Paikhatala,179,592,94,276,85,316,23.2,25.4,21.2,00000
89.0,70.0,94.0,732,02,01,  Gachgara,535,990,269,474,266,516,35.1,36.2,34.0,00000
89.0,70.0,94.0,929,01,01,  Singarpar,371,865,171,413,200,452,30.0,29.3,30.7,00000
89.0,70.0,94.0,929,02,01,  Nijpara,559,428,298,200,261,228,56.6,59.8,53.4,00000
89.0,70.0,94.0,929,03,01,  Bhugaichapur,573,1792,303,836,270,956,24.2,26.6,22.0,00000
89.0,88.0,11.0,647,01,01,  Paschim Kumri,562,1084,307,519,255,565,34.1,37.2,31.1,00000
89.0,88.0,11.0,647,02,01,  Madhya Kumri,560,876,293,435,267,441,39.0,40.2,37.7,00000
89.0,88.0,11.0,647,03,01,  Kamar Para,89,461,43,221,46,240,16.2,16.3,16.1,00000
89.0,88.0,11.0,647,04,01,  Mudi Para,459,578,266,279,193,299,44.3,48.8,39.2,00000
89.0,88.0,11.0,647,05,01,  Purba Kumri,395,968,208,455,187,513,29.0,31.4,26.7,00000
89.0,88.0,11.0,779,01,01,  Pratabia,297,1338,151,662,146,676,18.2,18.6,17.8,00000
89.0,88.0,11.0,779,02,01,  Lokairpar,112,340,64,172,48,168,24.8,27.1,22.2,00000
89.0,88.0,11.0,779,03,01,  Baraitar,152,656,86,300,66,356,18.8,22.3,15.6,00000
89.0,88.0,27.0,202,01,01,  Char Babna,902,2582,475,1254,427,1328,25.9,27.5,24.3,00000
89.0,88.0,27.0,202,02,01,  Nalbaid,772,2243,416,1078,356,1165,25.6,27.8,23.4,00000
89.0,88.0,27.0,469,01,01,  Harindhara,1213,3227,637,1540,576,1687,27.3,29.3,25.5,00000
89.0,88.0,27.0,469,02,01,  Tanka Char,133,661,75,327,58,334,16.8,18.7,14.8,00000
89.0,88.0,27.0,469,03,01,  Munshir Char,1173,3018,640,1459,533,1559,28.0,30.5,25.5,00000
89.0,88.0,27.0,722,01,01,  Majh Para,967,1775,507,836,460,939,35.3,37.8,32.9,00000
89.0,88.0,27.0,722,02,01,  Kanduar Char,205,194,109,90,96,104,51.4,54.8,48.0,00000
89.0,88.0,27.0,722,03,01,  Datia Para,492,608,294,267,198,341,44.7,52.4,36.7,00000
89.0,88.0,27.0,722,04,01,  Puran Para,493,1097,261,504,232,593,31.0,34.1,28.1,00000
89.0,88.0,27.0,732,01,01,  Muksedpur,436,468,221,192,215,276,48.2,53.5,43.8,00000
89.0,88.0,27.0,732,02,01,  Khamar Para,367,502,195,242,172,260,42.2,44.6,39.8,00000
89.0,88.0,27.0,732,03,01,  Talia Para,319,562,181,272,138,290,36.2,40.0,32.2,00000
89.0,88.0,27.0,732,04,01,  Nandir Para,308,464,146,220,162,244,39.9,39.9,39.9,00000
89.0,88.0,33.0,244,01,01,  Dakater Gop,58,329,33,180,25,149,15.0,15.5,14.4,00000
89.0,88.0,33.0,244,02,01,  Jangaldi,760,2289,425,1161,335,1128,24.9,26.8,22.9,00000
89.0,88.0,33.0,244,03,01,  Bagalgar,515,1352,304,650,211,702,27.6,31.9,23.1,00000
89.0,88.0,33.0,244,04,01,  Takimari,406,688,220,340,186,348,37.1,39.3,34.8,00000
89.0,88.0,33.0,244,05,01,  Danur Para,546,875,302,406,244,469,38.4,42.7,34.2,00000
89.0,88.0,33.0,244,06,01,  Nandir Jot,290,741,167,350,123,391,28.1,32.3,23.9,00000
89.0,88.0,33.0,244,07,01,  Khas Para,662,1936,342,948,320,988,25.5,26.5,24.5,00000
89.0,88.0,33.0,244,08,01,  Chunir Char,417,1034,222,494,195,540,28.7,31.0,26.5,00000
89.0,88.0,33.0,244,09,01,  Dikpara,771,1258,432,605,339,653,38.0,41.7,34.2,00000
89.0,88.0,33.0,244,10,01,  Dakpara,508,1513,275,775,233,738,25.1,26.2,24.0,00000
89.0,88.0,33.0,244,11,01,  Bepari Para,566,1852,329,859,237,993,23.4,27.7,19.3,00000
89.0,88.0,33.0,244,12,01,  Kulur Char,535,1550,289,769,246,781,25.7,27.3,24.0,00000
89.0,88.0,33.0,244,13,01,  Satpakia,874,2987,503,1536,371,1451,22.6,24.7,20.4,00000
89.0,88.0,40.0,272,01,01,  Nijpara,384,1506,215,699,169,807,20.3,23.5,17.3,00000
89.0,88.0,40.0,272,02,01,  Dhopaghat,176,688,92,337,84,351,20.4,21.4,19.3,00000
89.0,88.0,40.0,272,03,01,  Tangari Para,225,728,124,334,101,394,23.6,27.1,20.4,00000
89.0,88.0,40.0,272,04,01,  Dari Para,653,1999,387,940,266,1059,24.6,29.2,20.1,00000
89.0,88.0,40.0,272,05,01,  Dashkahania,228,714,131,346,97,368,24.2,27.5,20.9,00000
89.0,88.0,40.0,272,06,01,  Satani Para,501,1471,293,682,208,789,25.4,30.1,20.9,00000
89.0,88.0,40.0,272,07,01,  Nugpara,229,898,140,439,89,459,20.3,24.2,16.2,00000
89.0,88.0,40.0,272,08,01,  Naya Para,201,911,128,433,73,478,18.1,22.8,13.2,00000
89.0,88.0,40.0,272,09,01,  Uttarpara,111,501,75,236,36,265,18.1,24.1,12.0,00000
89.0,88.0,40.0,272,10,01,  Purbapara,300,1558,169,760,131,798,16.1,18.2,14.1,00000
89.0,88.0,40.0,272,11,01,  Bagerchar,213,834,129,406,84,428,20.3,24.1,16.4,00000
89.0,88.0,40.0,478,01,01,  Balurghat,280,997,150,482,130,515,21.9,23.7,20.2,00000
89.0,88.0,40.0,478,02,01,  Taluk Para,516,642,291,306,225,336,44.6,48.7,40.1,00000
89.0,88.0,40.0,478,03,01,  Taila Para,115,649,76,313,39,336,15.1,19.5,10.4,00000
89.0,88.0,40.0,478,04,01,  Bazari Para,138,421,81,188,57,233,24.7,30.1,19.7,00000
89.0,88.0,40.0,478,05,01,  Naya Para,94,387,52,183,42,204,19.5,22.1,17.1,00000
89.0,88.0,40.0,478,06,01,  Nijpara,140,381,83,177,57,204,26.9,31.9,21.8,00000
89.0,88.0,40.0,544,01,01,  Purbapara,412,657,211,305,201,352,38.5,40.9,36.3,00000
89.0,88.0,40.0,544,02,01,  Nama Para,180,588,94,287,86,301,23.4,24.7,22.2,00000
89.0,88.0,40.0,544,03,01,  Kharia Para,103,270,61,129,42,141,27.6,32.1,23.0,00000
89.0,88.0,40.0,544,04,01,  Kanda Para,201,419,103,196,98,223,32.4,34.4,30.5,00000
89.0,88.0,47.0,366,01,01,  Nama Para-1,287,363,157,165,130,198,44.2,48.8,39.6,00000
89.0,88.0,47.0,366,02,01,  Nama Para-2,315,801,172,388,143,413,28.2,30.7,25.7,00000
89.0,88.0,54.0,422,01,01,  Girda Para,611,1034,310,518,301,516,37.1,37.4,36.8,00000
89.0,88.0,54.0,422,02,01,  Koraikanda,168,187,88,78,80,109,47.3,53.0,42.3,00000
89.0,88.0,54.0,422,03,01,  Chak Para,486,935,234,464,252,471,34.2,33.5,34.9,00000
89.0,88.0,54.0,422,04,01,  Dikpara,168,403,80,217,88,186,29.4,26.9,32.1,00000
89.0,88.0,54.0,422,05,01,  Kanda Para,966,1059,473,474,493,585,47.7,49.9,45.7,00000
89.0,88.0,54.0,422,06,01,  Gazaria,332,549,183,260,149,289,37.7,41.3,34.0,00000
89.0,88.0,54.0,422,07,01,  Salchura,247,593,127,285,120,308,29.4,30.8,28.0,00000
89.0,88.0,54.0,422,08,01,  Palashia,557,1715,277,844,280,871,24.5,24.7,24.3,00000
89.0,88.0,54.0,422,09,01,  Kejarpar,129,211,53,109,76,102,37.9,32.7,42.7,00000
89.0,88.0,54.0,422,10,01,  Bubiarpar,318,843,187,412,131,431,27.4,31.2,23.3,00000
89.0,88.0,54.0,422,11,01,  Kharkharia,367,433,192,199,175,234,45.9,49.1,42.8,00000
89.0,88.0,54.0,422,12,01,  Kawa Pechi,434,935,223,449,211,486,31.7,33.2,30.3,00000
89.0,88.0,54.0,422,13,01,  Kuruliakanda,258,624,145,282,113,342,29.3,34.0,24.8,00000
89.0,88.0,61.0,572,01,01,  6 No Char,591,1904,336,944,255,960,23.7,26.3,21.0,00000
89.0,88.0,61.0,572,02,01,  7 No Char,802,2035,483,989,319,1046,28.3,32.8,23.4,00000
89.0,88.0,61.0,572,03,01,  Goal Para,197,985,124,480,73,505,16.7,20.5,12.6,00000
89.0,88.0,61.0,572,04,01,  Parastir Char,97,314,66,154,31,160,23.6,30.0,16.2,00000
89.0,88.0,61.0,572,05,01,  Bepari Para,391,1028,235,492,156,536,27.6,32.3,22.5,00000
89.0,88.0,61.0,572,06,01,  Sahabdir Char Kamar Para,382,1195,203,588,179,607,24.2,25.7,22.8,00000
89.0,88.0,61.0,572,07,01,  Dashani Para,321,705,160,366,161,339,31.3,30.4,32.2,00000
89.0,88.0,61.0,572,08,01,  Sahabdir Char Uttar Para,315,886,184,423,131,463,26.2,30.3,22.1,00000
89.0,88.0,61.0,572,09,01,  Dakshin Dobar Char,700,1270,397,614,303,656,35.5,39.3,31.6,00000
89.0,88.0,61.0,572,10,01,  Pandit Para,150,249,80,115,70,134,37.6,41.0,34.3,00000
89.0,88.0,61.0,572,11,01,  Paiker Para,161,231,94,100,67,131,41.1,48.5,33.8,00000
89.0,88.0,61.0,572,12,01,  Bagher Char,210,441,112,222,98,219,32.3,33.5,30.9,00000
89.0,88.0,61.0,572,13,01,  Shibuttar,189,212,101,94,88,118,47.1,51.8,42.7,00000
89.0,88.0,61.0,572,14,01,  Nij Kamarer Char,115,468,63,230,52,238,19.7,21.5,17.9,00000
89.0,88.0,74.0,384,01,01,  Dighaldi,440,1222,250,596,190,626,26.5,29.6,23.3,00000
89.0,88.0,74.0,384,02,01,  Digoldi Mulla Para,357,1240,172,621,185,619,22.4,21.7,23.0,00000
89.0,88.0,74.0,525,01,01,  Barajhauer Char,239,610,132,296,107,314,28.2,30.8,25.4,00000
89.0,88.0,74.0,525,02,01,  Chota Jhauer Char,159,626,84,311,75,315,20.3,21.3,19.2,00000
89.0,88.0,74.0,619,01,01,  Krishnapur,959,1896,525,924,434,972,33.6,36.2,30.9,00000
89.0,88.0,74.0,619,02,01,  Dari Para,1193,2047,622,1004,571,1043,36.8,38.3,35.4,00000
89.0,88.0,74.0,657,01,01,  Lakshmanpur,1429,2664,780,1285,649,1379,34.9,37.8,32.0,00000
89.0,88.0,74.0,657,02,01,  Kanda Serir Char,485,695,253,354,232,341,41.1,41.7,40.5,00000
89.0,88.0,74.0,657,03,01,  Kazir Char,401,679,213,320,188,359,37.1,40.0,34.4,00000
89.0,88.0,74.0,657,04,01,  Hati Alga,790,1862,412,912,378,950,29.8,31.1,28.5,00000
89.0,88.0,74.0,657,05,01,  Gina Para,817,1195,424,577,393,618,40.6,42.4,38.9,00000
89.0,88.0,74.0,657,06,01,  Namasekir Char,174,563,89,302,85,261,23.6,22.8,24.6,00000
89.0,88.0,74.0,657,07,01,  Lasksman Pur Jayer Char,338,623,160,303,178,320,35.2,34.6,35.7,00000
89.0,88.0,74.0,657,08,01,  Solgori Para,334,450,182,215,152,235,42.6,45.8,39.3,00000
89.0,88.0,81.0,028,01,01,  Tegharia,300,1176,160,583,140,593,20.3,21.5,19.1,00000
89.0,88.0,81.0,028,02,01,  Bada,357,983,185,462,172,521,26.6,28.6,24.8,00000
89.0,88.0,81.0,112,01,01,  Khujuria,245,740,121,351,124,389,24.9,25.6,24.2,00000
89.0,88.0,81.0,112,02,01,  Shanakbhanga,244,605,138,297,106,308,28.7,31.7,25.6,00000
89.0,88.0,81.0,112,03,01,  Bakir Par,282,665,152,323,130,342,29.8,32.0,27.5,00000
89.0,88.0,81.0,112,04,01,  Baratia,663,1842,345,891,318,951,26.5,27.9,25.1,00000
89.0,88.0,81.0,413,01,01,  Ganai Bharua Para,731,1619,381,763,350,856,31.1,33.3,29.0,00000
89.0,88.0,81.0,413,02,01,  Ganai Mominikanda,407,1651,206,821,201,830,19.8,20.1,19.5,00000
89.0,88.0,88.0,835,01,01,  Char Para,296,712,161,326,135,386,29.4,33.1,25.9,00000
89.0,88.0,88.0,835,03,01,  Sumir Doba Para,250,444,144,215,106,229,36.0,40.1,31.6,00000
89.0,88.0,88.0,835,04,01,  Madhyapara,449,710,219,333,230,377,38.7,39.7,37.9,00000
89.0,88.0,88.0,835,05,01,  Garpara,316,583,182,276,134,307,35.2,39.7,30.4,00000
89.0,88.0,88.0,835,06,01,  Bepari Para,115,467,72,235,43,232,19.8,23.5,15.6,00000
89.0,88.0,88.0,835,07,01,  Purbapara,719,995,350,489,369,506,41.9,41.7,42.2,00000
89.0,88.0,88.0,835,08,01,  Nawbhaga,365,370,196,169,169,201,49.7,53.7,45.7,00000
89.0,90.0,15.0,122,01,01,  Barar Char,480,1115,296,517,184,598,30.1,36.4,23.5,00000
89.0,90.0,15.0,122,02,01,  Balida Para,227,866,122,436,105,430,20.8,21.9,19.6,00000
89.0,90.0,15.0,122,03,01,  Tinani Para,464,958,260,466,204,492,32.6,35.8,29.3,00000
89.0,90.0,15.0,122,04,01,  Dakra Para,566,940,319,456,247,484,37.6,41.2,33.8,00000
89.0,90.0,15.0,122,05,01,  Dali Para,58,241,35,119,23,122,19.4,22.7,15.9,00000
89.0,90.0,15.0,167,01,01,  Bhelua,626,980,352,479,274,501,39.0,42.4,35.4,00000
89.0,90.0,15.0,167,02,01,  Tinani Bhelua,638,679,352,321,286,358,48.4,52.3,44.4,00000
89.0,90.0,15.0,167,03,01,  Dasti Para,311,629,186,302,125,327,33.1,38.1,27.7,00000
89.0,90.0,15.0,212,01,01,  Chak Bandi,199,679,123,331,76,348,22.7,27.1,17.9,00000
89.0,90.0,15.0,212,02,01,  Kabiraj Para,145,408,70,200,75,208,26.2,25.9,26.5,00000
89.0,90.0,15.0,212,03,01,  Naya Para,206,922,113,446,93,476,18.3,20.2,16.3,00000
89.0,90.0,15.0,212,04,01,  Kowner Char,555,1627,307,783,248,844,25.4,28.2,22.7,00000
89.0,90.0,15.0,893,01,01,  Shimulchura,626,887,357,412,269,475,41.4,46.4,36.2,00000
89.0,90.0,15.0,893,02,01,  Char Shimulchura,841,1711,447,821,394,890,33.0,35.3,30.7,00000
89.0,90.0,15.0,893,03,01,  Chang Para,527,1427,295,685,232,742,27.0,30.1,23.8,00000
89.0,90.0,15.0,893,04,01,  Bhanda Dhatua,578,500,332,222,246,278,53.6,59.9,46.9,00000
89.0,90.0,39.0,067,01,01,  Baliachandi,504,617,282,281,222,336,45.0,50.1,39.8,00000
89.0,90.0,39.0,067,02,01,  Daherpar,281,568,165,272,116,296,33.1,37.8,28.2,00000
89.0,90.0,47.0,580,01,01,  Chak Para,179,359,105,160,74,199,33.3,39.6,27.1,00000
89.0,90.0,47.0,580,02,01,  Garkhola,289,404,148,196,141,208,41.7,43.0,40.4,00000
89.0,90.0,47.0,580,03,01,  Perojpur,229,625,126,303,103,322,26.8,29.4,24.2,00000
89.0,90.0,47.0,580,04,01,  Khamar Para,386,632,186,300,200,332,37.9,38.3,37.6,00000
89.0,90.0,47.0,580,05,01,  Kutubpur,309,344,161,145,148,199,47.3,52.6,42.7,00000
89.0,90.0,47.0,580,06,01,  Satani Para,144,346,76,148,68,198,29.4,33.9,25.6,00000
89.0,90.0,47.0,580,07,01,  Gobrikura,392,611,191,283,201,328,39.1,40.3,38.0,00000
89.0,90.0,47.0,580,08,01,  Khanchi Para,265,384,137,189,128,195,40.8,42.0,39.6,00000
89.0,90.0,47.0,580,09,01,  Digdari,90,473,41,222,49,251,16.0,15.6,16.3,00000
89.0,90.0,47.0,580,10,01,  Uligara,69,248,35,116,34,132,21.8,23.2,20.5,00000
89.0,90.0,47.0,580,11,01,  Malmari,397,652,191,312,206,340,37.8,38.0,37.7,00000
89.0,90.0,47.0,580,12,01,  Kamar Para,421,589,218,273,203,316,41.7,44.4,39.1,00000
89.0,90.0,47.0,580,13,01,  Chenguter,88,282,50,135,38,147,23.8,27.0,20.5,00000
89.0,90.0,47.0,580,14,01,  Bhutnikanda,97,140,57,65,40,75,40.9,46.7,34.8,00000
89.0,90.0,47.0,580,15,01,  Chithalia,537,672,309,297,228,375,44.4,51.0,37.8,00000
89.0,90.0,47.0,580,16,01,  Garamara,707,757,379,328,328,429,48.3,53.6,43.3,00000
89.0,90.0,47.0,580,17,01,  Putal,47,194,25,98,22,96,19.5,20.3,18.6,00000
89.0,90.0,47.0,580,18,01,  Kamardaha,284,547,145,249,139,298,34.2,36.8,31.8,00000
89.0,90.0,47.0,636,01,01,  Uttar Khosalpur,501,1113,269,543,232,570,31.0,33.1,28.9,00000
89.0,90.0,47.0,636,02,01,  Dakshin Khosalpur,513,851,246,408,267,443,37.6,37.6,37.6,00000
89.0,90.0,47.0,636,03,01,  Madhya Khosalpur,190,915,99,460,91,455,17.2,17.7,16.7,00000
89.0,90.0,47.0,636,04,01,  Nij Khosalpur,168,500,103,238,65,262,25.1,30.2,19.9,00000
89.0,90.0,47.0,636,05,01,  Baldiar Char,456,908,230,438,226,470,33.4,34.4,32.5,00000
89.0,90.0,55.0,614,01,01,  Kharia,637,1911,354,906,283,1005,25.0,28.1,22.0,00000
89.0,90.0,55.0,614,02,01,  Kazir Char,551,1414,303,666,248,748,28.0,31.3,24.9,00000
89.0,90.0,55.0,681,01,01,  Rupar Para,381,961,195,463,186,498,28.4,29.6,27.2,00000
89.0,90.0,55.0,681,02,01,  Bandha Baishnabir Char,216,289,124,137,92,152,42.8,47.5,37.7,00000
89.0,90.0,55.0,681,03,01,  Langar Para,1614,4616,912,2156,702,2460,25.9,29.7,22.2,00000
89.0,90.0,55.0,681,04,01,  Ulukanda,89,483,51,212,38,271,15.6,19.4,12.3,00000
89.0,90.0,55.0,703,01,01,  Halgara,544,763,291,348,253,415,41.6,45.5,37.9,00000
89.0,90.0,55.0,703,02,01,  Baishnabir Char,205,585,113,278,92,307,25.9,28.9,23.1,00000
89.0,90.0,55.0,703,03,01,  Garpara,50,350,30,174,20,176,12.5,14.7,10.2,00000
89.0,90.0,55.0,703,04,01,  Madarpur,575,1448,320,721,255,727,28.4,30.7,26.0,00000
89.0,90.0,71.0,044,01,01,  Dakshin Bagh Hata,334,606,175,271,159,335,35.5,39.2,32.2,00000
89.0,90.0,71.0,044,02,01,  Uttar Bagh Hata,328,997,167,449,161,548,24.8,27.1,22.7,00000
89.0,90.0,71.0,078,01,01,  Balijuri,371,948,189,455,182,493,28.1,29.3,27.0,00000
89.0,90.0,71.0,078,02,01,  Rangajan,155,453,77,198,78,255,25.5,28.0,23.4,00000
89.0,90.0,71.0,078,03,01,  Kharamora,184,652,94,300,90,352,22.0,23.9,20.4,00000
89.0,90.0,71.0,156,01,01,  Bhayadanga,1178,1079,628,474,550,605,52.2,57.0,47.6,00000
89.0,90.0,71.0,156,02,01,  Dakshinpaschim B.Danga,467,713,229,335,238,378,39.6,40.6,38.6,00000
89.0,90.0,71.0,156,03,01,  Dakshinpurba Bhyadanga,637,657,341,300,296,357,49.2,53.2,45.3,00000
89.0,90.0,71.0,156,04,01,  Uttarpurba Bhayadanga,1115,1330,561,621,554,709,45.6,47.5,43.9,00000
89.0,90.0,71.0,234,01,01,  Chakrapur,205,302,117,146,88,156,40.4,44.5,36.1,00000
89.0,90.0,71.0,234,02,01,  Hasdhara,424,423,207,184,217,239,50.1,52.9,47.6,00000
89.0,90.0,86.0,726,01,01,  Kuri Para,244,1211,144,571,100,640,16.8,20.1,13.5,00000
89.0,90.0,86.0,726,02,01,  Baghber,119,248,63,120,56,128,32.4,34.4,30.4,00000
89.0,90.0,86.0,726,03,01,  Manjalia,225,278,117,127,108,151,44.7,48.0,41.7,00000
89.0,90.0,86.0,726,04,01,  Baluaghat,127,816,69,411,58,405,13.5,14.4,12.5,00000
89.0,90.0,86.0,726,05,01,  Nabinagar,170,557,81,267,89,290,23.4,23.3,23.5,00000
89.0,90.0,86.0,726,06,01,  Nij Mamdamari,272,440,140,204,132,236,38.2,40.7,35.9,00000
89.0,90.0,86.0,726,07,01,  Izara Para,118,547,78,256,40,291,17.7,23.4,12.1,00000
89.0,90.0,86.0,726,08,01,  Tangar Para,185,828,109,389,76,439,18.3,21.9,14.8,00000
89.0,90.0,86.0,726,09,01,  Mamdamari,363,994,213,470,150,524,26.8,31.2,22.3,00000
89.0,90.0,86.0,726,10,01,  Abuar Para,258,817,136,396,122,421,24.0,25.6,22.5,00000
89.0,90.0,86.0,726,11,01,  Mamdamari Naya Para,96,350,54,171,42,179,21.5,24.0,19.0,00000
89.0,90.0,86.0,726,12,01,  Bakshabaid,336,1019,202,451,134,568,24.8,30.9,19.1,00000
89.0,90.0,86.0,927,01,01,  Kokrapar,194,499,101,244,93,255,28.0,29.3,26.7,00000
89.0,90.0,86.0,927,02,01,  Puratan Sreebardi,182,709,119,329,63,380,20.4,26.6,14.2,00000
89.0,90.0,86.0,927,03,01,  Nayani Sreebardi,434,553,221,249,213,304,44.0,47.0,41.2,00000
89.0,90.0,94.0,223,01,01,  Chak Kauria (Part),714,1460,378,707,336,753,32.8,34.8,30.9,00000
89.0,90.0,94.0,223,02,01,  Garamara,432,883,254,421,178,462,32.9,37.6,27.8,00000
89.0,90.0,94.0,223,03,01,  Jalu Para,286,854,159,442,127,412,25.1,26.5,23.6,00000
89.0,90.0,94.0,536,01,01,  Janakikhila,389,1074,212,538,177,536,26.6,28.3,24.8,00000
89.0,90.0,94.0,536,02,01,  Bhatpur,610,1209,330,554,280,655,33.5,37.3,29.9,00000
89.0,90.0,94.0,536,03,01,  Shalmara,118,262,69,114,49,148,31.1,37.7,24.9,00000
68.0,7.0,11.0,047,01,01,  Wari,745,583,377,261,368,322,56.1,59.1,53.3,00000
68.0,7.0,11.0,047,02,01,  Bateshwar,831,712,422,309,409,403,53.9,57.7,50.4,00000
68.0,7.0,11.0,047,03,01,  Dakshin Bateshwar,695,197,368,82,327,115,77.9,81.8,74.0,00000
68.0,7.0,11.0,047,04,01,  Rangartek,294,173,155,80,139,93,63.0,66.0,59.9,00000
68.0,7.0,11.0,047,05,01,  Kandua,504,386,268,199,236,187,56.6,57.4,55.8,00000
68.0,7.0,11.0,047,06,01,  Ichartek,140,82,75,29,65,53,63.1,72.1,55.1,00000
68.0,7.0,11.0,047,07,01,  Haniabaid,151,77,80,37,71,40,66.2,68.4,64.0,00000
68.0,7.0,11.0,047,08,01,  Rajarbagh,908,609,442,298,466,311,59.9,59.7,60.0,00000
68.0,7.0,11.0,047,09,01,  Shah Para,545,283,260,128,285,155,65.8,67.0,64.8,00000
68.0,7.0,11.0,047,10,01,  Amlaba,847,990,427,456,420,534,46.1,48.4,44.0,00000
68.0,7.0,11.0,971,01,01,  Lakhpur,765,355,394,162,371,193,68.3,70.9,65.8,00000
68.0,7.0,11.0,971,02,01,  Abdulnagar,665,590,318,280,347,310,53.0,53.2,52.8,00000
68.0,7.0,11.0,971,03,01,  Ujilab,1537,1689,769,787,768,902,47.6,49.4,46.0,00000
68.0,7.0,11.0,971,04,01,  Dhukundi,1494,1324,789,622,705,702,53.0,55.9,50.1,00000
68.0,7.0,20.0,150,01,03,  Gangkul Para,1638,1506,835,799,803,707,52.1,51.1,53.2,00000
68.0,7.0,20.0,150,02,03,  Matial Para,1802,1334,970,722,832,612,57.5,57.3,57.6,00000
68.0,7.0,20.0,150,03,03,  Tekpara,1011,1249,480,608,531,641,44.7,44.1,45.3,00000
68.0,7.0,20.0,264,01,03,  Char Belabo Madhya Para,556,639,282,303,274,336,46.5,48.2,44.9,00000
68.0,7.0,20.0,264,02,03,  Char Belabo Nama Para,709,817,340,374,369,443,46.5,47.6,45.4,00000
68.0,7.0,20.0,781,01,03,  Char Lakshmipur Madhyapar,488,537,201,264,287,273,47.6,43.2,51.3,00000
68.0,7.0,20.0,781,02,03,  Char Lakshmipur Nama Para,335,460,136,201,199,259,42.1,40.4,43.4,00000
68.0,7.0,25.0,227,01,01,  Birkanda,634,868,326,377,308,491,42.2,46.4,38.5,00000
68.0,7.0,25.0,227,02,01,  Maratalikanda,254,443,110,227,144,216,36.4,32.6,40.0,00000
68.0,7.0,25.0,227,03,01,  Jalkanda,234,949,122,445,112,504,19.8,21.5,18.2,00000
68.0,7.0,25.0,227,04,01,  Ghoskanda,339,549,159,272,180,277,38.2,36.9,39.4,00000
68.0,7.0,25.0,227,05,01,  Joharikanda,195,443,86,210,109,233,30.6,29.1,31.9,00000
68.0,7.0,25.0,227,06,01,  Tekpara,45,74,16,42,29,32,37.8,27.6,47.5,00000
68.0,7.0,25.0,227,07,01,  Bhangrikanda,61,97,31,43,30,54,38.6,41.9,35.7,00000
68.0,7.0,25.0,227,08,01,  Lohajurikanda,265,290,140,139,125,151,47.7,50.2,45.3,00000
68.0,7.0,25.0,227,09,01,  Aholikanda,363,574,175,284,188,290,38.7,38.1,39.3,00000
68.0,7.0,25.0,227,10,01,  Dighaldikanda,591,747,271,347,320,400,44.2,43.9,44.4,00000
68.0,7.0,25.0,264,01,01,  Char Latifpur,630,648,298,309,332,339,49.3,49.1,49.5,00000
68.0,7.0,25.0,264,02,01,  Rehay Latifpur,302,160,153,77,149,83,65.4,66.5,64.2,00000
68.0,7.0,31.0,047,01,01,  Amlaba Paschimpara,748,876,345,431,403,445,46.1,44.5,47.5,00000
68.0,7.0,31.0,047,02,01,  Amlaba Purbapara,381,511,207,247,174,264,42.7,45.6,39.7,00000
68.0,7.0,31.0,047,03,01,  Purba Amlaba Madhya Para,440,443,236,231,204,212,49.8,50.5,49.0,00000
68.0,7.0,31.0,971,01,01,  Barecha,1618,1536,838,770,780,766,51.3,52.1,50.5,00000
68.0,7.0,31.0,971,02,01,  Dewaner Char,1903,1571,975,718,928,853,54.8,57.6,52.1,00000
68.0,7.0,31.0,971,03,01,  Char Ujilaba,1380,1227,725,553,655,674,52.9,56.7,49.3,00000
68.0,7.0,59.0,450,01,01,  Jalalabad,478,872,198,405,280,467,35.4,32.8,37.5,00000
68.0,7.0,59.0,450,02,01,  Patiladaya,135,466,53,241,82,225,22.5,18.0,26.7,00000
68.0,7.0,59.0,450,03,01,  Kangalia,1048,1132,520,558,528,574,48.1,48.2,47.9,00000
68.0,7.0,59.0,458,01,01,  Batibond,1242,836,577,367,665,469,59.8,61.1,58.6,00000
68.0,7.0,59.0,458,02,01,  Gobindapur,325,290,154,149,171,141,52.8,50.8,54.8,00000
68.0,7.0,59.0,458,03,01,  Nawakandi,254,501,137,237,117,264,33.6,36.6,30.7,00000
68.0,7.0,59.0,458,04,01,  Darikandi,658,546,322,255,336,291,54.7,55.8,53.6,00000
68.0,7.0,59.0,458,05,01,  Hosen Nagar,1388,1567,666,741,722,826,47.0,47.3,46.6,00000
68.0,7.0,59.0,458,06,01,  Amtali,306,404,176,197,130,207,43.1,47.2,38.6,00000
68.0,7.0,59.0,462,01,01,  Lakshmipur,1646,1970,764,951,882,1019,45.5,44.5,46.4,00000
68.0,7.0,59.0,462,02,01,  Dulalkandi,1264,1574,640,784,624,790,44.5,44.9,44.1,00000
68.0,7.0,59.0,462,03,01,  Marichakandi,641,912,316,410,325,502,41.3,43.5,39.3,00000
68.0,7.0,59.0,462,04,01,  Bhather Char,1041,1544,503,724,538,820,40.3,41.0,39.6,00000
68.0,7.0,59.0,462,05,01,  Rahimerkandi,913,1001,460,477,453,524,47.7,49.1,46.4,00000
68.0,7.0,59.0,462,06,01,  Kukurmara,476,546,238,253,238,293,46.6,48.5,44.8,00000
68.0,7.0,59.0,462,07,01,  Khamarer Char,692,788,339,389,353,399,46.8,46.6,46.9,00000
68.0,7.0,59.0,462,08,01,  Jangua,558,709,254,357,304,352,44.0,41.6,46.3,00000
68.0,7.0,59.0,462,09,01,  Potimara,95,122,46,62,49,60,43.8,42.6,45.0,00000
68.0,7.0,71.0,724,01,01,  Muga,379,395,189,183,190,212,49.0,50.8,47.3,00000
68.0,7.0,71.0,724,02,01,  Uttar Bangalgaon,30,35,15,15,15,20,46.2,50.0,42.9,00000
68.0,7.0,71.0,816,01,01,  Patuli,993,807,508,365,485,442,55.2,58.2,52.3,00000
68.0,7.0,71.0,816,02,01,  Dolirpar,506,246,228,111,278,135,67.3,67.3,67.3,00000
68.0,7.0,71.0,816,03,01,  Shimultala,121,124,62,60,59,64,49.4,50.8,48.0,00000
68.0,7.0,71.0,816,04,01,  Modurtek,143,247,86,111,57,136,36.7,43.7,29.5,00000
68.0,52.0,27.0,681,01,01,  Masimpur,239,279,116,119,123,160,46.1,49.4,43.5,00000
68.0,52.0,27.0,681,02,01,  Baghber,1022,1002,475,479,547,523,50.5,49.8,51.1,00000
68.0,52.0,27.0,681,03,01,  Hafizpur,2670,3295,1218,1550,1452,1745,44.8,44.0,45.4,00000
68.0,52.0,33.0,196,01,03,  Hetemdi,623,440,310,198,313,242,58.6,61.0,56.4,00000
68.0,52.0,33.0,196,02,03,  Kutubdi,282,181,145,66,137,115,60.9,68.7,54.4,00000
68.0,52.0,33.0,681,01,01,  Kismat Sarerkandi,264,425,107,211,157,214,38.3,33.6,42.3,00000
68.0,52.0,33.0,681,02,01,  Lakhpur,879,579,381,272,498,307,60.3,58.3,61.9,00000
68.0,52.0,33.0,681,03,01,  Chandanpur,1034,702,458,311,576,391,59.6,59.6,59.6,00000
68.0,52.0,33.0,743,01,01,  Nalua Chak,1250,1038,573,490,677,548,54.6,53.9,55.3,00000
68.0,52.0,33.0,743,02,01,  Manarkandi,207,120,98,57,109,63,63.3,63.2,63.4,00000
68.0,52.0,33.0,743,03,01,  Mahishkandi,259,257,118,113,141,144,50.2,51.1,49.5,00000
68.0,52.0,40.0,614,01,01,  Khaliabad,587,937,268,430,319,507,38.5,38.4,38.6,00000
68.0,52.0,40.0,614,02,01,  Birgaon,2259,2434,1166,1173,1093,1261,48.1,49.9,46.4,00000
68.0,52.0,40.0,644,01,01,  Krishnapur,1363,1379,647,668,716,711,49.7,49.2,50.2,00000
68.0,52.0,40.0,644,02,01,  Char Gulmahmud,104,170,36,77,68,93,38.0,31.9,42.2,00000
68.0,52.0,47.0,374,01,01,  Daulatpur,1983,1752,905,782,1078,970,53.1,53.6,52.6,00000
68.0,52.0,47.0,374,02,01,  Keraninagar,664,398,313,185,351,213,62.5,62.9,62.2,00000
68.0,52.0,54.0,418,01,01,  Eakduaria,934,1340,426,620,508,720,41.1,40.7,41.4,00000
68.0,52.0,54.0,418,02,01,  Lakshmipur,225,98,109,47,116,51,69.7,69.9,69.5,00000
68.0,52.0,54.0,418,03,01,  Taltala,410,684,182,331,228,353,37.5,35.5,39.2,00000
68.0,52.0,61.0,325,01,01,  Chula,862,417,372,193,490,224,67.4,65.8,68.6,00000
68.0,52.0,61.0,325,02,01,  Rajballabhkandi,299,561,146,287,153,274,34.8,33.7,35.8,00000
68.0,52.0,61.0,325,03,01,  Baghibari,578,803,271,383,307,420,41.9,41.4,42.2,00000
68.0,52.0,61.0,325,04,01,  Mamdartek,251,427,106,188,145,239,37.0,36.1,37.8,00000
68.0,52.0,61.0,325,05,01,  Mamudpur,147,227,62,98,85,129,39.3,38.8,39.7,00000
68.0,52.0,61.0,325,06,01,  Bakchar,115,341,47,152,68,189,25.2,23.6,26.5,00000
68.0,52.0,61.0,325,07,01,  Durbakandi,123,318,49,171,74,147,27.9,22.3,33.5,00000
68.0,52.0,61.0,411,01,01,  Doaigaon,561,656,266,286,295,370,46.1,48.2,44.4,00000
68.0,52.0,61.0,411,02,01,  Kona Para,280,286,119,126,161,160,49.5,48.6,50.2,00000
68.0,52.0,61.0,411,03,01,  Khotmora,466,523,195,246,271,277,47.1,44.2,49.5,00000
68.0,52.0,61.0,411,04,01,  Tiekerkandi,633,295,325,109,308,186,68.2,74.9,62.3,00000
68.0,52.0,61.0,466,01,01,  Tan Gotashia,319,539,151,255,168,284,37.2,37.2,37.2,00000
68.0,52.0,61.0,466,02,01,  Nama Gotashia,786,909,380,412,406,497,46.4,48.0,45.0,00000
68.0,52.0,61.0,466,03,01,  Setartek,112,252,54,126,58,126,30.8,30.0,31.5,00000
68.0,52.0,61.0,466,04,01,  Ratherkanda,234,271,102,129,132,142,46.3,44.2,48.2,00000
68.0,52.0,61.0,466,05,01,  Talekanda,350,452,160,211,190,241,43.6,43.1,44.1,00000
68.0,52.0,61.0,466,06,01,  Pratab Mahal,310,419,198,171,112,248,42.5,53.7,31.1,00000
68.0,52.0,61.0,466,07,01,  Paterkanda,557,489,263,202,294,287,53.3,56.6,50.6,00000
68.0,52.0,61.0,798,01,01,  Panchkandi,1237,1453,603,692,634,761,46.0,46.6,45.4,00000
68.0,52.0,61.0,798,02,01,  Tatuakanda,207,205,105,90,102,115,50.2,53.8,47.0,00000
68.0,52.0,67.0,558,01,01,  Uttar Kanchikata,1104,1294,547,600,557,694,46.0,47.7,44.5,00000
68.0,52.0,67.0,558,02,01,  Dakshin Kanchikata,379,512,167,241,212,271,42.5,40.9,43.9,00000
68.0,52.0,67.0,558,03,01,  Dairadi,343,478,146,222,197,256,41.8,39.7,43.5,00000
68.0,52.0,67.0,558,04,01,  Kaliakuri,373,664,200,330,173,334,36.0,37.7,34.1,00000
68.0,52.0,67.0,558,05,01,  Rudrudi,771,1090,354,503,417,587,41.4,41.3,41.5,00000
68.0,52.0,67.0,558,06,01,  Panchaikur,476,817,210,367,266,450,36.8,36.4,37.2,00000
68.0,52.0,67.0,687,01,01,  Madhushal,1253,1103,539,506,714,597,53.2,51.6,54.5,00000
68.0,52.0,67.0,687,02,01,  Chechari,25,336,15,165,10,171,6.9,8.3,5.5,00000
68.0,52.0,74.0,270,01,01,  Mantala,1267,1665,593,812,674,853,43.2,42.2,44.1,00000
68.0,52.0,74.0,270,02,01,  Bawlia Para,71,308,34,150,37,158,18.7,18.5,19.0,00000
68.0,52.0,74.0,270,03,01,  Kalir Char,300,382,136,190,164,192,44.0,41.7,46.1,00000
68.0,52.0,74.0,614,01,01,  Khidirpur,375,319,190,170,185,149,54.0,52.8,55.4,00000
68.0,52.0,74.0,614,02,01,  Naya Para,997,1214,454,580,543,634,45.1,43.9,46.1,00000
68.0,52.0,74.0,614,03,01,  Domonmara,2266,2503,1052,1181,1214,1322,47.5,47.1,47.9,00000
68.0,52.0,74.0,614,04,01,  Rampur,1428,1439,679,668,749,771,49.8,50.4,49.3,00000
68.0,52.0,74.0,614,05,01,  Jibakaya,165,179,75,81,90,98,48.0,48.1,47.9,00000
68.0,52.0,74.0,614,06,01,  Paratala,197,415,99,204,98,211,32.2,32.7,31.7,00000
68.0,52.0,74.0,632,01,01,  Chak Ahmedpur,883,752,392,335,491,417,54.0,53.9,54.1,00000
68.0,52.0,74.0,632,02,01,  Bir Ahmedpur,1341,1147,610,588,731,559,53.9,50.9,56.7,00000
68.0,52.0,81.0,436,01,01,  Gangkul,988,761,441,381,547,380,56.5,53.6,59.0,00000
68.0,52.0,81.0,436,02,01,  Royer Para,587,830,283,490,304,340,41.4,36.6,47.2,00000
68.0,52.0,81.0,939,01,01,  Tarakandi,1321,1067,547,511,774,556,55.3,51.7,58.2,00000
68.0,52.0,81.0,939,02,01,  Nayakandi,566,559,225,273,341,286,50.3,45.2,54.4,00000
68.0,52.0,81.0,945,01,01,  Tatirdi,609,664,257,333,352,331,47.8,43.6,51.5,00000
68.0,52.0,81.0,945,02,01,  Chak Tatirdi,614,950,263,449,351,501,39.3,36.9,41.2,00000
68.0,60.0,20.0,296,01,01,  Bakharnagar,629,2113,321,1046,308,1067,22.9,23.5,22.4,00000
68.0,60.0,20.0,296,02,01,  Satpara,236,631,125,283,111,348,27.2,30.6,24.2,00000
68.0,60.0,20.0,296,03,01,  Muradnagar,438,1629,234,754,204,875,21.2,23.7,18.9,00000
68.0,60.0,20.0,296,04,01,  Bokshalipur,294,856,126,414,168,442,25.6,23.3,27.5,00000
68.0,60.0,20.0,296,05,01,  Kajirkandi,424,1099,204,521,220,578,27.8,28.1,27.6,00000
68.0,60.0,20.0,296,06,01,  Nekjanpur,480,1226,245,573,235,653,28.1,30.0,26.5,00000
68.0,60.0,20.0,296,07,01,  Birgaon,235,508,115,241,120,267,31.6,32.3,31.0,00000
68.0,60.0,21.0,106,01,01,  Baradia,387,635,191,308,196,327,37.9,38.3,37.5,00000
68.0,60.0,21.0,106,02,01,  Tentulia,317,233,183,86,134,147,57.6,68.0,47.7,00000
68.0,60.0,21.0,106,03,01,  Kanthalia,187,164,101,83,86,81,53.3,54.9,51.5,00000
68.0,60.0,21.0,106,04,01,  Pakuria,1715,1683,897,829,818,854,50.5,52.0,48.9,00000
68.0,60.0,21.0,106,05,01,  Paikardia,278,111,153,48,125,63,71.5,76.1,66.5,00000
68.0,60.0,21.0,106,06,01,  Dahurtek,199,209,95,101,104,108,48.8,48.5,49.1,00000
68.0,60.0,21.0,106,07,01,  Debaurtek,33,42,12,21,21,21,44.0,36.4,50.0,00000
68.0,60.0,21.0,106,08,01,  Goaldirtek,89,99,48,52,41,47,47.3,48.0,46.6,00000
68.0,60.0,21.0,106,09,01,  Akhalia,1362,2088,696,1042,666,1046,39.5,40.0,38.9,00000
68.0,60.0,21.0,106,10,01,  Chandgaon,947,1306,504,642,443,664,42.0,44.0,40.0,00000
68.0,60.0,21.0,106,11,01,  Hatkhola,366,253,191,123,175,130,59.1,60.8,57.4,00000
68.0,60.0,21.0,106,12,01,  Kabidirtek,39,97,16,51,23,46,28.7,23.9,33.3,00000
68.0,60.0,21.0,130,01,01,  Bara Banaid,610,541,327,271,283,270,53.0,54.7,51.2,00000
68.0,60.0,21.0,130,02,01,  Chota Banaid,274,181,146,82,128,99,60.2,64.0,56.4,00000
68.0,60.0,21.0,130,03,01,  Belati,168,175,100,89,68,86,49.0,52.9,44.2,00000
68.0,60.0,21.0,183,01,01,  Belabo,909,1213,413,594,496,619,42.8,41.0,44.5,00000
68.0,60.0,21.0,183,02,01,  Tangail,223,407,107,199,116,208,35.4,35.0,35.8,00000
68.0,60.0,21.0,438,01,01,  Dharmapur,297,216,160,108,137,108,57.9,59.7,55.9,00000
68.0,60.0,21.0,438,02,01,  Kairbari,178,121,91,67,87,54,59.5,57.6,61.7,00000
68.0,60.0,21.0,438,03,01,  Shankhola,168,342,96,159,72,183,32.9,37.6,28.2,00000
68.0,60.0,21.0,580,01,01,  Kandail,942,1092,484,546,458,546,46.3,47.0,45.6,00000
68.0,60.0,21.0,580,02,01,  Goal Para,914,1094,460,530,454,564,45.5,46.5,44.6,00000
68.0,60.0,21.0,580,03,01,  Sonpara,324,192,171,93,153,99,62.8,64.8,60.7,00000
68.0,60.0,21.0,580,04,01,  Keta Para,395,852,182,441,213,411,31.7,29.2,34.1,00000
68.0,60.0,21.0,642,01,01,  Kuralia,283,184,153,82,130,102,60.6,65.1,56.0,00000
68.0,60.0,21.0,642,02,01,  Anaibari,206,165,116,74,90,91,55.5,61.1,49.7,00000
68.0,60.0,21.0,642,03,01,  Bhum,272,340,128,162,144,178,44.4,44.1,44.7,00000
68.0,60.0,23.0,402,01,01,  Tidir Char,376,763,171,362,205,401,33.0,32.1,33.8,00000
68.0,60.0,23.0,402,02,01,  Jitrampur (Paschim Para),167,362,82,171,85,191,31.6,32.4,30.8,00000
68.0,60.0,23.0,639,01,01,  Doani,891,1209,452,538,439,671,42.4,45.7,39.5,00000
68.0,60.0,23.0,639,02,01,  Araiani,244,287,125,122,119,165,46.0,50.6,41.9,00000
68.0,60.0,23.0,639,03,01,  Nawabpur,255,623,126,299,129,324,29.0,29.6,28.5,00000
68.0,60.0,23.0,639,04,01,  Anantarampur,589,1327,321,636,268,691,30.7,33.5,27.9,00000
68.0,60.0,23.0,639,05,01,  Nayakandi,191,566,95,272,96,294,25.2,25.9,24.6,00000
68.0,60.0,25.0,485,01,01,  Ghoradia,4127,4197,2171,2046,1956,2151,49.6,51.5,47.6,00000
68.0,60.0,25.0,485,02,01,  Daspara,1054,1049,525,520,529,529,50.1,50.2,50.0,00000
68.0,60.0,25.0,485,03,01,  Tawadi(Part),207,192,114,81,93,111,51.9,58.5,45.6,00000
68.0,60.0,25.0,835,01,01,  Puran Para,3679,1529,1925,734,1754,795,70.6,72.4,68.8,00000
68.0,60.0,25.0,835,02,01,  Ghoradia (Part),4161,1876,2067,864,2094,1012,68.9,70.5,67.4,00000
68.0,60.0,25.0,835,03,01,  Dashpara (Part),1543,714,809,348,734,366,68.4,69.9,66.7,00000
68.0,60.0,41.0,562,01,01,  Kalikapur,87,325,36,158,51,167,21.1,18.6,23.4,00000
68.0,60.0,41.0,562,02,01,  Bogargoth,201,1385,99,646,102,739,12.7,13.3,12.1,00000
68.0,60.0,41.0,595,01,01,  Karimpur,2443,3606,1270,1700,1173,1906,40.4,42.8,38.1,00000
68.0,60.0,41.0,595,02,01,  Nawabpur(Algaali Para),163,728,82,351,81,377,18.3,18.9,17.7,00000
68.0,60.0,41.0,595,03,01,  Paschim Bausia,735,724,373,338,362,386,50.4,52.5,48.4,00000
68.0,60.0,41.0,595,04,01,  Purba Bausia,242,262,131,152,111,110,48.0,46.3,50.2,00000
68.0,60.0,41.0,595,05,01,  Sreenagar,1746,2469,931,1201,815,1268,41.4,43.7,39.1,00000
68.0,60.0,41.0,595,06,01,  Jagatpur,299,805,146,378,153,427,27.1,27.9,26.4,00000
68.0,60.0,41.0,595,07,01,  Rasulpur,605,1312,303,617,302,695,31.6,32.9,30.3,00000
68.0,60.0,41.0,595,08,01,  Rasulpur Kanda Para(Daksh,469,1165,239,574,230,591,28.7,29.4,28.0,00000
68.0,60.0,47.0,148,01,01,  Maishadi,914,1741,433,927,481,814,34.4,31.8,37.1,00000
68.0,60.0,47.0,148,02,01,  Milky Para,506,1159,229,590,277,569,30.4,28.0,32.7,00000
68.0,60.0,47.0,432,01,01,  Daukandi,1552,4028,752,2045,800,1983,27.8,26.9,28.7,00000
68.0,60.0,47.0,432,02,01,  Abdullahkandi,399,1052,204,524,195,528,27.5,28.0,27.0,00000
68.0,60.0,47.0,432,03,01,  Baraikandi,94,383,42,196,52,187,19.7,17.6,21.8,00000
68.0,60.0,47.0,615,01,01,  Kharia,950,1029,458,531,492,498,48.0,46.3,49.7,00000
68.0,60.0,47.0,615,02,01,  Darikandi,336,412,171,211,165,201,44.9,44.8,45.1,00000
68.0,60.0,47.0,615,03,01,  Shiberkandi,246,385,121,186,125,199,39.0,39.4,38.6,00000
68.0,60.0,53.0,156,01,03,  Bara Noapara,2283,1103,1216,597,1067,506,67.4,67.1,67.8,00000
68.0,60.0,53.0,156,02,03,  Roynadi,1007,582,524,297,483,285,63.4,63.8,62.9,00000
68.0,60.0,53.0,156,03,03,  Khudra Noapara,1069,709,527,341,542,368,60.1,60.7,59.6,00000
68.0,60.0,53.0,156,04,03,  Kanda Para,1307,1078,656,533,651,545,54.8,55.2,54.4,00000
68.0,60.0,53.0,156,05,03,  Dari Para,741,568,402,319,339,249,56.6,55.8,57.7,00000
68.0,60.0,53.0,384,01,01,  Chatto Ramchandradi,698,880,359,449,339,431,44.2,44.4,44.0,00000
68.0,60.0,53.0,384,02,01,  Islamabad,804,449,423,214,381,235,64.2,66.4,61.9,00000
68.0,60.0,53.0,467,01,03,  Bara Gadair Char,1461,1131,774,573,687,558,56.4,57.5,55.2,00000
68.0,60.0,53.0,467,02,03,  Bahar Char,156,291,78,157,78,134,34.9,33.2,36.8,00000
68.0,60.0,53.0,467,03,03,  Joria Kanda,544,1032,258,526,286,506,34.5,32.9,36.1,00000
68.0,60.0,53.0,467,04,03,  Alga Para,237,507,116,255,121,252,31.9,31.3,32.4,00000
68.0,60.0,53.0,467,05,03,  Khidirkandi,525,659,242,334,283,325,44.3,42.0,46.5,00000
68.0,60.0,53.0,793,01,01,  Nuralapur,1708,1646,869,839,839,807,50.9,50.9,51.0,00000
68.0,60.0,53.0,793,02,01,  Shyamtali,440,612,234,297,206,315,41.8,44.1,39.5,00000
68.0,60.0,53.0,793,03,01,  Jhirkutia,250,679,108,335,142,344,26.9,24.4,29.2,00000
68.0,60.0,53.0,793,04,01,  Matialkanda,368,601,169,327,199,274,38.0,34.1,42.1,00000
68.0,60.0,53.0,900,01,01,  Shimulkandi,442,433,243,200,199,233,50.5,54.9,46.1,00000
68.0,60.0,53.0,900,02,01,  Senerkandi,117,231,54,124,63,107,33.6,30.3,37.1,00000
68.0,60.0,59.0,047,01,01,  At Paika,911,1704,473,827,438,877,34.8,36.4,33.3,00000
68.0,60.0,59.0,047,02,01,  Baiderkandi,24,276,15,137,9,139,8.0,9.9,6.1,00000
68.0,60.0,59.0,100,01,01,  Balusair,1632,2208,779,1114,853,1094,42.5,41.2,43.8,00000
68.0,60.0,59.0,100,02,01,  Alga Para,96,364,42,174,54,190,20.9,19.4,22.1,00000
68.0,60.0,59.0,100,03,01,  Baniadi,211,1149,91,705,120,444,15.5,11.4,21.3,00000
68.0,60.0,59.0,100,04,01,  Balu Char,281,1085,116,546,165,539,20.6,17.5,23.4,00000
68.0,60.0,59.0,100,05,01,  Kali Bhairabpur,19,95,10,53,9,42,16.7,15.9,17.6,00000
68.0,60.0,59.0,325,01,01,  Chaudda Paika,881,1500,486,744,395,756,37.0,39.5,34.3,00000
68.0,60.0,59.0,325,02,01,  Khilgaon,1230,1867,622,991,608,876,39.7,38.6,41.0,00000
68.0,60.0,59.0,325,03,01,  Kalakanda,202,714,92,376,110,338,22.1,19.7,24.6,00000
68.0,60.0,59.0,325,04,01,  Durgakanda,117,150,61,77,56,73,43.8,44.2,43.4,00000
68.0,60.0,59.0,479,01,01,  Gazirgaon,28,517,11,268,17,249,5.1,3.9,6.4,00000
68.0,60.0,59.0,479,02,01,  Dari Gazirgaon,37,656,24,315,13,341,5.3,7.1,3.7,00000
68.0,60.0,59.0,479,03,01,  Udingdia,44,381,30,185,14,196,10.4,14.0,6.7,00000
68.0,60.0,59.0,657,01,01,  Kotowaler Char,526,544,251,277,275,267,49.2,47.5,50.7,00000
68.0,60.0,59.0,657,02,01,  Darikandi,663,564,326,284,337,280,54.0,53.4,54.6,00000
68.0,60.0,59.0,657,03,01,  Bilpar,246,706,120,345,126,361,25.8,25.8,25.9,00000
68.0,60.0,59.0,657,04,01,  Dairarpar,76,422,45,218,31,204,15.3,17.1,13.2,00000
68.0,60.0,59.0,666,01,03,  Maishasura,886,1349,454,695,432,654,39.6,39.5,39.8,00000
68.0,60.0,59.0,666,02,03,  Damorbhola,863,1142,419,546,444,596,43.0,43.4,42.7,00000
68.0,60.0,59.0,666,03,03,  Shantibhola,702,1111,356,560,346,551,38.7,38.9,38.6,00000
68.0,60.0,59.0,666,04,03,  Hamti,203,696,97,349,106,347,22.6,21.7,23.4,00000
68.0,60.0,65.0,823,01,01,  Korerpar,1019,726,549,365,470,361,58.4,60.1,56.6,00000
68.0,60.0,65.0,823,02,01,  Paulan Pur,1182,1137,625,531,557,606,51.0,54.1,47.9,00000
68.0,60.0,65.0,929,01,01,  Sreenagar,459,358,263,186,196,172,56.2,58.6,53.3,00000
68.0,60.0,65.0,929,02,01,  Pathar Para,460,479,240,244,220,235,49.0,49.6,48.4,00000
68.0,60.0,65.0,929,03,01,  Panchbhag,538,475,283,232,255,243,53.1,55.0,51.2,00000
68.0,60.0,65.0,929,04,01,  Saikadi,189,191,96,98,93,93,49.7,49.5,50.0,00000
68.0,60.0,77.0,017,01,01,  Champak Nagar,1002,1870,555,867,447,1003,34.9,39.0,30.8,00000
68.0,60.0,77.0,017,02,01,  Kalai Gobindapur,1090,1574,542,727,548,847,40.9,42.7,39.3,00000
68.0,60.0,77.0,450,01,01,  Dilarpur,957,1322,475,622,482,700,42.0,43.3,40.8,00000
68.0,60.0,77.0,450,02,01,  Baher Char,401,1312,215,597,186,715,23.4,26.5,20.6,00000
68.0,60.0,77.0,450,03,01,  Alipur,595,2322,310,1091,285,1231,20.4,22.1,18.8,00000
68.0,60.0,77.0,450,04,01,  Nazarpur,878,1592,427,753,451,839,35.5,36.2,35.0,00000
68.0,60.0,77.0,450,05,01,  Changatali,102,180,52,87,50,93,36.2,37.4,35.0,00000
68.0,60.0,77.0,450,06,01,  Chagharia Para,1457,1698,748,727,709,971,46.2,50.7,42.2,00000
68.0,60.0,77.0,450,07,01,  Nabipur,1038,2982,530,1489,508,1493,25.8,26.3,25.4,00000
68.0,60.0,77.0,450,08,01,  Jamaliakandi,868,950,491,427,377,523,47.7,53.5,41.9,00000
68.0,60.0,77.0,450,09,01,  Dari Nabipur,855,1275,462,573,393,702,40.1,44.6,35.9,00000
68.0,60.0,83.0,124,01,01,  Bara Balapur,1048,1195,546,607,502,588,46.7,47.4,46.1,00000
68.0,60.0,83.0,124,02,01,  Chhota Balapur,147,266,65,143,82,123,35.6,31.3,40.0,00000
68.0,60.0,83.0,124,03,01,  Bala Purer Char,829,1770,418,900,411,870,31.9,31.7,32.1,00000
68.0,60.0,83.0,124,04,01,  Menurkandi,412,320,222,149,190,171,56.3,59.8,52.6,00000
68.0,60.0,83.0,124,05,01,  Bibirkandi,577,705,309,340,268,365,45.0,47.6,42.3,00000
68.0,60.0,83.0,124,06,01,  Sagardi,821,2091,438,1011,383,1080,28.2,30.2,26.2,00000
68.0,60.0,83.0,142,01,01,  Chhota Khamar Char,183,388,93,180,90,208,32.0,34.1,30.2,00000
68.0,60.0,83.0,142,02,01,  Khamar Char,370,1119,175,557,195,562,24.8,23.9,25.8,00000
68.0,60.0,83.0,266,01,01,  Dakshin Char,788,1956,409,977,379,979,28.7,29.5,27.9,00000
68.0,60.0,83.0,266,02,01,  Dari Char,351,730,171,363,180,367,32.5,32.0,32.9,00000
68.0,60.0,83.0,829,01,01,  Puran Char,855,1702,474,870,381,832,33.4,35.3,31.4,00000
68.0,60.0,83.0,829,02,01,  Meratali,135,178,74,82,61,96,43.1,47.4,38.9,00000
68.0,60.0,89.0,207,01,01,  Bhat Para,877,735,498,367,379,368,54.4,57.6,50.7,00000
68.0,60.0,89.0,207,02,01,  Laskar Para,419,174,218,70,201,104,70.7,75.7,65.9,00000
68.0,60.0,89.0,207,03,01,  Shib Para,166,26,91,9,75,17,86.5,91.0,81.5,00000
68.0,60.0,89.0,207,04,01,  Dighirpar,246,200,118,100,128,100,55.2,54.1,56.1,00000
68.0,60.0,89.0,207,05,01,  Lathurbagh,174,101,68,58,106,43,63.3,54.0,71.1,00000
68.0,60.0,89.0,207,06,01,  Tangartek,302,229,151,99,151,130,56.9,60.4,53.7,00000
68.0,60.0,89.0,207,07,01,  Badhubari,159,70,89,31,70,39,69.4,74.2,64.2,00000
68.0,60.0,89.0,207,08,01,  Purba Chakshal,398,430,205,224,193,206,48.1,47.8,48.4,00000
68.0,60.0,89.0,207,09,01,  Purba Kulati,298,222,148,103,150,119,57.3,59.0,55.8,00000
68.0,60.0,89.0,556,01,01,  Kakasia,771,947,407,445,364,502,44.9,47.8,42.0,00000
68.0,60.0,89.0,556,02,01,  Durbartek,311,308,167,164,144,144,50.2,50.5,50.0,00000
68.0,60.0,89.0,556,03,01,  Aula Barirtek,32,136,13,71,19,65,19.0,15.5,22.6,00000
68.0,60.0,89.0,556,04,01,  Bania Barirtek,83,237,41,112,42,125,25.9,26.8,25.1,00000
68.0,60.0,89.0,556,05,01,  Ajunartek,29,7,19,4,10,3,80.6,82.6,76.9,00000
68.0,60.0,89.0,781,01,01,  Nehaba,972,685,484,337,488,348,58.7,59.0,58.4,00000
68.0,60.0,89.0,781,02,01,  Kailad,139,195,66,99,73,96,41.6,40.0,43.2,00000
68.0,60.0,89.0,781,03,01,  Dewanbari,149,313,66,155,83,158,32.3,29.9,34.4,00000
68.0,60.0,89.0,781,04,01,  Puranbari,175,149,82,74,93,75,54.0,52.6,55.4,00000
68.0,60.0,89.0,781,05,01,  Bardia,108,132,50,65,58,67,45.0,43.5,46.4,00000
68.0,60.0,89.0,781,06,01,  Beladi,180,337,74,165,106,172,34.8,31.0,38.1,00000
68.0,60.0,89.0,781,07,01,  Shimulia,235,190,118,93,117,97,55.3,55.9,54.7,00000
68.0,60.0,89.0,781,08,01,  Tangai,266,467,132,232,134,235,36.3,36.3,36.3,00000
68.0,60.0,89.0,781,09,01,  Allartek,191,268,104,162,87,106,41.6,39.1,45.1,00000
68.0,60.0,89.0,781,10,01,  Paschim Kulait,420,459,231,223,189,236,47.8,50.9,44.5,00000
68.0,60.0,89.0,781,11,01,  Paschim Chakshail,229,376,105,169,124,207,37.9,38.3,37.5,00000
68.0,60.0,95.0,065,01,01,  Baghatia,6078,3235,3206,1591,2872,1644,65.3,66.8,63.6,00000
68.0,60.0,95.0,065,02,01,  Saheb Pratap,2353,1231,1333,624,1020,607,65.7,68.1,62.7,00000
68.0,60.0,95.0,065,03,01,  Masimpur,751,405,400,206,351,199,65.0,66.0,63.8,00000
68.0,63.0,15.0,292,01,01,  Dakshin Deora,1168,1527,551,789,617,738,43.3,41.1,45.5,00000
68.0,63.0,15.0,292,02,01,  Fulbaria,627,661,315,333,312,328,48.7,48.6,48.8,00000
68.0,63.0,15.0,805,01,01,  Char Alinagar,323,344,140,172,183,172,48.4,44.9,51.5,00000
68.0,63.0,15.0,805,02,01,  Char Madhyanagar,183,146,91,71,92,75,55.6,56.2,55.1,00000
68.0,63.0,15.0,994,01,01,  Malita,1662,1334,820,606,842,728,55.5,57.5,53.6,00000
68.0,63.0,15.0,994,02,01,  Loharkanda,125,106,69,51,56,55,54.1,57.5,50.5,00000
68.0,63.0,15.0,994,03,01,  Kala Paika,123,167,58,80,65,87,42.4,42.0,42.8,00000
68.0,63.0,31.0,078,01,01,  Birinda,1680,1329,872,608,808,721,55.8,58.9,52.8,00000
68.0,63.0,31.0,078,02,01,  Joynagar,998,1453,466,865,532,588,40.7,35.0,47.5,00000
68.0,63.0,31.0,505,01,01,  Dash Para(Islampara),2209,2536,1126,1438,1083,1098,46.6,43.9,49.7,00000
68.0,63.0,31.0,505,02,01,  Kajair,1210,1378,625,783,585,595,46.8,44.4,49.6,00000
68.0,63.0,47.0,473,01,01,  Noakanda,2057,1405,980,698,1077,707,59.4,58.4,60.4,00000
68.0,63.0,47.0,473,02,01,  Ichhakhali,943,977,473,485,470,492,49.1,49.4,48.9,00000
68.0,63.0,47.0,473,03,01,  Daluar Char,307,212,148,103,159,109,59.2,59.0,59.3,00000
68.0,63.0,47.0,473,04,01,  Musarkanda,31,34,17,17,14,17,47.7,50.0,45.2,00000
68.0,63.0,47.0,473,05,01,  Khashawala,178,146,75,75,103,71,54.9,50.0,59.2,00000
68.0,63.0,47.0,473,06,01,  Joypura,739,694,348,342,391,352,51.6,50.4,52.6,00000
68.0,63.0,47.0,473,07,01,  Gajaria,1168,1156,587,538,581,618,50.3,52.2,48.5,00000
68.0,63.0,47.0,473,08,01,  Sarkar Char,741,365,340,183,401,182,67.0,65.0,68.8,00000
68.0,63.0,79.0,647,01,01,  Kuraitali,337,402,180,191,157,211,45.6,48.5,42.7,00000
68.0,63.0,79.0,647,02,01,  Barabo,340,143,180,60,160,83,70.4,75.0,65.8,00000
68.0,63.0,79.0,647,03,01,  Baghaba,123,86,71,33,52,53,58.9,68.3,49.5,00000
68.0,63.0,79.0,647,04,01,  Baribari,281,247,161,98,120,149,53.2,62.2,44.6,00000
68.0,63.0,79.0,647,05,01,  Bad Barabo,153,256,75,128,78,128,37.4,36.9,37.9,00000
68.0,63.0,79.0,647,06,01,  Lakheraj,136,86,68,36,68,50,61.3,65.4,57.6,00000
68.0,63.0,79.0,837,01,01,  Raban,387,347,207,153,180,194,52.7,57.5,48.1,00000
68.0,63.0,79.0,837,02,01,  Sattekia,241,126,137,43,104,83,65.7,76.1,55.6,00000
68.0,63.0,79.0,837,03,01,  Bhaluka Para,663,181,356,69,307,112,78.6,83.8,73.3,00000
68.0,63.0,79.0,837,04,01,  Bilpar,166,192,101,86,65,106,46.4,54.0,38.0,00000
68.0,64.0,10.0,094,01,01,  Baluakandi,726,1306,330,635,396,671,35.7,34.2,37.1,00000
68.0,64.0,10.0,094,02,01,  Khala Para,981,1438,470,750,511,688,40.6,38.5,42.6,00000
68.0,64.0,10.0,094,03,01,  Joynagar,65,154,35,74,30,80,29.7,32.1,27.3,00000
68.0,64.0,10.0,094,04,01,  Dari Baliakandi,373,865,166,442,207,423,30.1,27.3,32.9,00000
68.0,64.0,10.0,426,01,01,  Amirganj,470,511,221,299,249,212,47.9,42.5,54.0,00000
68.0,64.0,10.0,426,02,01,  Karimganj,1536,2005,708,991,828,1014,43.4,41.7,45.0,00000
68.0,64.0,10.0,426,03,01,  Nalbata,847,1505,393,763,454,742,36.0,34.0,38.0,00000
68.0,64.0,10.0,426,04,01,  Hasnabad,5640,3838,2950,2031,2690,1807,59.5,59.2,59.8,00000
68.0,64.0,10.0,426,05,01,  Aganagar,388,680,175,334,213,346,36.3,34.4,38.1,00000
68.0,64.0,10.0,426,06,01,  Atkandi,152,219,66,120,86,99,41.0,35.5,46.5,00000
68.0,64.0,10.0,813,01,01,  Rahimabad,816,649,394,302,422,347,55.7,56.6,54.9,00000
68.0,64.0,10.0,813,02,01,  Rahimabad Khamar,702,386,339,183,363,203,64.5,64.9,64.1,00000
68.0,64.0,12.0,015,01,01,  Sherpur,1671,2011,807,955,864,1056,45.4,45.8,45.0,00000
68.0,64.0,12.0,015,02,01,  Naya Char,1885,1800,954,814,931,986,51.2,54.0,48.6,00000
68.0,64.0,12.0,015,03,01,  Adiabad,5363,4096,2479,1899,2884,2197,56.7,56.6,56.8,00000
68.0,64.0,14.0,064,01,01,  Boalmara,484,685,225,330,259,355,41.4,40.5,42.2,00000
68.0,64.0,14.0,064,02,01,  Jahagirnagar,453,1063,219,518,234,545,29.9,29.7,30.0,00000
68.0,64.0,14.0,679,01,01,  Nabiabad,1588,1496,724,679,864,817,51.5,51.6,51.4,00000
68.0,64.0,14.0,679,02,01,  Brahman Badua,377,551,181,262,196,289,40.6,40.9,40.4,00000
68.0,64.0,14.0,963,01,03,  Tulaluli,447,786,219,391,228,395,36.3,35.9,36.6,00000
68.0,64.0,14.0,963,02,03,  Sahebnagar,338,474,152,203,186,271,41.6,42.8,40.7,00000
68.0,64.0,14.0,963,03,03,  Jahangirnagar,120,464,66,241,54,223,20.5,21.5,19.5,00000
68.0,64.0,14.0,963,04,03,  Boalmara,343,445,156,214,187,231,43.5,42.2,44.7,00000
68.0,64.0,16.0,118,01,01,  Banshgari(Balua&Chander Kandi),1091,2665,603,1191,488,1474,29.0,33.6,24.9,00000
68.0,64.0,16.0,118,02,01,  Dighaliakandi,563,1629,316,740,247,889,25.7,29.9,21.7,00000
68.0,64.0,16.0,118,03,01,  Battalikandi,550,2548,301,1169,249,1379,17.8,20.5,15.3,00000
68.0,64.0,16.0,118,04,01,  Rajnagar,272,726,125,301,147,425,27.3,29.3,25.7,00000
68.0,64.0,16.0,118,05,01,  Payarakandi,112,140,51,55,61,85,44.4,48.1,41.8,00000
68.0,64.0,16.0,118,06,01,  Sobanpur,53,419,26,194,27,225,11.2,11.8,10.7,00000
68.0,64.0,23.0,947,01,01,  Sreenidhi,593,1343,274,637,319,706,30.6,30.1,31.1,00000
68.0,64.0,23.0,947,02,01,  Barakanda,412,723,197,342,215,381,36.3,36.5,36.1,00000
68.0,64.0,23.0,947,03,01,  Kharitala,1001,1006,462,457,539,549,49.9,50.3,49.5,00000
68.0,64.0,23.0,947,04,01,  Baher Char,846,866,398,386,448,480,49.4,50.8,48.3,00000
68.0,64.0,27.0,071,01,01,  Bagh Duariakandi,382,934,192,459,190,475,29.0,29.5,28.6,00000
68.0,64.0,27.0,071,02,01,  Alipur,108,312,55,173,53,139,25.7,24.1,27.6,00000
68.0,64.0,27.0,071,03,01,  Kalikapur (Part),644,978,309,502,335,476,39.7,38.1,41.3,00000
68.0,64.0,27.0,568,01,01,  Majher Char,632,2464,309,1205,323,1259,20.4,20.4,20.4,00000
68.0,64.0,27.0,568,02,01,  Chandpur Deara (Part),357,1177,192,582,165,595,23.3,24.8,21.7,00000
68.0,64.0,27.0,568,03,01,  Islampur,206,1065,94,521,112,544,16.2,15.3,17.1,00000
68.0,64.0,27.0,789,01,01,  Sadagarkandi,1065,2154,569,997,496,1157,33.1,36.3,30.0,00000
68.0,64.0,27.0,789,02,01,  Sujatpur,107,411,52,203,55,208,20.7,20.4,20.9,00000
68.0,64.0,27.0,789,03,01,  Mohinipur,243,1046,113,508,130,538,18.9,18.2,19.5,00000
68.0,64.0,27.0,789,04,01,  Majidpur,24,360,11,178,13,182,6.3,5.8,6.7,00000
68.0,64.0,27.0,789,05,01,  Kurerpar,387,910,192,417,195,493,29.8,31.5,28.3,00000
68.0,64.0,27.0,789,06,01,  Imander Kandi,33,134,14,70,19,64,19.8,16.7,22.9,00000
68.0,64.0,30.0,134,01,01,  Batakandi,339,510,178,238,161,272,39.9,42.8,37.2,00000
68.0,64.0,30.0,134,02,01,  Battali,596,1258,272,603,324,655,32.1,31.1,33.1,00000
68.0,64.0,30.0,134,03,01,  Khamar,437,1033,187,501,250,532,29.7,27.2,32.0,00000
68.0,64.0,30.0,205,01,01,  Bagaikandi,883,2967,447,1451,436,1516,22.9,23.6,22.3,00000
68.0,64.0,30.0,205,02,01,  Aralia,534,1680,264,828,270,852,24.1,24.2,24.1,00000
68.0,64.0,30.0,205,03,01,  Baradakandi,240,523,114,248,126,275,31.5,31.5,31.4,00000
68.0,64.0,33.0,276,01,01,  Char Madhua,796,2186,406,967,390,1219,26.7,29.6,24.2,00000
68.0,64.0,33.0,276,02,01,  Bir Charmadhua,451,722,189,322,262,400,38.4,37.0,39.6,00000
68.0,64.0,33.0,884,01,01,  Samibad,483,1819,235,820,248,999,21.0,22.3,19.9,00000
68.0,64.0,33.0,884,02,01,  Gazipur,448,668,195,303,253,365,40.1,39.2,40.9,00000
68.0,64.0,37.0,007,01,01,  Abdullapur,1305,2192,586,1060,719,1132,37.3,35.6,38.8,00000
68.0,64.0,37.0,007,02,01,  Meher Nagar,313,814,133,391,180,423,27.8,25.4,29.9,00000
68.0,64.0,37.0,157,01,01,  Bhaishber,645,1640,300,788,345,852,28.2,27.6,28.8,00000
68.0,64.0,37.0,157,02,01,  Ballabhpur,238,306,97,156,141,150,43.8,38.3,48.5,00000
68.0,64.0,37.0,300,01,01,  Char Subuddi,2917,4128,1345,1976,1572,2152,41.4,40.5,42.2,00000
68.0,64.0,37.0,300,02,01,  Chanpur Uttar Para,123,629,58,292,65,337,16.4,16.6,16.2,00000
68.0,64.0,40.0,379,01,01,  Lakshmipur,1060,362,503,162,557,200,74.5,75.6,73.6,00000
68.0,64.0,40.0,379,02,01,  Khas Howla,448,401,210,188,238,213,52.8,52.8,52.8,00000
68.0,64.0,40.0,379,03,01,  Daukar Char,971,698,446,361,525,337,58.2,55.3,60.9,00000
68.0,64.0,44.0,181,01,01,  Birkandi,1588,2816,732,1446,856,1370,36.1,33.6,38.5,00000
68.0,64.0,44.0,181,02,01,  Manipura,60,196,29,98,31,98,23.4,22.8,24.0,00000
68.0,64.0,44.0,181,03,01,  Mamudpur,240,235,111,108,129,127,50.5,50.7,50.4,00000
68.0,64.0,44.0,410,01,01,  Hairmara,1853,2729,862,1331,991,1398,40.4,39.3,41.5,00000
68.0,64.0,44.0,410,02,01,  Darihairmara,1113,753,506,340,607,413,59.6,59.8,59.5,00000
68.0,64.0,47.0,023,01,01,  Algi,892,1512,469,785,423,727,37.1,37.4,36.8,00000
68.0,64.0,47.0,023,02,01,  Kurerpar,437,1070,197,495,240,575,29.0,28.5,29.4,00000
68.0,64.0,47.0,142,01,01,  Kasarikandi,567,989,229,469,338,520,36.4,32.8,39.4,00000
68.0,64.0,47.0,142,02,01,  Thanakandi,448,702,199,321,249,381,39.0,38.3,39.5,00000
68.0,64.0,47.0,142,03,01,  Hoglakandi,274,439,107,223,167,216,38.4,32.4,43.6,00000
68.0,64.0,47.0,142,04,01,  Karaipur,443,581,193,265,250,316,43.3,42.1,44.2,00000
68.0,64.0,47.0,142,05,01,  Jaukandi,841,1488,357,715,484,773,36.1,33.3,38.5,00000
68.0,64.0,47.0,142,06,01,  Daulatkandi,474,586,222,299,252,287,44.7,42.6,46.8,00000
68.0,64.0,47.0,142,07,01,  Ghagotia,506,586,214,276,292,310,46.3,43.7,48.5,00000
68.0,64.0,50.0,639,01,01,  Rajbari,1066,1191,499,593,567,598,47.2,45.7,48.7,00000
68.0,64.0,50.0,639,02,01,  Kumartek,213,184,112,94,101,90,53.7,54.4,52.9,00000
68.0,64.0,50.0,639,03,01,  Bhiti Marjal,580,630,301,281,279,349,47.9,51.7,44.4,00000
68.0,64.0,50.0,639,04,01,  Dhukundi Char,1058,1002,511,487,547,515,51.4,51.2,51.5,00000
68.0,64.0,50.0,639,05,01,  Jehahi,225,347,99,173,126,174,39.3,36.4,42.0,00000
68.0,64.0,50.0,639,06,01,  Batiara,869,738,418,348,451,390,54.1,54.6,53.6,00000
68.0,64.0,50.0,639,07,01,  Brahmaner Tek,481,448,238,220,243,228,51.8,52.0,51.6,00000
68.0,64.0,50.0,639,08,01,  Marjal,2968,2388,1468,1202,1500,1186,55.4,55.0,55.8,00000
68.0,64.0,50.0,639,09,01,  Char Marjal,2122,3311,1020,1571,1102,1740,39.1,39.4,38.8,00000
68.0,64.0,54.0,110,01,01,  Bangalinagar,1416,1293,681,590,735,703,52.3,53.6,51.1,00000
68.0,64.0,54.0,110,02,01,  Majherkandi,816,591,384,268,432,323,58.0,58.9,57.2,00000
68.0,64.0,54.0,994,01,01,  Mirzanagar,1070,1016,514,452,556,564,51.3,53.2,49.6,00000
68.0,64.0,54.0,994,02,01,  Purbakandi,608,598,273,275,335,323,50.4,49.8,50.9,00000
68.0,64.0,54.0,994,03,01,  Hoglakandi,772,586,352,274,420,312,56.8,56.2,57.4,00000
68.0,64.0,54.0,994,04,01,  Baher Char,1700,2820,793,1403,907,1417,37.6,36.1,39.0,00000
68.0,64.0,57.0,055,01,01,  Anwarabad,306,443,162,193,144,250,40.9,45.6,36.5,00000
68.0,64.0,57.0,055,02,01,  Majubanda,129,92,64,40,65,52,58.4,61.5,55.6,00000
68.0,64.0,57.0,536,01,01,  Kukurmara,472,293,244,125,228,168,61.7,66.1,57.6,00000
68.0,64.0,57.0,536,02,01,  Puberchar,531,368,285,160,246,208,59.1,64.0,54.2,00000
68.0,64.0,57.0,584,01,01,  Mamudabad(Tuan Para),1954,1318,964,612,990,706,59.7,61.2,58.4,00000
68.0,64.0,57.0,584,02,01,  Mamudabad Nama Para,1124,1756,549,911,575,845,39.0,37.6,40.5,00000
68.0,64.0,57.0,765,01,01,  Pirajkandi,1899,1846,975,862,924,984,50.7,53.1,48.4,00000
68.0,64.0,57.0,765,02,01,  Dari Para,222,522,104,231,118,291,29.8,31.0,28.9,00000
68.0,64.0,57.0,765,03,01,  Meratali,381,742,192,334,189,408,33.9,36.5,31.7,00000
68.0,64.0,57.0,773,01,01,  Pirpur,751,978,394,508,357,470,43.4,43.7,43.2,00000
68.0,64.0,57.0,773,02,01,  Khanda Para,714,924,370,487,344,437,43.6,43.2,44.0,00000
68.0,64.0,57.0,852,01,01,  Sadhunagar,199,325,80,154,119,171,38.0,34.2,41.0,00000
68.0,64.0,57.0,852,02,01,  Khanda Para,3,5,1,3,2,2,37.5,25.0,50.0,00000
68.0,64.0,61.0,663,01,01,  Biram Para,206,733,110,359,96,374,21.9,23.5,20.4,00000
68.0,64.0,61.0,663,02,01,  Uttarpara,237,283,98,118,139,165,45.6,45.4,45.7,00000
68.0,64.0,61.0,663,03,01,  Madhyapara,116,345,52,147,64,198,25.2,26.1,24.4,00000
68.0,64.0,61.0,663,04,01,  Purbapara,140,374,78,158,62,216,27.2,33.1,22.3,00000
68.0,64.0,61.0,663,05,01,  Paschimpara,159,777,74,358,85,419,17.0,17.1,16.9,00000
68.0,64.0,61.0,663,06,01,  Balu Char,89,221,49,110,40,111,28.7,30.8,26.5,00000
68.0,64.0,61.0,663,07,01,  Tatua Para,17,206,12,105,5,101,7.6,10.3,4.7,00000
68.0,64.0,61.0,663,08,01,  Baratek (Islampur),26,122,11,63,15,59,17.6,14.9,20.3,00000
68.0,64.0,61.0,663,09,01,  Bilpara (Ferospur),93,142,40,70,53,72,39.6,36.4,42.4,00000
68.0,64.0,61.0,663,10,01,  Lakshmipur,94,513,42,227,52,286,15.5,15.6,15.4,00000
68.0,64.0,61.0,663,11,01,  Shantipur,322,1009,141,466,181,543,24.2,23.2,25.0,00000
68.0,64.0,71.0,718,01,01,  Sonakandi,296,1391,141,621,155,770,17.5,18.5,16.8,00000
68.0,64.0,71.0,718,02,01,  Birgaon Kanda Para,624,1246,309,575,315,671,33.4,35.0,31.9,00000
68.0,64.0,71.0,718,03,01,  Birgaon Paschim Para,528,1628,249,745,279,883,24.5,25.1,24.0,00000
68.0,64.0,71.0,718,04,01,  Birgaon Purba Para,815,1069,392,454,423,615,43.3,46.3,40.8,00000
68.0,64.0,71.0,718,05,01,  Haripur,827,1084,400,476,427,608,43.3,45.7,41.3,00000
68.0,64.0,71.0,718,06,01,  Darigaon,699,2725,355,1293,344,1432,20.4,21.5,19.4,00000
68.0,64.0,71.0,718,07,01,  Gopinathpur,486,2671,247,1230,239,1441,15.4,16.7,14.2,00000
68.0,64.0,74.0,347,01,01,  Gobindapur,1032,1183,487,544,545,639,46.6,47.2,46.0,00000
68.0,64.0,74.0,347,02,01,  Miahjanpur,354,133,177,65,177,68,72.7,73.1,72.2,00000
68.0,64.0,74.0,521,01,01,  Khag Char,516,373,251,185,265,188,58.0,57.6,58.5,00000
68.0,64.0,74.0,521,02,01,  Kamalpur,192,364,82,184,110,180,34.5,30.8,37.9,00000
68.0,64.0,74.0,655,01,03,  Khag Char (Part),862,1405,390,677,472,728,38.0,36.6,39.3,00000
68.0,64.0,74.0,655,02,03,  Nurpur,387,468,177,213,210,255,45.3,45.4,45.2,00000
68.0,64.0,74.0,655,03,03,  Methikanda (Part),593,561,291,266,302,295,51.4,52.2,50.6,00000
68.0,64.0,74.0,693,01,01,  Palashtali,366,328,161,145,205,183,52.7,52.6,52.8,00000
68.0,64.0,74.0,693,02,01,  Takipura(Part),347,297,192,143,155,154,53.9,57.3,50.2,00000
68.0,64.0,74.0,758,01,01,  Phuldi,686,589,351,263,335,326,53.8,57.2,50.7,00000
68.0,64.0,74.0,758,02,01,  Chasiamara,564,798,267,390,297,408,41.4,40.6,42.1,00000
68.0,64.0,74.0,758,03,01,  Char Phuldi,531,178,255,79,276,99,74.9,76.3,73.6,00000
68.0,64.0,74.0,758,04,01,  Taki Pura,862,984,404,422,458,562,46.7,48.9,44.9,00000
68.0,64.0,74.0,758,05,01,  Palashtali,1674,2120,759,998,915,1122,44.1,43.2,44.9,00000
68.0,64.0,78.0,229,01,01,  Baluakandi,335,1329,180,615,155,714,20.1,22.6,17.8,00000
68.0,64.0,78.0,229,02,01,  Sachiamara,112,431,50,207,62,224,20.6,19.5,21.7,00000
68.0,64.0,78.0,434,01,01,  Madhyanagar,1674,4051,830,1829,844,2222,29.2,31.2,27.5,00000
68.0,64.0,78.0,434,02,01,  Alinagar,418,905,213,422,205,483,31.6,33.5,29.8,00000
68.0,64.0,78.0,434,03,01,  Kasarikandi,744,2859,355,1343,389,1516,20.6,20.9,20.4,00000
68.0,64.0,78.0,434,04,01,  Khashkandi,173,697,75,337,98,360,19.9,18.2,21.4,00000
68.0,64.0,78.0,434,05,01,  Sonabalua,154,272,87,113,67,159,36.2,43.5,29.6,00000
68.0,64.0,78.0,434,06,01,  Mirekandi,103,479,58,220,45,259,17.7,20.9,14.8,00000
68.0,64.0,78.0,434,07,01,  Krishtanagar,34,57,18,30,16,27,37.4,37.5,37.2,00000
68.0,64.0,78.0,434,08,01,  Paratali,476,1018,242,481,234,537,31.9,33.5,30.4,00000
68.0,64.0,78.0,434,09,01,  Manadirkandi,348,714,194,317,154,397,32.8,38.0,27.9,00000
68.0,64.0,78.0,434,10,01,  Singrapur,447,1040,222,468,225,572,30.1,32.2,28.2,00000
68.0,64.0,78.0,434,11,01,  Maniknagar,95,249,61,116,34,133,27.6,34.5,20.4,00000
68.0,64.0,78.0,434,12,01,  Karaipur,147,528,75,244,72,284,21.8,23.5,20.2,00000
68.0,64.0,78.0,434,13,01,  Azizpur,174,438,80,216,94,222,28.4,27.0,29.7,00000
68.0,64.0,81.0,331,01,01,  Chhota Lakshmipur,97,261,39,120,58,141,27.1,24.5,29.1,00000
68.0,64.0,81.0,331,02,01,  Lakshimpur,1259,1793,630,840,629,953,41.3,42.9,39.8,00000
68.0,64.0,84.0,600,01,01,  Mamudpur,1357,1747,606,816,751,931,43.7,42.6,44.6,00000
68.0,64.0,84.0,600,02,01,  Saharkhola,673,1024,303,499,370,525,39.7,37.8,41.3,00000
68.0,64.0,84.0,600,03,01,  Chhota Ban,56,54,36,23,20,31,50.9,61.0,39.2,00000
68.0,64.0,84.0,600,04,01,  Mamudpur Baluakanda,210,251,86,139,124,112,45.6,38.2,52.5,00000
68.0,64.0,91.0,307,01,01,  Islampur,8,72,5,36,3,36,10.0,12.2,7.7,00000
68.0,64.0,91.0,307,02,01,  Mursidabad,57,265,29,126,28,139,17.7,18.7,16.8,00000
68.0,64.0,91.0,844,01,01,  Rangpur,386,582,206,249,180,333,39.9,45.3,35.1,00000
68.0,64.0,91.0,844,02,01,  Abdullar Char,158,545,85,260,73,285,22.5,24.6,20.4,00000
68.0,64.0,91.0,939,01,01,  Bhalua Char,850,2152,419,1015,431,1137,28.3,29.2,27.5,00000
68.0,64.0,91.0,939,02,01,  Bhaluarchar Purbpara,460,1783,216,838,244,945,20.5,20.5,20.5,00000
68.0,64.0,91.0,939,03,01,  Vojranathpur,28,425,11,212,17,213,6.2,4.9,7.4,00000
68.0,64.0,91.0,939,04,01,  Sreenagar,651,1614,351,723,300,891,28.7,32.7,25.2,00000
68.0,64.0,91.0,939,05,01,  Gazariakandi,298,945,135,405,163,540,24.0,25.0,23.2,00000
68.0,64.0,91.0,939,06,01,  Saidabad,1012,1564,519,733,493,831,39.3,41.5,37.2,00000
68.0,64.0,91.0,939,07,01,  Bagaikandi,334,821,172,371,162,450,28.9,31.7,26.5,00000
68.0,64.0,91.0,939,08,01,  Palashtali,275,829,144,365,131,464,24.9,28.3,22.0,00000
68.0,64.0,91.0,939,09,01,  Gopinathpur,418,1259,215,563,203,696,24.9,27.6,22.6,00000
68.0,64.0,91.0,939,10,01,  Kalipur,427,585,203,268,224,317,42.2,43.1,41.4,00000
68.0,64.0,91.0,939,11,01,  Nobabpur,80,194,34,81,46,113,29.2,29.6,28.9,00000
68.0,64.0,91.0,939,12,01,  Sonakanda,44,254,25,123,19,131,14.8,16.9,12.7,00000
68.0,64.0,94.0,979,01,01,  Bakharnagar,1231,2094,595,1035,636,1059,37.0,36.5,37.5,00000
68.0,64.0,94.0,979,02,01,  Ratanpur,562,1420,249,722,313,698,28.4,25.6,31.0,00000
68.0,64.0,94.0,979,03,01,  Gopalpur,353,487,174,211,179,276,42.0,45.2,39.3,00000
68.0,64.0,94.0,979,04,01,  Lochanpur,1229,2830,579,1386,650,1444,30.3,29.5,31.0,00000
68.0,64.0,94.0,979,05,01,  Shibpur,709,1165,350,595,359,570,37.8,37.0,38.6,00000
68.0,76.0,10.0,154,01,01,  Bangsirdia,1275,700,606,315,669,385,64.6,65.8,63.5,00000
68.0,76.0,10.0,154,02,01,  Aliabad,470,779,194,380,276,399,37.6,33.8,40.9,00000
68.0,76.0,10.0,154,03,01,  Ghagutia,886,959,401,454,485,505,48.0,46.9,49.0,00000
68.0,76.0,10.0,154,04,01,  Jangalia,266,383,114,191,152,192,41.0,37.4,44.2,00000
68.0,76.0,10.0,154,05,01,  Burburia,808,410,387,192,421,218,66.3,66.8,65.9,00000
68.0,76.0,10.0,154,06,01,  Shibpur Kand Para,208,222,97,98,111,124,48.4,49.7,47.2,00000
68.0,76.0,10.0,269,01,01,  Chandandia,661,295,313,146,348,149,69.1,68.2,70.0,00000
68.0,76.0,10.0,269,02,01,  Hizlia,440,703,200,346,240,357,38.5,36.6,40.2,00000
68.0,76.0,10.0,269,03,01,  Shankhola,643,890,279,429,364,461,41.9,39.4,44.1,00000
68.0,76.0,21.0,246,01,01,  Brahmandi,1359,1031,651,519,708,512,56.9,55.6,58.0,00000
68.0,76.0,21.0,246,02,01,  Barakandi,314,567,135,303,179,264,35.6,30.8,40.4,00000
68.0,76.0,21.0,246,03,01,  Kharakmara,383,577,199,281,184,296,39.9,41.5,38.3,00000
68.0,76.0,31.0,123,01,01,  Bailaba,1462,1388,678,611,784,777,51.3,52.6,50.2,00000
68.0,76.0,31.0,123,02,01,  Bhatgaon,385,318,184,149,201,169,54.8,55.3,54.3,00000
68.0,76.0,31.0,123,03,01,  Moharpara,444,401,206,175,238,226,52.5,54.1,51.3,00000
68.0,76.0,31.0,123,04,01,  Dopathar,581,635,242,299,339,336,47.8,44.7,50.2,00000
68.0,76.0,31.0,138,01,01,  Girda Para,314,142,158,62,156,80,68.9,71.8,66.1,00000
68.0,76.0,31.0,138,02,01,  Chandertek,558,379,269,176,289,203,59.6,60.4,58.7,00000
68.0,76.0,31.0,185,01,01,  Baraigaon,1418,996,703,484,715,512,58.7,59.2,58.3,00000
68.0,76.0,31.0,185,02,01,  Atardia,157,212,67,104,90,108,42.5,39.2,45.5,00000
68.0,76.0,42.0,046,01,01,  Shimulia,1958,1362,871,660,1087,702,59.0,56.9,60.8,00000
68.0,76.0,42.0,046,02,01,  Paratala,1094,629,496,304,598,325,63.5,62.0,64.8,00000
68.0,76.0,42.0,046,03,01,  Madhyanagar,466,430,189,214,277,216,52.0,46.9,56.2,00000
68.0,76.0,42.0,046,04,01,  Alinagar,866,869,399,424,467,445,49.9,48.5,51.2,00000
68.0,76.0,42.0,046,05,01,  Bilchinadi,199,200,98,115,101,85,49.9,46.0,54.3,00000
68.0,76.0,42.0,046,06,01,  Dargarbanda,1065,830,508,423,557,407,56.2,54.6,57.8,00000
68.0,76.0,42.0,046,07,01,  Bhitichinadi,506,524,244,262,262,262,49.1,48.2,50.0,00000
68.0,76.0,42.0,046,08,01,  Baher Char,20,5,8,3,12,2,80.0,72.7,85.7,00000
68.0,76.0,42.0,547,01,01,  Harankhola,275,283,126,120,149,163,49.3,51.2,47.8,00000
68.0,76.0,42.0,547,02,01,  Kazir Char,729,436,338,206,391,230,62.6,62.1,63.0,00000
68.0,76.0,52.0,023,01,01,  Agarpur,143,217,63,114,80,103,39.7,35.6,43.7,00000
68.0,76.0,52.0,023,02,01,  Makalla,228,93,118,36,110,57,71.0,76.6,65.9,00000
68.0,76.0,52.0,215,01,01,  Bhiti Khainkut,364,427,160,200,204,227,46.0,44.4,47.3,00000
68.0,76.0,52.0,215,02,01,  Dakshin Kamalpur,180,314,74,156,106,158,36.4,32.2,40.2,00000
68.0,76.0,52.0,316,01,01,  Chhutaband,1361,685,700,293,661,392,66.5,70.5,62.8,00000
68.0,76.0,52.0,316,02,01,  Lalkhartek,415,178,209,78,206,100,70.0,72.8,67.3,00000
68.0,76.0,52.0,316,03,01,  Kamartek,663,226,359,105,304,121,74.6,77.4,71.5,00000
68.0,76.0,52.0,316,04,01,  Chaitania,1449,403,722,193,727,210,78.2,78.9,77.6,00000
68.0,76.0,52.0,485,01,01,  Josar,1093,873,576,393,517,480,55.6,59.4,51.9,00000
68.0,76.0,52.0,485,02,01,  Chandertek,82,16,44,7,38,9,83.7,86.3,80.9,00000
68.0,76.0,52.0,485,03,01,  Uttar Agarpur,379,83,194,41,185,42,82.0,82.6,81.5,00000
68.0,76.0,52.0,485,04,01,  Sharifpur,382,170,186,96,196,74,69.2,66.0,72.6,00000
68.0,76.0,52.0,485,05,01,  Kulortek,163,109,88,41,75,68,59.9,68.2,52.4,00000
68.0,76.0,52.0,485,06,01,  Tongirtek,183,234,82,115,101,119,43.9,41.6,45.9,00000
68.0,76.0,52.0,485,07,01,  Purana Atashia,123,145,58,70,65,75,45.9,45.3,46.4,00000
68.0,76.0,52.0,485,08,01,  Amratali,92,48,53,25,39,23,65.7,67.9,62.9,00000
68.0,76.0,52.0,748,01,01,  Naoghata,903,924,464,434,439,490,49.4,51.7,47.3,00000
68.0,76.0,52.0,748,02,01,  Murgiber,705,533,322,252,383,281,56.9,56.1,57.7,00000
68.0,76.0,52.0,748,03,01,  Dabalertek,289,341,139,179,150,162,45.9,43.7,48.1,00000
68.0,76.0,52.0,940,01,01,  Sreeshti Ghar,1611,953,823,454,788,499,62.8,64.4,61.2,00000
68.0,76.0,52.0,940,02,01,  Bhangertek,549,368,299,199,250,169,59.9,60.0,59.7,00000
68.0,76.0,52.0,940,03,01,  Jankhartek,612,725,287,346,325,379,45.8,45.3,46.2,00000
68.0,76.0,52.0,940,04,01,  Atashia,262,181,156,95,106,86,59.1,62.2,55.2,00000
68.0,76.0,63.0,030,01,01,  Ajkitala,593,720,305,358,288,362,45.2,46.0,44.3,00000
68.0,76.0,63.0,030,02,01,  Joynagar,677,598,326,286,351,312,53.1,53.3,52.9,00000
68.0,76.0,63.0,030,03,01,  Chhota Banda,476,227,236,111,240,116,67.7,68.0,67.4,00000
68.0,76.0,63.0,030,04,01,  Bagh Mara,279,79,145,31,134,48,77.9,82.4,73.6,00000
68.0,76.0,63.0,030,05,01,  Joynagar Purba Para,990,445,482,207,508,238,69.0,70.0,68.1,00000
68.0,76.0,63.0,069,01,01,  Ashtani,355,279,190,123,165,156,56.0,60.7,51.4,00000
68.0,76.0,63.0,069,02,01,  Simarbagh,480,443,261,200,219,243,52.0,56.6,47.4,00000
68.0,76.0,63.0,069,03,01,  Daripura,992,1264,477,615,515,649,44.0,43.7,44.2,00000
68.0,76.0,63.0,069,04,01,  Joynagar,597,600,297,277,300,323,49.9,51.7,48.2,00000
68.0,76.0,63.0,401,01,01,  Gilaber,1421,377,693,166,728,211,79.0,80.7,77.5,00000
68.0,76.0,63.0,401,02,01,  Josar Para,323,263,191,126,132,137,55.1,60.3,49.1,00000
68.0,76.0,63.0,524,01,01,  Dhupirtek,508,463,236,235,272,228,52.3,50.1,54.4,00000
68.0,76.0,63.0,524,02,01,  Betagia,620,417,288,193,332,224,59.8,59.9,59.7,00000
68.0,76.0,63.0,524,03,01,  Dashpara,179,134,95,63,84,71,57.2,60.1,54.2,00000
68.0,76.0,63.0,524,04,01,  Jamghar,510,429,238,193,272,236,54.3,55.2,53.5,00000
68.0,76.0,63.0,524,05,01,  Jamira,109,163,61,67,48,96,40.1,47.7,33.3,00000
68.0,76.0,63.0,524,06,01,  Kandapara,284,402,143,194,141,208,41.4,42.4,40.4,00000
68.0,76.0,63.0,524,07,01,  Kamraba,345,400,167,180,178,220,46.3,48.1,44.7,00000
68.0,76.0,63.0,524,08,01,  Kamraba Purbapara,168,51,84,28,84,23,76.7,75.0,78.5,00000
68.0,76.0,63.0,524,09,01,  Noara,165,67,85,27,80,40,71.1,75.9,66.7,00000
68.0,76.0,63.0,524,10,01,  Palpara,339,339,163,164,176,175,50.0,49.8,50.1,00000
68.0,76.0,63.0,524,11,01,  Rishipara,99,240,47,106,52,134,29.2,30.7,28.0,00000
68.0,76.0,63.0,524,12,01,  Julartek,72,123,33,60,39,63,36.9,35.5,38.2,00000
68.0,76.0,63.0,524,13,01,  Sunarutola,194,124,100,58,94,66,61.0,63.3,58.8,00000
68.0,76.0,63.0,663,01,01,  Maishartek,213,74,109,23,104,51,74.2,82.6,67.1,00000
68.0,76.0,63.0,663,02,01,  Kumartek,294,163,137,68,157,95,64.3,66.8,62.3,00000
68.0,76.0,63.0,663,03,01,  Beramar,254,87,136,48,118,39,74.5,73.9,75.2,00000
68.0,76.0,63.0,771,01,01,  Dhanaia,382,622,197,305,185,317,38.0,39.2,36.9,00000
68.0,76.0,63.0,771,02,01,  Naoghata,627,504,315,246,312,258,55.4,56.1,54.7,00000
68.0,76.0,63.0,771,03,01,  Tekpara,228,240,109,126,119,114,48.7,46.4,51.1,00000
68.0,76.0,63.0,771,04,01,  Gazarmara,224,143,101,56,123,87,61.0,64.3,58.6,00000
68.0,76.0,63.0,956,01,01,  Sujatpur,653,504,348,238,305,266,56.4,59.4,53.4,00000
68.0,76.0,63.0,956,02,01,  Ashtani (Part),723,437,344,200,379,237,62.3,63.2,61.5,00000
68.0,76.0,73.0,347,01,01,  Ichhabnagar,322,183,149,77,173,106,63.8,65.9,62.0,00000
68.0,76.0,73.0,347,02,01,  Paschimpara,1141,897,526,425,615,472,56.0,55.3,56.6,00000
68.0,76.0,73.0,347,03,01,  Mirzakandi,481,614,222,288,259,326,43.9,43.5,44.3,00000
68.0,76.0,73.0,347,04,01,  Madhyapara,2066,1188,1062,579,1004,609,63.5,64.7,62.2,00000
68.0,76.0,73.0,347,05,01,  Chaugharia,1253,966,573,458,680,508,56.5,55.6,57.2,00000
68.0,76.0,73.0,347,06,01,  Telikanda,245,201,122,93,123,108,54.9,56.7,53.2,00000
68.0,76.0,73.0,347,07,01,  Bhiti Para,1159,1355,532,668,627,687,46.1,44.3,47.7,00000
68.0,76.0,84.0,509,01,01,  Kamargaon,2165,2328,1018,1121,1147,1207,48.2,47.6,48.7,00000
68.0,76.0,84.0,509,02,01,  Saidnagar,2764,1956,1438,954,1326,1002,58.6,60.1,57.0,00000
68.0,76.0,84.0,509,03,01,  Sherpur,722,817,403,442,319,375,46.9,47.7,46.0,00000
68.0,76.0,84.0,509,04,01,  Putia,315,266,160,120,155,146,54.2,57.1,51.5,00000
68.0,76.0,84.0,532,01,01,  Mamudpur,1778,1565,908,733,870,832,53.2,55.3,51.1,00000
68.0,76.0,84.0,532,02,01,  Sahapur,1055,765,500,335,555,430,58.0,59.9,56.3,00000
68.0,76.0,84.0,987,01,01,  Karimabad,675,372,319,157,356,215,64.5,67.0,62.3,00000
68.0,76.0,84.0,987,02,01,  Kashmahal,258,305,126,156,132,149,45.8,44.7,47.0,00000
68.0,76.0,84.0,987,03,01,  Madhya Karardi Char,904,243,607,104,297,139,78.8,85.4,68.1,00000
68.0,76.0,84.0,987,04,01,  Uttar Karardi Char,909,368,422,183,487,185,71.2,69.8,72.5,00000
68.0,76.0,94.0,871,01,01,  Sankardi,523,414,266,200,257,214,55.8,57.1,54.6,00000
68.0,76.0,94.0,871,02,01,  Tatarkandi,290,234,149,120,141,114,55.3,55.4,55.3,00000
33.0,30.0,23.0,463,01,01,  Itahata,3622,2937,2038,1429,1584,1508,55.2,58.8,51.2,00000
33.0,30.0,23.0,463,02,01,  Barbaika,3479,2724,2060,1266,1419,1458,56.1,61.9,49.3,00000
33.0,30.0,23.0,463,03,01,  Dighir Chala,4109,2713,2258,1360,1851,1353,60.2,62.4,57.8,00000
33.0,30.0,23.0,463,04,01,  Kadda Bazar,470,573,261,285,209,288,45.1,47.8,42.1,00000
33.0,30.0,23.0,463,05,01,  Lathibhanga,308,210,159,84,149,126,59.5,65.4,54.2,00000
33.0,30.0,23.0,463,06,01,  Goldighla Tek,465,228,276,113,189,115,67.1,71.0,62.2,00000
33.0,30.0,23.0,463,07,01,  Khoar Para,1048,417,619,190,429,227,71.5,76.5,65.4,00000
33.0,30.0,23.0,463,08,01,  Kanthalia Para,716,444,483,229,233,215,61.7,67.8,52.0,00000
33.0,30.0,23.0,463,09,01,  Gaylaypara,162,203,97,94,65,109,44.4,50.8,37.4,00000
33.0,30.0,23.0,751,01,01,  Naojuri,3311,2288,2086,1124,1225,1164,59.1,65.0,51.3,00000
33.0,30.0,23.0,751,02,01,  Kalakair,236,402,139,216,97,186,37.0,39.2,34.3,00000
33.0,30.0,23.0,814,01,01,  Paler Para,938,997,489,460,449,537,48.5,51.5,45.5,00000
33.0,30.0,23.0,814,02,01,  Mir Baher,276,207,144,98,132,109,57.1,59.5,54.8,00000
33.0,30.0,25.0,586,01,01,  Chhota Kayer,1705,766,892,353,813,413,69.0,71.6,66.3,00000
33.0,30.0,25.0,586,02,01,  Bara Kayer,2185,1266,1119,586,1066,680,63.3,65.6,61.1,00000
33.0,30.0,25.0,586,03,01,  Nalchhata,70,67,38,30,32,37,51.1,55.9,46.4,00000
33.0,30.0,31.0,349,01,01,  Gachha,1915,1190,1061,549,854,641,61.7,65.9,57.1,00000
33.0,30.0,31.0,349,02,01,  Aripara,209,219,112,102,97,117,48.8,52.3,45.3,00000
33.0,30.0,31.0,349,03,01,  Malipara,504,180,349,77,155,103,73.7,81.9,60.1,00000
33.0,30.0,31.0,349,04,01,  Rangamati,272,165,132,80,140,85,62.2,62.3,62.2,00000
33.0,30.0,31.0,593,01,01,  Kamarjuri,6914,3693,4121,1792,2793,1901,65.2,69.7,59.5,00000
33.0,30.0,31.0,628,01,01,  Uttar Khalikair,14733,5895,8778,2698,5955,3197,71.4,76.5,65.1,00000
33.0,30.0,31.0,628,02,01,  Dakshin Khalikair,19756,8826,11335,3982,8421,4844,69.1,74.0,63.5,00000
33.0,30.0,31.0,628,03,01,  Adarsha Gram,3653,1155,2284,544,1369,611,76.0,80.8,69.1,00000
33.0,30.0,47.0,280,01,01,  Latifpur,3910,2874,2158,1352,1752,1522,57.6,61.5,53.5,00000
33.0,30.0,47.0,280,02,01,  Tentuibari,2064,883,1293,397,771,486,70.0,76.5,61.3,00000
33.0,30.0,47.0,387,01,01,  Gobindabari,683,656,401,326,282,330,51.0,55.2,46.1,00000
33.0,30.0,47.0,387,02,01,  Hatimara,1531,1030,787,466,744,564,59.8,62.8,56.9,00000
33.0,30.0,47.0,387,03,01,  Enayetpur,5735,2133,3050,958,2685,1175,72.9,76.1,69.6,00000
33.0,30.0,47.0,387,04,01,  Dakshin Juran,1396,792,741,349,655,443,63.8,68.0,59.7,00000
33.0,30.0,47.0,387,05,01,  Sardaganj,8102,5544,4329,2607,3773,2937,59.4,62.4,56.2,00000
33.0,30.0,47.0,551,01,01,  Kasimpur,3492,1287,2032,612,1460,675,73.1,76.9,68.4,00000
33.0,30.0,47.0,551,02,01,  Naya Para,3685,1528,2226,678,1459,850,70.7,76.7,63.2,00000
33.0,30.0,47.0,551,03,01,  Nadirpar,1740,613,996,272,744,341,73.9,78.5,68.6,00000
33.0,30.0,47.0,873,01,01,  Saraba,5631,1853,3332,889,2299,964,75.2,78.9,70.5,00000
33.0,30.0,47.0,873,02,01,  Mosartek,560,229,375,112,185,117,71.0,77.0,61.3,00000
33.0,30.0,47.0,879,01,01,  Sarupaitali,401,803,217,393,184,410,33.3,35.6,31.0,00000
33.0,30.0,47.0,879,02,01,  Danjoykhali,456,581,255,296,201,285,44.0,46.3,41.4,00000
33.0,30.0,54.0,028,01,01,  Gazaria Para,4076,2065,2500,1048,1576,1017,66.4,70.5,60.8,00000
33.0,30.0,54.0,028,02,01,  Nanduail,1695,978,955,448,740,530,63.4,68.1,58.3,00000
33.0,30.0,54.0,028,03,01,  Kumarkhada,164,187,99,86,65,101,46.7,53.5,39.2,00000
33.0,30.0,54.0,028,04,01,  Bhauaraid,2648,1725,1600,824,1048,901,60.6,66.0,53.8,00000
33.0,30.0,54.0,028,05,01,  Jangalia Para,2157,1681,1164,773,993,908,56.2,60.1,52.2,00000
33.0,30.0,54.0,028,06,01,  Banagram,121,89,74,47,47,42,57.6,61.2,52.8,00000
33.0,30.0,54.0,073,01,01,  Bahadurpur,2350,1658,1299,747,1051,911,58.6,63.5,53.6,00000
33.0,30.0,54.0,073,02,01,  Tulsi Bhita,1979,1422,1130,692,849,730,58.2,62.0,53.8,00000
33.0,30.0,54.0,989,01,01,  Porabari,1268,919,717,393,551,526,58.0,64.6,51.2,00000
33.0,30.0,54.0,989,02,01,  Uttar Salna,2301,2069,1300,917,1001,1152,52.7,58.6,46.5,00000
33.0,30.0,60.0,070,01,01,  Ambagh,21468,15343,12496,8309,8972,7034,58.3,60.1,56.1,00000
33.0,30.0,60.0,070,02,01,  Kaler Bhita,854,850,464,386,390,464,50.1,54.6,45.7,00000
33.0,30.0,60.0,070,03,01,  Megh Lal,453,660,248,311,205,349,40.7,44.4,37.0,00000
33.0,30.0,60.0,070,04,01,  Baghia,1888,1288,1045,584,843,704,59.4,64.1,54.5,00000
33.0,30.0,60.0,070,05,01,  Baghia Nadirpar,215,255,117,114,98,141,45.7,50.6,41.0,00000
33.0,30.0,60.0,070,06,01,  Katlakhali,143,86,82,42,61,44,62.4,66.1,58.1,00000
33.0,30.0,60.0,070,07,01,  Rajabari,856,230,481,108,375,122,78.8,81.7,75.5,00000
33.0,30.0,60.0,076,01,01,  Baimail,24814,12895,13934,6526,10880,6369,65.8,68.1,63.1,00000
33.0,30.0,60.0,076,02,01,  Baimail Nadirpar,498,1425,288,860,210,565,25.9,25.1,27.1,00000
33.0,30.0,60.0,076,03,01,  Juran Chhonkhola(Majipara,16,19,9,9,7,10,45.7,50.0,41.2,00000
33.0,30.0,60.0,471,01,01,  Ahaki,272,333,140,147,132,186,45.0,48.8,41.5,00000
33.0,30.0,60.0,471,02,01,  Jayer Tek,941,774,527,351,414,423,54.9,60.0,49.5,00000
33.0,30.0,60.0,687,01,01,  Jarun,20677,6127,12159,2901,8518,3226,77.1,80.7,72.5,00000
33.0,30.0,60.0,687,02,01,  Harinachala,13914,5825,8153,2831,5761,2994,70.5,74.2,65.8,00000
33.0,30.0,60.0,687,03,01,  Deoliabari,13232,6601,9604,3775,3628,2826,66.7,71.8,56.2,00000
33.0,30.0,60.0,687,04,01,  Konabari,22723,4737,14574,2252,8149,2485,82.7,86.6,76.6,00000
33.0,30.0,67.0,107,01,01,  Nayanpur,9671,3116,5021,1488,4650,1628,75.6,77.1,74.1,00000
33.0,30.0,67.0,107,02,01,  Pingail,550,397,287,186,263,211,58.1,60.7,55.5,00000
33.0,30.0,67.0,107,03,01,  Chungarchala,90,199,49,97,41,102,31.1,33.6,28.7,00000
33.0,30.0,67.0,107,04,01,  Singratoli,324,420,157,194,167,226,43.5,44.7,42.5,00000
33.0,30.0,67.0,107,05,01,  Dargahchala,634,522,330,245,304,277,54.8,57.4,52.3,00000
33.0,30.0,67.0,107,06,01,  Naljani,507,441,236,218,271,223,53.5,52.0,54.9,00000
33.0,30.0,67.0,107,07,01,  Lutiarchala,458,369,236,166,222,203,55.4,58.7,52.2,00000
33.0,30.0,67.0,107,08,01,  Patpocha,233,161,118,74,115,87,59.1,61.5,56.9,00000
33.0,30.0,67.0,107,09,01,  Koraitoli,758,259,404,117,354,142,74.5,77.5,71.4,00000
33.0,30.0,67.0,107,10,01,  Rakhitpur,252,171,140,77,112,94,59.6,64.5,54.4,00000
33.0,30.0,67.0,107,11,01,  Ranipur,327,357,160,174,167,183,47.8,47.9,47.7,00000
33.0,30.0,67.0,107,12,01,  Janakail,524,201,254,87,270,114,72.3,74.5,70.3,00000
33.0,30.0,67.0,107,13,01,  Rodrapur,933,768,523,365,410,403,54.9,58.9,50.4,00000
33.0,30.0,67.0,107,14,01,  Haldoba,507,288,291,130,216,158,63.8,69.1,57.8,00000
33.0,30.0,67.0,107,15,01,  Rajendrapur Cantonment,2416,266,1816,105,600,161,90.1,94.5,78.8,00000
33.0,30.0,67.0,197,01,01,  Manipur,8093,3997,4789,1890,3304,2107,66.9,71.7,61.1,00000
33.0,30.0,67.0,197,02,01,  Naya Para,5067,3473,2997,1520,2070,1953,59.3,66.3,51.5,00000
33.0,30.0,67.0,293,01,01,  Purba Dagari,1704,1339,934,559,770,780,56.0,62.6,49.7,00000
33.0,30.0,67.0,293,02,01,  Paschim Dagari,1783,1479,1002,666,781,813,54.7,60.1,49.0,00000
33.0,30.0,67.0,293,03,01,  Naya Para,2250,1739,1325,820,925,919,56.4,61.8,50.2,00000
33.0,30.0,67.0,638,01,01,  Shibirchala,9218,4792,5242,2336,3976,2456,65.8,69.2,61.8,00000
33.0,30.0,67.0,638,02,01,  Baniarchala,8817,4299,4916,2033,3901,2266,67.2,70.7,63.3,00000
33.0,30.0,67.0,638,03,01,  Bhabanipur,7154,2904,4112,1418,3042,1486,71.1,74.4,67.2,00000
33.0,30.0,67.0,689,01,01,  Mirzapur,3431,3215,1982,1850,1449,1365,51.6,51.7,51.5,00000
33.0,30.0,67.0,689,02,01,  Kanjanol,2311,1782,1543,838,768,944,56.5,64.8,44.9,00000
33.0,30.0,67.0,831,01,01,  Sarkar Para,2098,1510,1052,655,1046,855,58.1,61.6,55.0,00000
33.0,30.0,67.0,831,02,01,  Madhya Para,1681,1457,859,641,822,816,53.6,57.3,50.2,00000
33.0,30.0,67.0,831,03,01,  Bortha Para,2176,1719,1143,753,1033,966,55.9,60.3,51.7,00000
33.0,30.0,67.0,831,04,01,  Uttarpara,558,1130,285,513,273,617,33.1,35.7,30.7,00000
33.0,30.0,67.0,831,05,01,  Nowla Para,884,791,448,339,436,452,52.8,56.9,49.1,00000
33.0,30.0,67.0,831,06,01,  Moyta Para,1060,1251,537,531,523,720,45.9,50.3,42.1,00000
33.0,30.0,81.0,180,01,01,  Bindan,968,474,511,234,457,240,67.1,68.6,65.6,00000
33.0,30.0,81.0,180,02,01,  Badurtala,252,227,121,117,131,110,52.6,50.8,54.4,00000
33.0,30.0,81.0,180,03,01,  Gojain,55,64,29,30,26,34,46.2,49.2,43.3,00000
33.0,30.0,81.0,203,01,01,  Boran,139,134,73,59,66,75,50.9,55.3,46.8,00000
33.0,30.0,81.0,203,02,01,  Patak Tek,242,177,135,95,107,82,57.8,58.7,56.6,00000
33.0,30.0,81.0,356,01,01,  Dhopa Para,289,203,144,94,145,109,58.7,60.5,57.1,00000
33.0,30.0,81.0,356,02,01,  Baunir Tek,285,85,162,34,123,51,77.0,82.7,70.7,00000
33.0,30.0,81.0,412,01,01,  Harbaid,92,180,51,91,41,89,33.8,35.9,31.5,00000
33.0,30.0,81.0,412,02,01,  Kodalia,186,222,107,111,79,111,45.6,49.1,41.6,00000
33.0,30.0,81.0,412,03,01,  Mathalia,318,86,168,36,150,50,78.7,82.4,75.0,00000
33.0,30.0,81.0,582,01,01,  Khilgaon,1102,836,581,432,521,404,56.9,57.4,56.3,00000
33.0,30.0,81.0,582,02,01,  Kumaria,249,173,134,85,115,88,59.0,61.2,56.7,00000
33.0,30.0,81.0,836,01,01,  Pubail,619,142,339,62,280,80,81.3,84.5,77.8,00000
33.0,30.0,81.0,836,02,01,  Nayani Para,2195,1105,1117,504,1078,601,66.5,68.9,64.2,00000
33.0,30.0,81.0,836,03,01,  Bara Dhal,458,79,244,29,214,50,85.3,89.4,81.1,00000
33.0,30.0,81.0,836,04,01,  Haribari Tek,593,281,340,138,253,143,67.8,71.1,63.9,00000
33.0,30.0,81.0,836,05,01,  Demati,94,118,47,58,47,60,44.3,44.8,43.9,00000
33.0,30.0,81.0,836,06,01,  Sapmara,280,86,143,36,137,50,76.5,79.9,73.3,00000
33.0,30.0,81.0,910,01,01,  Sorul,512,312,275,137,237,175,62.1,66.7,57.5,00000
33.0,30.0,81.0,910,02,01,  Baroibari,447,105,250,51,197,54,81.0,83.1,78.5,00000
33.0,32.0,13.0,442,01,01,  Gosatra,1006,591,503,258,503,333,63.0,66.1,60.2,00000
33.0,32.0,13.0,442,02,01,  Chowdhury Tek,422,79,207,25,215,54,84.2,89.2,79.9,00000
33.0,32.0,19.0,210,01,01,  Berachala,142,197,72,88,70,109,41.9,45.0,39.1,00000
33.0,32.0,19.0,210,02,01,  Shimulchala,136,299,71,144,65,155,31.3,33.0,29.5,00000
33.0,32.0,19.0,265,01,01,  Boali,702,688,367,318,335,370,50.5,53.6,47.5,00000
33.0,32.0,19.0,265,02,01,  Nanderchala,120,153,63,78,57,75,44.0,44.7,43.2,00000
33.0,32.0,19.0,265,03,01,  Sikdarchala,141,125,76,52,65,73,53.0,59.4,47.1,00000
33.0,32.0,19.0,265,04,01,  Kapasia Chala,70,92,39,35,31,57,43.2,52.7,35.2,00000
33.0,32.0,19.0,353,01,01,  Kundaghata,372,280,199,132,173,148,57.1,60.1,53.9,00000
33.0,32.0,19.0,353,02,01,  Dakurail,418,101,218,36,200,65,80.5,85.8,75.5,00000
33.0,32.0,19.0,353,03,01,  Dhoal Samudra,440,153,236,57,204,96,74.2,80.5,68.0,00000
33.0,32.0,19.0,431,01,01,  Golaia,331,347,183,132,148,215,48.8,58.1,40.8,00000
33.0,32.0,19.0,431,02,01,  Madankhali,212,200,103,92,109,108,51.5,52.8,50.2,00000
33.0,32.0,19.0,596,01,01,  Raghunathpur,204,149,124,60,80,89,57.8,67.4,47.3,00000
33.0,32.0,19.0,596,02,01,  Sreepur,545,726,304,326,241,400,42.9,48.3,37.6,00000
33.0,32.0,19.0,596,03,01,  Madhyapara,168,234,109,100,59,134,41.8,52.2,30.6,00000
33.0,32.0,19.0,596,04,01,  Gaburiachala,664,768,339,392,325,376,46.4,46.4,46.4,00000
33.0,32.0,19.0,596,05,01,  Dhopadhara,153,303,78,149,75,154,33.6,34.4,32.8,00000
33.0,32.0,19.0,596,06,01,  Gachhbari,840,716,439,303,401,413,54.0,59.2,49.3,00000
33.0,32.0,19.0,596,07,01,  Bathenachala,63,86,33,32,30,54,42.3,50.8,35.7,00000
33.0,32.0,19.0,674,01,01,  Nandichala,78,86,44,40,34,46,47.6,52.4,42.5,00000
33.0,32.0,19.0,674,02,01,  Talgachhiachala,170,75,93,27,77,48,69.4,77.5,61.6,00000
33.0,32.0,19.0,674,03,01,  Kapasiachala,271,154,157,64,114,90,63.8,71.0,55.9,00000
33.0,32.0,19.0,674,04,01,  Gabchala,214,209,106,93,108,116,50.6,53.3,48.2,00000
33.0,32.0,19.0,862,01,01,  Sonatala,761,583,403,244,358,339,56.6,62.3,51.4,00000
33.0,32.0,19.0,862,02,01,  Chabagan,364,416,182,184,182,232,46.7,49.7,44.0,00000
33.0,32.0,19.0,862,03,01,  Jhingahati,428,456,238,207,190,249,48.4,53.5,43.3,00000
33.0,32.0,19.0,862,04,01,  Naya Para,474,599,236,279,238,320,44.2,45.8,42.7,00000
33.0,32.0,19.0,862,05,01,  Karaitali,189,188,105,87,84,101,50.1,54.7,45.4,00000
33.0,32.0,47.0,508,01,01,  Jathila,789,1172,426,519,363,653,40.2,45.1,35.7,00000
33.0,32.0,47.0,508,02,01,  Mazidchala,289,423,155,196,134,227,40.6,44.2,37.1,00000
33.0,32.0,47.0,508,03,01,  Amtail,178,299,96,133,82,166,37.3,41.9,33.1,00000
33.0,32.0,47.0,508,04,01,  Barachala,224,290,112,128,112,162,43.6,46.7,40.9,00000
33.0,32.0,47.0,508,05,01,  Bagair,370,367,179,149,191,218,50.2,54.6,46.7,00000
33.0,32.0,47.0,508,06,01,  Amgachhachala,85,84,45,41,40,43,50.3,52.3,48.2,00000
33.0,32.0,47.0,569,01,01,  Khalishajani,701,739,377,316,324,423,48.7,54.4,43.4,00000
33.0,32.0,47.0,569,02,01,  Ramchandrapur,576,837,330,349,246,488,40.8,48.6,33.5,00000
33.0,32.0,47.0,569,03,01,  Kenduar Baid,250,383,148,211,102,172,39.5,41.2,37.2,00000
33.0,32.0,47.0,569,04,01,  Sirajpur,191,141,101,72,90,69,57.5,58.4,56.6,00000
33.0,32.0,47.0,569,05,01,  Kathachora,779,848,399,388,380,460,47.9,50.7,45.2,00000
33.0,32.0,47.0,569,06,01,  Baheratali,692,785,355,337,337,448,46.9,51.3,42.9,00000
33.0,32.0,47.0,619,01,01,  Mantala,457,721,218,328,239,393,38.8,39.9,37.8,00000
33.0,32.0,47.0,619,02,01,  Pubachala,609,652,306,279,303,373,48.3,52.3,44.8,00000
33.0,32.0,47.0,646,01,01,  Mothajuri,315,655,163,287,152,368,32.5,36.2,29.2,00000
33.0,32.0,47.0,646,02,01,  Gayenchala,154,239,82,112,72,127,39.2,42.3,36.2,00000
33.0,32.0,47.0,646,03,01,  Salonga,267,787,130,365,137,422,25.3,26.3,24.5,00000
33.0,32.0,47.0,646,04,01,  Talchala,283,645,148,291,135,354,30.5,33.7,27.6,00000
33.0,32.0,47.0,646,05,01,  Phida Para,380,599,200,289,180,310,38.8,40.9,36.7,00000
33.0,32.0,47.0,646,06,01,  Bakchala,201,342,105,150,96,192,37.0,41.2,33.3,00000
33.0,32.0,47.0,646,07,01,  Khil Para,234,449,120,202,114,247,34.3,37.3,31.6,00000
33.0,32.0,47.0,646,08,01,  Motha Para,245,132,115,70,130,62,65.0,62.2,67.7,00000
33.0,32.0,47.0,646,09,01,  Saldaha Para,261,377,133,165,128,212,40.9,44.6,37.6,00000
33.0,32.0,47.0,646,10,01,  Pingabaha,109,201,60,84,49,117,35.2,41.7,29.5,00000
33.0,32.0,47.0,646,11,01,  Kachighata,493,436,256,188,237,248,53.1,57.7,48.9,00000
33.0,32.0,47.0,646,12,01,  Uttar Fulbaria Para,632,820,346,367,286,453,43.5,48.5,38.7,00000
33.0,32.0,47.0,646,13,01,  Fulbaria Bazar,294,114,180,64,114,50,72.1,73.8,69.5,00000
33.0,32.0,47.0,646,14,01,  Purba Fulbari Para,495,478,283,218,212,260,50.9,56.5,44.9,00000
33.0,32.0,47.0,646,15,01,  Dakshin Fulbaria Para,481,528,242,244,239,284,47.7,49.8,45.7,00000
33.0,32.0,47.0,646,16,01,  Karichala,192,535,92,255,100,280,26.4,26.5,26.3,00000
33.0,32.0,47.0,646,17,01,  Rampur,153,159,79,73,74,86,49.0,52.0,46.3,00000
33.0,32.0,47.0,646,18,01,  Naya Para,28,78,16,38,12,40,26.4,29.6,23.1,00000
33.0,32.0,47.0,646,19,01,  Bagarpur,147,240,61,110,86,130,38.0,35.7,39.8,00000
33.0,32.0,47.0,994,01,01,  Uttar Shimulia,397,499,213,211,184,288,44.3,50.2,39.0,00000
33.0,32.0,47.0,994,02,01,  Janpara,150,274,84,122,66,152,35.4,40.8,30.3,00000
33.0,32.0,47.0,994,03,01,  Kombal Para,293,289,163,110,130,179,50.3,59.7,42.1,00000
33.0,32.0,47.0,994,04,01,  Sindukchala,34,101,19,49,15,52,25.2,27.9,22.4,00000
33.0,32.0,57.0,403,01,01,  Sailakhali,300,123,163,45,137,78,70.9,78.4,63.7,00000
33.0,32.0,57.0,403,02,01,  Galachipa,322,298,171,132,151,166,51.9,56.4,47.6,00000
33.0,32.0,57.0,403,03,01,  Berichala,113,45,64,11,49,34,71.5,85.3,59.0,00000
33.0,32.0,57.0,403,04,01,  Baharia Chala,334,193,185,75,149,118,63.4,71.2,55.8,00000
33.0,32.0,57.0,403,05,01,  Sejab,98,80,54,29,44,51,55.1,65.1,46.3,00000
33.0,32.0,57.0,580,01,01,  Kusulnath,123,94,62,44,61,50,56.7,58.5,55.0,00000
33.0,32.0,57.0,580,02,01,  Kuarchala,435,493,236,244,199,249,46.9,49.2,44.4,00000
33.0,32.0,57.0,580,03,01,  Busbari,21,33,10,16,11,17,38.9,38.5,39.3,00000
33.0,32.0,57.0,580,04,01,  Kathaltali,209,129,120,51,89,78,61.8,70.2,53.3,00000
33.0,32.0,57.0,602,01,01,  Purba Barachala,226,159,116,76,110,83,58.7,60.4,57.0,00000
33.0,32.0,57.0,602,02,01,  Palashtali,558,304,297,127,261,177,64.7,70.0,59.6,00000
33.0,32.0,57.0,602,03,01,  Jamalpur,362,196,238,89,124,107,64.9,72.8,53.7,00000
33.0,32.0,57.0,602,04,01,  Duanai Chala,277,145,168,72,109,73,65.6,70.0,59.9,00000
33.0,32.0,57.0,602,05,01,  Durgapur,392,292,225,140,167,152,57.3,61.6,52.4,00000
33.0,32.0,57.0,602,06,01,  Fakirchala,217,160,122,77,95,83,57.6,61.3,53.4,00000
33.0,32.0,57.0,602,07,01,  Thengar Band,1140,927,626,434,514,493,55.2,59.1,51.0,00000
33.0,32.0,57.0,834,01,01,  Solahati,446,66,232,25,214,41,87.1,90.3,83.9,00000
33.0,32.0,57.0,834,02,01,  Chotalsolahati,87,60,49,25,38,35,59.2,66.2,52.1,00000
33.0,32.0,57.0,834,03,01,  Amdair,623,528,341,241,282,287,54.1,58.6,49.6,00000
33.0,32.0,57.0,834,04,01,  Haturiachala,1075,814,583,338,492,476,56.9,63.3,50.8,00000
33.0,32.0,57.0,834,05,01,  Aliar Chala,394,473,195,204,199,269,45.4,48.9,42.5,00000
33.0,32.0,57.0,834,06,01,  Gobindapur,398,412,213,185,185,227,49.1,53.5,44.9,00000
33.0,32.0,57.0,834,07,01,  Tanar Chala,140,75,72,29,68,46,65.1,71.3,59.6,00000
33.0,32.0,57.0,917,01,01,  Akulichala,66,65,36,34,30,31,50.4,51.4,49.2,00000
33.0,32.0,57.0,917,02,01,  Muradpur,758,774,415,362,343,412,49.5,53.4,45.4,00000
33.0,32.0,57.0,917,03,01,  Howriachala,357,256,195,115,162,141,58.2,62.9,53.5,00000
33.0,32.0,57.0,917,04,01,  Nakchala,214,357,112,171,102,186,37.5,39.6,35.4,00000
33.0,32.0,57.0,917,05,01,  Thakur Para,539,276,287,116,252,160,66.1,71.2,61.2,00000
33.0,32.0,57.0,917,06,01,  Jaluavita,437,507,241,232,196,275,46.3,51.0,41.6,00000
33.0,32.0,57.0,967,01,01,  Barachala,223,209,124,94,99,115,51.6,56.9,46.3,00000
33.0,32.0,57.0,967,02,01,  Zenji Chala,689,549,367,256,322,293,55.7,58.9,52.4,00000
33.0,32.0,57.0,967,03,01,  Laskarchala,182,315,98,149,84,166,36.6,39.7,33.6,00000
33.0,32.0,57.0,967,04,01,  Rayerchala,229,267,129,119,100,148,46.2,52.0,40.3,00000
33.0,32.0,57.0,967,05,01,  Kamarchala,126,82,65,34,61,48,60.6,65.7,56.0,00000
33.0,32.0,57.0,967,06,01,  Senchala,60,59,32,25,28,34,50.4,56.1,45.2,00000
33.0,32.0,57.0,967,07,01,  Naichala,104,103,55,45,49,58,50.2,55.0,45.8,00000
33.0,32.0,57.0,967,08,01,  Madhya Para,160,111,80,51,80,60,59.0,61.1,57.1,00000
33.0,32.0,66.0,121,01,01,  Banshtali,472,518,277,229,195,289,47.7,54.7,40.3,00000
33.0,32.0,66.0,121,02,01,  Muzud Banshtali,246,182,131,82,115,100,57.5,61.5,53.5,00000
33.0,32.0,66.0,149,01,01,  Baraba,2314,1234,1275,583,1039,651,65.2,68.6,61.5,00000
33.0,32.0,66.0,149,02,01,  Suyapur,742,692,374,312,368,380,51.7,54.5,49.2,00000
33.0,32.0,66.0,149,03,01,  Madhabchala,313,184,174,82,139,102,63.0,68.0,57.7,00000
33.0,32.0,66.0,215,01,01,  Bhannara,2239,870,1145,380,1094,490,72.0,75.1,69.1,00000
33.0,32.0,66.0,215,02,01,  Dhopachala,665,364,349,150,316,214,64.6,69.9,59.6,00000
33.0,32.0,66.0,215,03,01,  Kathuriachala,473,248,238,117,235,131,65.6,67.0,64.2,00000
33.0,32.0,66.0,215,04,01,  Porachala,395,240,193,119,202,121,62.2,61.9,62.5,00000
33.0,32.0,66.0,563,01,01,  Kauchakuri,243,158,136,74,107,84,60.6,64.8,56.0,00000
33.0,32.0,66.0,563,02,01,  Kubjarchala,387,219,210,99,177,120,63.9,68.0,59.6,00000
33.0,32.0,66.0,563,03,01,  Atramchala,182,111,103,47,79,64,62.1,68.7,55.2,00000
33.0,32.0,66.0,563,04,01,  Kainara,2484,1155,1276,543,1208,612,68.3,70.1,66.4,00000
33.0,32.0,66.0,563,05,01,  Bamanbagh,237,215,121,94,116,121,52.4,56.3,48.9,00000
33.0,32.0,66.0,563,06,01,  Mouchak & Novuarbagh,10954,4716,6546,2188,4408,2528,69.9,74.9,63.6,00000
33.0,32.0,66.0,563,07,01,  Nischintapur,2256,1231,1402,629,854,602,64.7,69.0,58.7,00000
33.0,32.0,66.0,563,08,01,  Kalabhanda,2184,2214,1144,988,1040,1226,49.7,53.7,45.9,00000
33.0,32.0,66.0,563,09,01,  Kamrangachala,2925,1327,1598,616,1327,711,68.8,72.2,65.1,00000
33.0,32.0,66.0,563,10,01,  Sadarchala,724,734,405,339,319,395,49.7,54.4,44.7,00000
33.0,32.0,66.0,563,11,01,  Telerchala,5638,2924,3218,1381,2420,1543,65.8,70.0,61.1,00000
33.0,32.0,66.0,563,12,01,  Rakhaliarchala,3436,3476,1778,1632,1658,1844,49.7,52.1,47.3,00000
33.0,32.0,66.0,563,13,01,  Nali Para,57,88,28,40,29,48,39.3,41.2,37.7,00000
33.0,32.0,66.0,563,14,01,  Jogirchala,1550,937,906,431,644,506,62.3,67.8,56.0,00000
33.0,32.0,66.0,563,15,01,  Andhar Manik,385,283,193,131,192,152,57.6,59.6,55.8,00000
33.0,32.0,66.0,613,01,01,  Majhukhan,252,258,148,117,104,141,49.4,55.8,42.4,00000
33.0,32.0,66.0,613,02,01,  Hazarichala,913,572,492,234,421,338,61.5,67.8,55.5,00000
33.0,32.0,66.0,613,03,01,  Barachanchala,419,187,227,73,192,114,69.1,75.7,62.7,00000
33.0,32.0,66.0,613,04,01,  Fulchala,286,148,159,63,127,85,65.9,71.6,59.9,00000
33.0,32.0,66.0,795,01,01,  Sahebabad,828,303,448,104,380,199,73.2,81.2,65.6,00000
33.0,32.0,66.0,795,02,01,  Bairagirchala,131,92,72,42,59,50,58.7,63.2,54.1,00000
33.0,34.0,15.0,178,01,01,  Betua,385,525,200,261,185,264,42.3,43.4,41.2,00000
33.0,34.0,15.0,178,02,01,  Chaygati,570,409,276,219,294,190,58.2,55.8,60.7,00000
33.0,34.0,15.0,614,01,01,  Khalapara,1611,903,829,429,782,474,64.1,65.9,62.3,00000
33.0,34.0,15.0,614,02,01,  Kakab,851,338,441,155,410,183,71.6,74.0,69.1,00000
33.0,34.0,15.0,614,03,01,  Char Para,870,436,448,201,422,235,66.6,69.0,64.2,00000
33.0,34.0,15.0,614,04,01,  Sonachora,697,303,368,157,329,146,69.7,70.1,69.3,00000
33.0,34.0,17.0,916,01,01,  Satani Para,872,420,398,202,474,218,67.5,66.3,68.5,00000
33.0,34.0,17.0,916,02,01,  Paschim Satani Para,368,81,164,35,204,46,82.0,82.4,81.6,00000
33.0,34.0,60.0,491,01,01,  Jamalpur,6866,4258,3476,2134,3390,2124,61.7,62.0,61.5,00000
33.0,34.0,60.0,491,02,01,  Mendipur,587,381,292,189,295,192,60.6,60.7,60.6,00000
33.0,34.0,96.0,103,01,01,  Bhashabhashi,296,313,153,153,143,160,48.6,50.0,47.2,00000
33.0,34.0,96.0,103,02,01,  Barakaw,698,424,367,201,331,223,62.2,64.6,59.7,00000
33.0,34.0,96.0,103,03,01,  Kalikuti,164,225,87,108,77,117,42.2,44.6,39.7,00000
33.0,34.0,96.0,220,01,01,  Birua,169,109,93,45,76,64,60.8,67.4,54.3,00000
33.0,34.0,96.0,220,02,01,  Nalchata,78,40,46,14,32,26,66.1,76.7,55.2,00000
33.0,34.0,96.0,535,01,01,  Ketun,441,185,240,91,201,94,70.4,72.5,68.1,00000
33.0,34.0,96.0,535,02,01,  Mirer Tek,123,65,61,37,62,28,65.4,62.2,68.9,00000
33.0,34.0,96.0,633,01,01,  Mathbari,278,130,135,67,143,63,68.1,66.8,69.4,00000
33.0,34.0,96.0,633,02,01,  Baghbari,246,93,125,46,121,47,72.6,73.1,72.0,00000
33.0,34.0,96.0,633,03,01,  Malla,221,52,98,24,123,28,81.0,80.3,81.5,00000
33.0,34.0,96.0,633,04,01,  Tahurdia,308,156,170,72,138,84,66.4,70.2,62.2,00000
33.0,34.0,96.0,633,05,01,  Mathail,99,81,49,43,50,38,55.0,53.3,56.8,00000
33.0,34.0,96.0,633,06,01,  Hatkhola,131,121,70,57,61,64,52.0,55.1,48.8,00000
33.0,34.0,96.0,633,07,01,  Bara Dahindi,423,168,230,76,193,92,71.6,75.2,67.7,00000
33.0,34.0,96.0,633,08,01,  Kalun,134,50,57,27,77,23,72.8,67.9,77.0,00000
33.0,34.0,96.0,633,09,01,  Chhota Dahindi,229,75,113,35,116,40,75.3,76.4,74.4,00000
33.0,34.0,96.0,685,01,01,  Nagari,474,37,304,17,170,20,92.8,94.7,89.5,00000
33.0,34.0,96.0,685,02,01,  Bhururia,756,152,364,75,392,77,83.3,82.9,83.6,00000
33.0,34.0,96.0,736,01,01,  Dakshin Panjora,1341,1058,655,514,686,544,55.9,56.0,55.8,00000
33.0,34.0,96.0,736,02,01,  Madhya Panjora,657,509,330,235,327,274,56.3,58.4,54.4,00000
33.0,34.0,96.0,736,03,01,  Sukpara,219,297,98,137,121,160,42.4,41.7,43.1,00000
33.0,34.0,96.0,736,04,01,  Banik Para,491,125,231,77,260,48,79.7,75.0,84.4,00000
33.0,34.0,96.0,736,05,01,  Bhashani,421,211,181,113,240,98,66.6,61.6,71.0,00000
33.0,34.0,96.0,736,06,01,  Chankhola,126,92,63,50,63,42,57.8,55.8,60.0,00000
33.0,34.0,96.0,736,07,01,  Kumar Para,226,136,105,71,121,65,62.4,59.7,65.1,00000
33.0,34.0,96.0,779,01,01,  Pipulia,756,408,419,191,337,217,64.9,68.7,60.8,00000
33.0,34.0,96.0,779,02,01,  Kakalia,12,126,7,61,5,65,8.7,10.3,7.1,00000
33.0,34.0,96.0,807,01,01,  Rathura,642,426,332,218,310,208,60.1,60.4,59.8,00000
33.0,34.0,96.0,807,02,01,  Belun,199,98,102,41,97,57,67.0,71.3,63.0,00000
33.0,34.0,96.0,807,03,01,  Kutarati,69,48,34,26,35,22,59.0,56.7,61.4,00000
33.0,34.0,96.0,896,01,01,  Talia,272,274,134,158,138,116,49.8,45.9,54.3,00000
33.0,34.0,96.0,896,02,01,  Karaihati,79,22,45,11,34,11,78.2,80.4,75.6,00000
33.0,34.0,96.0,985,01,01,  Ulukhola,418,207,208,108,210,99,66.9,65.8,68.0,00000
33.0,34.0,96.0,985,02,01,  Bashbari,81,58,43,27,38,31,58.3,61.4,55.1,00000
33.0,34.0,97.0,032,01,01,  Boaliar Tek,81,8,41,3,40,5,91.0,93.2,88.9,00000
33.0,34.0,97.0,032,02,01,  Ara Bandakhola,572,231,278,105,294,126,71.2,72.6,70.0,00000
33.0,34.0,97.0,032,03,01,  Puinnar Tek,256,131,124,65,132,66,66.1,65.6,66.7,00000
33.0,34.0,97.0,084,01,01,  Bandakhola,674,390,369,192,305,198,63.3,65.8,60.6,00000
33.0,34.0,97.0,084,02,01,  Dari Para,809,183,353,101,456,82,81.6,77.8,84.8,00000
33.0,34.0,97.0,084,03,01,  Madhabnagar,145,64,72,28,73,36,69.4,72.0,67.0,00000
33.0,34.0,97.0,084,04,01,  Kachurir Tek,18,7,8,5,10,2,72.0,61.5,83.3,00000
33.0,34.0,97.0,084,05,01,  Tiler Tek,78,78,48,40,30,38,50.0,54.5,44.1,00000
33.0,34.0,97.0,276,01,01,  Sanaiya,187,121,89,49,98,72,60.7,64.5,57.6,00000
33.0,34.0,97.0,276,02,01,  Bariakhali,74,37,36,14,38,23,66.7,72.0,62.3,00000
33.0,34.0,97.0,276,03,01,  Charerkhola,371,71,166,32,205,39,83.9,83.8,84.0,00000
33.0,34.0,97.0,281,01,01,  Chuariakhola(Uttar),880,731,438,367,442,364,54.6,54.4,54.8,00000
33.0,34.0,97.0,281,02,01,  Chuariakhola(Dakshin),2278,1288,1100,601,1178,687,63.9,64.7,63.2,00000
33.0,34.0,97.0,281,03,01,  Joyramber,281,145,117,81,164,64,66.0,59.1,71.9,00000
33.0,34.0,97.0,281,04,01,  Rangamatia,513,205,242,103,271,102,71.4,70.1,72.7,00000
33.0,34.0,97.0,281,05,01,  Dari Para,466,89,222,50,244,39,84.0,81.6,86.2,00000
33.0,34.0,97.0,877,01,01,  Uttar Som,1188,686,637,307,551,379,63.4,67.5,59.2,00000
33.0,34.0,97.0,877,02,01,  Dakshin Som,870,401,426,195,444,206,68.5,68.6,68.3,00000
33.0,36.0,13.0,138,01,01,  Barishaba,438,529,193,263,245,266,45.3,42.3,47.9,00000
33.0,36.0,13.0,138,02,01,  Banarkandi,618,699,259,341,359,358,46.9,43.2,50.1,00000
33.0,36.0,13.0,138,03,01,  Pingali,115,136,42,75,73,61,45.8,35.9,54.5,00000
33.0,36.0,13.0,138,04,01,  Chowkerchala,287,271,124,130,163,141,51.4,48.8,53.6,00000
33.0,36.0,13.0,186,01,01,  Bhikar Tek,325,411,134,202,191,209,44.2,39.9,47.8,00000
33.0,36.0,13.0,186,02,01,  Bagra,181,212,78,106,103,106,46.1,42.4,49.3,00000
33.0,36.0,13.0,337,01,01,  Daora,359,342,174,163,185,179,51.2,51.6,50.8,00000
33.0,36.0,13.0,337,02,01,  Banor Haola,623,539,283,270,340,269,53.6,51.2,55.8,00000
33.0,36.0,13.0,434,01,01,  Gaorar,912,1344,454,646,458,698,40.4,41.3,39.6,00000
33.0,36.0,13.0,434,02,01,  Bherarchala,670,731,328,350,342,381,47.8,48.4,47.3,00000
33.0,36.0,13.0,434,03,01,  Babirchala,169,278,79,137,90,141,37.8,36.6,39.0,00000
33.0,36.0,13.0,615,01,01,  Kirtania,471,677,208,320,263,357,41.0,39.4,42.4,00000
33.0,36.0,13.0,615,02,01,  Poirabo,450,358,206,184,244,174,55.7,52.8,58.4,00000
33.0,36.0,13.0,651,01,01,  Lohadia,1678,1216,800,564,878,652,58.0,58.7,57.4,00000
33.0,36.0,13.0,651,02,01,  Narsingpur,568,812,284,391,284,421,41.2,42.1,40.3,00000
33.0,36.0,13.0,651,03,01,  Durlabhpur,232,207,98,97,134,110,52.8,50.3,54.9,00000
33.0,36.0,13.0,717,01,01,  Narottampur,450,570,199,277,251,293,44.1,41.8,46.1,00000
33.0,36.0,13.0,717,02,01,  Batna,454,395,225,202,229,193,53.5,52.7,54.3,00000
33.0,36.0,13.0,717,03,01,  Rajabari,154,127,74,58,80,69,54.8,56.1,53.7,00000
33.0,36.0,13.0,735,01,01,  Nayanagar,813,627,414,276,399,351,56.5,60.0,53.2,00000
33.0,36.0,13.0,735,02,01,  Damuarchala,367,452,176,214,191,238,44.8,45.1,44.5,00000
33.0,36.0,17.0,627,01,01,  Kot Bajalia,648,567,299,292,349,275,53.3,50.6,55.9,00000
33.0,36.0,17.0,627,02,01,  Barpushia,508,580,237,290,271,290,46.7,45.0,48.3,00000
33.0,36.0,17.0,627,03,01,  Bhat Para,218,45,113,23,105,22,82.9,83.1,82.7,00000
33.0,36.0,25.0,361,01,01,  Daulgaon (Khilgaon),703,443,317,230,386,213,61.3,58.0,64.4,00000
33.0,36.0,25.0,361,02,01,  Rupduiar Tek,225,110,106,52,119,58,67.2,67.1,67.2,00000
33.0,36.0,25.0,476,01,01,  Gosaingaon,690,602,315,291,375,311,53.4,52.0,54.7,00000
33.0,36.0,25.0,476,02,01,  Raniganj Bazar,41,20,22,9,19,11,67.2,71.0,63.3,00000
33.0,36.0,25.0,820,01,01,  Raonat,1596,1149,768,529,828,620,58.1,59.2,57.2,00000
33.0,36.0,25.0,820,02,01,  Doaipathuri,377,359,171,175,206,184,51.2,49.4,52.8,00000
33.0,36.0,25.0,820,03,01,  Tekmerun,152,120,67,62,85,58,55.9,51.9,59.4,00000
33.0,36.0,34.0,066,01,01,  Bagua,916,890,451,424,465,466,50.7,51.5,49.9,00000
33.0,36.0,34.0,066,02,01,  Singua,779,973,365,491,414,482,44.5,42.6,46.2,00000
33.0,36.0,43.0,578,01,03,  Kapasia,1716,1911,889,958,827,953,47.3,48.1,46.5,00000
33.0,36.0,43.0,578,02,03,  Baratek,401,355,193,180,208,175,53.0,51.7,54.3,00000
33.0,36.0,43.0,928,01,01,  Surjya Narayanpur,1989,1785,876,766,1113,1019,52.7,53.3,52.2,00000
33.0,36.0,43.0,928,02,01,  Bhubanerchala,541,480,255,221,286,259,53.0,53.6,52.5,00000
33.0,36.0,51.0,428,01,01,  Paschimpara,776,441,366,208,410,233,63.8,63.8,63.8,00000
33.0,36.0,51.0,428,02,01,  Purbapara,998,678,451,323,547,355,59.5,58.3,60.6,00000
33.0,36.0,51.0,428,03,01,  Char Khamar,920,459,442,213,478,246,66.7,67.5,66.0,00000
33.0,36.0,51.0,584,01,01,  Karihata,1041,1027,462,493,579,534,50.3,48.4,52.0,00000
33.0,36.0,51.0,584,02,01,  Bagunhati,288,345,129,165,159,180,45.5,43.9,46.9,00000
33.0,36.0,51.0,584,03,01,  Sreepur,158,64,83,21,75,43,71.2,79.8,63.6,00000
33.0,36.0,51.0,753,01,01,  Pakiaba,181,591,69,292,112,299,23.4,19.1,27.3,00000
33.0,36.0,51.0,753,02,01,  Kozzaid Kiddie,206,221,83,105,123,116,48.2,44.1,51.5,00000
33.0,36.0,60.0,054,01,01,  Bagherhat,686,418,361,191,325,227,62.1,65.4,58.9,00000
33.0,36.0,60.0,054,02,01,  Mahtabpur,271,364,127,192,144,172,42.7,39.8,45.6,00000
33.0,36.0,60.0,114,01,01,  Barahar,743,742,361,367,382,375,50.0,49.6,50.5,00000
33.0,36.0,60.0,114,02,01,  Baluchara,234,270,111,149,123,121,46.4,42.7,50.4,00000
33.0,36.0,60.0,114,03,01,  Chak Barahar,578,567,286,283,292,284,50.5,50.3,50.7,00000
33.0,36.0,60.0,114,04,01,  Marulia Para,598,481,266,228,332,253,55.4,53.8,56.8,00000
33.0,36.0,60.0,174,01,01,  Belasi,1562,1195,847,562,715,633,56.7,60.1,53.0,00000
33.0,36.0,60.0,174,02,01,  Talla Para,441,292,208,155,233,137,60.2,57.3,63.0,00000
33.0,36.0,60.0,832,01,01,  Kaldaia,515,264,256,115,259,149,66.1,69.0,63.5,00000
33.0,36.0,60.0,832,02,01,  Bibadia,425,364,184,187,241,177,53.9,49.6,57.7,00000
33.0,36.0,60.0,832,03,01,  Madhyapara,883,647,402,302,481,345,57.7,57.1,58.2,00000
33.0,36.0,60.0,832,04,01,  Purbapara,1050,605,531,292,519,313,63.4,64.5,62.4,00000
33.0,36.0,60.0,832,05,01,  Bara Gartak,87,45,45,19,42,26,65.9,70.3,61.8,00000
33.0,36.0,60.0,832,06,01,  Mamu Bhaignar Tek,140,119,59,57,81,62,54.1,50.9,56.6,00000
33.0,36.0,60.0,832,07,01,  Aowlab,488,224,227,104,261,120,68.5,68.6,68.5,00000
33.0,36.0,60.0,844,01,01,  Dardaria,629,428,302,196,327,232,59.5,60.6,58.5,00000
33.0,36.0,60.0,844,02,01,  Chaura Para,404,396,187,180,217,216,50.5,51.0,50.1,00000
33.0,36.0,69.0,904,01,01,  Chandia,1075,774,494,411,581,363,58.1,54.6,61.5,00000
33.0,36.0,69.0,904,02,01,  Mamrudi,698,382,320,187,378,195,64.6,63.1,66.0,00000
33.0,36.0,69.0,904,03,01,  Joydeb Pahari,99,91,36,45,63,46,52.1,44.4,57.8,00000
33.0,36.0,77.0,898,01,01,  Kuriadi,614,630,293,312,321,318,49.4,48.4,50.2,00000
33.0,36.0,77.0,898,02,01,  Nayanagar,959,382,459,176,500,206,71.5,72.3,70.8,00000
33.0,36.0,77.0,898,03,01,  Barber,575,693,295,323,280,370,45.3,47.7,43.1,00000
33.0,36.0,77.0,898,04,01,  Jhauadi,703,610,316,294,387,316,53.5,51.8,55.0,00000
33.0,36.0,77.0,898,05,01,  Bhiti Para,1368,1674,682,799,686,875,45.0,46.0,43.9,00000
33.0,36.0,77.0,898,06,01,  Kulganga,302,155,150,66,152,89,66.1,69.4,63.1,00000
33.0,36.0,77.0,898,07,01,  Barabari,279,170,150,91,129,79,62.1,62.2,62.0,00000
33.0,36.0,77.0,898,08,01,  Bailarkandi,43,60,14,28,29,32,41.7,33.3,47.5,00000
33.0,36.0,77.0,898,09,01,  Dowain Nagar,290,133,129,61,161,72,68.6,67.9,69.1,00000
33.0,36.0,77.0,898,10,01,  Boribari,1237,709,614,332,623,377,63.6,64.9,62.3,00000
33.0,36.0,77.0,898,11,01,  Sohagpur,739,397,349,186,390,211,65.1,65.2,64.9,00000
33.0,36.0,77.0,898,12,01,  Namila,1170,575,568,263,602,312,67.0,68.4,65.9,00000
33.0,36.0,77.0,898,13,01,  Norda,279,159,143,82,136,77,63.7,63.6,63.8,00000
33.0,36.0,77.0,898,14,01,  Kapalishwar,1695,1039,817,496,878,543,62.0,62.2,61.8,00000
33.0,36.0,86.0,687,01,01,  Matikata,37,54,17,29,20,25,40.7,37.0,44.4,00000
33.0,36.0,86.0,687,02,01,  Dakshin Khamar,426,360,211,179,215,181,54.2,54.1,54.3,00000
33.0,36.0,86.0,687,03,01,  Uttar Khamar,3001,2187,1444,1072,1557,1115,57.8,57.4,58.3,00000
33.0,36.0,86.0,916,01,01,  Sonarua,272,171,127,78,145,93,61.4,62.0,60.9,00000
33.0,36.0,86.0,916,02,01,  Dusara Anjab,134,82,60,46,74,36,62.0,56.6,67.3,00000
33.0,36.0,86.0,916,03,01,  Luhuri,294,253,115,124,179,129,53.7,48.1,58.1,00000
33.0,36.0,86.0,916,04,01,  Nabipur,594,390,287,177,307,213,60.4,61.9,59.0,00000
33.0,36.0,94.0,976,01,01,  Bengurdi,291,405,139,197,152,208,41.8,41.4,42.2,00000
33.0,36.0,94.0,976,02,01,  Gooradia,312,183,154,93,158,90,63.0,62.3,63.7,00000
33.0,36.0,94.0,976,03,01,  Chhatarbar,405,365,196,180,209,185,52.6,52.1,53.0,00000
33.0,36.0,94.0,976,04,01,  Pakurdia,125,81,63,45,62,36,60.7,58.3,63.3,00000
33.0,36.0,94.0,976,05,01,  Barachala,416,350,217,170,199,180,54.3,56.1,52.5,00000
33.0,36.0,94.0,976,06,01,  Dighirpar,431,580,208,272,223,308,42.6,43.3,42.0,00000
33.0,36.0,94.0,976,07,01,  Cheurait,443,361,213,164,230,197,55.1,56.5,53.9,00000
33.0,36.0,94.0,976,08,01,  Baradia,534,823,234,399,300,424,39.4,37.0,41.4,00000
33.0,36.0,94.0,976,09,01,  Biruzali,1384,1224,693,586,691,638,53.1,54.2,52.0,00000
33.0,86.0,21.0,125,01,01,  Barmi,3866,1907,1928,944,1938,963,67.0,67.1,66.8,00000
33.0,86.0,21.0,125,02,01,  Shit Para,608,337,294,175,314,162,64.3,62.7,66.0,00000
33.0,86.0,21.0,125,03,01,  Nehalia,281,241,149,116,132,125,53.8,56.2,51.4,00000
33.0,86.0,21.0,125,04,01,  Mudibari,147,335,72,150,75,185,30.5,32.4,28.8,00000
33.0,86.0,21.0,125,05,01,  Haritakir Tek,369,285,199,124,170,161,56.4,61.6,51.4,00000
33.0,86.0,21.0,138,01,01,  Barnal,1580,1344,779,686,801,658,54.0,53.2,54.9,00000
33.0,86.0,21.0,138,02,01,  Barkul,1607,1320,813,642,794,678,54.9,55.9,53.9,00000
33.0,86.0,21.0,226,01,01,  Char Bahar,370,349,187,152,183,197,51.5,55.2,48.2,00000
33.0,86.0,21.0,226,02,01,  Durlabhpur,1471,1582,762,711,709,871,48.2,51.7,44.9,00000
33.0,86.0,21.0,327,01,01,  Gararan,1667,1957,853,969,814,988,46.0,46.8,45.2,00000
33.0,86.0,21.0,327,02,01,  Sonakar,824,468,419,219,405,249,63.8,65.7,61.9,00000
33.0,86.0,21.0,327,03,01,  Tatirsuta,450,261,244,125,206,136,63.3,66.1,60.2,00000
33.0,86.0,21.0,768,01,01,  Pathan Tek,1602,795,905,411,697,384,66.8,68.8,64.5,00000
33.0,86.0,21.0,768,02,01,  Pathanbari,389,445,196,190,193,255,46.6,50.8,43.1,00000
33.0,86.0,21.0,768,03,01,  Barmi Bazar,857,268,468,101,389,167,76.2,82.2,70.0,00000
33.0,86.0,21.0,894,01,01,  Daibarir Tek,276,327,145,152,131,175,45.8,48.8,42.8,00000
33.0,86.0,21.0,894,02,01,  Balia Para,817,868,375,374,442,494,48.5,50.1,47.2,00000
33.0,86.0,21.0,894,03,01,  Kasijhuli,466,594,234,287,232,307,44.0,44.9,43.0,00000
33.0,86.0,21.0,894,04,01,  Deduar,193,171,101,75,92,96,53.0,57.4,48.9,00000
33.0,86.0,21.0,894,05,01,  Nimaichala,148,319,75,161,73,158,31.7,31.8,31.6,00000
33.0,86.0,21.0,894,06,01,  Bhiti Para,1156,1187,581,592,575,595,49.3,49.5,49.1,00000
33.0,86.0,21.0,894,07,01,  Thakurtala,319,215,153,106,166,109,59.7,59.1,60.4,00000
33.0,86.0,21.0,894,08,01,  Maij Para,533,651,253,327,280,324,45.0,43.6,46.4,00000
33.0,86.0,21.0,894,09,01,  Satkhamair,1492,1003,779,462,713,541,59.8,62.8,56.9,00000
33.0,86.0,21.0,894,10,01,  Posaid,176,311,90,160,86,151,36.1,36.0,36.3,00000
33.0,86.0,21.0,894,11,01,  Dhargarchala,608,963,291,468,317,495,38.7,38.3,39.0,00000
33.0,86.0,21.0,894,12,01,  Dhaleshwar,400,537,205,269,195,268,42.7,43.2,42.1,00000
33.0,86.0,21.0,894,13,01,  Kalartek,72,215,33,115,39,100,25.1,22.3,28.1,00000
33.0,86.0,21.0,894,14,01,  Mulamulir Tek,56,103,26,47,30,56,35.2,35.6,34.9,00000
33.0,86.0,21.0,894,15,01,  Lakhchatal,563,522,270,248,293,274,51.9,52.1,51.7,00000
33.0,86.0,25.0,289,01,01,  Dhanua,4536,3930,2636,1822,1900,2108,53.6,59.1,47.4,00000
33.0,86.0,25.0,289,02,01,  Ajugirchala,706,988,398,447,308,541,41.7,47.1,36.3,00000
33.0,86.0,25.0,289,03,01,  Butuli,551,833,307,358,244,475,39.8,46.2,33.9,00000
33.0,86.0,25.0,289,04,01,  Nagar Haola,2773,3233,1550,1588,1223,1645,46.2,49.4,42.6,00000
33.0,86.0,25.0,289,05,01,  Faridpur,1641,1416,913,668,728,748,53.7,57.7,49.3,00000
33.0,86.0,25.0,352,01,01,  Naya Para,709,1139,389,526,320,613,38.4,42.5,34.3,00000
33.0,86.0,25.0,352,02,01,  Gazipur,3730,4090,2047,2023,1683,2067,47.7,50.3,44.9,00000
33.0,86.0,25.0,352,03,01,  Nij Mauna,3026,3866,1626,1753,1400,2113,43.9,48.1,39.9,00000
33.0,86.0,28.0,390,01,01,  Gosinga,1130,745,535,372,595,373,60.3,59.0,61.5,00000
33.0,86.0,28.0,390,02,01,  Moitagara,250,350,126,181,124,169,41.7,41.0,42.3,00000
33.0,86.0,28.0,390,03,01,  Savarchala,362,211,167,101,195,110,63.2,62.3,63.9,00000
33.0,86.0,28.0,390,04,01,  Hayat Kharchala,696,436,342,200,354,236,61.5,63.1,60.0,00000
33.0,86.0,28.0,390,05,01,  Khila Para,507,220,256,95,251,125,69.7,72.9,66.8,00000
33.0,86.0,28.0,390,06,01,  Kachabari,184,247,89,108,95,139,42.7,45.2,40.6,00000
33.0,86.0,28.0,780,01,01,  Patka,2002,1763,1068,836,934,927,53.2,56.1,50.2,00000
33.0,86.0,28.0,780,02,01,  Hara Patka,379,279,171,151,208,128,57.6,53.1,61.9,00000
33.0,86.0,38.0,277,01,01,  Bidhay,887,1359,479,663,408,696,39.5,41.9,37.0,00000
33.0,86.0,38.0,277,02,01,  Abdar,711,679,422,324,289,355,51.2,56.6,44.9,00000
33.0,86.0,38.0,277,03,01,  Naya Para,644,1137,333,553,311,584,36.2,37.6,34.7,00000
33.0,86.0,38.0,277,04,01,  Shimultali,905,1297,430,641,475,656,41.1,40.1,42.0,00000
33.0,86.0,38.0,277,05,01,  Dhamlai,1756,2519,878,1242,878,1277,41.1,41.4,40.7,00000
33.0,86.0,38.0,277,06,01,  Galda Para,1426,2317,728,1139,698,1178,38.1,39.0,37.2,00000
33.0,86.0,38.0,277,07,01,  Haydebpur,640,830,325,416,315,414,43.5,43.9,43.2,00000
33.0,86.0,38.0,277,08,01,  Jogirshit,1234,1369,685,679,549,690,47.4,50.2,44.3,00000
33.0,86.0,47.0,100,01,01,  Pathar Para,712,656,398,306,314,350,52.0,56.5,47.3,00000
33.0,86.0,47.0,100,02,01,  Singhar Dighi,1471,1765,836,824,635,941,45.5,50.4,40.3,00000
33.0,86.0,47.0,100,03,01,  Bedjuri,307,626,162,289,145,337,32.9,35.9,30.1,00000
33.0,86.0,47.0,100,04,01,  Baratopa,2297,2262,1215,981,1082,1281,50.4,55.3,45.8,00000
33.0,86.0,47.0,100,05,01,  Fulalershit,474,646,262,286,212,360,42.3,47.8,37.1,00000
33.0,86.0,47.0,100,06,01,  Barabaid,115,146,54,68,61,78,44.1,44.3,43.9,00000
33.0,86.0,47.0,100,07,01,  Hasikhali,119,227,75,88,44,139,34.4,46.0,24.0,00000
33.0,86.0,47.0,100,08,01,  Joynatali,275,532,150,239,125,293,34.1,38.6,29.9,00000
33.0,86.0,47.0,100,09,01,  Baramtali,478,358,269,136,209,222,57.2,66.4,48.5,00000
33.0,86.0,47.0,100,10,01,  Indrapur,821,924,428,422,393,502,47.0,50.4,43.9,00000
33.0,86.0,47.0,100,11,01,  Beltali,405,587,196,299,209,288,40.8,39.6,42.1,00000
33.0,86.0,47.0,100,12,01,  Kabarghata,280,305,150,133,130,172,47.9,53.0,43.0,00000
33.0,86.0,47.0,604,01,01,  Maona,4268,3605,2403,1649,1865,1956,54.2,59.3,48.8,00000
33.0,86.0,47.0,604,02,01,  Chak Para,3176,2504,1839,1201,1337,1303,55.9,60.5,50.6,00000
33.0,86.0,47.0,604,03,01,  Kapatia Para,1137,2459,607,1161,530,1298,31.6,34.3,29.0,00000
33.0,86.0,47.0,604,04,01,  Singhar Dighi,1351,2110,829,1014,522,1096,39.0,45.0,32.3,00000
33.0,86.0,47.0,604,05,01,  Aktar Para,796,1798,412,811,384,987,30.7,33.7,28.0,00000
33.0,86.0,47.0,604,06,01,  Badnibhanga,552,800,304,358,248,442,40.8,45.9,35.9,00000
33.0,86.0,47.0,604,07,01,  Simla Para,337,468,179,225,158,243,41.9,44.3,39.4,00000
33.0,86.0,47.0,604,08,01,  Sirishghuri,626,875,333,409,293,466,41.7,44.9,38.6,00000
33.0,86.0,47.0,604,09,01,  Beltail,103,316,52,153,51,163,24.6,25.4,23.8,00000
33.0,86.0,57.0,012,01,01,  Atlora,534,773,266,389,268,384,40.9,40.6,41.1,00000
33.0,86.0,57.0,012,02,01,  Karala Madhabpur,327,218,171,97,156,121,60.0,63.8,56.3,00000
33.0,86.0,57.0,239,01,01,  Damdama,759,538,354,223,405,315,58.5,61.4,56.3,00000
33.0,86.0,57.0,239,02,01,  Char Damdama,831,599,371,294,460,305,58.1,55.8,60.1,00000
33.0,86.0,57.0,541,01,01,  Kismat Nanaia,354,293,168,135,186,158,54.7,55.4,54.1,00000
33.0,86.0,57.0,541,02,01,  Naniar Char,79,47,38,22,41,25,62.7,63.3,62.1,00000
33.0,86.0,57.0,541,03,01,  Atipara,166,82,76,31,90,51,66.9,71.0,63.8,00000
33.0,86.0,57.0,591,01,01,  Lohagachhia,533,368,269,177,264,191,59.2,60.3,58.0,00000
33.0,86.0,57.0,591,02,01,  Pratappur,517,404,250,189,267,215,56.1,56.9,55.4,00000
33.0,86.0,57.0,591,03,01,  Potabari,436,291,230,119,206,172,60.0,65.9,54.5,00000
33.0,86.0,57.0,591,04,01,  Maricherchala,199,62,106,24,93,38,76.2,81.5,71.0,00000
33.0,86.0,57.0,591,05,01,  Bhiti Para,409,457,201,219,208,238,47.2,47.9,46.6,00000
33.0,86.0,57.0,591,06,01,  Ashulia Para,415,270,183,119,232,151,60.6,60.6,60.6,00000
33.0,86.0,57.0,591,07,01,  Kadma,193,96,89,34,104,62,66.8,72.4,62.7,00000
33.0,86.0,57.0,591,08,01,  Sheraliabari,196,95,103,45,93,50,67.4,69.6,65.0,00000
33.0,86.0,57.0,591,09,01,  Rakhalia,191,98,99,41,92,57,66.1,70.7,61.7,00000
33.0,86.0,57.0,591,10,01,  Uzalia,176,243,95,114,81,129,42.0,45.5,38.6,00000
33.0,86.0,57.0,617,01,01,  Marta,1275,783,628,378,647,405,62.0,62.4,61.5,00000
33.0,86.0,57.0,617,02,01,  Baghmara,281,176,137,98,144,78,61.5,58.3,64.9,00000
33.0,86.0,57.0,617,03,01,  Martar Char,106,152,58,74,48,78,41.1,43.9,38.1,00000
33.0,86.0,57.0,705,01,01,  Nimuria,171,122,87,59,84,63,58.4,59.6,57.1,00000
33.0,86.0,57.0,705,02,01,  Mendipur,248,171,110,86,138,85,59.2,56.1,61.9,00000
33.0,86.0,66.0,340,01,01,  Gazaria,1472,921,763,443,709,478,61.5,63.3,59.7,00000
33.0,86.0,66.0,340,02,01,  Kural Para,419,196,210,84,209,112,68.1,71.4,65.1,00000
33.0,86.0,66.0,340,03,01,  Paburiarchala,533,407,324,230,209,177,56.7,58.5,54.1,00000
33.0,86.0,66.0,340,04,01,  Dhaljor,339,283,166,117,173,166,54.5,58.7,51.0,00000
33.0,86.0,66.0,629,01,01,  Mitalu,758,718,377,360,381,358,51.4,51.2,51.6,00000
33.0,86.0,66.0,629,02,01,  Madhabpur,620,518,319,230,301,288,54.5,58.1,51.1,00000
33.0,86.0,66.0,629,03,01,  Biraimati,142,272,64,126,78,146,34.3,33.7,34.8,00000
33.0,86.0,66.0,730,01,01,  Noagaon,2189,1504,1130,680,1059,824,59.3,62.4,56.2,00000
33.0,86.0,66.0,730,02,01,  Rajendrapur,1446,422,760,199,686,223,77.4,79.2,75.5,00000
33.0,86.0,66.0,843,01,01,  Rajabari,867,322,458,135,409,187,72.9,77.2,68.6,00000
33.0,86.0,66.0,843,02,01,  Mali Para,763,495,384,245,379,250,60.7,61.0,60.3,00000
33.0,86.0,66.0,843,03,01,  Bhiti Para,324,314,175,157,149,157,50.8,52.7,48.7,00000
33.0,86.0,66.0,843,04,01,  Batgachhia,183,148,96,69,87,79,55.3,58.2,52.4,00000
33.0,86.0,66.0,843,05,01,  Barachala,217,138,116,61,101,77,61.1,65.5,56.7,00000
33.0,86.0,66.0,843,06,01,  China Shukhania,2260,1843,1075,884,1185,959,55.1,54.9,55.3,00000
33.0,86.0,85.0,957,01,01,  Telihati,771,663,432,285,339,378,53.8,60.3,47.3,00000
33.0,86.0,85.0,957,02,01,  Godar Chala,831,710,435,336,396,374,53.9,56.4,51.4,00000
33.0,86.0,85.0,957,03,01,  Saitalia,734,737,390,335,344,402,49.9,53.8,46.1,00000
33.0,86.0,85.0,957,04,01,  Taltali,846,955,444,457,402,498,47.0,49.3,44.7,00000
33.0,86.0,85.0,957,05,01,  Udaykhali,376,473,205,223,171,250,44.3,47.9,40.6,00000
33.0,86.0,85.0,957,06,01,  Abdar,1775,1459,927,677,848,782,54.9,57.8,52.0,00000
33.0,86.0,85.0,957,07,01,  Dewaner Chala,334,439,174,217,160,222,43.2,44.5,41.9,00000
33.0,86.0,85.0,957,08,01,  Suti Para,748,633,395,300,353,333,54.2,56.8,51.5,00000
33.0,86.0,85.0,957,09,01,  Dambari Chala,1142,995,645,473,497,522,53.4,57.7,48.8,00000
90.0,18.0,17.0,112,01,01,  Sirajpur,677,1369,339,629,338,740,33.1,35.0,31.4,00000
90.0,18.0,17.0,112,02,01,  Baghgaon,387,885,220,427,167,458,30.4,34.0,26.7,00000
90.0,18.0,17.0,124,01,01,  Baghmara,217,260,102,128,115,132,45.5,44.3,46.6,00000
90.0,18.0,17.0,124,02,01,  Bhati Para,103,137,56,74,47,63,42.9,43.1,42.7,00000
90.0,18.0,17.0,124,03,01,  Lalulapur,97,550,55,285,42,265,15.0,16.2,13.7,00000
90.0,18.0,17.0,124,04,01,  Saridharpur,183,385,88,184,95,201,32.2,32.4,32.1,00000
90.0,18.0,17.0,124,05,01,  Natun Baghmara,265,426,134,190,131,236,38.4,41.4,35.7,00000
90.0,18.0,17.0,124,06,01,  Jagonathpur,70,400,39,191,31,209,14.9,17.0,12.9,00000
90.0,18.0,17.0,124,07,01,  Durgapur,358,710,172,366,186,344,33.5,32.0,35.1,00000
90.0,18.0,17.0,124,09,01,  Sonapur,25,296,14,155,11,141,7.8,8.3,7.2,00000
90.0,18.0,17.0,371,01,01,  Ikaratia,198,369,107,177,91,192,34.9,37.7,32.2,00000
90.0,18.0,17.0,371,02,01,  Noagaon,72,195,38,96,34,99,27.0,28.4,25.6,00000
90.0,18.0,17.0,371,03,01,  Basantapur,239,641,118,319,121,322,27.2,27.0,27.3,00000
90.0,18.0,17.0,371,04,01,  Ullasnagar,83,383,25,190,58,193,17.8,11.6,23.1,00000
90.0,18.0,17.0,371,05,01,  Gandamara,55,243,33,125,22,118,18.5,20.9,15.7,00000
90.0,18.0,17.0,530,01,01,  Jalilpur,249,237,136,124,113,113,51.2,52.3,50.0,00000
90.0,18.0,17.0,530,02,01,  Rahimpur,68,170,36,89,32,81,28.6,28.8,28.3,00000
90.0,18.0,17.0,577,01,01,  Manbeg,81,163,41,76,40,87,33.2,35.0,31.5,00000
90.0,18.0,17.0,577,02,01,  Miar Char,257,852,144,411,113,441,23.2,25.9,20.4,00000
90.0,18.0,17.0,596,01,01,  Omarpur,228,431,113,228,115,203,34.6,33.1,36.2,00000
90.0,18.0,17.0,596,02,01,  Shakiar Khola,621,773,309,392,312,381,44.5,44.1,45.0,00000
90.0,18.0,17.0,596,03,01,  Madhu Pur,139,171,65,94,74,77,44.8,40.9,49.0,00000
90.0,18.0,20.0,248,01,01,  Chatar Kaona,1013,1330,490,638,523,692,43.2,43.4,43.0,00000
90.0,18.0,20.0,248,02,01,  Hala Badi,618,778,302,374,316,404,44.3,44.7,43.9,00000
90.0,18.0,20.0,248,03,01,  Bata Gara,196,213,94,114,102,99,47.9,45.2,50.7,00000
90.0,18.0,20.0,248,04,01,  Madhya Nagar,191,593,106,282,85,311,24.4,27.3,21.5,00000
90.0,18.0,20.0,248,05,01,  Tara Ngia,351,306,187,138,164,168,53.4,57.5,49.4,00000
90.0,18.0,20.0,248,06,01,  Madhya Nagar Naya Para,93,130,49,67,44,63,41.7,42.2,41.1,00000
90.0,18.0,20.0,248,07,01,  Madhya Nagar Reserve,77,305,38,150,39,155,20.2,20.2,20.1,00000
90.0,18.0,20.0,248,08,01,  Goal Para,52,148,22,74,30,74,26.0,22.9,28.8,00000
90.0,18.0,20.0,530,01,01,  Meruakhola,748,1294,394,610,354,684,36.6,39.2,34.1,00000
90.0,18.0,20.0,530,02,01,  Islampur,214,849,108,422,106,427,20.1,20.4,19.9,00000
90.0,18.0,20.0,530,03,01,  Ramnagar,46,168,26,73,20,95,21.5,26.3,17.4,00000
90.0,18.0,20.0,530,04,01,  Sureshnagar,425,613,212,296,213,317,40.9,41.7,40.2,00000
90.0,18.0,20.0,530,05,01,  Katakhali,127,87,66,38,61,49,59.3,63.5,55.5,00000
90.0,18.0,20.0,530,06,01,  Boalia,127,424,64,206,63,218,23.0,23.7,22.4,00000
90.0,18.0,20.0,530,07,01,  Chargaon,696,849,351,410,345,439,45.0,46.1,44.0,00000
90.0,18.0,20.0,530,08,01,  Asamgaon,99,126,44,65,55,61,44.0,40.4,47.4,00000
90.0,18.0,20.0,530,09,01,  Dudpur,307,587,141,278,166,309,34.3,33.7,34.9,00000
90.0,18.0,20.0,530,10,01,  Lakshmipar,414,689,217,336,197,353,37.5,39.2,35.8,00000
90.0,18.0,20.0,530,11,01,  Purba Raj Nagar,178,437,90,215,88,222,28.9,29.5,28.4,00000
90.0,18.0,20.0,530,12,01,  Paschim Rajnagar,163,226,92,112,71,114,41.9,45.1,38.4,00000
90.0,18.0,20.0,530,13,01,  Kalutia,34,71,18,32,16,39,32.4,36.0,29.1,00000
90.0,18.0,20.0,530,14,01,  Dhan Pur,1053,697,551,330,502,367,60.2,62.5,57.8,00000
90.0,18.0,20.0,530,15,01,  Chan Dergaon,374,409,182,205,192,204,47.8,47.0,48.5,00000
90.0,18.0,20.0,530,16,01,  Chalita Daba,92,207,33,116,59,91,30.8,22.1,39.3,00000
90.0,18.0,20.0,530,17,01,  Kait Kana,284,294,129,134,155,160,49.1,49.0,49.2,00000
90.0,18.0,20.0,530,18,01,  Gulgaon,328,414,171,193,157,221,44.2,47.0,41.5,00000
90.0,18.0,20.0,530,19,01,  Lotargaon,170,211,85,104,85,107,44.6,45.0,44.3,00000
90.0,18.0,20.0,663,01,01,  Gamair Tala,452,1059,239,474,213,585,29.9,33.5,26.7,00000
90.0,18.0,20.0,663,02,01,  Shil Doar,687,817,370,366,317,451,45.7,50.3,41.3,00000
90.0,18.0,20.0,663,03,01,  China Kandi,562,611,298,298,264,313,47.9,50.0,45.8,00000
90.0,18.0,20.0,663,04,01,  Raja Para,120,212,59,102,61,110,36.1,36.6,35.7,00000
90.0,18.0,20.0,845,01,01,  Machim Pur,645,932,319,429,326,503,40.9,42.6,39.3,00000
90.0,18.0,20.0,845,02,01,  Sonatala,169,378,78,172,91,206,30.9,31.2,30.6,00000
90.0,18.0,20.0,845,03,01,  Surup Gonj,280,811,143,383,137,428,25.7,27.2,24.2,00000
90.0,18.0,20.0,845,04,01,  Mahandra Nagar,105,240,56,114,49,126,30.4,32.9,28.0,00000
90.0,18.0,34.0,066,01,01,  Kaya,128,171,68,83,60,88,42.8,45.0,40.5,00000
90.0,18.0,34.0,066,02,01,  Kotakhali,116,1153,63,606,53,547,9.1,9.4,8.8,00000
90.0,18.0,34.0,066,03,01,  Pachisha,72,182,48,87,24,95,28.3,35.6,20.2,00000
90.0,18.0,34.0,074,01,01,  Bishwambarpur,229,757,129,376,100,381,23.2,25.5,20.8,00000
90.0,18.0,34.0,074,02,01,  Bahadurpur,78,295,50,149,28,146,20.9,25.1,16.1,00000
90.0,18.0,34.0,074,03,01,  Chandargaon,53,272,30,133,23,139,16.3,18.4,14.2,00000
90.0,18.0,34.0,074,04,01,  Lakhmipur,98,293,50,140,48,153,25.1,26.3,23.9,00000
90.0,18.0,34.0,074,05,01,  Gagtia,6,376,4,186,2,190,1.6,2.1,1.0,00000
90.0,18.0,34.0,074,06,01,  Gopalpur,110,365,63,180,47,185,23.2,25.9,20.3,00000
90.0,18.0,34.0,074,07,01,  Rajnagar,147,171,75,91,72,80,46.2,45.2,47.4,00000
90.0,18.0,34.0,555,01,01,  Radhanagar,209,158,110,75,99,83,56.9,59.5,54.4,00000
90.0,18.0,34.0,555,02,01,  Roypur,63,191,33,104,30,87,24.8,24.1,25.6,00000
90.0,18.0,34.0,555,03,01,  Habibnagar,30,32,22,11,8,21,48.4,66.7,27.6,00000
90.0,18.0,34.0,555,04,01,  Biswambarpur Bazar,12,8,11,7,1,1,60.0,61.1,50.0,00000
90.0,18.0,34.0,646,01,01,  Pirijpur,168,354,76,160,92,194,32.2,32.2,32.2,00000
90.0,18.0,34.0,646,02,01,  Haripur,111,229,60,103,51,126,32.6,36.8,28.8,00000
90.0,18.0,34.0,945,01,01,  Uttar Fatehpur,237,484,124,234,113,250,32.9,34.6,31.1,00000
90.0,18.0,34.0,945,02,01,  Kalaya,206,180,112,79,94,101,53.4,58.6,48.2,00000
90.0,18.0,34.0,961,01,01,  Khidirpur,211,396,82,205,129,191,34.8,28.6,40.3,00000
90.0,18.0,34.0,961,02,01,  Gazinagar,61,190,30,94,31,96,24.3,24.2,24.4,00000
90.0,18.0,34.0,961,03,01,  Gopalganj,170,540,85,275,85,265,23.9,23.6,24.3,00000
90.0,18.0,34.0,994,01,01,  Shahapur,409,774,206,406,203,368,34.6,33.7,35.6,00000
90.0,18.0,34.0,994,02,01,  Anantapur,365,500,191,230,174,270,42.2,45.4,39.2,00000
90.0,18.0,77.0,298,01,01,  Parinagar,212,353,101,151,111,202,37.5,40.1,35.5,00000
90.0,18.0,77.0,298,02,01,  Dharerpar,237,565,131,260,106,305,29.6,33.5,25.8,00000
90.0,18.0,77.0,298,03,01,  Baghgaon,300,342,164,155,136,187,46.7,51.4,42.1,00000
90.0,18.0,77.0,298,04,01,  Adukhali,491,166,248,74,243,92,74.7,77.0,72.5,00000
90.0,18.0,77.0,298,05,01,  Dakshin Majhimoar,83,239,44,108,39,131,25.8,28.9,22.9,00000
90.0,18.0,77.0,298,06,01,  Uttar Matimoar,126,159,51,71,75,88,44.2,41.8,46.0,00000
90.0,18.0,77.0,381,01,01,  Lalargaon,126,249,62,130,64,119,33.6,32.3,35.0,00000
90.0,18.0,77.0,381,02,01,  Rasulpur,83,366,42,167,41,199,18.5,20.1,17.1,00000
90.0,18.0,77.0,381,03,01,  Kachigati,448,806,216,402,232,404,35.7,35.0,36.5,00000
90.0,18.0,77.0,381,04,01,  Rajghat,242,260,137,123,105,137,48.2,52.7,43.4,00000
90.0,18.0,77.0,381,05,01,  Padmanagar,118,322,55,152,63,170,26.8,26.6,27.0,00000
90.0,18.0,77.0,381,06,01,  Hamidnagar,13,53,1,34,12,19,19.7,2.9,38.7,00000
90.0,18.0,77.0,381,07,01,  Mollikpur,408,320,199,152,209,168,56.0,56.7,55.4,00000
90.0,18.0,77.0,414,01,01,  Kuti Para,160,238,78,104,82,134,40.2,42.9,38.0,00000
90.0,18.0,77.0,414,02,01,  Kajura,311,384,173,184,138,200,44.7,48.5,40.8,00000
90.0,18.0,77.0,414,03,01,  Pakijan,95,251,50,127,45,124,27.5,28.2,26.6,00000
90.0,18.0,77.0,414,04,01,  Talikona,137,214,67,103,70,111,39.0,39.4,38.7,00000
90.0,18.0,77.0,414,05,01,  Kurihatia,130,202,72,98,58,104,39.2,42.4,35.8,00000
90.0,18.0,77.0,414,06,01,  Dighirpar,59,168,28,79,31,89,26.0,26.2,25.8,00000
90.0,18.0,77.0,414,07,01,  Dighalbagh,97,252,53,128,44,124,27.8,29.3,26.2,00000
90.0,18.0,77.0,414,08,01,  Nutun Golgown,197,222,115,97,82,125,47.0,54.2,39.6,00000
90.0,18.0,77.0,464,01,01,  Majhair,445,714,236,353,209,361,38.4,40.1,36.7,00000
90.0,18.0,77.0,464,02,01,  Gobindanagar,160,202,73,90,87,112,44.2,44.8,43.7,00000
90.0,18.0,77.0,464,03,01,  Pukurpar,130,210,70,92,60,118,38.2,43.2,33.7,00000
90.0,18.0,77.0,464,04,01,  Bajitpur,193,148,90,78,103,70,56.6,53.6,59.5,00000
90.0,18.0,77.0,464,05,01,  Palashgaon,638,596,313,302,325,294,51.7,50.9,52.5,00000
90.0,18.0,77.0,464,06,01,  Chayara,376,528,191,269,185,259,41.6,41.5,41.7,00000
90.0,18.0,77.0,464,07,01,  Joynagar,83,127,37,68,46,59,39.5,35.2,43.8,00000
90.0,18.0,77.0,464,08,01,  Huchukona,133,218,59,107,74,111,37.9,35.5,40.0,00000
90.0,18.0,77.0,530,01,01,  Chandpur,229,383,101,192,128,191,37.4,34.5,40.1,00000
90.0,18.0,77.0,530,02,01,  Dashgar,221,519,111,250,110,269,29.9,30.7,29.0,00000
90.0,18.0,77.0,555,01,03,  Muktikhola,464,960,262,434,202,526,32.6,37.6,27.7,00000
90.0,18.0,77.0,555,02,03,  Krishnanagar,235,108,120,50,115,58,68.5,70.6,66.5,00000
90.0,18.0,77.0,555,03,03,  Harishnagar,646,131,387,53,259,78,83.1,88.0,76.9,00000
90.0,18.0,77.0,762,01,01,  Ranabidya,236,209,103,104,133,105,53.0,49.8,55.9,00000
90.0,18.0,77.0,762,02,01,  Rangpur,39,210,25,114,14,96,15.7,18.0,12.7,00000
90.0,18.0,77.0,762,03,01,  Alipur,292,546,143,256,149,290,34.8,35.8,33.9,00000
90.0,18.0,77.0,762,04,01,  Talartal,217,439,113,221,104,218,33.1,33.8,32.3,00000
90.0,18.0,77.0,762,08,01,  Kolarpur,139,338,68,164,71,174,29.1,29.3,29.0,00000
90.0,18.0,80.0,015,01,01,  Bhadar Tak Utta Para,401,1236,209,631,192,605,24.5,24.9,24.1,00000
90.0,18.0,80.0,015,02,01,  Bhadar Tak Dhakshin Para,261,448,115,212,146,236,36.8,35.2,38.2,00000
90.0,18.0,80.0,015,03,01,  Bhadar Tak Madda Para,423,720,229,345,194,375,37.0,39.9,34.1,00000
90.0,18.0,80.0,015,04,01,  Bhadar Tak Monipuri Hati,410,860,209,475,201,385,32.3,30.6,34.3,00000
90.0,18.0,80.0,480,01,01,  Garar Gaon,332,593,165,299,167,294,35.9,35.6,36.2,00000
90.0,18.0,80.0,480,02,01,  Rangamati,97,253,46,129,51,124,27.7,26.3,29.1,00000
90.0,18.0,80.0,530,01,01,  Mathur Kandi,488,1255,238,633,250,622,28.0,27.3,28.7,00000
90.0,18.0,80.0,530,02,01,  Kapna,565,1920,284,954,281,966,22.7,22.9,22.5,00000
90.0,18.0,80.0,530,03,01,  Gosso Gram,36,39,19,17,17,22,48.0,52.8,43.6,00000
90.0,18.0,80.0,530,04,01,  Moakura,503,712,292,324,211,388,41.4,47.4,35.2,00000
90.0,18.0,80.0,530,05,01,  Amra Gara,203,193,103,96,100,97,51.3,51.8,50.8,00000
90.0,18.0,80.0,530,06,01,  Kashirpur,137,126,75,51,62,75,52.1,59.5,45.3,00000
90.0,18.0,80.0,762,01,01,  Jagan Nath Pur,158,833,85,431,73,402,15.9,16.5,15.4,00000
90.0,18.0,80.0,762,02,01,  Lama Para,58,186,28,100,30,86,23.8,21.9,25.9,00000
90.0,18.0,80.0,762,03,01,  Chalbanda,592,1754,293,904,299,850,25.2,24.5,26.0,00000
90.0,18.0,80.0,762,04,01,  Hicha Gaon,111,121,72,61,39,60,47.8,54.1,39.4,00000
90.0,18.0,80.0,780,01,01,  Ratar Gaon,685,1070,345,546,340,524,39.0,38.7,39.4,00000
90.0,18.0,80.0,780,02,01,  Sona Para,231,630,99,325,132,305,26.8,23.3,30.2,00000
90.0,18.0,80.0,780,03,01,  Puran Mathur Kandi,257,515,127,280,130,235,33.3,31.2,35.6,00000
90.0,18.0,80.0,780,04,01,  Adang,113,892,62,465,51,427,11.2,11.8,10.7,00000
90.0,18.0,80.0,780,05,01,  Jinar Pur,473,1127,248,585,225,542,29.6,29.8,29.3,00000
90.0,18.0,80.0,780,06,01,  Pachim Majar Tak,149,298,73,143,76,155,33.3,33.8,32.9,00000
90.0,18.0,80.0,780,07,01,  Purba Majar Tak,75,406,32,219,43,187,15.6,12.7,18.7,00000
90.0,18.0,80.0,780,08,01,  Purda Dolura,200,881,102,474,98,407,18.5,17.7,19.4,00000
90.0,18.0,80.0,780,09,01,  Chang Bil,74,233,43,120,31,113,24.1,26.4,21.5,00000
90.0,18.0,80.0,780,10,01,  Kali Pur,36,337,17,161,19,176,9.7,9.6,9.7,00000
90.0,18.0,80.0,878,01,01,  Baghbar,258,445,135,227,123,218,36.7,37.3,36.1,00000
90.0,18.0,80.0,878,02,01,  Moni Nagar,131,119,60,59,71,60,52.4,50.4,54.2,00000
90.0,18.0,80.0,878,03,01,  Garar Gaon,25,163,13,71,12,92,13.3,15.5,11.5,00000
90.0,18.0,80.0,995,01,01,  Rampur,209,537,117,270,92,267,28.0,30.2,25.6,00000
90.0,18.0,80.0,995,02,01,  Goayen Gaon,74,161,40,90,34,71,31.5,30.8,32.4,00000
90.0,18.0,80.0,995,03,01,  Minaj Pur,2,45,2,21,0,24,4.3,8.7,0.0,00000
90.0,18.0,80.0,995,04,01,  Akta Para,129,812,61,406,68,406,13.7,13.1,14.3,00000
90.0,23.0,11.0,072,01,01,  Baratika,492,976,271,489,221,487,33.5,35.7,31.2,00000
90.0,23.0,11.0,072,02,01,  Hasnabad,103,173,46,95,57,78,37.3,32.6,42.2,00000
90.0,23.0,11.0,072,03,01,  Islampur,44,117,21,64,23,53,27.3,24.7,30.3,00000
90.0,23.0,11.0,072,04,01,  Jalalpur,77,141,37,78,40,63,35.3,32.2,38.8,00000
90.0,23.0,11.0,072,05,01,  Narasingpur,98,115,45,62,53,53,46.0,42.1,50.0,00000
90.0,23.0,11.0,072,06,01,  Mabarakpur,21,21,12,12,9,9,50.0,50.0,50.0,00000
90.0,23.0,11.0,072,07,01,  Dakshin Masakapur,144,151,72,65,72,86,48.8,52.6,45.6,00000
90.0,23.0,11.0,072,08,01,  Nasaratpur,112,108,58,51,54,57,50.9,53.2,48.6,00000
90.0,23.0,11.0,091,01,01,  Bhadgaon,780,1321,399,643,381,678,37.1,38.3,36.0,00000
90.0,23.0,11.0,091,02,01,  Kachurgaon,118,228,66,109,52,119,34.1,37.7,30.4,00000
90.0,23.0,11.0,378,01,01,  Jalia,735,1293,356,638,379,655,36.2,35.8,36.7,00000
90.0,23.0,11.0,378,02,01,  Satarpoy,362,424,186,215,176,209,46.1,46.4,45.7,00000
90.0,23.0,11.0,378,03,01,  Pagnarpar,37,394,19,177,18,217,8.6,9.7,7.7,00000
90.0,23.0,11.0,828,01,01,  Rokantaj,282,194,157,92,125,102,59.2,63.1,55.1,00000
90.0,23.0,11.0,828,02,01,  Karampur,43,63,24,27,19,36,40.6,47.1,34.5,00000
90.0,23.0,13.0,080,01,01,  Purba Baushi,142,198,70,93,72,105,41.8,42.9,40.7,00000
90.0,23.0,13.0,080,02,01,  Paschim Baushi,269,476,139,214,130,262,36.1,39.4,33.2,00000
90.0,23.0,13.0,951,01,01,  Tirarahi,213,326,101,147,112,179,39.5,40.7,38.5,00000
90.0,23.0,13.0,951,02,01,  Muktirgaon,206,239,109,108,97,131,46.3,50.2,42.5,00000
90.0,23.0,13.0,951,03,01,  Kazihata,150,735,89,345,61,390,16.9,20.5,13.5,00000
90.0,23.0,13.0,951,04,01,  Kandigaon,49,254,24,108,25,146,16.2,18.2,14.6,00000
90.0,23.0,13.0,951,05,01,  Madhukuni,93,217,44,108,49,109,30.0,28.9,31.0,00000
90.0,23.0,13.0,962,01,01,  Brahmangaon,125,388,63,174,62,214,24.4,26.6,22.5,00000
90.0,23.0,13.0,962,02,01,  Machukhali Noagaon,95,276,48,125,47,151,25.6,27.7,23.7,00000
90.0,23.0,14.0,150,01,01,  Prathamar Char,153,439,58,209,95,230,25.8,21.7,29.2,00000
90.0,23.0,14.0,150,02,01,  Char Durlabh,62,386,32,183,30,203,13.8,14.9,12.9,00000
90.0,23.0,14.0,150,03,01,  Hasan Nagar,19,33,8,19,11,14,36.5,29.6,44.0,00000
90.0,23.0,14.0,150,04,01,  Chikka,68,152,32,68,36,84,30.9,32.0,30.0,00000
90.0,23.0,14.0,150,05,01,  Char Majumdari,38,155,15,71,23,84,19.7,17.4,21.5,00000
90.0,23.0,14.0,150,06,01,  Abdullah Char,139,217,58,101,81,116,39.0,36.5,41.1,00000
90.0,23.0,14.0,150,07,01,  Sanua,45,240,21,110,24,130,15.8,16.0,15.6,00000
90.0,23.0,14.0,164,01,01,  Khoridi Char,244,251,130,107,114,144,49.3,54.9,44.2,00000
90.0,23.0,14.0,164,02,01,  Char Madhab,282,364,149,184,133,180,43.7,44.7,42.5,00000
90.0,23.0,14.0,164,03,01,  Behai,13,31,8,14,5,17,29.5,36.4,22.7,00000
90.0,23.0,14.0,365,01,01,  Sidher Char,120,266,59,131,61,135,31.1,31.1,31.1,00000
90.0,23.0,14.0,365,02,01,  Harishnagar (Sahar Char),70,160,36,78,34,82,30.4,31.6,29.3,00000
90.0,23.0,14.0,365,03,01,  Jalalir Char,193,662,87,299,106,363,22.6,22.5,22.6,00000
90.0,23.0,14.0,365,04,01,  Nankar,74,134,36,62,38,72,35.6,36.7,34.5,00000
90.0,23.0,14.0,380,01,01,  Kamarkhal,214,82,114,28,100,54,72.3,80.3,64.9,00000
90.0,23.0,14.0,380,02,01,  Bara Char Gobinda,51,134,27,65,24,69,27.6,29.3,25.8,00000
90.0,23.0,14.0,380,03,01,  Chhota Char Gobinda,52,124,28,49,24,75,29.5,36.4,24.2,00000
90.0,23.0,14.0,432,01,01,  Chhota Kajaura,58,66,27,27,31,39,46.8,50.0,44.3,00000
90.0,23.0,14.0,432,02,01,  Bara Kajaura,244,154,123,64,121,90,61.3,65.8,57.3,00000
90.0,23.0,14.0,850,01,01,  Sakaiti,156,227,62,108,94,119,40.7,36.5,44.1,00000
90.0,23.0,14.0,850,02,01,  Shahapur,95,38,48,16,47,22,71.4,75.0,68.1,00000
90.0,23.0,38.0,096,01,01,  Jogalnagar,306,244,185,120,121,124,55.6,60.7,49.4,00000
90.0,23.0,38.0,096,02,01,  Talupat,244,259,136,108,108,151,48.5,55.7,41.7,00000
90.0,23.0,38.0,129,01,01,  Dashpaika,64,58,34,27,30,31,52.5,55.7,49.2,00000
90.0,23.0,38.0,129,02,01,  Bubrajan,77,45,41,15,36,30,63.1,73.2,54.5,00000
90.0,23.0,38.0,129,03,01,  Talibpur,7,33,4,18,3,15,17.5,18.2,16.7,00000
90.0,23.0,38.0,129,04,01,  Buria Bade,25,18,14,10,11,8,58.1,58.3,57.9,00000
90.0,23.0,38.0,129,05,01,  Buria,597,482,303,226,294,256,55.3,57.3,53.5,00000
90.0,23.0,38.0,207,01,01,  Sreekrishnapur,475,497,254,233,221,264,48.9,52.2,45.6,00000
90.0,23.0,38.0,207,02,01,  Dilalpur,64,64,34,34,30,30,50.0,50.0,50.0,00000
90.0,23.0,38.0,227,01,01,  Islampur,70,50,38,24,32,26,58.3,61.3,55.2,00000
90.0,23.0,38.0,227,02,01,  Dakshin Kurshi,416,1557,199,784,217,773,21.1,20.2,21.9,00000
90.0,23.0,38.0,373,01,01,  Jahidpur,1264,1131,652,525,612,606,52.8,55.4,50.2,00000
90.0,23.0,38.0,373,02,01,  Chelar Char,280,225,139,102,141,123,55.4,57.7,53.4,00000
90.0,23.0,38.0,373,03,01,  Sherpur,112,123,59,62,53,61,47.7,48.8,46.5,00000
90.0,23.0,38.0,373,04,01,  Chandpur,235,228,136,114,99,114,50.8,54.4,46.5,00000
90.0,23.0,38.0,373,05,01,  Alampur,463,539,237,260,226,279,46.2,47.7,44.8,00000
90.0,23.0,38.0,373,06,01,  Gopinathpur,227,360,93,174,134,186,38.7,34.8,41.9,00000
90.0,23.0,38.0,373,07,01,  Bhaual,253,98,142,32,111,66,72.1,81.6,62.7,00000
90.0,23.0,38.0,373,08,01,  Mohammadpur,366,184,215,72,151,112,66.5,74.9,57.4,00000
90.0,23.0,38.0,373,09,01,  Rampur,321,314,157,148,164,166,50.6,51.5,49.7,00000
90.0,23.0,38.0,373,10,01,  Basantapur,486,554,250,275,236,279,46.7,47.6,45.8,00000
90.0,23.0,38.0,373,11,01,  Gobindapur,187,214,103,107,84,107,46.6,49.0,44.0,00000
90.0,23.0,38.0,393,01,01,  Jati,449,190,245,76,204,114,70.3,76.3,64.2,00000
90.0,23.0,38.0,393,02,01,  Gopalpur,90,66,49,25,41,41,57.7,66.2,50.0,00000
90.0,23.0,38.0,393,03,01,  Sulamanpur,177,289,98,141,79,148,38.0,41.0,34.8,00000
90.0,23.0,38.0,393,04,01,  Palpur,1,28,1,14,0,14,3.4,6.7,0.0,00000
90.0,23.0,38.0,544,01,01,  Lakshmipasha,124,65,62,30,62,35,65.6,67.4,63.9,00000
90.0,23.0,38.0,544,02,01,  Ekakamal,69,38,36,14,33,24,64.5,72.0,57.9,00000
90.0,23.0,38.0,544,03,01,  Bahubali,57,7,24,2,33,5,89.1,92.3,86.8,00000
90.0,23.0,38.0,577,01,01,  Mainpur,448,657,239,287,209,370,40.5,45.4,36.1,00000
90.0,23.0,38.0,577,02,01,  Chankhar Bagan,32,83,14,45,18,38,27.8,23.7,32.1,00000
90.0,23.0,38.0,577,03,01,  Chak Keshabpur,74,51,32,22,42,29,59.2,59.3,59.2,00000
90.0,23.0,38.0,577,04,01,  Saila,126,254,59,118,67,136,33.2,33.3,33.0,00000
90.0,23.0,38.0,577,05,01,  Sasan,38,30,24,12,14,18,55.9,66.7,43.8,00000
90.0,23.0,38.0,577,06,01,  Durgapur,64,93,33,47,31,46,40.8,41.3,40.3,00000
90.0,23.0,38.0,634,01,01,  Muktarpur,139,290,62,139,77,151,32.4,30.8,33.8,00000
90.0,23.0,38.0,634,02,01,  Jamsherpur,32,44,17,23,15,21,42.1,42.5,41.7,00000
90.0,23.0,38.0,653,01,01,  Namsakpur,221,219,128,103,93,116,50.2,55.4,44.5,00000
90.0,23.0,38.0,653,02,01,  Jania,44,27,19,15,25,12,62.0,55.9,67.6,00000
90.0,23.0,38.0,817,01,01,  Rauli,423,490,200,236,223,254,46.3,45.9,46.8,00000
90.0,23.0,38.0,817,02,01,  Katasala,320,279,164,126,156,153,53.4,56.6,50.5,00000
90.0,23.0,42.0,102,01,01,  Bhuigaon,554,1194,297,551,257,643,31.7,35.0,28.6,00000
90.0,23.0,42.0,102,02,01,  Chaga Para,123,221,63,99,60,122,35.8,38.9,33.0,00000
90.0,23.0,42.0,102,03,01,  Seola Para,128,195,59,95,69,100,39.6,38.3,40.8,00000
90.0,23.0,42.0,102,04,01,  Sikandarpur,105,204,50,90,55,114,34.0,35.7,32.5,00000
90.0,23.0,42.0,179,01,01,  Chechan,649,1167,333,534,316,633,35.7,38.4,33.3,00000
90.0,23.0,42.0,179,02,01,  Chandar Bari,21,117,15,49,6,68,15.2,23.4,8.1,00000
90.0,23.0,42.0,336,01,01,  Hariswaran,50,120,22,64,28,56,29.4,25.6,33.3,00000
90.0,23.0,42.0,336,02,01,  Ramchandrapur,38,145,23,74,15,71,20.8,23.7,17.4,00000
90.0,23.0,42.0,498,01,01,  Khurma,407,888,207,433,200,455,31.4,32.3,30.5,00000
90.0,23.0,42.0,498,02,01,  Kashipur,159,204,79,100,80,104,43.8,44.1,43.5,00000
90.0,23.0,42.0,498,03,01,  Chhota Mayerkul,138,317,62,165,76,152,30.3,27.3,33.3,00000
90.0,23.0,42.0,502,01,01,  Kirtishasan,60,185,25,94,35,91,24.5,21.0,27.8,00000
90.0,23.0,42.0,502,02,01,  Naogaon,167,577,70,292,97,285,22.4,19.3,25.4,00000
90.0,23.0,42.0,516,01,01,  Kumbhayan,251,370,116,167,135,203,40.4,41.0,39.9,00000
90.0,23.0,42.0,516,02,01,  Dararpar,141,281,69,129,72,152,33.4,34.8,32.1,00000
90.0,23.0,42.0,559,01,01,  Madan,524,679,276,323,248,356,43.6,46.1,41.1,00000
90.0,23.0,42.0,559,02,01,  Juskhai,8,54,3,31,5,23,12.9,8.8,17.9,00000
90.0,23.0,42.0,559,03,01,  Ballabhpur,18,205,10,105,8,100,8.1,8.7,7.4,00000
90.0,23.0,42.0,568,01,01,  Mayerkul,227,911,121,436,106,475,19.9,21.7,18.2,00000
90.0,23.0,42.0,568,02,01,  Madhabpur,32,165,13,84,19,81,16.2,13.4,19.0,00000
90.0,23.0,42.0,605,01,01,  Manipur,115,182,52,87,63,95,38.7,37.4,39.9,00000
90.0,23.0,42.0,605,02,01,  Senpur,146,183,75,89,71,94,44.4,45.7,43.0,00000
90.0,23.0,42.0,612,01,01,  Marjad,454,548,225,264,229,284,45.3,46.0,44.6,00000
90.0,23.0,42.0,612,02,01,  Baje Marjad,134,296,70,145,64,151,31.2,32.6,29.8,00000
90.0,23.0,47.0,014,01,01,  Puran Noakot,95,409,51,204,44,205,18.8,20.0,17.7,00000
90.0,23.0,47.0,014,02,01,  Rasnagar,125,64,74,34,51,30,66.1,68.5,63.0,00000
90.0,23.0,47.0,014,03,01,  Bangaon,418,1054,209,500,209,554,28.4,29.5,27.4,00000
90.0,23.0,47.0,014,04,01,  Gangpar Noakot,356,594,179,282,177,312,37.5,38.8,36.2,00000
90.0,23.0,47.0,014,05,01,  Darogakhali,158,456,77,229,81,227,25.7,25.2,26.3,00000
90.0,23.0,47.0,014,06,01,  Baishakandi,126,849,67,428,59,421,12.9,13.5,12.3,00000
90.0,23.0,47.0,274,01,03,  Kuchbari,373,1005,236,444,137,561,27.1,34.7,19.6,00000
90.0,23.0,47.0,274,02,03,  Bamangaon,12,287,8,138,4,149,4.0,5.5,2.6,00000
90.0,23.0,47.0,274,03,03,  Mollah Para,162,665,98,326,64,339,19.6,23.1,15.9,00000
90.0,23.0,47.0,274,04,03,  Kumardani,102,412,53,212,49,200,19.8,20.0,19.7,00000
90.0,23.0,47.0,293,01,01,  Noagaon,236,341,148,136,88,205,40.9,52.1,30.0,00000
90.0,23.0,47.0,293,02,01,  Patharipur,149,373,85,173,64,200,28.5,32.9,24.2,00000
90.0,23.0,47.0,293,03,01,  Maulvirgaon,114,468,72,208,42,260,19.6,25.7,13.9,00000
90.0,23.0,47.0,293,04,01,  Jaintapur,93,301,57,137,36,164,23.6,29.4,18.0,00000
90.0,23.0,47.0,293,05,01,  Bahadurpur,401,943,237,415,164,528,29.8,36.3,23.7,00000
90.0,23.0,47.0,293,06,01,  Niamatpur,51,162,31,73,20,89,23.9,29.8,18.3,00000
90.0,23.0,47.0,293,07,01,  Uttar Ganeshpur,341,670,197,277,144,393,33.7,41.6,26.8,00000
90.0,23.0,47.0,293,08,01,  Dakshin Ganeshpur,530,902,288,402,242,500,37.0,41.7,32.6,00000
90.0,23.0,47.0,293,09,01,  Madhya Ganeshpur,470,695,322,473,148,222,40.3,40.5,40.0,00000
90.0,23.0,47.0,367,01,01,  Jamura,67,519,43,257,24,262,11.4,14.3,8.4,00000
90.0,23.0,47.0,367,02,01,  Rahmatpur-2,74,425,55,215,19,210,14.8,20.4,8.3,00000
90.0,23.0,47.0,367,03,01,  Islampur,270,621,166,273,104,348,30.3,37.8,23.0,00000
90.0,23.0,47.0,446,01,01,  Luvia,134,362,78,167,56,195,27.0,31.8,22.3,00000
90.0,23.0,47.0,446,02,01,  Kazirgaon,90,273,49,139,41,134,24.8,26.1,23.4,00000
90.0,23.0,47.0,774,01,01,  Alampur,87,304,44,159,43,145,22.3,21.7,22.9,00000
90.0,23.0,47.0,774,02,01,  Rahmatpur-1,311,1305,152,679,159,626,19.2,18.3,20.3,00000
90.0,23.0,47.0,979,01,01,  Nijgaon,237,377,132,177,105,200,38.6,42.7,34.4,00000
90.0,23.0,47.0,979,02,01,  Dhanitila,59,158,39,76,20,82,27.2,33.9,19.6,00000
90.0,23.0,52.0,040,01,01,  Badeshwari,227,718,136,348,91,370,24.0,28.1,19.7,00000
90.0,23.0,52.0,040,02,01,  Bagarai,51,253,23,120,28,133,16.8,16.1,17.4,00000
90.0,23.0,52.0,067,01,01,  Tukergaon,90,164,45,80,45,84,35.4,36.0,34.9,00000
90.0,23.0,52.0,067,02,01,  Uttar Bara Kapan,392,461,196,215,196,246,46.0,47.7,44.3,00000
90.0,23.0,52.0,067,03,01,  Dakshin Bara Kapan,535,877,261,397,274,480,37.9,39.7,36.3,00000
90.0,23.0,52.0,194,01,01,  Tarapur,61,137,26,71,35,66,30.8,26.8,34.7,00000
90.0,23.0,52.0,194,02,01,  Churigaon,103,255,45,122,58,133,28.8,26.9,30.4,00000
90.0,23.0,52.0,238,01,01,  Patali,30,154,18,72,12,82,16.3,20.0,12.8,00000
90.0,23.0,52.0,238,02,01,  Deorgaon,743,1242,390,592,353,650,37.4,39.7,35.2,00000
90.0,23.0,52.0,395,01,01,  Jaua,835,873,397,394,438,479,48.9,50.2,47.8,00000
90.0,23.0,52.0,395,02,01,  Jaua Bazar,491,233,425,171,66,62,67.8,71.3,51.6,00000
90.0,23.0,52.0,397,01,01,  Jhamak,411,701,207,354,204,347,37.0,36.9,37.0,00000
90.0,23.0,52.0,397,02,01,  Binandapur,299,419,146,205,153,214,41.6,41.6,41.7,00000
90.0,23.0,52.0,397,03,01,  Rahimpur,40,51,24,24,16,27,44.0,50.0,37.2,00000
90.0,23.0,52.0,397,04,01,  Hipatnagar,23,36,14,18,9,18,39.0,43.8,33.3,00000
90.0,23.0,52.0,461,01,01,  Kapala,435,787,215,393,220,394,35.6,35.4,35.8,00000
90.0,23.0,52.0,461,02,01,  Mogalgaon,144,111,79,46,65,65,56.5,63.2,50.0,00000
90.0,23.0,52.0,461,03,01,  Surujpur,38,28,21,12,17,16,57.6,63.6,51.5,00000
90.0,23.0,57.0,006,01,01,  Akupur,185,283,93,149,92,134,39.5,38.4,40.7,00000
90.0,23.0,57.0,006,02,01,  Khairgaon,125,213,58,96,67,117,37.0,37.7,36.4,00000
90.0,23.0,57.0,006,03,01,  Mohanpur,75,136,39,79,36,57,35.5,33.1,38.7,00000
90.0,23.0,57.0,006,04,01,  Noagaon,99,202,49,92,50,110,32.9,34.8,31.3,00000
90.0,23.0,57.0,111,01,01,  Khalpar (Part),88,249,44,108,44,141,26.1,28.9,23.8,00000
90.0,23.0,57.0,111,02,01,  Billai,73,152,38,78,35,74,32.4,32.8,32.1,00000
90.0,23.0,57.0,111,03,01,  Kalaruka,436,663,221,302,215,361,39.7,42.3,37.3,00000
90.0,23.0,57.0,111,04,01,  Chandpur,120,245,59,112,61,133,32.9,34.5,31.4,00000
90.0,23.0,57.0,111,05,01,  Lama Para,117,431,66,200,51,231,21.4,24.8,18.1,00000
90.0,23.0,57.0,214,01,01,  Mukirgoan,492,686,275,346,217,340,41.8,44.3,39.0,00000
90.0,23.0,57.0,214,02,01,  Shimultala,324,1098,158,554,166,544,22.8,22.2,23.4,00000
90.0,23.0,57.0,214,03,01,  Harishpur,368,610,208,278,160,332,37.6,42.8,32.5,00000
90.0,23.0,57.0,214,04,01,  Nanchiri,149,288,81,143,68,145,34.1,36.2,31.9,00000
90.0,23.0,57.0,214,05,01,  Mitragaon,109,263,56,119,53,144,29.3,32.0,26.9,00000
90.0,23.0,57.0,214,06,01,  Pirpur,254,153,141,73,113,80,62.4,65.9,58.5,00000
90.0,23.0,57.0,214,07,01,  Gauripur,100,280,62,131,38,149,26.3,32.1,20.3,00000
90.0,23.0,57.0,290,01,01,  Gandharabapur,176,164,88,77,88,87,51.8,53.3,50.3,00000
90.0,23.0,57.0,290,02,01,  Tajpur,306,204,153,94,153,110,60.0,61.9,58.2,00000
90.0,23.0,57.0,290,03,01,  Balar Pirpur,213,249,100,110,113,139,46.1,47.6,44.8,00000
90.0,23.0,57.0,290,04,01,  Nayagaon,46,36,26,18,20,18,56.1,59.1,52.6,00000
90.0,23.0,57.0,387,01,01,  Jamrail,126,113,66,53,60,60,52.7,55.5,50.0,00000
90.0,23.0,57.0,387,02,01,  Ghargaon,106,86,61,41,45,45,55.2,59.8,50.0,00000
90.0,23.0,57.0,400,01,01,  Hasnabad,435,662,231,299,204,363,39.7,43.6,36.0,00000
90.0,23.0,57.0,400,02,01,  Taluk Para,141,157,70,78,71,79,47.3,47.3,47.3,00000
90.0,23.0,57.0,400,03,01,  Nowka Kande,109,497,62,246,47,251,18.0,20.1,15.8,00000
90.0,23.0,57.0,481,01,01,  Lambahati,113,268,56,130,57,138,29.7,30.1,29.2,00000
90.0,23.0,57.0,481,02,01,  Karachkhali,136,503,63,248,73,255,21.3,20.3,22.3,00000
90.0,23.0,57.0,505,01,01,  Rampur,154,193,68,91,86,102,44.4,42.8,45.7,00000
90.0,23.0,57.0,505,02,01,  Kotalpur,253,457,143,202,110,255,35.6,41.4,30.1,00000
90.0,23.0,57.0,590,01,01,  Mamudpur,146,70,74,18,72,52,67.6,80.4,58.1,00000
90.0,23.0,57.0,590,02,01,  Tengergaon,43,65,23,27,20,38,39.8,46.0,34.5,00000
90.0,23.0,57.0,826,01,01,  Roysantoshpur,755,805,377,371,378,434,48.4,50.4,46.6,00000
90.0,23.0,57.0,826,02,01,  Sekh Kandi,27,124,16,64,11,60,17.9,20.0,15.5,00000
90.0,23.0,57.0,865,01,01,  Najam Pur,38,216,18,102,20,114,15.0,15.0,14.9,00000
90.0,23.0,57.0,865,02,01,  Sankarpur,350,398,187,191,163,207,46.8,49.5,44.1,00000
90.0,23.0,57.0,865,03,01,  Khal Par (Purbu),19,206,15,106,4,100,8.4,12.4,3.8,00000
90.0,23.0,57.0,865,04,01,  Rajapur,100,426,48,196,52,230,19.0,19.7,18.4,00000
90.0,23.0,57.0,898,01,01,  Sikandarpur,66,302,36,128,30,174,17.9,22.0,14.7,00000
90.0,23.0,57.0,898,02,01,  Sikka,22,221,13,102,9,119,9.1,11.3,7.0,00000
90.0,23.0,57.0,898,03,01,  Malipur,36,304,20,134,16,170,10.6,13.0,8.6,00000
90.0,23.0,57.0,994,01,01,  Uzirpur,92,187,41,95,51,92,33.0,30.1,35.7,00000
90.0,23.0,57.0,994,02,01,  Udaypur,30,177,18,84,12,93,14.5,17.6,11.4,00000
90.0,23.0,57.0,994,03,01,  Sahebergaon,83,151,39,60,44,91,35.5,39.4,32.6,00000
90.0,23.0,76.0,074,01,01,  Batiyarkandi,234,334,130,154,104,180,41.2,45.8,36.6,00000
90.0,23.0,76.0,074,02,01,  Maruatila,14,217,11,103,3,114,6.1,9.6,2.6,00000
90.0,23.0,76.0,213,01,01,  Chandpur,195,726,105,342,90,384,21.2,23.5,19.0,00000
90.0,23.0,76.0,213,02,01,  Kachu Dair,60,644,31,298,29,346,8.5,9.4,7.7,00000
90.0,23.0,76.0,213,03,01,  Manikpur,198,603,123,272,75,331,24.7,31.1,18.5,00000
90.0,23.0,76.0,213,04,01,  Godhabari,174,526,85,257,89,269,24.9,24.9,24.9,00000
90.0,23.0,76.0,213,05,01,  Baragalla,238,640,125,290,113,350,27.1,30.1,24.4,00000
90.0,23.0,76.0,274,01,03,  Noari Islampur (P),164,381,89,187,75,194,30.1,32.2,27.9,00000
90.0,23.0,76.0,274,02,03,  Fakirtila,9,224,9,102,0,122,3.9,8.1,0.0,00000
90.0,23.0,76.0,274,03,03,  Rajgaon,90,319,42,146,48,173,22.0,22.3,21.7,00000
90.0,23.0,76.0,463,01,01,  Char Bhara,411,887,207,398,204,489,31.7,34.2,29.4,00000
90.0,23.0,76.0,463,02,01,  Karailgaon,412,611,212,273,200,338,40.3,43.7,37.2,00000
90.0,23.0,76.0,542,01,01,  Lakshmi Baur,508,2018,309,937,199,1081,20.1,24.8,15.5,00000
90.0,23.0,76.0,542,02,01,  Burairgaon,103,238,56,114,47,124,30.2,32.9,27.5,00000
90.0,23.0,76.0,611,01,01,  Mirzapur,149,499,82,249,67,250,23.0,24.8,21.1,00000
90.0,23.0,76.0,611,02,01,  Asadnagar,112,589,55,274,57,315,16.0,16.7,15.3,00000
90.0,23.0,76.0,611,03,01,  Ulurgaon,51,278,30,133,21,145,15.5,18.4,12.7,00000
90.0,23.0,76.0,611,04,01,  Katalpur,95,279,45,144,50,135,25.4,23.8,27.0,00000
90.0,23.0,76.0,611,05,01,  Rangpur,184,1021,95,482,89,539,15.3,16.5,14.2,00000
90.0,23.0,76.0,611,06,01,  Betura,159,359,83,179,76,180,30.7,31.7,29.7,00000
90.0,23.0,76.0,768,01,01,  Rajargaon,368,1604,170,763,198,841,18.7,18.2,19.1,00000
90.0,23.0,76.0,768,02,01,  Chankhair,431,864,214,385,217,479,33.3,35.7,31.2,00000
90.0,23.0,76.0,768,03,01,  Angaroka,54,265,20,139,34,126,16.9,12.6,21.3,00000
90.0,23.0,76.0,768,04,01,  Joynagar,221,1443,113,718,108,725,13.3,13.6,13.0,00000
90.0,23.0,76.0,768,05,01,  Mahishmara,48,354,25,178,23,176,11.9,12.3,11.6,00000
90.0,23.0,76.0,768,06,01,  Kuria,39,141,20,70,19,71,21.7,22.2,21.1,00000
90.0,23.0,76.0,795,01,01,  Jurapani,218,386,113,186,105,200,36.1,37.8,34.4,00000
90.0,23.0,76.0,795,02,01,  Moula,112,259,58,111,54,148,30.2,34.3,26.7,00000
90.0,23.0,76.0,795,03,01,  Bandargaon,171,129,84,55,87,74,57.0,60.4,54.0,00000
90.0,23.0,76.0,795,04,01,  Khuiadal,28,99,14,51,14,48,22.0,21.5,22.6,00000
90.0,23.0,76.0,795,05,01,  Uttar Kupia,84,410,41,197,43,213,17.0,17.2,16.8,00000
90.0,23.0,76.0,795,06,01,  Dakshin Kupia,199,984,117,479,82,505,16.8,19.6,14.0,00000
90.0,23.0,76.0,795,07,01,  Khurma,147,398,76,201,71,197,27.0,27.4,26.5,00000
90.0,23.0,76.0,795,08,01,  Singarkach,219,464,117,210,102,254,32.1,35.8,28.7,00000
90.0,23.0,76.0,934,01,01,  Sarpin Nagar,294,976,155,465,139,511,23.1,25.0,21.4,00000
90.0,23.0,76.0,934,02,01,  Bashtila,43,420,27,203,16,217,9.3,11.7,6.9,00000
90.0,23.0,85.0,085,01,01,  Behrajpur,215,417,128,195,87,222,34.0,39.6,28.2,00000
90.0,23.0,85.0,085,02,01,  Alampur,55,78,26,46,29,32,41.4,36.1,47.5,00000
90.0,23.0,85.0,085,03,01,  Khidirpur,78,101,44,49,34,52,43.6,47.3,39.5,00000
90.0,23.0,85.0,126,01,01,  Burairgaon,171,133,88,45,83,88,56.3,66.2,48.5,00000
90.0,23.0,85.0,126,02,01,  Gobindapur,30,20,16,9,14,11,60.0,64.0,56.0,00000
90.0,23.0,85.0,126,03,01,  Alampur,200,167,94,76,106,91,54.5,55.3,53.8,00000
90.0,23.0,85.0,126,04,01,  Burairgaon Bazar,22,64,15,47,7,17,25.6,24.2,29.2,00000
90.0,23.0,85.0,198,01,01,  Brammangaon,41,169,21,89,20,80,19.5,19.1,20.0,00000
90.0,23.0,85.0,198,02,01,  Sunarugaon,31,58,20,25,11,33,34.8,44.4,25.0,00000
90.0,23.0,85.0,231,01,01,  Dayaroy,39,17,19,8,20,9,69.6,70.4,69.0,00000
90.0,23.0,85.0,231,02,01,  Madhabpur,9,7,4,3,5,4,56.3,57.1,55.6,00000
90.0,23.0,85.0,474,01,01,  Katalpur,67,317,41,135,26,182,17.4,23.3,12.5,00000
90.0,23.0,85.0,474,02,01,  Hailkiari,98,202,50,91,48,111,32.7,35.5,30.2,00000
90.0,23.0,85.0,483,01,01,  Khagaura,351,522,178,227,173,295,40.2,44.0,37.0,00000
90.0,23.0,85.0,483,02,01,  Gaharpur,95,104,49,46,46,58,47.7,51.6,44.2,00000
90.0,23.0,85.0,763,01,01,  Kharai,6,36,2,22,4,14,14.3,8.3,22.2,00000
90.0,23.0,85.0,763,02,01,  Sadarpur,7,73,2,40,5,33,8.8,4.8,13.2,00000
90.0,23.0,85.0,769,01,01,  Pirpur,453,628,218,275,235,353,41.9,44.2,40.0,00000
90.0,23.0,85.0,769,02,01,  Imamganj Bazar,1,0,1,0,0,0,100.0,100.0,0.0,00000
90.0,23.0,85.0,769,03,01,  Bahubugu,70,226,24,118,46,108,23.6,16.9,29.9,00000
90.0,23.0,85.0,776,01,01,  Dashghar,431,389,222,185,209,204,52.6,54.5,50.6,00000
90.0,23.0,85.0,776,02,01,  Lakshmipur,60,23,27,13,33,10,72.3,67.5,76.7,00000
90.0,23.0,85.0,776,03,01,  Gaurangar,73,211,42,96,31,115,25.7,30.4,21.2,00000
90.0,23.0,85.0,776,04,01,  Bishwamvarpur,237,344,118,157,119,187,40.8,42.9,38.9,00000
90.0,23.0,85.0,776,05,01,  Bilpar,334,513,185,239,149,274,39.4,43.6,35.2,00000
90.0,23.0,85.0,776,06,01,  Gobindanagar,659,739,343,347,316,392,47.1,49.7,44.6,00000
90.0,23.0,85.0,841,01,01,  Saidargaon,364,244,183,121,181,123,59.9,60.2,59.5,00000
90.0,23.0,85.0,841,02,01,  Jalalpur,244,195,117,71,127,124,55.6,62.2,50.6,00000
90.0,23.0,85.0,841,03,01,  Kakura,185,85,101,52,84,33,68.5,66.0,71.8,00000
90.0,23.0,85.0,841,04,01,  Alampur,193,49,88,23,105,26,79.8,79.3,80.2,00000
90.0,23.0,85.0,841,05,01,  Dharan,186,247,83,102,103,145,43.0,44.9,41.5,00000
90.0,23.0,85.0,841,06,01,  Gopalpur,55,72,32,28,23,44,43.3,53.3,34.3,00000
90.0,23.0,85.0,841,07,01,  Piran Nagar,9,19,3,7,6,12,32.1,30.0,33.3,00000
90.0,23.0,85.0,841,08,01,  Saudpur,158,240,81,108,77,132,39.7,42.9,36.8,00000
90.0,23.0,85.0,841,09,01,  Furkan Chak,101,165,55,78,46,87,38.0,41.4,34.6,00000
90.0,23.0,85.0,841,10,01,  Faridpur,20,58,12,25,8,33,25.6,32.4,19.5,00000
90.0,23.0,85.0,905,01,01,  Singua,59,76,34,34,25,42,43.7,50.0,37.3,00000
90.0,23.0,85.0,905,02,01,  Akanida Singua,98,69,47,40,51,29,58.7,54.0,63.8,00000
90.0,23.0,85.0,905,03,01,  Gobindaganj Nayabazar,49,78,19,38,30,40,38.6,33.3,42.9,00000
90.0,23.0,85.0,916,01,01,  Paschim Suhitpur,415,219,216,95,199,124,65.5,69.5,61.6,00000
90.0,23.0,85.0,916,02,01,  Suhitpur,67,89,35,46,32,43,42.9,43.2,42.7,00000
90.0,23.0,85.0,916,03,01,  Purba Suhitpur,82,141,39,70,43,71,36.8,35.8,37.7,00000
90.0,23.0,85.0,927,01,01,  Takipur,179,144,82,66,97,78,55.4,55.4,55.4,00000
90.0,23.0,85.0,927,02,01,  Rail Gate,119,246,83,129,36,117,32.6,39.2,23.5,00000
90.0,23.0,85.0,988,01,01,  Badirgaon,59,43,27,18,32,25,57.8,60.0,56.1,00000
90.0,23.0,85.0,988,02,01,  Sreepur,49,31,31,12,18,19,61.3,72.1,48.6,00000
90.0,23.0,90.0,124,01,01,  Gopalpur,16,64,7,32,9,32,20.0,17.9,22.0,00000
90.0,23.0,90.0,124,02,01,  Mirzapur,18,85,8,42,10,43,17.5,16.0,18.9,00000
90.0,23.0,90.0,124,03,01,  Sekh Para,62,216,30,104,32,112,22.3,22.4,22.2,00000
90.0,23.0,90.0,124,04,01,  Brahman Julia,226,513,136,237,90,276,30.6,36.5,24.6,00000
90.0,23.0,90.0,124,05,01,  Basanakandi,92,133,50,66,42,67,40.9,43.1,38.5,00000
90.0,23.0,90.0,212,01,01,  Nakeshwar Bazar,35,38,12,19,23,19,47.9,38.7,54.8,00000
90.0,23.0,90.0,212,02,01,  Nakeshwar,730,1095,366,523,364,572,40.0,41.2,38.9,00000
90.0,23.0,90.0,212,03,01,  Bara Palirgaon,492,447,237,211,255,236,52.4,52.9,51.9,00000
90.0,23.0,90.0,212,04,01,  Chhota Palirgaon,112,199,51,96,61,103,36.0,34.7,37.2,00000
90.0,23.0,90.0,358,01,01,  Deogaon,251,277,116,136,135,141,47.5,46.0,48.9,00000
90.0,23.0,90.0,358,02,01,  Bahadurpur,149,221,70,107,79,114,40.3,39.5,40.9,00000
90.0,23.0,90.0,358,03,01,  Inam,205,351,111,159,94,192,36.9,41.1,32.9,00000
90.0,23.0,90.0,358,04,01,  Chak Biram,80,200,41,93,39,107,28.6,30.6,26.7,00000
90.0,23.0,90.0,358,05,01,  Jati,45,71,26,28,19,43,38.8,48.1,30.6,00000
90.0,23.0,90.0,358,06,01,  Khurma,51,45,32,18,19,27,53.1,64.0,41.3,00000
90.0,23.0,90.0,358,07,01,  Sayla,27,54,11,32,16,22,33.3,25.6,42.1,00000
90.0,23.0,90.0,487,01,01,  Khalagaon,206,155,99,76,107,79,57.1,56.6,57.5,00000
90.0,23.0,90.0,487,02,01,  Khola Lakshmipur,33,46,14,24,19,22,41.8,36.8,46.3,00000
90.0,23.0,90.0,551,01,01,  Barachal,201,141,105,66,96,75,58.8,61.4,56.1,00000
90.0,23.0,90.0,551,02,01,  Bagain,586,667,297,331,289,336,46.8,47.3,46.2,00000
90.0,23.0,90.0,551,03,01,  Lakshmipur,58,130,31,63,27,67,30.9,33.0,28.7,00000
90.0,23.0,90.0,771,01,01,  Gobindaganj Natun Bazar,352,192,204,64,148,128,64.7,76.1,53.6,00000
90.0,23.0,90.0,771,02,01,  Gobindaganj Puran Bazar,342,215,173,105,169,110,61.4,62.2,60.6,00000
90.0,23.0,90.0,771,03,01,  Purba Rampur,356,706,181,344,175,362,33.5,34.5,32.6,00000
90.0,23.0,90.0,776,01,01,  Shibnagar,299,492,145,224,154,268,37.8,39.3,36.5,00000
90.0,23.0,90.0,776,02,01,  Radhanagar,721,594,358,263,363,331,54.8,57.6,52.3,00000
90.0,23.0,90.0,776,03,01,  Harinagar,59,27,34,6,25,21,68.6,85.0,54.3,00000
90.0,23.0,90.0,776,04,01,  Krishnanagar,313,600,156,280,157,320,34.3,35.8,32.9,00000
90.0,23.0,90.0,776,05,01,  Shyamnagar,479,382,252,164,227,218,55.6,60.6,51.0,00000
90.0,23.0,90.0,776,06,01,  Sreenagar,195,169,113,75,82,94,53.6,60.1,46.6,00000
90.0,23.0,90.0,776,07,01,  Tegari,107,316,50,150,57,166,25.3,25.0,25.6,00000
90.0,23.0,90.0,776,08,01,  Jagannathpur,94,241,50,121,44,120,28.1,29.2,26.8,00000
90.0,23.0,90.0,776,09,01,  Gopalnagar,126,288,65,141,61,147,30.4,31.6,29.3,00000
90.0,23.0,90.0,776,10,01,  Anandanagar,126,305,71,138,55,167,29.2,34.0,24.8,00000
90.0,23.0,90.0,776,11,01,  Noapara,306,692,176,338,130,354,30.7,34.2,26.9,00000
90.0,23.0,90.0,776,12,01,  Lakshmi Narayanpur,201,164,98,70,103,94,55.1,58.3,52.3,00000
90.0,23.0,92.0,406,01,01,  Jiapur,799,1086,383,536,416,550,42.4,41.7,43.1,00000
90.0,23.0,92.0,406,02,01,  Parganer Bazar,462,482,226,230,236,252,48.9,49.6,48.4,00000
90.0,23.0,92.0,758,01,01,  Mahadi,359,563,167,273,192,290,38.9,38.0,39.8,00000
90.0,23.0,92.0,758,02,01,  Sing Chapair,841,1793,403,861,438,932,31.9,31.9,32.0,00000
90.0,23.0,92.0,758,03,01,  Chikankandi,35,170,13,94,22,76,17.1,12.1,22.4,00000
90.0,23.0,92.0,758,04,01,  Sirajgaon Bazar,27,124,16,64,11,60,17.9,20.0,15.5,00000
90.0,23.0,92.0,758,05,01,  Mamadpur,144,343,69,165,75,178,29.6,29.5,29.6,00000
90.0,23.0,92.0,758,06,01,  Banikandi,907,747,514,312,393,435,54.8,62.2,47.5,00000
90.0,23.0,92.0,883,01,01,  Satis,266,581,128,280,138,301,31.4,31.4,31.4,00000
90.0,23.0,92.0,883,02,01,  Aslampur,21,75,11,39,10,36,21.9,22.0,21.7,00000
90.0,23.0,94.0,109,01,01,  Bara Bihai,92,229,38,112,54,117,28.7,25.3,31.6,00000
90.0,23.0,94.0,109,02,01,  Chhota Bihai,63,372,26,170,37,202,14.5,13.3,15.5,00000
90.0,23.0,94.0,301,01,01,  Ghila Chhara,142,490,65,232,77,258,22.5,21.9,23.0,00000
90.0,23.0,94.0,301,02,01,  Takirai,130,128,64,55,66,73,50.4,53.8,47.5,00000
90.0,23.0,94.0,301,03,01,  Noagaon,153,179,79,72,74,107,46.1,52.3,40.9,00000
90.0,23.0,94.0,546,01,01,  Amertala,170,411,83,194,87,217,29.3,30.0,28.6,00000
90.0,23.0,94.0,546,02,01,  Furkan Nagar,139,116,59,57,80,59,54.5,50.9,57.6,00000
90.0,23.0,94.0,546,03,01,  Lakshmipasha,168,117,75,60,93,57,58.9,55.6,62.0,00000
90.0,23.0,94.0,578,01,01,  Mohanpur,262,571,138,292,124,279,31.5,32.1,30.8,00000
90.0,23.0,94.0,578,02,01,  Tebapur,104,209,55,104,49,105,33.2,34.6,31.8,00000
90.0,23.0,94.0,578,03,01,  Moyshapur,128,164,65,73,63,91,43.8,47.1,40.9,00000
90.0,23.0,94.0,578,04,01,  Naya Bazargaon,31,49,19,20,12,29,38.8,48.7,29.3,00000
90.0,23.0,94.0,578,05,01,  Bazargaon,58,202,26,99,32,103,22.3,20.8,23.7,00000
90.0,23.0,94.0,578,06,01,  Saola,113,189,47,94,66,95,37.4,33.3,41.0,00000
90.0,23.0,94.0,578,07,01,  Aklimnagar,42,128,16,64,26,64,24.7,20.0,28.9,00000
90.0,23.0,94.0,579,01,01,  Naya Maishapur,446,605,260,245,186,360,42.4,51.5,34.1,00000
90.0,23.0,94.0,579,02,01,  Dhargaon,62,185,28,92,34,93,25.1,23.3,26.8,00000
90.0,23.0,94.0,579,03,01,  Charalkona,68,135,30,62,38,73,33.5,32.6,34.2,00000
90.0,23.0,94.0,579,04,01,  Kanchanpur,186,351,81,168,105,183,34.6,32.5,36.5,00000
90.0,23.0,94.0,579,05,01,  Gauripur,5,29,2,14,3,15,14.7,12.5,16.7,00000
90.0,23.0,94.0,579,06,01,  Manjiara,77,154,38,64,39,90,33.3,37.3,30.2,00000
90.0,23.0,94.0,602,01,01,  Gatpar,116,106,71,43,45,63,52.3,62.3,41.7,00000
90.0,23.0,94.0,602,02,01,  Chalitarbagh,13,83,6,46,7,37,13.5,11.5,15.9,00000
90.0,23.0,94.0,697,01,01,  Paranpur Chak,29,46,15,21,14,25,38.7,41.7,35.9,00000
90.0,23.0,94.0,697,02,01,  Rasulpur,229,164,134,62,95,102,58.3,68.4,48.2,00000
90.0,23.0,94.0,765,01,01,  Nanchhiri,117,230,56,104,61,126,33.7,35.0,32.6,00000
90.0,23.0,94.0,765,02,01,  Islampur,70,78,46,30,24,48,47.3,60.5,33.3,00000
90.0,27.0,11.0,161,01,01,  Chhayara,404,523,185,264,219,259,43.6,41.2,45.8,00000
90.0,27.0,11.0,161,02,01,  Harinagar,227,494,106,247,121,247,31.5,30.0,32.9,00000
90.0,27.0,11.0,308,01,01,  Durgapasha,529,912,241,443,288,469,36.7,35.2,38.0,00000
90.0,27.0,11.0,308,02,01,  Aktar Para,741,876,380,423,361,453,45.8,47.3,44.3,00000
90.0,27.0,11.0,308,03,01,  Noagaon,342,442,184,213,158,229,43.6,46.3,40.8,00000
90.0,27.0,11.0,308,04,01,  Rasulpur,137,93,72,49,65,44,59.6,59.5,59.6,00000
90.0,27.0,11.0,676,01,01,  Paikapan,348,1231,183,577,165,654,22.0,24.1,20.1,00000
90.0,27.0,11.0,676,02,01,  Jamkhala,106,480,37,231,69,249,18.1,13.8,21.7,00000
90.0,27.0,11.0,732,02,01,  Sitaharan Chak,105,269,43,126,62,143,28.1,25.4,30.2,00000
90.0,27.0,11.0,732,04,01,  Sriramgagan Sri,46,41,24,22,22,19,52.9,52.2,53.7,00000
90.0,27.0,11.0,819,01,01,  Sichni,341,797,183,438,158,359,30.0,29.5,30.6,00000
90.0,27.0,11.0,819,02,01,  Saidpur,242,176,126,94,116,82,57.9,57.3,58.6,00000
90.0,27.0,11.0,819,03,01,  Gandidoar,105,88,46,51,59,37,54.4,47.4,61.5,00000
90.0,27.0,11.0,819,04,01,  Nurpur,71,292,31,147,40,145,19.6,17.4,21.6,00000
90.0,27.0,11.0,854,01,01,  Sarishpur,54,74,28,39,26,35,42.2,41.8,42.6,00000
90.0,27.0,11.0,854,02,01,  Alampur Chak,34,44,19,19,15,25,43.6,50.0,37.5,00000
90.0,27.0,11.0,854,04,01,  Goalgaon,7,52,3,26,4,26,11.9,10.3,13.3,00000
90.0,27.0,11.0,854,05,01,  Ichha Pausa,12,59,8,34,4,25,16.9,19.0,13.8,00000
90.0,27.0,33.0,154,01,01,  Astama,548,1769,280,851,268,918,23.7,24.8,22.6,00000
90.0,27.0,33.0,154,02,01,  Asampur,253,1304,120,654,133,650,16.2,15.5,17.0,00000
90.0,27.0,33.0,437,01,01,  Hasnabad,359,515,184,232,175,283,41.1,44.2,38.2,00000
90.0,27.0,33.0,437,02,01,  Jamlabaj,1275,1821,663,855,612,966,41.2,43.7,38.8,00000
90.0,27.0,33.0,441,01,03,  Joykalas,587,1285,328,613,259,672,31.4,34.9,27.8,00000
90.0,27.0,33.0,441,02,03,  Ujanigaon,739,991,391,490,348,501,42.7,44.4,41.0,00000
90.0,27.0,33.0,441,03,03,  Nayagaon,36,359,19,172,17,187,9.1,9.9,8.3,00000
90.0,27.0,33.0,630,01,01,  Mirzapur,282,560,147,267,135,293,33.5,35.5,31.5,00000
90.0,27.0,33.0,630,02,01,  Fathepur,176,242,100,115,76,127,42.1,46.5,37.4,00000
90.0,27.0,33.0,630,03,01,  Manikpur,187,54,101,20,86,34,77.6,83.5,71.7,00000
90.0,27.0,33.0,683,01,01,  Tegharia (Part),185,406,107,191,78,215,31.3,35.9,26.6,00000
90.0,27.0,33.0,683,02,01,  Sadarpur,415,483,200,218,215,265,46.2,47.8,44.8,00000
90.0,27.0,33.0,683,03,01,  Parbatipur,279,955,148,473,131,482,22.6,23.8,21.4,00000
90.0,27.0,33.0,931,01,01,  Dabagram,189,125,98,64,91,61,60.2,60.5,59.9,00000
90.0,27.0,33.0,931,02,01,  Bagarkara,391,870,166,440,225,430,31.0,27.4,34.4,00000
90.0,27.0,33.0,931,03,01,  Nayakhali,401,428,222,215,179,213,48.4,50.8,45.7,00000
90.0,27.0,61.0,035,01,01,  Amdabad,219,298,111,128,108,170,42.4,46.4,38.8,00000
90.0,27.0,61.0,035,02,01,  Hachar Char,359,858,186,376,173,482,29.5,33.1,26.4,00000
90.0,27.0,61.0,227,01,01,  Kandigaon,232,411,123,206,109,205,36.1,37.4,34.7,00000
90.0,27.0,61.0,227,02,01,  Puran Kandigaon,43,212,23,104,20,108,16.9,18.1,15.6,00000
90.0,27.0,61.0,329,01,01,  Ganiganj,579,1109,321,511,258,598,34.3,38.6,30.1,00000
90.0,27.0,61.0,329,02,01,  Nagar (Hindu Para),346,341,175,153,171,188,50.4,53.4,47.6,00000
90.0,27.0,61.0,387,01,01,  Kashipur,4,296,1,144,3,152,1.3,0.7,1.9,00000
90.0,27.0,61.0,387,02,01,  Narayankuri,7,213,6,107,1,106,3.2,5.3,0.9,00000
90.0,27.0,61.0,423,01,01,  Jahanpur,151,518,99,229,52,289,22.6,30.2,15.2,00000
90.0,27.0,61.0,423,02,01,  Jahanpur Puran,124,697,63,322,61,375,15.1,16.4,14.0,00000
90.0,27.0,61.0,711,01,01,  Patharia,566,1280,268,574,298,706,30.7,31.8,29.7,00000
90.0,27.0,61.0,711,02,01,  Kandargaon,39,140,21,65,18,75,21.8,24.4,19.4,00000
90.0,27.0,61.0,711,03,01,  Talukgaon,260,305,123,144,137,161,46.0,46.1,46.0,00000
90.0,27.0,61.0,711,04,01,  Gazinagar,893,2509,460,1188,433,1321,26.2,27.9,24.7,00000
90.0,27.0,61.0,788,01,01,  Saidabad,104,335,64,166,40,169,23.7,27.8,19.1,00000
90.0,27.0,61.0,788,02,01,  Kumrail,144,358,63,171,81,187,28.7,26.9,30.2,00000
90.0,27.0,61.0,788,03,01,  Babania,70,358,38,175,32,183,16.4,17.8,14.9,00000
90.0,27.0,78.0,248,01,01,  Shimulbagh,578,1003,307,440,271,563,36.6,41.1,32.5,00000
90.0,27.0,78.0,248,02,01,  Raghunathpur,40,333,30,162,10,171,10.7,15.6,5.5,00000
90.0,27.0,78.0,273,01,01,  Sardarpur,145,307,75,155,70,152,32.1,32.6,31.5,00000
90.0,27.0,78.0,273,02,01,  Dhanpur,518,1163,258,589,260,574,30.8,30.5,31.2,00000
90.0,27.0,78.0,529,01,01,  Kanthalia,176,829,83,417,93,412,17.5,16.6,18.4,00000
90.0,27.0,78.0,529,02,01,  Akta Para,113,559,56,270,57,289,16.8,17.2,16.5,00000
90.0,27.0,78.0,574,01,01,  Muktakai,456,874,237,433,219,441,34.3,35.4,33.2,00000
90.0,27.0,78.0,574,02,01,  Keshabpur,83,190,39,87,44,103,30.4,31.0,29.9,00000
90.0,27.0,78.0,574,03,01,  Nurpur,162,662,93,333,69,329,19.7,21.8,17.3,00000
90.0,27.0,78.0,700,01,01,  Amria,383,752,191,376,192,376,33.7,33.7,33.8,00000
90.0,27.0,78.0,700,02,01,  Kandargaon,194,311,105,152,89,159,38.4,40.9,35.9,00000
90.0,27.0,78.0,700,03,01,  Khidirpur,68,487,42,228,26,259,12.3,15.6,9.1,00000
90.0,27.0,78.0,700,04,01,  Rameshwarpur,103,249,68,95,35,154,29.3,41.7,18.5,00000
90.0,27.0,78.0,700,05,01,  Dalagaon,271,644,125,308,146,336,29.6,28.9,30.3,00000
90.0,27.0,78.0,700,06,01,  Chandpur,267,457,146,220,121,237,36.9,39.9,33.8,00000
90.0,27.0,89.0,307,01,01,  Ukhtirpar,153,523,66,250,87,273,22.6,20.9,24.2,00000
90.0,27.0,89.0,307,02,01,  Umednagar,250,340,124,161,126,179,42.4,43.5,41.3,00000
90.0,27.0,89.0,307,03,01,  Kauajuri,106,271,62,133,44,138,28.1,31.8,24.2,00000
90.0,27.0,89.0,367,01,01,  Durbakanda,213,526,108,245,105,281,28.8,30.6,27.2,00000
90.0,27.0,89.0,367,02,01,  Hular Bhita,41,110,13,60,28,50,27.2,17.8,35.9,00000
90.0,27.0,89.0,444,01,01,  Joysiddi Basiakhauri,530,870,258,417,272,453,37.9,38.2,37.5,00000
90.0,27.0,89.0,444,02,01,  Basiakhauri Banuarbari,284,324,135,156,149,168,46.7,46.4,47.0,00000
90.0,27.0,89.0,444,03,01,  Bamangaon,30,52,18,19,12,33,36.6,48.6,26.7,00000
90.0,27.0,89.0,444,04,01,  Shantipur,78,254,42,134,36,120,23.5,23.9,23.1,00000
90.0,27.0,89.0,620,01,01,  Maukhala,222,267,100,131,122,136,45.4,43.3,47.3,00000
90.0,27.0,89.0,620,02,01,  Shyamnagar,287,662,140,315,147,347,30.2,30.8,29.8,00000
90.0,27.0,89.0,620,03,01,  Saparkona,265,511,129,251,136,260,34.1,33.9,34.3,00000
90.0,27.0,89.0,903,01,01,  Thakurbhog,359,733,187,346,172,387,32.9,35.1,30.8,00000
90.0,27.0,89.0,903,02,01,  Durgapur,268,562,131,266,137,296,32.3,33.0,31.6,00000
90.0,27.0,90.0,140,01,01,  Brahmangaon (Part),1080,1696,524,805,556,891,38.9,39.4,38.4,00000
90.0,27.0,90.0,140,02,01,  Hussain Pur,98,225,49,104,49,121,30.3,32.0,28.8,00000
90.0,27.0,90.0,140,03,01,  Nidonpur,42,303,13,163,29,140,12.2,7.4,17.2,00000
90.0,27.0,90.0,222,01,01,  Chandapur,366,733,194,317,172,416,33.3,38.0,29.3,00000
90.0,27.0,90.0,222,02,01,  Roypur,417,701,195,338,222,363,37.3,36.6,37.9,00000
90.0,27.0,90.0,222,03,01,  Kadipur,278,1025,151,489,127,536,21.3,23.6,19.2,00000
90.0,27.0,90.0,809,01,01,  Enayetnagar,335,705,179,342,156,363,32.2,34.4,30.1,00000
90.0,27.0,90.0,809,02,01,  Satrumardan,2275,2782,1191,1384,1084,1398,45.0,46.3,43.7,00000
90.0,27.0,92.0,126,01,01,  Birgaon,1535,3723,798,1767,737,1956,29.2,31.1,27.4,00000
90.0,27.0,92.0,126,02,01,  Salap,707,1793,342,850,365,943,28.3,28.7,27.9,00000
90.0,27.0,92.0,126,03,01,  Dharampur,437,729,212,332,225,397,37.5,39.0,36.2,00000
90.0,27.0,92.0,126,04,01,  Bhabangaon,452,856,244,434,208,422,34.6,36.0,33.0,00000
90.0,27.0,94.0,023,01,01,  Nazimpur,130,242,49,130,81,112,34.9,27.4,42.0,00000
90.0,27.0,94.0,023,02,01,  Alampur,334,304,171,152,163,152,52.4,52.9,51.7,00000
90.0,27.0,94.0,023,03,01,  Digar Kandi,156,557,77,277,79,280,21.9,21.8,22.0,00000
90.0,27.0,94.0,164,01,01,  Chikarkandi,464,1208,245,571,219,637,27.8,30.0,25.6,00000
90.0,27.0,94.0,164,02,01,  Badulapur,69,347,33,158,36,189,16.6,17.3,16.0,00000
90.0,27.0,94.0,392,01,01,  Madhya Alampur Chak (Khodira,478,843,242,401,236,442,36.2,37.6,34.8,00000
90.0,27.0,94.0,392,02,01,  Ransi (Part),29,96,15,50,14,46,23.2,23.1,23.3,00000
90.0,27.0,94.0,767,01,01,  Ransi,671,1038,344,483,327,555,39.3,41.6,37.1,00000
90.0,27.0,94.0,767,02,01,  Kararai,33,48,16,26,17,22,40.7,38.1,43.6,00000
90.0,27.0,94.0,767,03,01,  Mamadpur,497,778,253,373,244,405,39.0,40.4,37.6,00000
90.0,29.0,17.0,253,01,01,  Dattagaon,456,704,249,347,207,357,39.3,41.8,36.7,00000
90.0,29.0,17.0,253,02,01,  Dhulpashi,139,241,70,118,69,123,36.6,37.2,35.9,00000
90.0,29.0,17.0,273,01,01,  Alinagar,427,1307,249,612,178,695,24.6,28.9,20.4,00000
90.0,29.0,17.0,273,02,01,  Nurnagar,85,490,41,262,44,228,14.8,13.5,16.2,00000
90.0,29.0,17.0,923,01,01,  Sutargaon,166,173,98,78,68,95,49.0,55.7,41.7,00000
90.0,29.0,17.0,923,02,01,  Chatalpar,57,289,31,137,26,152,16.5,18.5,14.6,00000
90.0,29.0,17.0,975,01,01,  Urdhanpur,480,380,257,176,223,204,55.8,59.4,52.2,00000
90.0,29.0,17.0,975,02,01,  Ganka,290,142,153,59,137,83,67.1,72.2,62.3,00000
90.0,29.0,19.0,159,01,01,  Lawlar Char,686,1091,374,533,312,558,38.6,41.2,35.9,00000
90.0,29.0,19.0,159,02,01,  Lasimpur,217,173,101,95,116,78,55.6,51.5,59.8,00000
90.0,29.0,19.0,159,03,01,  Joypur,213,273,116,127,97,146,43.8,47.7,39.9,00000
90.0,29.0,19.0,159,04,01,  Gopalpur,354,453,176,218,178,235,43.9,44.7,43.1,00000
90.0,29.0,19.0,208,01,01,  Mytia,170,812,87,408,83,404,17.3,17.6,17.0,00000
90.0,29.0,19.0,208,02,01,  Kartikpur,412,1281,210,614,202,667,24.3,25.5,23.2,00000
90.0,29.0,19.0,208,03,01,  Noagaon,164,1225,101,626,63,599,11.8,13.9,9.5,00000
90.0,29.0,19.0,208,04,01,  Santipur,83,260,53,129,30,131,24.2,29.1,18.6,00000
90.0,29.0,19.0,702,01,01,  Shyamar Char,474,1223,257,609,217,614,27.9,29.7,26.1,00000
90.0,29.0,19.0,702,02,01,  Shyamar Char Bazar,383,109,216,39,167,70,77.8,84.7,70.5,00000
90.0,29.0,19.0,702,03,01,  Daulatpur,322,712,186,342,136,370,31.1,35.2,26.9,00000
90.0,29.0,19.0,851,01,01,  Hasnabad,120,646,60,341,60,305,15.7,15.0,16.4,00000
90.0,29.0,19.0,851,02,01,  Baktarpur,159,307,94,149,65,158,34.1,38.7,29.1,00000
90.0,29.0,19.0,851,03,01,  Perua,756,839,390,419,366,420,47.4,48.2,46.6,00000
90.0,29.0,19.0,851,04,01,  Sherpur,48,261,23,116,25,145,15.5,16.5,14.7,00000
90.0,29.0,19.0,851,05,01,  Alipur,174,133,91,61,83,72,56.7,59.9,53.5,00000
90.0,29.0,19.0,851,06,01,  Kanupur,125,173,79,74,46,99,41.9,51.6,31.7,00000
90.0,29.0,19.0,851,07,01,  Satyanandapur,107,300,54,153,53,147,26.3,26.1,26.5,00000
90.0,29.0,19.0,851,08,01,  Along Jore,307,193,162,98,145,95,61.4,62.3,60.4,00000
90.0,29.0,28.0,162,01,03,  Kollani,226,317,116,154,110,163,41.6,43.0,40.3,00000
90.0,29.0,28.0,162,02,03,  Ramnagar,154,311,67,157,87,154,33.1,29.9,36.1,00000
90.0,29.0,28.0,377,01,01,  Hasimpur,488,474,232,226,256,248,50.7,50.7,50.8,00000
90.0,29.0,28.0,377,02,01,  Bangal Para,40,262,21,128,19,134,13.2,14.1,12.4,00000
90.0,29.0,28.0,377,03,01,  Durgapur,53,292,24,141,29,151,15.4,14.5,16.1,00000
90.0,29.0,28.0,637,01,01,  Hazaipur,88,231,39,131,49,100,27.6,22.9,32.9,00000
90.0,29.0,28.0,637,02,01,  Noagaon,254,363,128,175,126,188,41.2,42.2,40.1,00000
90.0,29.0,28.0,845,01,01,  Sarmangal,238,644,125,323,113,321,27.0,27.9,26.0,00000
90.0,29.0,28.0,845,02,01,  Rangamatia,236,231,131,107,105,124,50.5,55.0,45.9,00000
90.0,29.0,28.0,845,03,01,  Chandrapur,64,611,36,304,28,307,9.5,10.6,8.4,00000
90.0,29.0,28.0,845,04,01,  Dhanpur,95,820,59,394,36,426,10.4,13.0,7.8,00000
90.0,29.0,28.0,845,05,01,  Chandipur,151,683,85,335,66,348,18.1,20.2,15.9,00000
90.0,29.0,38.0,097,01,01,  Barkapan,132,208,62,104,70,104,38.8,37.3,40.2,00000
90.0,29.0,38.0,097,02,01,  Bhatirgaon,186,330,78,158,108,172,36.0,33.1,38.6,00000
90.0,29.0,38.0,266,01,01,  Daulatpur (Chhayara),308,458,160,243,148,215,40.2,39.7,40.8,00000
90.0,29.0,38.0,266,02,01,  Chayra,30,55,16,29,14,26,35.3,35.6,35.0,00000
90.0,29.0,38.0,351,01,01,  Garma,154,322,75,154,79,168,32.4,32.8,32.0,00000
90.0,29.0,38.0,351,02,01,  Rajnagar,296,752,135,361,161,391,28.2,27.2,29.2,00000
90.0,29.0,38.0,351,03,01,  Atbari,97,322,51,156,46,166,23.2,24.6,21.7,00000
90.0,29.0,38.0,396,01,01,  Hosenpur,336,787,160,372,176,415,29.9,30.1,29.8,00000
90.0,29.0,38.0,396,02,01,  Sikandarpur,455,1309,227,629,228,680,25.8,26.5,25.1,00000
90.0,29.0,38.0,396,03,01,  Naya Para Daulatpur,94,131,47,64,47,67,41.8,42.3,41.2,00000
90.0,29.0,38.0,396,04,01,  Kandagaon,65,241,38,120,27,121,21.2,24.1,18.2,00000
90.0,29.0,38.0,409,01,01,  Jagaddal,819,1037,418,486,401,551,44.1,46.2,42.1,00000
90.0,29.0,38.0,409,02,01,  Dulargaon,68,48,39,24,29,24,58.6,61.9,54.7,00000
90.0,29.0,38.0,513,01,01,  Kamribich,195,787,104,383,91,404,19.9,21.4,18.4,00000
90.0,29.0,38.0,513,02,01,  Pukidar,204,342,96,177,108,165,37.4,35.2,39.6,00000
90.0,29.0,38.0,656,01,01,  Nagdipur,449,637,211,314,238,323,41.3,40.2,42.4,00000
90.0,29.0,38.0,656,02,01,  Bara Nagdipur,467,325,228,143,239,182,59.0,61.5,56.8,00000
90.0,29.0,38.0,656,03,01,  Kawajuri Nayagaon,182,260,99,110,83,150,41.2,47.4,35.6,00000
90.0,29.0,38.0,669,01,01,  Narayankuri,276,403,140,186,136,217,40.6,42.9,38.5,00000
90.0,29.0,38.0,669,02,01,  Kadamtali,63,140,33,62,30,78,31.0,34.7,27.8,00000
90.0,29.0,38.0,871,01,01,  Singhanath,239,526,119,251,120,275,31.2,32.2,30.4,00000
90.0,29.0,38.0,871,02,01,  Rupai Jagaddal,190,107,96,54,94,53,64.0,64.0,63.9,00000
90.0,29.0,38.0,871,03,01,  Panch Kahania,110,142,54,75,56,67,43.7,41.9,45.5,00000
90.0,29.0,38.0,871,04,01,  Sitaharan,146,201,71,98,75,103,42.1,42.0,42.1,00000
90.0,29.0,38.0,871,05,01,  Kusi Jagaddal,55,119,23,65,32,54,31.6,26.1,37.2,00000
90.0,29.0,47.0,364,01,01,  Halimpur,363,651,186,351,177,300,35.8,34.6,37.1,00000
90.0,29.0,47.0,364,02,01,  Gobindapur,181,221,93,117,88,104,45.0,44.3,45.8,00000
90.0,29.0,47.0,364,03,01,  Matiapur (Part),53,131,21,70,32,61,28.8,23.1,34.4,00000
90.0,29.0,47.0,520,01,01,  Karimpur,551,384,283,197,268,187,58.9,59.0,58.9,00000
90.0,29.0,47.0,520,02,01,  Tajpur,137,310,61,155,76,155,30.6,28.2,32.9,00000
90.0,29.0,47.0,526,01,01,  Purana Karnagaon,157,512,79,258,78,254,23.5,23.4,23.5,00000
90.0,29.0,47.0,526,02,01,  Nutan Karnagaon,240,593,117,288,123,305,28.8,28.9,28.7,00000
90.0,29.0,47.0,617,01,01,  Muksedpur,709,1020,384,578,325,442,41.0,39.9,42.4,00000
90.0,29.0,47.0,617,02,01,  Rajnagar,148,165,69,76,79,89,47.3,47.6,47.0,00000
90.0,29.0,47.0,884,01,01,  Sreenarayanpur,505,475,218,250,287,225,51.5,46.6,56.1,00000
90.0,29.0,47.0,884,02,01,  Tanakhali Bazar,35,92,29,90,6,2,27.6,24.4,75.0,00000
90.0,29.0,47.0,884,03,01,  Islampur,106,242,41,127,65,115,30.5,24.4,36.1,00000
90.0,29.0,47.0,884,04,01,  Matiapur (Part),125,430,59,218,66,212,22.5,21.3,23.7,00000
90.0,29.0,47.0,958,01,03,  Tukderai,600,489,300,231,300,258,55.1,56.5,53.8,00000
90.0,29.0,47.0,958,02,03,  Nayahati,236,178,104,94,132,84,57.0,52.5,61.1,00000
90.0,29.0,47.0,958,03,03,  Nasirpur,140,345,65,165,75,180,28.9,28.3,29.4,00000
90.0,29.0,47.0,994,01,01,  Nagergaon,254,343,145,166,109,177,42.5,46.6,38.1,00000
90.0,29.0,47.0,994,02,01,  Badalpur,111,435,47,215,64,220,20.3,17.9,22.5,00000
90.0,29.0,57.0,091,01,01,  Baraitiyar,259,257,132,126,127,131,50.2,51.2,49.2,00000
90.0,29.0,57.0,091,02,01,  Anandanagar,10,57,9,46,1,11,14.9,16.4,8.3,00000
90.0,29.0,57.0,130,01,01,  Bhaitgaon,391,424,181,195,210,229,48.0,48.1,47.8,00000
90.0,29.0,57.0,130,02,01,  Dakshin Suriarpur,166,624,69,311,97,313,21.0,18.2,23.7,00000
90.0,29.0,57.0,344,01,01,  Galisal,336,329,163,128,173,201,50.5,56.0,46.3,00000
90.0,29.0,57.0,344,02,01,  Ratanpur,120,311,63,145,57,166,27.8,30.3,25.6,00000
90.0,29.0,57.0,390,01,01,  Hatia,1171,1286,604,601,567,685,47.7,50.1,45.3,00000
90.0,29.0,57.0,390,02,01,  Radhanagar,98,368,53,182,45,186,21.0,22.6,19.5,00000
90.0,29.0,57.0,390,03,01,  Uttar Suriarpar,643,1983,306,972,337,1011,24.5,23.9,25.0,00000
90.0,29.0,57.0,890,01,01,  Suatior,162,298,74,151,88,147,35.2,32.9,37.4,00000
90.0,29.0,57.0,890,02,01,  Mostafapur,107,188,57,93,50,95,36.3,38.0,34.5,00000
90.0,29.0,57.0,955,01,01,  Tetaiya,657,1141,311,566,346,575,36.5,35.5,37.6,00000
90.0,29.0,57.0,955,02,01,  Islampur,292,347,156,170,136,177,45.7,47.9,43.5,00000
90.0,29.0,57.0,955,03,01,  Rasulpur,27,268,15,142,12,126,9.2,9.6,8.7,00000
90.0,29.0,66.0,084,01,01,  Baraghar,89,333,49,171,40,162,21.1,22.3,19.8,00000
90.0,29.0,66.0,084,02,01,  Basakharach,123,473,57,251,66,222,20.6,18.5,22.9,00000
90.0,29.0,66.0,383,01,01,  Beora,2,51,2,22,0,29,3.8,8.3,0.0,00000
90.0,29.0,66.0,383,02,01,  Samipur,92,240,51,120,41,120,27.7,29.8,25.5,00000
90.0,29.0,66.0,383,03,01,  Gaziargaon,52,248,30,132,22,116,17.3,18.5,15.9,00000
90.0,29.0,66.0,383,04,01,  Hasnabad,90,204,44,97,46,107,30.6,31.2,30.1,00000
90.0,29.0,66.0,383,05,01,  Sadirpur,94,303,65,131,29,172,23.7,33.2,14.4,00000
90.0,29.0,66.0,559,01,01,  Kurigaon,14,168,7,89,7,79,7.7,7.3,8.1,00000
90.0,29.0,66.0,559,02,01,  Jagannathpur,71,371,40,182,31,189,16.1,18.0,14.1,00000
90.0,29.0,66.0,591,01,01,  Nowagaon,126,491,68,229,58,262,20.4,22.9,18.1,00000
90.0,29.0,66.0,591,02,01,  Masimpur,292,1151,188,532,104,619,20.2,26.1,14.4,00000
90.0,29.0,66.0,611,01,01,  Meghna,335,374,175,177,160,197,47.2,49.7,44.8,00000
90.0,29.0,66.0,611,02,01,  Suranjtnagar,47,73,28,34,19,39,39.2,45.2,32.8,00000
90.0,29.0,66.0,695,01,01,  Paschim Anwarpur,98,400,61,202,37,198,19.7,23.2,15.7,00000
90.0,29.0,66.0,695,02,01,  Bangla Bazar,18,439,8,231,10,208,3.9,3.3,4.6,00000
90.0,29.0,66.0,741,01,01,  Uttar Rafinagar,433,1594,276,768,157,826,21.4,26.4,16.0,00000
90.0,29.0,66.0,741,02,01,  Dakshin Rafinagar,392,1509,230,763,162,746,20.6,23.2,17.8,00000
90.0,29.0,66.0,741,03,01,  Mirzapur,230,1125,147,539,83,586,17.0,21.4,12.4,00000
90.0,29.0,76.0,149,01,01,  Bharargaon,116,156,75,84,41,72,42.6,47.2,36.3,00000
90.0,29.0,76.0,149,02,01,  Dhapki(Part),60,127,32,61,28,66,32.1,34.4,29.8,00000
90.0,29.0,76.0,338,01,01,  Gachia,377,928,189,470,188,458,28.9,28.7,29.1,00000
90.0,29.0,76.0,338,02,01,  Kajaura,197,185,102,85,95,100,51.6,54.5,48.7,00000
90.0,29.0,76.0,455,01,01,  Kadamtali,378,485,196,239,182,246,43.8,45.1,42.5,00000
90.0,29.0,76.0,455,02,01,  Harinagar,58,61,29,28,29,33,48.7,50.9,46.8,00000
90.0,29.0,76.0,455,03,01,  Kurar Goan,17,16,6,6,11,10,51.5,50.0,52.4,00000
90.0,29.0,76.0,461,01,01,  Kaima,295,261,154,112,141,149,53.1,57.9,48.6,00000
90.0,29.0,76.0,461,02,01,  Madhupur,333,591,164,267,169,324,36.0,38.1,34.3,00000
90.0,29.0,76.0,461,03,01,  Dhalua,185,389,97,178,88,211,32.2,35.3,29.4,00000
90.0,29.0,76.0,553,01,01,  Kejaura,383,913,183,442,200,471,29.6,29.3,29.8,00000
90.0,29.0,76.0,553,02,01,  Begumpur,117,221,58,113,59,108,34.6,33.9,35.3,00000
90.0,29.0,76.0,553,03,01,  Modhupur Rari,1,76,1,46,0,30,1.3,2.1,0.0,00000
90.0,29.0,76.0,754,01,01,  Rajanagar,349,720,174,351,175,369,32.6,33.1,32.2,00000
90.0,29.0,76.0,754,02,01,  Hornagar,131,396,76,181,55,215,24.9,29.6,20.4,00000
90.0,29.0,76.0,754,03,01,  Kalinagar,195,268,102,115,93,153,42.1,47.0,37.8,00000
90.0,29.0,76.0,754,04,01,  Dhapkia,257,879,125,450,132,429,22.6,21.7,23.5,00000
90.0,29.0,76.0,786,01,01,  Ranarchar,670,649,338,289,332,360,50.8,53.9,48.0,00000
90.0,29.0,76.0,786,02,01,  Jagaran Char,207,402,101,202,106,200,34.0,33.3,34.6,00000
90.0,29.0,76.0,786,03,01,  Nuton Kandi Hati,147,433,71,236,76,197,25.3,23.1,27.8,00000
90.0,29.0,85.0,039,01,01,  Paschim Asram,327,669,162,355,165,314,32.8,31.3,34.4,00000
90.0,29.0,85.0,039,02,01,  Purba Asram,445,793,238,373,207,420,35.9,39.0,33.0,00000
90.0,29.0,85.0,234,01,01,  Daiyargaon,330,170,153,88,177,82,66.0,63.5,68.3,00000
90.0,29.0,85.0,234,02,01,  Islam Pur,50,397,25,191,25,206,11.2,11.6,10.8,00000
90.0,29.0,85.0,286,01,01,  Dhal (Bhati Dhal),458,972,204,525,254,447,32.0,28.0,36.2,00000
90.0,29.0,85.0,286,02,01,  Vzhara Out,215,818,104,433,111,385,20.8,19.4,22.4,00000
90.0,29.0,85.0,292,01,01,  Amirpur,180,403,82,183,98,220,30.9,30.9,30.8,00000
90.0,29.0,85.0,292,02,01,  Saraltoba,360,705,207,345,153,360,33.8,37.5,29.8,00000
90.0,29.0,85.0,292,03,01,  Ujandhal,305,605,150,314,155,291,33.5,32.3,34.8,00000
90.0,29.0,85.0,292,04,01,  Kadirpur,72,422,29,200,43,222,14.6,12.7,16.2,00000
90.0,29.0,85.0,845,01,01,  Noagaon,417,972,246,474,171,498,30.0,34.2,25.6,00000
90.0,29.0,85.0,845,02,01,  Santoshpur,86,163,44,88,42,75,34.5,33.3,35.9,00000
90.0,29.0,85.0,845,03,01,  Rajnagar,35,84,19,42,16,42,29.4,31.1,27.6,00000
90.0,29.0,85.0,845,04,01,  Talbausi,195,974,105,480,90,494,16.7,17.9,15.4,00000
90.0,32.0,21.0,399,01,01,  Holaskhali,5,134,4,69,1,65,3.6,5.5,1.5,00000
90.0,32.0,21.0,399,02,01,  Ghulua,228,645,119,333,109,312,26.1,26.3,25.9,00000
90.0,32.0,21.0,816,01,01,  Lalanbari,37,151,20,72,17,79,19.7,21.7,17.7,00000
90.0,32.0,21.0,816,02,01,  Barahati,29,77,19,38,10,39,27.4,33.3,20.4,00000
90.0,32.0,21.0,816,03,01,  Nayahati,73,303,30,149,43,154,19.4,16.8,21.8,00000
90.0,32.0,21.0,816,04,01,  Gazinagar,91,330,47,162,44,168,21.6,22.5,20.8,00000
90.0,32.0,21.0,816,05,01,  Dakshinhati,99,432,53,217,46,215,18.6,19.6,17.6,00000
90.0,32.0,21.0,816,06,01,  Agalhati,85,359,41,175,44,184,19.1,19.0,19.3,00000
90.0,32.0,21.0,816,07,01,  Rangpurhati,85,429,46,208,39,221,16.5,18.1,15.0,00000
90.0,32.0,21.0,969,01,01,  Tahirpur,28,364,25,189,3,175,7.1,11.7,1.7,00000
90.0,32.0,21.0,969,02,01,  Dayalpur,8,135,4,72,4,63,5.6,5.3,6.0,00000
90.0,32.0,21.0,969,03,01,  Gabindapur(Rahmatpur),25,284,15,140,10,144,8.1,9.7,6.5,00000
90.0,32.0,23.0,402,01,01,  Jalusha,273,892,152,438,121,454,23.4,25.8,21.0,00000
90.0,32.0,23.0,402,02,01,  Uttar Amjura,289,449,153,227,136,222,39.2,40.3,38.0,00000
90.0,32.0,23.0,402,03,01,  Dakshin Amjura,26,232,14,110,12,122,10.1,11.3,9.0,00000
90.0,32.0,23.0,402,04,01,  Dakshin Nagda Para,88,104,41,43,47,61,45.8,48.8,43.5,00000
90.0,32.0,23.0,402,05,01,  Uttar Nagda Para,73,62,37,24,36,38,54.1,60.7,48.6,00000
90.0,32.0,23.0,570,01,01,  Laudugnai,101,652,50,338,51,314,13.4,12.9,14.0,00000
90.0,32.0,23.0,570,02,01,  Laudugnai(Wapda),1,114,0,57,1,57,0.9,0.0,1.7,00000
90.0,32.0,23.0,927,01,01,  Sarifpur,73,231,38,108,35,123,24.0,26.0,22.2,00000
90.0,32.0,23.0,927,02,01,  Jagannathpur,0,68,0,36,0,32,0.0,0.0,0.0,00000
90.0,32.0,35.0,011,01,01,  Alampur,290,215,164,102,126,113,57.4,61.7,52.7,00000
90.0,32.0,35.0,011,02,01,  Roha,265,679,149,334,116,345,28.1,30.8,25.2,00000
90.0,32.0,35.0,055,01,01,  Bakhar Par,33,164,20,83,13,81,16.8,19.4,13.8,00000
90.0,32.0,35.0,055,02,01,  Joypur,75,277,43,141,32,136,21.3,23.4,19.0,00000
90.0,32.0,35.0,055,03,01,  Harinakanda,43,347,23,173,20,174,11.0,11.7,10.3,00000
90.0,32.0,35.0,100,01,01,  Bangshikunda,392,569,205,275,187,294,40.8,42.7,38.9,00000
90.0,32.0,35.0,100,02,01,  Noagaon,105,347,60,173,45,174,23.2,25.8,20.5,00000
90.0,32.0,35.0,223,01,01,  Dakshinura,104,352,62,176,42,176,22.8,26.1,19.3,00000
90.0,32.0,35.0,223,02,01,  Dhulpushi,72,252,38,125,34,127,22.2,23.3,21.1,00000
90.0,32.0,35.0,223,03,01,  Batta,42,408,27,188,15,220,9.3,12.6,6.4,00000
90.0,32.0,35.0,324,01,01,  Rangsi,157,1105,94,548,63,557,12.4,14.6,10.2,00000
90.0,32.0,35.0,324,02,01,  Khidirpur,65,232,31,120,34,112,21.9,20.5,23.3,00000
90.0,32.0,35.0,324,03,01,  Amanipur,108,329,58,154,50,175,24.7,27.4,22.2,00000
90.0,32.0,35.0,324,04,01,  Datia Para,266,804,145,395,121,409,24.9,26.9,22.8,00000
90.0,32.0,35.0,346,01,01,  Hatpatan,31,312,20,153,11,159,9.0,11.6,6.5,00000
90.0,32.0,35.0,346,02,01,  Nowabon,70,250,40,127,30,123,21.9,24.0,19.6,00000
90.0,32.0,35.0,525,01,01,  Kauahani,21,445,14,227,7,218,4.5,5.8,3.1,00000
90.0,32.0,35.0,525,02,01,  Makandi,18,131,15,72,3,59,12.1,17.2,4.8,00000
90.0,32.0,35.0,782,01,01,  Panarkuri,45,485,31,239,14,246,8.5,11.5,5.4,00000
90.0,32.0,35.0,782,02,01,  Garakata,278,665,179,308,99,357,29.5,36.8,21.7,00000
90.0,32.0,35.0,804,01,01,  Patkura,191,332,105,152,86,180,36.5,40.9,32.3,00000
90.0,32.0,35.0,804,02,01,  Gopaikuna,104,374,67,172,37,202,21.8,28.0,15.5,00000
90.0,32.0,35.0,827,01,01,  Rangamatia,123,227,71,95,52,132,35.1,42.8,28.3,00000
90.0,32.0,35.0,827,02,01,  Masimpur (Atasia),247,148,137,74,110,74,62.5,64.9,59.8,00000
90.0,32.0,35.0,883,01,01,  Sahapur,52,463,27,232,25,231,10.1,10.4,9.8,00000
90.0,32.0,35.0,883,03,01,  Bashraura,136,100,78,42,58,58,57.6,65.0,50.0,00000
90.0,32.0,35.0,939,01,01,  Satur,115,368,63,180,52,188,23.8,25.9,21.7,00000
90.0,32.0,35.0,939,02,01,  Jagannathpur,23,291,12,149,11,142,7.3,7.5,7.2,00000
90.0,32.0,38.0,068,01,01,  Rajnagar,159,632,81,322,78,310,20.1,20.1,20.1,00000
90.0,32.0,38.0,068,02,01,  Nalgora,92,274,50,150,42,124,25.1,25.0,25.3,00000
90.0,32.0,38.0,068,03,01,  Abuar Char,281,662,134,329,147,333,29.8,28.9,30.6,00000
90.0,32.0,38.0,306,01,01,  Deola,228,536,131,254,97,282,29.8,34.0,25.6,00000
90.0,32.0,38.0,306,02,01,  Janear Char,68,284,33,148,35,136,19.3,18.2,20.5,00000
90.0,32.0,38.0,306,03,01,  Rajdharpur,56,368,23,194,33,174,13.2,10.6,15.9,00000
90.0,32.0,38.0,306,04,01,  Madhupur,54,355,31,171,23,184,13.2,15.3,11.1,00000
90.0,32.0,38.0,306,05,01,  Noagaon,52,260,27,130,25,130,16.7,17.2,16.1,00000
90.0,32.0,38.0,314,01,03,  Dharmapasha,1718,1965,910,937,808,1028,46.6,49.3,44.0,00000
90.0,32.0,38.0,314,02,03,  Kamlabaj,1283,494,706,208,577,286,72.2,77.2,66.9,00000
90.0,32.0,38.0,314,03,03,  Fatemanagar,60,274,34,136,26,138,18.0,20.0,15.9,00000
90.0,32.0,38.0,314,04,03,  Niabanda,177,552,98,257,79,295,24.3,27.6,21.1,00000
90.0,32.0,38.0,323,01,01,  Dasadari,220,455,120,224,100,231,32.6,34.9,30.2,00000
90.0,32.0,38.0,323,02,01,  Dhudbahar,278,390,140,188,138,202,41.6,42.7,40.6,00000
90.0,32.0,38.0,323,03,01,  Bawhatia Kanda,72,188,38,88,34,100,27.7,30.2,25.4,00000
90.0,32.0,38.0,340,01,01,  Durbakanda,57,197,36,102,21,95,22.4,26.1,18.1,00000
90.0,32.0,38.0,340,02,01,  Maguar Char,38,202,22,106,16,96,15.8,17.2,14.3,00000
90.0,32.0,38.0,340,03,01,  Gofurkanda,26,65,11,31,15,34,28.6,26.2,30.6,00000
90.0,32.0,38.0,340,04,01,  Muradpur,8,58,5,30,3,28,12.1,14.3,9.7,00000
90.0,32.0,38.0,535,01,01,  Kanda Para,375,1336,201,678,174,658,21.9,22.9,20.9,00000
90.0,32.0,38.0,535,02,01,  Kykoria,58,238,25,110,33,128,19.6,18.5,20.5,00000
90.0,32.0,38.0,535,03,01,  Radhanagar,213,315,107,155,106,160,40.3,40.8,39.8,00000
90.0,32.0,38.0,535,04,01,  Keshabpur,29,289,17,149,12,140,9.1,10.2,7.9,00000
90.0,32.0,38.0,926,01,01,  Halidakanda,776,2307,415,1086,361,1221,25.2,27.6,22.8,00000
90.0,32.0,38.0,926,02,01,  Sonajana,22,239,13,121,9,118,8.4,9.7,7.1,00000
90.0,32.0,38.0,926,03,01,  Mahisher Batan,16,192,11,105,5,87,7.7,9.5,5.4,00000
90.0,32.0,47.0,076,01,01,  Baghauchha,490,999,253,510,237,489,32.9,33.2,32.6,00000
90.0,32.0,47.0,076,02,01,  Sakargaon,209,396,116,196,93,200,34.5,37.2,31.7,00000
90.0,32.0,47.0,153,01,01,  Rajapur,26,194,13,101,13,93,11.8,11.4,12.3,00000
90.0,32.0,47.0,153,02,01,  Sanbari,129,379,72,177,57,202,25.4,28.9,22.0,00000
90.0,32.0,47.0,153,03,01,  Banarashipur,61,485,32,246,29,239,11.2,11.5,10.8,00000
90.0,32.0,47.0,416,01,01,  Haripur,200,725,100,361,100,364,21.6,21.7,21.6,00000
90.0,32.0,47.0,416,02,01,  Shantipur,87,592,43,297,44,295,12.8,12.6,13.0,00000
90.0,32.0,47.0,484,01,01,  Durgapur,154,519,87,259,67,260,22.9,25.1,20.5,00000
90.0,32.0,47.0,484,02,01,  Joysree,203,441,100,222,103,219,31.5,31.1,32.0,00000
90.0,32.0,47.0,484,03,01,  Rajendrapur,117,294,61,130,56,164,28.5,31.9,25.5,00000
90.0,32.0,47.0,484,04,01,  Mafiznagar,41,171,26,73,15,98,19.3,26.3,13.3,00000
90.0,32.0,57.0,033,01,01,  Anwarpur,115,139,62,59,53,80,45.3,51.2,39.8,00000
90.0,32.0,57.0,033,02,01,  Shibrampur,58,364,30,166,28,198,13.7,15.3,12.4,00000
90.0,32.0,57.0,067,01,01,  Baithakhali,115,98,46,50,69,48,54.0,47.9,59.0,00000
90.0,32.0,57.0,067,02,01,  Maij Para,52,49,24,27,28,22,51.5,47.1,56.0,00000
90.0,32.0,57.0,067,03,01,  Guchagram,33,170,15,79,18,91,16.3,16.0,16.5,00000
90.0,32.0,57.0,357,01,01,  Inatnagar,96,772,47,402,49,370,11.1,10.5,11.7,00000
90.0,32.0,57.0,357,02,01,  Kamaura,151,562,70,275,81,287,21.2,20.3,22.0,00000
90.0,32.0,57.0,380,01,01,  Haripur,119,175,64,82,55,93,40.5,43.8,37.2,00000
90.0,32.0,57.0,380,02,01,  Noagaon,102,299,57,139,45,160,25.4,29.1,22.0,00000
90.0,32.0,57.0,391,01,01,  Jalalpur,84,224,48,91,36,133,27.3,34.5,21.3,00000
90.0,32.0,57.0,391,02,01,  Anantapur,8,195,4,100,4,95,3.9,3.8,4.0,00000
90.0,32.0,57.0,391,04,01,  Arippur,40,350,21,158,19,192,10.3,11.7,9.0,00000
90.0,32.0,57.0,413,01,01,  Teli Para,163,615,93,292,70,323,21.0,24.2,17.8,00000
90.0,32.0,57.0,413,02,01,  Piprakanda,202,175,131,79,71,96,53.6,62.4,42.5,00000
90.0,32.0,57.0,480,01,01,  Kanda Para,96,199,61,105,35,94,32.5,36.7,27.1,00000
90.0,32.0,57.0,480,02,01,  Ethauri (Etnauri),111,355,65,167,46,188,23.8,28.0,19.7,00000
90.0,32.0,57.0,614,01,03,  Purbapara,163,118,75,53,88,65,58.0,58.6,57.5,00000
90.0,32.0,57.0,614,02,03,  Maij Para,128,65,70,29,58,36,66.3,70.7,61.7,00000
90.0,32.0,57.0,614,03,03,  Paschimpara,74,73,36,30,38,43,50.3,54.5,46.9,00000
90.0,32.0,57.0,614,04,03,  Haor Para,37,107,20,53,17,54,25.7,27.4,23.9,00000
90.0,32.0,57.0,614,05,03,  Chhota Sekh Para,113,206,57,109,56,97,35.4,34.3,36.6,00000
90.0,32.0,57.0,614,06,03,  Bara Sekh Para,67,126,37,60,30,66,34.7,38.1,31.3,00000
90.0,32.0,57.0,614,07,03,  Sonai Para,77,254,44,133,33,121,23.3,24.9,21.4,00000
90.0,32.0,57.0,614,08,03,  Shaliani Para,153,322,82,169,71,153,32.2,32.7,31.7,00000
90.0,32.0,57.0,614,09,03,  Madhyanagar,766,501,449,283,317,218,60.5,61.3,59.3,00000
90.0,32.0,57.0,622,01,01,  Khalisakanda,440,125,233,54,207,71,77.9,81.2,74.5,00000
90.0,32.0,57.0,622,02,01,  Noapara,88,23,43,11,45,12,79.3,79.6,78.9,00000
90.0,32.0,66.0,127,01,01,  Balia,78,55,38,29,40,26,58.6,56.7,60.6,00000
90.0,32.0,66.0,127,02,01,  Madanpur,36,23,16,11,20,12,61.0,59.3,62.5,00000
90.0,32.0,66.0,170,01,01,  Baraihati,90,424,45,213,45,211,17.5,17.4,17.6,00000
90.0,32.0,66.0,170,02,01,  Geria Para,131,155,67,77,64,78,45.8,46.5,45.1,00000
90.0,32.0,66.0,170,03,01,  Bukri Para,32,60,13,34,19,26,34.8,27.7,42.2,00000
90.0,32.0,66.0,178,01,01,  Jamalpur,105,351,51,183,54,168,23.0,21.8,24.3,00000
90.0,32.0,66.0,178,02,01,  Naya Para,8,108,4,63,4,45,6.9,6.0,8.2,00000
90.0,32.0,66.0,178,03,01,  Bara Khurdarpur,3,14,2,5,1,9,17.6,28.6,10.0,00000
90.0,32.0,66.0,178,04,01,  Bamlahati,70,290,41,137,29,153,19.4,23.0,15.9,00000
90.0,32.0,66.0,187,01,01,  Baulam,323,831,147,406,176,425,28.0,26.6,29.3,00000
90.0,32.0,66.0,187,02,01,  Mukinpur,275,445,143,219,132,226,38.2,39.5,36.9,00000
90.0,32.0,66.0,187,03,01,  Badshaganj Bazar,131,104,67,47,64,57,55.7,58.8,52.9,00000
90.0,32.0,66.0,603,01,01,  Lengur,151,278,82,138,69,140,35.2,37.3,33.0,00000
90.0,32.0,66.0,603,02,01,  Janglegara,248,775,106,385,142,390,24.2,21.6,26.7,00000
90.0,32.0,66.0,603,03,01,  Daspara,228,424,115,209,113,215,35.0,35.5,34.5,00000
90.0,32.0,66.0,603,04,01,  Bara Khola,37,576,19,274,18,302,6.0,6.5,5.6,00000
90.0,32.0,66.0,603,05,01,  Barikandi,258,684,118,358,140,326,27.4,24.8,30.0,00000
90.0,32.0,66.0,765,01,01,  Nizampur,170,271,95,132,75,139,38.5,41.9,35.0,00000
90.0,32.0,66.0,765,02,01,  Baghbari,55,93,22,48,33,45,37.2,31.4,42.3,00000
90.0,32.0,66.0,782,01,01,  Paikrati,206,481,111,232,95,249,30.0,32.4,27.6,00000
90.0,32.0,66.0,782,02,01,  Sultanpur,89,294,43,137,46,157,23.2,23.9,22.7,00000
90.0,32.0,66.0,782,03,01,  Kurikhania,143,581,67,293,76,288,19.8,18.6,20.9,00000
90.0,32.0,66.0,824,01,01,  Rajapur,161,752,83,396,78,356,17.6,17.3,18.0,00000
90.0,32.0,66.0,824,02,01,  Roypur,30,337,18,159,12,178,8.2,10.2,6.3,00000
90.0,32.0,66.0,824,03,01,  Hijla,38,385,23,193,15,192,9.0,10.6,7.2,00000
90.0,32.0,66.0,875,01,01,  Sairtali,94,127,44,62,50,65,42.5,41.5,43.5,00000
90.0,32.0,66.0,875,02,01,  Thanura,285,341,123,173,162,168,45.5,41.6,49.1,00000
90.0,32.0,66.0,875,03,01,  Pachan,142,131,64,67,78,64,52.0,48.9,54.9,00000
90.0,32.0,76.0,017,01,01,  Ahammadpur,246,281,117,141,129,140,46.7,45.3,48.0,00000
90.0,32.0,76.0,017,02,01,  Binnamuri,48,28,24,9,24,19,63.2,72.7,55.8,00000
90.0,32.0,76.0,357,01,01,  Bandgabi,496,825,241,375,255,450,37.5,39.1,36.2,00000
90.0,32.0,76.0,357,02,01,  Nijgabi,473,1368,251,647,222,721,25.7,28.0,23.5,00000
90.0,32.0,76.0,357,03,01,  Desantar,13,35,4,19,9,16,27.1,17.4,36.0,00000
90.0,32.0,76.0,357,04,01,  Bahirbari,28,190,13,98,15,92,12.8,11.7,14.0,00000
90.0,32.0,76.0,357,05,01,  Lakshimpur,9,65,4,32,5,33,12.2,11.1,13.2,00000
90.0,32.0,76.0,408,01,01,  Habibpur (Madhabpur),9,65,3,35,6,30,12.2,7.9,16.7,00000
90.0,32.0,76.0,408,02,01,  Mudaharpur,120,513,69,239,51,274,19.0,22.4,15.7,00000
90.0,32.0,76.0,544,01,01,  Kakiam,41,112,16,61,25,51,26.8,20.8,32.9,00000
90.0,32.0,76.0,544,02,01,  Mahammadpur,179,570,85,280,94,290,23.9,23.3,24.5,00000
90.0,32.0,76.0,544,03,01,  Khala Para,202,378,105,174,97,204,34.8,37.6,32.2,00000
90.0,32.0,76.0,705,01,01,  Mirzapur,139,202,70,107,69,95,40.8,39.5,42.1,00000
90.0,32.0,76.0,705,02,01,  Bari Kandi,10,83,3,37,7,46,10.8,7.5,13.2,00000
90.0,32.0,76.0,884,01,01,  Saiyadpur,448,596,250,287,198,309,42.9,46.6,39.1,00000
90.0,32.0,76.0,884,02,01,  Munsurnagar,27,20,13,8,14,12,57.4,61.9,53.8,00000
90.0,32.0,76.0,884,03,01,  Latifpur,31,8,14,3,17,5,79.5,82.4,77.3,00000
90.0,32.0,76.0,892,01,01,  Salap,283,620,146,285,137,335,31.3,33.9,29.0,00000
90.0,32.0,76.0,892,02,01,  Palpara,32,187,16,98,16,89,14.6,14.0,15.2,00000
90.0,32.0,76.0,892,03,01,  Rangpur,29,121,16,54,13,67,19.3,22.9,16.3,00000
90.0,32.0,85.0,120,01,01,  Baghbari,113,227,61,121,52,106,33.2,33.5,32.9,00000
90.0,32.0,85.0,120,02,01,  Nayagaon,71,153,39,77,32,76,31.7,33.6,29.6,00000
90.0,32.0,85.0,120,03,01,  Malaypur,55,97,28,51,27,46,36.2,35.4,37.0,00000
90.0,32.0,85.0,190,01,01,  Babupur,129,353,74,181,55,172,26.8,29.0,24.2,00000
90.0,32.0,85.0,190,02,01,  Asmatpur,36,134,19,70,17,64,21.2,21.3,21.0,00000
90.0,32.0,85.0,190,03,01,  Bahadur Pur,144,233,82,119,62,114,38.2,40.8,35.2,00000
90.0,32.0,85.0,190,04,01,  Digjan,280,380,150,167,130,213,42.4,47.3,37.9,00000
90.0,32.0,85.0,190,05,01,  Jahangir Nagar,4,21,2,11,2,10,16.0,15.4,16.7,00000
90.0,32.0,85.0,190,06,01,  Baulai Ganj,269,393,133,199,136,194,40.6,40.1,41.2,00000
90.0,32.0,85.0,425,01,01,  Islampur,334,420,180,197,154,223,44.3,47.7,40.8,00000
90.0,32.0,85.0,425,02,01,  Shantipur,140,450,84,210,56,240,23.7,28.6,18.9,00000
90.0,32.0,85.0,425,03,01,  Sariatpur,129,567,73,266,56,301,18.5,21.5,15.7,00000
90.0,32.0,85.0,425,04,01,  Kazirgaon,126,318,60,167,66,151,28.4,26.4,30.4,00000
90.0,32.0,85.0,425,05,01,  Berirpar,182,441,93,221,89,220,29.2,29.6,28.8,00000
90.0,32.0,85.0,425,06,01,  Galakpur Bazar,27,28,22,16,5,12,49.1,57.9,29.4,00000
90.0,32.0,85.0,425,07,01,  Fazilpur,66,189,41,86,25,103,25.9,32.3,19.5,00000
90.0,32.0,85.0,425,08,01,  Golakpur,114,85,59,44,55,41,57.3,57.3,57.3,00000
90.0,32.0,85.0,425,09,01,  Hajipur,34,175,23,89,11,86,16.3,20.5,11.3,00000
90.0,32.0,85.0,500,01,01,  Kismat Sukhair (Sukhair),239,521,130,259,109,262,31.4,33.4,29.4,00000
90.0,32.0,85.0,500,02,01,  Anwer Pur,34,251,14,115,20,136,11.9,10.9,12.8,00000
90.0,32.0,85.0,780,01,01,  Pathariakanda,39,162,26,81,13,81,19.4,24.3,13.8,00000
90.0,32.0,85.0,780,02,01,  Malipur,9,98,5,54,4,44,8.4,8.5,8.3,00000
90.0,32.0,85.0,820,01,01,  Sharishakanda,114,435,61,221,53,214,20.8,21.6,19.9,00000
90.0,32.0,85.0,820,02,01,  Islampur,272,760,152,412,120,348,26.4,27.0,25.6,00000
90.0,32.0,85.0,945,01,01,  Bandharbari,7,52,1,31,6,21,11.9,3.1,22.2,00000
90.0,32.0,85.0,945,02,01,  Sukhair Nij,188,665,105,354,83,311,22.0,22.9,21.1,00000
90.0,32.0,90.0,022,01,01,  Antarpur,66,313,32,166,34,147,17.4,16.2,18.8,00000
90.0,32.0,90.0,022,02,01,  Rupnagar,269,981,137,514,132,467,21.5,21.0,22.0,00000
90.0,32.0,90.0,022,03,01,  Rajendrapur (Rupnagar),55,107,29,64,26,43,34.0,31.2,37.7,00000
90.0,32.0,90.0,111,01,01,  Beheratali,119,209,67,106,52,103,36.3,38.7,33.5,00000
90.0,32.0,90.0,111,02,01,  Banda,75,287,50,139,25,148,20.7,26.5,14.5,00000
90.0,32.0,90.0,122,01,01,  Bholaganj,81,178,44,86,37,92,31.3,33.8,28.7,00000
90.0,32.0,90.0,122,02,01,  Sreepur,89,181,47,80,42,101,33.0,37.0,29.4,00000
90.0,32.0,90.0,122,03,01,  Nababpur,122,219,63,108,59,111,35.8,36.8,34.7,00000
90.0,32.0,90.0,122,04,01,  Issamari,64,357,32,180,32,177,15.2,15.1,15.3,00000
90.0,32.0,90.0,122,05,01,  Golgaon,153,256,78,137,75,119,37.4,36.3,38.7,00000
90.0,32.0,90.0,268,01,01,  Kalaghar,462,1064,246,531,216,533,30.3,31.7,28.8,00000
90.0,32.0,90.0,268,02,01,  Said Para,341,1108,195,536,146,572,23.5,26.7,20.3,00000
90.0,32.0,90.0,424,01,01,  Jamalpur,168,442,90,215,78,227,27.5,29.5,25.6,00000
90.0,32.0,90.0,424,02,01,  Kartikpur,404,954,211,448,193,506,29.7,32.0,27.6,00000
90.0,32.0,90.0,424,03,01,  Rampur,91,437,40,236,51,201,17.2,14.5,20.2,00000
90.0,32.0,90.0,558,01,01,  Lakshmipur,65,239,34,106,31,133,21.4,24.3,18.9,00000
90.0,32.0,90.0,558,02,01,  Karebari,108,254,58,120,50,134,29.8,32.6,27.2,00000
90.0,32.0,90.0,558,03,01,  Matirbanda,183,609,94,302,89,307,23.1,23.7,22.5,00000
90.0,32.0,90.0,637,01,01,  Mahishkhola,250,92,161,45,89,47,73.1,78.2,65.4,00000
90.0,32.0,90.0,637,02,01,  Mohanpur,106,312,71,150,35,162,25.4,32.1,17.8,00000
90.0,32.0,90.0,637,03,01,  Rangpur,141,377,69,187,72,190,27.2,27.0,27.5,00000
90.0,32.0,90.0,637,04,01,  Kalipur,74,132,45,59,29,73,35.9,43.3,28.4,00000
90.0,32.0,90.0,637,05,01,  Hossainpur,114,309,63,158,51,151,27.0,28.5,25.2,00000
90.0,32.0,90.0,715,01,01,  Bangalbeta,212,366,116,187,96,179,36.7,38.3,34.9,00000
90.0,32.0,90.0,715,02,01,  Majearsara,130,457,73,230,57,227,22.1,24.1,20.1,00000
90.0,32.0,90.0,715,03,01,  Gilagara,40,269,27,130,13,139,12.9,17.2,8.6,00000
90.0,32.0,90.0,715,04,01,  Bakatala,257,761,153,349,104,412,25.2,30.5,20.2,00000
90.0,32.0,90.0,715,05,01,  Kaydakona,48,57,23,26,25,31,45.7,46.9,44.6,00000
90.0,32.0,90.0,715,06,01,  Rangsi Para,74,179,40,88,34,91,29.2,31.3,27.2,00000
90.0,32.0,90.0,715,07,01,  Kalta Para,38,150,21,68,17,82,20.2,23.6,17.2,00000
90.0,33.0,21.0,014,01,01,  Champerghat,343,336,168,157,175,179,50.5,51.7,49.4,00000
90.0,33.0,21.0,014,02,01,  Bougla,317,290,163,132,154,158,52.2,55.3,49.4,00000
90.0,33.0,21.0,014,03,01,  Bagahana,91,221,38,107,53,114,29.2,26.2,31.7,00000
90.0,33.0,21.0,014,04,01,  Nawadar,136,176,64,93,72,83,43.6,40.8,46.5,00000
90.0,33.0,21.0,021,01,01,  Ramnagar,115,203,53,89,62,114,36.2,37.3,35.2,00000
90.0,33.0,21.0,021,02,01,  Terakuri,67,163,35,75,32,88,29.1,31.8,26.7,00000
90.0,33.0,21.0,078,01,01,  Bahargaon,189,416,92,201,97,215,31.2,31.4,31.1,00000
90.0,33.0,21.0,078,02,01,  Chanderghat,122,170,65,66,57,104,41.8,49.6,35.4,00000
90.0,33.0,21.0,078,03,01,  Nayagaon,134,211,58,106,76,105,38.8,35.4,42.0,00000
90.0,33.0,21.0,078,04,01,  Mollah Para,170,134,85,66,85,68,55.9,56.3,55.6,00000
90.0,33.0,21.0,078,05,01,  Napalkuti,87,219,40,116,47,103,28.4,25.6,31.3,00000
90.0,33.0,21.0,341,01,01,  Edukona,204,440,95,201,109,239,31.7,32.1,31.3,00000
90.0,33.0,21.0,341,02,01,  Feshkargaon,197,177,100,82,97,95,52.7,54.9,50.5,00000
90.0,33.0,21.0,341,03,01,  Baganbari,374,368,190,154,184,214,50.4,55.2,46.2,00000
90.0,33.0,21.0,341,04,01,  Chamdar,0,2,0,1,0,1,0.0,0.0,0.0,00000
90.0,33.0,21.0,341,05,01,  Gachhgara,183,447,85,211,98,236,29.0,28.7,29.3,00000
90.0,33.0,21.0,341,06,01,  Rajapur,31,117,18,59,13,58,20.9,23.4,18.3,00000
90.0,33.0,21.0,341,07,01,  Darmapur Khaiajuri,232,421,117,223,115,198,35.5,34.4,36.7,00000
90.0,33.0,21.0,341,08,01,  Khaiajuri,130,251,64,130,66,121,34.1,33.0,35.3,00000
90.0,33.0,21.0,405,01,01,  Ashirnagar,100,230,39,112,61,118,30.3,25.8,34.1,00000
90.0,33.0,21.0,405,02,01,  Kabirnagar,121,196,59,99,62,97,38.2,37.3,39.0,00000
90.0,33.0,21.0,405,03,01,  Kandagaon,99,248,49,114,50,134,28.5,30.1,27.2,00000
90.0,33.0,21.0,874,01,01,  Sonachora,168,150,79,65,89,85,52.8,54.9,51.1,00000
90.0,33.0,21.0,874,02,01,  Balichhara,204,418,98,203,106,215,32.8,32.6,33.0,00000
90.0,33.0,27.0,092,01,03,  Bajitpur,346,1567,175,758,171,809,18.1,18.8,17.4,00000
90.0,33.0,27.0,092,02,03,  Purba Machimpur,194,1065,101,506,93,559,15.4,16.6,14.3,00000
90.0,33.0,27.0,092,03,03,  Paschim Machimpur,242,872,118,456,124,416,21.7,20.6,23.0,00000
90.0,33.0,27.0,092,04,03,  Dowarabazar,714,339,419,194,295,145,67.8,68.4,67.0,00000
90.0,33.0,27.0,092,05,03,  Muradpur,190,393,112,176,78,217,32.6,38.9,26.4,00000
90.0,33.0,27.0,262,01,01,  Dalairgaon,98,241,44,109,54,132,28.9,28.8,29.0,00000
90.0,33.0,27.0,262,02,01,  Rakhalkandi,59,415,28,198,31,217,12.4,12.4,12.5,00000
90.0,33.0,27.0,262,03,01,  Birsingha,221,275,120,116,101,159,44.6,50.8,38.8,00000
90.0,33.0,27.0,262,04,01,  Batlartek,42,120,21,53,21,67,25.9,28.4,23.9,00000
90.0,33.0,27.0,646,01,03,  Manglargaon,354,138,181,60,173,78,72.0,75.1,68.9,00000
90.0,33.0,27.0,646,02,03,  Dakshin Barabanda,36,530,22,269,14,261,6.4,7.6,5.1,00000
90.0,33.0,27.0,646,03,03,  Purba Naingaon,199,481,116,227,83,254,29.3,33.8,24.6,00000
90.0,33.0,27.0,646,04,03,  Paschim Naingaon,481,792,256,363,225,429,37.8,41.4,34.4,00000
90.0,33.0,27.0,646,05,03,  Teganga,27,241,17,116,10,125,10.1,12.8,7.4,00000
90.0,33.0,27.0,646,06,03,  Majhergaon,118,423,73,207,45,216,21.8,26.1,17.2,00000
90.0,33.0,27.0,646,07,03,  Raynagar,47,499,25,255,22,244,8.6,8.9,8.3,00000
90.0,33.0,27.0,646,08,03,  Bagra,41,310,18,158,23,152,11.7,10.2,13.1,00000
90.0,33.0,27.0,646,09,03,  Maijkhala,25,102,8,50,17,52,19.7,13.8,24.6,00000
90.0,33.0,27.0,646,10,03,  Uttar Baraband,93,857,48,434,45,423,9.8,10.0,9.6,00000
90.0,33.0,27.0,696,01,01,  Parameshwaripur,373,474,197,215,176,259,44.0,47.8,40.5,00000
90.0,33.0,27.0,696,02,01,  Raispur,55,192,19,102,36,90,22.3,15.7,28.6,00000
90.0,33.0,27.0,696,03,01,  Teblai,192,804,111,388,81,416,19.3,22.2,16.3,00000
90.0,33.0,27.0,696,04,01,  Sundarpai,33,168,23,84,10,84,16.4,21.5,10.6,00000
90.0,33.0,27.0,824,01,01,  Paschim Lamasania,88,1007,50,525,38,482,8.0,8.7,7.3,00000
90.0,33.0,27.0,824,02,01,  Andha Manikpur Bazar,20,44,14,22,6,22,31.3,38.9,21.4,00000
90.0,33.0,32.0,067,01,01,  Kandagaon,187,507,92,244,95,263,26.9,27.4,26.5,00000
90.0,33.0,32.0,067,02,01,  Nayagaon,117,507,64,236,53,271,18.8,21.3,16.4,00000
90.0,33.0,32.0,089,01,01,  Bhabanipur,177,819,100,385,77,434,17.8,20.6,15.1,00000
90.0,33.0,32.0,089,02,01,  Kumarikandi,53,258,32,115,21,143,17.0,21.8,12.8,00000
90.0,33.0,32.0,666,01,01,  Niamatpur,73,182,40,82,33,100,28.6,32.8,24.8,00000
90.0,33.0,32.0,666,02,01,  Angam,19,44,8,24,11,20,30.2,25.0,35.5,00000
90.0,33.0,32.0,695,01,01,  Panail,835,2077,424,999,411,1078,28.7,29.8,27.6,00000
90.0,33.0,32.0,695,02,01,  Ulura,75,263,38,120,37,143,22.2,24.1,20.6,00000
90.0,33.0,32.0,695,03,01,  Dewan Nagar,85,452,31,207,54,245,15.8,13.0,18.1,00000
90.0,33.0,32.0,745,01,01,  Pratabpur,383,858,188,375,195,483,30.9,33.4,28.8,00000
90.0,33.0,32.0,745,02,01,  Goarai,72,154,38,69,34,85,31.9,35.5,28.6,00000
90.0,33.0,61.0,099,01,01,  Idrispur,138,209,64,103,74,106,39.8,38.3,41.1,00000
90.0,33.0,61.0,099,02,01,  Baktarpur,550,1060,292,489,258,571,34.2,37.4,31.1,00000
90.0,33.0,61.0,099,03,01,  Mirpur,101,409,54,203,47,206,19.8,21.0,18.6,00000
90.0,33.0,61.0,099,04,01,  Dhigirpar,71,75,32,33,39,42,48.6,49.2,48.1,00000
90.0,33.0,61.0,270,01,01,  Rahamatpur,32,230,14,92,18,138,12.2,13.2,11.5,00000
90.0,33.0,61.0,520,01,01,  Rasrai,192,433,94,188,98,245,30.7,33.3,28.6,00000
90.0,33.0,61.0,520,02,01,  Naya Para,152,445,79,218,73,227,25.5,26.6,24.3,00000
90.0,33.0,61.0,596,01,01,  Daulatpur,209,331,114,152,95,179,38.7,42.9,34.7,00000
90.0,33.0,61.0,596,02,01,  Matgaon,478,967,234,462,244,505,33.1,33.6,32.6,00000
90.0,33.0,61.0,596,03,01,  Bhanga Para,347,605,170,288,177,317,36.4,37.1,35.8,00000
90.0,33.0,61.0,867,01,01,  Sultanpur,92,219,52,95,40,124,29.6,35.4,24.4,00000
90.0,33.0,61.0,867,02,01,  Natun Baithakhai,76,255,46,125,30,130,23.0,26.9,18.8,00000
90.0,33.0,61.0,888,01,01,  Delwarnagar,167,438,104,218,63,220,27.6,32.3,22.3,00000
90.0,33.0,61.0,888,02,01,  Surigaon,160,441,82,225,78,216,26.6,26.7,26.5,00000
90.0,33.0,61.0,888,03,01,  Shefaligaon,136,195,68,93,68,102,41.1,42.2,40.0,00000
90.0,33.0,61.0,888,04,01,  Choklapur,20,68,10,32,10,36,22.7,23.8,21.7,00000
90.0,33.0,61.0,888,05,01,  Ranabhumi,87,394,46,189,41,205,18.1,19.6,16.7,00000
90.0,33.0,61.0,888,06,01,  Jamalpur,98,81,58,36,40,45,54.7,61.7,47.1,00000
90.0,33.0,61.0,888,07,01,  Telurakandi,81,691,48,352,33,339,10.5,12.0,8.9,00000
90.0,33.0,61.0,888,08,01,  Fatehpur,194,385,99,185,95,200,33.5,34.9,32.2,00000
90.0,33.0,61.0,888,09,01,  Chandanpur,55,260,24,130,31,130,17.5,15.6,19.3,00000
90.0,33.0,61.0,888,10,01,  Taradal,61,233,38,111,23,122,20.7,25.5,15.9,00000
90.0,33.0,61.0,888,11,01,  Kalaiura,56,184,23,81,33,103,23.3,22.1,24.3,00000
90.0,33.0,61.0,994,01,01,  Akilpur,77,239,33,97,44,142,24.4,25.4,23.7,00000
90.0,33.0,61.0,994,02,01,  Uttar Solaimanpur,225,142,125,76,100,66,61.3,62.2,60.2,00000
90.0,33.0,61.0,994,03,01,  Islampur,77,206,37,82,40,124,27.2,31.1,24.4,00000
90.0,33.0,67.0,042,01,01,  Ulukandi,155,287,69,144,86,143,35.1,32.4,37.6,00000
90.0,33.0,67.0,042,02,01,  Edanpur,185,659,89,315,96,344,21.9,22.0,21.8,00000
90.0,33.0,67.0,042,03,01,  Ansafnagar,36,148,21,68,15,80,19.6,23.6,15.8,00000
90.0,33.0,67.0,042,04,01,  Ajampur,529,1102,267,504,262,598,32.4,34.6,30.5,00000
90.0,33.0,67.0,042,05,01,  Ajrafnagar,44,155,30,79,14,76,22.1,27.5,15.6,00000
90.0,33.0,67.0,042,06,01,  Ahamadnagar,87,166,47,73,40,93,34.4,39.2,30.1,00000
90.0,33.0,67.0,049,01,01,  Badarpur,253,523,136,228,117,295,32.6,37.4,28.4,00000
90.0,33.0,67.0,049,02,01,  Basantapur,220,587,104,270,116,317,27.3,27.8,26.8,00000
90.0,33.0,67.0,049,03,01,  Aminpur,20,53,10,30,10,23,27.4,25.0,30.3,00000
90.0,33.0,67.0,298,01,01,  Dholpushi,253,610,128,293,125,317,29.3,30.4,28.3,00000
90.0,33.0,67.0,298,02,01,  Chandipur,57,350,39,164,18,186,14.0,19.2,8.8,00000
90.0,33.0,67.0,312,01,01,  Durgapur,200,201,111,100,89,101,49.9,52.6,46.8,00000
90.0,33.0,67.0,312,02,01,  Dombanda,107,268,57,124,50,144,28.5,31.5,25.8,00000
90.0,33.0,67.0,369,01,01,  Jogirgaon,171,884,83,429,88,455,16.2,16.2,16.2,00000
90.0,33.0,67.0,369,02,01,  Ambari Bazar,234,179,121,68,113,111,56.7,64.0,50.4,00000
90.0,33.0,67.0,369,03,01,  Ambarigram,244,562,116,260,128,302,30.3,30.9,29.8,00000
90.0,33.0,67.0,369,04,01,  Gopalpur,270,634,159,300,111,334,29.9,34.6,24.9,00000
90.0,33.0,67.0,369,05,01,  Gonargaon,187,396,99,185,88,211,32.1,34.9,29.4,00000
90.0,33.0,67.0,369,06,01,  Sreenathpur,77,274,41,132,36,142,21.9,23.7,20.2,00000
90.0,33.0,67.0,575,01,01,  Mannargaon,652,717,303,336,349,381,47.6,47.4,47.8,00000
90.0,33.0,67.0,575,02,01,  Hazarigaon,353,647,188,293,165,354,35.3,39.1,31.8,00000
90.0,33.0,67.0,710,01,01,  Paschim Kamargaon,141,254,65,95,76,159,35.7,40.6,32.3,00000
90.0,33.0,67.0,710,02,01,  Nayagaon,141,432,63,222,78,210,24.6,22.1,27.1,00000
90.0,33.0,67.0,717,01,01,  Pirijpur,136,483,58,234,78,249,22.0,19.9,23.9,00000
90.0,33.0,67.0,717,02,01,  Baderampur,148,332,81,162,67,170,30.8,33.3,28.3,00000
90.0,33.0,67.0,717,03,01,  Rampur,533,576,254,259,279,317,48.1,49.5,46.8,00000
90.0,33.0,67.0,717,04,01,  Islampur,125,179,52,88,73,91,41.1,37.1,44.5,00000
90.0,33.0,67.0,753,01,01,  Jalalpur,290,571,122,282,168,289,33.7,30.2,36.8,00000
90.0,33.0,67.0,753,02,01,  Putipushi,189,219,83,108,106,111,46.3,43.5,48.8,00000
90.0,33.0,78.0,234,01,01,  Chengaya,302,745,146,335,156,410,28.8,30.4,27.6,00000
90.0,33.0,78.0,234,02,01,  Shahebergaon,421,613,206,311,215,302,40.7,39.8,41.6,00000
90.0,33.0,78.0,275,01,01,  Dukrua,57,154,28,80,29,74,27.0,25.9,28.2,00000
90.0,33.0,78.0,275,02,01,  Afsar Nagar,133,629,71,304,62,325,17.5,18.9,16.0,00000
90.0,33.0,78.0,277,01,01,  Asaknagar,125,297,64,148,61,149,29.6,30.2,29.0,00000
90.0,33.0,78.0,277,02,01,  Gazinagar,74,284,48,123,26,161,20.7,28.1,13.9,00000
90.0,33.0,78.0,277,03,01,  Daukerkara,118,581,72,280,46,301,16.9,20.5,13.3,00000
90.0,33.0,78.0,277,04,01,  Ratinagar,105,311,53,138,52,173,25.2,27.7,23.1,00000
90.0,33.0,78.0,277,05,01,  Raispur,88,114,55,48,33,66,43.6,53.4,33.3,00000
90.0,33.0,78.0,277,06,01,  Arshadnagar,18,120,12,57,6,63,13.0,17.4,8.7,00000
90.0,33.0,78.0,376,01,01,  Gupinagar,113,456,64,216,49,240,19.9,22.9,17.0,00000
90.0,33.0,78.0,376,02,01,  Haripadhanagar,163,288,71,134,92,154,36.1,34.6,37.4,00000
90.0,33.0,78.0,376,03,01,  Natun Nagar,145,836,56,441,89,395,14.8,11.3,18.4,00000
90.0,33.0,78.0,376,04,01,  Bahadurpur (Part),316,658,164,310,152,348,32.4,34.6,30.4,00000
90.0,33.0,78.0,525,01,01,  Radhanagar,81,449,42,209,39,240,15.3,16.7,14.0,00000
90.0,33.0,78.0,525,02,01,  Puran Krishnanagar,130,433,71,193,59,240,23.1,26.9,19.7,00000
90.0,33.0,78.0,525,03,01,  Natun Krishnanagar,204,706,88,331,116,375,22.4,21.0,23.6,00000
90.0,33.0,78.0,568,01,01,  Paschim Pandergoan,279,757,130,373,149,384,26.9,25.8,28.0,00000
90.0,33.0,78.0,568,02,01,  Purba Pandergaon,252,572,145,289,107,283,30.6,33.4,27.4,00000
90.0,33.0,78.0,651,01,01,  Mastandergaon,39,72,27,33,12,39,35.1,45.0,23.5,00000
90.0,33.0,78.0,651,02,01,  Hossairgaon,115,259,58,122,57,137,30.7,32.2,29.4,00000
90.0,33.0,78.0,651,03,01,  Nalua,142,574,73,276,69,298,19.8,20.9,18.8,00000
90.0,33.0,81.0,085,01,01,  Baithakhali,72,285,34,144,38,141,20.2,19.1,21.2,00000
90.0,33.0,81.0,085,02,01,  Hasan Bahar,94,244,45,109,49,135,27.8,29.2,26.6,00000
90.0,33.0,81.0,085,03,01,  Alipur,364,662,192,298,172,364,35.5,39.2,32.1,00000
90.0,33.0,81.0,106,01,01,  Tengra Haor,640,469,317,217,323,252,57.7,59.4,56.2,00000
90.0,33.0,81.0,106,02,01,  Shimultala,204,150,111,58,93,92,57.6,65.7,50.3,00000
90.0,33.0,81.0,106,03,01,  Khagura,195,430,104,205,91,225,31.2,33.7,28.8,00000
90.0,33.0,81.0,106,04,01,  Islampur,111,211,44,114,67,97,34.5,27.8,40.9,00000
90.0,33.0,81.0,106,05,01,  Puraba Tilagaon,613,985,331,444,282,541,38.4,42.7,34.3,00000
90.0,33.0,81.0,106,06,01,  Rupnagar,466,596,256,267,210,329,43.9,48.9,39.0,00000
90.0,33.0,81.0,106,07,01,  Rajnagar,96,257,51,128,45,129,27.2,28.5,25.9,00000
90.0,33.0,81.0,106,08,01,  Ajabpur,322,266,151,134,171,132,54.8,53.0,56.4,00000
90.0,33.0,81.0,106,09,01,  Kouarghar,137,219,73,109,64,110,38.5,40.1,36.8,00000
90.0,33.0,81.0,170,01,01,  Kadamtali,86,313,41,152,45,161,21.6,21.2,21.8,00000
90.0,33.0,81.0,170,02,01,  Kalikapur,78,180,36,88,42,92,30.2,29.0,31.3,00000
90.0,33.0,81.0,170,03,01,  Bhujna,148,302,66,151,82,151,32.9,30.4,35.2,00000
90.0,33.0,81.0,170,04,01,  Sarifpur,309,1298,178,607,131,691,19.2,22.7,15.9,00000
90.0,33.0,81.0,440,01,01,  Santipur,45,68,22,38,23,30,39.8,36.7,43.4,00000
90.0,33.0,81.0,440,02,01,  Mobarakpur,42,97,28,44,14,53,30.2,38.9,20.9,00000
90.0,33.0,81.0,618,01,01,  Gujaurra,114,358,56,175,58,183,24.2,24.2,24.1,00000
90.0,33.0,81.0,618,02,01,  Barkatnagar,93,287,46,138,47,149,24.5,25.0,24.0,00000
90.0,33.0,81.0,618,03,01,  Mamunpur,34,254,21,111,13,143,11.8,15.9,8.3,00000
90.0,33.0,81.0,980,01,01,  Batirgaon,178,677,83,335,95,342,20.8,19.9,21.7,00000
90.0,33.0,81.0,980,02,01,  Nurpur,215,593,130,285,85,308,26.6,31.3,21.6,00000
90.0,33.0,81.0,980,03,01,  Nandigram,140,278,73,137,67,141,33.5,34.8,32.2,00000
90.0,33.0,86.0,142,01,01,  Mularpar,262,474,124,236,138,238,35.6,34.4,36.7,00000
90.0,33.0,86.0,142,02,01,  Chowdhury Para,340,407,160,188,180,219,45.5,46.0,45.1,00000
90.0,33.0,86.0,142,03,01,  Banshtala,214,288,110,131,104,157,42.6,45.6,39.8,00000
90.0,33.0,86.0,355,01,01,  Gharua,139,189,69,87,70,102,42.4,44.2,40.7,00000
90.0,33.0,86.0,355,02,01,  Razar Gaon,175,220,97,91,78,129,44.3,51.6,37.7,00000
90.0,33.0,86.0,355,03,01,  Palkapan,130,323,56,151,74,172,28.7,27.1,30.1,00000
90.0,33.0,86.0,518,01,01,  Kiran Para,213,389,109,174,104,215,35.4,38.5,32.6,00000
90.0,33.0,86.0,518,02,01,  Bhawali Para,210,227,110,117,100,110,48.1,48.5,47.6,00000
90.0,33.0,86.0,739,01,01,  Puran Banstala,25,433,15,212,10,221,5.5,6.6,4.3,00000
90.0,33.0,86.0,739,02,01,  Chialipar,12,399,7,219,5,180,2.9,3.1,2.7,00000
90.0,33.0,86.0,902,01,01,  Jhamgaon,501,841,248,391,253,450,37.3,38.8,36.0,00000
90.0,33.0,86.0,902,02,01,  Pekpara,686,1033,363,497,323,536,39.9,42.2,37.6,00000
90.0,33.0,86.0,902,03,01,  Colony,205,956,108,475,97,481,17.7,18.5,16.8,00000
90.0,33.0,86.0,902,04,01,  Natun Banshtola,177,204,100,89,77,115,46.5,52.9,40.1,00000
90.0,33.0,86.0,923,01,01,  Uttar Ushingargaon,595,753,289,370,306,383,44.1,43.9,44.4,00000
90.0,33.0,86.0,923,02,01,  Barakhala,762,451,376,205,386,246,62.8,64.7,61.1,00000
90.0,33.0,92.0,113,01,01,  Baliura,69,281,37,144,32,137,19.7,20.4,18.9,00000
90.0,33.0,92.0,113,02,01,  Baliura Bazar,39,7,28,7,11,0,84.8,80.0,100.0,00000
90.0,33.0,92.0,220,01,01,  Ledarkandi,50,319,26,145,24,174,13.6,15.2,12.1,00000
90.0,33.0,92.0,220,02,01,  Khalpar,214,218,115,92,99,126,49.5,55.6,44.0,00000
90.0,33.0,92.0,220,03,01,  Chamkirgaon,49,134,29,66,20,68,26.8,30.5,22.7,00000
90.0,33.0,92.0,305,01,01,  Dargaon,146,471,71,220,75,251,23.7,24.4,23.0,00000
90.0,33.0,92.0,305,02,01,  Prataber Gaon,67,363,35,176,32,187,15.6,16.6,14.6,00000
90.0,33.0,92.0,639,01,01,  Ghilachhara,204,543,109,264,95,279,27.3,29.2,25.4,00000
90.0,33.0,92.0,639,02,01,  Khairgaon,212,725,96,349,116,376,22.6,21.6,23.6,00000
90.0,33.0,92.0,639,03,01,  Mantajnagar,140,442,71,226,69,216,24.1,23.9,24.2,00000
90.0,33.0,92.0,639,04,01,  Nasirnagar,105,207,58,96,47,111,33.7,37.7,29.7,00000
90.0,33.0,92.0,639,05,01,  Sarpin,26,196,13,98,13,98,11.7,11.7,11.7,00000
90.0,33.0,92.0,639,06,01,  Nasimpur Bazar,11,14,6,7,5,7,44.0,46.2,41.7,00000
90.0,33.0,92.0,639,07,01,  Nachimpur,164,259,86,123,78,136,38.8,41.1,36.4,00000
90.0,33.0,92.0,639,08,01,  Rahimer Para,217,562,114,278,103,284,27.9,29.1,26.6,00000
90.0,33.0,92.0,639,09,01,  Purba Chairgaon,304,893,143,436,161,457,25.4,24.7,26.1,00000
90.0,33.0,92.0,639,10,01,  Daulatpur,281,745,139,354,142,391,27.4,28.2,26.6,00000
90.0,33.0,92.0,639,11,01,  Birendranagar,153,522,74,261,79,261,22.7,22.1,23.2,00000
90.0,33.0,92.0,724,01,01,  Purba Sonapur,94,691,54,322,40,369,12.0,14.4,9.8,00000
90.0,33.0,92.0,724,02,01,  Sarpin Para,94,385,46,193,48,192,19.6,19.2,20.0,00000
90.0,33.0,92.0,724,03,01,  Habibnagar,145,569,74,285,71,284,20.3,20.6,20.0,00000
90.0,33.0,92.0,724,04,01,  Sonapur,212,627,96,322,116,305,25.3,23.0,27.6,00000
90.0,33.0,92.0,760,01,01,  Natun Sirajpur,161,233,78,109,83,124,40.9,41.7,40.1,00000
90.0,33.0,92.0,760,02,01,  Narasingpur,272,553,144,269,128,284,33.0,34.9,31.1,00000
90.0,33.0,92.0,760,03,01,  Narasingpur Bazar,52,31,39,17,13,14,62.7,69.6,48.1,00000
90.0,33.0,92.0,760,04,01,  Purana Sirajpur,49,87,28,44,21,43,36.0,38.9,32.8,00000
90.0,33.0,92.0,760,05,01,  Bagerpar,240,228,121,96,119,132,51.3,55.8,47.4,00000
90.0,33.0,92.0,760,06,01,  Sunaitta,86,204,37,97,49,107,29.7,27.6,31.4,00000
90.0,33.0,92.0,760,07,01,  Uttar Naturchay,125,181,57,77,68,104,40.8,42.5,39.5,00000
90.0,33.0,92.0,760,08,01,  Naturchay,202,429,112,218,90,211,32.0,33.9,29.9,00000
90.0,33.0,92.0,760,09,01,  Kalapashi,157,124,91,61,66,63,55.9,59.9,51.2,00000
90.0,33.0,92.0,760,10,01,  Shiraj Pur,95,164,46,75,49,89,36.7,38.0,35.5,00000
90.0,33.0,92.0,845,01,01,  Dinertuk,265,737,137,343,128,394,26.4,28.5,24.5,00000
90.0,33.0,92.0,845,02,01,  Chairgaon,367,652,191,299,176,353,36.0,39.0,33.3,00000
90.0,33.0,92.0,845,03,01,  Sreepur,249,617,130,281,119,336,28.8,31.6,26.2,00000
90.0,33.0,92.0,845,04,01,  Uttar Sreepur,80,376,46,195,34,181,17.5,19.1,15.8,00000
90.0,47.0,17.0,455,01,01,  Joyda,488,542,241,260,247,282,47.4,48.1,46.7,00000
90.0,47.0,17.0,455,02,01,  Jamalpur,285,652,123,358,162,294,30.4,25.6,35.5,00000
90.0,47.0,19.0,121,01,01,  Bhahudharal,390,957,173,465,217,492,29.0,27.1,30.6,00000
90.0,47.0,19.0,121,02,01,  Ohidnagar,269,242,126,122,143,120,52.6,50.8,54.4,00000
90.0,47.0,19.0,356,01,01,  Haldipur,134,323,69,164,65,159,29.3,29.6,29.0,00000
90.0,47.0,19.0,356,02,01,  Kabirpur,196,488,95,236,101,252,28.7,28.7,28.6,00000
90.0,47.0,19.0,657,01,01,  Mahishakona,292,334,136,169,156,165,46.6,44.6,48.6,00000
90.0,47.0,19.0,657,02,01,  Kasiarkona,113,80,53,41,60,39,58.5,56.4,60.6,00000
90.0,47.0,19.0,687,01,01,  Nayua Chilaura,685,503,351,222,334,281,57.7,61.3,54.3,00000
90.0,47.0,19.0,687,02,01,  Jatrapur,75,100,41,54,34,46,42.9,43.2,42.5,00000
90.0,47.0,19.0,687,03,01,  Harigobindapur,45,192,23,89,22,103,19.0,20.5,17.6,00000
90.0,47.0,19.0,846,01,01,  Samdhal,251,567,118,288,133,279,30.7,29.1,32.3,00000
90.0,47.0,19.0,846,02,01,  Pandita,285,397,145,198,140,199,41.8,42.3,41.3,00000
90.0,47.0,38.0,075,01,01,  Bade Khasila,556,1149,260,579,296,570,32.6,31.0,34.2,00000
90.0,47.0,38.0,075,02,01,  Kabilpur,37,94,26,51,11,43,28.2,33.8,20.4,00000
90.0,47.0,38.0,075,03,01,  Aduya,25,80,14,37,11,43,23.8,27.5,20.4,00000
90.0,47.0,38.0,075,04,01,  Senapacha,73,56,38,28,35,28,56.6,57.6,55.6,00000
90.0,47.0,38.0,075,05,01,  Sadarpur,6,7,4,2,2,5,46.2,66.7,28.6,00000
90.0,47.0,38.0,075,06,01,  Jugalnagar,140,153,65,76,75,77,47.8,46.1,49.3,00000
90.0,47.0,38.0,091,01,01,  Balikandi,612,1418,336,679,276,739,30.1,33.1,27.2,00000
90.0,47.0,38.0,091,02,01,  Mokam Para,90,234,45,107,45,127,27.8,29.6,26.2,00000
90.0,47.0,38.0,186,01,01,  Char Hatia,125,181,60,96,65,85,40.8,38.5,43.3,00000
90.0,47.0,38.0,186,02,01,  Talikuna,112,737,57,347,55,390,13.2,14.1,12.4,00000
90.0,47.0,38.0,186,03,01,  Nayagaon,46,182,26,90,20,92,20.2,22.4,17.9,00000
90.0,47.0,38.0,243,01,01,  Dhangpur,121,283,68,141,53,142,30.0,32.5,27.2,00000
90.0,47.0,38.0,243,02,01,  Supar Mamudpur,54,110,24,53,30,57,32.9,31.2,34.5,00000
90.0,47.0,38.0,489,01,01,  Kalyanpur,176,214,76,109,100,105,45.1,41.1,48.8,00000
90.0,47.0,38.0,489,02,01,  Kalitayki,5,59,2,33,3,26,7.8,5.7,10.3,00000
90.0,47.0,38.0,497,01,01,  Kamarkhal,423,496,206,240,217,256,46.0,46.2,45.9,00000
90.0,47.0,38.0,497,02,01,  Kandargaon,47,203,25,108,22,95,18.8,18.8,18.8,00000
90.0,47.0,38.0,660,01,01,  Mollargaon,165,185,83,81,82,104,47.1,50.6,44.1,00000
90.0,47.0,38.0,660,02,01,  Balbal,22,33,9,16,13,17,40.0,36.0,43.3,00000
90.0,47.0,38.0,660,03,01,  Gipura,108,273,45,125,63,148,28.3,26.5,29.9,00000
90.0,47.0,38.0,660,04,01,  Shangirgaon,118,173,57,87,61,86,40.5,39.6,41.5,00000
90.0,47.0,38.0,683,01,01,  Nadampur,238,504,129,243,109,261,32.1,34.7,29.5,00000
90.0,47.0,38.0,683,02,01,  Patsuki,39,77,17,39,22,38,33.6,30.4,36.7,00000
90.0,47.0,38.0,683,03,01,  Gopikona,27,139,15,65,12,74,16.3,18.8,14.0,00000
90.0,47.0,38.0,732,01,01,  Parargaon,296,821,158,392,138,429,26.5,28.7,24.3,00000
90.0,47.0,38.0,732,02,01,  Noapara,17,44,8,24,9,20,27.9,25.0,31.0,00000
90.0,47.0,38.0,964,01,01,  Chhota Dighalbak,23,19,9,8,14,11,54.8,52.9,56.0,00000
90.0,47.0,38.0,964,02,01,  Gungirgaon,162,191,89,86,73,105,45.9,50.9,41.0,00000
90.0,47.0,47.0,007,01,01,  Kyrankandi,98,81,42,34,56,47,54.7,55.3,54.4,00000
90.0,47.0,47.0,007,02,01,  Kazirgaon,79,60,37,33,42,27,56.8,52.9,60.9,00000
90.0,47.0,47.0,007,03,01,  Radanagar,285,238,131,108,154,130,54.5,54.8,54.2,00000
90.0,47.0,47.0,007,04,01,  Pataria Darapar,104,276,58,136,46,140,27.4,29.9,24.7,00000
90.0,47.0,47.0,113,01,01,  Bara Kapan,333,657,168,351,165,306,33.6,32.4,35.0,00000
90.0,47.0,47.0,113,02,01,  Sreekarpur,92,65,40,39,52,26,58.6,50.6,66.7,00000
90.0,47.0,47.0,307,01,01,  Gargaria,619,732,329,343,290,389,45.8,49.0,42.7,00000
90.0,47.0,47.0,307,02,01,  Lahari Gangpar,191,202,101,101,90,101,48.6,50.0,47.1,00000
90.0,47.0,47.0,611,01,01,  Mashajan,31,57,15,30,16,27,35.2,33.3,37.2,00000
90.0,47.0,47.0,611,02,01,  Purbagaon,127,65,63,31,64,34,66.1,67.0,65.3,00000
90.0,47.0,47.0,634,01,01,  Mirpur,419,342,238,193,181,149,55.1,55.2,54.8,00000
90.0,47.0,47.0,634,02,01,  Najipur,364,177,206,84,158,93,67.3,71.0,62.9,00000
90.0,47.0,47.0,634,03,01,  Haliar Para,374,478,195,236,179,242,43.9,45.2,42.5,00000
90.0,47.0,47.0,675,01,01,  Dighirpar,214,118,113,52,101,66,64.5,68.5,60.5,00000
90.0,47.0,47.0,675,02,01,  Sathal,172,286,96,139,76,147,37.6,40.9,34.1,00000
90.0,47.0,47.0,675,03,01,  Nabinagar,351,328,175,158,176,170,51.7,52.6,50.9,00000
90.0,47.0,47.0,721,01,01,  Pailbagh,61,264,29,136,32,128,18.8,17.6,20.0,00000
90.0,47.0,47.0,721,02,01,  Patuma,133,132,69,62,64,70,50.2,52.7,47.8,00000
90.0,47.0,47.0,900,01,01,  Shashanhabi,338,195,165,99,173,96,63.4,62.5,64.3,00000
90.0,47.0,47.0,900,02,01,  Ratia Para,240,217,128,95,112,122,52.5,57.4,47.9,00000
90.0,47.0,47.0,938,01,01,  Paschim Sreeramsi,766,453,427,212,339,241,62.8,66.8,58.4,00000
90.0,47.0,47.0,938,02,01,  Purba Sreeramsi,155,61,93,28,62,33,71.8,76.9,65.3,00000
90.0,47.0,57.0,022,02,01,  Alitali,989,1134,501,548,488,586,46.6,47.8,45.4,00000
90.0,47.0,57.0,345,01,01,  Gotgaon,581,2006,289,963,292,1043,22.5,23.1,21.9,00000
90.0,47.0,57.0,345,02,01,  Gopinathpur,77,59,41,23,36,36,56.6,64.1,50.0,00000
90.0,47.0,57.0,527,01,01,  Katia,582,688,386,339,196,349,45.8,53.2,36.0,00000
90.0,47.0,57.0,527,02,01,  Purba Katia,308,835,130,419,178,416,26.9,23.7,30.0,00000
90.0,47.0,57.0,535,01,01,  Khanpur,187,493,98,232,89,261,27.5,29.7,25.4,00000
90.0,47.0,57.0,535,02,01,  Jalalpur,495,924,270,435,225,489,34.9,38.3,31.5,00000
90.0,47.0,57.0,535,03,01,  Mashjan,86,242,39,120,47,122,26.2,24.5,27.8,00000
90.0,47.0,57.0,535,04,01,  Alagadi (Puran),79,208,31,100,48,108,27.5,23.7,30.8,00000
90.0,47.0,57.0,725,01,01,  Pailgaon,609,1592,304,752,305,840,27.7,28.8,26.6,00000
90.0,47.0,57.0,725,02,01,  Nagargaon,98,283,45,141,53,142,25.7,24.2,27.2,00000
90.0,47.0,57.0,725,03,01,  Sonatala,191,306,92,143,99,163,38.4,39.1,37.8,00000
90.0,47.0,57.0,725,04,01,  Bagmayna Tagapur,94,392,47,205,47,187,19.3,18.7,20.1,00000
90.0,47.0,57.0,725,05,01,  Rasulpur,98,367,52,182,46,185,21.1,22.2,19.9,00000
90.0,47.0,57.0,797,01,01,  Ramapatipur,254,186,130,99,124,87,57.7,56.8,58.8,00000
90.0,47.0,57.0,862,01,01,  Sata,336,190,164,88,172,102,63.9,65.1,62.8,00000
90.0,47.0,57.0,862,02,01,  Alagadi,166,256,83,121,83,135,39.3,40.7,38.1,00000
90.0,47.0,66.0,174,01,01,  Chak Achimpur,36,26,20,10,16,16,58.1,66.7,50.0,00000
90.0,47.0,66.0,174,02,01,  Kabirpur,122,107,69,42,53,65,53.3,62.2,44.9,00000
90.0,47.0,66.0,174,03,01,  Chanpur,172,174,89,73,83,101,49.7,54.9,45.1,00000
90.0,47.0,66.0,224,01,01,  Masardam,19,65,7,35,12,30,22.6,16.7,28.6,00000
90.0,47.0,66.0,224,02,01,  Dari Khananpur,65,174,41,92,24,82,27.2,30.8,22.6,00000
90.0,47.0,66.0,273,01,01,  Ekabara,52,101,23,49,29,52,34.0,31.9,35.8,00000
90.0,47.0,66.0,273,02,01,  Sathal,68,176,36,82,32,94,27.9,30.5,25.4,00000
90.0,47.0,66.0,569,01,01,  Lohargaon,462,698,258,341,204,357,39.8,43.1,36.4,00000
90.0,47.0,66.0,569,02,01,  Khetrapasha,122,184,68,90,54,94,39.9,43.0,36.5,00000
90.0,47.0,66.0,592,01,01,  Makrampur,245,165,121,77,124,88,59.8,61.1,58.5,00000
90.0,47.0,66.0,592,02,01,  Fatapur,23,106,15,53,8,53,17.8,22.1,13.1,00000
90.0,47.0,66.0,619,01,01,  Rasul Khanjan Bazar,167,476,110,240,57,236,26.0,31.4,19.5,00000
90.0,47.0,66.0,619,02,01,  Miazpur,236,408,124,205,112,203,36.6,37.7,35.6,00000
90.0,47.0,66.0,626,01,01,  Sulmanpur,50,132,19,52,31,80,27.5,26.8,27.9,00000
90.0,47.0,66.0,626,02,01,  Fuhirjala,83,56,48,26,35,30,59.7,64.9,53.8,00000
90.0,47.0,66.0,626,03,01,  Minajpur,151,240,95,110,56,130,38.6,46.3,30.1,00000
90.0,47.0,66.0,691,01,01,  Asampur,190,148,104,66,86,82,56.2,61.2,51.2,00000
90.0,47.0,66.0,691,02,01,  Nandirgaon,230,271,118,112,112,159,45.9,51.3,41.3,00000
90.0,47.0,66.0,801,01,01,  Bangaon,199,234,110,101,89,133,46.0,52.1,40.1,00000
90.0,47.0,66.0,801,02,01,  Nurbala,157,241,82,121,75,120,39.4,40.4,38.5,00000
90.0,47.0,66.0,801,03,01,  Laotala,20,21,12,9,8,12,48.8,57.1,40.0,00000
90.0,47.0,66.0,801,04,01,  Radunikona,32,57,19,23,13,34,36.0,45.2,27.7,00000
90.0,47.0,66.0,801,05,01,  Rasulpur,649,834,352,388,297,446,43.8,47.6,40.0,00000
90.0,47.0,66.0,801,07,01,  Lama Rasulganj Bazar,35,14,22,9,13,5,71.4,71.0,72.2,00000
90.0,47.0,66.0,892,01,01,  Islampur,110,342,57,160,53,182,24.3,26.3,22.6,00000
90.0,47.0,66.0,892,02,01,  Shasan,91,256,55,126,36,130,26.2,30.4,21.7,00000
90.0,47.0,66.0,926,01,01,  Dhananjoypur,30,92,17,45,13,47,24.6,27.4,21.7,00000
90.0,47.0,66.0,926,02,01,  Bariachin,62,87,30,42,32,45,41.6,41.7,41.6,00000
90.0,47.0,76.0,094,01,01,  Balisree,187,342,89,169,98,173,35.3,34.5,36.2,00000
90.0,47.0,76.0,094,02,01,  Rawail,938,1079,443,551,495,528,46.5,44.6,48.4,00000
90.0,47.0,76.0,094,03,01,  Alampur,174,124,88,58,86,66,58.4,60.3,56.6,00000
90.0,47.0,76.0,094,04,01,  Nayagaon,531,1280,241,602,290,678,29.3,28.6,30.0,00000
90.0,47.0,76.0,296,01,01,  Gandharbapur,808,1557,393,778,415,779,34.2,33.6,34.8,00000
90.0,47.0,76.0,296,02,01,  Raniganj,374,294,228,160,146,134,56.0,58.8,52.1,00000
90.0,47.0,76.0,296,03,01,  Raninagar,173,227,84,113,89,114,43.3,42.6,43.8,00000
90.0,47.0,76.0,296,04,01,  Islampur,281,585,147,270,134,315,32.4,35.3,29.8,00000
90.0,47.0,76.0,505,01,01,  Kamrakhai,504,1021,240,502,264,519,33.0,32.3,33.7,00000
90.0,47.0,76.0,505,02,01,  Joyanagar,223,402,101,192,122,210,35.7,34.5,36.7,00000
90.0,47.0,76.0,505,03,01,  Kusari,190,326,94,154,96,172,36.8,37.9,35.8,00000
90.0,47.0,76.0,550,01,01,  Kubajpur,968,1767,493,836,475,931,35.4,37.1,33.8,00000
90.0,47.0,76.0,550,02,01,  Ahmedabad,161,429,78,211,83,218,27.3,27.0,27.6,00000
90.0,47.0,76.0,550,03,01,  Shibganj,83,39,48,23,35,16,68.0,67.6,68.6,00000
90.0,47.0,76.0,550,04,01,  Asimpur,279,297,137,145,142,152,48.4,48.6,48.3,00000
90.0,47.0,76.0,550,05,01,  Noyapara,186,250,83,130,103,120,42.7,39.0,46.2,00000
90.0,47.0,76.0,550,06,01,  Islampur,58,127,28,65,30,62,31.4,30.1,32.6,00000
90.0,47.0,85.0,960,01,01,  Saedpur,831,896,489,435,342,461,48.1,52.9,42.6,00000
90.0,47.0,85.0,960,02,01,  Eshankona,637,714,350,331,287,383,47.2,51.4,42.8,00000
90.0,47.0,85.0,960,03,01,  Agunkona,711,828,396,410,315,418,46.2,49.1,43.0,00000
90.0,47.0,85.0,960,04,01,  Harikona,458,167,229,73,229,94,73.3,75.8,70.9,00000
90.0,47.0,85.0,960,05,01,  Paschimpara,608,527,329,254,279,273,53.6,56.4,50.5,00000
90.0,50.0,13.0,072,01,01,  Beheli,380,345,193,167,187,178,52.4,53.6,51.2,00000
90.0,50.0,13.0,072,02,01,  Beheli Alipur,44,653,27,341,17,312,6.3,7.3,5.2,00000
90.0,50.0,13.0,072,03,01,  Shibpur,98,332,55,178,43,154,22.8,23.6,21.8,00000
90.0,50.0,13.0,072,04,01,  Tilkey,13,92,10,47,3,45,12.4,17.5,6.3,00000
90.0,50.0,13.0,275,01,01,  Bagani,29,182,14,93,15,89,13.7,13.1,14.4,00000
90.0,50.0,13.0,275,02,01,  Harinagar,385,196,209,89,176,107,66.3,70.1,62.2,00000
90.0,50.0,13.0,325,01,01,  Inathnagar,192,305,91,151,101,154,38.6,37.6,39.6,00000
90.0,50.0,13.0,325,02,01,  Badarpur,386,421,230,140,156,281,47.8,62.2,35.7,00000
90.0,50.0,13.0,514,01,01,  Islampur,128,969,78,481,50,488,11.7,14.0,9.3,00000
90.0,50.0,13.0,514,02,01,  Chandipur,89,233,41,129,48,104,27.6,24.1,31.6,00000
90.0,50.0,13.0,514,03,01,  Prakashnagar,39,141,25,76,14,65,21.7,24.8,17.7,00000
90.0,50.0,13.0,514,04,01,  Moshalghat,142,57,70,23,72,34,71.4,75.3,67.9,00000
90.0,50.0,13.0,514,05,01,  Nymoshalghat,497,420,258,210,239,210,54.2,55.1,53.2,00000
90.0,50.0,13.0,703,01,01,  Rahimapur,343,224,159,102,184,122,60.5,60.9,60.1,00000
90.0,50.0,13.0,703,02,01,  Gopalpur,54,309,33,150,21,159,14.9,18.0,11.7,00000
90.0,50.0,13.0,703,03,01,  Rajapur,69,122,39,50,30,72,36.1,43.8,29.4,00000
90.0,50.0,13.0,703,04,01,  Chinamara,49,251,22,128,27,123,16.3,14.7,18.0,00000
90.0,50.0,27.0,137,01,01,  Chandernagar,80,467,33,219,47,248,14.6,13.1,15.9,00000
90.0,50.0,27.0,137,02,01,  Tarannagar,141,518,80,248,61,270,21.4,24.4,18.4,00000
90.0,50.0,27.0,240,01,01,  Santoshpur,82,361,39,189,43,172,18.5,17.1,20.0,00000
90.0,50.0,27.0,240,02,01,  Krishna Nagar,14,94,9,49,5,45,13.0,15.5,10.0,00000
90.0,50.0,27.0,315,01,01,  Salaya,169,727,88,355,81,372,18.9,19.9,17.9,00000
90.0,50.0,27.0,315,02,01,  Manigaon,264,412,136,199,128,213,39.1,40.6,37.5,00000
90.0,50.0,27.0,315,03,01,  Mahmudpur,540,982,261,496,279,486,35.5,34.5,36.5,00000
90.0,50.0,27.0,315,04,01,  Kandagaon,227,221,112,110,115,111,50.7,50.5,50.9,00000
90.0,50.0,27.0,315,05,01,  Fakaul Mahmudpur,372,481,190,233,182,248,43.6,44.9,42.3,00000
90.0,50.0,27.0,380,01,01,  Kalkatka,736,1339,369,631,367,708,35.5,36.9,34.1,00000
90.0,50.0,27.0,380,02,01,  Gazipur,25,81,17,43,8,38,23.6,28.3,17.4,00000
90.0,50.0,27.0,493,01,01,  Makharkhala,143,244,84,104,59,140,37.0,44.7,29.6,00000
90.0,50.0,27.0,493,02,01,  Vanda,216,609,121,319,95,290,26.2,27.5,24.7,00000
90.0,50.0,27.0,493,03,01,  Raza Baje,52,185,30,94,22,91,21.9,24.2,19.5,00000
90.0,50.0,27.0,501,01,01,  Malinagar,393,408,182,198,211,210,49.1,47.9,50.1,00000
90.0,50.0,27.0,501,02,01,  Puran Chandabari,156,125,80,60,76,65,55.5,57.1,53.9,00000
90.0,50.0,27.0,501,03,01,  Chandabari,444,714,216,330,228,384,38.3,39.6,37.3,00000
90.0,50.0,27.0,509,01,01,  Mallikpur,835,1028,432,470,403,558,44.8,47.9,41.9,00000
90.0,50.0,27.0,509,02,01,  Hararkandi,57,157,29,75,28,82,26.6,27.9,25.5,00000
90.0,50.0,27.0,509,03,01,  Hogali,37,488,25,229,12,259,7.0,9.8,4.4,00000
90.0,50.0,27.0,509,04,01,  Faridpur,28,170,19,84,9,86,14.1,18.4,9.5,00000
90.0,50.0,27.0,590,01,01,  Bahadurpur,219,304,107,152,112,152,41.9,41.3,42.4,00000
90.0,50.0,27.0,590,02,01,  Nowagaon,382,1187,212,572,170,615,24.3,27.0,21.7,00000
90.0,50.0,27.0,904,01,01,  Bisana,436,868,192,426,244,442,33.4,31.1,35.6,00000
90.0,50.0,27.0,904,02,01,  Kalipur,276,198,150,78,126,120,58.2,65.8,51.2,00000
90.0,50.0,27.0,904,03,01,  Jangalbari,36,85,20,41,16,44,29.8,32.8,26.7,00000
90.0,50.0,27.0,904,04,01,  Vimkhali Bazar,86,140,49,65,37,75,38.1,43.0,33.0,00000
90.0,50.0,27.0,904,05,01,  Hasnabaj,390,376,190,177,200,199,50.9,51.8,50.1,00000
90.0,50.0,27.0,904,06,01,  Kirtenpur,52,78,27,32,25,46,40.0,45.8,35.2,00000
90.0,50.0,27.0,904,07,01,  Kamlabaj,284,295,147,144,137,151,49.1,50.5,47.6,00000
90.0,50.0,27.0,914,01,01,  Sreepur,313,380,147,187,166,193,45.2,44.0,46.2,00000
90.0,50.0,27.0,914,02,01,  Ujjalpur,79,521,35,265,44,256,13.2,11.7,14.7,00000
90.0,50.0,54.0,125,01,01,  Bishnupur,248,793,148,388,100,405,23.8,27.6,19.8,00000
90.0,50.0,54.0,125,02,01,  Rajendrapur,55,224,37,103,18,121,19.7,26.4,12.9,00000
90.0,50.0,54.0,161,01,01,  Ujan Daulatpur,116,164,60,84,56,80,41.4,41.7,41.2,00000
90.0,50.0,54.0,161,02,01,  Bhati Daulatpur,144,190,74,96,70,94,43.1,43.5,42.7,00000
90.0,50.0,54.0,202,01,01,  Dakshin Rampur,248,815,142,425,106,390,23.3,25.0,21.4,00000
90.0,50.0,54.0,202,02,01,  Suzzatpur,201,660,115,328,86,332,23.3,26.0,20.6,00000
90.0,50.0,54.0,202,03,01,  Bhutiarpur,71,430,45,225,26,205,14.2,16.7,11.3,00000
90.0,50.0,54.0,218,01,01,  Lalpur,109,138,53,67,56,71,44.1,44.2,44.1,00000
90.0,50.0,54.0,218,02,01,  Benazura,340,424,181,198,159,226,44.5,47.8,41.3,00000
90.0,50.0,54.0,244,01,01,  Enayetnagar,85,402,46,206,39,196,17.5,18.3,16.6,00000
90.0,50.0,54.0,244,02,01,  Bijoynagar,42,186,27,93,15,93,18.4,22.5,13.9,00000
90.0,50.0,54.0,250,01,01,  Gangadharpur,147,628,100,264,47,364,19.0,27.5,11.4,00000
90.0,50.0,54.0,250,02,01,  Razapur,465,989,260,469,205,520,32.0,35.7,28.3,00000
90.0,50.0,54.0,250,03,01,  Tegharia,77,107,43,46,34,61,41.8,48.3,35.8,00000
90.0,50.0,54.0,370,01,01,  Jasmantapur,40,257,22,128,18,129,13.5,14.7,12.2,00000
90.0,50.0,54.0,370,02,01,  Gozaria,529,1973,370,1005,159,968,21.1,26.9,14.1,00000
90.0,50.0,54.0,370,03,01,  Tuyabnagar,82,303,42,154,40,149,21.3,21.4,21.2,00000
90.0,50.0,54.0,388,01,01,  Kamargaon,229,249,125,110,104,139,47.9,53.2,42.8,00000
90.0,50.0,54.0,388,02,01,  Udaypur,107,359,69,171,38,188,23.0,28.8,16.8,00000
90.0,50.0,54.0,396,01,01,  Kadarpur,233,1214,130,576,103,638,16.1,18.4,13.9,00000
90.0,50.0,54.0,396,02,01,  Alipur,288,814,176,422,112,392,26.1,29.4,22.2,00000
90.0,50.0,54.0,396,03,01,  Morulpur,32,400,20,200,12,200,7.4,9.1,5.7,00000
90.0,50.0,54.0,412,01,01,  Shantipur,371,699,219,360,152,339,34.7,37.8,31.0,00000
90.0,50.0,54.0,412,02,01,  Fenarbak,506,802,281,380,225,422,38.7,42.5,34.8,00000
90.0,50.0,54.0,412,03,01,  Badarpur,10,196,4,100,6,96,4.9,3.8,5.9,00000
90.0,50.0,54.0,420,01,01,  Kashipur,46,94,26,49,20,45,32.9,34.7,30.8,00000
90.0,50.0,54.0,420,02,01,  Nazimnagar,209,969,124,494,85,475,17.7,20.1,15.2,00000
90.0,50.0,54.0,420,03,01,  Tazpur,15,158,9,84,6,74,8.7,9.7,7.5,00000
90.0,50.0,54.0,420,04,01,  Lakshmipur Natun Para,112,511,60,258,52,253,18.0,18.9,17.0,00000
90.0,50.0,54.0,578,01,01,  Nidhipur,211,252,99,129,112,123,45.6,43.4,47.7,00000
90.0,50.0,54.0,578,02,01,  Amanipur,56,378,30,183,26,195,12.9,14.1,11.8,00000
90.0,50.0,54.0,578,03,01,  Fazilpur,9,166,5,88,4,78,5.1,5.4,4.9,00000
90.0,50.0,54.0,835,01,01,  Sharifpur (Salimgonj Bazar),328,1141,183,581,145,560,22.3,24.0,20.6,00000
90.0,50.0,54.0,835,02,01,  Saidnagar,103,130,64,60,39,70,44.2,51.6,35.8,00000
90.0,50.0,67.0,060,01,01,  Baghbari Chak,2,196,1,96,1,100,1.0,1.0,1.0,00000
90.0,50.0,67.0,060,02,01,  Zunupur,2,276,2,143,0,133,0.7,1.4,0.0,00000
90.0,50.0,67.0,137,01,01,  Sonapur,136,838,83,402,53,436,14.0,17.1,10.8,00000
90.0,50.0,67.0,137,02,01,  Chandpur,346,1129,187,551,159,578,23.5,25.3,21.6,00000
90.0,50.0,67.0,137,03,01,  Aburhati,202,568,127,272,75,296,26.2,31.8,20.2,00000
90.0,50.0,67.0,137,04,01,  Durgapur,86,138,51,59,35,79,38.4,46.4,30.7,00000
90.0,50.0,67.0,137,05,01,  Hindu Kalipur,28,67,14,32,14,35,29.5,30.4,28.6,00000
90.0,50.0,67.0,137,06,01,  Bhuarhat,117,289,66,146,51,143,28.8,31.1,26.3,00000
90.0,50.0,67.0,394,01,01,  Jamalghar Aburhati,169,310,93,164,76,146,35.3,36.2,34.2,00000
90.0,50.0,67.0,394,02,01,  Muslim Kanamtali,113,424,61,217,52,207,21.0,21.9,20.1,00000
90.0,50.0,67.0,394,03,01,  Talianatun Para,1472,762,717,345,755,417,65.9,67.5,64.4,00000
90.0,50.0,67.0,404,01,01,  Saderkandi,191,443,105,231,86,212,30.1,31.3,28.9,00000
90.0,50.0,67.0,404,02,01,  Uttar Kamlabaj,839,1269,401,628,438,641,39.8,39.0,40.6,00000
90.0,50.0,67.0,404,03,01,  Sharatpur,298,328,169,139,129,189,47.6,54.9,40.6,00000
90.0,50.0,67.0,404,04,01,  Lambabagh,815,2175,507,1036,308,1139,27.3,32.9,21.3,00000
90.0,50.0,67.0,404,05,01,  Gulahati,168,245,94,116,74,129,40.7,44.8,36.5,00000
90.0,50.0,67.0,404,06,01,  Danuakhali,180,617,111,294,69,323,22.6,27.4,17.6,00000
90.0,50.0,67.0,404,07,01,  Paratali Hati,141,257,91,114,50,143,35.4,44.4,25.9,00000
90.0,50.0,67.0,404,08,01,  Kalipur,476,1244,273,598,203,646,27.7,31.3,23.9,00000
90.0,50.0,67.0,428,01,01,  Mominpur,143,721,72,352,71,369,16.6,17.0,16.1,00000
90.0,50.0,67.0,428,02,01,  Hossainpur,37,348,19,168,18,180,9.6,10.2,9.1,00000
90.0,50.0,67.0,428,03,01,  Kaminpur,345,975,213,496,132,479,26.1,30.0,21.6,00000
90.0,50.0,67.0,428,04,01,  Uttar Kshmipur,11,291,7,145,4,146,3.6,4.6,2.7,00000
90.0,50.0,67.0,477,01,01,  Uzanlalpur,245,730,162,342,83,388,25.1,32.1,17.6,00000
90.0,50.0,67.0,477,02,01,  Umidpur,108,572,64,282,44,290,15.9,18.5,13.2,00000
90.0,50.0,67.0,477,03,01,  Lakshmipur,481,2302,268,1132,213,1170,17.3,19.1,15.4,00000
90.0,50.0,67.0,477,04,01,  Insenpur,42,146,30,73,12,73,22.3,29.1,14.1,00000
90.0,50.0,67.0,760,01,01,  Sachna,1021,1105,537,516,484,589,48.0,51.0,45.1,00000
90.0,50.0,67.0,760,02,01,  Alipur,55,496,35,244,20,252,10.0,12.5,7.4,00000
90.0,50.0,67.0,760,03,01,  Sarifpur,12,405,11,211,1,194,2.9,5.0,0.5,00000
90.0,50.0,67.0,760,04,01,  Kalibari,278,638,162,293,116,345,30.3,35.6,25.2,00000
90.0,50.0,67.0,784,01,01,  Kalaguza,173,415,109,212,64,203,29.4,34.0,24.0,00000
90.0,50.0,67.0,784,02,01,  Kashipur,337,1111,182,569,155,542,23.3,24.2,22.2,00000
90.0,50.0,67.0,784,03,01,  Samadpur,408,526,225,248,183,278,43.7,47.6,39.7,00000
90.0,50.0,67.0,784,04,01,  Vatilalpur,294,921,198,427,96,494,24.2,31.7,16.3,00000
90.0,50.0,67.0,897,01,03,  Kadamtali,244,360,130,159,114,201,40.4,45.0,36.2,00000
90.0,50.0,67.0,897,02,03,  Noyahalot,1339,1904,665,960,674,944,41.3,40.9,41.7,00000
90.0,50.0,67.0,897,03,03,  Dakshin Kamla Baze,703,936,381,460,322,476,42.9,45.3,40.4,00000
90.0,50.0,67.0,897,04,03,  Jamalganj,716,178,423,79,293,99,80.1,84.3,74.7,00000
90.0,50.0,67.0,897,05,03,  Hindu Kalipur,74,74,43,32,31,42,50.0,57.3,42.5,00000
90.0,50.0,81.0,169,01,01,  Fatehpur,295,347,163,168,132,179,46.0,49.2,42.4,00000
90.0,50.0,81.0,169,02,01,  Mafiz Nagar,183,371,117,198,66,173,33.0,37.1,27.6,00000
90.0,50.0,81.0,186,01,01,  Kandagaon,100,380,36,202,64,178,20.8,15.1,26.4,00000
90.0,50.0,81.0,186,02,01,  Falokpur,115,283,63,139,52,144,28.9,31.2,26.5,00000
90.0,50.0,81.0,226,01,01,  Sudebpur,340,645,184,327,156,318,34.5,36.0,32.9,00000
90.0,50.0,81.0,226,02,01,  Naya Sudebpur,177,618,92,298,85,320,22.3,23.6,21.0,00000
90.0,50.0,81.0,226,03,01,  Brahmangaon,21,114,13,54,8,60,15.6,19.4,11.8,00000
90.0,50.0,81.0,598,01,03,  Sachna Bazar,655,83,385,25,270,58,88.8,93.9,82.3,00000
90.0,50.0,81.0,598,02,03,  Palak,493,686,268,339,225,347,41.8,44.2,39.3,00000
90.0,50.0,81.0,630,01,01,  Baratpur,644,517,323,267,321,250,55.5,54.7,56.2,00000
90.0,50.0,81.0,630,02,01,  Akta Para,47,101,22,50,25,51,31.8,30.6,32.9,00000
90.0,50.0,81.0,663,01,01,  Jamlabagh,182,291,81,142,101,149,38.5,36.3,40.4,00000
90.0,50.0,81.0,663,02,01,  Nurpur,171,291,89,147,82,144,37.0,37.7,36.3,00000
90.0,50.0,81.0,663,03,01,  Fazilpur,283,551,147,270,136,281,33.9,35.3,32.6,00000
90.0,50.0,81.0,728,01,01,  Rangamati,390,511,222,258,168,253,43.3,46.3,39.9,00000
90.0,50.0,81.0,728,02,01,  Sarifpur,156,171,77,86,79,85,47.7,47.2,48.2,00000
90.0,86.0,23.0,044,01,01,  Ujangaon,724,1493,370,744,354,749,32.7,33.2,32.1,00000
90.0,86.0,23.0,044,02,01,  Gobindanagar,160,143,83,75,77,68,52.8,52.5,53.1,00000
90.0,86.0,23.0,059,01,01,  Ballabhpur,0,20,0,12,0,8,0.0,0.0,0.0,00000
90.0,86.0,23.0,059,02,01,  Chikadubi,8,63,4,28,4,35,11.3,12.5,10.3,00000
90.0,86.0,23.0,059,03,01,  Sarmakanda,101,998,61,501,40,497,9.2,10.9,7.4,00000
90.0,86.0,23.0,103,01,01,  Shosarkanda,378,1699,211,816,167,883,18.2,20.5,15.9,00000
90.0,86.0,23.0,103,02,01,  Mahmud Nagar,1102,1501,537,748,565,753,42.3,41.8,42.9,00000
90.0,86.0,23.0,103,03,01,  Ganganagar,139,436,72,223,67,213,24.2,24.4,23.9,00000
90.0,86.0,23.0,237,01,01,  Daudpur,210,451,105,229,105,222,31.8,31.4,32.1,00000
90.0,86.0,23.0,237,02,01,  Daulatpur,645,1084,325,546,320,538,37.3,37.3,37.3,00000
90.0,86.0,23.0,371,01,01,  Ujaniarabad,37,639,21,312,16,327,5.5,6.3,4.7,00000
90.0,86.0,23.0,371,02,01,  Bhatiirabad,165,1224,117,584,48,640,11.9,16.7,7.0,00000
90.0,86.0,23.0,579,01,01,  Mirzapur,56,903,33,466,23,437,5.8,6.6,5.0,00000
90.0,86.0,23.0,579,02,01,  Sonakandi,157,603,92,308,65,295,20.7,23.0,18.1,00000
90.0,86.0,23.0,579,03,01,  Bazirkandi,367,516,189,261,178,255,41.6,42.0,41.1,00000
90.0,86.0,47.0,252,01,03,  Dumra,809,410,446,162,363,248,66.4,73.4,59.4,00000
90.0,86.0,47.0,252,02,03,  Mannanpur,44,144,29,67,15,77,23.4,30.2,16.3,00000
90.0,86.0,47.0,252,03,03,  Tajpur,70,108,38,54,32,54,39.3,41.3,37.2,00000
90.0,86.0,47.0,341,01,01,  Haripur,206,114,102,42,104,72,64.4,70.8,59.1,00000
90.0,86.0,47.0,341,02,01,  Meghna Para-1,101,72,57,35,44,37,58.4,62.0,54.3,00000
90.0,86.0,47.0,341,03,01,  Nainda,134,130,67,58,67,72,50.8,53.6,48.2,00000
90.0,86.0,47.0,430,01,01,  Kandakhala,136,147,57,74,79,73,48.1,43.5,52.0,00000
90.0,86.0,47.0,430,02,01,  Kalakaldi,12,143,5,72,7,71,7.7,6.5,9.0,00000
90.0,86.0,47.0,787,01,01,  Jatrapur,211,153,102,73,109,80,58.0,58.3,57.7,00000
90.0,86.0,47.0,787,02,01,  Ujan Jatrapur,135,124,68,66,67,58,52.1,50.7,53.6,00000
90.0,86.0,47.0,787,03,01,  Bagerhati,94,89,46,42,48,47,51.4,52.3,50.5,00000
90.0,86.0,47.0,787,04,01,  Bahara,333,843,191,389,142,454,28.3,32.9,23.8,00000
90.0,86.0,47.0,787,05,01,  Porarpar,286,203,148,88,138,115,58.5,62.7,54.5,00000
90.0,86.0,47.0,787,06,01,  Shibpur,105,197,53,97,52,100,34.8,35.3,34.2,00000
90.0,86.0,47.0,950,01,01,  Sudankalli,141,148,85,70,56,78,48.8,54.8,41.8,00000
90.0,86.0,47.0,950,02,01,  Mohankalli,135,86,72,36,63,50,61.1,66.7,55.8,00000
90.0,86.0,47.0,950,03,01,  Meghna Para-2,280,246,148,115,132,131,53.2,56.3,50.2,00000
90.0,86.0,47.0,950,04,01,  Mirzapur,1,13,1,6,0,7,7.1,14.3,0.0,00000
90.0,86.0,47.0,965,01,01,  Sukhlain,170,473,94,235,76,238,26.4,28.6,24.2,00000
90.0,86.0,47.0,965,02,01,  Ragunathpur,148,303,94,125,54,178,32.8,42.9,23.3,00000
90.0,86.0,47.0,965,03,01,  Angaura,275,365,138,177,137,188,43.0,43.8,42.2,00000
90.0,86.0,47.0,965,04,01,  Nayagaon,138,268,69,127,69,141,34.0,35.2,32.9,00000
90.0,86.0,71.0,148,01,01,  Brahmangaon,61,164,36,81,25,83,27.1,30.8,23.1,00000
90.0,86.0,71.0,148,02,01,  Asanpur,187,231,102,110,85,121,44.7,48.1,41.3,00000
90.0,86.0,71.0,178,01,01,  Chakua,389,530,207,245,182,285,42.3,45.8,39.0,00000
90.0,86.0,71.0,178,02,01,  Paschimpara,291,205,151,92,140,113,58.7,62.1,55.3,00000
90.0,86.0,71.0,207,01,01,  Faizullapur,420,1160,215,565,205,595,26.6,27.6,25.6,00000
90.0,86.0,71.0,207,02,01,  Saudisree,533,1150,274,554,259,596,31.7,33.1,30.3,00000
90.0,86.0,71.0,207,03,01,  Anandanagar,234,672,144,314,90,358,25.8,31.4,20.1,00000
90.0,86.0,71.0,222,01,01,  Datta Para,98,122,50,63,48,59,44.5,44.2,44.9,00000
90.0,86.0,71.0,222,02,01,  Shaskhai,364,267,187,119,177,148,57.7,61.1,54.5,00000
90.0,86.0,71.0,222,03,01,  Bishnupur,575,215,323,107,252,108,72.8,75.1,70.0,00000
90.0,86.0,71.0,326,01,01,  Rampur,148,146,62,72,86,74,50.3,46.3,53.8,00000
90.0,86.0,71.0,326,02,01,  Ditpur,136,96,67,43,69,53,58.6,60.9,56.6,00000
90.0,86.0,71.0,326,03,01,  Habibpur,433,652,241,309,192,343,39.9,43.8,35.9,00000
90.0,86.0,71.0,460,01,01,  Kashipur,343,1527,187,797,156,730,18.3,19.0,17.6,00000
90.0,86.0,71.0,460,02,01,  Bholanagar,55,166,25,86,30,80,24.9,22.5,27.3,00000
90.0,86.0,71.0,683,01,01,  Anandapur,438,981,232,456,206,525,30.9,33.7,28.2,00000
90.0,86.0,71.0,683,02,01,  Niamatpur,304,352,137,156,167,196,46.3,46.8,46.0,00000
90.0,86.0,71.0,683,03,01,  Chargaon,173,549,86,269,87,280,24.0,24.2,23.7,00000
90.0,86.0,95.0,163,01,01,  Chhabbisha,269,778,139,368,130,410,25.7,27.4,24.1,00000
90.0,86.0,95.0,163,02,01,  Dampur,269,761,145,385,124,376,26.1,27.4,24.8,00000
90.0,86.0,95.0,267,01,01,  Gobindapur,245,174,121,87,124,87,58.5,58.2,58.8,00000
90.0,86.0,95.0,267,02,01,  Kamargaon,8,277,7,136,1,141,2.8,4.9,0.7,00000
90.0,86.0,95.0,311,01,01,  Goani,185,135,104,65,81,70,57.8,61.5,53.6,00000
90.0,86.0,95.0,311,02,01,  Kartikpur,225,535,137,263,88,272,29.6,34.3,24.4,00000
90.0,86.0,95.0,386,01,01,  Bara Abda,283,213,152,102,131,111,57.1,59.8,54.1,00000
90.0,86.0,95.0,386,02,01,  Isakpur,49,386,34,198,15,188,11.3,14.7,7.4,00000
90.0,86.0,95.0,386,03,01,  Shonkarpur,10,118,6,61,4,57,7.8,9.0,6.6,00000
90.0,86.0,95.0,386,04,01,  Islam Pur,24,152,10,76,14,76,13.6,11.6,15.6,00000
90.0,86.0,95.0,475,01,01,  Keruala,96,172,58,76,38,96,35.8,43.3,28.4,00000
90.0,86.0,95.0,475,02,01,  Balarampur,114,97,64,39,50,58,54.0,62.1,46.3,00000
90.0,86.0,95.0,519,01,01,  Manua,427,444,232,214,195,230,49.0,52.0,45.9,00000
90.0,86.0,95.0,519,02,01,  Shimarkanda,168,683,107,344,61,339,19.7,23.7,15.3,00000
90.0,86.0,95.0,519,03,01,  Krishnapur,78,190,38,86,40,104,29.1,30.6,27.8,00000
90.0,86.0,95.0,668,01,01,  Nawagaon,74,162,41,90,33,72,31.4,31.3,31.4,00000
90.0,86.0,95.0,668,02,01,  Rahmatpur,77,234,36,123,41,111,24.8,22.6,27.0,00000
90.0,86.0,95.0,816,01,01,  Purba Iarabad,142,667,85,336,57,331,17.6,20.2,14.7,00000
90.0,86.0,95.0,816,02,01,  Nasirpur,53,175,28,84,25,91,23.2,25.0,21.6,00000
90.0,86.0,95.0,935,01,01,  Chhota Abda,23,277,15,142,8,135,7.7,9.6,5.6,00000
90.0,86.0,95.0,935,02,01,  Sreehail,271,856,141,446,130,410,24.0,24.0,24.1,00000
90.0,86.0,95.0,980,01,01,  Sulla,915,1807,465,926,450,881,33.6,33.4,33.8,00000
90.0,86.0,95.0,980,02,01,  Kadirpur,129,305,87,127,42,178,29.7,40.7,19.1,00000
90.0,86.0,95.0,980,03,01,  Durlabhpur,91,302,43,147,48,155,23.2,22.6,23.6,00000
90.0,86.0,95.0,980,04,01,  Sen Nagar,111,384,53,194,58,190,22.4,21.5,23.4,00000
90.0,89.0,10.0,024,01,01,  Alampur,205,690,107,312,98,378,22.9,25.5,20.6,00000
90.0,89.0,10.0,024,02,01,  Nayagaon,63,397,29,201,34,196,13.7,12.6,14.8,00000
90.0,89.0,10.0,136,01,01,  Natun Brahmangaon,117,60,59,26,58,34,66.1,69.4,63.0,00000
90.0,89.0,10.0,136,02,01,  Brahmangaon,823,1397,417,682,406,715,37.1,37.9,36.2,00000
90.0,89.0,10.0,136,03,01,  Hamilpur,81,228,41,112,40,116,26.2,26.8,25.6,00000
90.0,89.0,10.0,136,04,01,  Shakergaon,134,369,63,176,71,193,26.6,26.4,26.9,00000
90.0,89.0,10.0,136,05,01,  Achintapur,32,155,15,77,17,78,17.1,16.3,17.9,00000
90.0,89.0,10.0,486,01,01,  Shahpur,187,477,99,226,88,251,28.2,30.5,26.0,00000
90.0,89.0,10.0,486,02,01,  Kairghat,46,61,24,30,22,31,43.0,44.4,41.5,00000
90.0,89.0,10.0,486,03,01,  Hasan Bahar,198,621,111,297,87,324,24.2,27.2,21.2,00000
90.0,89.0,10.0,486,04,01,  Hasanpur,61,225,25,103,36,122,21.3,19.5,22.8,00000
90.0,89.0,10.0,581,01,01,  Maijbari,1152,1583,595,781,557,802,42.1,43.2,41.0,00000
90.0,89.0,10.0,581,02,01,  Rajnagar (Haluargaon),16,107,11,54,5,53,13.0,16.9,8.6,00000
90.0,89.0,10.0,928,01,01,  Kalarkanda,27,84,11,43,16,41,24.3,20.4,28.1,00000
90.0,89.0,10.0,928,02,01,  Lalar Char,108,219,64,101,44,118,33.0,38.8,27.2,00000
90.0,89.0,27.0,003,01,01,  Achintapur,356,906,204,498,152,408,28.2,29.1,27.1,00000
90.0,89.0,27.0,003,02,01,  Bahadurpur,28,40,13,21,15,19,41.2,38.2,44.1,00000
90.0,89.0,27.0,003,03,01,  Chandpur,105,176,56,87,49,89,37.4,39.2,35.5,00000
90.0,89.0,27.0,003,04,01,  Gobindapur,58,114,36,49,22,65,33.7,42.4,25.3,00000
90.0,89.0,27.0,003,05,01,  Rajargaon,92,335,58,159,34,176,21.5,26.7,16.2,00000
90.0,89.0,27.0,003,06,01,  Radhanagar,118,430,57,212,61,218,21.5,21.2,21.9,00000
90.0,89.0,27.0,003,07,01,  Biytakhali,231,207,120,90,111,117,52.7,57.1,48.7,00000
90.0,89.0,27.0,003,08,01,  Baraghat,272,517,142,244,130,273,34.5,36.8,32.3,00000
90.0,89.0,27.0,010,01,01,  Ahmadabad,178,191,95,88,83,103,48.2,51.9,44.6,00000
90.0,89.0,27.0,010,02,01,  Naogaon,18,119,8,59,10,60,13.1,11.9,14.3,00000
90.0,89.0,27.0,014,01,01,  Doalpasi,72,165,38,87,34,78,30.4,30.4,30.4,00000
90.0,89.0,27.0,014,02,01,  Dampara,148,305,83,152,65,153,32.7,35.3,29.8,00000
90.0,89.0,27.0,336,01,01,  Gaura Ranga Bade,379,1368,178,679,201,689,21.7,20.8,22.6,00000
90.0,89.0,27.0,336,02,01,  Purangaon,103,209,54,103,49,106,33.0,34.4,31.6,00000
90.0,89.0,27.0,336,03,01,  Kandigaon,134,339,75,159,59,180,28.3,32.1,24.7,00000
90.0,89.0,27.0,336,04,01,  Barigaon,68,83,33,48,35,35,45.0,40.7,50.0,00000
90.0,89.0,27.0,336,05,01,  Upandranagar,32,103,15,60,17,43,23.7,20.0,28.3,00000
90.0,89.0,27.0,388,01,01,  Hossainpur,242,333,131,163,111,170,42.1,44.6,39.5,00000
90.0,89.0,27.0,388,02,01,  Manmatar Char,135,241,89,104,46,137,35.9,46.1,25.1,00000
90.0,89.0,27.0,599,01,01,  Harinagar,136,333,56,169,80,164,29.0,24.9,32.8,00000
90.0,89.0,27.0,599,02,01,  Nawagaon,185,633,90,323,95,310,22.6,21.8,23.5,00000
90.0,89.0,27.0,599,03,01,  Naluarpar,151,553,86,274,65,279,21.4,23.9,18.9,00000
90.0,89.0,27.0,599,04,01,  Jagannathpur,152,485,81,236,71,249,23.9,25.6,22.2,00000
90.0,89.0,27.0,658,01,01,  Nidhir Char,167,313,93,157,74,156,34.8,37.2,32.2,00000
90.0,89.0,27.0,658,02,01,  Berajali,153,364,88,178,65,186,29.6,33.1,25.9,00000
90.0,89.0,27.0,658,03,01,  Umedsree,193,732,94,332,99,400,20.9,22.1,19.8,00000
90.0,89.0,27.0,725,01,01,  Puran Lakshmansree,355,481,198,208,157,273,42.5,48.8,36.5,00000
90.0,89.0,27.0,725,02,01,  Jogirgaon,358,899,190,418,168,481,28.5,31.3,25.9,00000
90.0,89.0,27.0,730,01,01,  Sonapur,491,899,275,418,216,481,35.3,39.7,31.0,00000
90.0,89.0,27.0,730,02,01,  Lalpur,863,1663,425,810,438,853,34.2,34.4,33.9,00000
90.0,89.0,27.0,730,03,01,  Sakterpur,269,409,152,196,117,213,39.7,43.7,35.5,00000
90.0,89.0,27.0,795,01,01,  Ujan Sapahala,258,596,138,272,120,324,30.2,33.7,27.0,00000
90.0,89.0,27.0,795,02,01,  Bhati Sapahala,437,819,230,378,207,441,34.8,37.8,31.9,00000
90.0,89.0,27.0,907,01,01,  Tukergaon,162,429,85,208,77,221,27.4,29.0,25.8,00000
90.0,89.0,27.0,907,02,01,  Hasnabad,172,274,90,126,82,148,38.6,41.7,35.7,00000
90.0,89.0,33.0,322,01,01,  Dolora,212,265,116,133,96,132,44.4,46.6,42.1,00000
90.0,89.0,33.0,322,02,01,  Fenibil,243,751,124,354,119,397,24.4,25.9,23.1,00000
90.0,89.0,33.0,322,03,01,  Natun Gudigaon,425,681,230,325,195,356,38.4,41.4,35.4,00000
90.0,89.0,33.0,322,04,01,  Puratan Gudigaon,370,362,190,180,180,182,50.5,51.4,49.7,00000
90.0,89.0,33.0,322,05,01,  Noyidar Khamar,67,433,38,202,29,231,13.4,15.8,11.2,00000
90.0,89.0,33.0,322,06,01,  Jharjharia,754,1465,393,710,361,755,34.0,35.6,32.3,00000
90.0,89.0,33.0,322,07,01,  Ampara,186,507,90,243,96,264,26.8,27.0,26.7,00000
90.0,89.0,33.0,322,08,01,  Rajanagar,158,178,93,75,65,103,47.0,55.4,38.7,00000
90.0,89.0,33.0,341,01,01,  Ghasigaon,321,518,180,229,141,289,38.3,44.0,32.8,00000
90.0,89.0,33.0,341,02,01,  Kamargaon,148,259,68,119,80,140,36.4,36.4,36.4,00000
90.0,89.0,33.0,341,03,01,  Aimagaon,47,118,28,55,19,63,28.5,33.7,23.2,00000
90.0,89.0,33.0,341,04,01,  Nurujpur,164,415,92,192,72,223,28.3,32.4,24.4,00000
90.0,89.0,33.0,341,05,01,  Jahangirnagar,299,613,142,274,157,339,32.8,34.1,31.7,00000
90.0,89.0,33.0,341,06,01,  Mirar Char,67,119,32,57,35,62,36.0,36.0,36.1,00000
90.0,89.0,33.0,341,07,01,  Mangalkata,777,757,422,356,355,401,50.7,54.2,47.0,00000
90.0,89.0,33.0,341,08,01,  Dulaipar,192,328,101,150,91,178,36.9,40.2,33.8,00000
90.0,89.0,33.0,341,09,01,  Khagergaon,269,307,127,130,142,177,46.7,49.4,44.5,00000
90.0,89.0,33.0,341,10,01,  Islampur,446,724,217,329,229,395,38.1,39.7,36.7,00000
90.0,89.0,33.0,660,01,01,  Narayantala (Comilla Hati),261,266,127,115,134,151,49.5,52.5,47.0,00000
90.0,89.0,33.0,660,02,01,  Kamar Bhita,116,459,59,235,57,224,20.2,20.1,20.3,00000
90.0,89.0,33.0,660,03,01,  Kona Para,198,188,100,85,98,103,51.3,54.1,48.8,00000
90.0,89.0,33.0,660,04,01,  Kanda Para,223,281,115,141,108,140,44.2,44.9,43.5,00000
90.0,89.0,33.0,660,05,01,  Mugai Para,383,105,184,52,199,53,78.5,78.0,79.0,00000
90.0,89.0,33.0,660,06,01,  Malaigaon,68,247,40,117,28,130,21.6,25.5,17.7,00000
90.0,89.0,33.0,660,07,01,  Kanthalbari,118,292,63,155,55,137,28.8,28.9,28.6,00000
90.0,89.0,33.0,660,08,01,  Guchagram,79,141,49,69,30,72,35.9,41.5,29.4,00000
90.0,89.0,33.0,780,01,01,  Ratargaon (Kayargaon Part),346,1829,177,987,169,842,15.9,15.2,16.7,00000
90.0,89.0,33.0,780,02,01,  Dakshandolura,30,524,12,252,18,272,5.4,4.5,6.2,00000
90.0,89.0,36.0,493,01,01,  Kalaiya,453,1181,228,538,225,643,27.7,29.8,25.9,00000
90.0,89.0,36.0,493,02,01,  Nawagaon,186,1387,113,630,73,757,11.8,15.2,8.8,00000
90.0,89.0,36.0,574,01,01,  Magura,284,702,149,341,135,361,28.8,30.4,27.2,00000
90.0,89.0,36.0,574,02,01,  Hasan Nagar,180,414,96,201,84,213,30.3,32.3,28.3,00000
90.0,89.0,36.0,651,01,01,  Narkila,24,241,14,110,10,131,9.1,11.3,7.1,00000
90.0,89.0,36.0,651,02,01,  Chanditior,13,235,7,112,6,123,5.2,5.9,4.7,00000
90.0,89.0,36.0,651,03,01,  Jagjibanpur,219,310,116,140,103,170,41.4,45.3,37.7,00000
90.0,89.0,36.0,651,04,01,  Brahmangaon,108,200,58,98,50,102,35.1,37.2,32.9,00000
90.0,89.0,36.0,651,05,01,  Gulergaon,263,563,146,260,117,303,31.8,36.0,27.9,00000
90.0,89.0,36.0,651,06,01,  Katair,240,234,130,113,110,121,50.6,53.5,47.6,00000
90.0,89.0,36.0,791,01,01,  Puran Sakhaiti,92,208,54,98,38,110,30.7,35.5,25.7,00000
90.0,89.0,36.0,791,02,01,  Natun Sakhaiti,632,1319,348,625,284,694,32.4,35.8,29.0,00000
90.0,89.0,39.0,105,01,01,  Bahadurpur,309,804,146,434,163,370,27.8,25.2,30.6,00000
90.0,89.0,39.0,105,02,01,  Baroghar,147,145,76,66,71,79,50.3,53.5,47.3,00000
90.0,89.0,39.0,105,03,01,  Haluargoan,329,268,184,125,145,143,55.1,59.5,50.3,00000
90.0,89.0,39.0,430,01,03,  Jalilpur,9,73,4,37,5,36,11.0,9.8,12.2,00000
90.0,89.0,39.0,430,02,03,  Fakirnagar,121,472,63,225,58,247,20.4,21.9,19.0,00000
90.0,89.0,39.0,469,01,01,  Janigaon,537,1494,288,736,249,758,26.4,28.1,24.7,00000
90.0,89.0,39.0,469,02,01,  Salimpur,65,209,38,96,27,113,23.7,28.4,19.3,00000
90.0,89.0,39.0,469,03,01,  Rabarbari,374,574,192,278,182,296,39.5,40.9,38.1,00000
90.0,89.0,39.0,515,01,01,  Lilpur,173,608,86,285,87,323,22.2,23.2,21.2,00000
90.0,89.0,39.0,515,02,01,  Gobindapur,381,640,183,315,198,325,37.3,36.7,37.9,00000
90.0,89.0,39.0,515,03,01,  Madanpur,21,302,15,151,6,151,6.5,9.0,3.8,00000
90.0,89.0,39.0,515,04,01,  Ghosh Madanpur,302,706,158,339,144,367,30.0,31.8,28.2,00000
90.0,89.0,39.0,515,05,01,  Tajpur,43,279,24,131,19,148,13.4,15.5,11.4,00000
90.0,89.0,50.0,273,01,01,  Mohanpur,313,1496,188,717,125,779,17.3,20.8,13.8,00000
90.0,89.0,50.0,273,02,01,  Sardarpur,167,407,89,198,78,209,29.1,31.0,27.2,00000
90.0,89.0,50.0,273,03,01,  Joynagar,484,165,238,72,246,93,74.6,76.8,72.6,00000
90.0,89.0,50.0,273,04,01,  Santipur,46,101,26,48,20,53,31.3,35.1,27.4,00000
90.0,89.0,50.0,273,05,01,  Tajnagar (Nayahati),169,280,89,143,80,137,37.6,38.4,36.9,00000
90.0,89.0,50.0,655,01,01,  Naukakhali,98,319,50,138,48,181,23.5,26.6,21.0,00000
90.0,89.0,50.0,655,02,01,  Murarband,328,482,153,212,175,270,40.5,41.9,39.3,00000
90.0,89.0,50.0,655,03,01,  Rashnagar,133,313,63,142,70,171,29.8,30.7,29.0,00000
90.0,89.0,50.0,655,04,01,  Banipur,247,564,140,268,107,296,30.5,34.3,26.6,00000
90.0,89.0,50.0,655,05,01,  Brahmuttar,412,449,222,217,190,232,47.9,50.6,45.0,00000
90.0,89.0,50.0,679,01,01,  Natun Painda,364,1037,177,512,187,525,26.0,25.7,26.3,00000
90.0,89.0,50.0,679,02,01,  Puran Painda,262,91,124,46,138,45,74.2,72.9,75.4,00000
90.0,89.0,55.0,059,01,01,  Bade Sadakpur,134,646,71,326,63,320,17.2,17.9,16.4,00000
90.0,89.0,55.0,059,02,01,  Tupikona (Dupi Kona),17,91,11,38,6,53,15.7,22.4,10.2,00000
90.0,89.0,55.0,059,03,01,  Shantipur,8,32,5,13,3,19,20.0,27.8,13.6,00000
90.0,89.0,55.0,059,04,01,  Ganipur,26,52,17,20,9,32,33.3,45.9,22.0,00000
90.0,89.0,55.0,220,01,01,  Jagannathpur,71,190,33,85,38,105,27.2,28.0,26.6,00000
90.0,89.0,55.0,220,02,01,  Bhabanipur,2,109,0,55,2,54,1.8,0.0,3.6,00000
90.0,89.0,55.0,220,03,01,  Lalpur,236,612,108,301,128,311,27.8,26.4,29.2,00000
90.0,89.0,55.0,353,01,01,  Burisatal,145,138,66,81,79,57,51.2,44.9,58.1,00000
90.0,89.0,55.0,353,02,01,  Rowarpar,7,76,3,30,4,46,8.4,9.1,8.0,00000
90.0,89.0,55.0,353,03,01,  Hurmatnagar,68,224,34,109,34,115,23.3,23.8,22.8,00000
90.0,89.0,55.0,353,04,01,  Goachhara,43,326,23,161,20,165,11.7,12.5,10.8,00000
90.0,89.0,55.0,353,05,01,  Hasan Hussain,8,76,5,38,3,38,9.5,11.6,7.3,00000
90.0,89.0,55.0,427,01,01,  Uchargaon,67,370,38,162,29,208,15.3,19.0,12.2,00000
90.0,89.0,55.0,427,02,01,  Sardabaj,131,126,62,47,69,79,51.0,56.9,46.6,00000
90.0,89.0,55.0,427,03,01,  Pirpur,32,360,10,186,22,174,8.2,5.1,11.2,00000
90.0,89.0,55.0,427,04,01,  Bade Abdullahpur,204,155,102,76,102,79,56.8,57.3,56.4,00000
90.0,89.0,55.0,427,05,01,  Abdullahpur,104,323,45,167,59,156,24.4,21.2,27.4,00000
90.0,89.0,55.0,497,01,01,  Durlabhpur,33,252,16,121,17,131,11.6,11.7,11.5,00000
90.0,89.0,55.0,497,02,01,  Akilpur,35,252,19,132,16,120,12.2,12.6,11.8,00000
90.0,89.0,55.0,497,03,01,  Rahmanpur,61,143,36,70,25,73,29.9,34.0,25.5,00000
90.0,89.0,55.0,497,04,01,  Ratanpur,62,176,33,88,29,88,26.1,27.3,24.8,00000
90.0,89.0,55.0,497,05,01,  Jalalpur,395,466,194,206,201,260,45.9,48.5,43.6,00000
90.0,89.0,55.0,497,06,01,  Nagergaon,56,63,30,28,26,35,47.1,51.7,42.6,00000
90.0,89.0,55.0,497,07,01,  Barigaon,5,18,2,8,3,10,21.7,20.0,23.1,00000
90.0,89.0,55.0,501,01,01,  Sholabagi Chak,80,105,47,46,33,59,43.2,50.5,35.9,00000
90.0,89.0,55.0,501,02,01,  Madhupur,81,156,41,78,40,78,34.2,34.5,33.9,00000
90.0,89.0,55.0,571,01,01,  Dariabaj,307,688,152,331,155,357,30.9,31.5,30.3,00000
90.0,89.0,55.0,571,02,01,  Eachagari,323,309,165,140,158,169,51.1,54.1,48.3,00000
90.0,89.0,55.0,707,01,01,  Kalaura,89,128,49,59,40,69,41.0,45.4,36.7,00000
90.0,89.0,55.0,707,02,01,  Haripur,62,148,35,74,27,74,29.5,32.1,26.7,00000
90.0,89.0,55.0,707,03,01,  Jagjibanpur,129,296,62,142,67,154,30.4,30.4,30.3,00000
90.0,89.0,55.0,707,04,01,  Anantapur Kandi,107,116,57,57,50,59,48.0,50.0,45.9,00000
90.0,89.0,55.0,707,05,01,  Sadekpur,229,344,120,157,109,187,40.0,43.3,36.8,00000
90.0,89.0,55.0,707,06,01,  Sreenathpur,134,115,78,46,56,69,53.8,62.9,44.8,00000
90.0,89.0,55.0,707,07,01,  Ramnagar,133,81,74,28,59,53,62.1,72.5,52.7,00000
90.0,89.0,55.0,707,08,01,  Amtail,59,127,28,60,31,67,31.7,31.8,31.6,00000
90.0,89.0,55.0,707,09,01,  Muchi Para,0,40,0,24,0,16,0.0,0.0,0.0,00000
90.0,89.0,55.0,949,01,01,  Jaifarpur,116,261,55,123,61,138,30.8,30.9,30.7,00000
90.0,89.0,55.0,949,02,01,  Sarifban,64,139,31,59,33,80,31.5,34.4,29.2,00000
90.0,89.0,55.0,949,03,01,  Maukhola,37,54,19,24,18,30,40.7,44.2,37.5,00000
90.0,89.0,55.0,982,01,01,  Rameshwarpur,135,454,80,216,55,238,22.9,27.0,18.8,00000
90.0,89.0,55.0,982,02,01,  Mollah Para,258,246,113,120,145,126,51.2,48.5,53.5,00000
90.0,89.0,55.0,982,03,01,  Khagura,109,493,57,246,52,247,18.1,18.8,17.4,00000
90.0,89.0,72.0,087,01,01,  Ballabhpur,119,219,68,96,51,123,35.2,41.5,29.3,00000
90.0,89.0,72.0,087,02,01,  Kandigaon,8,21,6,10,2,11,27.6,37.5,15.4,00000
90.0,89.0,72.0,091,01,01,  Kadamtali,126,146,63,69,63,77,46.3,47.7,45.0,00000
90.0,89.0,72.0,091,02,01,  Brindaban Nagar,271,825,141,383,130,442,24.7,26.9,22.7,00000
90.0,89.0,72.0,091,03,01,  Chandpur,35,236,22,115,13,121,12.9,16.1,9.7,00000
90.0,89.0,72.0,091,04,01,  Naogaon,204,444,97,209,107,235,31.5,31.7,31.3,00000
90.0,89.0,72.0,371,01,01,  Purbapara,454,1435,233,701,221,734,24.0,24.9,23.1,00000
90.0,89.0,72.0,371,02,01,  Paschimpara,523,1894,262,899,261,995,21.6,22.6,20.8,00000
90.0,89.0,72.0,382,01,01,  Hasaura,426,754,210,345,216,409,36.1,37.8,34.6,00000
90.0,89.0,72.0,382,02,01,  Shahpur,102,264,48,120,54,144,27.9,28.6,27.3,00000
90.0,89.0,72.0,382,03,01,  Rasulpur,107,319,49,148,58,171,25.1,24.9,25.3,00000
90.0,89.0,72.0,763,01,01,  Rangar Char,838,1058,432,476,406,582,44.2,47.6,41.1,00000
90.0,89.0,72.0,763,02,01,  Chatlarpar,83,288,40,146,43,142,22.4,21.5,23.2,00000
90.0,89.0,72.0,840,01,01,  Kishoreganj Hati,83,253,37,123,46,130,24.7,23.1,26.1,00000
90.0,89.0,72.0,840,02,01,  Singpurhati,48,447,21,222,27,225,9.7,8.6,10.7,00000
90.0,89.0,72.0,891,01,01,  Bangaon,213,496,108,218,105,278,30.0,33.1,27.4,00000
90.0,89.0,72.0,891,02,01,  Somadnagar,323,914,150,446,173,468,26.1,25.2,27.0,00000
90.0,89.0,72.0,959,01,01,  Uttar Muradpur (Rangpur Hati,100,104,49,47,51,57,49.0,51.0,47.2,00000
90.0,89.0,72.0,959,02,01,  Bakter Gaon,41,124,20,69,21,55,24.8,22.5,27.6,00000
90.0,89.0,77.0,016,01,01,  Akshaynagar,251,450,143,200,108,250,35.8,41.7,30.2,00000
90.0,89.0,77.0,016,02,01,  Hurarkanda,313,310,186,137,127,173,50.2,57.6,42.3,00000
90.0,89.0,77.0,016,03,01,  Muslimpur,276,594,143,308,133,286,31.7,31.7,31.7,00000
90.0,89.0,77.0,122,01,01,  Haluargoan,44,227,24,118,20,109,16.2,16.9,15.5,00000
90.0,89.0,77.0,122,02,01,  Balikandi,482,1390,245,667,237,723,25.7,26.9,24.7,00000
90.0,89.0,77.0,122,03,01,  Parbatipur,128,430,65,207,63,223,22.9,23.9,22.0,00000
90.0,89.0,77.0,122,04,01,  Belabar Hati,104,425,58,200,46,225,19.7,22.5,17.0,00000
90.0,89.0,77.0,122,05,01,  Sholaghar,85,379,42,165,43,214,18.3,20.3,16.7,00000
90.0,89.0,77.0,122,06,01,  Rahmatpur,168,295,84,157,84,138,36.3,34.9,37.8,00000
90.0,89.0,77.0,322,01,01,  Krishnanagar,94,288,45,135,49,153,24.6,25.0,24.3,00000
90.0,89.0,77.0,322,02,01,  Sahebnagar,20,161,12,82,8,79,11.0,12.8,9.2,00000
90.0,89.0,77.0,322,03,01,  Banipur,98,232,46,104,52,128,29.7,30.7,28.9,00000
90.0,89.0,77.0,322,05,01,  Konagoan(Part),61,268,32,123,29,145,18.5,20.6,16.7,00000
90.0,89.0,77.0,341,07,01,  Baghmara,276,408,153,194,123,214,40.4,44.1,36.5,00000
90.0,89.0,77.0,341,08,01,  Dalagaon,82,143,39,64,43,79,36.4,37.9,35.2,00000
90.0,89.0,77.0,341,09,01,  Konagaon (Part),50,47,25,26,25,21,51.5,49.0,54.3,00000
90.0,89.0,77.0,341,11,01,  Baisharpar,358,351,163,162,195,189,50.5,50.2,50.8,00000
90.0,89.0,77.0,341,12,01,  Sahebnagar,222,342,111,169,111,173,39.4,39.6,39.1,00000
90.0,89.0,77.0,341,13,01,  Terapur,189,243,98,113,91,130,43.8,46.4,41.2,00000
90.0,89.0,77.0,392,01,01,  Ibrahimpur,1671,1992,963,922,708,1070,45.6,51.1,39.8,00000
90.0,89.0,77.0,392,02,01,  Jagannathpur,251,416,138,200,113,216,37.6,40.8,34.3,00000
90.0,89.0,77.0,784,01,01,  Sadargar,297,1028,158,511,139,517,22.4,23.6,21.2,00000
90.0,89.0,77.0,784,02,01,  Amirganj,38,100,23,48,15,52,27.5,32.4,22.4,00000
90.0,89.0,77.0,784,03,01,  Amirpur,50,468,29,244,21,224,9.7,10.6,8.6,00000
90.0,89.0,77.0,784,04,01,  Kuratala,49,318,27,198,22,120,13.4,12.0,15.5,00000
90.0,89.0,77.0,882,01,01,  Saidpur,1145,2452,567,1150,578,1302,31.8,33.0,30.7,00000
90.0,89.0,77.0,882,02,01,  Muslimpur,35,203,15,94,20,109,14.7,13.8,15.5,00000
90.0,89.0,77.0,882,03,01,  Berigaon,354,647,208,305,146,342,35.4,40.5,29.9,00000
90.0,89.0,77.0,882,04,01,  Nalua,115,191,64,99,51,92,37.6,39.3,35.7,00000
90.0,89.0,77.0,882,05,01,  Banipur (Part),70,67,38,32,32,35,51.1,54.3,47.8,00000
90.0,89.0,77.0,882,06,01,  Krishnanagar (Part),156,237,79,114,77,123,39.7,40.9,38.5,00000
90.0,89.0,77.0,966,01,01,  Manpur,419,1191,230,570,189,621,26.0,28.8,23.3,00000
90.0,89.0,77.0,966,02,01,  Haluaghat,87,180,47,101,40,79,32.6,31.8,33.6,00000
90.0,89.0,77.0,966,03,01,  Radhartek,65,192,36,97,29,95,25.3,27.1,23.4,00000
90.0,92.0,10.0,039,01,01,  Anwarpur,561,1043,296,506,265,537,35.0,36.9,33.0,00000
90.0,92.0,10.0,039,02,01,  Anwarpur Bazar,107,104,89,66,18,38,50.7,57.4,32.1,00000
90.0,92.0,10.0,064,01,01,  Balijuri,477,1531,229,786,248,745,23.8,22.6,25.0,00000
90.0,92.0,10.0,064,02,01,  Kala Para,137,462,61,226,76,236,22.9,21.3,24.4,00000
90.0,92.0,10.0,064,03,01,  Lama Para,198,537,86,285,112,252,26.9,23.2,30.8,00000
90.0,92.0,10.0,064,04,01,  Balijuri Bazar,6,8,6,8,0,0,42.9,42.9,0.0,00000
90.0,92.0,10.0,064,05,01,  Nayahata,258,193,121,92,137,101,57.2,56.8,57.6,00000
90.0,92.0,10.0,064,06,01,  Shundharpur,51,120,21,62,30,58,29.8,25.3,34.1,00000
90.0,92.0,10.0,064,07,01,  Ramnagar,148,96,64,59,84,37,60.7,52.0,69.4,00000
90.0,92.0,10.0,358,01,01,  Hosenpur,75,224,43,115,32,109,25.1,27.2,22.7,00000
90.0,92.0,10.0,358,02,01,  Dakshinkul,420,1080,225,507,195,573,28.0,30.7,25.4,00000
90.0,92.0,10.0,532,01,01,  Lohachura,326,430,173,197,153,233,43.1,46.8,39.6,00000
90.0,92.0,10.0,532,02,01,  Raghunathpur,46,44,26,20,20,24,51.1,56.5,45.5,00000
90.0,92.0,10.0,597,01,01,  Mangpur,132,141,62,74,70,67,48.4,45.6,51.1,00000
90.0,92.0,10.0,597,02,01,  Sifatnagar,47,27,25,12,22,15,63.5,67.6,59.5,00000
90.0,92.0,10.0,736,01,01,  Puran Barunka,466,522,239,247,227,275,47.2,49.2,45.2,00000
90.0,92.0,10.0,736,02,01,  Patari,91,84,43,42,48,42,52.0,50.6,53.3,00000
90.0,92.0,33.0,099,01,01,  Bhabanipur,120,62,61,32,59,30,65.9,65.6,66.3,00000
90.0,92.0,33.0,099,02,01,  Balaikandi,45,64,24,30,21,34,41.3,44.4,38.2,00000
90.0,92.0,33.0,288,01,01,  Dumal,210,281,100,145,110,136,42.8,40.8,44.7,00000
90.0,92.0,33.0,288,02,01,  Shibpur,42,66,23,40,19,26,38.9,36.5,42.2,00000
90.0,92.0,33.0,383,01,01,  Gopinather Noagaon,43,241,31,114,12,127,15.1,21.4,8.6,00000
90.0,92.0,33.0,383,02,01,  Noanagar,198,326,101,164,97,162,37.8,38.1,37.5,00000
90.0,92.0,33.0,383,03,01,  Marala,198,282,105,150,93,132,41.3,41.2,41.3,00000
90.0,92.0,33.0,383,04,01,  Jagadishpur,17,111,10,55,7,56,13.3,15.4,11.1,00000
90.0,92.0,33.0,383,06,01,  Jalalpur,16,90,8,45,8,45,15.1,15.1,15.1,00000
90.0,92.0,33.0,407,01,01,  Janjail,30,124,23,57,7,67,19.5,28.8,9.5,00000
90.0,92.0,33.0,407,02,01,  Santoshpur,60,163,27,85,33,78,26.9,24.1,29.7,00000
90.0,92.0,33.0,487,01,01,  Sarifpur,35,125,25,55,10,70,21.9,31.3,12.5,00000
90.0,92.0,33.0,487,02,01,  Durlabhpur,76,726,42,357,34,369,9.5,10.5,8.4,00000
90.0,92.0,33.0,502,01,01,  Lamagaon,505,953,271,461,234,492,34.6,37.0,32.2,00000
90.0,92.0,33.0,502,02,01,  Ramsinghpur,150,321,85,158,65,163,31.8,35.0,28.5,00000
90.0,92.0,33.0,502,03,01,  Hukumpur,119,261,63,128,56,133,31.3,33.0,29.6,00000
90.0,92.0,33.0,567,01,01,  Mahmudpur,236,399,134,200,102,199,37.2,40.1,33.9,00000
90.0,92.0,33.0,567,02,01,  Gorergaon,9,35,6,18,3,17,20.5,25.0,15.0,00000
90.0,92.0,33.0,567,03,01,  Parabekai,172,222,78,115,94,107,43.7,40.4,46.8,00000
90.0,92.0,33.0,567,04,01,  Bhander Chapar,52,71,26,35,26,36,42.3,42.6,41.9,00000
90.0,92.0,33.0,631,01,01,  Moazzampur,109,105,48,55,61,50,50.9,46.6,55.0,00000
90.0,92.0,33.0,631,02,01,  Joysree,141,317,73,172,68,145,30.8,29.8,31.9,00000
90.0,92.0,33.0,631,03,01,  Noagaon,51,217,26,103,25,114,19.0,20.2,18.0,00000
90.0,92.0,33.0,631,04,01,  Uktiyargaon,32,182,14,91,18,91,15.0,13.3,16.5,00000
90.0,92.0,33.0,706,01,01,  Paindub,187,397,94,186,93,211,32.0,33.6,30.6,00000
90.0,92.0,33.0,706,02,01,  Kamdebpur,61,182,31,82,30,100,25.1,27.4,23.1,00000
90.0,92.0,33.0,766,01,01,  Purba Nischintapur,25,259,12,124,13,135,8.8,8.8,8.8,00000
90.0,92.0,33.0,766,02,01,  Ekrampur,51,87,29,42,22,45,37.0,40.8,32.8,00000
90.0,92.0,33.0,820,01,01,  Ramjibanpur,145,509,94,237,51,272,22.2,28.4,15.8,00000
90.0,92.0,33.0,820,02,01,  Rajdharpur,23,104,14,48,9,56,18.1,22.6,13.8,00000
90.0,92.0,33.0,820,03,01,  Sahebnagar,37,215,17,110,20,105,14.7,13.4,16.0,00000
90.0,92.0,33.0,920,01,01,  Sreepur,798,688,597,400,201,288,53.7,59.9,41.1,00000
90.0,92.0,33.0,920,02,01,  Sahaganj,70,235,39,111,31,124,23.0,26.0,20.0,00000
90.0,92.0,43.0,333,01,01,  Hapania,35,286,23,142,12,144,10.9,13.9,7.7,00000
90.0,92.0,43.0,333,02,01,  Matikata,178,893,99,437,79,456,16.6,18.5,14.8,00000
90.0,92.0,43.0,676,01,01,  Baradal Puranhati,493,845,239,417,254,428,36.8,36.4,37.2,00000
90.0,92.0,43.0,676,02,01,  Baradal Nayahati,651,862,340,422,311,440,43.0,44.6,41.4,00000
90.0,92.0,43.0,676,03,01,  Bagbari,231,254,116,132,115,122,47.6,46.8,48.5,00000
90.0,92.0,43.0,800,01,01,  Rasulpur,96,863,52,433,44,430,10.0,10.7,9.3,00000
90.0,92.0,43.0,800,02,01,  Gobindpur,24,99,12,41,12,58,19.5,22.6,17.1,00000
90.0,92.0,43.0,800,03,01,  Thkergaon,23,258,16,132,7,126,8.2,10.8,5.3,00000
90.0,92.0,64.0,218,01,01,  Birsnagar,352,378,170,180,182,198,48.2,48.6,47.9,00000
90.0,92.0,64.0,218,02,01,  Chiksa,914,1148,465,546,449,602,44.3,46.0,42.7,00000
90.0,92.0,64.0,388,01,01,  Ujan Jamalgar,157,300,92,132,65,168,34.4,41.1,27.9,00000
90.0,92.0,64.0,388,02,01,  Bhari Jamalgar,123,592,70,292,53,300,17.2,19.3,15.0,00000
90.0,92.0,64.0,388,03,01,  Gazipur,34,365,20,187,14,178,8.5,9.7,7.3,00000
90.0,92.0,64.0,388,04,01,  Lakshmipur,96,520,51,274,45,246,15.6,15.7,15.5,00000
90.0,92.0,64.0,388,05,01,  Surjergaon,341,518,185,227,156,291,39.7,44.9,34.9,00000
90.0,92.0,64.0,935,01,03,  Gobindasree,491,819,318,473,173,346,37.5,40.2,33.3,00000
90.0,92.0,64.0,935,02,03,  Thakurhati,209,149,115,68,94,81,58.4,62.8,53.7,00000
90.0,92.0,64.0,935,03,03,  Bhati Tahirpur,662,914,371,429,291,485,42.0,46.4,37.5,00000
90.0,92.0,64.0,935,04,03,  Tahirpur Bazar,73,31,55,26,18,5,70.2,67.9,78.3,00000
90.0,92.0,64.0,935,05,03,  Madyha Tahirpur,1148,1293,635,599,513,694,47.0,51.5,42.5,00000
90.0,92.0,64.0,935,06,03,  Ujan Tahirpur,699,335,348,157,351,178,67.6,68.9,66.4,00000
90.0,92.0,64.0,935,07,03,  Dhumta,199,238,111,115,88,123,45.5,49.1,41.7,00000
90.0,92.0,64.0,935,08,03,  Joynagar,270,179,140,95,130,84,60.1,59.6,60.7,00000
90.0,92.0,71.0,160,01,01,  Mudegaon,400,445,243,184,157,261,47.3,56.9,37.6,00000
90.0,92.0,71.0,160,02,01,  Kamalpur,87,51,46,22,41,29,63.0,67.6,58.6,00000
90.0,92.0,71.0,196,01,01,  Ghagtika,613,825,349,350,264,475,42.6,49.9,35.7,00000
90.0,92.0,71.0,196,02,01,  Nowa Para,277,431,153,177,124,254,39.1,46.4,32.8,00000
90.0,92.0,71.0,196,03,01,  Kaikorpara,169,303,97,135,72,168,35.8,41.8,30.0,00000
90.0,92.0,71.0,308,01,01,  Jaitapur,197,452,101,217,96,235,30.4,31.8,29.0,00000
90.0,92.0,71.0,308,02,01,  Gharkati,108,182,46,95,62,87,37.2,32.6,41.6,00000
90.0,92.0,71.0,415,01,01,  Kamraband,1259,954,657,460,602,494,56.9,58.8,54.9,00000
90.0,92.0,71.0,415,02,01,  Mallikpur,172,323,81,162,91,161,34.7,33.3,36.1,00000
90.0,92.0,71.0,415,03,01,  Badaghat Bazar,410,296,237,172,173,124,58.1,57.9,58.2,00000
90.0,92.0,71.0,415,04,01,  Badaghat,485,143,278,59,207,84,77.2,82.5,71.1,00000
90.0,92.0,71.0,415,05,01,  Nanai,261,495,143,243,118,252,34.5,37.0,31.9,00000
90.0,92.0,71.0,415,06,01,  Bholakhali,99,153,53,70,46,83,39.3,43.1,35.7,00000
90.0,92.0,71.0,415,07,01,  Badlarpar,120,293,66,142,54,151,29.1,31.7,26.3,00000
90.0,92.0,71.0,415,08,01,  Nagarpur,361,509,207,227,154,282,41.5,47.7,35.3,00000
90.0,92.0,71.0,415,09,01,  Noagaon,89,255,57,121,32,134,25.9,32.0,19.3,00000
90.0,92.0,71.0,415,10,01,  Sonapur,100,434,64,189,36,245,18.7,25.3,12.8,00000
90.0,92.0,71.0,415,11,01,  Kalipur,30,272,18,139,12,133,9.9,11.5,8.3,00000
90.0,92.0,71.0,415,12,01,  Islampur,253,550,138,273,115,277,31.5,33.6,29.3,00000
90.0,92.0,71.0,415,13,01,  Patargaon,46,543,25,263,21,280,7.8,8.7,7.0,00000
90.0,92.0,71.0,415,14,01,  Jaspratap,47,81,25,43,22,38,36.7,36.8,36.7,00000
90.0,92.0,71.0,415,15,01,  Dighirpar,347,549,179,263,168,286,38.7,40.5,37.0,00000
90.0,92.0,71.0,482,01,01,  Kunaihat,32,313,21,173,11,140,9.3,10.8,7.3,00000
90.0,92.0,71.0,482,02,01,  Pathan Para,51,484,25,250,26,234,9.5,9.1,10.0,00000
90.0,92.0,71.0,482,03,01,  Konaihat Chora,212,679,114,318,98,361,23.8,26.4,21.4,00000
90.0,92.0,71.0,636,01,01,  Mollah Para,515,416,279,188,236,228,55.3,59.7,50.9,00000
90.0,92.0,71.0,636,02,01,  Sundra Pahari,131,437,73,214,58,223,23.1,25.4,20.6,00000
90.0,92.0,71.0,751,01,01,  Laurgar,951,1381,495,660,456,721,40.8,42.9,38.7,00000
90.0,92.0,71.0,751,02,01,  Uttar Muksedpur,230,723,116,334,114,389,24.1,25.8,22.7,00000
90.0,92.0,71.0,751,03,01,  Dakshin Muksedpur,134,311,64,138,70,173,30.1,31.7,28.8,00000
90.0,92.0,71.0,751,04,01,  Dalarpar,129,583,70,300,59,283,18.1,18.9,17.3,00000
90.0,92.0,71.0,751,05,01,  Lohajuri Shararpar,118,309,61,157,57,152,27.6,28.0,27.3,00000
90.0,92.0,71.0,751,06,01,  Saidabad,248,651,137,322,111,329,27.6,29.8,25.2,00000
90.0,92.0,71.0,751,07,01,  Puran Laur,535,1209,284,567,251,642,30.7,33.4,28.1,00000
90.0,92.0,71.0,850,01,01,  Rajargaon,254,368,124,173,130,195,40.8,41.8,40.0,00000
90.0,92.0,71.0,850,02,01,  Rahmathpur,279,492,175,237,104,255,36.2,42.5,29.0,00000
90.0,92.0,71.0,850,03,01,  Sonapur,135,160,67,80,68,80,45.8,45.6,45.9,00000
90.0,92.0,82.0,019,01,01,  Alipur,83,412,46,204,37,208,16.8,18.4,15.1,00000
90.0,92.0,82.0,019,02,01,  Jalalpur,107,173,62,93,45,80,38.2,40.0,36.0,00000
90.0,92.0,82.0,043,01,01,  Ambari,434,1002,258,494,176,508,30.2,34.3,25.7,00000
90.0,92.0,82.0,043,02,01,  Badarpur,16,80,10,37,6,43,16.7,21.3,12.2,00000
90.0,92.0,82.0,043,03,01,  Sonapura,41,337,25,180,16,157,10.8,12.2,9.2,00000
90.0,92.0,82.0,144,01,01,  Puranghat,249,1199,143,601,106,598,17.2,19.2,15.1,00000
90.0,92.0,82.0,144,02,01,  Brahmangaon,359,1399,218,680,141,719,20.4,24.3,16.4,00000
90.0,92.0,82.0,268,01,01,  Dighalbak,47,477,30,246,17,231,9.0,10.9,6.9,00000
90.0,92.0,82.0,268,02,01,  Madhuar Char,20,229,14,115,6,114,8.0,10.9,5.0,00000
90.0,92.0,82.0,415,01,01,  Fakirnagar,31,145,15,75,16,70,17.6,16.7,18.6,00000
90.0,92.0,82.0,415,02,01,  Chargaon,226,686,133,333,93,353,24.8,28.5,20.9,00000
90.0,92.0,82.0,415,03,01,  Pailanpur,478,664,271,338,207,326,41.9,44.5,38.8,00000
90.0,92.0,82.0,587,01,01,  Manigaon,270,1724,141,848,129,876,13.5,14.3,12.8,00000
90.0,92.0,82.0,587,02,01,  Shimultala,297,964,176,433,121,531,23.6,28.9,18.6,00000
90.0,92.0,82.0,587,03,01,  Gutila,229,1608,123,781,106,827,12.5,13.6,11.4,00000
90.0,92.0,82.0,756,01,01,  Chargaon,33,316,20,164,13,152,9.5,10.9,7.9,00000
90.0,92.0,82.0,756,02,01,  Ramesherpur,99,246,50,118,49,128,28.7,29.8,27.7,00000
90.0,92.0,82.0,810,01,01,  Baragok,200,1077,114,523,86,554,15.7,17.9,13.4,00000
90.0,92.0,82.0,810,02,01,  Karaigara,34,51,12,27,22,24,40.0,30.8,47.8,00000
90.0,92.0,82.0,810,03,01,  Rajai,81,484,50,238,31,246,14.3,17.4,11.2,00000
90.0,92.0,82.0,810,04,01,  Maharam,261,1486,140,720,121,766,14.9,16.3,13.6,00000
90.0,92.0,82.0,870,01,01,  Rajani Lain,231,1168,133,559,98,609,16.5,19.2,13.9,00000
90.0,92.0,82.0,870,02,01,  Chandpur,153,842,85,421,68,421,15.4,16.8,13.9,00000
90.0,92.0,82.0,870,03,01,  Shantipur Chararpar,591,1397,316,680,275,717,29.7,31.7,27.7,00000
90.0,92.0,82.0,880,01,01,  Barahal,402,1114,222,547,180,567,26.5,28.9,24.1,00000
90.0,92.0,82.0,880,02,01,  Chandrapur,100,382,55,183,45,199,20.7,23.1,18.4,00000
90.0,92.0,92.0,089,01,01,  Bara Chhara,1081,1650,788,836,293,814,39.6,48.5,26.5,00000
90.0,92.0,92.0,089,02,01,  Bhurunga Chhara,266,633,162,304,104,329,29.6,34.8,24.0,00000
90.0,92.0,92.0,089,03,01,  Takurghat,447,201,252,74,195,127,69.0,77.3,60.6,00000
90.0,92.0,92.0,089,04,01,  Putiamari,124,165,80,86,44,79,42.9,48.2,35.8,00000
90.0,92.0,92.0,199,01,01,  Charagaon,1377,1751,1184,971,193,780,44.0,54.9,19.8,00000
90.0,92.0,92.0,199,02,01,  Bashtala,358,510,190,249,168,261,41.2,43.3,39.2,00000
90.0,92.0,92.0,199,03,01,  Lalghat,217,935,123,460,94,475,18.8,21.1,16.5,00000
90.0,92.0,92.0,199,04,01,  Lakma,537,3146,329,1569,208,1577,14.6,17.3,11.7,00000
90.0,92.0,92.0,248,01,01,  Dalairgaon,149,791,118,610,31,181,15.9,16.2,14.6,00000
90.0,92.0,92.0,248,02,01,  Nayaband,77,400,48,185,29,215,16.1,20.6,11.9,00000
90.0,92.0,92.0,378,01,01,  Joypur,52,211,32,107,20,104,19.8,23.0,16.1,00000
90.0,92.0,92.0,378,02,01,  Gulabari,36,113,22,54,14,59,24.2,28.9,19.2,00000
90.0,92.0,92.0,378,03,01,  Keshabpur,3,13,3,13,0,0,18.8,18.8,0.0,00000
90.0,92.0,92.0,398,01,01,  Madanpur,22,107,14,49,8,58,17.1,22.2,12.1,00000
90.0,92.0,92.0,398,02,01,  Jamalpur,155,455,82,241,73,214,25.4,25.4,25.4,00000
90.0,92.0,92.0,398,03,01,  Nababpur,25,170,15,92,10,78,12.8,14.0,11.4,00000
90.0,92.0,92.0,422,01,01,  Kalagaon,865,2048,487,1119,378,929,29.7,30.3,28.9,00000
90.0,92.0,92.0,422,02,01,  Jangalbari,215,847,125,415,90,432,20.2,23.1,17.2,00000
90.0,92.0,92.0,422,03,01,  Sundarpur,94,108,55,46,39,62,46.5,54.5,38.6,00000
90.0,92.0,92.0,422,04,01,  Ranga Chhara,100,614,63,300,37,314,14.0,17.4,10.5,00000
90.0,92.0,92.0,422,05,01,  Lamakata,86,290,52,146,34,144,22.9,26.3,19.1,00000
90.0,92.0,92.0,422,06,01,  Sonapur,93,252,51,124,42,128,27.0,29.1,24.7,00000
90.0,92.0,92.0,531,01,01,  Khalishajuri,407,429,212,222,195,207,48.7,48.8,48.5,00000
90.0,92.0,92.0,531,02,01,  Amritapur,400,602,223,292,177,310,39.9,43.3,36.3,00000
90.0,92.0,92.0,531,03,01,  Islampur,73,302,45,137,28,165,19.5,24.7,14.5,00000
90.0,92.0,92.0,531,04,01,  Golakpur,17,88,11,42,6,46,16.2,20.8,11.5,00000
90.0,92.0,92.0,531,05,01,  Kachunali,50,162,25,72,25,90,23.6,25.8,21.7,00000
90.0,92.0,92.0,730,01,01,  Birendra Nagar,405,1023,232,512,173,511,28.4,31.2,25.3,00000
90.0,92.0,92.0,730,02,01,  Indrapur,70,471,47,227,23,244,12.9,17.2,8.6,00000
90.0,92.0,92.0,835,01,01,  Paniakhali,14,32,9,13,5,19,30.4,40.9,20.8,00000
90.0,92.0,92.0,835,02,01,  Binodpur,100,130,53,69,47,61,43.5,43.4,43.5,00000
90.0,92.0,92.0,925,01,01,  Betagara,100,153,60,63,40,90,39.5,48.8,30.8,00000
90.0,92.0,92.0,925,02,01,  Matiain,30,370,17,189,13,181,7.5,8.3,6.7,00000
90.0,92.0,92.0,925,03,01,  Kadamtali,71,140,49,64,22,76,33.6,43.4,22.4,00000
90.0,92.0,92.0,965,01,01,  Teligaon,588,740,314,369,274,371,44.3,46.0,42.5,00000
90.0,92.0,92.0,965,02,01,  Bhuraghat,96,378,56,184,40,194,20.3,23.3,17.1,00000
90.0,92.0,92.0,995,01,01,  Tahirpur,69,341,32,176,37,165,16.8,15.4,18.3,00000
90.0,92.0,92.0,995,02,01,  Chiriargaon,103,175,61,89,42,86,37.1,40.7,32.8,00000
36.0,2.0,13.0,015,01,01,  Aoi,169,408,91,200,78,208,29.3,31.3,27.3,00000
36.0,2.0,13.0,015,02,01,  Gucha Gram,42,153,23,78,19,75,21.5,22.8,20.2,00000
36.0,2.0,13.0,150,01,01,  Bashatia,220,938,111,450,109,488,19.0,19.8,18.3,00000
36.0,2.0,13.0,150,02,01,  Hasham Pur,61,223,33,97,28,126,21.5,25.4,18.2,00000
36.0,2.0,13.0,195,01,01,  Birat,138,192,73,93,65,99,41.8,44.0,39.6,00000
36.0,2.0,13.0,195,02,01,  Noruttam Pur,68,120,29,57,39,63,36.2,33.7,38.2,00000
36.0,2.0,13.0,195,03,01,  Durlong Pur,107,117,50,59,57,58,47.8,45.9,49.6,00000
36.0,2.0,13.0,286,01,01,  Fatehpur (Part),40,112,15,58,25,54,26.3,20.5,31.6,00000
36.0,2.0,13.0,286,02,01,  Madusadan Pur,133,151,72,83,61,68,46.8,46.5,47.3,00000
36.0,2.0,13.0,286,03,01,  Islam P[Ur,18,159,9,75,9,84,10.2,10.7,9.7,00000
36.0,2.0,27.0,075,01,01,  Badalpur,257,533,130,264,127,269,32.5,33.0,32.1,00000
36.0,2.0,27.0,075,02,01,  Haripur,42,480,20,242,22,238,8.0,7.6,8.5,00000
36.0,2.0,27.0,075,03,01,  Nadipur,108,421,66,204,42,217,20.4,24.4,16.2,00000
36.0,2.0,27.0,075,04,01,  Dighalbak,224,160,110,84,114,76,58.3,56.7,60.0,00000
36.0,2.0,27.0,467,01,01,  Jhilua,323,423,181,208,142,215,43.3,46.5,39.8,00000
36.0,2.0,27.0,467,02,01,  Katakhali (Part),204,575,107,262,97,313,26.2,29.0,23.7,00000
36.0,2.0,27.0,663,01,01,  Paharpur,1157,1691,626,811,531,880,40.6,43.6,37.6,00000
36.0,2.0,27.0,663,02,01,  Mamudpur,266,245,136,119,130,126,52.1,53.3,50.8,00000
36.0,2.0,27.0,663,03,01,  Matiakara,247,323,142,132,105,191,43.3,51.8,35.5,00000
36.0,2.0,27.0,663,04,01,  Kaya,90,167,36,86,54,81,35.0,29.5,40.0,00000
36.0,2.0,27.0,663,05,01,  Charmamudpur,8,7,4,2,4,5,53.3,66.7,44.4,00000
36.0,2.0,27.0,663,06,01,  Katakhali (Part),347,434,172,206,175,228,44.4,45.5,43.4,00000
36.0,2.0,27.0,663,07,01,  Sunam Pur,35,273,22,123,13,150,11.4,15.2,8.0,00000
36.0,2.0,27.0,663,08,01,  Uday Pur,29,132,18,63,11,69,18.0,22.2,13.8,00000
36.0,2.0,27.0,663,09,01,  Gupi,144,264,73,113,71,151,35.3,39.2,32.0,00000
36.0,2.0,27.0,663,10,01,  Paharpur Bazar,204,117,170,72,34,45,63.6,70.2,43.0,00000
36.0,2.0,27.0,723,01,01,  Pirojpur,317,526,188,239,129,287,37.6,44.0,31.0,00000
36.0,2.0,27.0,723,02,01,  Joy Pur,105,237,62,102,43,135,30.7,37.8,24.2,00000
36.0,2.0,27.0,723,03,01,  Guchagram,25,346,19,178,6,168,6.7,9.6,3.4,00000
36.0,2.0,27.0,723,04,01,  Hilaj Pur,65,94,33,53,32,41,40.9,38.4,43.8,00000
36.0,2.0,27.0,753,01,01,  Purba Kalni,852,784,446,346,406,438,52.1,56.3,48.1,00000
36.0,2.0,27.0,753,02,01,  Shanjoy Pur,135,146,72,67,63,79,48.0,51.8,44.4,00000
36.0,2.0,27.0,874,01,01,  Noagaon,90,245,51,118,39,127,26.9,30.2,23.5,00000
36.0,2.0,27.0,874,02,01,  Piatur Kandi (Part),347,647,177,308,170,339,34.9,36.5,33.4,00000
36.0,2.0,27.0,874,04,01,  Azadpur,28,64,17,28,11,36,30.4,37.8,23.4,00000
36.0,2.0,54.0,060,01,01,  Madabpasha,498,966,208,469,290,497,34.0,30.7,36.8,00000
36.0,2.0,54.0,060,02,01,  Atpara,584,805,280,401,304,404,42.0,41.1,42.9,00000
36.0,2.0,54.0,060,03,01,  Madhaypara,520,536,249,244,271,292,49.2,50.5,48.1,00000
36.0,2.0,54.0,060,04,01,  Dakhin Atpara,327,395,151,191,176,204,45.3,44.2,46.3,00000
36.0,2.0,54.0,060,05,01,  Uttar Atpara,84,314,30,156,54,158,21.1,16.1,25.5,00000
36.0,2.0,54.0,407,01,01,  Jalsuka,71,44,26,20,45,24,61.7,56.5,65.2,00000
36.0,2.0,54.0,407,02,01,  Murakhai,107,87,61,52,46,35,55.2,54.0,56.8,00000
36.0,2.0,54.0,407,03,01,  Durlabhpur,137,194,69,83,68,111,41.4,45.4,38.0,00000
36.0,2.0,54.0,407,04,01,  Anantapur,153,282,57,122,96,160,35.2,31.8,37.5,00000
36.0,2.0,54.0,407,05,01,  Chanderabad,51,72,27,33,24,39,41.5,45.0,38.1,00000
36.0,2.0,54.0,407,06,01,  Kadirpur,56,51,27,26,29,25,52.3,50.9,53.7,00000
36.0,2.0,54.0,407,07,01,  Durgapur,49,112,22,53,27,59,30.4,29.3,31.4,00000
36.0,2.0,54.0,407,08,01,  Ishiabpur,483,562,238,292,245,270,46.2,44.9,47.6,00000
36.0,2.0,54.0,708,01,01,  Patlipara,306,617,148,298,158,319,33.2,33.2,33.1,00000
36.0,2.0,54.0,708,02,01,  Lakhihati,145,62,69,25,76,37,70.0,73.4,67.3,00000
36.0,2.0,67.0,045,01,01,  Alipur,143,153,68,74,75,79,48.3,47.9,48.7,00000
36.0,2.0,67.0,045,02,01,  Mahtabpur,295,448,137,206,158,242,39.7,39.9,39.5,00000
36.0,2.0,67.0,241,01,01,  Demikandi,38,87,18,52,20,35,30.4,25.7,36.4,00000
36.0,2.0,67.0,241,02,01,  Sarifpur,521,600,251,302,270,298,46.5,45.4,47.5,00000
36.0,2.0,67.0,482,01,01,  Rasulpur Uttar,383,669,231,275,152,394,36.4,45.7,27.8,00000
36.0,2.0,67.0,482,02,01,  Anandapur,418,599,207,305,211,294,41.1,40.4,41.8,00000
36.0,2.0,67.0,482,03,01,  Kakailseo,196,163,110,77,86,86,54.6,58.8,50.0,00000
36.0,2.0,67.0,482,04,01,  Qumedpur,469,487,236,232,233,255,49.1,50.4,47.7,00000
36.0,2.0,67.0,482,05,01,  Gopal Pur,226,297,127,137,99,160,43.2,48.1,38.2,00000
36.0,2.0,67.0,482,06,01,  Chan Pur,138,170,69,76,69,94,44.8,47.6,42.3,00000
36.0,2.0,67.0,482,07,01,  Mahes Nagar,5,1,2,0,3,1,83.3,100.0,75.0,00000
36.0,2.0,67.0,482,08,01,  Krepal Nagar,126,76,61,38,65,38,62.4,61.6,63.1,00000
36.0,2.0,67.0,482,09,01,  Joganath Pur,60,18,36,6,24,12,76.9,85.7,66.7,00000
36.0,2.0,67.0,482,10,01,  Char Hati,76,324,33,173,43,151,19.0,16.0,22.2,00000
36.0,2.0,67.0,482,11,01,  Fakhrabad,79,42,51,15,28,27,65.3,77.3,50.9,00000
36.0,2.0,67.0,482,12,01,  Enayet Nagar,21,85,10,44,11,41,19.8,18.5,21.2,00000
36.0,2.0,67.0,542,01,01,  Mamudpur,343,150,185,58,158,92,69.6,76.1,63.2,00000
36.0,2.0,67.0,542,02,01,  Umed Nagar,93,127,57,56,36,71,42.3,50.4,33.6,00000
36.0,2.0,67.0,542,03,01,  Narsingpur,171,76,91,32,80,44,69.2,74.0,64.5,00000
36.0,2.0,67.0,542,04,01,  Jamigoawlgaon,209,90,119,40,90,50,69.9,74.8,64.3,00000
36.0,2.0,67.0,542,05,01,  Shampur,173,63,82,34,91,29,73.3,70.7,75.8,00000
36.0,2.0,67.0,768,01,01,  Raja Nagar,151,45,69,20,82,25,77.0,77.5,76.6,00000
36.0,2.0,67.0,768,02,01,  Gonga Nagar,158,111,74,57,84,54,58.7,56.5,60.9,00000
36.0,2.0,67.0,768,03,01,  Gaora Nagar,115,101,65,37,50,64,53.2,63.7,43.9,00000
36.0,2.0,67.0,768,04,01,  Khala Para,69,88,31,39,38,49,43.9,44.3,43.7,00000
36.0,2.0,67.0,814,01,01,  Saulari,170,369,98,216,72,153,31.5,31.2,32.0,00000
36.0,2.0,67.0,814,02,01,  Sarifpur,389,341,196,167,193,174,53.3,54.0,52.6,00000
36.0,2.0,67.0,814,03,01,  Ghardair,219,326,130,126,89,200,40.2,50.8,30.8,00000
36.0,2.0,67.0,814,04,01,  Ramonipur,330,693,152,336,178,357,32.3,31.1,33.3,00000
36.0,2.0,67.0,814,05,01,  Jatrapur,123,281,82,128,41,153,30.4,39.0,21.1,00000
36.0,2.0,67.0,814,06,01,  Badarpur,100,161,44,79,56,82,38.3,35.8,40.6,00000
36.0,2.0,67.0,814,07,01,  Manipur,57,160,43,72,14,88,26.3,37.4,13.7,00000
36.0,2.0,67.0,814,08,01,  Kadir Pur,108,49,54,22,54,27,68.8,71.1,66.7,00000
36.0,2.0,67.0,814,09,01,  Binna Khali,67,21,36,10,31,11,76.1,78.3,73.8,00000
36.0,2.0,67.0,814,10,01,  Goshai Pur,81,280,47,141,34,139,22.4,25.0,19.7,00000
36.0,2.0,67.0,814,11,01,  Bahadur Pur,72,81,39,36,33,45,47.1,52.0,42.3,00000
36.0,2.0,67.0,814,12,01,  Kannajuri,4,40,2,23,2,17,9.1,8.0,10.5,00000
36.0,2.0,67.0,814,13,01,  Rudra Nagar,48,32,25,12,23,20,60.0,67.6,53.5,00000
36.0,2.0,67.0,814,14,01,  Hargori Hati,51,78,24,36,27,42,39.5,40.0,39.1,00000
36.0,2.0,67.0,814,15,01,  Manger Hati,114,163,65,69,49,94,41.2,48.5,34.3,00000
36.0,2.0,67.0,814,16,01,  Jaynagar,7,63,3,30,4,33,10.0,9.1,10.8,00000
36.0,2.0,67.0,814,17,01,  Nayahati,61,50,29,23,32,27,55.0,55.8,54.2,00000
36.0,2.0,67.0,814,18,01,  Mirzapur,25,103,14,47,11,56,19.5,23.0,16.4,00000
36.0,2.0,81.0,105,01,01,  Bang,843,1392,416,596,427,796,37.7,41.1,34.9,00000
36.0,2.0,81.0,105,02,01,  Nayahati,228,250,111,107,117,143,47.7,50.9,45.0,00000
36.0,2.0,81.0,105,03,01,  Razbari,25,200,10,98,15,102,11.1,9.3,12.8,00000
36.0,2.0,81.0,316,01,01,  Votra Para,104,181,55,86,49,95,36.5,39.0,34.0,00000
36.0,2.0,81.0,316,02,01,  Gayengaon,50,141,23,72,27,69,26.2,24.2,28.1,00000
36.0,2.0,81.0,316,03,01,  Banganj,165,229,75,113,90,116,41.9,39.9,43.7,00000
36.0,2.0,81.0,693,01,01,  Paschimbagh,272,560,142,276,130,284,32.7,34.0,31.4,00000
36.0,2.0,81.0,693,02,01,  Padmatara,304,524,152,249,152,275,36.7,37.9,35.6,00000
36.0,2.0,81.0,693,03,01,  Kayesta Para,179,207,93,102,86,105,46.4,47.7,45.0,00000
36.0,2.0,81.0,693,04,01,  Digirpar,70,26,35,11,35,15,72.9,76.1,70.0,00000
36.0,2.0,81.0,693,05,01,  Pairal,46,125,24,56,22,69,26.9,30.0,24.2,00000
36.0,2.0,81.0,693,06,01,  Varalipara,52,94,24,46,28,48,35.6,34.3,36.8,00000
36.0,2.0,81.0,693,07,01,  Tinkusa,87,59,51,30,36,29,59.6,63.0,55.4,00000
36.0,2.0,81.0,829,01,01,  Shib Pasha,2209,3859,1079,1806,1130,2053,36.4,37.4,35.5,00000
36.0,2.0,81.0,829,02,01,  Nurpur,73,224,38,114,35,110,24.6,25.0,24.1,00000
36.0,5.0,11.0,177,01,01,  Lohakhola,107,78,53,24,54,54,57.8,68.8,50.0,00000
36.0,5.0,11.0,177,02,01,  Kabirpur,216,267,124,115,92,152,44.7,51.9,37.7,00000
36.0,5.0,11.0,193,01,01,  Chak Habizpur,268,426,118,227,150,199,38.6,34.2,43.0,00000
36.0,5.0,11.0,193,02,01,  Habizpur,54,379,26,184,28,195,12.5,12.4,12.6,00000
36.0,5.0,11.0,197,01,01,  Chandania,339,1081,144,510,195,571,23.9,22.0,25.5,00000
36.0,5.0,11.0,197,02,01,  Noabad,65,189,24,91,41,98,25.6,20.9,29.5,00000
36.0,5.0,11.0,211,01,01,  Chhota Baraiuri,57,181,27,90,30,91,23.9,23.1,24.8,00000
36.0,5.0,11.0,211,02,01,  Alapur,72,53,34,26,38,27,57.6,56.7,58.5,00000
36.0,5.0,11.0,270,01,01,  Joynabad,140,117,73,65,67,52,54.5,52.9,56.3,00000
36.0,5.0,11.0,270,02,01,  Noagaon,182,79,106,33,76,46,69.7,76.3,62.3,00000
36.0,5.0,11.0,270,03,01,  Ishaquepur,71,40,47,18,24,22,64.0,72.3,52.2,00000
36.0,5.0,11.0,340,01,01,  Goharoa,326,739,172,353,154,386,30.6,32.8,28.5,00000
36.0,5.0,11.0,340,02,01,  Bara Khal,34,130,18,72,16,58,20.7,20.0,21.6,00000
36.0,5.0,11.0,340,03,01,  Sundargaon,34,202,16,100,18,102,14.4,13.8,15.0,00000
36.0,5.0,11.0,429,01,01,  Islampur (Part),50,40,36,27,14,13,55.6,57.1,51.9,00000
36.0,5.0,11.0,429,02,01,  Jangalia,547,370,289,195,258,175,59.7,59.7,59.6,00000
36.0,5.0,11.0,429,03,01,  Dash Kapon,184,100,101,46,83,54,64.8,68.7,60.6,00000
36.0,5.0,11.0,490,01,01,  Kaithgaon,272,573,128,249,144,324,32.2,34.0,30.8,00000
36.0,5.0,11.0,490,02,01,  Mohanpur (Razapur),228,658,114,312,114,346,25.7,26.8,24.8,00000
36.0,5.0,11.0,490,03,01,  Mithapur (Part),125,235,63,109,62,126,34.7,36.6,33.0,00000
36.0,5.0,11.0,490,04,01,  Ponar Abda,74,329,25,163,49,166,18.4,13.3,22.8,00000
36.0,5.0,11.0,531,01,01,  Domgaon,6,196,3,95,3,101,3.0,3.1,2.9,00000
36.0,5.0,11.0,531,02,01,  Kasba Karimpur,246,464,124,218,122,246,34.6,36.3,33.2,00000
36.0,5.0,11.0,558,01,01,  Mayanabad,48,139,18,67,30,72,25.7,21.2,29.4,00000
36.0,5.0,11.0,558,02,01,  Gangergaon,44,184,24,77,20,107,19.3,23.8,15.7,00000
36.0,5.0,11.0,651,01,01,  Baidyanatpur,2,165,1,90,1,75,1.2,1.1,1.3,00000
36.0,5.0,11.0,651,02,01,  Narayanpur,60,62,26,33,34,29,49.2,44.1,54.0,00000
36.0,5.0,11.0,654,01,01,  Mauri,250,254,131,111,119,143,49.6,54.1,45.4,00000
36.0,5.0,11.0,654,02,01,  Puran Mauri,11,104,5,53,6,51,9.6,8.6,10.5,00000
36.0,5.0,11.0,654,03,01,  Dayalpur,24,78,16,42,8,36,23.5,27.6,18.2,00000
36.0,5.0,11.0,654,04,01,  Rampur,39,204,20,105,19,99,16.0,16.0,16.1,00000
36.0,5.0,11.0,654,05,01,  Balarampur,14,97,3,51,11,46,12.6,5.6,19.3,00000
36.0,5.0,11.0,654,06,01,  Tilabari,148,151,75,76,73,75,49.5,49.7,49.3,00000
36.0,5.0,11.0,654,07,01,  Haritala,343,1262,182,621,161,641,21.4,22.7,20.1,00000
36.0,5.0,11.0,885,01,03,  Satparia,262,415,135,188,127,227,38.7,41.8,35.9,00000
36.0,5.0,11.0,885,02,03,  Bade Satparia,413,165,210,73,203,92,71.5,74.2,68.8,00000
36.0,5.0,11.0,949,01,01,  Daulatpur,49,231,27,117,22,114,17.5,18.8,16.2,00000
36.0,5.0,11.0,949,02,01,  Uttar Sur,159,435,74,202,85,233,26.8,26.8,26.7,00000
36.0,5.0,23.0,013,01,01,  Abdapatia,81,422,34,185,47,237,16.1,15.5,16.5,00000
36.0,5.0,23.0,013,02,01,  Paschim Shaharapur,116,162,56,81,60,81,41.7,40.9,42.6,00000
36.0,5.0,23.0,013,03,01,  Jashpala,150,271,75,137,75,134,35.6,35.4,35.9,00000
36.0,5.0,23.0,013,04,01,  Hafizpur,70,82,32,40,38,42,46.1,44.4,47.5,00000
36.0,5.0,23.0,023,01,01,  Chichirkut,401,493,192,209,209,284,44.9,47.9,42.4,00000
36.0,5.0,23.0,023,02,01,  Himargaon,79,158,42,81,37,77,33.3,34.1,32.5,00000
36.0,5.0,23.0,129,01,01,  Baragaon,594,892,294,442,300,450,40.0,39.9,40.0,00000
36.0,5.0,23.0,129,02,01,  Baragaon Pakla,36,41,16,16,20,25,46.8,50.0,44.4,00000
36.0,5.0,23.0,184,01,01,  Biharipur,418,458,248,234,170,224,47.7,51.5,43.1,00000
36.0,5.0,23.0,184,02,01,  Khujargaon,142,238,78,117,64,121,37.4,40.0,34.6,00000
36.0,5.0,23.0,238,01,01,  Uttar Daulatpur,306,592,159,293,147,299,34.1,35.2,33.0,00000
36.0,5.0,23.0,238,02,01,  Dakshin Daulatpur,304,330,151,157,153,173,47.9,49.0,46.9,00000
36.0,5.0,23.0,286,01,01,  Aliachhara Khasia,347,138,205,57,142,81,71.5,78.2,63.7,00000
36.0,5.0,23.0,286,02,01,  Aliachhara Basti,34,63,16,34,18,29,35.1,32.0,38.3,00000
36.0,5.0,23.0,286,03,01,  Musai Amtali Didarabad,217,361,127,163,90,198,37.5,43.8,31.3,00000
36.0,5.0,23.0,293,01,01,  Fazilabad T.G.,217,615,146,267,71,348,26.1,35.4,16.9,00000
36.0,5.0,23.0,293,02,01,  Fazilabad Badamtila Nutan,533,965,323,454,210,511,35.6,41.6,29.1,00000
36.0,5.0,23.0,466,01,01,  Jasmangal,91,96,50,46,41,50,48.7,52.1,45.1,00000
36.0,5.0,23.0,466,02,01,  Bhairabikona,41,60,24,30,17,30,40.6,44.4,36.2,00000
36.0,5.0,23.0,517,01,01,  Kamaichara,187,807,124,405,63,402,18.8,23.4,13.5,00000
36.0,5.0,23.0,517,02,01,  Balochara,131,280,86,129,45,151,31.9,40.0,23.0,00000
36.0,5.0,23.0,524,01,01,  Joypur,801,536,412,240,389,296,59.9,63.2,56.8,00000
36.0,5.0,23.0,524,02,01,  Purba Joypur,276,119,149,49,127,70,69.9,75.3,64.5,00000
36.0,5.0,23.0,545,01,01,  Kashirampur,118,119,52,69,66,50,49.8,43.0,56.9,00000
36.0,5.0,23.0,545,02,01,  Kandigaon,109,218,61,128,48,90,33.3,32.3,34.8,00000
36.0,5.0,23.0,656,01,01,  Kashimpur,45,166,18,86,27,80,21.3,17.3,25.2,00000
36.0,5.0,23.0,656,02,01,  Paschim Bhadershwar,579,809,299,365,280,444,41.7,45.0,38.7,00000
36.0,5.0,23.0,729,01,01,  Paik Para,215,132,105,56,110,76,62.0,65.2,59.1,00000
36.0,5.0,23.0,729,02,01,  Natun Bazar,87,151,71,128,16,23,36.6,35.7,41.0,00000
36.0,5.0,23.0,729,03,01,  Chak Rampur,298,178,160,78,138,100,62.6,67.2,58.0,00000
36.0,5.0,23.0,733,01,01,  Purba Bhadeshwar,672,917,342,412,330,505,42.3,45.4,39.5,00000
36.0,5.0,23.0,733,02,01,  Gangpar,49,183,21,82,28,101,21.1,20.4,21.7,00000
36.0,5.0,23.0,797,01,01,  Rashidpur,49,115,27,55,22,60,29.9,32.9,26.8,00000
36.0,5.0,23.0,797,02,01,  Shahanagar,28,66,13,27,15,39,29.8,32.5,27.8,00000
36.0,5.0,23.0,797,03,01,  Shufiabad,62,202,29,108,33,94,23.5,21.2,26.0,00000
36.0,5.0,23.0,804,01,01,  Rashidpur T.E.,183,383,110,173,73,210,32.3,38.9,25.8,00000
36.0,5.0,23.0,804,02,01,  Rashidpur T.E.Baralane,285,596,181,269,104,327,32.3,40.2,24.1,00000
36.0,5.0,23.0,804,03,01,  Rashidpur T.E.Chamartila,237,330,155,134,82,196,41.8,53.6,29.5,00000
36.0,5.0,23.0,804,04,01,  Rashidpur T.E.Uriatila,192,705,125,343,67,362,21.4,26.7,15.6,00000
36.0,5.0,23.0,804,05,01,  Rashidpur Bazar,55,29,37,17,18,12,65.5,68.5,60.0,00000
36.0,5.0,23.0,851,01,01,  Nijgaon,122,385,65,168,57,217,24.1,27.9,20.8,00000
36.0,5.0,23.0,851,02,01,  Shahapur,286,172,126,76,160,96,62.4,62.4,62.5,00000
36.0,5.0,23.0,851,03,01,  Olipur,171,98,87,41,84,57,63.6,68.0,59.6,00000
36.0,5.0,23.0,933,01,01,  Sillachara T.G.,118,316,77,139,41,177,27.2,35.6,18.8,00000
36.0,5.0,23.0,933,02,01,  Sitalachara Khasia Punji,62,139,41,60,21,79,30.8,40.6,21.0,00000
36.0,5.0,35.0,006,01,01,  Abdamanikhya,124,126,60,51,64,75,49.6,54.1,46.0,00000
36.0,5.0,35.0,006,02,01,  Chakmatua,159,208,86,92,73,116,43.3,48.3,38.6,00000
36.0,5.0,35.0,006,03,01,  Hara Ballabpur,30,9,15,6,15,3,76.9,71.4,83.3,00000
36.0,5.0,35.0,143,01,01,  Selimnagar,89,140,39,73,50,67,38.9,34.8,42.7,00000
36.0,5.0,35.0,143,02,01,  Barikandi,72,87,37,39,35,48,45.3,48.7,42.2,00000
36.0,5.0,35.0,193,01,01,  Habizpur,45,173,27,93,18,80,20.6,22.5,18.4,00000
36.0,5.0,35.0,193,02,01,  Chilami,31,51,15,18,16,33,37.8,45.5,32.7,00000
36.0,5.0,35.0,193,03,01,  Bhairabikona,46,220,24,106,22,114,17.3,18.5,16.2,00000
36.0,5.0,35.0,218,01,01,  Chauapur,77,216,43,99,34,117,26.3,30.3,22.5,00000
36.0,5.0,35.0,218,02,01,  Shimuliam,370,424,180,186,190,238,46.6,49.2,44.4,00000
36.0,5.0,35.0,218,03,01,  Kasipur,171,320,79,151,92,169,34.8,34.3,35.2,00000
36.0,5.0,35.0,218,04,01,  Purba Shimuliam,66,187,33,84,33,103,26.1,28.2,24.3,00000
36.0,5.0,35.0,226,01,01,  Habizpur,381,391,183,198,198,193,49.4,48.0,50.6,00000
36.0,5.0,35.0,226,02,01,  Pathakpur,148,121,78,55,70,66,55.0,58.6,51.5,00000
36.0,5.0,35.0,252,01,01,  Dhaniakhali,11,41,3,22,8,19,21.2,12.0,29.6,00000
36.0,5.0,35.0,252,02,01,  Krishnapur,81,139,36,63,45,76,36.8,36.4,37.2,00000
36.0,5.0,35.0,306,01,01,  Faridpur,100,61,56,32,44,29,62.1,63.6,60.3,00000
36.0,5.0,35.0,306,02,01,  Debalaya,18,27,10,15,8,12,40.0,40.0,40.0,00000
36.0,5.0,35.0,306,03,01,  Jamunabad,73,81,31,39,42,42,47.4,44.3,50.0,00000
36.0,5.0,35.0,306,04,01,  Chaitynpur,32,7,16,1,16,6,82.1,94.1,72.7,00000
36.0,5.0,35.0,306,05,01,  Archana Bagh,20,8,11,3,9,5,71.4,78.6,64.3,00000
36.0,5.0,35.0,306,06,01,  Barigram,112,11,58,2,54,9,91.1,96.7,85.7,00000
36.0,5.0,35.0,408,01,01,  Hajipur,175,432,104,199,71,233,28.8,34.3,23.4,00000
36.0,5.0,35.0,408,02,01,  Chandapur,55,388,38,181,17,207,12.4,17.4,7.6,00000
36.0,5.0,35.0,555,01,01,  Lamani Khudra,22,18,11,10,11,8,55.0,52.4,57.9,00000
36.0,5.0,35.0,555,02,01,  Rampur,126,54,56,22,70,32,70.0,71.8,68.6,00000
36.0,5.0,35.0,555,03,01,  Bhulkut,248,215,127,99,121,116,53.6,56.2,51.1,00000
36.0,5.0,35.0,555,04,01,  Brahmangaon,62,67,27,33,35,34,48.1,45.0,50.7,00000
36.0,5.0,35.0,555,05,01,  Moyanabad,64,27,34,13,30,14,70.3,72.3,68.2,00000
36.0,5.0,35.0,667,01,01,  Munshrifkhola,128,403,50,185,78,218,24.1,21.3,26.4,00000
36.0,5.0,35.0,667,02,01,  Rameshwarepur,84,80,37,39,47,41,51.2,48.7,53.4,00000
36.0,5.0,35.0,667,03,01,  Bade Rameshwarepur,87,128,37,54,50,74,40.5,40.7,40.3,00000
36.0,5.0,35.0,667,04,01,  Sreekalash,59,257,27,118,32,139,18.7,18.6,18.7,00000
36.0,5.0,35.0,695,01,01,  Nandanpur,120,7,61,1,59,6,94.5,98.4,90.8,00000
36.0,5.0,35.0,695,02,01,  Nandanpur Bazar,38,6,32,4,6,2,86.4,88.9,75.0,00000
36.0,5.0,35.0,695,03,01,  Abda Satdananda,329,175,153,80,176,95,65.3,65.7,64.9,00000
36.0,5.0,35.0,701,01,01,  Kazihata,621,1163,303,545,318,618,34.8,35.7,34.0,00000
36.0,5.0,35.0,701,02,01,  Ekiar Kona,122,192,69,77,53,115,38.9,47.3,31.5,00000
36.0,5.0,35.0,776,01,01,  Jadabpur,26,9,14,1,12,8,74.3,93.3,60.0,00000
36.0,5.0,35.0,776,02,01,  Modhaha Rabda,105,28,56,7,49,21,78.9,88.9,70.0,00000
36.0,5.0,35.0,776,03,01,  Karergaon,185,206,81,97,104,109,47.3,45.5,48.8,00000
36.0,5.0,35.0,776,04,01,  Pikram,43,14,22,5,21,9,75.4,81.5,70.0,00000
36.0,5.0,35.0,913,01,01,  Shibpasha,368,610,159,292,209,318,37.6,35.3,39.7,00000
36.0,5.0,35.0,913,02,01,  Lamanigaon,66,166,26,86,40,80,28.4,23.2,33.3,00000
36.0,5.0,35.0,974,01,01,  Tarapasha,136,494,62,222,74,272,21.6,21.8,21.4,00000
36.0,5.0,35.0,974,02,01,  Bade Hajipur,254,569,121,290,133,279,30.9,29.4,32.3,00000
36.0,5.0,47.0,034,01,01,  Abdullahpur (Part),401,424,188,172,213,252,48.6,52.2,45.8,00000
36.0,5.0,47.0,034,02,01,  Bashina,542,387,275,207,267,180,58.3,57.1,59.7,00000
36.0,5.0,47.0,180,01,01,  Ghagra,32,8,16,4,16,4,80.0,80.0,80.0,00000
36.0,5.0,47.0,180,02,01,  Bhugli,268,760,139,340,129,420,26.1,29.0,23.5,00000
36.0,5.0,47.0,204,01,01,  Chandrachari,300,268,150,124,150,144,52.8,54.7,51.0,00000
36.0,5.0,47.0,204,02,01,  Shahapur,59,82,38,36,21,46,41.8,51.4,31.3,00000
36.0,5.0,47.0,268,01,01,  Tungeswar,368,168,181,72,187,96,68.7,71.5,66.1,00000
36.0,5.0,47.0,268,02,01,  Khilbamai,104,187,65,84,39,103,35.7,43.6,27.5,00000
36.0,5.0,47.0,268,03,01,  Tungeswar Bazar,23,3,23,3,0,0,88.5,88.5,0.0,00000
36.0,5.0,47.0,268,04,01,  Bedebamy,111,155,49,64,62,91,41.7,43.4,40.5,00000
36.0,5.0,47.0,436,01,01,  Abda Raghab,97,79,49,37,48,42,55.1,57.0,53.3,00000
36.0,5.0,47.0,436,02,01,  Izzatnagar,502,336,248,154,254,182,59.9,61.7,58.3,00000
36.0,5.0,47.0,442,01,01,  Raghurampur,135,99,69,52,66,47,57.7,57.0,58.4,00000
36.0,5.0,47.0,442,02,01,  Paschim Jaipur,742,792,354,384,388,408,48.4,48.0,48.7,00000
36.0,5.0,47.0,565,01,01,  Noagaon,294,114,141,42,153,72,72.1,77.0,68.0,00000
36.0,5.0,47.0,565,02,01,  Lakri Para,268,573,117,287,151,286,31.9,29.0,34.6,00000
36.0,5.0,47.0,586,01,01,  Haripasa,308,227,170,104,138,123,57.6,62.0,52.9,00000
36.0,5.0,47.0,586,02,01,  Lamatashi (Part),353,272,195,114,158,158,56.5,63.1,50.0,00000
36.0,5.0,47.0,661,01,01,  Kutandar,55,11,24,3,31,8,83.3,88.9,79.5,00000
36.0,5.0,47.0,661,02,01,  Mirjatula,467,568,249,323,218,245,45.1,43.5,47.1,00000
36.0,5.0,47.0,661,03,01,  Pathantula,42,20,22,6,20,14,67.7,78.6,58.8,00000
36.0,5.0,47.0,661,04,01,  Kalutula,148,133,74,58,74,75,52.7,56.1,49.7,00000
36.0,5.0,47.0,661,05,01,  Faridpur,75,16,36,7,39,9,82.4,83.7,81.3,00000
36.0,5.0,47.0,661,06,01,  Bandar,42,127,23,56,19,71,24.9,29.1,21.1,00000
36.0,5.0,47.0,661,07,01,  Balu Char,29,26,14,10,15,16,52.7,58.3,48.4,00000
36.0,5.0,47.0,661,08,01,  Kaith Para,78,194,47,95,31,99,28.7,33.1,23.8,00000
36.0,5.0,47.0,770,01,01,  Daspara,156,173,69,83,87,90,47.4,45.4,49.2,00000
36.0,5.0,47.0,770,02,01,  Gobindapur,157,68,79,23,78,45,69.8,77.5,63.4,00000
36.0,5.0,47.0,770,03,01,  Ramjibanpur,93,128,36,61,57,67,42.1,37.1,46.0,00000
36.0,5.0,47.0,770,04,01,  Rajendrapur,173,228,85,104,88,124,43.1,45.0,41.5,00000
36.0,5.0,47.0,770,05,01,  Gachhani,29,5,12,1,17,4,85.3,92.3,81.0,00000
36.0,5.0,47.0,845,01,01,  Purba Rupshankar,453,651,207,297,246,354,41.0,41.1,41.0,00000
36.0,5.0,47.0,845,02,01,  Paschim Rupshankar,446,390,269,180,177,210,53.3,59.9,45.7,00000
36.0,5.0,47.0,845,03,01,  Chakka Zil,88,142,54,88,34,54,38.3,38.0,38.6,00000
36.0,5.0,47.0,947,01,01,  Paschim Datta Para,369,229,190,112,179,117,61.7,62.9,60.5,00000
36.0,5.0,47.0,947,02,01,  Bara Aoulia,159,139,82,59,77,80,53.4,58.2,49.0,00000
36.0,5.0,47.0,947,03,01,  Purba Datta Para,93,130,47,60,46,70,41.7,43.9,39.7,00000
36.0,5.0,47.0,981,01,01,  Tetarkona,357,428,176,191,181,237,45.5,48.0,43.3,00000
36.0,5.0,47.0,981,02,01,  Sharnarekha,404,443,200,212,204,231,47.7,48.5,46.9,00000
36.0,5.0,59.0,047,01,01,  Kona Dubai,155,197,89,89,66,108,44.0,50.0,37.9,00000
36.0,5.0,59.0,047,02,01,  Uttar Dubai,184,185,79,87,105,98,49.9,47.6,51.7,00000
36.0,5.0,59.0,047,03,01,  Dakshin Dubai,354,387,169,203,185,184,47.8,45.4,50.1,00000
36.0,5.0,59.0,047,04,01,  Bhat Para,129,69,60,30,69,39,65.2,66.7,63.9,00000
36.0,5.0,59.0,170,01,01,  Bhimsi,35,338,25,170,10,168,9.4,12.8,5.6,00000
36.0,5.0,59.0,170,02,01,  Golgaon,114,499,49,257,65,242,18.6,16.0,21.2,00000
36.0,5.0,59.0,226,01,01,  Chak Gaon,117,93,53,48,64,45,55.7,52.5,58.7,00000
36.0,5.0,59.0,226,02,01,  Chak Mandal Kapan,146,168,78,84,68,84,46.5,48.1,44.7,00000
36.0,5.0,59.0,408,01,01,  Hilalpur,417,208,207,90,210,118,66.7,69.7,64.0,00000
36.0,5.0,59.0,408,02,01,  Modhupur,74,14,30,8,44,6,84.1,78.9,88.0,00000
36.0,5.0,59.0,408,03,01,  Purba Bijuli,273,104,129,52,144,52,72.4,71.3,73.5,00000
36.0,5.0,59.0,408,04,01,  Paschim Bijuli (Dubai Bazar),310,201,147,104,163,97,60.7,58.6,62.7,00000
36.0,5.0,59.0,477,01,01,  Bagherkhal (Part),9,14,2,8,7,6,39.1,20.0,53.8,00000
36.0,5.0,59.0,477,02,01,  Mirer Para,196,359,92,177,104,182,35.3,34.2,36.4,00000
36.0,5.0,59.0,477,03,01,  Kumedpur,142,128,71,52,71,76,52.6,57.7,48.3,00000
36.0,5.0,59.0,511,01,01,  Kalyanpur,287,119,150,56,137,63,70.7,72.8,68.5,00000
36.0,5.0,59.0,511,02,01,  Shambhupur,322,216,151,107,171,109,59.9,58.5,61.1,00000
36.0,5.0,59.0,592,01,01,  Kali Gojia R.F.,100,53,59,25,41,28,65.4,70.2,59.4,00000
36.0,5.0,59.0,592,02,01,  Madhupur R.F.,39,106,35,39,4,67,26.9,47.3,5.6,00000
36.0,5.0,59.0,592,03,01,  1st Tila,43,35,22,15,21,20,55.1,59.5,51.2,00000
36.0,5.0,59.0,749,01,01,  Rajsurat (Digambar Bazar),202,252,109,123,93,129,44.5,47.0,41.9,00000
36.0,5.0,59.0,749,02,01,  Romabolob Pur,37,12,20,6,17,6,75.5,76.9,73.9,00000
36.0,5.0,59.0,749,03,01,  Kesharnagar,49,19,26,8,23,11,72.1,76.5,67.6,00000
36.0,5.0,59.0,749,04,01,  Haji Madam (Part),9,9,6,2,3,7,50.0,75.0,30.0,00000
36.0,5.0,59.0,864,01,01,  Amudpur (Part),117,33,57,18,60,15,78.0,76.0,80.0,00000
36.0,5.0,59.0,864,02,01,  Noapara,245,169,130,74,115,95,59.2,63.7,54.8,00000
36.0,5.0,59.0,864,03,01,  Jadabpur (Putijuri Bazar),348,325,188,154,160,171,51.7,55.0,48.3,00000
36.0,5.0,59.0,864,04,01,  Saribatpur,57,22,27,11,30,11,72.2,71.1,73.2,00000
36.0,5.0,59.0,864,05,01,  Harish Chandrapur,51,154,29,77,22,77,24.9,27.4,22.2,00000
36.0,5.0,59.0,864,06,01,  Bagar Khal (Part),75,37,36,20,39,17,67.0,64.3,69.6,00000
36.0,5.0,59.0,954,01,01,  Chak Sukh Char,192,38,93,14,99,24,83.5,86.9,80.5,00000
36.0,5.0,59.0,954,02,01,  Sukh Char,296,201,159,87,137,114,59.6,64.6,54.6,00000
36.0,5.0,59.0,967,01,01,  Haji Madam (Part),155,66,73,29,82,37,70.1,71.6,68.9,00000
36.0,5.0,59.0,967,02,01,  Abda Narayan,509,483,248,227,261,256,51.3,52.2,50.5,00000
36.0,5.0,59.0,967,03,01,  Lama Putijuri,319,33,158,19,161,14,90.6,89.3,92.0,00000
36.0,5.0,59.0,967,04,01,  Kanchan Nagar,6,0,3,0,3,0,100.0,100.0,100.0,00000
36.0,5.0,59.0,974,01,01,  Bagherkhal (Part),56,105,28,52,28,53,34.8,35.0,34.6,00000
36.0,5.0,59.0,974,02,01,  Amudpur (Part),112,50,59,21,53,29,69.1,73.8,64.6,00000
36.0,5.0,71.0,027,01,01,  Abda Sahasi & Rajapur &Keshabp,174,247,85,119,89,128,41.3,41.7,41.0,00000
36.0,5.0,71.0,027,02,01,  Shaicha (Part),49,79,24,38,25,41,38.3,38.7,37.9,00000
36.0,5.0,71.0,027,03,01,  Shankarpur (Part),17,107,10,51,7,56,13.7,16.4,11.1,00000
36.0,5.0,71.0,231,01,01,  Dariapur & Baragul,89,270,50,140,39,130,24.8,26.3,23.1,00000
36.0,5.0,71.0,231,02,01,  Karimpur (Part),35,116,13,64,22,52,23.2,16.9,29.7,00000
36.0,5.0,71.0,265,01,01,  Sutin & Rajarampur,82,625,51,306,31,319,11.6,14.3,8.9,00000
36.0,5.0,71.0,265,02,01,  Moragaon & Durgapur & Rampur,128,277,53,148,75,129,31.6,26.4,36.8,00000
36.0,5.0,71.0,447,01,01,  Sarangpur,59,498,30,244,29,254,10.6,10.9,10.2,00000
36.0,5.0,71.0,447,02,01,  Mahabbatpur,104,534,55,266,49,268,16.3,17.1,15.5,00000
36.0,5.0,71.0,447,03,01,  Soayia (Part),324,677,150,347,174,330,32.4,30.2,34.5,00000
36.0,5.0,71.0,538,01,01,  Chandpur,29,56,7,31,22,25,34.1,18.4,46.8,00000
36.0,5.0,71.0,538,02,01,  Ijjatpur & Khanpur,274,149,132,66,142,83,64.8,66.7,63.1,00000
36.0,5.0,71.0,538,03,01,  Noagaon,79,47,44,19,35,28,62.7,69.8,55.6,00000
36.0,5.0,71.0,538,04,01,  Yusufpur,28,29,15,11,13,18,49.1,57.7,41.9,00000
36.0,5.0,71.0,538,05,01,  Kharia,187,223,92,104,95,119,45.6,46.9,44.4,00000
36.0,5.0,71.0,613,01,01,  Adittyapur (Part),285,353,130,182,155,171,44.7,41.7,47.5,00000
36.0,5.0,71.0,613,02,01,  Abdafoujdia,188,145,96,64,92,81,56.5,60.0,53.2,00000
36.0,5.0,71.0,613,03,01,  Arishpur,71,106,40,41,31,65,40.1,49.4,32.3,00000
36.0,5.0,71.0,613,04,01,  Mahish Dulong,233,260,103,125,130,135,47.3,45.2,49.1,00000
36.0,5.0,71.0,623,01,01,  Manikpur,96,746,39,377,57,369,11.4,9.4,13.4,00000
36.0,5.0,71.0,623,02,01,  Purba Jaria,92,328,42,134,50,194,21.9,23.9,20.5,00000
36.0,5.0,71.0,623,03,01,  Bangaon,31,56,16,24,15,32,35.6,40.0,31.9,00000
36.0,5.0,71.0,623,04,01,  Jarianoagaon,101,129,56,60,45,69,43.9,48.3,39.5,00000
36.0,5.0,71.0,651,01,01,  Manika,73,196,34,85,39,111,27.1,28.6,26.0,00000
36.0,5.0,71.0,651,02,01,  Chararpar,20,59,12,27,8,32,25.3,30.8,20.0,00000
36.0,5.0,71.0,651,03,01,  Saralia,45,279,23,143,22,136,13.9,13.9,13.9,00000
36.0,5.0,71.0,651,04,01,  Chak Harihar,113,189,57,90,56,99,37.4,38.8,36.1,00000
36.0,5.0,71.0,651,05,01,  Bhabanipur,21,135,12,69,9,66,13.5,14.8,12.0,00000
36.0,5.0,71.0,651,06,01,  Haraiteka,52,33,30,16,22,17,61.2,65.2,56.4,00000
36.0,5.0,71.0,651,07,01,  Mirzomla,22,27,12,14,10,13,44.9,46.2,43.5,00000
36.0,5.0,71.0,708,01,01,  Narikeltala,439,265,240,122,199,143,62.4,66.3,58.2,00000
36.0,5.0,71.0,708,02,01,  Karamabad,27,126,18,64,9,62,17.6,22.0,12.7,00000
36.0,5.0,71.0,708,03,01,  Shinghanath,81,134,52,59,29,75,37.7,46.8,27.9,00000
36.0,5.0,71.0,722,01,01,  Noagoan,72,144,36,67,36,77,33.3,35.0,31.9,00000
36.0,5.0,71.0,722,02,01,  Petpara,68,137,29,69,39,68,33.2,29.6,36.4,00000
36.0,5.0,71.0,722,03,01,  Bhanukona,40,49,17,24,23,25,44.9,41.5,47.9,00000
36.0,5.0,71.0,722,04,01,  Bishnupur,59,121,27,53,32,68,32.8,33.8,32.0,00000
36.0,5.0,71.0,722,05,01,  Kalikona,67,110,28,59,39,51,37.9,32.2,43.3,00000
36.0,5.0,71.0,810,01,01,  Jagatpur,204,520,98,248,106,272,28.2,28.3,28.0,00000
36.0,5.0,71.0,810,02,01,  Rasulpur,97,467,50,241,47,226,17.2,17.2,17.2,00000
36.0,5.0,71.0,810,03,01,  Gakulpur,333,616,167,308,166,308,35.1,35.2,35.0,00000
36.0,5.0,71.0,817,01,01,  Purba Rasulpur,96,458,46,230,50,228,17.3,16.7,18.0,00000
36.0,5.0,71.0,817,02,01,  Khrimpur (P),123,188,64,88,59,100,39.5,42.1,37.1,00000
36.0,5.0,71.0,863,01,01,  Ramaballabpur,83,117,38,51,45,66,41.5,42.7,40.5,00000
36.0,5.0,71.0,863,02,01,  Chhaicha (Part),27,123,12,57,15,66,18.0,17.4,18.5,00000
36.0,5.0,71.0,863,03,01,  Sankarpur (Part),13,26,7,12,6,14,33.3,36.8,30.0,00000
36.0,5.0,71.0,879,01,01,  Satkapan,1014,523,608,256,406,267,66.0,70.4,60.3,00000
36.0,5.0,71.0,879,02,01,  Chalitatala,42,27,23,12,19,15,60.9,65.7,55.9,00000
36.0,5.0,71.0,879,03,01,  Uzirpur,66,110,38,51,28,59,37.5,42.7,32.2,00000
36.0,5.0,71.0,879,04,01,  Rugbpur,112,86,61,38,51,48,56.6,61.6,51.5,00000
36.0,5.0,71.0,887,01,01,  Bakatapur,183,992,87,506,96,486,15.6,14.7,16.5,00000
36.0,5.0,71.0,887,02,01,  Rawail,98,291,60,141,38,150,25.2,29.9,20.2,00000
36.0,5.0,71.0,926,01,01,  Telikandi,94,89,57,44,37,45,51.4,56.4,45.1,00000
36.0,5.0,71.0,926,02,01,  Durlabpur,25,33,12,14,13,19,43.1,46.2,40.6,00000
36.0,5.0,71.0,926,03,01,  Hashiarjush,72,89,31,42,41,47,44.7,42.5,46.6,00000
36.0,5.0,71.0,926,04,01,  Adittapur (Part),39,28,18,14,21,14,58.2,56.3,60.0,00000
36.0,5.0,71.0,926,05,01,  T.G.Madhupur Staff Qtr.,213,618,138,284,75,334,25.6,32.7,18.3,00000
36.0,5.0,71.0,957,01,01,  Ulua,477,538,203,264,274,274,47.0,43.5,50.0,00000
36.0,5.0,71.0,957,02,01,  Bade Olua,181,497,98,235,83,262,26.7,29.4,24.1,00000
36.0,5.0,71.0,957,03,01,  Alua Noagaon,182,386,84,184,98,202,32.0,31.3,32.7,00000
36.0,5.0,71.0,957,04,01,  Senarkandi,59,493,32,233,27,260,10.7,12.1,9.4,00000
36.0,5.0,83.0,074,01,01,  Ashatala,205,354,105,180,100,174,36.7,36.8,36.5,00000
36.0,5.0,83.0,074,02,01,  Karampur,51,114,27,45,24,69,30.9,37.5,25.8,00000
36.0,5.0,83.0,074,03,01,  Hasanpur,180,527,91,259,89,268,25.5,26.0,24.9,00000
36.0,5.0,83.0,299,01,01,  Lalpur (Part),205,71,102,29,103,42,74.3,77.9,71.0,00000
36.0,5.0,83.0,299,02,01,  Nidanpur,174,228,67,105,107,123,43.3,39.0,46.5,00000
36.0,5.0,83.0,313,01,01,  Fatehpur,239,276,112,135,127,141,46.4,45.3,47.4,00000
36.0,5.0,83.0,313,02,01,  Enayetpur,36,26,17,8,19,18,58.1,68.0,51.4,00000
36.0,5.0,83.0,313,03,01,  Shyampur,310,189,143,99,167,90,62.1,59.1,65.0,00000
36.0,5.0,83.0,313,04,01,  Paila Para,93,191,36,103,57,88,32.7,25.9,39.3,00000
36.0,5.0,83.0,313,05,01,  Alapur (Part),26,40,14,22,12,18,39.4,38.9,40.0,00000
36.0,5.0,83.0,313,06,01,  Mirar Chak,32,47,12,24,20,23,40.5,33.3,46.5,00000
36.0,5.0,83.0,395,01,01,  Chak Haydar,176,478,104,235,72,243,26.9,30.7,22.9,00000
36.0,5.0,83.0,395,02,01,  Abda Kamal,160,168,80,73,80,95,48.8,52.3,45.7,00000
36.0,5.0,83.0,415,01,01,  Husenpur,413,241,177,129,236,112,63.1,57.8,67.8,00000
36.0,5.0,83.0,415,02,01,  Lalpur (Part),35,30,16,16,19,14,53.8,50.0,57.6,00000
36.0,5.0,83.0,415,03,01,  Alapur (Part),85,138,40,66,45,72,38.1,37.7,38.5,00000
36.0,5.0,83.0,497,01,01,  Kalakarail,11,37,3,17,8,20,22.9,15.0,28.6,00000
36.0,5.0,83.0,497,02,01,  Sham Padir,62,152,24,81,38,71,29.0,22.9,34.9,00000
36.0,5.0,83.0,504,01,01,  Kalapur,299,141,150,65,149,76,68.0,69.8,66.2,00000
36.0,5.0,83.0,504,02,01,  Dauthpur,80,151,36,82,44,69,34.6,30.5,38.9,00000
36.0,5.0,83.0,940,01,01,  Snanghat,1049,2837,535,1385,514,1452,27.0,27.9,26.1,00000
36.0,5.0,83.0,940,02,01,  Baghdair,355,635,131,340,224,295,35.9,27.8,43.2,00000
36.0,11.0,11.0,198,01,03,  Chaturanga Rayerpara,258,377,131,186,127,191,40.6,41.3,39.9,00000
36.0,11.0,11.0,198,02,03,  Dattapara,537,540,284,270,253,270,49.9,51.3,48.4,00000
36.0,11.0,11.0,198,03,03,  Nagarkhana,116,161,59,68,57,93,41.9,46.5,38.0,00000
36.0,11.0,11.0,198,04,03,  Dewan Dighir Purbapara,192,132,98,68,94,64,59.3,59.0,59.5,00000
36.0,11.0,11.0,198,06,03,  Chhota Nagar,104,86,53,50,51,36,54.7,51.5,58.6,00000
36.0,11.0,11.0,198,07,03,  Bara Nagar,111,266,53,123,58,143,29.4,30.1,28.9,00000
36.0,11.0,11.0,464,01,01,  Kamalkhani,540,918,255,438,285,480,37.0,36.8,37.3,00000
36.0,11.0,11.0,464,06,01,  Mir Mahalla,191,352,98,195,93,157,35.2,33.4,37.2,00000
36.0,11.0,11.0,563,01,01,  Majlish Mahalla,977,1037,454,484,523,553,48.5,48.4,48.6,00000
36.0,11.0,11.0,563,04,01,  Jamalpur,61,555,31,255,30,300,9.9,10.8,9.1,00000
36.0,11.0,11.0,563,05,01,  Hangumiar Para,141,247,83,117,58,130,36.3,41.5,30.9,00000
36.0,11.0,11.0,563,06,01,  Chandpur,83,346,30,177,53,169,19.3,14.5,23.9,00000
36.0,11.0,11.0,563,07,01,  Hazra Para,216,298,118,144,98,154,42.0,45.0,38.9,00000
36.0,11.0,11.0,563,08,01,  Gop Mohalla,99,485,39,219,60,266,17.0,15.1,18.4,00000
36.0,11.0,11.0,748,01,03,  Nandi Para,736,1036,391,491,345,545,41.5,44.3,38.8,00000
36.0,11.0,11.0,748,02,03,  Daspara,217,66,115,25,102,41,76.7,82.1,71.3,00000
36.0,11.0,11.0,748,03,03,  Bhaduari,193,557,101,299,92,258,25.7,25.3,26.3,00000
36.0,11.0,11.0,748,04,03,  Puran Topkhana,235,215,119,81,116,134,52.2,59.5,46.4,00000
36.0,11.0,11.0,748,05,03,  Janggala Tona,20,9,10,7,10,2,69.0,58.8,83.3,00000
36.0,11.0,11.0,748,06,03,  Darga Mahalla,163,225,70,109,93,116,42.0,39.1,44.5,00000
36.0,11.0,11.0,748,07,03,  Tambalitola,271,281,137,141,134,140,49.1,49.3,48.9,00000
36.0,11.0,11.0,748,08,03,  Dakshinpara,263,252,131,104,132,148,51.1,55.7,47.1,00000
36.0,11.0,11.0,951,01,03,  Topkhana,334,589,155,266,179,323,36.2,36.8,35.7,00000
36.0,11.0,11.0,951,03,03,  Bagh,479,433,258,213,221,220,52.5,54.8,50.1,00000
36.0,11.0,11.0,951,04,03,  Dargah Mohalla,271,302,185,154,86,148,47.3,54.6,36.8,00000
36.0,11.0,11.0,951,05,03,  Khandakar Mohalla,205,305,134,164,71,141,40.2,45.0,33.5,00000
36.0,11.0,11.0,951,06,03,  Bawyal Tola,121,69,58,31,63,38,63.7,65.2,62.4,00000
36.0,11.0,11.0,951,08,03,  Dewanbagh,110,138,59,70,51,68,44.4,45.7,42.9,00000
36.0,11.0,12.0,041,01,01,  Bhidda Bushan Para,220,817,111,411,109,406,21.2,21.3,21.2,00000
36.0,11.0,12.0,041,02,01,  Rupa Rajkhar Para,259,317,132,168,127,149,45.0,44.0,46.0,00000
36.0,11.0,12.0,041,03,01,  Amirkhani,525,1029,247,520,278,509,33.8,32.2,35.3,00000
36.0,11.0,12.0,041,04,01,  Ghagrakona,59,565,29,278,30,287,9.5,9.4,9.5,00000
36.0,11.0,12.0,464,01,01,  Raghu Chowdhury Para,330,1511,151,784,179,727,17.9,16.1,19.8,00000
36.0,11.0,12.0,464,02,01,  Tak Bajkhani,665,783,335,377,330,406,45.9,47.1,44.8,00000
36.0,11.0,12.0,532,01,01,  Garib Hossan Mohalla,305,373,150,189,155,184,45.0,44.2,45.7,00000
36.0,11.0,12.0,532,02,01,  Sheker Mohalla,218,346,88,167,130,179,38.7,34.5,42.1,00000
36.0,11.0,12.0,532,03,01,  Bhatta Para,153,275,79,137,74,138,35.7,36.6,34.9,00000
36.0,11.0,12.0,532,04,01,  Mohorer Para,486,520,218,241,268,279,48.3,47.5,49.0,00000
36.0,11.0,12.0,532,05,01,  Kutubkhali,722,1129,337,526,385,603,39.0,39.0,39.0,00000
36.0,11.0,12.0,889,01,01,  Sharifkhani,566,430,255,184,311,246,56.8,58.1,55.8,00000
36.0,11.0,12.0,889,02,01,  Adam Khani,159,177,66,75,93,102,47.3,46.8,47.7,00000
36.0,11.0,12.0,951,01,03,  Topkhana,356,128,161,59,195,69,73.6,73.2,73.9,00000
36.0,11.0,12.0,951,02,03,  Uttar Topkhana,345,422,154,201,191,221,45.0,43.4,46.4,00000
36.0,11.0,12.0,951,03,03,  Dukanitola,371,377,172,168,199,209,49.6,50.6,48.8,00000
36.0,11.0,12.0,951,05,03,  Pathantola,380,140,199,50,181,90,73.1,79.9,66.8,00000
36.0,11.0,12.0,951,06,03,  Minat,297,712,143,344,154,368,29.4,29.4,29.5,00000
36.0,11.0,12.0,951,07,03,  Khagchire,372,218,185,104,187,114,63.1,64.0,62.1,00000
36.0,11.0,12.0,951,08,03,  Chand Para,509,707,228,323,281,384,41.9,41.4,42.3,00000
36.0,11.0,12.0,951,09,03,  Acharjja Para,308,119,164,56,144,63,72.1,74.5,69.6,00000
36.0,11.0,18.0,203,01,01,  Banasar Spara,486,681,215,296,271,385,41.6,42.1,41.3,00000
36.0,11.0,18.0,203,02,01,  Chowdhury Para,508,336,278,147,230,189,60.2,65.4,54.9,00000
36.0,11.0,18.0,203,03,01,  Triker Mohalla,237,181,108,79,129,102,56.7,57.8,55.8,00000
36.0,11.0,18.0,277,01,01,  Sagar Dighir Purbapar,601,546,267,218,334,328,52.4,55.1,50.5,00000
36.0,11.0,18.0,277,02,01,  Thakurani Dighir Paschimpar,189,262,84,123,105,139,41.9,40.6,43.0,00000
36.0,11.0,18.0,277,03,01,  Desh Mukshya Para,258,545,111,252,147,293,32.1,30.6,33.4,00000
36.0,11.0,18.0,277,04,01,  Dhal Mohalla,232,487,105,241,127,246,32.3,30.3,34.0,00000
36.0,11.0,18.0,277,05,01,  Paragaon,275,922,114,439,161,483,23.0,20.6,25.0,00000
36.0,11.0,18.0,277,06,01,  Thakurani Dighir Purbapar,135,118,56,53,79,65,53.4,51.4,54.9,00000
36.0,11.0,18.0,277,07,01,  Madhukhali,174,73,89,28,85,45,70.4,76.1,65.4,00000
36.0,11.0,18.0,406,01,01,  Jatukarna Para,1506,4172,720,2043,786,2129,26.5,26.1,27.0,00000
36.0,11.0,18.0,406,02,01,  Kalidas Tek,50,379,16,182,34,197,11.7,8.1,14.7,00000
36.0,11.0,18.0,406,03,01,  Tatari Mohalla,407,1117,185,532,222,585,26.7,25.8,27.5,00000
36.0,11.0,18.0,406,04,01,  Chilla Panja,305,680,133,347,172,333,31.0,27.7,34.1,00000
36.0,11.0,18.0,406,05,01,  Mahabat Khani,295,288,141,136,154,152,50.6,50.9,50.3,00000
36.0,11.0,18.0,406,06,01,  Thakur Para,36,5,16,3,20,2,87.8,84.2,90.9,00000
36.0,11.0,18.0,611,01,01,  Miakhani,311,707,171,312,140,395,30.6,35.4,26.2,00000
36.0,11.0,18.0,611,02,01,  Doyakhani,337,1021,155,509,182,512,24.8,23.3,26.2,00000
36.0,11.0,18.0,750,01,03,  Puranbagh,209,149,90,59,119,90,58.4,60.4,56.9,00000
36.0,11.0,18.0,750,02,03,  Enathkhani,457,771,199,359,258,412,37.2,35.7,38.5,00000
36.0,11.0,18.0,750,03,03,  Adamkhani,164,47,86,18,78,29,77.7,82.7,72.9,00000
36.0,11.0,25.0,611,01,03,  Basia Para,297,759,120,342,177,417,28.1,26.0,29.8,00000
36.0,11.0,25.0,611,03,03,  Pathantola,293,270,161,113,132,157,52.0,58.8,45.7,00000
36.0,11.0,25.0,750,01,03,  Madaritola,180,442,106,226,74,216,28.9,31.9,25.5,00000
36.0,11.0,25.0,838,01,01,  Sagar Dighi Dakshinpar,185,300,91,146,94,154,38.1,38.4,37.9,00000
36.0,11.0,25.0,838,02,01,  Sagar Dighi Paschimpar,572,534,253,224,319,310,51.7,53.0,50.7,00000
36.0,11.0,25.0,838,03,01,  Sagar Dighi Uttarpar,582,627,288,283,294,344,48.1,50.4,46.1,00000
36.0,11.0,25.0,838,04,01,  Lama Para,244,392,115,177,129,215,38.4,39.4,37.5,00000
36.0,11.0,25.0,838,05,01,  Aralia Para,164,69,81,25,83,44,70.4,76.4,65.4,00000
36.0,11.0,25.0,889,01,01,  Sharifkhani,1047,1349,531,657,516,692,43.7,44.7,42.7,00000
36.0,11.0,25.0,889,02,01,  Buruj Para,83,392,48,178,35,214,17.5,21.2,14.1,00000
36.0,11.0,25.0,889,03,01,  Kalika Para,276,201,139,94,137,107,57.9,59.7,56.1,00000
36.0,11.0,25.0,889,05,01,  Tilak Ram Royer Para,71,88,33,42,38,46,44.7,44.0,45.2,00000
36.0,11.0,31.0,157,01,01,  Betkandi,244,433,106,223,138,210,36.0,32.2,39.7,00000
36.0,11.0,31.0,157,02,01,  Baktarpur,215,619,93,300,122,319,25.8,23.7,27.7,00000
36.0,11.0,31.0,157,03,01,  Rajapur,73,94,29,46,44,48,43.7,38.7,47.8,00000
36.0,11.0,31.0,460,01,01,  Kalinjura,390,844,188,380,202,464,31.6,33.1,30.3,00000
36.0,11.0,31.0,460,02,01,  Holdarpur,836,1077,377,501,459,576,43.7,42.9,44.3,00000
36.0,11.0,31.0,823,01,01,  Rokanpur,0,12,0,7,0,5,0.0,0.0,0.0,00000
36.0,11.0,31.0,823,02,01,  Shassham,89,160,48,74,41,86,35.7,39.3,32.3,00000
36.0,11.0,31.0,823,03,01,  Nasni,59,300,30,145,29,155,16.4,17.1,15.8,00000
36.0,11.0,31.0,823,04,01,  Bodpur,28,69,17,27,11,42,28.9,38.6,20.8,00000
36.0,11.0,37.0,207,01,01,  Chauki Chak,263,596,113,286,150,310,30.6,28.3,32.6,00000
36.0,11.0,37.0,207,02,01,  Purba Daulatpur,904,1725,395,863,509,862,34.4,31.4,37.1,00000
36.0,11.0,37.0,244,01,01,  Damargaon,354,618,147,320,207,298,36.4,31.5,41.0,00000
36.0,11.0,37.0,244,02,01,  Chandipur,346,554,166,297,180,257,38.4,35.9,41.2,00000
36.0,11.0,37.0,244,03,01,  Paschim Daulatpur,2176,2705,1017,1361,1159,1344,44.6,42.8,46.3,00000
36.0,11.0,37.0,605,01,01,  Hilalnagar,608,547,331,266,277,281,52.6,55.4,49.6,00000
36.0,11.0,37.0,605,02,01,  Muradpur,174,586,94,286,80,300,22.9,24.7,21.1,00000
36.0,11.0,37.0,605,03,01,  Kadirganj Bazar,801,421,439,215,362,206,65.5,67.1,63.7,00000
36.0,11.0,37.0,605,04,01,  Omar Pur,202,192,93,100,109,92,51.3,48.2,54.2,00000
36.0,11.0,37.0,883,01,01,  Shakhaiti,197,241,89,121,108,120,45.0,42.4,47.4,00000
36.0,11.0,37.0,883,02,01,  Altabpur,55,171,23,87,32,84,24.3,20.9,27.6,00000
36.0,11.0,37.0,883,03,01,  Kalipur,108,125,53,62,55,63,46.4,46.1,46.6,00000
36.0,11.0,37.0,883,04,01,  Noagaon,442,480,194,255,248,225,47.9,43.2,52.4,00000
36.0,11.0,37.0,941,01,01,  Telghari,782,608,434,284,348,324,56.3,60.4,51.8,00000
36.0,11.0,37.0,941,02,01,  Kabirpur,321,553,168,276,153,277,36.7,37.8,35.6,00000
36.0,11.0,37.0,941,03,01,  Ratanpur,85,97,43,45,42,52,46.7,48.9,44.7,00000
36.0,11.0,44.0,087,01,01,  Baghata,283,1040,145,516,138,524,21.4,21.9,20.8,00000
36.0,11.0,44.0,087,02,01,  Batakandi,125,359,65,178,60,181,25.8,26.7,24.9,00000
36.0,11.0,44.0,087,03,01,  Gazipur,91,1281,51,674,40,607,6.6,7.0,6.2,00000
36.0,11.0,44.0,443,01,01,  Kagapasha,755,1224,339,610,416,614,38.2,35.7,40.4,00000
36.0,11.0,44.0,443,02,01,  Haridharpur,163,451,68,230,95,221,26.5,22.8,30.1,00000
36.0,11.0,44.0,572,01,01,  Makal Kandi,601,567,293,259,308,308,51.5,53.1,50.0,00000
36.0,11.0,44.0,572,02,01,  Muslimpur,9,220,7,113,2,107,3.9,5.8,1.8,00000
36.0,11.0,50.0,004,01,01,  Hossainpur,131,309,75,148,56,161,29.8,33.6,25.8,00000
36.0,11.0,50.0,004,02,01,  Jaganathpur,62,83,30,42,32,41,42.8,41.7,43.8,00000
36.0,11.0,50.0,236,01,01,  Karcha,222,183,96,86,126,97,54.8,52.7,56.5,00000
36.0,11.0,50.0,236,02,01,  Bara Abda,190,242,76,121,114,121,44.0,38.6,48.5,00000
36.0,11.0,50.0,236,03,01,  Rangahati,133,156,53,75,80,81,46.0,41.4,49.7,00000
36.0,11.0,50.0,315,01,01,  Ghatua,185,216,74,112,111,104,46.1,39.8,51.6,00000
36.0,11.0,50.0,315,02,01,  Amirpur,82,68,35,31,47,37,54.7,53.0,56.0,00000
36.0,11.0,50.0,795,01,01,  Rajpara,475,868,234,447,241,421,35.4,34.4,36.4,00000
36.0,11.0,50.0,795,02,01,  Jamalpur,3,28,1,15,2,13,9.7,6.3,13.3,00000
36.0,11.0,50.0,833,01,01,  Rupshapur,87,211,38,106,49,105,29.2,26.4,31.8,00000
36.0,11.0,50.0,833,02,01,  Chhota Ujirpur,74,223,31,121,43,102,24.9,20.4,29.7,00000
36.0,11.0,50.0,849,01,01,  Saidpur,92,164,40,78,52,86,35.9,33.9,37.7,00000
36.0,11.0,50.0,849,02,01,  Shibpur,58,108,20,55,38,53,34.9,26.7,41.8,00000
36.0,11.0,50.0,866,01,01,  Sandanpur,353,372,172,192,181,180,48.7,47.3,50.1,00000
36.0,11.0,50.0,866,02,01,  Haripur,120,560,61,289,59,271,17.6,17.4,17.9,00000
36.0,11.0,50.0,932,01,01,  Tajpur,176,378,74,190,102,188,31.8,28.0,35.2,00000
36.0,11.0,50.0,932,02,01,  Daulatpur,230,273,112,130,118,143,45.7,46.3,45.2,00000
36.0,11.0,50.0,965,01,01,  Ujirpur,358,972,160,466,198,506,26.9,25.6,28.1,00000
36.0,11.0,50.0,965,02,01,  Basantapur,186,172,101,74,85,98,52.0,57.7,46.4,00000
36.0,11.0,50.0,994,01,01,  Mathurapur,330,549,152,253,178,296,37.5,37.5,37.6,00000
36.0,11.0,50.0,994,02,01,  Lama Ujirpur,47,84,30,32,17,52,35.9,48.4,24.6,00000
36.0,11.0,56.0,230,01,01,  Dakshin Sangar,909,3167,436,1502,473,1665,22.3,22.5,22.1,00000
36.0,11.0,56.0,230,02,01,  Mohanpur,13,165,8,79,5,86,7.3,9.2,5.5,00000
36.0,11.0,56.0,230,03,01,  Radhapur,260,435,146,195,114,240,37.4,42.8,32.2,00000
36.0,11.0,56.0,230,04,01,  Barakandi,100,470,55,229,45,241,17.5,19.4,15.7,00000
36.0,11.0,56.0,331,01,01,  Hiala,596,1016,275,510,321,506,37.0,35.0,38.8,00000
36.0,11.0,56.0,331,02,01,  Kachuarabda,109,201,50,98,59,103,35.2,33.8,36.4,00000
36.0,11.0,56.0,489,01,01,  Kendua Baha,208,248,103,118,105,130,45.6,46.6,44.7,00000
36.0,11.0,56.0,489,02,01,  Nurpur,47,59,19,31,28,28,44.3,38.0,50.0,00000
36.0,11.0,56.0,489,03,01,  Talia,3,66,2,30,1,36,4.3,6.3,2.7,00000
36.0,11.0,56.0,679,01,01,  Nischintapur(Mahatab Pur),132,563,71,273,61,290,19.0,20.6,17.4,00000
36.0,11.0,56.0,679,02,01,  Kabilpur,243,372,127,192,116,180,39.5,39.8,39.2,00000
36.0,11.0,56.0,721,01,01,  Noa Patharia,253,874,123,441,130,433,22.4,21.8,23.1,00000
36.0,11.0,56.0,721,02,01,  Puran Patharia,603,1108,300,574,303,534,35.2,34.3,36.2,00000
36.0,11.0,63.0,008,01,01,  Rajanagar,62,265,27,124,35,141,19.0,17.9,19.9,00000
36.0,11.0,63.0,008,02,01,  Agoa,474,1219,248,621,226,598,28.0,28.5,27.4,00000
36.0,11.0,63.0,008,03,01,  Dulalpur,111,443,56,204,55,239,20.0,21.5,18.7,00000
36.0,11.0,63.0,493,01,01,  Keorakandi,410,1018,191,513,219,505,28.7,27.1,30.2,00000
36.0,11.0,63.0,493,02,01,  Kanaipur,82,254,41,126,41,128,24.4,24.6,24.3,00000
36.0,11.0,63.0,592,01,01,  Mandari,727,1470,380,733,347,737,33.1,34.1,32.0,00000
36.0,11.0,63.0,592,02,01,  Jalilpur,168,372,85,186,83,186,31.1,31.4,30.9,00000
36.0,11.0,63.0,592,03,01,  Sunampur,175,401,81,206,94,195,30.4,28.2,32.5,00000
36.0,11.0,69.0,302,01,01,  Gandpur Bade,126,478,76,229,50,249,20.9,24.9,16.7,00000
36.0,11.0,69.0,302,02,01,  Josh Keshshari,137,133,78,63,59,70,50.7,55.3,45.7,00000
36.0,11.0,69.0,348,01,01,  Hasanpur,154,746,102,342,52,404,17.1,23.0,11.4,00000
36.0,11.0,69.0,348,02,01,  Nil Hasanpur,146,321,82,149,64,172,31.3,35.5,27.1,00000
36.0,11.0,69.0,348,03,01,  Matikata,74,445,43,232,31,213,14.3,15.6,12.7,00000
36.0,11.0,69.0,348,04,01,  Islampur,129,334,78,163,51,171,27.9,32.4,23.0,00000
36.0,11.0,69.0,348,05,01,  Satanihati,62,298,30,148,32,150,17.2,16.9,17.6,00000
36.0,11.0,69.0,352,01,01,  Paharpur,92,353,47,173,45,180,20.7,21.4,20.0,00000
36.0,11.0,69.0,352,02,01,  Mirzapur,48,217,29,96,19,121,18.1,23.2,13.6,00000
36.0,11.0,69.0,352,03,01,  Kandipara,62,149,34,71,28,78,29.4,32.4,26.4,00000
36.0,11.0,69.0,352,04,01,  Paglashi,36,156,20,75,16,81,18.8,21.1,16.5,00000
36.0,11.0,69.0,352,05,01,  Nilhati,16,140,8,69,8,71,10.3,10.4,10.1,00000
36.0,11.0,69.0,596,01,01,  Mardanpur,87,418,47,212,40,206,17.2,18.1,16.3,00000
36.0,11.0,69.0,596,02,01,  Makania,38,431,22,206,16,225,8.1,9.6,6.6,00000
36.0,11.0,69.0,596,03,01,  Santipur,12,359,6,183,6,176,3.2,3.2,3.3,00000
36.0,11.0,69.0,779,01,01,  Talabpur,5,241,2,114,3,127,2.0,1.7,2.3,00000
36.0,11.0,69.0,779,02,01,  Rahmatpur,80,407,37,199,43,208,16.4,15.7,17.1,00000
36.0,11.0,69.0,779,03,01,  Shahjalal Pur,30,203,13,102,17,101,12.9,11.3,14.4,00000
36.0,11.0,69.0,779,04,01,  Mohamd Pur,20,165,15,78,5,87,10.8,16.1,5.4,00000
36.0,11.0,69.0,820,01,01,  Roypur,25,306,15,157,10,149,7.6,8.7,6.3,00000
36.0,11.0,69.0,820,02,01,  Lalpur,15,274,13,142,2,132,5.2,8.4,1.5,00000
36.0,11.0,69.0,820,03,01,  Babanipur,118,363,72,166,46,197,24.5,30.3,18.9,00000
36.0,11.0,75.0,024,01,01,  Alamnagar,109,254,68,118,41,136,30.0,36.6,23.2,00000
36.0,11.0,75.0,024,02,01,  Goshainagar,29,100,15,52,14,48,22.5,22.4,22.6,00000
36.0,11.0,75.0,024,03,01,  Dangarkhola,52,141,26,75,26,66,26.9,25.7,28.3,00000
36.0,11.0,75.0,178,01,01,  Bijoypur,113,490,51,235,62,255,18.7,17.8,19.6,00000
36.0,11.0,75.0,178,02,01,  Lal Rahmatpur,32,86,18,40,14,46,27.1,31.0,23.3,00000
36.0,11.0,75.0,530,01,01,  Kumri,129,298,78,129,51,169,30.2,37.7,23.2,00000
36.0,11.0,75.0,530,02,01,  Nilpur,110,171,55,82,55,89,39.1,40.1,38.2,00000
36.0,11.0,75.0,530,03,01,  Farangitolla,221,151,108,71,113,80,59.4,60.3,58.5,00000
36.0,11.0,75.0,530,04,01,  Najarpur,426,1437,242,714,184,723,22.9,25.3,20.3,00000
36.0,11.0,75.0,530,05,01,  Durgapur,547,2284,320,1059,227,1225,19.3,23.2,15.6,00000
36.0,11.0,75.0,700,01,01,  Pailarkandi,590,1345,315,664,275,681,30.5,32.2,28.8,00000
36.0,11.0,75.0,905,01,01,  Sreemangal Kandi,120,452,84,209,36,243,21.0,28.7,12.9,00000
36.0,11.0,75.0,905,02,01,  Goalhati,242,518,132,236,110,282,31.8,35.9,28.1,00000
36.0,11.0,75.0,905,03,01,  Paschimhati,272,141,138,64,134,77,65.9,68.3,63.5,00000
36.0,11.0,75.0,905,04,01,  Gagapur,74,52,39,22,35,30,58.7,63.9,53.8,00000
36.0,11.0,75.0,905,05,01,  Jagatpur,25,115,16,48,9,67,17.9,25.0,11.8,00000
36.0,11.0,75.0,905,06,01,  Aradhanpur,18,145,11,71,7,74,11.0,13.4,8.6,00000
36.0,11.0,75.0,905,07,01,  Baktapur,24,148,18,74,6,74,14.0,19.6,7.5,00000
36.0,11.0,75.0,905,08,01,  Noahati,28,229,22,106,6,123,10.9,17.2,4.7,00000
36.0,11.0,75.0,905,09,01,  Munshihati,57,196,29,108,28,88,22.5,21.2,24.1,00000
36.0,11.0,82.0,012,01,01,  Ahammadpur,127,225,75,138,52,87,36.1,35.2,37.4,00000
36.0,11.0,82.0,012,02,01,  Mohammadpur,87,279,43,141,44,138,23.8,23.4,24.2,00000
36.0,11.0,82.0,074,01,01,  Auwal Mahal,277,516,136,237,141,279,34.9,36.5,33.6,00000
36.0,11.0,82.0,074,02,01,  Amirpur,114,207,44,97,70,110,35.5,31.2,38.9,00000
36.0,11.0,82.0,240,01,01,  Sikandarpur,577,283,289,125,288,158,67.1,69.8,64.6,00000
36.0,11.0,82.0,240,02,01,  Sapair Chak,40,92,20,41,20,51,30.3,32.8,28.2,00000
36.0,11.0,82.0,240,03,01,  Ramganj,241,969,107,475,134,494,19.9,18.4,21.3,00000
36.0,11.0,82.0,269,01,01,  Daulatpur,122,1015,74,516,48,499,10.7,12.5,8.8,00000
36.0,11.0,82.0,269,02,01,  Aligonj Bazar,5,95,2,41,3,54,5.0,4.7,5.3,00000
36.0,11.0,82.0,431,01,01,  Juranagar,91,187,36,103,55,84,32.7,25.9,39.6,00000
36.0,11.0,82.0,431,02,01,  Jamalpur,57,162,28,81,29,81,26.0,25.7,26.4,00000
36.0,11.0,82.0,630,01,01,  Murarabda,359,254,174,111,185,143,58.6,61.1,56.4,00000
36.0,11.0,82.0,630,02,01,  Krishana Nagar,119,547,62,274,57,273,17.9,18.5,17.3,00000
36.0,11.0,82.0,653,01,01,  Nagura,455,347,232,162,223,185,56.7,58.9,54.7,00000
36.0,11.0,82.0,653,02,01,  Adamnagar,101,93,55,42,46,51,52.1,56.7,47.4,00000
36.0,11.0,82.0,653,03,01,  Nagura Agri.Farm,97,4,81,2,16,2,96.0,97.6,88.9,00000
36.0,11.0,82.0,746,01,01,  Pukhra,750,942,350,473,400,469,44.3,42.5,46.0,00000
36.0,11.0,82.0,746,02,01,  Sampur,133,577,70,267,63,310,18.7,20.8,16.9,00000
36.0,11.0,88.0,082,01,01,  Purba Bajuka,197,448,106,227,91,221,30.5,31.8,29.2,00000
36.0,11.0,88.0,082,02,01,  Dattapur,81,58,44,27,37,31,58.3,62.0,54.4,00000
36.0,11.0,88.0,082,03,01,  Durgapur,2,28,0,11,2,17,6.7,0.0,10.5,00000
36.0,11.0,88.0,140,01,01,  Madhupur,101,83,64,32,37,51,54.9,66.7,42.0,00000
36.0,11.0,88.0,140,02,01,  Bishnapur,28,45,15,17,13,28,38.4,46.9,31.7,00000
36.0,11.0,88.0,140,03,01,  Mehedipur,177,334,110,151,67,183,34.6,42.1,26.8,00000
36.0,11.0,88.0,223,01,01,  Dakshin Badarpur,133,559,61,288,72,271,19.2,17.5,21.0,00000
36.0,11.0,88.0,223,02,01,  Kagella,20,203,9,96,11,107,9.0,8.6,9.3,00000
36.0,11.0,94.0,903,01,01,  Sonaru Karompur,890,523,431,245,459,278,63.0,63.8,62.3,00000
36.0,11.0,94.0,903,02,01,  Nuton Noa Gaon,61,169,28,85,33,84,26.5,24.8,28.2,00000
36.0,11.0,94.0,916,01,01,  Subidpur,138,390,89,184,49,206,26.1,32.6,19.2,00000
36.0,11.0,94.0,916,02,01,  Karim Nagor,49,58,27,26,22,32,45.8,50.9,40.7,00000
36.0,26.0,13.0,024,01,01,  Ghanashyampur,742,788,354,348,388,440,48.5,50.4,46.9,00000
36.0,26.0,13.0,024,02,01,  Sondarpur,294,422,150,191,144,231,41.1,44.0,38.4,00000
36.0,26.0,13.0,030,01,01,  Alirajapur,186,198,108,88,78,110,48.4,55.1,41.5,00000
36.0,26.0,13.0,030,02,01,  Damudharpur,123,64,62,28,61,36,65.8,68.9,62.9,00000
36.0,26.0,13.0,066,01,01,  Ashrafpur,196,179,99,76,97,103,52.3,56.6,48.5,00000
36.0,26.0,13.0,066,02,01,  Ganganagar,592,83,270,33,322,50,87.7,89.1,86.6,00000
36.0,26.0,13.0,156,01,01,  Bogadubi,742,661,356,299,386,362,52.9,54.4,51.6,00000
36.0,26.0,13.0,156,02,01,  Shukdedpur,73,89,37,32,36,57,45.1,53.6,38.7,00000
36.0,26.0,13.0,156,03,01,  Sharifpur,64,101,29,47,35,54,38.8,38.2,39.3,00000
36.0,26.0,13.0,307,01,01,  Gadishal,318,365,153,169,165,196,46.6,47.5,45.7,00000
36.0,26.0,13.0,307,02,01,  Chhaysree,716,625,345,248,371,377,53.4,58.2,49.6,00000
36.0,26.0,13.0,355,01,01,  Guchchha Para,474,434,253,203,221,231,52.2,55.5,48.9,00000
36.0,26.0,13.0,355,02,01,  Kala Mandal,304,358,160,162,144,196,45.9,49.7,42.4,00000
36.0,26.0,13.0,355,03,01,  Amu Road Bazar,16,41,11,16,5,25,28.1,40.7,16.7,00000
36.0,26.0,13.0,681,01,01,  Nalua T.E.,892,2482,598,1070,294,1412,26.4,35.9,17.2,00000
36.0,26.0,13.0,681,02,01,  Arang Bil,129,367,80,142,49,225,26.0,36.0,17.9,00000
36.0,26.0,13.0,898,01,01,  Kalisree,627,1768,275,800,352,968,26.2,25.6,26.7,00000
36.0,26.0,13.0,898,02,01,  Harhajura,126,201,63,86,63,115,38.5,42.3,35.4,00000
36.0,26.0,13.0,970,01,01,  Thoigaon,226,234,106,104,120,130,49.1,50.5,48.0,00000
36.0,26.0,13.0,970,02,01,  Haripur,33,48,14,22,19,26,40.7,38.9,42.2,00000
36.0,26.0,13.0,970,03,01,  Bangaon,464,691,235,360,229,331,40.2,39.5,40.9,00000
36.0,26.0,19.0,205,01,01,  Churta,274,423,148,183,126,240,39.3,44.7,34.4,00000
36.0,26.0,19.0,205,02,01,  Chand Bhanga,4,0,3,0,1,0,100.0,100.0,100.0,00000
36.0,26.0,19.0,205,03,01,  Mirerpara,133,158,61,75,72,83,45.7,44.9,46.5,00000
36.0,26.0,19.0,367,01,01,  Gogaura (Part),242,482,112,239,130,243,33.4,31.9,34.9,00000
36.0,26.0,19.0,367,02,01,  Katakhila,48,38,22,16,26,22,55.8,57.9,54.2,00000
36.0,26.0,19.0,379,01,01,  Habibpur,26,69,11,33,15,36,27.4,25.0,29.4,00000
36.0,26.0,19.0,379,02,01,  Nur Mohammadpur,124,276,64,142,60,134,31.0,31.1,30.9,00000
36.0,26.0,19.0,476,01,01,  Jikua,698,1185,367,552,331,633,37.1,39.9,34.3,00000
36.0,26.0,19.0,476,02,01,  Sekhergaon,135,142,73,64,62,78,48.7,53.3,44.3,00000
36.0,26.0,19.0,687,01,01,  Narpati,1456,3144,684,1512,772,1632,31.7,31.1,32.1,00000
36.0,26.0,19.0,687,02,01,  Fulbari,261,201,124,92,137,109,56.5,57.4,55.7,00000
36.0,26.0,19.0,687,03,01,  Murarband,224,485,103,230,121,255,31.6,30.9,32.2,00000
36.0,26.0,19.0,687,04,01,  Mukhepur,185,89,95,37,90,52,67.5,72.0,63.4,00000
36.0,26.0,19.0,777,01,01,  Ramsree,275,608,144,289,131,319,31.1,33.3,29.1,00000
36.0,26.0,19.0,777,02,01,  Alapur,112,167,55,82,57,85,40.1,40.1,40.1,00000
36.0,26.0,28.0,108,01,01,  Barabari,281,324,132,144,149,180,46.4,47.8,45.3,00000
36.0,26.0,28.0,108,02,01,  Jhuria,119,359,52,179,67,180,24.9,22.5,27.1,00000
36.0,26.0,28.0,180,01,01,  Chandichhara T.E.,1204,1636,698,720,506,916,42.4,49.2,35.6,00000
36.0,26.0,28.0,180,02,01,  Bhela Bil,57,434,39,214,18,220,11.6,15.4,7.6,00000
36.0,26.0,28.0,192,01,01,  Chandapur Bagan,1215,1960,774,802,441,1158,38.3,49.1,27.6,00000
36.0,26.0,28.0,192,02,01,  Joalbhanga,360,1311,216,621,144,690,21.5,25.8,17.3,00000
36.0,26.0,28.0,192,03,01,  Ramganga,178,508,106,229,72,279,25.9,31.6,20.5,00000
36.0,26.0,28.0,192,04,01,  Jamtila,75,104,49,39,26,65,41.9,55.7,28.6,00000
36.0,26.0,28.0,247,01,01,  Deogachh,1248,1197,624,534,624,663,51.0,53.9,48.5,00000
36.0,26.0,28.0,247,02,01,  Nayani Bangaon,50,178,24,87,26,91,21.9,21.6,22.2,00000
36.0,26.0,28.0,488,01,01,  Kachua,498,680,236,312,262,368,42.3,43.1,41.6,00000
36.0,26.0,28.0,488,02,01,  Kalichung,212,266,96,118,116,148,44.4,44.9,43.9,00000
36.0,26.0,28.0,488,03,01,  Dhanchi,131,115,65,45,66,70,53.3,59.1,48.5,00000
36.0,26.0,28.0,488,04,01,  Maynabad,267,97,135,46,132,51,73.4,74.6,72.1,00000
36.0,26.0,28.0,814,01,01,  Lakshmipur,250,163,130,72,120,91,60.5,64.4,56.9,00000
36.0,26.0,28.0,814,02,01,  Rajapur,165,228,87,93,78,135,42.0,48.3,36.6,00000
36.0,26.0,38.0,090,01,01,  Bagiargaon,214,478,104,220,110,258,30.9,32.1,29.9,00000
36.0,26.0,38.0,090,02,01,  Basantapur,113,205,51,104,62,101,35.5,32.9,38.0,00000
36.0,26.0,38.0,090,03,01,  Bashulla,528,1024,248,494,280,530,34.0,33.4,34.6,00000
36.0,26.0,38.0,090,04,01,  Kabilashpur,182,457,75,208,107,249,28.5,26.5,30.1,00000
36.0,26.0,38.0,270,01,01,  Dhulna T.G. (Part),342,742,163,354,179,388,31.5,31.5,31.6,00000
36.0,26.0,38.0,270,02,01,  Ganakirpar,306,301,162,122,144,179,50.4,57.0,44.6,00000
36.0,26.0,38.0,270,03,01,  Ekartali,333,556,151,261,182,295,37.5,36.7,38.2,00000
36.0,26.0,38.0,270,04,01,  Haptar Haor,127,197,68,96,59,101,39.2,41.5,36.9,00000
36.0,26.0,38.0,270,05,01,  Karaitila,77,46,33,19,44,27,62.6,63.5,62.0,00000
36.0,26.0,38.0,331,01,01,  Gazinagar,258,220,123,94,135,126,54.0,56.7,51.7,00000
36.0,26.0,38.0,331,02,01,  Alinagar,376,1093,189,510,187,583,25.6,27.0,24.3,00000
36.0,26.0,38.0,331,03,01,  Khetamara,190,243,83,115,107,128,43.9,41.9,45.5,00000
36.0,26.0,38.0,331,04,01,  Sunachong,67,231,35,103,32,128,22.5,25.4,20.0,00000
36.0,26.0,38.0,331,05,01,  Krishnanagar,166,570,79,284,87,286,22.6,21.8,23.3,00000
36.0,26.0,38.0,337,01,01,  Gazipur,491,349,233,132,258,217,58.5,63.8,54.3,00000
36.0,26.0,38.0,337,02,01,  Asampur,228,164,113,75,115,89,58.2,60.1,56.4,00000
36.0,26.0,38.0,337,03,01,  Bilpar,268,237,132,108,136,129,53.1,55.0,51.3,00000
36.0,26.0,38.0,337,04,01,  Dighirpar,68,178,41,84,27,94,27.6,32.8,22.3,00000
36.0,26.0,38.0,337,05,01,  Kadarkot,89,198,48,85,41,113,31.0,36.1,26.6,00000
36.0,26.0,38.0,337,06,01,  Tekerghat,657,830,334,368,323,462,44.2,47.6,41.1,00000
36.0,26.0,38.0,337,07,01,  Tilabari,63,119,27,59,36,60,34.6,31.4,37.5,00000
36.0,26.0,38.0,337,08,01,  Pakkabari,78,175,40,82,38,93,30.8,32.8,29.0,00000
36.0,26.0,38.0,337,09,01,  Katanipar,157,73,64,30,93,43,68.3,68.1,68.4,00000
36.0,26.0,38.0,337,10,01,  Bangaon,211,126,113,43,98,83,62.6,72.4,54.1,00000
36.0,26.0,38.0,349,01,01,  Abadgaon,226,194,132,90,94,104,53.8,59.5,47.5,00000
36.0,26.0,38.0,349,02,01,  Jatragaon,89,75,33,37,56,38,54.3,47.1,59.6,00000
36.0,26.0,38.0,349,03,01,  Konagaon,245,334,128,140,117,194,42.3,47.8,37.6,00000
36.0,26.0,38.0,349,04,01,  Barajom,96,247,53,113,43,134,28.0,31.9,24.3,00000
36.0,26.0,38.0,349,05,01,  Chaganagar,479,349,227,154,252,195,57.9,59.6,56.4,00000
36.0,26.0,38.0,349,06,01,  Fata Bil,71,122,29,59,42,63,36.8,33.0,40.0,00000
36.0,26.0,38.0,349,07,01,  Gobarkhola,656,621,309,306,347,315,51.4,50.2,52.4,00000
36.0,26.0,38.0,349,08,01,  Thakurgaon,35,88,18,39,17,49,28.5,31.6,25.8,00000
36.0,26.0,38.0,349,09,01,  Kattamara,148,124,83,57,65,67,54.4,59.3,49.2,00000
36.0,26.0,38.0,349,10,01,  Chankola,526,693,276,322,250,371,43.2,46.2,40.3,00000
36.0,26.0,38.0,349,11,01,  Karisha Basti,161,184,79,99,82,85,46.7,44.4,49.1,00000
36.0,26.0,38.0,349,12,01,  Golgoan,199,168,95,77,104,91,54.2,55.2,53.3,00000
36.0,26.0,38.0,669,01,01,  Balumara,63,213,42,100,21,113,22.8,29.6,15.7,00000
36.0,26.0,38.0,669,02,01,  Kadamtali,68,130,45,60,23,70,34.3,42.9,24.7,00000
36.0,26.0,38.0,699,01,01,  Osmanpur,315,556,152,250,163,306,36.2,37.8,34.8,00000
36.0,26.0,38.0,699,02,01,  Shibnagar,114,34,54,14,60,20,77.0,79.4,75.0,00000
36.0,26.0,38.0,699,03,01,  Khoiyauri,78,330,35,171,43,159,19.1,17.0,21.3,00000
36.0,26.0,38.0,699,04,01,  Buchibil,68,133,28,64,40,69,33.8,30.4,36.7,00000
36.0,26.0,38.0,699,05,01,  Dholajai,107,169,49,76,58,93,38.8,39.2,38.4,00000
36.0,26.0,38.0,699,06,01,  Manik Bandar,102,378,44,181,58,197,21.3,19.6,22.7,00000
36.0,26.0,47.0,012,01,01,  Adampur,347,432,160,203,187,229,44.5,44.1,45.0,00000
36.0,26.0,47.0,012,02,01,  Dargaon,60,115,29,49,31,66,34.3,37.2,32.0,00000
36.0,26.0,47.0,012,03,01,  Purba Porajar,55,149,22,77,33,72,27.0,22.2,31.4,00000
36.0,26.0,47.0,012,04,01,  Joydedpur,32,49,18,22,14,27,39.5,45.0,34.1,00000
36.0,26.0,47.0,012,05,01,  Durgaprashadpur,38,43,20,17,18,26,46.9,54.1,40.9,00000
36.0,26.0,47.0,012,06,01,  Sattalia,49,163,29,75,20,88,23.1,27.9,18.5,00000
36.0,26.0,47.0,036,01,01,  Alunia,541,364,265,168,276,196,59.8,61.2,58.5,00000
36.0,26.0,47.0,036,02,01,  Goaspur,362,309,188,142,174,167,53.9,57.0,51.0,00000
36.0,26.0,47.0,036,03,01,  Ratanpur,118,149,60,77,58,72,44.2,43.8,44.6,00000
36.0,26.0,47.0,054,01,01,  Amtala,190,410,90,211,100,199,31.7,29.9,33.4,00000
36.0,26.0,47.0,054,02,01,  Pirpur,124,168,58,80,66,88,42.5,42.0,42.9,00000
36.0,26.0,47.0,060,01,01,  Ashla,27,87,12,40,15,47,23.7,23.1,24.2,00000
36.0,26.0,47.0,060,02,01,  Joynabad,23,55,10,28,13,27,29.5,26.3,32.5,00000
36.0,26.0,47.0,060,03,01,  Purusuttampur,34,170,14,83,20,87,16.7,14.4,18.7,00000
36.0,26.0,47.0,060,04,01,  Narasingergaon,121,128,62,56,59,72,48.6,52.5,45.0,00000
36.0,26.0,47.0,060,05,01,  Radhaballabhpur,42,33,25,15,17,18,56.0,62.5,48.6,00000
36.0,26.0,47.0,060,06,01,  Sreeballabhpur,40,56,18,31,22,25,41.7,36.7,46.8,00000
36.0,26.0,47.0,114,01,01,  Barabda,371,863,183,414,188,449,30.1,30.7,29.5,00000
36.0,26.0,47.0,114,02,01,  Laturgaon,246,697,92,358,154,339,26.1,20.4,31.2,00000
36.0,26.0,47.0,114,03,01,  Buyertoli,20,214,8,105,12,109,8.5,7.1,9.9,00000
36.0,26.0,47.0,404,01,01,  Hariharpur,65,181,32,83,33,98,26.4,27.8,25.2,00000
36.0,26.0,47.0,404,02,01,  Paschim Parajar,85,209,38,97,47,112,28.9,28.1,29.6,00000
36.0,26.0,47.0,446,01,01,  Bhularjum,247,407,114,185,133,222,37.8,38.1,37.5,00000
36.0,26.0,47.0,446,02,01,  Kumarkada,58,122,30,64,28,58,32.2,31.9,32.6,00000
36.0,26.0,47.0,446,03,01,  Sonatala,67,52,38,20,29,32,56.3,65.5,47.5,00000
36.0,26.0,47.0,446,04,01,  Hurpara,139,221,73,99,66,122,38.6,42.4,35.1,00000
36.0,26.0,47.0,446,05,01,  Jala Basti,16,189,4,90,12,99,7.8,4.3,10.8,00000
36.0,26.0,47.0,494,01,01,  Kaichtala,34,25,16,9,18,16,57.6,64.0,52.9,00000
36.0,26.0,47.0,494,02,01,  Aitan,309,165,170,66,139,99,65.2,72.0,58.4,00000
36.0,26.0,47.0,494,03,01,  Badshargaon,83,116,33,47,50,69,41.7,41.3,42.0,00000
36.0,26.0,47.0,494,04,01,  Saidabad,189,299,81,138,108,161,38.7,37.0,40.1,00000
36.0,26.0,47.0,500,01,01,  Kakaus,332,379,136,164,196,215,46.7,45.3,47.7,00000
36.0,26.0,47.0,500,02,01,  Ekdala,263,431,129,195,134,236,37.9,39.8,36.2,00000
36.0,26.0,47.0,512,01,01,  Himalia,139,602,62,311,77,291,18.8,16.6,20.9,00000
36.0,26.0,47.0,512,02,01,  Chamoltali,78,332,31,161,47,171,19.0,16.1,21.6,00000
36.0,26.0,47.0,536,01,01,  Jalilpur,181,111,79,55,102,56,62.0,59.0,64.6,00000
36.0,26.0,47.0,536,02,01,  Faridpur,95,124,35,58,60,66,43.4,37.6,47.6,00000
36.0,26.0,47.0,536,03,01,  Haripur,73,64,31,31,42,33,53.3,50.0,56.0,00000
36.0,26.0,47.0,536,04,01,  Kamalpur,39,17,19,6,20,11,69.6,76.0,64.5,00000
36.0,26.0,47.0,536,05,01,  Rupampur,140,371,71,169,69,202,27.4,29.6,25.5,00000
36.0,26.0,47.0,536,06,01,  Noabad,72,42,34,18,38,24,63.2,65.4,61.3,00000
36.0,26.0,47.0,584,01,01,  Lalkera,65,273,31,140,34,133,19.2,18.1,20.4,00000
36.0,26.0,47.0,584,02,01,  Parbata Adarsha Gram,60,152,28,72,32,80,28.3,28.0,28.6,00000
36.0,26.0,47.0,643,01,01,  Maynabad,56,90,28,52,28,38,38.4,35.0,42.4,00000
36.0,26.0,47.0,643,02,01,  Abda Chalia,168,277,88,129,80,148,37.8,40.6,35.1,00000
36.0,26.0,47.0,663,01,01,  Muchhikandi,168,306,75,142,93,164,35.4,34.6,36.2,00000
36.0,26.0,47.0,663,02,01,  Gobindapur,139,314,74,146,65,168,30.7,33.6,27.9,00000
36.0,26.0,47.0,729,01,01,  Pakuria,393,703,198,327,195,376,35.9,37.7,34.2,00000
36.0,26.0,47.0,729,02,01,  Sing Para,177,151,86,67,91,84,54.0,56.2,52.0,00000
36.0,26.0,47.0,729,03,01,  Dakshin Pirergaon,449,285,199,129,250,156,61.2,60.7,61.6,00000
36.0,26.0,47.0,729,04,01,  Addargabi(Chararpar),48,41,28,16,20,25,53.9,63.6,44.4,00000
36.0,26.0,47.0,820,01,01,  Rakhi,156,218,75,94,81,124,41.7,44.4,39.5,00000
36.0,26.0,47.0,820,02,01,  Mahdirkona,198,338,85,162,113,176,36.9,34.4,39.1,00000
36.0,26.0,47.0,856,01,01,  Gatabala,433,320,204,141,229,179,57.5,59.1,56.1,00000
36.0,26.0,47.0,856,02,01,  Krishnapur,173,285,91,136,82,149,37.8,40.1,35.5,00000
36.0,26.0,47.0,856,03,01,  Noapara,91,59,42,31,49,28,60.7,57.5,63.6,00000
36.0,26.0,47.0,868,01,01,  Sadashibpur,11,9,4,5,7,4,55.0,44.4,63.6,00000
36.0,26.0,47.0,868,02,01,  Paschim Mirashe,63,89,29,40,34,49,41.4,42.0,41.0,00000
36.0,26.0,47.0,868,03,01,  Bhabanandapur,8,45,4,24,4,21,15.1,14.3,16.0,00000
36.0,26.0,47.0,868,04,01,  Anandapur,70,125,36,60,34,65,35.9,37.5,34.3,00000
36.0,26.0,57.0,065,01,01,  Bara Dhalia,92,74,53,29,39,45,55.4,64.6,46.4,00000
36.0,26.0,57.0,065,02,01,  Karimpur,60,107,35,49,25,58,35.9,41.7,30.1,00000
36.0,26.0,57.0,257,01,01,  Deundi T.E.,1254,1797,786,733,468,1064,41.1,51.7,30.5,00000
36.0,26.0,57.0,257,02,01,  Galani,210,446,124,194,86,252,32.0,39.0,25.4,00000
36.0,26.0,57.0,397,01,01,  Dakshin Deundi Basti,38,246,18,130,20,116,13.4,12.2,14.7,00000
36.0,26.0,57.0,397,02,01,  Kanthalbari,233,306,134,139,99,167,43.2,49.1,37.2,00000
36.0,26.0,57.0,615,01,01,  Joar Magurura,408,504,195,227,213,277,44.7,46.2,43.5,00000
36.0,26.0,57.0,615,02,01,  Nij Magurura,290,220,135,113,155,107,56.9,54.4,59.2,00000
36.0,26.0,57.0,627,01,01,  Muchipur,28,128,12,67,16,61,17.9,15.2,20.8,00000
36.0,26.0,57.0,627,02,01,  Jamsherpur,141,297,72,144,69,153,32.2,33.3,31.1,00000
36.0,26.0,57.0,627,03,01,  Majhisail,157,360,82,159,75,201,30.4,34.0,27.2,00000
36.0,26.0,57.0,639,01,01,  Noabad,89,371,42,174,47,197,19.3,19.4,19.3,00000
36.0,26.0,57.0,639,02,01,  Marulura Chak,151,308,74,133,77,175,32.9,35.7,30.6,00000
36.0,26.0,57.0,762,01,01,  Dakshin Phandrail,384,418,186,193,198,225,47.9,49.1,46.8,00000
36.0,26.0,57.0,762,02,01,  Mugra Para,50,118,19,56,31,62,29.8,25.3,33.3,00000
36.0,26.0,57.0,838,01,01,  Bengi,47,64,28,28,19,36,42.3,50.0,34.5,00000
36.0,26.0,57.0,838,02,01,  Abdullahpur,102,286,44,141,58,145,26.3,23.8,28.6,00000
36.0,26.0,57.0,838,03,01,  Haldiura,178,403,102,199,76,204,30.6,33.9,27.1,00000
36.0,26.0,57.0,958,01,01,  Sutang,198,254,91,117,107,137,43.8,43.8,43.9,00000
36.0,26.0,57.0,958,02,01,  Uttar Sutang (Baze Sutang),107,160,58,68,49,92,40.1,46.0,34.8,00000
36.0,26.0,66.0,301,01,01,  Gabhigaon,455,512,218,239,237,273,47.1,47.7,46.5,00000
36.0,26.0,66.0,301,02,01,  Birampur,75,57,37,24,38,33,56.8,60.7,53.5,00000
36.0,26.0,66.0,301,03,01,  Gaziganj,43,66,25,35,18,31,39.4,41.7,36.7,00000
36.0,26.0,66.0,301,04,01,  Pirergaon,606,559,296,237,310,322,52.0,55.5,49.1,00000
36.0,26.0,66.0,301,05,01,  Abdur Rahimpur,45,136,25,62,20,74,24.9,28.7,21.3,00000
36.0,26.0,66.0,416,01,01,  Harishankarpur,122,67,63,29,59,38,64.6,68.5,60.8,00000
36.0,26.0,66.0,416,02,01,  Shahapur,41,75,20,36,21,39,35.3,35.7,35.0,00000
36.0,26.0,66.0,506,01,01,  Kalikapur,138,259,58,129,80,130,34.8,31.0,38.1,00000
36.0,26.0,66.0,506,02,01,  Kanurabad,9,25,3,13,6,12,26.5,18.8,33.3,00000
36.0,26.0,66.0,536,01,01,  Kamalpur,84,47,44,20,40,27,64.1,68.8,59.7,00000
36.0,26.0,66.0,536,02,01,  Faridpur,36,33,16,18,20,15,52.2,47.1,57.1,00000
36.0,26.0,66.0,536,03,01,  Noabad,52,65,22,31,30,34,44.4,41.5,46.9,00000
36.0,26.0,66.0,693,01,01,  Bhangatila Islampur,64,246,29,123,35,123,20.6,19.1,22.2,00000
36.0,26.0,66.0,693,02,01,  Hakajura,284,374,125,177,159,197,43.2,41.4,44.7,00000
36.0,26.0,66.0,693,03,01,  Manipur,89,276,41,132,48,144,24.4,23.7,25.0,00000
36.0,26.0,66.0,693,04,01,  Kaoatita,8,10,5,5,3,5,44.4,50.0,37.5,00000
36.0,26.0,66.0,693,05,01,  Alapur,30,47,12,25,18,22,39.0,32.4,45.0,00000
36.0,26.0,66.0,711,01,01,  Pachgatia,627,484,327,210,300,274,56.4,60.9,52.3,00000
36.0,26.0,66.0,711,02,01,  Habibulla,13,12,6,4,7,8,52.0,60.0,46.7,00000
36.0,26.0,66.0,753,01,01,  Parkul Basti,462,729,238,326,224,403,38.8,42.2,35.7,00000
36.0,26.0,66.0,753,02,01,  Atikpur,254,399,108,195,146,204,38.9,35.6,41.7,00000
36.0,26.0,66.0,753,03,01,  Telimara,53,49,28,22,25,27,52.0,56.0,48.1,00000
36.0,26.0,66.0,753,04,01,  Harinmara (1),80,49,43,21,37,28,62.0,67.2,56.9,00000
36.0,26.0,66.0,757,01,01,  Parkul T.E.,614,987,361,416,253,571,38.4,46.5,30.7,00000
36.0,26.0,66.0,757,02,01,  Nasimabad T.E.,269,944,159,451,110,493,22.2,26.1,18.2,00000
36.0,26.0,66.0,826,01,01,  Uttar Ranigaon,831,873,407,417,424,456,48.8,49.4,48.2,00000
36.0,26.0,66.0,826,02,01,  Dakshin Ranigoan,1326,1257,605,572,721,685,51.3,51.4,51.3,00000
36.0,26.0,66.0,826,03,01,  Tahirpur,26,37,11,18,15,19,41.3,37.9,44.1,00000
36.0,26.0,66.0,853,01,01,  Aschipur,45,62,19,27,26,35,42.1,41.3,42.6,00000
36.0,26.0,66.0,853,02,01,  Kaiyarag,49,69,18,34,31,35,41.5,34.6,47.0,00000
36.0,26.0,66.0,853,03,01,  Bagula,84,78,34,34,50,44,51.9,50.0,53.2,00000
36.0,26.0,66.0,853,04,01,  Hajipur,141,178,68,80,73,98,44.2,45.9,42.7,00000
36.0,26.0,66.0,853,05,01,  Baraiura,135,126,64,62,71,64,51.7,50.8,52.6,00000
36.0,26.0,66.0,853,06,01,  Mirasi,805,699,388,324,417,375,53.5,54.5,52.7,00000
36.0,26.0,66.0,853,07,01,  Bisraband,107,355,45,166,62,189,23.2,21.3,24.7,00000
36.0,26.0,66.0,853,08,01,  Lakhairgaon,114,100,56,56,58,44,53.3,50.0,56.9,00000
36.0,26.0,66.0,853,09,01,  Tarasul,174,132,75,59,99,73,56.9,56.0,57.6,00000
36.0,26.0,66.0,940,01,01,  Kalanga Reserved,442,1427,245,683,197,744,23.6,26.4,20.9,00000
36.0,26.0,66.0,940,02,01,  Goramchhari,99,319,43,164,56,155,23.7,20.8,26.5,00000
36.0,26.0,66.0,940,03,01,  Harinmara (2),65,210,34,102,31,108,23.6,25.0,22.3,00000
36.0,26.0,76.0,168,01,01,  Chalitarabada,211,264,112,130,99,134,44.4,46.3,42.5,00000
36.0,26.0,76.0,168,02,01,  Dobaria,334,328,166,151,168,177,50.5,52.4,48.7,00000
36.0,26.0,76.0,168,03,01,  Alapur,124,188,56,86,68,102,39.7,39.4,40.0,00000
36.0,26.0,76.0,422,01,01,  Harunpur,37,106,16,50,21,56,25.9,24.2,27.3,00000
36.0,26.0,76.0,422,02,01,  Sultanpur,87,181,43,86,44,95,32.5,33.3,31.7,00000
36.0,26.0,76.0,422,03,01,  Jangal,35,51,17,25,18,26,40.7,40.5,40.9,00000
36.0,26.0,76.0,458,01,01,  Jahapur,31,78,16,38,15,40,28.4,29.6,27.3,00000
36.0,26.0,76.0,458,02,01,  Patra Sharif,310,193,164,95,146,98,61.6,63.3,59.8,00000
36.0,26.0,76.0,572,01,01,  Deutali,324,502,152,234,172,268,39.2,39.4,39.1,00000
36.0,26.0,76.0,572,02,01,  Noagaon,201,231,106,111,95,120,46.5,48.8,44.2,00000
36.0,26.0,76.0,572,03,01,  Ramapur,113,312,52,144,61,168,26.6,26.5,26.6,00000
36.0,26.0,76.0,572,04,01,  Lalchand Joar,624,1178,308,562,316,616,34.6,35.4,33.9,00000
36.0,26.0,76.0,572,05,01,  Turatipi,45,89,23,39,22,50,33.6,37.1,30.6,00000
36.0,26.0,76.0,723,01,01,  Paikura,389,829,200,400,189,429,31.9,33.3,30.6,00000
36.0,26.0,76.0,723,02,01,  Baje Shatung,42,233,27,107,15,126,15.3,20.1,10.6,00000
36.0,26.0,76.0,723,03,01,  Shakir Mamud Bazar,51,27,27,14,24,13,65.4,65.9,64.9,00000
36.0,26.0,76.0,723,04,01,  Iktarpur,43,145,25,67,18,78,22.9,27.2,18.8,00000
36.0,26.0,76.0,747,01,01,  Panchhari (Kalinagar),349,848,177,410,172,438,29.2,30.2,28.2,00000
36.0,26.0,76.0,747,02,01,  Ashrayan Prokalpa,107,517,47,249,60,268,17.1,15.9,18.3,00000
36.0,26.0,76.0,789,01,01,  Raghunandan R.F.,579,292,320,87,259,205,66.5,78.6,55.8,00000
36.0,26.0,76.0,789,02,01,  Saltila,256,142,169,51,87,91,64.3,76.8,48.9,00000
36.0,26.0,76.0,940,01,01,  Charghat,44,177,22,82,22,95,19.9,21.2,18.8,00000
36.0,26.0,76.0,940,02,01,  Mirzapur,18,30,8,15,10,15,37.5,34.8,40.0,00000
36.0,26.0,76.0,940,03,01,  Sadekpur,484,861,242,407,242,454,36.0,37.3,34.8,00000
36.0,26.0,76.0,940,04,01,  Majlishpur,110,101,54,41,56,60,52.1,56.8,48.3,00000
36.0,26.0,85.0,072,01,01,  Athalia,333,100,147,67,186,33,76.9,68.7,84.9,00000
36.0,26.0,85.0,072,02,01,  Sahapur,117,222,51,99,66,123,34.5,34.0,34.9,00000
36.0,26.0,85.0,144,01,01,  Bashudebpur,148,219,80,95,68,124,40.3,45.7,35.4,00000
36.0,26.0,85.0,144,02,01,  Sirajnagar,113,107,50,47,63,60,51.4,51.5,51.2,00000
36.0,26.0,85.0,144,03,01,  Chilami,82,111,31,40,51,71,42.5,43.7,41.8,00000
36.0,26.0,85.0,144,04,01,  Chandertisa,51,17,26,6,25,11,75.0,81.3,69.4,00000
36.0,26.0,85.0,144,05,01,  Kaichhanachari,174,105,92,44,82,61,62.4,67.6,57.3,00000
36.0,26.0,85.0,144,06,01,  Shekpara,144,140,79,67,65,73,50.7,54.1,47.1,00000
36.0,26.0,85.0,150,01,01,  Ayrabadura,159,208,81,91,78,117,43.3,47.1,40.0,00000
36.0,26.0,85.0,150,02,01,  Hanagori,221,50,99,18,122,32,81.5,84.6,79.2,00000
36.0,26.0,85.0,217,01,01,  Dargaon,300,269,131,126,169,143,52.7,51.0,54.2,00000
36.0,26.0,85.0,217,02,01,  Manduragaon,191,107,95,52,96,55,64.1,64.6,63.6,00000
36.0,26.0,85.0,223,02,01,  Daragaon T.E.,831,933,532,363,299,570,47.1,59.4,34.4,00000
36.0,26.0,85.0,223,04,01,  Rambasti,64,90,54,31,10,59,41.6,63.5,14.5,00000
36.0,26.0,85.0,223,05,01,  Purantila,75,229,57,88,18,141,24.7,39.3,11.3,00000
36.0,26.0,85.0,223,06,01,  Hatimara,27,329,14,159,13,170,7.6,8.1,7.1,00000
36.0,26.0,85.0,223,07,01,  Bairagi Punge,68,22,42,13,26,9,75.6,76.4,74.3,00000
36.0,26.0,85.0,223,08,01,  Suta Para,125,308,78,135,47,173,28.9,36.6,21.4,00000
36.0,26.0,85.0,223,09,01,  Budnirkuse,4,17,3,6,1,11,19.0,33.3,8.3,00000
36.0,26.0,85.0,385,01,01,  Haji Kamalpur,19,1,8,0,11,1,95.0,100.0,91.7,00000
36.0,26.0,85.0,385,02,01,  Kazirkhil (Chichirkot),253,195,127,90,126,105,56.5,58.5,54.5,00000
36.0,26.0,85.0,560,01,01,  Kunaura,157,222,81,114,76,108,41.4,41.5,41.3,00000
36.0,26.0,85.0,560,02,01,  Talagaon,84,285,43,142,41,143,22.8,23.2,22.3,00000
36.0,26.0,85.0,862,01,01,  Ballabhpur,80,39,45,19,35,20,67.2,70.3,63.6,00000
36.0,26.0,85.0,862,02,01,  Mahamadpur,26,149,13,68,13,81,14.9,16.0,13.8,00000
36.0,26.0,85.0,862,03,01,  Shatiajuri,187,579,109,255,78,324,24.4,29.9,19.4,00000
36.0,26.0,85.0,862,04,01,  Kalapur,254,398,142,170,112,228,39.0,45.5,32.9,00000
36.0,26.0,85.0,862,05,01,  Katiballab Pur,55,116,27,62,28,54,32.2,30.3,34.1,00000
36.0,26.0,85.0,928,01,01,  Sreebari T.E.,475,1115,305,502,170,613,29.9,37.8,21.7,00000
36.0,26.0,85.0,928,02,01,  Kaknimara,52,212,34,102,18,110,19.7,25.0,14.1,00000
36.0,26.0,85.0,952,01,01,  Sundarpur,373,488,168,236,205,252,43.3,41.6,44.9,00000
36.0,26.0,85.0,952,02,01,  Bade Sundarpur,74,50,37,25,37,25,59.7,59.7,59.7,00000
36.0,26.0,95.0,530,01,01,  Karimpur,49,19,25,8,24,11,72.1,75.8,68.6,00000
36.0,26.0,95.0,530,02,01,  Joar Jikua,104,165,42,83,62,82,38.7,33.6,43.1,00000
36.0,26.0,95.0,783,01,01,  Raghurampur,129,251,67,108,62,143,33.9,38.3,30.2,00000
36.0,26.0,95.0,783,02,01,  Noagaon (Part),261,214,155,100,106,114,54.9,60.8,48.2,00000
36.0,26.0,95.0,844,01,01,  Gopalpur,208,429,115,193,93,236,32.7,37.3,28.3,00000
36.0,26.0,95.0,844,02,01,  Hatuakandi,126,192,50,99,76,93,39.6,33.6,45.0,00000
36.0,26.0,95.0,844,03,01,  Hamidpur,120,98,57,46,63,52,55.0,55.3,54.8,00000
36.0,26.0,95.0,844,04,01,  Razzakpur,135,163,63,76,72,87,45.3,45.3,45.3,00000
36.0,26.0,95.0,844,05,01,  Durgapur,45,71,20,35,25,36,38.8,36.4,41.0,00000
36.0,26.0,95.0,904,01,01,  Sakimahmud(Sakir Mahmud),1,11,0,6,1,5,8.3,0.0,16.7,00000
36.0,26.0,95.0,904,02,01,  Jamalpur,87,64,42,28,45,36,57.6,60.0,55.6,00000
36.0,26.0,95.0,904,03,01,  Hurarkul,299,442,155,193,144,249,40.4,44.5,36.6,00000
36.0,26.0,95.0,904,04,01,  Alipur,69,29,33,13,36,16,70.4,71.7,69.2,00000
36.0,26.0,95.0,910,01,01,  Serikandi,293,467,147,227,146,240,38.6,39.3,37.8,00000
36.0,26.0,95.0,910,02,01,  Noagoan (Part),121,181,64,81,57,100,40.1,44.1,36.3,00000
36.0,26.0,95.0,976,01,01,  Uabhata,840,702,456,341,384,361,54.5,57.2,51.5,00000
36.0,26.0,95.0,976,02,01,  Kutirgaon,66,52,37,28,29,24,55.9,56.9,54.7,00000
36.0,26.0,95.0,976,03,01,  Shimultala,301,469,157,242,144,227,39.1,39.3,38.8,00000
36.0,44.0,22.0,092,01,03,  Anandapur,650,725,311,340,339,385,47.3,47.8,46.8,00000
36.0,44.0,22.0,092,02,03,  Bara Baula,3748,3171,1991,1476,1757,1695,54.2,57.4,50.9,00000
36.0,44.0,22.0,128,01,01,  Narayanpur,211,399,101,185,110,214,34.6,35.3,34.0,00000
36.0,44.0,22.0,128,02,01,  Dhigalbagh,699,936,358,414,341,522,42.8,46.4,39.5,00000
36.0,44.0,22.0,128,03,01,  Sreepur,20,105,7,53,13,52,16.0,11.7,20.0,00000
36.0,44.0,22.0,128,04,01,  Alipur,481,346,222,143,259,203,58.2,60.8,56.1,00000
36.0,44.0,22.0,205,01,01,  Bhadai Purba,525,1158,255,545,270,613,31.2,31.9,30.6,00000
36.0,44.0,22.0,205,02,01,  Bhadai Paschim,1474,1309,787,599,687,710,53.0,56.8,49.2,00000
36.0,44.0,22.0,503,01,01,  Jatra Barabari,227,276,112,120,115,156,45.1,48.3,42.4,00000
36.0,44.0,22.0,503,02,01,  Barabari,191,378,93,166,98,212,33.6,35.9,31.6,00000
36.0,44.0,22.0,715,01,01,  Duliakhal,1533,1079,1096,811,437,268,58.7,57.5,62.0,00000
36.0,44.0,22.0,715,02,01,  Tatuya,970,557,428,249,542,308,63.5,63.2,63.8,00000
36.0,44.0,22.0,715,03,01,  Rangergaon,603,576,332,289,271,287,51.1,53.5,48.6,00000
36.0,44.0,22.0,715,04,01,  Gopaya,1120,690,689,312,431,378,61.9,68.8,53.3,00000
36.0,44.0,22.0,715,05,01,  Bariuri,46,171,21,92,25,79,21.2,18.6,24.0,00000
36.0,44.0,24.0,012,01,01,  Abdabakai,112,84,68,38,44,46,57.1,64.2,48.9,00000
36.0,44.0,24.0,012,02,01,  Hatirthan,148,305,75,142,73,163,32.7,34.6,30.9,00000
36.0,44.0,24.0,012,03,01,  Abdakhizir,284,230,146,108,138,122,55.3,57.5,53.1,00000
36.0,44.0,24.0,012,04,01,  Raghudayal,66,67,29,33,37,34,49.6,46.8,52.1,00000
36.0,44.0,24.0,049,01,01,  Adyapasa,320,288,172,135,148,153,52.6,56.0,49.2,00000
36.0,44.0,24.0,049,02,01,  Shyampur,142,266,66,119,76,147,34.8,35.7,34.1,00000
36.0,44.0,24.0,068,01,01,  Alampur,24,167,11,76,13,91,12.6,12.6,12.5,00000
36.0,44.0,24.0,068,02,01,  Ramnagar,72,231,31,112,41,119,23.8,21.7,25.6,00000
36.0,44.0,24.0,068,03,01,  Mohanabad,42,65,23,37,19,28,39.3,38.3,40.4,00000
36.0,44.0,24.0,149,01,01,  Balihata,349,361,175,177,174,184,49.2,49.7,48.6,00000
36.0,44.0,24.0,149,02,01,  Narayanpur,504,553,236,253,268,300,47.7,48.3,47.2,00000
36.0,44.0,24.0,149,03,01,  Char Hamua,273,216,127,100,146,116,55.8,55.9,55.7,00000
36.0,44.0,24.0,161,01,01,  Dakshin Band,208,238,95,109,113,129,46.6,46.6,46.7,00000
36.0,44.0,24.0,161,02,01,  Noabad,359,381,192,178,167,203,48.5,51.9,45.1,00000
36.0,44.0,24.0,161,03,01,  Etmanjani,51,66,22,30,29,36,43.6,42.3,44.6,00000
36.0,44.0,24.0,440,01,01,  Hamuar Char,521,520,278,222,243,298,50.0,55.6,44.9,00000
36.0,44.0,24.0,440,02,01,  Bangaon,430,349,189,173,241,176,55.2,52.2,57.8,00000
36.0,44.0,24.0,440,03,01,  Atikpur,15,11,10,2,5,9,57.7,83.3,35.7,00000
36.0,44.0,24.0,565,01,01,  Laskarpur,703,1023,397,467,306,556,40.7,45.9,35.5,00000
36.0,44.0,24.0,565,02,01,  Ganganagar,384,242,190,117,194,125,61.3,61.9,60.8,00000
36.0,44.0,24.0,634,01,01,  Masajan,434,117,210,44,224,73,78.8,82.7,75.4,00000
36.0,44.0,24.0,634,02,01,  Gayespur,144,75,75,30,69,45,65.8,71.4,60.5,00000
36.0,44.0,24.0,758,01,01,  Shughar,209,260,93,130,116,130,44.6,41.7,47.2,00000
36.0,44.0,24.0,758,02,01,  Jadabpur,342,149,184,63,158,86,69.7,74.5,64.8,00000
36.0,44.0,24.0,758,03,01,  Krishnarampur,28,26,18,13,10,13,51.9,58.1,43.5,00000
36.0,44.0,24.0,758,04,01,  Sughar,222,212,129,149,93,63,51.2,46.4,59.6,00000
36.0,44.0,24.0,945,01,01,  Sultanshi,1031,1702,530,814,501,888,37.7,39.4,36.1,00000
36.0,44.0,24.0,945,02,01,  Sarifpur,286,313,153,134,133,179,47.7,53.3,42.6,00000
36.0,44.0,24.0,945,03,01,  Hamidpur,399,740,202,359,197,381,35.0,36.0,34.1,00000
36.0,44.0,28.0,105,01,01,  Ashara,850,780,398,365,452,415,52.1,52.2,52.1,00000
36.0,44.0,28.0,105,02,01,  Badalpur,68,59,42,24,26,35,53.5,63.6,42.6,00000
36.0,44.0,28.0,317,01,01,  Joynagar,239,823,136,399,103,424,22.5,25.4,19.5,00000
36.0,44.0,28.0,317,02,01,  Haripur,40,209,21,109,19,100,16.1,16.2,16.0,00000
36.0,44.0,28.0,340,01,01,  Gopalpur,93,514,54,240,39,274,15.3,18.4,12.5,00000
36.0,44.0,28.0,340,02,01,  Jadabpur,137,755,76,370,61,385,15.4,17.0,13.7,00000
36.0,44.0,28.0,360,01,01,  Nazirpur,101,133,48,62,53,71,43.2,43.6,42.7,00000
36.0,44.0,28.0,360,02,01,  Paschim Dal,362,995,194,475,168,520,26.7,29.0,24.4,00000
36.0,44.0,28.0,375,01,01,  Uttar Bamkandi,372,1128,205,549,167,579,24.8,27.2,22.4,00000
36.0,44.0,28.0,375,02,01,  Dakshin Bamkandi,291,1258,139,624,152,634,18.8,18.2,19.3,00000
36.0,44.0,28.0,375,03,01,  Gobindapur,14,64,9,37,5,27,17.9,19.6,15.6,00000
36.0,44.0,28.0,718,01,01,  Chandpur,323,728,160,366,163,362,30.7,30.4,31.0,00000
36.0,44.0,28.0,718,02,01,  Gazariakandi,95,228,41,118,54,110,29.4,25.8,32.9,00000
36.0,44.0,28.0,718,03,01,  Dhanar Abda,23,308,14,167,9,141,6.9,7.7,6.0,00000
36.0,44.0,28.0,982,01,01,  Najirpur,79,177,44,82,35,95,30.9,34.9,26.9,00000
36.0,44.0,28.0,982,02,01,  Kashipur,140,729,68,356,72,373,16.1,16.0,16.2,00000
36.0,44.0,28.0,994,01,01,  Maturnagar,114,308,61,162,53,146,27.0,27.4,26.6,00000
36.0,44.0,28.0,994,02,01,  Daulatpur,104,401,58,193,46,208,20.6,23.1,18.1,00000
36.0,44.0,38.0,118,01,01,  Purba Paikpara (Uttar Paikpara,308,197,162,96,146,101,61.0,62.8,59.1,00000
36.0,44.0,38.0,118,02,01,  Paschim Paikpara,489,267,232,119,257,148,64.7,66.1,63.5,00000
36.0,44.0,38.0,118,03,01,  Sowargaon (Miturchar),145,75,78,35,67,40,65.9,69.0,62.6,00000
36.0,44.0,38.0,118,04,01,  Miturchak,47,127,29,67,18,60,27.0,30.2,23.1,00000
36.0,44.0,38.0,143,01,01,  Balbar Chak,176,112,95,48,81,64,61.1,66.4,55.9,00000
36.0,44.0,38.0,143,03,01,  Chakra Monath,261,117,131,50,130,67,69.0,72.4,66.0,00000
36.0,44.0,38.0,143,04,01,  Sukri Para,523,229,249,94,274,135,69.5,72.6,67.0,00000
36.0,44.0,38.0,143,05,01,  Khalpar,102,43,58,15,44,28,70.3,79.5,61.1,00000
36.0,44.0,38.0,143,06,01,  Sharifpur,126,37,69,16,57,21,77.3,81.2,73.1,00000
36.0,44.0,38.0,174,01,01,  Bara Char,307,110,162,47,145,63,73.6,77.5,69.7,00000
36.0,44.0,38.0,174,02,01,  Daulatpur,111,80,51,32,60,48,58.1,61.4,55.6,00000
36.0,44.0,38.0,174,03,01,  Durlabpur,39,23,19,12,20,11,62.9,61.3,64.5,00000
36.0,44.0,38.0,192,01,01,  Batasar,629,387,304,163,325,224,61.9,65.1,59.2,00000
36.0,44.0,38.0,192,02,01,  Jagatpur,407,116,194,39,213,77,77.8,83.3,73.4,00000
36.0,44.0,38.0,286,01,01,  Dakshin Chatul,262,172,132,71,130,101,60.4,65.0,56.3,00000
36.0,44.0,38.0,286,02,01,  Uttar Chatul,264,224,125,97,139,127,54.1,56.3,52.3,00000
36.0,44.0,38.0,286,03,01,  Mahmudpur,419,217,217,85,202,132,65.9,71.9,60.5,00000
36.0,44.0,38.0,286,04,01,  Duliakhal,764,499,394,209,370,290,60.5,65.3,56.1,00000
36.0,44.0,38.0,385,01,01,  Etbarpur,175,195,98,90,77,105,47.3,52.1,42.3,00000
36.0,44.0,38.0,385,02,01,  D.Mirzapur,100,29,51,11,49,18,77.5,82.3,73.1,00000
36.0,44.0,38.0,491,01,01,  Gouranar Chak,279,254,149,99,130,155,52.3,60.1,45.6,00000
36.0,44.0,38.0,491,02,01,  Mitapur,78,167,47,83,31,84,31.8,36.2,27.0,00000
36.0,44.0,38.0,491,03,01,  Barai Para,112,47,62,18,50,29,70.4,77.5,63.3,00000
36.0,44.0,38.0,690,01,01,  Nizampur,485,413,239,200,246,213,54.0,54.4,53.6,00000
36.0,44.0,38.0,690,02,01,  Khalkar Char,28,113,17,58,11,55,19.9,22.7,16.7,00000
36.0,44.0,38.0,963,01,01,  Saidpur,806,496,398,220,408,276,61.9,64.4,59.6,00000
36.0,44.0,38.0,963,02,01,  Nitair Chak,233,466,110,228,123,238,33.3,32.5,34.1,00000
36.0,44.0,38.0,963,03,01,  Purba Katakhali,293,214,151,102,142,112,57.8,59.7,55.9,00000
36.0,44.0,38.0,963,04,01,  Chhota Joyrampur,47,229,20,97,27,132,17.0,17.1,17.0,00000
36.0,44.0,38.0,963,05,01,  Shujatpur,67,228,34,104,33,124,22.7,24.6,21.0,00000
36.0,44.0,38.0,963,06,01,  Bhabanipur,113,175,64,86,49,89,39.2,42.7,35.5,00000
36.0,44.0,47.0,242,01,01,  Brahmandora,672,773,314,379,358,394,46.5,45.3,47.6,00000
36.0,44.0,47.0,242,02,01,  Jangal,49,189,33,96,16,93,20.6,25.6,14.7,00000
36.0,44.0,47.0,242,03,01,  Chhota Brahmandora,49,49,27,24,22,25,50.0,52.9,46.8,00000
36.0,44.0,47.0,288,01,01,  Noagaon (Basdirganj Bazar),270,334,136,141,134,193,44.7,49.1,41.0,00000
36.0,44.0,47.0,288,02,01,  Chandpur,644,597,344,264,300,333,51.9,56.6,47.4,00000
36.0,44.0,47.0,288,03,01,  Algapur,161,324,79,152,82,172,33.2,34.2,32.3,00000
36.0,44.0,47.0,288,04,01,  Nurpur,1217,822,585,383,632,439,59.7,60.4,59.0,00000
36.0,44.0,47.0,559,01,01,  Chandipur,127,172,63,94,64,78,42.5,40.1,45.1,00000
36.0,44.0,47.0,559,02,01,  Barlaria,113,290,54,137,59,153,28.0,28.3,27.8,00000
36.0,44.0,47.0,559,03,01,  Sreerampur,290,536,158,244,132,292,35.1,39.3,31.1,00000
36.0,44.0,47.0,559,04,01,  Madanpur,224,224,106,111,118,113,50.0,48.8,51.1,00000
36.0,44.0,47.0,640,01,01,  Merashani,45,85,19,41,26,44,34.6,31.7,37.1,00000
36.0,44.0,47.0,640,02,01,  Bakharpur,253,535,122,246,131,289,32.1,33.2,31.2,00000
36.0,44.0,47.0,858,01,01,  Sherpur Chak,72,205,33,102,39,103,26.0,24.4,27.5,00000
36.0,44.0,47.0,858,02,01,  Bakrabad,2,8,2,3,0,5,20.0,40.0,0.0,00000
36.0,44.0,47.0,951,01,01,  Surabahi,614,430,300,189,314,241,58.8,61.3,56.6,00000
36.0,44.0,47.0,951,02,01,  Char Mamudpur,148,104,83,44,65,60,58.7,65.4,52.0,00000
36.0,44.0,57.0,180,01,01,  Barapait,336,558,165,259,171,299,37.6,38.9,36.4,00000
36.0,44.0,57.0,180,02,01,  Najirpur,342,650,169,332,173,318,34.5,33.7,35.2,00000
36.0,44.0,57.0,323,01,01,  Sharifpur,40,191,20,88,20,103,17.3,18.5,16.3,00000
36.0,44.0,57.0,323,02,01,  Hatirthan,72,149,36,65,36,84,32.6,35.6,30.0,00000
36.0,44.0,57.0,323,03,01,  Daria,25,67,13,29,12,38,27.2,31.0,24.0,00000
36.0,44.0,57.0,323,04,01,  Chandpur,441,449,198,195,243,254,49.6,50.4,48.9,00000
36.0,44.0,66.0,037,01,01,  Joyrampur,226,487,122,220,104,267,31.7,35.7,28.0,00000
36.0,44.0,66.0,037,02,01,  Patli,112,427,52,219,60,208,20.8,19.2,22.4,00000
36.0,44.0,66.0,037,03,01,  Ratanpur,112,259,48,107,64,152,30.2,31.0,29.6,00000
36.0,44.0,66.0,166,01,01,  Bhadkuri,206,230,108,91,98,139,47.2,54.3,41.4,00000
36.0,44.0,66.0,166,02,01,  Bangurihati,92,251,44,115,48,136,26.8,27.7,26.1,00000
36.0,44.0,66.0,166,03,01,  Nayagaon,52,62,27,29,25,33,45.6,48.2,43.1,00000
36.0,44.0,66.0,166,04,01,  Nayabad,14,19,3,12,11,7,42.4,20.0,61.1,00000
36.0,44.0,66.0,279,01,01,  Charinao,897,1244,436,593,461,651,41.9,42.4,41.5,00000
36.0,44.0,66.0,279,02,01,  Badupasha,89,123,45,60,44,63,42.0,42.9,41.1,00000
36.0,44.0,66.0,429,01,01,  Ghorabai,209,216,92,97,117,119,49.2,48.7,49.6,00000
36.0,44.0,66.0,429,02,01,  Bagachhara,60,110,27,54,33,56,35.3,33.3,37.1,00000
36.0,44.0,66.0,429,03,01,  Hasnabad,52,79,34,36,18,43,39.7,48.6,29.5,00000
36.0,44.0,66.0,429,04,01,  Jalalabad,169,105,96,43,73,62,61.7,69.1,54.1,00000
36.0,44.0,66.0,429,05,01,  Raban Dubi,18,67,6,36,12,31,21.2,14.3,27.9,00000
36.0,44.0,66.0,429,06,01,  Aminpur,103,97,45,44,58,53,51.5,50.6,52.3,00000
36.0,44.0,66.0,429,07,01,  Azimabad,37,102,21,55,16,47,26.6,27.6,25.4,00000
36.0,44.0,66.0,764,01,01,  Chandapur,379,357,188,148,191,209,51.5,56.0,47.8,00000
36.0,44.0,66.0,764,02,01,  Raziura,528,848,246,386,282,462,38.4,38.9,37.9,00000
36.0,44.0,66.0,764,03,01,  Abdur Rahimpur,131,146,73,58,58,88,47.3,55.7,39.7,00000
36.0,44.0,66.0,764,04,01,  Gadanagar,573,436,288,213,285,223,56.8,57.5,56.1,00000
36.0,44.0,66.0,764,05,01,  Balikandi,95,90,42,39,53,51,51.4,51.9,51.0,00000
36.0,44.0,66.0,764,06,01,  Maturapur,54,68,23,36,31,32,44.3,39.0,49.2,00000
36.0,44.0,66.0,764,07,01,  Gucchhagram,15,25,8,9,7,16,37.5,47.1,30.4,00000
36.0,44.0,66.0,820,01,01,  Sanabai,215,519,111,257,104,262,29.3,30.2,28.4,00000
36.0,44.0,66.0,820,02,01,  Bekitaka,25,78,13,37,12,41,24.3,26.0,22.6,00000
36.0,44.0,66.0,820,03,01,  Akatpur,12,54,4,29,8,25,18.2,12.1,24.2,00000
36.0,44.0,66.0,870,01,01,  Shantisa,289,289,150,136,139,153,50.0,52.4,47.6,00000
36.0,44.0,66.0,870,02,01,  Daulatpur,153,99,61,35,92,64,60.7,63.5,59.0,00000
36.0,44.0,66.0,901,01,01,  Krishnapur,0,3,0,2,0,1,0.0,0.0,0.0,00000
36.0,44.0,66.0,901,02,01,  Charipur,219,305,119,162,100,143,41.8,42.3,41.2,00000
36.0,44.0,76.0,092,01,03,  Durlabpur,379,392,194,197,185,195,49.2,49.6,48.7,00000
36.0,44.0,76.0,092,02,03,  Sultan Mamudpur,1130,1196,593,549,537,647,48.6,51.9,45.4,00000
36.0,44.0,76.0,128,01,01,  Nayabad,73,255,29,99,44,156,22.3,22.7,22.0,00000
36.0,44.0,76.0,128,02,01,  Gopalpur,21,98,9,48,12,50,17.6,15.8,19.4,00000
36.0,44.0,76.0,128,03,01,  Bagulakhal,95,625,44,304,51,321,13.2,12.6,13.7,00000
36.0,44.0,76.0,939,01,01,  Jalalabad,670,1507,321,748,349,759,30.8,30.0,31.5,00000
36.0,44.0,76.0,939,02,01,  Noagaon,456,1511,233,728,223,783,23.2,24.2,22.2,00000
36.0,44.0,76.0,939,03,01,  Narayanpur,327,261,197,109,130,152,55.6,64.4,46.1,00000
36.0,44.0,76.0,988,01,01,  Kashipur,166,190,81,93,85,97,46.6,46.6,46.7,00000
36.0,44.0,76.0,988,02,01,  Nasharatpur,263,422,135,210,128,212,38.4,39.1,37.6,00000
36.0,44.0,76.0,988,03,01,  Titakhai,373,381,210,183,163,198,49.5,53.4,45.2,00000
36.0,44.0,76.0,988,04,01,  Jasher Abda,57,82,29,37,28,45,41.0,43.9,38.4,00000
36.0,44.0,85.0,174,01,01,  Paschim Barachar,264,154,137,65,127,89,63.2,67.8,58.8,00000
36.0,44.0,85.0,174,02,01,  Kadamtali,675,434,360,204,315,230,60.9,63.8,57.8,00000
36.0,44.0,85.0,174,03,01,  Morra,309,628,165,316,144,312,33.0,34.3,31.6,00000
36.0,44.0,85.0,404,01,01,  Faridpur,207,227,98,110,109,117,47.7,47.1,48.2,00000
36.0,44.0,85.0,404,02,01,  Kashipur,55,32,30,16,25,16,63.2,65.2,61.0,00000
36.0,44.0,85.0,432,01,01,  Hamua,434,155,238,62,196,93,73.7,79.3,67.8,00000
36.0,44.0,85.0,432,02,01,  Charhamur,294,239,156,111,138,128,55.2,58.4,51.9,00000
36.0,44.0,85.0,432,03,01,  Klimnagar,162,112,78,56,84,56,59.1,58.2,60.0,00000
36.0,44.0,95.0,091,01,01,  Uttar Tegharia,204,347,108,163,96,184,37.0,39.9,34.3,00000
36.0,44.0,95.0,091,02,01,  Dakshin Tegharia,377,887,196,421,181,466,29.8,31.8,28.0,00000
36.0,44.0,95.0,211,01,01,  Ramnagar,32,499,23,260,9,239,6.0,8.1,3.6,00000
36.0,44.0,95.0,211,02,01,  Bhagmatpur,70,115,36,56,34,59,37.8,39.1,36.6,00000
36.0,44.0,95.0,534,01,01,  Shial Daria,321,629,148,338,173,291,33.8,30.5,37.3,00000
36.0,44.0,95.0,534,02,01,  Panch Daria,367,579,177,298,190,281,38.8,37.3,40.3,00000
36.0,44.0,95.0,603,01,01,  Dakshin Mahmodabad,47,179,28,84,19,95,20.8,25.0,16.7,00000
36.0,44.0,95.0,603,02,01,  Kakiarabda,125,252,59,127,66,125,33.2,31.7,34.6,00000
36.0,44.0,95.0,603,03,01,  Purba Ananta Pur,19,191,7,90,12,101,9.0,7.2,10.6,00000
36.0,44.0,95.0,754,01,01,  Sydabad,210,332,96,146,114,186,38.7,39.7,38.0,00000
36.0,44.0,95.0,754,02,01,  Simer Gaon,54,219,22,105,32,114,19.8,17.3,21.9,00000
36.0,44.0,95.0,985,01,01,  Majlishpur,480,393,232,201,248,192,55.0,53.6,56.4,00000
36.0,44.0,95.0,985,02,01,  Aora,113,521,67,266,46,255,17.8,20.1,15.3,00000
36.0,68.0,27.0,127,01,01,  Bhabanipur,604,172,301,76,303,96,77.8,79.8,75.9,00000
36.0,68.0,27.0,127,02,01,  Purnibari,117,110,63,39,54,71,51.5,61.8,43.2,00000
36.0,68.0,27.0,127,03,01,  Begunai,464,702,223,322,241,380,39.8,40.9,38.8,00000
36.0,68.0,27.0,127,04,01,  Katia,324,422,176,202,148,220,43.4,46.6,40.2,00000
36.0,68.0,27.0,241,01,01,  Faridpur,207,598,104,300,103,298,25.7,25.7,25.7,00000
36.0,68.0,27.0,241,02,01,  Bali,126,218,68,108,58,110,36.6,38.6,34.5,00000
36.0,68.0,27.0,270,01,01,  Ramdebpur,112,317,58,147,54,170,26.1,28.3,24.1,00000
36.0,68.0,27.0,270,02,01,  Ganganagar,315,426,165,202,150,224,42.5,45.0,40.1,00000
36.0,68.0,54.0,440,01,01,  Radhanagar,107,544,49,249,58,295,16.4,16.4,16.4,00000
36.0,68.0,54.0,440,02,01,  Shantoshpur,137,1039,82,490,55,549,11.6,14.3,9.1,00000
36.0,68.0,54.0,824,01,01,  Ruhitansih,1143,2792,525,1264,618,1528,29.0,29.3,28.8,00000
36.0,68.0,54.0,824,02,01,  Chikanpur,43,172,13,70,30,102,20.0,15.7,22.7,00000
36.0,68.0,54.0,824,03,01,  Maram Pur,110,187,51,81,59,106,37.0,38.6,35.8,00000
36.0,68.0,54.0,824,04,01,  Sujanpur,13,402,10,204,3,198,3.1,4.7,1.5,00000
36.0,68.0,67.0,682,01,01,  Murakari,3422,5381,1712,2571,1710,2810,38.9,40.0,37.8,00000
36.0,68.0,67.0,682,02,01,  Subidpur,286,544,139,259,147,285,34.5,34.9,34.0,00000
36.0,68.0,67.0,682,03,01,  Lakshmipur,466,1118,212,517,254,601,29.4,29.1,29.7,00000
36.0,68.0,81.0,994,01,01,  Maubari,453,236,199,107,254,129,65.7,65.0,66.3,00000
36.0,68.0,81.0,994,02,01,  Tegharia,1671,3465,800,1493,871,1972,32.5,34.9,30.6,00000
36.0,71.0,16.0,245,01,01,  Sultanpur,568,605,280,273,288,332,48.4,50.6,46.5,00000
36.0,71.0,16.0,245,02,01,  Maharpur,133,281,60,138,73,143,32.1,30.3,33.8,00000
36.0,71.0,16.0,368,01,01,  Hosanpur,107,147,53,66,54,81,42.1,44.5,40.0,00000
36.0,71.0,16.0,368,02,01,  Mitapukur,732,1187,332,561,400,626,38.1,37.2,39.0,00000
36.0,71.0,16.0,379,01,01,  Goalnagar,104,861,47,400,57,461,10.8,10.5,11.0,00000
36.0,71.0,16.0,379,02,01,  Akta Para,140,492,74,258,66,234,22.2,22.3,22.0,00000
36.0,71.0,17.0,098,01,01,  Bakharnagar,439,362,214,174,225,188,54.8,55.2,54.5,00000
36.0,71.0,17.0,098,02,01,  Daspara,33,177,17,87,16,90,15.7,16.3,15.1,00000
36.0,71.0,17.0,098,03,01,  Radhapur,67,131,39,64,28,67,33.8,37.9,29.5,00000
36.0,71.0,17.0,346,01,03,  Fatehpur,1121,513,631,231,490,282,68.6,73.2,63.5,00000
36.0,71.0,17.0,346,02,03,  Tajpur,234,245,127,100,107,145,48.9,55.9,42.5,00000
36.0,71.0,17.0,445,01,01,  Haritala,630,1364,349,635,281,729,31.6,35.5,27.8,00000
36.0,71.0,17.0,445,02,01,  Joynagar,8,28,5,13,3,15,22.2,27.8,16.7,00000
36.0,71.0,17.0,445,03,01,  Uzirpur,110,218,57,109,53,109,33.5,34.3,32.7,00000
36.0,71.0,17.0,445,04,01,  Shibpur,35,248,17,111,18,137,12.4,13.3,11.6,00000
36.0,71.0,17.0,445,05,01,  Kalinagar,38,466,21,225,17,241,7.5,8.5,6.6,00000
36.0,71.0,17.0,445,06,01,  Shibjoynagar,80,619,45,306,35,313,11.4,12.8,10.1,00000
36.0,71.0,17.0,445,07,01,  Bhati Shibjoynagar,16,139,9,65,7,74,10.3,12.2,8.6,00000
36.0,71.0,17.0,445,08,01,  Satparia,300,703,153,328,147,375,29.9,31.8,28.2,00000
36.0,71.0,17.0,511,01,01,  Kahura,258,395,129,173,129,222,39.5,42.7,36.8,00000
36.0,71.0,17.0,511,02,01,  Dhitkura,61,342,28,155,33,187,15.1,15.3,15.0,00000
36.0,71.0,17.0,522,01,01,  Bhati Sundarpur,87,219,49,104,38,115,28.4,32.0,24.8,00000
36.0,71.0,17.0,522,02,01,  Kalikapur,77,212,46,90,31,122,26.6,33.8,20.3,00000
36.0,71.0,17.0,522,03,01,  Nayagaon,252,519,118,238,134,281,32.7,33.1,32.3,00000
36.0,71.0,17.0,522,04,01,  Rupnagar,360,757,177,361,183,396,32.2,32.9,31.6,00000
36.0,71.0,17.0,522,05,01,  Ganganagar,54,182,30,81,24,101,22.9,27.0,19.2,00000
36.0,71.0,17.0,522,06,01,  Uzzalpur,70,239,33,123,37,116,22.7,21.2,24.2,00000
36.0,71.0,17.0,522,07,01,  Lakshmipur,33,63,13,31,20,32,34.4,29.5,38.5,00000
36.0,71.0,17.0,522,08,01,  Ratanpur,82,327,44,163,38,164,20.0,21.3,18.8,00000
36.0,71.0,17.0,522,09,01,  Harunpur,48,55,22,24,26,31,46.6,47.8,45.6,00000
36.0,71.0,17.0,522,10,01,  Ramchandrapur,31,268,21,121,10,147,10.4,14.8,6.4,00000
36.0,71.0,17.0,522,11,01,  Sundarpur,180,362,97,158,83,204,33.2,38.0,28.9,00000
36.0,71.0,25.0,159,01,01,  Bhabanipur (Part),292,451,150,198,142,253,39.3,43.1,35.9,00000
36.0,71.0,25.0,159,02,01,  Pinamanipur,30,70,14,33,16,37,30.0,29.8,30.2,00000
36.0,71.0,25.0,285,01,01,  Deogaon,376,635,227,274,149,361,37.2,45.3,29.2,00000
36.0,71.0,25.0,285,02,01,  Rasulpur,144,176,79,77,65,99,45.0,50.6,39.6,00000
36.0,71.0,25.0,318,01,01,  Durlabpur,249,451,126,231,123,220,35.6,35.3,35.9,00000
36.0,71.0,25.0,318,02,01,  Uttar Shik,104,251,45,117,59,134,29.3,27.8,30.6,00000
36.0,71.0,25.0,318,03,01,  Gunganagar,115,167,55,71,60,96,40.8,43.7,38.5,00000
36.0,71.0,25.0,318,04,01,  Gupinathpur,106,350,49,177,57,173,23.2,21.7,24.8,00000
36.0,71.0,25.0,357,01,01,  Gangail,544,304,272,125,272,179,64.2,68.5,60.3,00000
36.0,71.0,25.0,357,02,01,  Sahapur,79,70,39,29,40,41,53.0,57.4,49.4,00000
36.0,71.0,25.0,357,03,01,  Chapra,17,12,11,3,6,9,58.6,78.6,40.0,00000
36.0,71.0,25.0,368,01,01,  Ghilatali,595,1006,302,464,293,542,37.2,39.4,35.1,00000
36.0,71.0,25.0,368,02,01,  Gonarpar,85,299,38,125,47,174,22.1,23.3,21.3,00000
36.0,71.0,25.0,478,01,01,  Hariprasadpur,119,137,50,62,69,75,46.5,44.6,47.9,00000
36.0,71.0,25.0,478,02,01,  Dayarampur,37,70,19,30,18,40,34.6,38.8,31.0,00000
36.0,71.0,25.0,582,01,01,  Rajnagar,155,222,72,103,83,119,41.1,41.1,41.1,00000
36.0,71.0,25.0,582,02,01,  Rajendrapur,120,282,69,148,51,134,29.9,31.8,27.6,00000
36.0,71.0,25.0,582,03,01,  Krishnapur Kismat,630,1341,301,629,329,712,32.0,32.4,31.6,00000
36.0,71.0,25.0,973,01,01,  Talibpur,128,165,56,69,72,96,43.7,44.8,42.9,00000
36.0,71.0,25.0,973,02,01,  Rustampur,34,70,21,34,13,36,32.7,38.2,26.5,00000
36.0,71.0,25.0,973,03,01,  Kolaycha Char,178,456,107,204,71,252,28.1,34.4,22.0,00000
36.0,71.0,25.0,973,04,01,  Mirzapur,126,51,67,26,59,25,71.2,72.0,70.2,00000
36.0,71.0,34.0,203,01,01,  Bulla,1054,2078,525,944,529,1134,33.7,35.7,31.8,00000
36.0,71.0,34.0,203,02,01,  Rampur,201,648,86,312,115,336,23.7,21.6,25.5,00000
36.0,71.0,34.0,948,01,01,  Mamudpur,256,663,114,275,142,388,27.9,29.3,26.8,00000
36.0,71.0,34.0,948,02,01,  Gagrabari,2,140,2,70,0,70,1.4,2.8,0.0,00000
36.0,71.0,43.0,236,01,01,  Chhatiain,2447,2116,1335,984,1112,1132,53.6,57.6,49.6,00000
36.0,71.0,43.0,236,02,01,  Alikpur,71,156,33,76,38,80,31.3,30.3,32.2,00000
36.0,71.0,43.0,236,03,01,  Gopinathpur,91,240,44,126,47,114,27.5,25.9,29.2,00000
36.0,71.0,43.0,245,01,01,  Daspara,342,1064,183,500,159,564,24.3,26.8,22.0,00000
36.0,71.0,43.0,245,02,01,  Sreemathpur,245,268,131,117,114,151,47.8,52.8,43.0,00000
36.0,71.0,43.0,935,01,01,  Ektiarpur,486,1482,257,747,229,735,24.7,25.6,23.8,00000
36.0,71.0,43.0,935,02,01,  Manipur,253,595,150,267,103,328,29.8,36.0,23.9,00000
36.0,71.0,43.0,935,03,01,  Nayahati,51,341,15,146,36,195,13.0,9.3,15.6,00000
36.0,71.0,51.0,060,01,01,  Arijpur,278,154,139,71,139,83,64.4,66.2,62.6,00000
36.0,71.0,51.0,060,02,01,  Kesharpur,37,59,18,27,19,32,38.5,40.0,37.3,00000
36.0,71.0,51.0,060,03,01,  Barui Para,201,126,110,59,91,67,61.5,65.1,57.6,00000
36.0,71.0,51.0,065,01,01,  Ashrafpur (Part),5,11,4,5,1,6,31.3,44.4,14.3,00000
36.0,71.0,51.0,065,02,01,  Kalikapur,170,169,71,83,99,86,50.1,46.1,53.5,00000
36.0,71.0,51.0,126,01,01,  Barura,742,487,377,208,365,279,60.4,64.4,56.7,00000
36.0,71.0,51.0,126,02,01,  Baneshwarpur,336,51,152,21,184,30,86.8,87.9,86.0,00000
36.0,71.0,51.0,192,01,01,  Bishnupur,391,415,188,185,203,230,48.5,50.4,46.9,00000
36.0,71.0,51.0,192,02,01,  Hachinabad,278,193,134,66,144,127,59.0,67.0,53.1,00000
36.0,71.0,51.0,258,01,01,  Debipur,318,204,157,81,161,123,60.9,66.0,56.7,00000
36.0,71.0,51.0,258,02,01,  Sahebnagar,554,383,280,176,274,207,59.1,61.4,57.0,00000
36.0,71.0,51.0,362,01,01,  Gazipur,215,236,99,103,116,133,47.7,49.0,46.6,00000
36.0,71.0,51.0,362,02,01,  Kamalnagar,249,593,111,292,138,301,29.6,27.5,31.4,00000
36.0,71.0,51.0,434,01,01,  Harinkhola,808,1057,408,484,400,573,43.3,45.7,41.1,00000
36.0,71.0,51.0,434,02,01,  Gopinathpur,176,97,96,38,80,59,64.5,71.6,57.6,00000
36.0,71.0,51.0,434,03,01,  Nayanpur,221,307,116,129,105,178,41.9,47.3,37.1,00000
36.0,71.0,51.0,500,01,01,  Joypur,237,203,124,91,113,112,53.9,57.7,50.2,00000
36.0,71.0,51.0,500,02,01,  Shajalalpur,163,437,71,222,92,215,27.2,24.2,30.0,00000
36.0,71.0,51.0,500,03,01,  Chak Bandak,75,30,34,15,41,15,71.4,69.4,73.2,00000
36.0,71.0,51.0,599,01,01,  Madanpur,173,38,84,18,89,20,82.0,82.4,81.7,00000
36.0,71.0,51.0,599,02,01,  Anandaram,450,131,215,52,235,79,77.5,80.5,74.8,00000
36.0,71.0,51.0,621,01,01,  Mahabbatpur,77,45,42,20,35,25,63.1,67.7,58.3,00000
36.0,71.0,51.0,621,02,01,  Alipur,218,115,110,47,108,68,65.5,70.1,61.4,00000
36.0,71.0,51.0,747,01,01,  Jadubpur,52,38,30,18,22,20,57.8,62.5,52.4,00000
36.0,71.0,51.0,747,02,01,  Ghanshampur,93,78,50,34,43,44,54.4,59.5,49.4,00000
36.0,71.0,51.0,747,03,01,  Nurullahpur,136,216,64,98,72,118,38.6,39.5,37.9,00000
36.0,71.0,51.0,797,01,01,  Rajnagar,445,1078,245,488,200,590,29.2,33.4,25.3,00000
36.0,71.0,51.0,797,02,01,  Kalikrishna Nagar,226,393,117,190,109,203,36.5,38.1,34.9,00000
36.0,71.0,51.0,983,01,01,  Tingaon,176,605,91,281,85,324,22.5,24.5,20.8,00000
36.0,71.0,51.0,983,02,01,  Rampur,58,214,30,101,28,113,21.3,22.9,19.9,00000
36.0,71.0,60.0,214,01,01,  Chak Rajendrapur,238,197,106,93,132,104,54.7,53.3,55.9,00000
36.0,71.0,60.0,214,02,01,  Mohadebpur,28,44,21,19,7,25,38.9,52.5,21.9,00000
36.0,71.0,60.0,274,01,01,  Debpur,985,616,504,267,481,349,61.5,65.4,58.0,00000
36.0,71.0,60.0,274,02,01,  Fatapur,183,105,82,37,101,68,63.5,68.9,59.8,00000
36.0,71.0,60.0,296,01,01,  Dharmapur,281,494,149,222,132,272,36.3,40.2,32.7,00000
36.0,71.0,60.0,296,02,01,  Lakshmipur,37,6,22,1,15,5,86.0,95.7,75.0,00000
36.0,71.0,60.0,296,03,01,  Azmatpur,94,21,44,5,50,16,81.7,89.8,75.8,00000
36.0,71.0,60.0,318,01,01,  Mohanpur,133,166,72,70,61,96,44.5,50.7,38.9,00000
36.0,71.0,60.0,318,02,01,  Alinagar,462,292,252,119,210,173,61.3,67.9,54.8,00000
36.0,71.0,60.0,324,01,01,  Gobindapur,675,396,330,170,345,226,63.0,66.0,60.4,00000
36.0,71.0,60.0,324,02,01,  Dharmagar Bazar,126,17,65,5,61,12,88.1,92.9,83.6,00000
36.0,71.0,60.0,555,01,01,  Kazir Chak,241,182,118,74,123,108,57.0,61.5,53.2,00000
36.0,71.0,60.0,555,02,01,  Jatrapur,15,18,8,9,7,9,45.5,47.1,43.8,00000
36.0,71.0,60.0,555,03,01,  Etimpur,80,61,42,25,38,36,56.7,62.7,51.4,00000
36.0,71.0,60.0,555,04,01,  Baisnabpur,138,192,73,82,65,110,41.8,47.1,37.1,00000
36.0,71.0,60.0,731,01,01,  Nijnagar,248,285,137,129,111,156,46.5,51.5,41.6,00000
36.0,71.0,60.0,731,02,01,  Santoshpur,103,222,52,105,51,117,31.7,33.1,30.4,00000
36.0,71.0,60.0,907,01,01,  Shibrampur,394,170,198,63,196,107,69.9,75.9,64.7,00000
36.0,71.0,60.0,907,02,01,  Krishaganj Bazar,184,33,93,15,91,18,84.8,86.1,83.5,00000
36.0,71.0,69.0,131,01,01,  Bejura North,1168,2080,607,951,561,1129,36.0,39.0,33.2,00000
36.0,71.0,69.0,131,02,01,  Bejura South,931,1470,482,689,449,781,38.8,41.2,36.5,00000
36.0,71.0,69.0,148,01,01,  Belghar,1003,1154,500,552,503,602,46.5,47.5,45.5,00000
36.0,71.0,69.0,148,02,01,  Tiagoria,57,290,29,138,28,152,16.4,17.4,15.6,00000
36.0,71.0,69.0,560,01,01,  Kharki East,585,1908,300,932,285,976,23.5,24.4,22.6,00000
36.0,71.0,69.0,560,02,01,  Kharki West,721,1088,399,500,322,588,39.9,44.4,35.4,00000
36.0,71.0,77.0,280,01,01,  Dighirpar,57,543,40,278,17,265,9.5,12.6,6.0,00000
36.0,71.0,77.0,280,02,01,  Dulichandpur,16,152,10,75,6,77,9.5,11.8,7.2,00000
36.0,71.0,77.0,439,01,01,  Harishyama,635,1411,336,657,299,754,31.0,33.8,28.4,00000
36.0,71.0,77.0,439,02,01,  Muradpur,240,350,116,161,124,189,40.7,41.9,39.6,00000
36.0,71.0,77.0,588,01,01,  Kutania,134,500,53,271,81,229,21.1,16.4,26.1,00000
36.0,71.0,77.0,588,02,01,  Tongibari,100,48,50,22,50,26,67.6,69.4,65.8,00000
36.0,71.0,86.0,461,01,01,  Takhola,1089,666,557,324,532,342,62.1,63.2,60.9,00000
36.0,71.0,86.0,461,02,01,  Kashipur,737,644,354,291,383,353,53.4,54.9,52.0,00000
36.0,71.0,86.0,461,03,01,  Ramishpur,286,310,138,149,148,161,48.0,48.1,47.9,00000
36.0,71.0,86.0,461,04,01,  Morapara,1475,1301,713,560,762,741,53.1,56.0,50.7,00000
36.0,71.0,86.0,890,01,01,  Shahapur,629,1070,333,538,296,532,37.0,38.2,35.7,00000
36.0,71.0,86.0,890,02,01,  Bhabanipur,118,151,61,71,57,80,43.9,46.2,41.6,00000
36.0,71.0,86.0,890,03,01,  Alinagar,89,215,43,110,46,105,29.3,28.1,30.5,00000
36.0,71.0,86.0,890,04,01,  Dhananjoynagar,113,166,53,81,60,85,40.5,39.6,41.4,00000
36.0,71.0,94.0,164,01,01,  Bhandarua,426,634,201,302,225,332,40.2,40.0,40.4,00000
36.0,71.0,94.0,164,02,01,  Jamalpur,157,194,81,89,76,105,44.7,47.6,42.0,00000
36.0,71.0,94.0,324,01,01,  Ratanpur,218,331,100,172,118,159,39.7,36.8,42.6,00000
36.0,71.0,94.0,324,02,01,  Farodpur,171,346,75,156,96,190,33.1,32.5,33.6,00000
36.0,71.0,94.0,324,03,01,  Baghbari,225,374,100,191,125,183,37.6,34.4,40.6,00000
36.0,71.0,94.0,329,01,01,  Ektiarpur,169,246,83,116,86,130,40.7,41.7,39.8,00000
36.0,71.0,94.0,329,02,01,  Bangaon,139,302,62,154,77,148,31.5,28.7,34.2,00000
36.0,71.0,94.0,483,01,01,  Jaluabad,291,725,137,332,154,393,28.6,29.2,28.2,00000
36.0,71.0,94.0,483,02,01,  Nayagaon,271,548,127,268,144,280,33.1,32.2,34.0,00000
36.0,71.0,94.0,841,01,01,  Sahapur,141,156,57,77,84,79,47.5,42.5,51.5,00000
36.0,71.0,94.0,841,02,01,  Shahanagar,69,145,36,66,33,79,32.2,35.3,29.5,00000
36.0,71.0,94.0,962,01,01,  Surma,276,907,124,454,152,453,23.3,21.5,25.1,00000
36.0,71.0,94.0,962,02,01,  Jagjibanpur,256,238,129,118,127,120,51.8,52.2,51.4,00000
36.0,71.0,94.0,962,03,01,  Najirpur,131,619,66,284,65,335,17.5,18.9,16.3,00000
36.0,71.0,94.0,967,01,01,  Surma T.E.,2636,4766,1510,2112,1126,2654,35.6,41.7,29.8,00000
36.0,71.0,94.0,967,02,01,  Rasulpur,139,579,74,281,65,298,19.4,20.8,17.9,00000
36.0,71.0,94.0,981,01,01,  Sultanpur,462,717,256,342,206,375,39.2,42.8,35.5,00000
36.0,71.0,94.0,981,02,01,  Talia Para,1007,623,535,279,472,344,61.8,65.7,57.8,00000
36.0,77.0,13.0,018,01,01,  Alampur,497,586,241,272,256,314,45.9,47.0,44.9,00000
36.0,77.0,13.0,018,02,01,  Chargaon,135,64,66,23,69,41,67.8,74.2,62.7,00000
36.0,77.0,13.0,288,01,01,  Dakshin Daulatpur,171,235,74,109,97,126,42.1,40.4,43.5,00000
36.0,77.0,13.0,288,02,01,  Uttar Daulatpur,246,142,128,66,118,76,63.4,66.0,60.8,00000
36.0,77.0,13.0,353,01,01,  Firachhatpur,43,168,23,84,20,84,20.4,21.5,19.2,00000
36.0,77.0,13.0,353,02,01,  Bakshipur,27,211,9,110,18,101,11.3,7.6,15.1,00000
36.0,77.0,13.0,628,01,01,  Majlishpur,141,193,77,93,64,100,42.2,45.3,39.0,00000
36.0,77.0,13.0,628,02,01,  Bhabanipur,84,121,40,58,44,63,41.0,40.8,41.1,00000
36.0,77.0,13.0,747,01,01,  Pitua,497,466,245,222,252,244,51.6,52.5,50.8,00000
36.0,77.0,13.0,747,02,01,  Mohammadpur,101,122,55,95,46,27,45.3,36.7,63.0,00000
36.0,77.0,13.0,747,03,01,  Miskinpur,174,225,90,123,84,102,43.6,42.3,45.2,00000
36.0,77.0,13.0,820,01,01,  Rudrapur,160,161,82,72,78,89,49.8,53.2,46.7,00000
36.0,77.0,13.0,820,02,01,  Niamatpur,119,126,56,61,63,65,48.6,47.9,49.2,00000
36.0,77.0,13.0,820,03,01,  Ujirpur,79,116,41,45,38,71,40.5,47.7,34.9,00000
36.0,77.0,13.0,829,01,01,  Sadrabad,725,754,366,344,359,410,49.0,51.5,46.7,00000
36.0,77.0,13.0,829,02,01,  Sunampur,120,139,69,62,51,77,46.3,52.7,39.8,00000
36.0,77.0,13.0,829,03,01,  Nazimpur,243,160,136,75,107,85,60.3,64.5,55.7,00000
36.0,77.0,13.0,843,01,01,  Betapur,146,251,72,125,74,126,36.8,36.5,37.0,00000
36.0,77.0,13.0,843,02,01,  Amkuna,174,326,92,150,82,176,34.8,38.0,31.8,00000
36.0,77.0,13.0,977,01,01,  Dighar Brahmangaon,232,649,95,322,137,327,26.3,22.8,29.5,00000
36.0,77.0,13.0,977,02,01,  Parkul,458,717,220,362,238,355,39.0,37.8,40.1,00000
36.0,77.0,13.0,977,03,01,  Paharpur,148,345,70,172,78,173,30.0,28.9,31.1,00000
36.0,77.0,13.0,977,04,01,  Bangaon,488,637,235,315,253,322,43.4,42.7,44.0,00000
36.0,77.0,13.0,977,05,01,  Islampur,53,77,29,34,24,43,40.8,46.0,35.8,00000
36.0,77.0,14.0,110,01,01,  Maijgaon,165,664,82,305,83,359,19.9,21.2,18.8,00000
36.0,77.0,14.0,110,02,01,  Bausa,492,499,237,230,255,269,49.6,50.7,48.7,00000
36.0,77.0,14.0,110,03,01,  Dakshingaon,133,492,73,238,60,254,21.3,23.5,19.1,00000
36.0,77.0,14.0,110,04,01,  Nadampur,258,357,104,176,154,181,42.0,37.1,46.0,00000
36.0,77.0,14.0,132,01,01,  Paik Para,774,846,342,405,432,441,47.8,45.8,49.5,00000
36.0,77.0,14.0,132,02,01,  Bhadardi,505,629,248,312,257,317,44.5,44.3,44.8,00000
36.0,77.0,14.0,132,03,01,  Maij Para,95,213,50,104,45,109,30.8,32.5,29.2,00000
36.0,77.0,14.0,132,04,01,  Nayagaon,226,314,111,162,115,152,41.9,40.7,43.1,00000
36.0,77.0,14.0,192,01,01,  Tunakandi,263,320,134,151,129,169,45.1,47.0,43.3,00000
36.0,77.0,14.0,192,02,01,  Kamirai,135,326,68,159,67,167,29.3,30.0,28.6,00000
36.0,77.0,14.0,192,03,01,  Dakshin Chandpur,448,564,207,296,241,268,44.3,41.2,47.3,00000
36.0,77.0,14.0,275,02,01,  Bashdor,261,396,128,184,133,212,39.7,41.0,38.6,00000
36.0,77.0,14.0,738,02,01,  Abda,259,274,127,132,132,142,48.6,49.0,48.2,00000
36.0,77.0,14.0,793,01,01,  Rasul Pur,295,229,155,100,140,129,56.3,60.8,52.0,00000
36.0,77.0,14.0,793,02,01,  Santipur,84,188,36,110,48,78,30.9,24.7,38.1,00000
36.0,77.0,14.0,806,01,03,  Rifatpur,721,316,335,162,386,154,69.5,67.4,71.5,00000
36.0,77.0,14.0,806,03,03,  Darbeshpur,18,195,5,91,13,104,8.5,5.2,11.1,00000
36.0,77.0,21.0,059,01,01,  Baithakhal,598,888,271,453,327,435,40.2,37.4,42.9,00000
36.0,77.0,21.0,059,02,01,  Zitkia,251,631,110,310,141,321,28.5,26.2,30.5,00000
36.0,77.0,21.0,137,01,01,  Bhanudeb,156,382,85,177,71,205,29.0,32.4,25.7,00000
36.0,77.0,21.0,137,02,01,  Sharfarajpur,310,380,162,177,148,203,44.9,47.8,42.2,00000
36.0,77.0,21.0,234,01,01,  Hussenpur,122,347,63,158,59,189,26.0,28.5,23.8,00000
36.0,77.0,21.0,234,02,01,  Latifpur,156,276,68,149,88,127,36.1,31.3,40.9,00000
36.0,77.0,21.0,296,01,01,  Debpara,725,1018,372,475,353,543,41.6,43.9,39.4,00000
36.0,77.0,21.0,296,02,01,  Kabuleshwar,258,198,128,89,130,109,56.6,59.0,54.4,00000
36.0,77.0,21.0,296,03,01,  Purba Debpara,397,489,212,226,185,263,44.8,48.4,41.3,00000
36.0,77.0,21.0,296,04,01,  Uttar Debpara,421,549,215,273,206,276,43.4,44.1,42.7,00000
36.0,77.0,21.0,296,05,01,  Nalsuja,230,67,151,48,79,19,77.4,75.9,80.6,00000
36.0,77.0,21.0,334,01,01,  Fatar Char,305,281,141,116,164,165,52.0,54.9,49.8,00000
36.0,77.0,21.0,334,03,01,  Rustampur,569,768,268,384,301,384,42.6,41.1,43.9,00000
36.0,77.0,21.0,421,01,01,  Haitandi,147,244,69,118,78,126,37.6,36.9,38.2,00000
36.0,77.0,21.0,421,02,01,  Guradika,82,128,38,66,44,62,39.0,36.5,41.5,00000
36.0,77.0,21.0,490,01,01,  Jalalsap,559,655,280,308,279,347,46.0,47.6,44.6,00000
36.0,77.0,21.0,490,02,01,  Gopalar Bazar,229,137,119,59,110,78,62.6,66.9,58.5,00000
36.0,77.0,21.0,527,01,01,  Kalabharpur,317,756,129,355,188,401,29.5,26.7,31.9,00000
36.0,77.0,21.0,527,02,01,  Alinagar,175,138,83,67,92,71,55.9,55.3,56.4,00000
36.0,77.0,21.0,710,01,01,  Matbangaon,74,417,38,214,36,203,15.1,15.1,15.1,00000
36.0,77.0,21.0,710,02,01,  Narindi,309,190,140,93,169,97,61.9,60.1,63.5,00000
36.0,77.0,21.0,710,03,01,  Ahingaon,53,21,26,10,27,11,71.6,72.2,71.1,00000
36.0,77.0,21.0,834,01,01,  Sadarghat,1625,1896,847,866,778,1030,46.2,49.4,43.0,00000
36.0,77.0,21.0,834,02,01,  Tarapasha,69,45,26,18,43,27,60.5,59.1,61.4,00000
36.0,77.0,21.0,958,01,01,  Uttar Faridpur,464,461,216,222,248,239,50.2,49.3,50.9,00000
36.0,77.0,21.0,958,02,01,  Darmanagar,230,211,113,113,117,98,52.2,50.0,54.4,00000
36.0,77.0,29.0,220,01,01,  Kasba,1093,2044,518,987,575,1057,34.8,34.4,35.2,00000
36.0,77.0,29.0,220,02,01,  Chargaon,154,339,70,159,84,180,31.2,30.6,31.8,00000
36.0,77.0,29.0,284,01,01,  Daudpur,419,276,188,129,231,147,60.3,59.3,61.1,00000
36.0,77.0,29.0,284,02,01,  Darbeshpur,174,252,72,119,102,133,40.8,37.7,43.4,00000
36.0,77.0,29.0,284,03,01,  Ragu Daudpur,168,289,77,139,91,150,36.8,35.6,37.8,00000
36.0,77.0,29.0,330,01,01,  Fafulla,271,526,121,272,150,254,34.0,30.8,37.1,00000
36.0,77.0,29.0,330,02,01,  Mathurapur,216,474,98,221,118,253,31.3,30.7,31.8,00000
36.0,77.0,29.0,366,01,01,  Madhabpur,271,567,120,285,151,282,32.3,29.6,34.9,00000
36.0,77.0,29.0,366,02,01,  Galimpur,505,603,244,302,261,301,45.6,44.7,46.4,00000
36.0,77.0,29.0,492,01,01,  Bankandipur,166,97,77,46,89,51,63.1,62.6,63.6,00000
36.0,77.0,29.0,492,02,01,  Sreedharpur,122,60,53,23,69,37,67.0,69.7,65.1,00000
36.0,77.0,29.0,577,01,01,  Karkhana,153,264,68,112,85,152,36.7,37.8,35.9,00000
36.0,77.0,29.0,577,02,01,  Baharampur,345,231,174,90,171,141,59.9,65.9,54.8,00000
36.0,77.0,29.0,692,01,01,  Khod Karimpur,130,118,68,62,62,56,52.4,52.3,52.5,00000
36.0,77.0,29.0,692,02,01,  Bania Pata,31,101,17,55,14,46,23.5,23.6,23.3,00000
36.0,77.0,29.0,756,01,01,  Nurgaon,209,60,149,29,60,31,77.7,83.7,65.9,00000
36.0,77.0,29.0,756,02,01,  Puradia,86,50,37,26,49,24,63.2,58.7,67.1,00000
36.0,77.0,29.0,756,03,01,  Moshibpur,172,109,83,51,89,58,61.2,61.9,60.5,00000
36.0,77.0,29.0,802,01,01,  Royghar Bade,299,367,141,181,158,186,44.9,43.8,45.9,00000
36.0,77.0,29.0,802,02,01,  Baregaon,99,67,48,31,51,36,59.6,60.8,58.6,00000
36.0,77.0,29.0,917,01,01,  Dighirpar,150,257,79,119,71,138,36.9,39.9,34.0,00000
36.0,77.0,29.0,917,02,01,  Chalitapur,119,96,59,46,60,50,55.3,56.2,54.5,00000
36.0,77.0,29.0,917,03,01,  Nagarkandi,79,330,35,172,44,158,19.3,16.9,21.8,00000
36.0,77.0,29.0,917,04,01,  Nowagaon,8,61,4,27,4,34,11.6,12.9,10.5,00000
36.0,77.0,29.0,917,05,01,  Swastipur,157,230,83,116,74,114,40.6,41.7,39.4,00000
36.0,77.0,29.0,917,06,01,  Harikandi,50,56,26,26,24,30,47.2,50.0,44.4,00000
36.0,77.0,29.0,967,01,01,  Uttar Hussainpur,288,248,142,120,146,128,53.7,54.2,53.3,00000
36.0,77.0,29.0,967,02,01,  Durgapur,152,403,68,202,84,201,27.4,25.2,29.5,00000
36.0,77.0,29.0,967,03,01,  Ahmedpur,61,119,34,59,27,60,33.9,36.6,31.0,00000
36.0,77.0,43.0,068,01,01,  Mouraura,85,87,32,49,53,38,49.4,39.5,58.2,00000
36.0,77.0,43.0,068,02,01,  Nidhanpur,83,164,41,87,42,77,33.6,32.0,35.3,00000
36.0,77.0,43.0,068,03,01,  Deopara,419,599,185,299,234,300,41.2,38.2,43.8,00000
36.0,77.0,43.0,068,04,01,  Bandura,309,391,158,169,151,222,44.1,48.3,40.5,00000
36.0,77.0,43.0,224,01,01,  Kayesta Goan Uttar,318,599,148,291,170,308,34.7,33.7,35.6,00000
36.0,77.0,43.0,224,02,01,  Kayesta Goan Dakshin,43,48,24,24,19,24,47.3,50.0,44.2,00000
36.0,77.0,43.0,224,03,01,  Mishakuri,51,340,22,158,29,182,13.0,12.2,13.7,00000
36.0,77.0,43.0,224,04,01,  Shankar Sena,213,280,100,128,113,152,43.2,43.9,42.6,00000
36.0,77.0,43.0,224,05,01,  Kayesta Goan Purba,310,515,124,257,186,258,37.6,32.5,41.9,00000
36.0,77.0,43.0,243,01,01,  Paschim Kamargaon,153,224,75,106,78,118,40.6,41.4,39.8,00000
36.0,77.0,43.0,243,02,01,  Taralia (Karki),131,155,58,74,73,81,45.8,43.9,47.4,00000
36.0,77.0,43.0,243,03,01,  Dakshin Kamargaon,154,283,73,136,81,147,35.2,34.9,35.5,00000
36.0,77.0,43.0,243,04,01,  Chowdhurygaon,110,310,51,149,59,161,26.2,25.5,26.8,00000
36.0,77.0,43.0,273,01,01,  Dakshin Bangaon,133,595,76,285,57,310,18.3,21.1,15.5,00000
36.0,77.0,43.0,273,02,01,  Dinai Shatak,14,7,5,3,9,4,66.7,62.5,69.2,00000
36.0,77.0,43.0,559,01,01,  Kandigaon,266,499,146,213,120,286,34.8,40.7,29.6,00000
36.0,77.0,43.0,559,02,01,  Lamru,788,708,382,319,406,389,52.7,54.5,51.1,00000
36.0,77.0,43.0,614,01,01,  Lugaon,268,485,145,221,123,264,35.6,39.6,31.8,00000
36.0,77.0,43.0,614,02,01,  Shialer Punji,84,273,49,125,35,148,23.5,28.2,19.1,00000
36.0,77.0,43.0,614,03,01,  Masudpur,270,212,136,110,134,102,56.0,55.3,56.8,00000
36.0,77.0,43.0,871,01,01,  Sataihal,368,1057,166,496,202,561,25.8,25.1,26.5,00000
36.0,77.0,43.0,871,02,01,  Hairaghat,42,554,13,281,29,273,7.0,4.4,9.6,00000
36.0,77.0,43.0,871,03,01,  Esepur,233,176,102,86,131,90,57.0,54.3,59.3,00000
36.0,77.0,43.0,871,04,01,  Kursha,652,2136,311,991,341,1145,23.4,23.9,22.9,00000
36.0,77.0,43.0,894,01,01,  Shatak,258,275,139,133,119,142,48.4,51.1,45.6,00000
36.0,77.0,43.0,894,02,01,  Shekergaon,134,507,55,243,79,264,20.9,18.5,23.0,00000
36.0,77.0,43.0,894,03,01,  Naya Para,250,251,124,123,126,128,49.9,50.2,49.6,00000
36.0,77.0,43.0,894,04,01,  Saidabad,31,585,14,311,17,274,5.0,4.3,5.8,00000
36.0,77.0,51.0,270,01,01,  Boaktarpur,454,297,220,146,234,151,60.5,60.1,60.8,00000
36.0,77.0,51.0,270,02,01,  Dakshingram,365,315,182,131,183,184,53.7,58.1,49.9,00000
36.0,77.0,51.0,270,03,01,  Kaikhai,471,264,231,104,240,160,64.1,69.0,60.0,00000
36.0,77.0,51.0,270,04,01,  Lalapur,263,182,134,98,129,84,59.1,57.8,60.6,00000
36.0,77.0,51.0,357,01,01,  Bara Firojpur,243,385,120,184,123,201,38.7,39.5,38.0,00000
36.0,77.0,51.0,357,02,01,  Chhota Firojpur,103,453,45,225,58,228,18.5,16.7,20.3,00000
36.0,77.0,51.0,389,01,01,  Gholduba (Part),762,937,383,473,379,464,44.8,44.7,45.0,00000
36.0,77.0,51.0,389,02,01,  Shamoly Guchhogram,226,438,111,212,115,226,34.0,34.4,33.7,00000
36.0,77.0,51.0,573,01,01,  Karimpur,493,273,307,120,186,153,64.4,71.9,54.9,00000
36.0,77.0,51.0,573,02,01,  Kakura,286,378,133,185,153,193,43.1,41.8,44.2,00000
36.0,77.0,51.0,669,01,01,  Mustafapur,458,232,236,99,222,133,66.4,70.4,62.5,00000
36.0,77.0,51.0,669,02,01,  Taptibagh,236,164,128,58,108,106,59.0,68.8,50.5,00000
36.0,77.0,51.0,669,03,01,  Latifpur,224,155,114,75,110,80,59.1,60.3,57.9,00000
36.0,77.0,51.0,669,04,01,  Chandipur,68,42,29,18,39,24,61.8,61.7,61.9,00000
36.0,77.0,51.0,669,05,01,  Dighirpar,662,738,349,339,313,399,47.3,50.7,44.0,00000
36.0,77.0,51.0,669,06,01,  Inathganj,400,266,228,145,172,121,60.1,61.1,58.7,00000
36.0,77.0,51.0,669,07,01,  Mansurpur,118,114,59,60,59,54,50.9,49.6,52.2,00000
36.0,77.0,51.0,669,08,01,  Isabpur,334,219,168,97,166,122,60.4,63.4,57.6,00000
36.0,77.0,51.0,669,09,01,  Mukam Para,54,52,26,24,28,28,50.9,52.0,50.0,00000
36.0,77.0,51.0,985,01,01,  Uttar Ramjanpur,165,143,94,60,71,83,53.6,61.0,46.1,00000
36.0,77.0,51.0,985,02,01,  Baniunda,423,181,205,51,218,130,70.0,80.1,62.6,00000
36.0,77.0,58.0,265,01,01,  Tak Chandpur,355,612,153,292,202,320,36.7,34.4,38.7,00000
36.0,77.0,58.0,265,02,01,  Debpara,146,140,66,71,80,69,51.0,48.2,53.7,00000
36.0,77.0,58.0,265,03,01,  Dakshin Umarpur,586,656,277,329,309,327,47.2,45.7,48.6,00000
36.0,77.0,58.0,529,01,01,  Sreematpur,845,953,413,458,432,495,47.0,47.4,46.6,00000
36.0,77.0,58.0,529,02,01,  Kaliar Bhanga,449,596,204,306,245,290,43.0,40.0,45.8,00000
36.0,77.0,58.0,529,03,01,  Chargaon,171,384,90,187,81,197,30.8,32.5,29.1,00000
36.0,77.0,58.0,529,04,01,  Purangaon,392,841,179,423,213,418,31.8,29.7,33.8,00000
36.0,77.0,58.0,529,05,01,  Imambari Bazar,150,47,81,20,69,27,76.1,80.2,71.9,00000
36.0,77.0,58.0,591,01,01,  Patharia,173,343,88,170,85,173,33.5,34.1,32.9,00000
36.0,77.0,58.0,591,02,01,  Kharia Lalpur,160,1037,94,473,66,564,13.4,16.6,10.5,00000
36.0,77.0,58.0,632,01,01,  Mandar Kandi,702,703,366,364,336,339,50.0,50.1,49.8,00000
36.0,77.0,58.0,632,02,01,  Paschimpara (Kasba),105,200,63,95,42,105,34.4,39.9,28.6,00000
36.0,77.0,58.0,788,01,01,  Ranigaon,318,375,150,186,168,189,45.9,44.6,47.1,00000
36.0,77.0,58.0,788,02,01,  Rampur,160,529,79,235,81,294,23.2,25.2,21.6,00000
36.0,77.0,65.0,036,01,01,  Kamalpur,363,239,177,114,186,125,60.3,60.8,59.8,00000
36.0,77.0,65.0,036,02,01,  Radhanagar,133,155,76,73,57,82,46.2,51.0,41.0,00000
36.0,77.0,65.0,036,03,01,  Durgapur,904,560,472,270,432,290,61.7,63.6,59.8,00000
36.0,77.0,65.0,036,04,01,  Lakshipur,138,373,78,186,60,187,27.0,29.5,24.3,00000
36.0,77.0,65.0,036,05,01,  Kashipur,198,337,97,177,101,160,37.0,35.4,38.7,00000
36.0,77.0,65.0,036,06,01,  Bara Shakua,704,646,369,286,335,360,52.1,56.3,48.2,00000
36.0,77.0,65.0,036,07,01,  Bailakipur,448,366,219,174,229,192,55.0,55.7,54.4,00000
36.0,77.0,65.0,183,01,01,  Burunga,206,218,136,86,70,132,48.6,61.3,34.7,00000
36.0,77.0,65.0,183,02,01,  Patli,213,40,118,15,95,25,84.2,88.7,79.2,00000
36.0,77.0,65.0,408,01,01,  Gumgumia,1246,1135,595,567,651,568,52.3,51.2,53.4,00000
36.0,77.0,65.0,408,02,01,  Sreedharpur,68,295,28,154,40,141,18.7,15.4,22.1,00000
36.0,77.0,65.0,596,01,01,  Kurisail Chak,68,281,29,140,39,141,19.5,17.2,21.7,00000
36.0,77.0,65.0,596,02,01,  Rampur,34,53,15,22,19,31,39.1,40.5,38.0,00000
36.0,77.0,65.0,651,01,03,  Janturi,193,279,93,140,100,139,40.9,39.9,41.8,00000
36.0,77.0,65.0,651,02,03,  Millik,131,349,70,177,61,172,27.3,28.3,26.2,00000
36.0,77.0,65.0,761,01,01,  Murang Patli,152,483,66,227,86,256,23.9,22.5,25.1,00000
36.0,77.0,65.0,761,02,01,  Chhota Shakua,251,435,104,197,147,238,36.6,34.6,38.2,00000
36.0,77.0,65.0,761,03,01,  Fatehnagar,140,338,74,157,66,181,29.3,32.0,26.7,00000
36.0,77.0,65.0,761,04,01,  Purushuttampur,241,326,123,156,118,170,42.5,44.1,41.0,00000
36.0,77.0,73.0,032,01,01,  Amtail,89,175,46,83,43,92,33.7,35.7,31.9,00000
36.0,77.0,73.0,032,02,01,  Shadullapur,166,439,86,201,80,238,27.4,30.0,25.2,00000
36.0,77.0,73.0,325,01,01,  Khankari Para,366,216,178,105,188,111,62.9,62.9,62.9,00000
36.0,77.0,73.0,325,02,01,  Enatabad,594,1132,272,523,322,609,34.4,34.2,34.6,00000
36.0,77.0,73.0,325,03,01,  Sultanpur,117,233,53,98,64,135,33.4,35.1,32.2,00000
36.0,77.0,73.0,325,04,01,  Joytara,158,180,75,89,83,91,46.7,45.7,47.7,00000
36.0,77.0,73.0,518,01,01,  Perichandpur,61,61,36,21,25,40,50.0,63.2,38.5,00000
36.0,77.0,73.0,518,02,01,  Kadma,64,135,34,64,30,71,32.2,34.7,29.7,00000
36.0,77.0,73.0,518,03,01,  Nindapur,58,37,26,15,32,22,61.1,63.4,59.3,00000
36.0,77.0,73.0,605,01,01,  Kurshi,661,615,318,302,343,313,51.8,51.3,52.3,00000
36.0,77.0,73.0,605,02,01,  Noagaon,125,236,55,108,70,128,34.6,33.7,35.4,00000
36.0,77.0,73.0,605,04,01,  Laskarpur,111,111,52,60,59,51,50.0,46.4,53.6,00000
36.0,77.0,73.0,774,01,01,  Raiapur,735,1059,311,507,424,552,41.0,38.0,43.4,00000
36.0,77.0,73.0,774,02,01,  Tahirpur,392,326,194,152,198,174,54.6,56.1,53.2,00000
36.0,77.0,73.0,839,01,01,  Kadepur,105,105,51,50,54,55,50.0,50.5,49.5,00000
36.0,77.0,73.0,839,02,01,  Sadullapur,179,343,85,165,94,178,34.3,34.0,34.6,00000
36.0,77.0,80.0,100,01,01,  Barkatpur,65,414,40,200,25,214,13.6,16.7,10.5,00000
36.0,77.0,80.0,100,02,01,  Purba Jahidpur,165,517,85,250,80,267,24.2,25.4,23.1,00000
36.0,77.0,80.0,132,01,01,  Ghona Para,105,372,53,184,52,188,22.0,22.4,21.7,00000
36.0,77.0,80.0,132,02,01,  Bara Alipur,633,746,309,389,324,357,45.9,44.3,47.6,00000
36.0,77.0,80.0,132,03,01,  Chhotta Alipur,269,364,121,188,148,176,42.5,39.2,45.7,00000
36.0,77.0,80.0,438,01,01,  Halitala,151,225,70,105,81,120,40.2,40.0,40.3,00000
36.0,77.0,80.0,438,02,01,  Tamaspur,229,49,116,19,113,30,82.4,85.9,79.0,00000
36.0,77.0,80.0,438,03,01,  Baraikandi,270,1136,151,538,119,598,19.2,21.9,16.6,00000
36.0,77.0,80.0,483,01,01,  Gujakhair,439,1804,201,855,238,949,19.6,19.0,20.1,00000
36.0,77.0,80.0,483,02,01,  Betapur,26,325,13,153,13,172,7.4,7.8,7.0,00000
36.0,77.0,80.0,554,01,03,  Kanaipur,160,734,64,370,96,364,17.9,14.7,20.9,00000
36.0,77.0,80.0,554,02,03,  Baje Kanaipur,307,152,156,66,151,86,66.9,70.3,63.7,00000
36.0,77.0,87.0,022,01,01,  Alipur,135,190,65,84,70,106,41.5,43.6,39.8,00000
36.0,77.0,87.0,022,02,01,  Khagaura,399,299,204,137,195,162,57.2,59.8,54.6,00000
36.0,77.0,87.0,022,03,01,  Kandi Para,90,85,45,39,45,46,51.4,53.6,49.5,00000
36.0,77.0,87.0,045,01,01,  Imam T.G.,129,308,81,136,48,172,29.5,37.3,21.8,00000
36.0,77.0,87.0,045,02,01,  Bawani T.G.,8,305,4,155,4,150,2.6,2.5,2.6,00000
36.0,77.0,87.0,729,01,01,  Paniumda,2025,3224,1003,1554,1022,1670,38.6,39.2,38.0,00000
36.0,77.0,87.0,729,02,01,  Barakandi,309,933,148,459,161,474,24.9,24.4,25.4,00000
36.0,77.0,87.0,889,01,01,  Shankarpur,255,906,146,448,109,458,22.0,24.6,19.2,00000
36.0,77.0,87.0,889,02,01,  Chak Shankarpur,279,236,128,110,151,126,54.2,53.8,54.5,00000
36.0,77.0,90.0,055,01,01,  Harinagar (Part),631,544,310,266,321,278,53.7,53.8,53.6,00000
36.0,77.0,90.0,055,02,01,  Baghaura,1015,1277,484,612,531,665,44.3,44.2,44.4,00000
36.0,77.0,90.0,079,01,01,  Chhota Bakhair,651,878,311,431,340,447,42.6,41.9,43.2,00000
36.0,77.0,90.0,079,02,01,  Bara Bakhair,767,896,372,435,395,461,46.1,46.1,46.1,00000
36.0,77.0,90.0,550,01,01,  Kamrakhai,336,769,153,382,183,387,30.4,28.6,32.1,00000
36.0,77.0,90.0,550,02,01,  Rampur,966,2991,472,1457,494,1534,24.4,24.5,24.4,00000
36.0,77.0,90.0,550,03,01,  Harinagar (Part),274,476,128,235,146,241,36.5,35.3,37.7,00000
36.0,77.0,94.0,343,01,01,  Fatehpur,485,785,236,375,249,410,38.2,38.6,37.8,00000
36.0,77.0,94.0,343,02,01,  Jagannathpur,985,1157,473,543,512,614,46.0,46.6,45.5,00000
36.0,77.0,94.0,343,03,01,  Sonapur,853,1411,410,610,443,801,37.7,40.2,35.6,00000
91.0,8.0,11.0,012,01,01,  Adityapur,450,181,213,87,237,94,71.3,71.0,71.6,00000
91.0,8.0,11.0,012,02,01,  Satyapur,190,150,97,79,93,71,55.9,55.1,56.7,00000
91.0,8.0,11.0,108,01,01,  Bara Char,412,293,201,146,211,147,58.4,57.9,58.9,00000
91.0,8.0,11.0,108,02,01,  Noapatan,283,112,145,48,138,64,71.6,75.1,68.3,00000
91.0,8.0,11.0,146,01,01,  Brittania,226,125,119,66,107,59,64.4,64.3,64.5,00000
91.0,8.0,11.0,146,02,01,  Kalakanu,73,44,35,25,38,19,62.4,58.3,66.7,00000
91.0,8.0,11.0,167,01,03,  Chandpur,859,406,427,183,432,223,67.9,70.0,66.0,00000
91.0,8.0,11.0,167,02,03,  Prasannapur,285,126,141,54,144,72,69.3,72.3,66.7,00000
91.0,8.0,11.0,167,03,03,  Balaganj Bazar,1829,929,975,434,854,495,66.3,69.2,63.3,00000
91.0,8.0,11.0,171,01,01,  Char Bhuabatan,158,104,82,50,76,54,60.3,62.1,58.5,00000
91.0,8.0,11.0,171,02,01,  Batapatan,177,131,101,64,76,67,57.5,61.2,53.1,00000
91.0,8.0,11.0,209,01,03,  Radhakuna,701,717,330,349,371,368,49.4,48.6,50.2,00000
91.0,8.0,11.0,209,02,03,  Korcharpar,324,375,154,197,170,178,46.4,43.9,48.9,00000
91.0,8.0,11.0,271,01,01,  Gorapur,178,49,89,24,89,25,78.4,78.8,78.1,00000
91.0,8.0,11.0,271,02,01,  Char Bota,537,117,245,60,292,57,82.1,80.3,83.7,00000
91.0,8.0,11.0,330,01,01,  Hossainpur,344,384,172,167,172,217,47.3,50.7,44.2,00000
91.0,8.0,11.0,330,02,01,  Kaliargaon,122,314,58,154,64,160,28.0,27.4,28.6,00000
91.0,8.0,11.0,447,01,01,  Kashipur,654,319,320,135,334,184,67.2,70.3,64.5,00000
91.0,8.0,11.0,447,02,01,  Rupia,356,288,189,133,167,155,55.3,58.7,51.9,00000
91.0,8.0,11.0,447,03,01,  Gaurinathpur,379,106,190,38,189,68,78.1,83.3,73.5,00000
91.0,8.0,11.0,447,04,01,  Jagatpur,220,86,107,35,113,51,71.9,75.4,68.9,00000
91.0,8.0,11.0,468,01,01,  Kazipur,362,285,178,139,184,146,56.0,56.2,55.8,00000
91.0,8.0,11.0,468,02,01,  Majlishpur,318,314,159,158,159,156,50.3,50.2,50.5,00000
91.0,8.0,11.0,468,03,01,  Kudlatipur,73,128,38,61,35,67,36.3,38.4,34.3,00000
91.0,8.0,11.0,468,04,01,  Char Bhita,198,186,96,88,102,98,51.6,52.2,51.0,00000
91.0,8.0,11.0,468,05,01,  Ilashpur,89,66,46,39,43,27,57.4,54.1,61.4,00000
91.0,8.0,11.0,748,01,01,  Pirpur,239,125,137,66,102,59,65.7,67.5,63.4,00000
91.0,8.0,11.0,748,02,01,  Chak Pirpur,229,96,111,42,118,54,70.5,72.5,68.6,00000
91.0,8.0,11.0,819,01,01,  Rifatpur,535,516,255,254,280,262,50.9,50.1,51.7,00000
91.0,8.0,11.0,819,02,01,  Char Subia (Mahananda),234,146,116,78,118,68,61.6,59.8,63.4,00000
91.0,8.0,11.0,819,03,01,  Char Haria,41,86,11,46,30,40,32.3,19.3,42.9,00000
91.0,8.0,11.0,819,04,01,  Gopkanu,101,168,47,83,54,85,37.5,36.2,38.8,00000
91.0,8.0,11.0,884,01,01,  Jinarpur,79,53,33,25,46,28,59.8,56.9,62.2,00000
91.0,8.0,11.0,884,02,01,  Berakhal,129,126,65,59,64,67,50.6,52.4,48.9,00000
91.0,8.0,11.0,986,01,01,  Trilochanpur,307,323,151,142,156,181,48.7,51.5,46.3,00000
91.0,8.0,11.0,986,02,01,  Char Natha,24,76,6,39,18,37,24.0,13.3,32.7,00000
91.0,8.0,11.0,986,03,01,  Char Sukia,20,57,10,28,10,29,26.0,26.3,25.6,00000
91.0,8.0,11.0,986,04,01,  Madaripur,68,62,28,33,40,29,52.3,45.9,58.0,00000
91.0,8.0,13.0,025,01,01,  Bangalia,126,83,70,42,56,41,60.3,62.5,57.7,00000
91.0,8.0,13.0,025,02,01,  Shibpur,78,92,34,42,44,50,45.9,44.7,46.8,00000
91.0,8.0,13.0,025,03,01,  Mohammed Shal,150,104,74,45,76,59,59.1,62.2,56.3,00000
91.0,8.0,13.0,104,01,01,  Banigaon,131,149,55,74,76,75,46.8,42.6,50.3,00000
91.0,8.0,13.0,104,02,01,  Binodpur,27,45,17,27,10,18,37.5,38.6,35.7,00000
91.0,8.0,13.0,104,03,01,  Uzialpur,21,53,7,28,14,25,28.4,20.0,35.9,00000
91.0,8.0,13.0,367,01,01,  Karmapur,289,124,137,55,152,69,70.0,71.4,68.8,00000
91.0,8.0,13.0,367,02,01,  Bade Ekachikan,143,23,73,10,70,13,86.1,88.0,84.3,00000
91.0,8.0,13.0,378,01,01,  Dakshin Majlishpur,207,178,101,82,106,96,53.8,55.2,52.5,00000
91.0,8.0,13.0,378,02,01,  Ekalima,56,81,26,42,30,39,40.9,38.2,43.5,00000
91.0,8.0,13.0,581,01,01,  Makrashi,255,456,115,235,140,221,35.9,32.9,38.8,00000
91.0,8.0,13.0,581,02,01,  Shindrakona,256,382,126,200,130,182,40.1,38.7,41.7,00000
91.0,8.0,13.0,622,01,01,  Mobarakpur,123,52,63,22,60,30,70.3,74.1,66.7,00000
91.0,8.0,13.0,622,02,01,  Ghugrakandi,65,27,33,17,32,10,70.7,66.0,76.2,00000
91.0,8.0,13.0,631,01,01,  Mokbelpur,250,533,109,251,141,282,31.9,30.3,33.3,00000
91.0,8.0,13.0,631,02,01,  Sarbandapur,36,126,17,58,19,68,22.2,22.7,21.8,00000
91.0,8.0,13.0,639,01,01,  Manoharpur,394,702,187,311,207,391,35.9,37.6,34.6,00000
91.0,8.0,13.0,639,02,01,  Banogaon,64,30,31,14,33,16,68.1,68.9,67.3,00000
91.0,8.0,13.0,673,01,01,  Nasiarpur,732,398,353,194,379,204,64.8,64.5,65.0,00000
91.0,8.0,13.0,673,02,01,  Roypur,80,51,42,19,38,32,61.1,68.9,54.3,00000
91.0,8.0,13.0,673,03,01,  Goyghar,16,7,8,2,8,5,69.6,80.0,61.5,00000
91.0,8.0,13.0,710,01,01,  Paschim Nurpur,290,262,156,126,134,136,52.5,55.3,49.6,00000
91.0,8.0,13.0,710,02,01,  Ekachikan,204,101,85,36,119,65,66.9,70.2,64.7,00000
91.0,8.0,13.0,907,01,01,  Sonapur,424,1093,196,609,228,484,27.9,24.3,32.0,00000
91.0,8.0,13.0,907,02,01,  Hushiarpur,110,137,51,65,59,72,44.5,44.0,45.0,00000
91.0,8.0,20.0,765,01,01,  Hajipur,379,423,238,194,141,229,47.3,55.1,38.1,00000
91.0,8.0,20.0,765,02,01,  Pearapur,398,180,203,96,195,84,68.9,67.9,69.9,00000
91.0,8.0,20.0,898,01,01,  Purba Sirajnagar,702,773,348,387,354,386,47.6,47.3,47.8,00000
91.0,8.0,20.0,898,02,01,  Paschim Sirajnagar,656,614,348,297,308,317,51.7,54.0,49.3,00000
91.0,8.0,20.0,982,01,01,  Purba Tila Para,819,1630,408,790,411,840,33.4,34.1,32.9,00000
91.0,8.0,20.0,982,02,01,  Paschim Tila Para,761,789,384,389,377,400,49.1,49.7,48.5,00000
91.0,8.0,27.0,016,01,01,  Dakuar Mahal,254,184,126,92,128,92,58.0,57.8,58.2,00000
91.0,8.0,27.0,016,02,01,  Keshabpur,123,117,60,60,63,57,51.3,50.0,52.5,00000
91.0,8.0,27.0,058,01,01,  Asrafpur,9,6,5,5,4,1,60.0,50.0,80.0,00000
91.0,8.0,27.0,058,02,01,  Karbari Para,130,41,64,14,66,27,76.0,82.1,71.0,00000
91.0,8.0,27.0,104,01,01,  Bara Dhirarai,578,746,282,366,296,380,43.7,43.5,43.8,00000
91.0,8.0,27.0,104,02,01,  Char Khalpar,67,62,32,31,35,31,51.9,50.8,53.0,00000
91.0,8.0,27.0,104,03,01,  Saniargaon,105,105,45,56,60,49,50.0,44.6,55.0,00000
91.0,8.0,27.0,104,04,01,  Noagaon,139,304,77,158,62,146,31.4,32.8,29.8,00000
91.0,8.0,27.0,104,05,01,  Alampur,70,91,33,48,37,43,43.5,40.7,46.3,00000
91.0,8.0,27.0,175,01,01,  Chintamani,640,555,325,268,315,287,53.6,54.8,52.3,00000
91.0,8.0,27.0,175,02,01,  Chandi Tiar,176,108,86,51,90,57,62.0,62.8,61.2,00000
91.0,8.0,27.0,175,03,01,  Kharai,73,44,38,12,35,32,62.4,76.0,52.2,00000
91.0,8.0,27.0,196,01,01,  Dayamir,632,906,299,447,333,459,41.1,40.1,42.0,00000
91.0,8.0,27.0,196,02,01,  Khalpar,97,46,45,23,52,23,67.8,66.2,69.3,00000
91.0,8.0,27.0,196,03,01,  Dayamir Bazar,75,40,59,29,16,11,65.2,67.0,59.3,00000
91.0,8.0,27.0,267,01,01,  Ghoshgaon,576,417,291,194,285,223,58.0,60.0,56.1,00000
91.0,8.0,27.0,267,02,01,  Sannyasi Para,65,87,31,33,34,54,42.8,48.4,38.6,00000
91.0,8.0,27.0,267,03,01,  Radhakona,61,155,28,72,33,83,28.2,28.0,28.4,00000
91.0,8.0,27.0,409,01,01,  Kaiyakhair,660,474,338,236,322,238,58.2,58.9,57.5,00000
91.0,8.0,27.0,409,02,01,  Tajpur,91,119,41,53,50,66,43.3,43.6,43.1,00000
91.0,8.0,27.0,480,01,01,  Khagdiar,506,688,241,320,265,368,42.4,43.0,41.9,00000
91.0,8.0,27.0,480,02,01,  Khalpar,384,59,178,25,206,34,86.7,87.7,85.8,00000
91.0,8.0,27.0,480,03,01,  Mirpara,496,114,209,53,287,61,81.3,79.8,82.5,00000
91.0,8.0,27.0,480,04,01,  Kaliya,285,194,136,100,149,94,59.5,57.6,61.3,00000
91.0,8.0,27.0,480,05,01,  Alapur,20,24,10,15,10,9,45.5,40.0,52.6,00000
91.0,8.0,27.0,480,06,01,  Sirajpur,128,77,65,41,63,36,62.4,61.3,63.6,00000
91.0,8.0,27.0,480,07,01,  Khandakar Bazar,150,365,68,178,82,187,29.1,27.6,30.5,00000
91.0,8.0,27.0,489,01,01,  Khapan,344,164,180,73,164,91,67.7,71.1,64.3,00000
91.0,8.0,27.0,489,02,01,  Khalpar,101,31,56,13,45,18,76.5,81.2,71.4,00000
91.0,8.0,27.0,489,03,01,  Mirder Char,79,89,46,45,33,44,47.0,50.5,42.9,00000
91.0,8.0,27.0,702,01,01,  Nij Kurua,1192,848,644,375,548,473,58.4,63.2,53.7,00000
91.0,8.0,27.0,702,02,01,  Jaigirdar Para,157,120,77,72,80,48,56.7,51.7,62.5,00000
91.0,8.0,27.0,702,03,01,  Chatalibanda,108,135,38,76,70,59,44.4,33.3,54.3,00000
91.0,8.0,27.0,702,04,01,  Kurua Bazar,51,24,31,11,20,13,68.0,73.8,60.6,00000
91.0,8.0,27.0,735,01,01,  Chhota Dirarai,447,279,222,128,225,151,61.6,63.4,59.8,00000
91.0,8.0,27.0,735,02,01,  Saraspur,369,334,178,157,191,177,52.5,53.1,51.9,00000
91.0,8.0,27.0,735,03,01,  Khatpur,113,133,73,67,40,66,45.9,52.1,37.7,00000
91.0,8.0,27.0,739,01,01,  Mandal Kapan,256,182,136,84,120,98,58.4,61.8,55.0,00000
91.0,8.0,27.0,739,02,01,  Mirergaon,203,273,111,126,92,147,42.6,46.8,38.5,00000
91.0,8.0,27.0,739,03,01,  Brahman Shasan,241,338,127,139,114,199,41.6,47.7,36.4,00000
91.0,8.0,27.0,742,01,01,  Daulatpur,336,424,149,204,187,220,44.2,42.2,45.9,00000
91.0,8.0,27.0,742,02,01,  Palpara,64,36,33,15,31,21,64.0,68.8,59.6,00000
91.0,8.0,27.0,785,01,01,  Raikdara,347,454,176,222,171,232,43.3,44.2,42.4,00000
91.0,8.0,27.0,785,02,01,  Gangpar,297,629,148,323,149,306,32.1,31.4,32.7,00000
91.0,8.0,27.0,854,01,01,  Khairpur,54,2,26,0,28,2,96.4,100.0,93.3,00000
91.0,8.0,27.0,854,02,01,  Suargaon,583,206,300,85,283,121,73.9,77.9,70.0,00000
91.0,8.0,27.0,854,03,01,  Khanjulpur,103,29,51,9,52,20,78.0,85.0,72.2,00000
91.0,8.0,33.0,033,01,01,  Alapur,273,328,124,157,149,171,45.4,44.1,46.6,00000
91.0,8.0,33.0,033,02,01,  Char Alapur,292,354,155,173,137,181,45.2,47.3,43.1,00000
91.0,8.0,33.0,033,03,01,  Sulemanpur,79,55,41,24,38,31,59.0,63.1,55.1,00000
91.0,8.0,33.0,121,01,01,  Bashirpur,218,263,98,122,120,141,45.3,44.5,46.0,00000
91.0,8.0,33.0,121,02,01,  Daulatpur,72,70,38,37,34,33,50.7,50.7,50.7,00000
91.0,8.0,33.0,121,03,01,  Jagannathpur,64,60,28,27,36,33,51.6,50.9,52.2,00000
91.0,8.0,33.0,121,04,01,  Jatergaon,70,48,30,24,40,24,59.3,55.6,62.5,00000
91.0,8.0,33.0,259,01,01,  Gayaspur,106,523,54,255,52,268,16.9,17.5,16.3,00000
91.0,8.0,33.0,259,02,01,  Hossainpur,224,611,99,290,125,321,26.8,25.4,28.0,00000
91.0,8.0,33.0,321,01,01,  Haydarpur,403,798,218,367,185,431,33.6,37.3,30.0,00000
91.0,8.0,33.0,321,02,01,  Sahapur,116,244,53,128,63,116,32.2,29.3,35.2,00000
91.0,8.0,33.0,530,01,01,  Kuberali,160,250,74,114,86,136,39.0,39.4,38.7,00000
91.0,8.0,33.0,530,02,01,  Shankarpur,323,370,151,176,172,194,46.6,46.2,47.0,00000
91.0,8.0,33.0,677,01,01,  Nasiarpur,380,225,188,98,192,127,62.8,65.7,60.2,00000
91.0,8.0,33.0,677,02,01,  Daulatpur,88,69,38,34,50,35,56.1,52.8,58.8,00000
91.0,8.0,33.0,677,03,01,  Roypur,35,11,15,4,20,7,76.1,78.9,74.1,00000
91.0,8.0,33.0,677,04,01,  Nizamkhali,53,58,22,33,31,25,47.7,40.0,55.4,00000
91.0,8.0,33.0,677,05,01,  Dafarpur,176,216,81,115,95,101,44.9,41.3,48.5,00000
91.0,8.0,33.0,693,01,01,  Nijgaharpur,95,532,34,279,61,253,15.2,10.9,19.4,00000
91.0,8.0,33.0,693,02,01,  Ahmedpur,144,270,73,134,71,136,34.8,35.3,34.3,00000
91.0,8.0,33.0,756,01,01,  Mohammedpur,403,594,172,302,231,292,40.4,36.3,44.2,00000
91.0,8.0,33.0,756,02,01,  Pachhal,235,271,122,147,113,124,46.4,45.4,47.7,00000
91.0,8.0,33.0,894,01,01,  Siorkhal,1015,1270,534,657,481,613,44.4,44.8,44.0,00000
91.0,8.0,33.0,894,02,01,  Hajipur,78,53,29,29,49,24,59.5,50.0,67.1,00000
91.0,8.0,33.0,923,01,01,  Kalimanzi,96,153,45,79,51,74,38.6,36.3,40.8,00000
91.0,8.0,33.0,923,02,01,  Purbapara,138,160,74,80,64,80,46.3,48.1,44.4,00000
91.0,8.0,33.0,978,01,01,  Ibrahimpur,106,233,45,129,61,104,31.3,25.9,37.0,00000
91.0,8.0,33.0,978,02,01,  Jahapur,178,174,83,88,95,86,50.6,48.5,52.5,00000
91.0,8.0,40.0,150,01,01,  Purba Brahmangram,657,1306,352,626,305,680,33.5,36.0,31.0,00000
91.0,8.0,40.0,150,02,01,  Paschim Brahmangram,567,356,291,166,276,190,61.4,63.7,59.2,00000
91.0,8.0,40.0,150,03,01,  Godiar Char,307,296,163,130,144,166,50.9,55.6,46.5,00000
91.0,8.0,40.0,150,04,01,  Dattagram,327,190,179,87,148,103,63.2,67.3,59.0,00000
91.0,8.0,40.0,284,01,01,  Gramtala,193,191,110,89,83,102,50.3,55.3,44.9,00000
91.0,8.0,40.0,284,02,01,  Dash Para,210,137,115,65,95,72,60.5,63.9,56.9,00000
91.0,8.0,40.0,284,03,01,  Oyeakushi,169,158,99,86,70,72,51.7,53.5,49.3,00000
91.0,8.0,40.0,284,04,01,  Oyeasukla,88,84,44,49,44,35,51.2,47.3,55.7,00000
91.0,8.0,40.0,284,05,01,  Jardhakushi,172,173,92,76,80,97,49.9,54.8,45.2,00000
91.0,8.0,40.0,284,06,01,  Purba Kayesta Para,293,189,153,88,140,101,60.8,63.5,58.1,00000
91.0,8.0,40.0,355,01,01,  Ilashpur,1136,582,607,271,529,311,66.1,69.1,63.0,00000
91.0,8.0,40.0,355,02,01,  Budarpur,110,56,51,33,59,23,66.3,60.7,72.0,00000
91.0,8.0,40.0,418,01,01,  Kalasara,257,194,126,87,131,107,57.0,59.2,55.0,00000
91.0,8.0,40.0,418,02,01,  Nagari Kapan,239,244,112,117,127,127,49.5,48.9,50.0,00000
91.0,8.0,40.0,418,03,01,  Goala Bazar,888,374,515,183,373,191,70.4,73.8,66.1,00000
91.0,8.0,40.0,418,04,01,  Taltala,115,120,61,61,54,59,48.9,50.0,47.8,00000
91.0,8.0,40.0,698,01,01,  Nij Karanshi,820,440,415,202,405,238,65.1,67.3,63.0,00000
91.0,8.0,40.0,698,02,01,  Nayarai,171,57,86,32,85,25,75.0,72.9,77.3,00000
91.0,8.0,40.0,698,03,01,  Bherukola,161,146,79,77,82,69,52.4,50.6,54.3,00000
91.0,8.0,40.0,698,04,01,  Awatoil,283,270,144,132,139,138,51.2,52.2,50.2,00000
91.0,8.0,40.0,698,05,01,  Mantail,150,38,71,20,79,18,79.8,78.0,81.4,00000
91.0,8.0,40.0,865,01,01,  Sasarkandi,337,171,170,76,167,95,66.3,69.1,63.7,00000
91.0,8.0,40.0,865,02,01,  Mobarakpur,90,46,50,22,40,24,66.2,69.4,62.5,00000
91.0,8.0,40.0,865,03,01,  Ekarai,279,100,149,46,130,54,73.6,76.4,70.7,00000
91.0,8.0,40.0,969,01,01,  Terahati,605,385,347,193,258,192,61.1,64.3,57.3,00000
91.0,8.0,40.0,969,02,01,  Kuchkurai,183,196,98,104,85,92,48.3,48.5,48.0,00000
91.0,8.0,40.0,969,03,01,  Kuchbubai,224,180,107,85,117,95,55.4,55.7,55.2,00000
91.0,8.0,40.0,969,04,01,  Datta Kapan,21,9,9,3,12,6,70.0,75.0,66.7,00000
91.0,8.0,40.0,985,01,01,  Uttar Nurpur,276,320,141,157,135,163,46.3,47.3,45.3,00000
91.0,8.0,40.0,985,02,01,  Jahirpur,219,192,112,92,107,100,53.3,54.9,51.7,00000
91.0,8.0,51.0,083,01,01,  Tahirpur,124,97,69,48,55,49,56.1,59.0,52.9,00000
91.0,8.0,51.0,083,02,01,  Abdullahpur,163,314,78,173,85,141,34.2,31.1,37.6,00000
91.0,8.0,51.0,217,01,01,  Dulalpur,23,30,14,12,9,18,43.4,53.8,33.3,00000
91.0,8.0,51.0,217,02,01,  Itachaki,111,56,57,18,54,38,66.5,76.0,58.7,00000
91.0,8.0,51.0,217,03,01,  Kalia,41,54,22,24,19,30,43.2,47.8,38.8,00000
91.0,8.0,51.0,326,01,01,  Hijalshua,201,262,103,129,98,133,43.4,44.4,42.4,00000
91.0,8.0,51.0,326,02,01,  Lama Hijalshua,70,109,38,63,32,46,39.1,37.6,41.0,00000
91.0,8.0,51.0,359,01,01,  Lama Isabpur,738,478,377,218,361,260,60.7,63.4,58.1,00000
91.0,8.0,51.0,359,02,01,  Bara Isabpur,849,878,451,411,398,467,49.2,52.3,46.0,00000
91.0,8.0,51.0,476,01,01,  Khadimpur,939,762,470,369,469,393,55.2,56.0,54.4,00000
91.0,8.0,51.0,476,02,01,  Naya Khadimpur,141,139,69,70,72,69,50.4,49.6,51.1,00000
91.0,8.0,51.0,526,01,01,  Kotwalpur,441,288,221,130,220,158,60.5,63.0,58.2,00000
91.0,8.0,51.0,526,02,01,  Habashpur,90,169,54,81,36,88,34.7,40.0,29.0,00000
91.0,8.0,51.0,526,03,01,  Banagram,178,153,92,76,86,77,53.8,54.8,52.8,00000
91.0,8.0,51.0,585,01,01,  Malihani,915,965,456,483,459,482,48.7,48.6,48.8,00000
91.0,8.0,51.0,585,02,01,  Aushpur,78,314,34,139,44,175,19.9,19.7,20.1,00000
91.0,8.0,51.0,597,01,01,  Mandaruka,149,145,71,78,78,67,50.7,47.7,53.8,00000
91.0,8.0,51.0,597,02,01,  Shibpur,40,34,22,15,18,19,54.1,59.5,48.6,00000
91.0,8.0,51.0,597,03,01,  Nij Mandaruka,371,263,199,129,172,134,58.5,60.7,56.2,00000
91.0,8.0,51.0,597,04,01,  Majidpur,56,60,24,25,32,35,48.3,49.0,47.8,00000
91.0,8.0,51.0,597,05,01,  Pazra Golpur,100,112,47,63,53,49,47.2,42.7,52.0,00000
91.0,8.0,51.0,610,01,01,  Mirzapur,61,42,29,18,32,24,59.2,61.7,57.1,00000
91.0,8.0,51.0,610,02,01,  Rangborang,73,75,37,38,36,37,49.3,49.3,49.3,00000
91.0,8.0,51.0,614,01,01,  Madhabpur,67,117,32,59,35,58,36.4,35.2,37.6,00000
91.0,8.0,51.0,614,02,01,  Saidpur,681,481,334,223,347,258,58.6,60.0,57.4,00000
91.0,8.0,51.0,744,01,01,  Mollah Para,287,224,148,104,139,120,56.2,58.7,53.7,00000
91.0,8.0,51.0,744,02,01,  Maijgaon,429,241,202,123,227,118,64.0,62.2,65.8,00000
91.0,8.0,51.0,744,03,01,  Purbagram,203,85,95,36,108,49,70.5,72.5,68.8,00000
91.0,8.0,51.0,744,04,01,  Paschimgram,261,339,143,151,118,188,43.5,48.6,38.6,00000
91.0,8.0,51.0,744,05,01,  Bhorout,37,88,16,49,21,39,29.6,24.6,35.0,00000
91.0,8.0,51.0,749,01,01,  Omarpur Bazar,66,254,51,169,15,85,20.6,23.2,15.0,00000
91.0,8.0,51.0,749,02,01,  Khujkipur,447,525,230,248,217,277,46.0,48.1,43.9,00000
91.0,8.0,51.0,877,01,01,  Shahjahanpur,260,257,135,125,125,132,50.3,51.9,48.6,00000
91.0,8.0,51.0,877,02,01,  Matikara,33,81,20,44,13,37,28.9,31.3,26.0,00000
91.0,8.0,51.0,877,03,01,  Aditaypur,18,68,12,34,6,34,20.9,26.1,15.0,00000
91.0,8.0,55.0,037,01,01,  Alipur,202,292,98,146,104,146,40.9,40.2,41.6,00000
91.0,8.0,55.0,037,02,01,  Shamaspur,64,49,35,26,29,23,56.6,57.4,55.8,00000
91.0,8.0,55.0,154,01,01,  Brahman Shasan,353,161,194,56,159,105,68.7,77.6,60.2,00000
91.0,8.0,55.0,154,02,01,  Mandar Kapan,30,12,21,5,9,7,71.4,80.8,56.3,00000
91.0,8.0,55.0,177,01,01,  Raghupur,126,189,50,92,76,97,40.0,35.2,43.9,00000
91.0,8.0,55.0,177,02,01,  Atapur (Adilpur),32,28,13,13,19,15,53.3,50.0,55.9,00000
91.0,8.0,55.0,346,01,01,  Ichhamati,235,427,88,199,147,228,35.5,30.7,39.2,00000
91.0,8.0,55.0,346,02,01,  Chak Ichhamati,75,25,36,15,39,10,75.0,70.6,79.6,00000
91.0,8.0,55.0,346,03,01,  Hossainpur,227,213,111,105,116,108,51.6,51.4,51.8,00000
91.0,8.0,55.0,392,01,01,  Kabulpur,236,41,129,15,107,26,85.2,89.6,80.5,00000
91.0,8.0,55.0,392,02,01,  Abdullahpur,213,160,103,93,110,67,57.1,52.6,62.1,00000
91.0,8.0,55.0,505,01,01,  Atgaon (Khajmahal),228,176,128,82,100,94,56.4,61.0,51.5,00000
91.0,8.0,55.0,505,02,01,  Kazirgaon,168,286,79,134,89,152,37.0,37.1,36.9,00000
91.0,8.0,55.0,505,03,01,  Gopalpur,110,108,61,47,49,61,50.5,56.5,44.5,00000
91.0,8.0,55.0,635,01,01,  Mominpur,339,696,151,335,188,361,32.8,31.1,34.2,00000
91.0,8.0,55.0,635,02,01,  Mirpur,258,139,140,62,118,77,65.0,69.3,60.5,00000
91.0,8.0,55.0,719,01,01,  Osmanpur,231,198,110,92,121,106,53.8,54.5,53.3,00000
91.0,8.0,55.0,719,02,01,  Mahabbatpur,60,29,29,18,31,11,67.4,61.7,73.8,00000
91.0,8.0,55.0,719,03,01,  Mirzapur,83,53,40,27,43,26,61.0,59.7,62.3,00000
91.0,8.0,55.0,719,04,01,  Raji Haji,35,20,19,10,16,10,63.6,65.5,61.5,00000
91.0,8.0,55.0,719,05,01,  Shibrampur,201,114,112,57,89,57,63.8,66.3,61.0,00000
91.0,8.0,55.0,719,06,01,  Satiya,37,13,22,6,15,7,74.0,78.6,68.2,00000
91.0,8.0,55.0,743,01,01,  Uttar Kamarpur,214,176,101,78,113,98,54.9,56.4,53.6,00000
91.0,8.0,55.0,743,02,01,  Kitti Kamarpur,296,42,148,12,148,30,87.6,92.5,83.1,00000
91.0,8.0,55.0,815,01,01,  Rautkhai,801,806,374,403,427,403,49.8,48.1,51.4,00000
91.0,8.0,55.0,815,02,01,  Burburia,26,50,16,30,10,20,34.2,34.8,33.3,00000
91.0,8.0,55.0,815,03,01,  Bibi Shaida,84,158,39,82,45,76,34.7,32.2,37.2,00000
91.0,8.0,55.0,882,01,01,  Char Subia,84,60,53,27,31,33,58.3,66.3,48.4,00000
91.0,8.0,55.0,882,02,01,  Bharakhal (Sharifnagar),324,232,158,108,166,124,58.3,59.4,57.2,00000
91.0,8.0,55.0,919,01,01,  Sultanabad,573,821,280,389,293,432,41.1,41.9,40.4,00000
91.0,8.0,55.0,919,02,01,  Nayamatpur,101,220,46,114,55,106,31.5,28.8,34.2,00000
91.0,8.0,55.0,974,01,01,  Kunaban,405,359,211,185,194,174,53.0,53.3,52.7,00000
91.0,8.0,55.0,974,02,01,  Betkhai,228,195,94,91,134,104,53.9,50.8,56.3,00000
91.0,8.0,55.0,974,03,01,  Barshel\Majidpara,345,317,168,153,177,164,52.1,52.3,51.9,00000
91.0,8.0,55.0,974,04,01,  Kutubpur,49,7,27,1,22,6,87.5,96.4,78.6,00000
91.0,8.0,55.0,974,05,01,  Thanagaon (Majpara),603,448,293,214,310,234,57.4,57.8,57.0,00000
91.0,8.0,60.0,062,01,01,  Atasan,1204,1439,571,682,633,757,45.6,45.6,45.5,00000
91.0,8.0,60.0,062,02,01,  Baburgaon,134,30,73,9,61,21,81.7,89.0,74.4,00000
91.0,8.0,60.0,071,01,01,  Azizpur,554,360,285,197,269,163,60.6,59.1,62.3,00000
91.0,8.0,60.0,071,02,01,  Badarpur,21,17,10,7,11,10,55.3,58.8,52.4,00000
91.0,8.0,60.0,213,01,01,  Dohalia,74,162,26,79,48,83,31.4,24.8,36.6,00000
91.0,8.0,60.0,213,02,01,  Alampur,163,301,67,161,96,140,35.1,29.4,40.7,00000
91.0,8.0,60.0,229,01,01,  Ekachikan,103,145,55,73,48,72,41.5,43.0,40.0,00000
91.0,8.0,60.0,229,02,01,  Lohamura,239,97,124,38,115,59,71.1,76.5,66.1,00000
91.0,8.0,60.0,664,01,01,  Naljur,352,416,144,206,208,210,45.8,41.1,49.8,00000
91.0,8.0,60.0,664,02,01,  Saraspur,205,170,96,77,109,93,54.7,55.5,54.0,00000
91.0,8.0,60.0,664,03,01,  Shashipur,28,22,13,9,15,13,56.0,59.1,53.6,00000
91.0,8.0,60.0,664,04,01,  Bashirpur,37,25,23,14,14,11,59.7,62.2,56.0,00000
91.0,8.0,64.0,091,01,01,  Bakshipur,207,315,117,148,90,167,39.7,44.2,35.0,00000
91.0,8.0,64.0,091,02,01,  Jamjamia,215,248,111,117,104,131,46.4,48.7,44.3,00000
91.0,8.0,64.0,091,03,01,  Mangalpur,139,171,75,67,64,104,44.8,52.8,38.1,00000
91.0,8.0,64.0,114,01,01,  Adampur,139,145,77,55,62,90,48.9,58.3,40.8,00000
91.0,8.0,64.0,114,02,01,  Chandpur,125,217,63,114,62,103,36.5,35.6,37.6,00000
91.0,8.0,64.0,118,01,01,  Mobarakpur,194,145,97,77,97,68,57.2,55.7,58.8,00000
91.0,8.0,64.0,118,02,01,  Daulatpur,113,127,61,65,52,62,47.1,48.4,45.6,00000
91.0,8.0,64.0,255,01,01,  Joinpur,28,63,12,31,16,32,30.8,27.9,33.3,00000
91.0,8.0,64.0,255,02,01,  Golmu Kapan,896,379,515,191,381,188,70.3,72.9,67.0,00000
91.0,8.0,64.0,472,01,01,  Keampur,383,148,195,60,188,88,72.1,76.5,68.1,00000
91.0,8.0,64.0,472,02,01,  Ahmedpur,31,11,18,2,13,9,73.8,90.0,59.1,00000
91.0,8.0,64.0,643,01,01,  Mostafapur,150,250,79,116,71,134,37.5,40.5,34.6,00000
91.0,8.0,64.0,643,02,01,  Kharukona,147,128,72,66,75,62,53.5,52.2,54.7,00000
91.0,8.0,64.0,794,01,01,  Ramkrishnapur,116,134,64,66,52,68,46.4,49.2,43.3,00000
91.0,8.0,64.0,794,02,01,  Jagirpur,53,199,26,90,27,109,21.0,22.4,19.9,00000
91.0,8.0,64.0,940,01,01,  Tafurpur,85,120,44,55,41,65,41.5,44.4,38.7,00000
91.0,8.0,64.0,940,02,01,  Ekamadhu,10,3,5,1,5,2,76.9,83.3,71.4,00000
91.0,8.0,64.0,940,03,01,  Mashadia,74,83,42,37,32,46,47.1,53.2,41.0,00000
91.0,8.0,64.0,988,01,01,  Ziapur,32,48,15,25,17,23,40.0,37.5,42.5,00000
91.0,8.0,64.0,988,02,01,  Hajipur,718,479,329,215,389,264,60.0,60.5,59.6,00000
91.0,8.0,64.0,988,03,01,  Khayerpur,34,9,18,6,16,3,79.1,75.0,84.2,00000
91.0,8.0,67.0,351,01,01,  Ichhapur Purba,240,508,120,253,120,255,32.1,32.2,32.0,00000
91.0,8.0,67.0,351,02,01,  Ichhapur Pashim,211,368,105,170,106,198,36.4,38.2,34.9,00000
91.0,8.0,67.0,376,01,01,  Jalalpur,437,919,194,444,243,475,32.2,30.4,33.8,00000
91.0,8.0,67.0,376,02,01,  Galimpur,298,323,143,131,155,192,48.0,52.2,44.7,00000
91.0,8.0,67.0,376,03,01,  Kitti Jalalpur,141,742,76,337,65,405,16.0,18.4,13.8,00000
91.0,8.0,67.0,723,01,01,  Fajilpur,248,426,116,200,132,226,36.8,36.7,36.9,00000
91.0,8.0,67.0,723,02,01,  Pailanpur,344,816,170,397,174,419,29.7,30.0,29.3,00000
91.0,8.0,67.0,723,03,01,  Butpara,75,151,43,69,32,82,33.2,38.4,28.1,00000
91.0,8.0,70.0,459,01,01,  Kayesthaghat,835,855,384,385,451,470,49.4,49.9,49.0,00000
91.0,8.0,70.0,459,02,01,  Kunamadhurai,110,113,51,57,59,56,49.3,47.2,51.3,00000
91.0,8.0,70.0,459,03,01,  Binodpur,239,167,109,82,130,85,58.9,57.1,60.5,00000
91.0,8.0,70.0,459,04,01,  Narikhola,71,64,29,40,42,24,52.6,42.0,63.6,00000
91.0,8.0,70.0,459,05,01,  Kandigaon,96,172,45,80,51,92,35.8,36.0,35.7,00000
91.0,8.0,70.0,459,06,01,  Purba Dekapur,742,404,344,179,398,225,64.7,65.8,63.9,00000
91.0,8.0,70.0,459,07,01,  Paschim Dekapur,606,286,279,141,327,145,67.9,66.4,69.3,00000
91.0,8.0,70.0,564,01,01,  Maishasi,937,903,462,412,475,491,50.9,52.9,49.2,00000
91.0,8.0,70.0,564,02,01,  Hamidpur,403,255,175,124,228,131,61.2,58.5,63.5,00000
91.0,8.0,70.0,564,03,01,  Sadikpur,301,125,152,51,149,74,70.7,74.9,66.8,00000
91.0,8.0,70.0,928,01,01,  Natun Sunampur,383,450,179,228,204,222,46.0,44.0,47.9,00000
91.0,8.0,70.0,928,02,01,  Mirar Char,70,113,28,62,42,51,38.3,31.1,45.2,00000
91.0,8.0,70.0,957,01,01,  Uttar Rukanpur,82,96,33,48,49,48,46.1,40.7,50.5,00000
91.0,8.0,70.0,957,02,01,  Taharbahar,246,230,115,117,131,113,51.7,49.6,53.7,00000
91.0,8.0,81.0,163,01,01,  Char Tajpur,127,484,68,230,59,254,20.8,22.8,18.8,00000
91.0,8.0,81.0,163,02,01,  Purba Tajpur,520,500,261,223,259,277,51.0,53.9,48.3,00000
91.0,8.0,81.0,163,03,01,  Lama Tajpur,395,369,191,189,204,180,51.7,50.3,53.1,00000
91.0,8.0,81.0,163,04,01,  Chargaon,439,431,236,196,203,235,50.5,54.6,46.3,00000
91.0,8.0,81.0,242,01,01,  Nalikona,41,182,18,90,23,92,18.4,16.7,20.0,00000
91.0,8.0,81.0,242,02,01,  Lama Gaburtaki,609,504,281,249,328,255,54.7,53.0,56.3,00000
91.0,8.0,81.0,246,01,01,  Gaburtaki,198,201,102,93,96,108,49.6,52.3,47.1,00000
91.0,8.0,81.0,246,02,01,  Andhair Chak,103,113,59,53,44,60,47.7,52.7,42.3,00000
91.0,8.0,81.0,501,01,01,  Khasrupur,768,1082,397,473,371,609,41.5,45.6,37.9,00000
91.0,8.0,81.0,501,02,01,  Khasrupur Bazar,50,25,26,14,24,11,66.7,65.0,68.6,00000
91.0,8.0,81.0,501,03,01,  Darkha,425,789,242,375,183,414,35.0,39.2,30.7,00000
91.0,8.0,81.0,501,04,01,  Mirpur,117,151,60,66,57,85,43.7,47.6,40.1,00000
91.0,8.0,81.0,501,05,01,  Kurpur,125,115,60,51,65,64,52.1,54.1,50.4,00000
91.0,8.0,81.0,836,01,01,  Sadipur,854,741,434,356,420,385,53.5,54.9,52.2,00000
91.0,8.0,81.0,836,02,01,  Sadipur Bazar,353,180,186,109,167,71,66.2,63.1,70.2,00000
91.0,8.0,81.0,848,01,01,  Saidpur,376,491,184,233,192,258,43.4,44.1,42.7,00000
91.0,8.0,81.0,848,02,01,  Palpara,70,83,36,35,34,48,45.8,50.7,41.5,00000
91.0,8.0,81.0,861,01,01,  Purba Kalanir Char,248,362,130,180,118,182,40.7,41.9,39.3,00000
91.0,8.0,81.0,861,02,01,  Uttar Kalanir Char,307,366,149,176,158,190,45.6,45.8,45.4,00000
91.0,8.0,81.0,861,03,01,  Dakshin Kalanir Char,414,563,197,274,217,289,42.4,41.8,42.9,00000
91.0,8.0,81.0,861,04,01,  Chatalpar,406,645,185,309,221,336,38.6,37.4,39.7,00000
91.0,8.0,81.0,861,05,01,  Rahmatpur,318,551,152,263,166,288,36.6,36.6,36.6,00000
91.0,8.0,81.0,977,01,01,  Purba Mobarakpur,238,200,108,100,130,100,54.3,51.9,56.5,00000
91.0,8.0,81.0,977,02,01,  Paschim Mobarakpur,309,178,156,91,153,87,63.4,63.2,63.8,00000
91.0,8.0,88.0,112,01,01,  Baraya,932,561,453,257,479,304,62.4,63.8,61.2,00000
91.0,8.0,88.0,112,02,01,  Tajpur Bazar,329,136,187,64,142,72,70.8,74.5,66.4,00000
91.0,8.0,88.0,112,03,01,  Chandpur,256,170,137,82,119,88,60.1,62.6,57.5,00000
91.0,8.0,88.0,137,01,01,  Bharera,518,594,271,298,247,296,46.6,47.6,45.5,00000
91.0,8.0,88.0,137,02,01,  Char Bharera,159,160,86,72,73,88,49.8,54.4,45.3,00000
91.0,8.0,88.0,137,03,01,  Bharera Madarpur,320,228,157,103,163,125,58.4,60.4,56.6,00000
91.0,8.0,88.0,179,01,01,  Dashal,272,506,115,241,157,265,35.0,32.3,37.2,00000
91.0,8.0,88.0,179,02,01,  Sultanpur,62,163,33,87,29,76,27.6,27.5,27.6,00000
91.0,8.0,88.0,225,01,01,  Durajpur,286,491,142,238,144,253,36.8,37.4,36.3,00000
91.0,8.0,88.0,225,02,01,  Rangia,378,179,199,77,179,102,67.9,72.1,63.7,00000
91.0,8.0,88.0,225,03,01,  Gayeshpur,132,70,66,28,66,42,65.3,70.2,61.1,00000
91.0,8.0,88.0,286,01,01,  Matihni,15,15,9,4,6,11,50.0,69.2,35.3,00000
91.0,8.0,88.0,286,02,01,  Fatehpur,260,153,129,68,131,85,63.0,65.5,60.6,00000
91.0,8.0,88.0,372,01,01,  Jahapur,81,78,41,35,40,43,50.9,53.9,48.2,00000
91.0,8.0,88.0,372,02,01,  Kaminikandi,231,195,126,92,105,103,54.2,57.8,50.5,00000
91.0,8.0,88.0,372,03,01,  Khod Bharera,25,32,11,18,14,14,43.9,37.9,50.0,00000
91.0,8.0,88.0,384,01,01,  Jiafak,49,39,30,17,19,22,55.7,63.8,46.3,00000
91.0,8.0,88.0,384,02,01,  Kalasar,82,66,43,37,39,29,55.4,53.8,57.4,00000
91.0,8.0,88.0,384,03,01,  Hasthipur,233,320,129,169,104,151,42.1,43.3,40.8,00000
91.0,8.0,88.0,397,01,01,  Kadipur,910,1028,481,521,429,507,47.0,48.0,45.8,00000
91.0,8.0,88.0,397,02,01,  Palpara (Tagari),140,147,78,67,62,80,48.8,53.8,43.7,00000
91.0,8.0,88.0,451,01,01,  Kashi Para,339,423,180,196,159,227,44.5,47.9,41.2,00000
91.0,8.0,88.0,451,02,01,  Haripur,387,221,195,98,192,123,63.7,66.6,61.0,00000
91.0,8.0,88.0,497,01,01,  Kashi Kapan,674,433,358,197,316,236,60.9,64.5,57.2,00000
91.0,8.0,88.0,497,02,01,  Silmanpur,276,110,138,44,138,66,71.5,75.8,67.6,00000
91.0,8.0,88.0,539,01,01,  Lalkailash,373,54,199,20,174,34,87.4,90.9,83.7,00000
91.0,8.0,88.0,539,02,01,  Mokam Para,410,169,218,71,192,98,70.8,75.4,66.2,00000
91.0,8.0,88.0,560,01,01,  Pichrakandi,88,264,43,128,45,136,25.0,25.1,24.9,00000
91.0,8.0,88.0,560,02,01,  Char Isabpur,387,380,192,181,195,199,50.5,51.5,49.5,00000
91.0,8.0,88.0,560,03,01,  Sonaikandi,17,118,6,55,11,63,12.6,9.8,14.9,00000
91.0,8.0,88.0,560,04,01,  Natpur,10,283,4,147,6,136,3.4,2.6,4.2,00000
91.0,8.0,88.0,660,01,01,  Nakirkona,159,209,88,93,71,116,43.2,48.6,38.0,00000
91.0,8.0,88.0,660,02,01,  Purba Rukanpur,106,124,52,64,54,60,46.1,44.8,47.4,00000
91.0,8.0,88.0,660,03,01,  Paschim Rukanpur,204,629,107,303,97,326,24.5,26.1,22.9,00000
91.0,8.0,88.0,760,01,01,  Mollah Para,222,287,119,116,103,171,43.6,50.6,37.6,00000
91.0,8.0,88.0,760,02,01,  Ekashani,16,30,6,15,10,15,34.8,28.6,40.0,00000
91.0,8.0,88.0,769,01,01,  Rabidas,466,528,233,242,233,286,46.9,49.1,44.9,00000
91.0,8.0,88.0,769,02,01,  Sonar Para,51,456,26,216,25,240,10.1,10.7,9.4,00000
91.0,8.0,88.0,769,03,01,  Fatehpur,71,106,43,57,28,49,40.1,43.0,36.4,00000
91.0,8.0,88.0,769,04,01,  Udarkona,164,127,81,66,83,61,56.4,55.1,57.6,00000
91.0,8.0,88.0,976,01,01,  Rahpur,22,16,10,9,12,7,57.9,52.6,63.2,00000
91.0,8.0,88.0,976,02,01,  Uttar Majlishpur,571,358,282,177,289,181,61.5,61.4,61.5,00000
91.0,8.0,88.0,976,03,01,  Tajpur,433,346,254,158,179,188,55.6,61.7,48.8,00000
91.0,17.0,11.0,192,01,01,  Chandagaon,1926,741,951,291,975,450,72.2,76.6,68.4,00000
91.0,17.0,11.0,192,02,01,  Fulmalik,189,128,91,85,98,43,59.6,51.7,69.5,00000
91.0,17.0,14.0,158,01,01,  Chhota Mollahpur,1199,594,612,255,587,339,66.9,70.6,63.4,00000
91.0,17.0,14.0,158,02,01,  Nidhanpur Part,378,239,184,92,194,147,61.3,66.7,56.9,00000
91.0,17.0,14.0,439,01,01,  Jaldhup Patan,679,279,326,119,353,160,70.9,73.3,68.8,00000
91.0,17.0,14.0,439,02,01,  Ushpar,479,138,221,48,258,90,77.6,82.2,74.1,00000
91.0,17.0,14.0,439,03,01,  Lama Patan,597,334,281,157,316,177,64.1,64.2,64.1,00000
91.0,17.0,14.0,645,01,01,  Matikata,676,433,329,204,347,229,61.0,61.7,60.2,00000
91.0,17.0,14.0,645,02,01,  Katcha,510,291,269,133,241,158,63.7,66.9,60.4,00000
91.0,17.0,14.0,645,03,01,  Baur Bag,208,118,104,58,104,60,63.8,64.2,63.4,00000
91.0,17.0,25.0,020,01,01,  Konagram,210,396,109,214,101,182,34.7,33.7,35.7,00000
91.0,17.0,25.0,020,02,01,  Khapan,267,85,135,34,132,51,75.9,79.9,72.1,00000
91.0,17.0,25.0,020,03,01,  Dalakhali,315,343,170,156,145,187,47.9,52.1,43.7,00000
91.0,17.0,25.0,020,04,01,  Rahmat Khani,237,100,117,51,120,49,70.3,69.6,71.0,00000
91.0,17.0,25.0,020,05,01,  Adinabad,534,246,282,103,252,143,68.5,73.2,63.8,00000
91.0,17.0,25.0,020,06,01,  Madhur Chak,420,201,212,100,208,101,67.6,67.9,67.3,00000
91.0,17.0,25.0,082,01,01,  Baghbari,543,457,254,208,289,249,54.3,55.0,53.7,00000
91.0,17.0,25.0,082,02,01,  Poegram,165,85,101,43,64,42,66.0,70.1,60.4,00000
91.0,17.0,25.0,185,01,01,  Chak Rabbani,1013,346,537,159,476,187,74.5,77.2,71.8,00000
91.0,17.0,25.0,185,02,01,  Ramashid,278,75,142,41,136,34,78.8,77.6,80.0,00000
91.0,17.0,25.0,301,01,01,  Deulgram,455,369,227,175,228,194,55.2,56.5,54.0,00000
91.0,17.0,25.0,301,02,01,  Patan,466,167,227,68,239,99,73.6,76.9,70.7,00000
91.0,17.0,25.0,391,01,01,  Gola,288,111,131,63,157,48,72.2,67.5,76.6,00000
91.0,17.0,25.0,391,02,01,  Baban Chak,217,281,104,147,113,134,43.6,41.4,45.7,00000
91.0,17.0,25.0,391,03,01,  Nayagram,391,295,180,135,211,160,57.0,57.1,56.9,00000
91.0,17.0,25.0,404,01,01,  Uttar Hajra Para,60,20,36,9,24,11,75.0,80.0,68.6,00000
91.0,17.0,25.0,404,02,01,  Dakshin Hajra Para,395,235,228,116,167,119,62.7,66.3,58.4,00000
91.0,17.0,25.0,432,01,01,  Munshir Chak,388,167,208,74,180,93,69.9,73.8,65.9,00000
91.0,17.0,25.0,432,02,01,  Jalalnagar,393,731,200,364,193,367,35.0,35.5,34.5,00000
91.0,17.0,25.0,432,03,01,  Dahal,206,146,115,69,91,77,58.5,62.5,54.2,00000
91.0,17.0,25.0,432,04,01,  Sayed Kotba,111,35,56,14,55,21,76.0,80.0,72.4,00000
91.0,17.0,25.0,459,01,01,  Baraigram,451,225,240,92,211,133,66.7,72.3,61.3,00000
91.0,17.0,25.0,459,02,01,  Purba Kachkatkha,270,134,161,67,109,67,66.8,70.6,61.9,00000
91.0,17.0,25.0,487,01,01,  Kamargram,404,227,227,108,177,119,64.0,67.8,59.8,00000
91.0,17.0,25.0,487,02,01,  Noakhani,501,265,277,115,224,150,65.4,70.7,59.9,00000
91.0,17.0,25.0,754,01,01,  Pally Shasan,227,112,109,49,118,63,67.0,69.0,65.2,00000
91.0,17.0,25.0,754,02,01,  Niar Chak,148,191,64,93,84,98,43.7,40.8,46.2,00000
91.0,17.0,25.0,754,03,01,  Mohanpur,70,130,39,65,31,65,35.0,37.5,32.3,00000
91.0,17.0,25.0,830,01,01,  Safa,279,263,132,137,147,126,51.5,49.1,53.8,00000
91.0,17.0,43.0,027,01,01,  Uttar Akakhajana,726,524,339,226,387,298,58.1,60.0,56.5,00000
91.0,17.0,43.0,027,02,01,  Angura Bazar,175,197,86,101,89,96,47.0,46.0,48.1,00000
91.0,17.0,43.0,027,03,01,  Akakhajana,873,657,423,328,450,329,57.1,56.3,57.8,00000
91.0,17.0,43.0,590,01,01,  Paschim Laujhari,320,141,170,66,150,75,69.4,72.0,66.7,00000
91.0,17.0,43.0,590,02,01,  Purba Laujhari,349,180,176,71,173,109,66.0,71.3,61.3,00000
91.0,17.0,43.0,590,03,01,  Gararbanda,863,894,439,382,424,512,49.1,53.5,45.3,00000
91.0,17.0,43.0,590,04,01,  Debasree,220,359,99,165,121,194,38.0,37.5,38.4,00000
91.0,17.0,51.0,089,01,01,  Baghprachanda Khan,674,1005,316,490,358,515,40.1,39.2,41.0,00000
91.0,17.0,51.0,089,02,01,  Gajarai,656,902,314,422,342,480,42.1,42.7,41.6,00000
91.0,17.0,51.0,089,03,01,  Tikar Para,1160,1696,583,793,577,903,40.6,42.4,39.0,00000
91.0,17.0,51.0,089,04,01,  Dakshin Patti,222,244,105,109,117,135,47.6,49.1,46.4,00000
91.0,17.0,51.0,439,01,01,  Jaldhup,1035,902,497,426,538,476,53.4,53.8,53.1,00000
91.0,17.0,51.0,439,02,01,  Astashangan,417,139,201,57,216,82,75.0,77.9,72.5,00000
91.0,17.0,51.0,439,03,01,  Kasi Bahar,144,170,72,77,72,93,45.9,48.3,43.6,00000
91.0,17.0,51.0,446,01,01,  Jaldhup Kalaura,1053,593,508,260,545,333,64.0,66.1,62.1,00000
91.0,17.0,51.0,446,02,01,  Kanli,366,135,158,51,208,84,73.1,75.6,71.2,00000
91.0,17.0,51.0,768,01,01,  Paria Bahar,544,1022,281,499,263,523,34.7,36.0,33.5,00000
91.0,17.0,51.0,768,02,01,  Uttar Paria Bahar,649,381,324,173,325,208,63.0,65.2,61.0,00000
91.0,17.0,60.0,631,01,01,  Durdhabkushi,1277,541,686,255,591,286,70.2,72.9,67.4,00000
91.0,17.0,60.0,631,02,01,  Roybanshi,222,252,126,116,96,136,46.8,52.1,41.4,00000
91.0,17.0,60.0,631,03,01,  Paschimpar,1388,755,735,362,653,393,64.8,67.0,62.4,00000
91.0,17.0,60.0,631,04,01,  Uttarpar,629,173,327,67,302,106,78.4,83.0,74.0,00000
91.0,17.0,60.0,631,05,01,  Purbapar,1598,654,840,271,758,383,71.0,75.6,66.4,00000
91.0,17.0,86.0,946,01,01,  Teradal,901,376,452,135,449,241,70.6,77.0,65.1,00000
91.0,17.0,86.0,946,02,01,  Alipur,207,126,115,45,92,81,62.2,71.9,53.2,00000
91.0,20.0,10.0,017,01,01,  Alankari,521,477,272,225,249,252,52.2,54.7,49.7,00000
91.0,20.0,10.0,017,02,01,  Agarkandi,46,51,25,24,21,27,47.4,51.0,43.8,00000
91.0,20.0,10.0,060,01,01,  Nabhag Manukupa,182,200,81,106,101,94,47.6,43.3,51.8,00000
91.0,20.0,10.0,060,02,01,  Hayaterrgaon,50,64,20,27,30,37,43.9,42.6,44.8,00000
91.0,20.0,10.0,060,03,01,  Madhabpur,123,96,63,41,60,55,56.2,60.6,52.2,00000
91.0,20.0,10.0,121,01,01,  Betsandi,388,379,177,185,211,194,50.6,48.9,52.1,00000
91.0,20.0,10.0,121,02,01,  Bhabangaon,317,373,155,187,162,186,45.9,45.3,46.6,00000
91.0,20.0,10.0,121,03,01,  Chan Kharigaon,176,174,82,76,94,98,50.3,51.9,49.0,00000
91.0,20.0,10.0,121,04,01,  Alamnagar,283,258,133,125,150,133,52.3,51.6,53.0,00000
91.0,20.0,10.0,121,05,01,  Guran,93,144,46,67,47,77,39.2,40.7,37.9,00000
91.0,20.0,10.0,129,01,01,  Bhagmatpur,29,21,18,10,11,11,58.0,64.3,50.0,00000
91.0,20.0,10.0,129,02,01,  Kirpakhli,80,146,45,63,35,83,35.4,41.7,29.7,00000
91.0,20.0,10.0,354,01,01,  Farhadpur,226,225,105,116,121,109,50.1,47.5,52.6,00000
91.0,20.0,10.0,354,02,01,  Munshirgaon,188,280,102,139,86,141,40.2,42.3,37.9,00000
91.0,20.0,10.0,354,04,01,  Sekhergaon,48,55,27,25,21,30,46.6,51.9,41.2,00000
91.0,20.0,10.0,510,01,01,  Kamalpur,400,297,201,142,199,155,57.4,58.6,56.2,00000
91.0,20.0,10.0,510,02,01,  Tek Kamalpur,114,110,53,58,61,52,50.9,47.7,54.0,00000
91.0,20.0,10.0,510,03,01,  Ramdhana,781,416,422,185,359,231,65.2,69.5,60.8,00000
91.0,20.0,10.0,510,04,01,  Shekhergaon,233,316,117,153,116,163,42.4,43.3,41.6,00000
91.0,20.0,10.0,571,01,01,  Mirgaon Khurma,194,172,91,84,103,88,53.0,52.0,53.9,00000
91.0,20.0,10.0,571,02,01,  Pechi Khurma,737,532,373,281,364,251,58.1,57.0,59.2,00000
91.0,20.0,10.0,571,03,01,  Uttar Bara Khurma,366,480,149,232,217,248,43.3,39.1,46.7,00000
91.0,20.0,10.0,571,04,01,  Bara Khurma,839,715,408,336,431,379,54.0,54.8,53.2,00000
91.0,20.0,10.0,770,01,01,  Pitakara,179,284,77,141,102,143,38.7,35.3,41.6,00000
91.0,20.0,10.0,770,02,01,  Alamnagar,62,83,35,41,27,42,42.8,46.1,39.1,00000
91.0,20.0,10.0,770,03,01,  Peshkargaon,98,179,41,83,57,96,35.4,33.1,37.3,00000
91.0,20.0,10.0,826,01,01,  Rampur,577,544,286,263,291,281,51.5,52.1,50.9,00000
91.0,20.0,10.0,826,02,01,  Ramair Chak,347,227,176,106,171,121,60.5,62.4,58.6,00000
91.0,20.0,10.0,946,01,01,  Rajibari Peshkargaon,88,96,40,47,48,49,47.8,46.0,49.5,00000
91.0,20.0,10.0,946,02,01,  Rajibari Shekhergaon,81,67,42,27,39,40,54.7,60.9,49.4,00000
91.0,20.0,10.0,946,03,01,  Dargaon,92,58,50,29,42,29,61.3,63.3,59.2,00000
91.0,20.0,10.0,946,04,01,  Haidarpur,255,118,130,64,125,54,68.4,67.0,69.8,00000
91.0,20.0,10.0,946,05,01,  Sutar Para,122,57,55,30,67,27,68.2,64.7,71.3,00000
91.0,20.0,10.0,946,06,01,  Nabhagkharpar,90,87,44,46,46,41,50.8,48.9,52.9,00000
91.0,20.0,10.0,946,07,01,  Laltek,598,556,273,246,325,310,51.8,52.6,51.2,00000
91.0,20.0,10.0,946,08,01,  Talibpur,29,23,19,13,10,10,55.8,59.4,50.0,00000
91.0,20.0,10.0,969,01,01,  Shabsen,328,249,163,115,165,134,56.8,58.6,55.2,00000
91.0,20.0,10.0,969,02,01,  Tengra,622,503,311,220,311,283,55.3,58.6,52.4,00000
91.0,20.0,10.0,969,03,01,  Shaban Tengra,642,410,316,180,326,230,61.0,63.7,58.6,00000
91.0,20.0,10.0,969,04,01,  Chanpur,215,220,109,104,106,116,49.4,51.2,47.7,00000
91.0,20.0,10.0,969,05,01,  Tukarkandi,135,92,68,40,67,52,59.5,63.0,56.3,00000
91.0,20.0,10.0,969,06,01,  Teghari,53,54,27,27,26,27,49.5,50.0,49.1,00000
91.0,20.0,21.0,008,01,03,  Durgapur,388,68,215,30,173,38,85.1,87.8,82.0,00000
91.0,20.0,21.0,008,02,03,  Karikona,605,495,339,220,266,275,55.0,60.6,49.2,00000
91.0,20.0,21.0,008,03,03,  Maharampur,35,15,18,9,17,6,70.0,66.7,73.9,00000
91.0,20.0,21.0,008,04,03,  Baiddya Kapan,104,94,50,48,54,46,52.5,51.0,54.0,00000
91.0,20.0,21.0,008,05,03,  Subirkhal,151,65,84,32,67,33,69.9,72.4,67.0,00000
91.0,20.0,21.0,008,06,03,  Paschim Mandal Kapan,240,217,122,101,118,116,52.5,54.7,50.4,00000
91.0,20.0,21.0,008,07,03,  Purba Mandal Kapan,119,90,68,29,51,61,56.9,70.1,45.5,00000
91.0,20.0,21.0,008,08,03,  Bishwanath,787,790,412,396,375,394,49.9,51.0,48.8,00000
91.0,20.0,21.0,043,01,01,  Atapur,130,236,61,112,69,124,35.5,35.3,35.8,00000
91.0,20.0,21.0,043,02,01,  Rahimpur,51,104,24,47,27,57,32.9,33.8,32.1,00000
91.0,20.0,21.0,043,03,01,  Khaiyakhair,42,127,21,54,21,73,24.9,28.0,22.3,00000
91.0,20.0,21.0,155,01,01,  Bidaisulpani,283,301,144,130,139,171,48.5,52.6,44.8,00000
91.0,20.0,21.0,155,02,01,  Baraigaon,65,47,37,19,28,28,58.0,66.1,50.0,00000
91.0,20.0,21.0,155,03,01,  Harikalash,210,177,106,85,104,92,54.3,55.5,53.1,00000
91.0,20.0,21.0,190,01,03,  Jahargaon,136,117,73,67,63,50,53.8,52.1,55.8,00000
91.0,20.0,21.0,190,02,03,  Sharishpur,476,322,238,174,238,148,59.6,57.8,61.7,00000
91.0,20.0,21.0,190,03,03,  Muktirgaon,369,319,201,150,168,169,53.6,57.3,49.9,00000
91.0,20.0,21.0,190,04,03,  Bishwanath Puran Bazar,425,418,231,207,194,211,50.4,52.7,47.9,00000
91.0,20.0,21.0,190,05,03,  Purba Chandasir Kapan,297,344,175,185,122,159,46.3,48.6,43.4,00000
91.0,20.0,21.0,190,06,03,  Paschim Chandasir Kapan,466,116,238,56,228,60,80.1,81.0,79.2,00000
91.0,20.0,21.0,190,07,03,  Chowdhurygaon,214,153,111,59,103,94,58.3,65.3,52.3,00000
91.0,20.0,21.0,207,01,01,  Naya Sirajpur,86,103,44,44,42,59,45.5,50.0,41.6,00000
91.0,20.0,21.0,207,02,01,  Sirajpur,343,198,172,92,171,106,63.4,65.2,61.7,00000
91.0,20.0,21.0,207,03,01,  Rajakpur,94,229,46,101,48,128,29.1,31.3,27.3,00000
91.0,20.0,21.0,302,01,01,  Dharmada Noagaon,289,142,148,61,141,81,67.1,70.8,63.5,00000
91.0,20.0,21.0,302,02,01,  Taj Maharam,119,107,66,54,53,53,52.7,55.0,50.0,00000
91.0,20.0,21.0,302,03,01,  Rampur,18,71,8,35,10,36,20.2,18.6,21.7,00000
91.0,20.0,21.0,302,04,01,  Baonpur,131,174,74,83,57,91,43.0,47.1,38.5,00000
91.0,20.0,21.0,302,05,01,  Hamidpur,202,117,107,50,95,67,63.3,68.2,58.6,00000
91.0,20.0,21.0,302,06,01,  Elimpur,87,185,41,91,46,94,32.0,31.1,32.9,00000
91.0,20.0,21.0,302,07,01,  Dharmada,333,249,162,122,171,127,57.2,57.0,57.4,00000
91.0,20.0,21.0,311,01,01,  Dhitpur,468,543,226,263,242,280,46.3,46.2,46.4,00000
91.0,20.0,21.0,311,02,01,  Ekabim,130,83,62,39,68,44,61.0,61.4,60.7,00000
91.0,20.0,21.0,311,03,01,  Khaiya Khaiyar Bazar,24,57,19,43,5,14,29.6,30.6,26.3,00000
91.0,20.0,21.0,320,01,01,  Gandhar Kapan,146,145,72,61,74,84,50.2,54.1,46.8,00000
91.0,20.0,21.0,320,02,01,  Gobindapur,128,125,72,50,56,75,50.6,59.0,42.7,00000
91.0,20.0,21.0,458,01,01,  Tatikona,175,215,90,104,85,111,44.9,46.4,43.4,00000
91.0,20.0,21.0,458,02,01,  Sadhugram,237,372,106,180,131,192,38.9,37.1,40.6,00000
91.0,20.0,21.0,622,01,01,  Majlish Bugsail,232,209,127,107,105,102,52.6,54.3,50.7,00000
91.0,20.0,21.0,622,02,01,  Masula,31,24,16,12,15,12,56.4,57.1,55.6,00000
91.0,20.0,21.0,674,01,01,  Dakshin Mirer Char,147,323,87,156,60,167,31.3,35.8,26.4,00000
91.0,20.0,21.0,674,02,01,  Uttar Mirer Char,327,245,176,115,151,130,57.2,60.5,53.7,00000
91.0,20.0,21.0,674,03,01,  Sarishpur,66,73,35,30,31,43,47.5,53.8,41.9,00000
91.0,20.0,21.0,674,04,01,  Durga Kapan,74,204,46,96,28,108,26.6,32.4,20.6,00000
91.0,20.0,21.0,674,05,01,  Goalgaon,61,88,31,40,30,48,40.9,43.7,38.5,00000
91.0,20.0,21.0,674,06,01,  Satrish,190,91,105,44,85,47,67.6,70.5,64.4,00000
91.0,20.0,21.0,674,07,01,  Sabragaon,91,90,50,48,41,42,50.3,51.0,49.4,00000
91.0,20.0,21.0,674,08,01,  Ilamergaon,123,116,61,50,62,66,51.5,55.0,48.4,00000
91.0,20.0,21.0,700,01,03,  Biswanath Natun Bazar,444,690,250,355,194,335,39.2,41.3,36.7,00000
91.0,20.0,21.0,700,02,03,  Bishwanath Station,382,360,186,151,196,209,51.5,55.2,48.4,00000
91.0,20.0,21.0,700,03,03,  Dakshin Musalia,607,659,342,322,265,337,47.9,51.5,44.0,00000
91.0,20.0,21.0,700,04,03,  Uttar Musalia(Janaiya),883,746,480,377,403,369,54.2,56.0,52.2,00000
91.0,20.0,21.0,778,01,03,  Biswaanath Station,1055,589,634,355,421,234,64.2,64.1,64.3,00000
91.0,20.0,21.0,778,02,03,  Janaya Noagaon,380,245,191,117,189,128,60.8,62.0,59.6,00000
91.0,20.0,21.0,778,03,03,  Mollargaon,169,233,94,106,75,127,42.0,47.0,37.1,00000
91.0,20.0,21.0,778,04,03,  Rajnagar,576,699,311,315,265,384,45.2,49.7,40.8,00000
91.0,20.0,21.0,778,05,03,  Shaijirgaon,218,302,109,128,109,174,41.9,46.0,38.5,00000
91.0,20.0,21.0,839,01,01,  Mohammadpur,188,83,97,41,91,42,69.4,70.3,68.4,00000
91.0,20.0,21.0,839,02,01,  Sarishpur,8,7,5,1,3,6,53.3,83.3,33.3,00000
91.0,20.0,21.0,839,03,01,  Rajapur,80,100,49,50,31,50,44.4,49.5,38.3,00000
91.0,20.0,21.0,873,01,01,  Saruala,381,308,179,149,202,159,55.3,54.6,56.0,00000
91.0,20.0,21.0,873,02,01,  Shajan Barat,49,41,26,21,23,20,54.4,55.3,53.5,00000
91.0,20.0,21.0,882,01,01,  Siranisai,19,15,10,9,9,6,55.9,52.6,60.0,00000
91.0,20.0,21.0,882,02,01,  Purba Sasram,359,288,160,141,199,147,55.5,53.2,57.5,00000
91.0,20.0,21.0,882,03,01,  Paschim Sasram,268,198,126,88,142,110,57.5,58.9,56.3,00000
91.0,20.0,21.0,882,04,01,  Abakrapur,98,63,60,28,38,35,60.9,68.2,52.1,00000
91.0,20.0,21.0,908,01,01,  Senergaon,201,103,105,53,96,50,66.1,66.5,65.8,00000
91.0,20.0,21.0,908,02,01,  Boghsail,305,124,162,48,143,76,71.1,77.1,65.3,00000
91.0,20.0,21.0,908,03,01,  Ikbalpur,112,54,54,22,58,32,67.5,71.1,64.4,00000
91.0,20.0,21.0,943,01,01,  Tajpur,72,70,33,35,39,35,50.7,48.5,52.7,00000
91.0,20.0,21.0,943,02,01,  Sadalpur,74,60,34,30,40,30,55.2,53.1,57.1,00000
91.0,20.0,21.0,943,03,01,  Batshala,56,98,20,46,36,52,36.4,30.3,40.9,00000
91.0,20.0,31.0,190,01,01,  Habra,161,137,85,64,76,73,54.0,57.0,51.0,00000
91.0,20.0,31.0,190,02,01,  Char Chandi,486,721,239,347,247,374,40.3,40.8,39.8,00000
91.0,20.0,31.0,190,03,01,  Chatish,610,1298,307,633,303,665,32.0,32.7,31.3,00000
91.0,20.0,31.0,190,04,01,  Ramianpur,65,255,35,124,30,131,20.3,22.0,18.6,00000
91.0,20.0,31.0,190,05,01,  Puran Habra Bazar,18,54,15,40,3,14,25.0,27.3,17.6,00000
91.0,20.0,31.0,190,06,01,  Natun Habra Bazar,0,2,0,2,0,0,0.0,0.0,0.0,00000
91.0,20.0,31.0,190,07,01,  Baoshen,37,52,20,31,17,21,41.6,39.2,44.7,00000
91.0,20.0,31.0,190,08,01,  Atpara,178,105,96,48,82,57,62.9,66.7,59.0,00000
91.0,20.0,31.0,190,09,01,  Miah Janergaon,185,152,102,61,83,91,54.9,62.6,47.7,00000
91.0,20.0,31.0,233,01,01,  Mirergaon,158,71,75,26,83,45,69.0,74.3,64.8,00000
91.0,20.0,31.0,233,02,01,  Chandpur,332,326,185,146,147,180,50.5,55.9,45.0,00000
91.0,20.0,31.0,233,03,01,  Jagadishpur,233,88,121,42,112,46,72.6,74.2,70.9,00000
91.0,20.0,31.0,233,04,01,  Teghari,112,31,64,10,48,21,78.3,86.5,69.6,00000
91.0,20.0,31.0,233,05,01,  Dash Paika,925,1295,450,652,475,643,41.7,40.8,42.5,00000
91.0,20.0,31.0,233,06,01,  Dash Paika Bazar,19,4,16,2,3,2,82.6,88.9,60.0,00000
91.0,20.0,31.0,233,07,01,  Dhanpur,19,95,6,47,13,48,16.7,11.3,21.3,00000
91.0,20.0,31.0,268,01,01,  Parwa,159,79,76,39,83,40,66.8,66.1,67.5,00000
91.0,20.0,31.0,268,02,01,  Uttar Daulatpur,439,255,227,126,212,129,63.3,64.3,62.2,00000
91.0,20.0,31.0,268,03,01,  Hashnaji,257,191,140,77,117,114,57.4,64.5,50.6,00000
91.0,20.0,31.0,268,04,01,  Dakshin Daulatpur,515,340,277,141,238,199,60.2,66.3,54.5,00000
91.0,20.0,31.0,268,05,01,  Daulatpur,397,277,214,129,183,148,58.9,62.4,55.3,00000
91.0,20.0,31.0,346,01,01,  Durja Kapan,497,650,260,301,237,349,43.3,46.3,40.4,00000
91.0,20.0,31.0,346,02,01,  Ramkrishnapur,70,103,38,53,32,50,40.5,41.8,39.0,00000
91.0,20.0,31.0,657,01,01,  Maulvigaon,226,271,121,121,105,150,45.5,50.0,41.2,00000
91.0,20.0,31.0,657,02,01,  Ujaijuri,134,212,72,89,62,123,38.7,44.7,33.5,00000
91.0,20.0,31.0,657,03,01,  Chithanynagar,244,380,117,206,127,174,39.1,36.2,42.2,00000
91.0,20.0,31.0,657,04,01,  Kaliteka,91,202,38,101,53,101,31.1,27.3,34.4,00000
91.0,20.0,31.0,657,05,01,  Islampur,30,38,18,20,12,18,44.1,47.4,40.0,00000
91.0,20.0,31.0,795,01,01,  Lejkata,114,52,57,17,57,35,68.7,77.0,62.0,00000
91.0,20.0,31.0,795,02,01,  Noagaon-1,115,94,58,39,57,55,55.0,59.8,50.9,00000
91.0,20.0,31.0,795,03,01,  Noagaon-2,152,132,80,59,72,73,53.5,57.6,49.7,00000
91.0,20.0,31.0,891,01,01,  Uttar Satpara,248,271,122,132,126,139,47.8,48.0,47.5,00000
91.0,20.0,31.0,891,02,01,  Dakshin Satpara,268,217,132,102,136,115,55.3,56.4,54.2,00000
91.0,20.0,31.0,917,01,01,  Dakshin Singraoli,139,213,74,96,65,117,39.5,43.5,35.7,00000
91.0,20.0,31.0,917,02,01,  Uttar Singraoli,247,347,127,171,120,176,41.6,42.6,40.5,00000
91.0,20.0,31.0,917,03,01,  Bhati Para,391,172,211,75,180,97,69.4,73.8,65.0,00000
91.0,20.0,31.0,917,04,01,  Bubrajan,51,109,27,58,24,51,31.9,31.8,32.0,00000
91.0,20.0,31.0,917,05,01,  Senbari,19,10,10,6,9,4,65.5,62.5,69.2,00000
91.0,20.0,31.0,917,06,01,  Singerkanch Bazar,93,246,58,121,35,125,27.4,32.4,21.9,00000
91.0,20.0,31.0,917,07,01,  Kadipur,27,81,13,40,14,41,25.0,24.5,25.5,00000
91.0,20.0,31.0,917,08,01,  Paschimgaon,191,581,104,280,87,301,24.7,27.1,22.4,00000
91.0,20.0,31.0,917,09,01,  Majhgaon,268,664,151,314,117,350,28.8,32.5,25.1,00000
91.0,20.0,31.0,917,10,01,  Paschim Sekhergaon,43,183,25,81,18,102,19.0,23.6,15.0,00000
91.0,20.0,31.0,917,11,01,  Bhatra Para,53,85,22,44,31,41,38.4,33.3,43.1,00000
91.0,20.0,31.0,917,12,01,  Purba Sekhergaon,278,296,142,133,136,163,48.4,51.6,45.5,00000
91.0,20.0,31.0,917,13,01,  Purbagaon,111,133,51,56,60,77,45.5,47.7,43.8,00000
91.0,20.0,31.0,917,14,01,  Kazirgaon,126,224,74,106,52,118,36.0,41.1,30.6,00000
91.0,20.0,31.0,917,15,01,  Dakshin Karpara,191,123,109,60,82,63,60.8,64.5,56.6,00000
91.0,20.0,31.0,917,16,01,  Purba Karpara,168,280,90,146,78,134,37.5,38.1,36.8,00000
91.0,20.0,31.0,917,17,01,  Khan Para,106,72,56,25,50,47,59.6,69.1,51.5,00000
91.0,20.0,42.0,025,01,01,  Alapur,167,358,92,181,75,177,31.8,33.7,29.8,00000
91.0,20.0,42.0,025,02,01,  Tatalpur,36,36,15,18,21,18,50.0,45.5,53.8,00000
91.0,20.0,42.0,242,01,01,  Datta,83,137,34,72,49,65,37.7,32.1,43.0,00000
91.0,20.0,42.0,242,02,01,  Kalishail,37,67,17,31,20,36,35.6,35.4,35.7,00000
91.0,20.0,42.0,242,03,01,  Ekatira,55,74,25,42,30,32,42.6,37.3,48.4,00000
91.0,20.0,42.0,259,01,01,  Daudpur,110,384,61,208,49,176,22.3,22.7,21.8,00000
91.0,20.0,42.0,259,02,01,  Sayedpur,314,165,170,72,144,93,65.6,70.2,60.8,00000
91.0,20.0,42.0,259,03,01,  Jamalpur,43,11,24,5,19,6,79.6,82.8,76.0,00000
91.0,20.0,42.0,259,04,01,  Perurgaon,75,52,33,27,42,25,59.1,55.0,62.7,00000
91.0,20.0,42.0,259,05,01,  Sukhipur,94,60,53,25,41,35,61.0,67.9,53.9,00000
91.0,20.0,42.0,259,06,01,  Kadipur,184,213,99,124,85,89,46.3,44.4,48.9,00000
91.0,20.0,42.0,259,07,01,  Samajpur,117,52,62,28,55,24,69.2,68.9,69.6,00000
91.0,20.0,42.0,259,08,01,  Sadpur,20,86,11,42,9,44,18.9,20.8,17.0,00000
91.0,20.0,42.0,276,01,01,  Deokalash Dakshin,59,69,32,35,27,34,46.1,47.8,44.3,00000
91.0,20.0,42.0,276,02,01,  Mazanpur,91,76,42,38,49,38,54.5,52.5,56.3,00000
91.0,20.0,42.0,276,03,01,  Kajkabad,254,205,112,99,142,106,55.3,53.1,57.3,00000
91.0,20.0,42.0,276,04,01,  Maijgaon,140,79,74,37,66,42,63.9,66.7,61.1,00000
91.0,20.0,42.0,276,05,01,  Eklabari,17,12,10,4,7,8,58.6,71.4,46.7,00000
91.0,20.0,42.0,276,06,01,  Dalipatli,133,97,80,39,53,58,57.8,67.2,47.7,00000
91.0,20.0,42.0,276,07,01,  Noagaon,138,92,69,42,69,50,60.0,62.2,58.0,00000
91.0,20.0,42.0,276,08,01,  Kandigram,272,302,132,146,140,156,47.4,47.5,47.3,00000
91.0,20.0,42.0,276,09,01,  Jagatpur,208,221,103,119,105,102,48.5,46.4,50.7,00000
91.0,20.0,42.0,276,10,01,  Niyamatpur,141,126,71,50,70,76,52.8,58.7,47.9,00000
91.0,20.0,42.0,276,11,01,  Kairghat,104,110,53,51,51,59,48.6,51.0,46.4,00000
91.0,20.0,42.0,276,12,01,  Deokalas Kalijuri,120,67,65,33,55,34,64.2,66.3,61.8,00000
91.0,20.0,42.0,276,13,01,  Agnu Para,149,137,77,63,72,74,52.1,55.0,49.3,00000
91.0,20.0,42.0,276,14,01,  Noahati,28,40,15,18,13,22,41.2,45.5,37.1,00000
91.0,20.0,42.0,276,15,01,  Kharjan,288,516,132,254,156,262,35.8,34.2,37.3,00000
91.0,20.0,42.0,276,16,01,  Mirpur,56,47,35,26,21,21,54.4,57.4,50.0,00000
91.0,20.0,42.0,320,01,01,  Dhopakhola,143,352,93,252,50,100,28.9,27.0,33.3,00000
91.0,20.0,42.0,320,02,01,  Ekasurai,34,64,16,29,18,35,34.7,35.6,34.0,00000
91.0,20.0,42.0,501,01,01,  Kalijuri-1,460,367,251,183,209,184,55.6,57.8,53.2,00000
91.0,20.0,42.0,501,02,01,  Mutuk Kona,172,35,102,15,70,20,83.1,87.2,77.8,00000
91.0,20.0,42.0,501,03,01,  Kamalpur,296,93,162,30,134,63,76.1,84.4,68.0,00000
91.0,20.0,42.0,501,04,01,  Bara Kapan,192,162,112,84,80,78,54.2,57.1,50.6,00000
91.0,20.0,42.0,501,05,01,  Sadarpur,90,119,47,58,43,61,43.1,44.8,41.3,00000
91.0,20.0,42.0,501,06,01,  Bagir Chak,62,42,33,20,29,22,59.6,62.3,56.9,00000
91.0,20.0,42.0,519,01,01,  Alua Para,181,153,96,68,85,85,54.2,58.5,50.0,00000
91.0,20.0,42.0,519,02,01,  Ailakandi,35,36,15,17,20,19,49.3,46.9,51.3,00000
91.0,20.0,42.0,519,03,01,  Manaikandi,32,54,14,27,18,27,37.2,34.1,40.0,00000
91.0,20.0,42.0,519,04,01,  Satmanpur,79,229,36,105,43,124,25.6,25.5,25.7,00000
91.0,20.0,42.0,614,01,01,  Maijpur,358,206,191,104,167,102,63.5,64.7,62.1,00000
91.0,20.0,42.0,614,02,01,  Sadurgaon,87,117,45,53,42,64,42.6,45.9,39.6,00000
91.0,20.0,42.0,614,03,01,  Bajitpur,129,58,69,30,60,28,69.0,69.7,68.2,00000
91.0,20.0,42.0,631,01,01,  Majlishpur,118,86,61,42,57,44,57.8,59.2,56.4,00000
91.0,20.0,42.0,631,02,01,  Tikirband,21,28,10,14,11,14,42.9,41.7,44.0,00000
91.0,20.0,42.0,899,01,01,  Puran Satpur,218,844,121,402,97,442,20.5,23.1,18.0,00000
91.0,20.0,42.0,899,02,01,  Naya Satpur,69,617,32,303,37,314,10.1,9.6,10.5,00000
91.0,20.0,42.0,899,03,01,  Dakshin Satpur,68,296,34,143,34,153,18.7,19.2,18.2,00000
91.0,20.0,52.0,103,01,01,  Baruni,779,871,435,436,344,435,47.2,49.9,44.2,00000
91.0,20.0,52.0,103,02,01,  Nachuni,234,236,122,111,112,125,49.8,52.4,47.3,00000
91.0,20.0,52.0,103,03,01,  Aushpur,168,290,82,136,86,154,36.7,37.6,35.8,00000
91.0,20.0,52.0,112,01,01,  Dhararai,45,43,26,18,19,25,51.1,59.1,43.2,00000
91.0,20.0,52.0,112,02,01,  Bausi,678,417,367,205,311,212,61.9,64.2,59.5,00000
91.0,20.0,52.0,181,01,01,  Chand Bharang,752,1206,420,587,332,619,38.4,41.7,34.9,00000
91.0,20.0,52.0,181,02,01,  Baishghar,484,676,234,327,250,349,41.7,41.7,41.7,00000
91.0,20.0,52.0,181,03,01,  Kachrakeli,86,48,45,19,41,29,64.2,70.3,58.6,00000
91.0,20.0,52.0,181,04,01,  Ballabhpur,237,402,126,197,111,205,37.1,39.0,35.1,00000
91.0,20.0,52.0,224,01,01,  Dasghar,601,617,315,291,286,326,49.3,52.0,46.7,00000
91.0,20.0,52.0,224,02,01,  Loharaspur,174,239,90,113,84,126,42.1,44.3,40.0,00000
91.0,20.0,52.0,224,03,01,  Kaibarta Kapan,28,30,18,14,10,16,48.3,56.3,38.5,00000
91.0,20.0,52.0,224,04,01,  Shambu Mardan,137,212,84,111,53,101,39.3,43.1,34.4,00000
91.0,20.0,52.0,224,05,01,  Saruil,144,195,70,100,74,95,42.5,41.2,43.8,00000
91.0,20.0,52.0,224,06,01,  Ekanarain,53,45,28,19,25,26,54.1,59.6,49.0,00000
91.0,20.0,52.0,224,07,01,  Bhati Para,33,98,18,53,15,45,25.2,25.4,25.0,00000
91.0,20.0,52.0,224,08,01,  Isabdaud,56,66,31,32,25,34,45.9,49.2,42.4,00000
91.0,20.0,52.0,224,09,01,  Dashghar Noagaon,377,787,191,392,186,395,32.4,32.8,32.0,00000
91.0,20.0,52.0,224,10,01,  Nialer Noagaon,314,206,145,97,169,109,60.4,59.9,60.8,00000
91.0,20.0,52.0,224,11,01,  Salia,190,309,93,154,97,155,38.1,37.7,38.5,00000
91.0,20.0,52.0,224,12,01,  Sikkagaon,135,129,67,64,68,65,51.1,51.1,51.1,00000
91.0,20.0,52.0,224,13,01,  Kamargaon,156,264,72,118,84,146,37.1,37.9,36.5,00000
91.0,20.0,52.0,224,14,01,  Karmargaon,42,119,21,63,21,56,26.1,25.0,27.3,00000
91.0,20.0,52.0,224,15,01,  Ghagutia,145,156,80,72,65,84,48.2,52.6,43.6,00000
91.0,20.0,52.0,475,01,01,  Jibanpur,146,239,71,108,75,131,37.9,39.7,36.4,00000
91.0,20.0,52.0,475,02,01,  Bishnupur,71,119,36,61,35,58,37.4,37.1,37.6,00000
91.0,20.0,52.0,475,03,01,  Roykeli,96,138,51,72,45,66,41.0,41.5,40.5,00000
91.0,20.0,63.0,077,01,01,  Baonpur,458,915,230,424,228,491,33.4,35.2,31.7,00000
91.0,20.0,63.0,077,02,01,  Austakeari,70,147,30,76,40,71,32.3,28.3,36.0,00000
91.0,20.0,63.0,077,03,01,  Ekakalyan,32,71,14,37,18,34,31.1,27.5,34.6,00000
91.0,20.0,63.0,077,04,01,  Bahadurmala,25,63,13,34,12,29,28.4,27.7,29.3,00000
91.0,20.0,63.0,138,01,01,  Bholaganj,324,366,146,168,178,198,47.0,46.5,47.3,00000
91.0,20.0,63.0,138,02,01,  Hamder Chak,242,164,113,76,129,88,59.6,59.8,59.4,00000
91.0,20.0,63.0,138,03,01,  Kurikhala,172,166,74,79,98,87,50.9,48.4,53.0,00000
91.0,20.0,63.0,138,04,01,  Ganaighar,163,239,77,111,86,128,40.5,41.0,40.2,00000
91.0,20.0,63.0,241,01,01,  Enayetpur,77,71,34,28,43,43,52.0,54.8,50.0,00000
91.0,20.0,63.0,241,02,01,  Tabalpur,96,195,45,93,51,102,33.0,32.6,33.3,00000
91.0,20.0,63.0,241,03,01,  Mushedor,146,217,68,124,78,93,40.2,35.4,45.6,00000
91.0,20.0,63.0,241,04,01,  Nurpur,35,35,14,19,21,16,50.0,42.4,56.8,00000
91.0,20.0,63.0,241,05,01,  Kayestagram,27,84,13,47,14,37,24.3,21.7,27.5,00000
91.0,20.0,63.0,241,06,01,  Muftir Bazar,3,4,3,3,0,1,42.9,50.0,0.0,00000
91.0,20.0,63.0,380,01,01,  Ghasigaon,171,60,94,21,77,39,74.0,81.7,66.4,00000
91.0,20.0,63.0,380,02,01,  Amargaon,104,70,59,33,45,37,59.8,64.1,54.9,00000
91.0,20.0,63.0,432,01,01,  Haripur,335,242,159,125,176,117,58.1,56.0,60.1,00000
91.0,20.0,63.0,449,01,01,  Paschim Krishnapur,99,336,43,161,56,175,22.8,21.1,24.2,00000
91.0,20.0,63.0,449,02,01,  Purba Krishnapur,93,203,39,99,54,104,31.4,28.3,34.2,00000
91.0,20.0,63.0,449,03,01,  Islampur,22,6,13,1,9,5,78.6,92.9,64.3,00000
91.0,20.0,63.0,449,04,01,  Gumragul,183,148,87,69,96,79,55.3,55.8,54.9,00000
91.0,20.0,63.0,449,05,01,  Rajnagar,39,79,17,40,22,39,33.1,29.8,36.1,00000
91.0,20.0,63.0,484,01,01,  Bhatgaon,41,48,26,23,15,25,46.1,53.1,37.5,00000
91.0,20.0,63.0,484,02,01,  Phulchandi,50,40,19,23,31,17,55.6,45.2,64.6,00000
91.0,20.0,63.0,536,01,01,  Karma Kalapati,182,389,98,175,84,214,31.9,35.9,28.2,00000
91.0,20.0,63.0,536,02,01,  Chhota Dhigali,224,280,107,139,117,141,44.4,43.5,45.3,00000
91.0,20.0,63.0,536,03,01,  Madhabpur,122,225,54,106,68,119,35.2,33.8,36.4,00000
91.0,20.0,63.0,596,01,01,  Timaighar,112,119,51,52,61,67,48.5,49.5,47.7,00000
91.0,20.0,63.0,596,02,01,  Roypur,168,363,71,179,97,184,31.6,28.4,34.5,00000
91.0,20.0,63.0,596,03,01,  Aowlarpar,103,94,53,41,50,53,52.3,56.4,48.5,00000
91.0,20.0,63.0,596,04,01,  Pratabpur,125,376,79,196,46,180,25.0,28.7,20.4,00000
91.0,20.0,63.0,596,05,01,  Nischintapur,28,36,11,17,17,19,43.8,39.3,47.2,00000
91.0,20.0,63.0,596,06,01,  Noarai,306,211,150,101,156,110,59.2,59.8,58.6,00000
91.0,20.0,63.0,596,07,01,  Kumar Para,59,181,24,82,35,99,24.6,22.6,26.1,00000
91.0,20.0,63.0,596,08,01,  Madanpur,153,203,79,93,74,110,43.0,45.9,40.2,00000
91.0,20.0,63.0,605,01,01,  Mohammadpur,117,80,63,39,54,41,59.4,61.8,56.8,00000
91.0,20.0,63.0,605,02,01,  Babunagar,65,69,41,32,24,37,48.5,56.2,39.3,00000
91.0,20.0,63.0,700,01,01,  Bhabanipur,53,110,25,55,28,55,32.5,31.3,33.7,00000
91.0,20.0,63.0,700,02,01,  Noagaon,227,421,108,208,119,213,35.0,34.2,35.8,00000
91.0,20.0,63.0,700,03,01,  Paschim Noagaon,62,55,33,22,29,33,53.0,60.0,46.8,00000
91.0,20.0,63.0,700,04,01,  Murauna,15,88,7,42,8,46,14.6,14.3,14.8,00000
91.0,20.0,63.0,700,05,01,  Dakshin Noagaon,184,276,99,136,85,140,40.0,42.1,37.8,00000
91.0,20.0,63.0,700,06,01,  Paschim Raghupur,48,49,19,21,29,28,49.5,47.5,50.9,00000
91.0,20.0,63.0,700,07,01,  Dwippur,16,6,10,3,6,3,72.7,76.9,66.7,00000
91.0,20.0,63.0,700,08,01,  Kamalpur,4,66,3,31,1,35,5.7,8.8,2.8,00000
91.0,20.0,63.0,726,01,01,  Paschim Paharpur,128,111,63,52,65,59,53.6,54.8,52.4,00000
91.0,20.0,63.0,726,02,01,  Noorpur,40,22,18,10,22,12,64.5,64.3,64.7,00000
91.0,20.0,63.0,752,01,01,  Prayag Mahal,182,341,99,154,83,187,34.8,39.1,30.7,00000
91.0,20.0,63.0,752,02,01,  Kabilpur,156,327,72,154,84,173,32.3,31.9,32.7,00000
91.0,20.0,63.0,752,03,01,  Chandragram,366,274,173,128,193,146,57.2,57.5,56.9,00000
91.0,20.0,63.0,752,04,01,  Chandipur,29,24,10,16,19,8,54.7,38.5,70.4,00000
91.0,20.0,63.0,752,05,01,  Pakichiri,125,176,61,81,64,95,41.5,43.0,40.3,00000
91.0,20.0,63.0,752,06,01,  Noapara Joynagar,154,217,77,97,77,120,41.5,44.3,39.1,00000
91.0,20.0,63.0,752,07,01,  Bhat Para,127,193,58,93,69,100,39.7,38.4,40.8,00000
91.0,20.0,63.0,752,08,01,  Bade Kabilpur,88,100,54,45,34,55,46.8,54.5,38.2,00000
91.0,20.0,63.0,752,09,01,  Kandigaon,147,341,82,155,65,186,30.1,34.6,25.9,00000
91.0,20.0,63.0,752,10,01,  Rajganja Bazar,0,4,0,3,0,1,0.0,0.0,0.0,00000
91.0,20.0,63.0,752,11,01,  Telikona,518,448,269,207,249,241,53.6,56.5,50.8,00000
91.0,20.0,63.0,752,12,01,  Shah Sahebergaon,120,28,55,13,65,15,81.1,80.9,81.3,00000
91.0,20.0,63.0,813,01,01,  Deepband,99,406,50,207,49,199,19.6,19.5,19.8,00000
91.0,20.0,63.0,813,02,01,  Gobindanagar,93,167,40,84,53,83,35.8,32.3,39.0,00000
91.0,20.0,63.0,813,03,01,  Sreemukh,1,2,0,0,1,2,33.3,0.0,33.3,00000
91.0,20.0,63.0,821,01,01,  Palgaon,128,82,72,42,56,40,61.0,63.2,58.3,00000
91.0,20.0,63.0,821,02,01,  Sonapur,179,121,85,56,94,65,59.7,60.3,59.1,00000
91.0,20.0,63.0,826,01,01,  Rahimpur,699,907,349,433,350,474,43.5,44.6,42.5,00000
91.0,20.0,63.0,826,02,01,  Rahimpur Khalpar,135,149,65,74,70,75,47.5,46.8,48.3,00000
91.0,20.0,63.0,826,03,01,  Piarai,91,235,42,125,49,110,27.9,25.1,30.8,00000
91.0,20.0,63.0,826,04,01,  Shiberkhala,126,96,74,42,52,54,56.8,63.8,49.1,00000
91.0,20.0,63.0,946,01,01,  Talibpur,196,112,103,41,93,71,63.6,71.5,56.7,00000
91.0,20.0,63.0,946,02,01,  Nawbhagh,245,123,120,54,125,69,66.6,69.0,64.4,00000
91.0,20.0,63.0,946,03,01,  Rauthergaon,278,173,145,72,133,101,61.6,66.8,56.8,00000
91.0,20.0,63.0,946,04,01,  Shahid Soleman Nagar,77,51,40,24,37,27,60.2,62.5,57.8,00000
91.0,20.0,63.0,986,01,01,  Tilakpur,94,72,46,33,48,39,56.6,58.2,55.2,00000
91.0,20.0,63.0,986,02,01,  Kishorepur,145,147,56,70,89,77,49.7,44.4,53.6,00000
91.0,20.0,63.0,986,03,01,  Purba Paharpur,135,84,71,39,64,45,61.6,64.5,58.7,00000
91.0,20.0,73.0,034,01,01,  Rajapur,389,246,199,101,190,145,61.3,66.3,56.7,00000
91.0,20.0,73.0,034,02,01,  Jagirala,251,155,129,69,122,86,61.8,65.2,58.7,00000
91.0,20.0,73.0,051,01,01,  Saudargaon,120,123,57,65,63,58,49.4,46.7,52.1,00000
91.0,20.0,73.0,051,02,01,  Natullahpur,63,77,22,36,41,41,45.0,37.9,50.0,00000
91.0,20.0,73.0,051,03,01,  Badurmala,485,574,235,273,250,301,45.8,46.3,45.4,00000
91.0,20.0,73.0,147,01,01,  Bhurki,496,633,243,314,253,319,43.9,43.6,44.2,00000
91.0,20.0,73.0,147,02,01,  Ekanida,18,12,13,6,5,6,60.0,68.4,45.5,00000
91.0,20.0,73.0,250,01,01,  Dattapur (Dighali),789,284,381,142,408,142,73.5,72.8,74.2,00000
91.0,20.0,73.0,250,02,01,  Mandabaz,62,415,36,203,26,212,13.0,15.1,10.9,00000
91.0,20.0,73.0,285,01,01,  Dewan Nagar,10,76,4,38,6,38,11.6,9.5,13.6,00000
91.0,20.0,73.0,285,02,01,  Bulchandergaon,6,9,3,4,3,5,40.0,42.9,37.5,00000
91.0,20.0,73.0,285,03,01,  Noagaon,84,153,46,71,38,82,35.4,39.3,31.7,00000
91.0,20.0,73.0,328,01,01,  Dighali,139,104,64,51,75,53,57.2,55.7,58.6,00000
91.0,20.0,73.0,328,02,01,  Paschim Birargaon,46,5,26,3,20,2,90.2,89.7,90.9,00000
91.0,20.0,73.0,337,01,01,  Duarigaon,88,202,42,90,46,112,30.3,31.8,29.1,00000
91.0,20.0,73.0,337,02,01,  Hailkari,24,31,11,15,13,16,43.6,42.3,44.8,00000
91.0,20.0,73.0,372,01,01,  Lama Kazi,99,93,74,48,25,45,51.6,60.7,35.7,00000
91.0,20.0,73.0,372,02,01,  Kazirgaon,184,414,91,197,93,217,30.8,31.6,30.0,00000
91.0,20.0,73.0,372,03,01,  Mollargaon,66,150,36,65,30,85,30.6,35.6,26.1,00000
91.0,20.0,73.0,372,04,01,  Keshabpur,185,209,90,90,95,119,47.0,50.0,44.4,00000
91.0,20.0,73.0,372,05,01,  Atapur,63,89,40,39,23,50,41.4,50.6,31.5,00000
91.0,20.0,73.0,372,06,01,  Bidyapati,123,42,65,21,58,21,74.5,75.6,73.4,00000
91.0,20.0,73.0,372,07,01,  Sangrai,79,169,47,78,32,91,31.9,37.6,26.0,00000
91.0,20.0,73.0,372,08,01,  Dokani Para,221,307,110,148,111,159,41.9,42.6,41.1,00000
91.0,20.0,73.0,372,09,01,  Purba Barergaon,206,320,110,157,96,163,39.2,41.2,37.1,00000
91.0,20.0,73.0,372,10,01,  Mirzargaon,961,1589,528,747,433,842,37.7,41.4,34.0,00000
91.0,20.0,73.0,397,01,01,  Hajarigaon,221,273,122,116,99,157,44.7,51.3,38.7,00000
91.0,20.0,73.0,397,02,01,  Tilakpur,84,150,39,82,45,68,35.9,32.2,39.8,00000
91.0,20.0,73.0,397,03,01,  Akilpur,338,236,183,113,155,123,58.9,61.8,55.8,00000
91.0,20.0,73.0,397,04,01,  Brabongaon,151,198,67,92,84,106,43.3,42.1,44.2,00000
91.0,20.0,73.0,397,05,01,  Kalimullahpur,146,232,82,103,64,129,38.6,44.3,33.2,00000
91.0,20.0,73.0,397,06,01,  Rasulpur,98,186,50,84,48,102,34.5,37.3,32.0,00000
91.0,20.0,73.0,406,01,01,  Durlab Farid,289,297,135,128,154,169,49.3,51.3,47.7,00000
91.0,20.0,73.0,406,02,01,  Hajrah,168,115,89,48,79,67,59.4,65.0,54.1,00000
91.0,20.0,73.0,406,03,01,  Gangapur,30,39,14,15,16,24,43.5,48.3,40.0,00000
91.0,20.0,73.0,423,01,01,  Hamjapur,113,128,52,62,61,66,46.9,45.6,48.0,00000
91.0,20.0,73.0,423,02,01,  Mirpur,203,123,94,52,109,71,62.3,64.4,60.6,00000
91.0,20.0,73.0,562,01,01,  Khujar Para,396,220,215,109,181,111,64.3,66.4,62.0,00000
91.0,20.0,73.0,562,02,01,  Madhabpur,333,418,168,214,165,204,44.3,44.0,44.7,00000
91.0,20.0,73.0,562,03,01,  Sahebnagar,189,234,106,118,83,116,44.7,47.3,41.7,00000
91.0,20.0,73.0,562,04,01,  Islampur,156,50,86,25,70,25,75.7,77.5,73.7,00000
91.0,20.0,73.0,562,05,01,  Dekapur,4,1,2,0,2,1,80.0,100.0,66.7,00000
91.0,20.0,73.0,562,06,01,  Haira Pashupati Datta,15,2,9,1,6,1,88.2,90.0,85.7,00000
91.0,20.0,73.0,579,01,01,  Konaura Noagaon,171,325,82,161,89,164,34.5,33.7,35.2,00000
91.0,20.0,73.0,579,02,01,  Hakuragaon,56,84,20,41,36,43,40.0,32.8,45.6,00000
91.0,20.0,73.0,579,03,01,  Pathan Chak,6,247,3,117,3,130,2.4,2.5,2.3,00000
91.0,20.0,73.0,709,01,01,  Mahatabpur,455,838,255,394,200,444,35.2,39.3,31.1,00000
91.0,20.0,73.0,709,02,01,  Shahapur,20,274,13,122,7,152,6.8,9.6,4.4,00000
91.0,20.0,73.0,709,03,01,  Kotiria,221,171,117,73,104,98,56.4,61.6,51.5,00000
91.0,20.0,73.0,744,01,01,  Tapiganj,11,182,7,91,4,91,5.7,7.1,4.2,00000
91.0,20.0,73.0,744,02,01,  Makargaon,33,172,15,86,18,86,16.1,14.9,17.3,00000
91.0,20.0,73.0,775,01,01,  Mangalsree,220,164,110,69,110,95,57.3,61.5,53.7,00000
91.0,20.0,73.0,775,02,01,  Krishnapur,164,115,81,57,83,58,58.8,58.7,58.9,00000
91.0,20.0,73.0,775,03,01,  Khajanchigaon,265,144,131,73,134,71,64.8,64.2,65.4,00000
91.0,20.0,73.0,865,01,01,  Sakarikona,390,185,201,68,189,117,67.8,74.7,61.8,00000
91.0,20.0,73.0,865,02,01,  Isabpur,393,423,214,194,179,229,48.2,52.5,43.9,00000
91.0,20.0,73.0,994,01,01,  Sirajpur,33,14,17,4,16,10,70.2,81.0,61.5,00000
91.0,20.0,73.0,994,02,01,  Basirpur,259,181,137,83,122,98,58.9,62.3,55.5,00000
91.0,20.0,73.0,994,03,01,  Pathangaon,186,285,87,132,99,153,39.5,39.7,39.3,00000
91.0,20.0,84.0,164,01,01,  Bubrajan,208,154,97,67,111,87,57.5,59.1,56.1,00000
91.0,20.0,84.0,164,02,01,  Ramchadrapur,259,210,136,101,123,109,55.2,57.4,53.0,00000
91.0,20.0,84.0,164,03,01,  Noagaon,195,308,97,148,98,160,38.8,39.6,38.0,00000
91.0,20.0,84.0,164,04,01,  Janaia,81,51,33,24,48,27,61.4,57.9,64.0,00000
91.0,20.0,84.0,173,01,01,  Chak Ramprasad,174,597,90,289,84,308,22.6,23.7,21.4,00000
91.0,20.0,84.0,173,02,01,  Anerpur,458,562,220,266,238,296,44.9,45.3,44.6,00000
91.0,20.0,84.0,294,01,01,  Dhalia Para,1252,1186,662,569,590,617,51.4,53.8,48.9,00000
91.0,20.0,84.0,294,02,01,  Jamserpur,953,2192,498,1092,455,1100,30.3,31.3,29.3,00000
91.0,20.0,84.0,363,01,01,  Gargaon,223,239,111,101,112,138,48.3,52.4,44.8,00000
91.0,20.0,84.0,363,02,01,  Agun Shasan,76,104,39,47,37,57,42.2,45.3,39.4,00000
91.0,20.0,84.0,363,03,01,  Bajrakona,23,30,9,16,14,14,43.4,36.0,50.0,00000
91.0,20.0,84.0,493,01,01,  Kadipur,219,256,119,128,100,128,46.1,48.2,43.9,00000
91.0,20.0,84.0,493,02,01,  Dashdhal,265,200,135,86,130,114,57.0,61.1,53.3,00000
91.0,20.0,84.0,692,01,01,  Naodhar,632,670,317,304,315,366,48.5,51.0,46.3,00000
91.0,20.0,84.0,692,02,01,  Rahman Nagar,413,539,213,249,200,290,43.4,46.1,40.8,00000
91.0,20.0,84.0,692,03,01,  Bairagirgaon,162,494,94,246,68,248,24.7,27.6,21.5,00000
91.0,20.0,84.0,700,01,01,  Nursingpur,313,296,159,150,154,146,51.4,51.5,51.3,00000
91.0,20.0,84.0,700,02,01,  Musalia,77,120,46,56,31,64,39.1,45.1,32.6,00000
91.0,20.0,84.0,700,03,01,  Bishwanathergaon,277,226,139,100,138,126,55.1,58.2,52.3,00000
91.0,20.0,84.0,700,04,01,  Sreedharpur,248,209,126,97,122,112,54.3,56.5,52.1,00000
91.0,20.0,84.0,700,05,01,  Bagamatpur,74,39,42,19,32,20,65.5,68.9,61.5,00000
91.0,20.0,84.0,700,06,01,  Gangadarpur,78,31,50,9,28,22,71.6,84.7,56.0,00000
91.0,20.0,84.0,735,01,01,  Bishghar,138,210,65,101,73,109,39.7,39.2,40.1,00000
91.0,20.0,84.0,735,02,01,  Purangaon,256,254,120,115,136,139,50.2,51.1,49.5,00000
91.0,20.0,84.0,735,03,01,  Kona Para,298,198,148,92,150,106,60.1,61.7,58.6,00000
91.0,20.0,84.0,735,04,01,  Hashan Nagar,210,238,113,108,97,130,46.9,51.1,42.7,00000
91.0,20.0,84.0,735,05,01,  Atghar,123,215,56,100,67,115,36.4,35.9,36.8,00000
91.0,20.0,84.0,735,06,01,  Ilamergaon,19,15,15,6,4,9,55.9,71.4,30.8,00000
91.0,20.0,84.0,847,01,01,  Rampasha,952,1157,467,517,485,640,45.1,47.5,43.1,00000
91.0,20.0,84.0,847,02,01,  Katli Para,544,907,264,442,280,465,37.5,37.4,37.6,00000
91.0,20.0,84.0,847,03,01,  Gorashail,90,44,48,27,42,17,67.2,64.0,71.2,00000
91.0,20.0,84.0,847,04,01,  Mujrai Para,110,242,54,114,56,128,31.3,32.1,30.4,00000
91.0,20.0,84.0,847,05,01,  Chandraudy,60,108,31,47,29,61,35.7,39.7,32.2,00000
91.0,20.0,84.0,847,06,01,  Sreepur,209,258,100,123,109,135,44.8,44.8,44.7,00000
91.0,20.0,84.0,847,07,01,  Panchgari,84,131,38,65,46,66,39.1,36.9,41.1,00000
91.0,20.0,84.0,847,08,01,  Pathakain,148,271,83,130,65,141,35.3,39.0,31.6,00000
91.0,20.0,84.0,847,09,01,  Manoharpur,192,336,97,165,95,171,36.4,37.0,35.7,00000
91.0,20.0,84.0,847,10,01,  Azidnagar,156,301,73,144,83,157,34.1,33.6,34.6,00000
91.0,20.0,84.0,847,11,01,  Bairagir Bazar,245,128,157,64,88,64,65.7,71.0,57.9,00000
91.0,20.0,84.0,847,12,01,  Kona Para,201,282,102,131,99,151,41.6,43.8,39.6,00000
91.0,27.0,11.0,198,01,01,  Chika Duhra,155,311,78,167,77,144,33.3,31.8,34.8,00000
91.0,27.0,11.0,198,02,01,  Jaliarpar(Puranjaliarpar),102,393,53,193,49,200,20.6,21.5,19.7,00000
91.0,27.0,11.0,397,02,01,  Kala Sadak,118,530,109,282,9,248,18.2,27.9,3.5,00000
91.0,27.0,11.0,397,03,01,  Nawa Gangerpar,394,608,210,301,184,307,39.3,41.1,37.5,00000
91.0,27.0,11.0,397,04,01,  Dakghar,237,414,147,210,90,204,36.4,41.2,30.6,00000
91.0,27.0,11.0,639,01,01,  Lama Para,391,608,198,303,193,305,39.1,39.5,38.8,00000
91.0,27.0,11.0,639,02,01,  Puran Bhulaganj,760,1686,408,827,352,859,31.1,33.0,29.1,00000
91.0,27.0,11.0,639,03,01,  Badikona,501,562,306,277,195,285,47.1,52.5,40.6,00000
91.0,27.0,11.0,639,04,01,  Ghoramara,76,267,37,128,39,139,22.2,22.4,21.9,00000
91.0,27.0,11.0,639,05,01,  Purba Nowabagi,236,299,117,158,119,141,44.1,42.5,45.8,00000
91.0,27.0,11.0,639,06,01,  Paschim Nowabagi,28,459,15,254,13,205,5.7,5.6,6.0,00000
91.0,27.0,11.0,639,07,01,  Babulnagar,138,236,67,119,71,117,36.9,36.0,37.8,00000
91.0,27.0,11.0,639,08,01,  Batertal,236,443,124,204,112,239,34.8,37.8,31.9,00000
91.0,27.0,11.0,639,09,01,  Nawagaon,294,768,149,368,145,400,27.7,28.8,26.6,00000
91.0,27.0,11.0,639,10,01,  Paschim Narayanpur,132,334,65,168,67,166,28.3,27.9,28.8,00000
91.0,27.0,11.0,639,11,01,  Rustampur,426,503,278,270,148,233,45.9,50.7,38.8,00000
91.0,27.0,11.0,639,12,01,  Purba Narayanpur,36,302,21,145,15,157,10.7,12.7,8.7,00000
91.0,27.0,11.0,639,13,01,  Mazh Para,713,2041,425,1052,288,989,25.9,28.8,22.6,00000
91.0,27.0,11.0,852,01,01,  Bardeo,841,1206,523,635,318,571,41.1,45.2,35.8,00000
91.0,27.0,11.0,852,02,01,  Kanthalbari(Part),73,416,42,206,31,210,14.9,16.9,12.9,00000
91.0,27.0,11.0,881,01,01,  Kanthalbari,523,1409,260,724,263,685,27.1,26.4,27.7,00000
91.0,27.0,11.0,881,02,01,  Lambakandi,294,678,140,378,154,300,30.2,27.0,33.9,00000
91.0,27.0,11.0,881,03,01,  Bhagarpar,236,341,119,168,117,173,40.9,41.5,40.3,00000
91.0,27.0,11.0,881,04,01,  Chandagul,152,405,72,198,80,207,27.3,26.7,27.9,00000
91.0,27.0,11.0,881,05,01,  Rajarkhal (Part),135,347,71,174,64,173,28.0,29.0,27.0,00000
91.0,27.0,11.0,881,06,01,  Dholakhal,317,285,169,135,148,150,52.7,55.6,49.7,00000
91.0,27.0,11.0,923,01,03,  Burdeo,826,515,468,247,358,268,61.6,65.5,57.2,00000
91.0,27.0,11.0,923,02,03,  Shiler Bhanga,172,550,92,290,80,260,23.8,24.1,23.5,00000
91.0,27.0,11.0,923,03,03,  Islampur,1334,2336,765,1242,569,1094,36.3,38.1,34.2,00000
91.0,27.0,11.0,923,04,03,  Taimurnagar,381,509,226,260,155,249,42.8,46.5,38.4,00000
91.0,27.0,11.0,923,05,03,  Laskhal,298,813,155,428,143,385,26.8,26.6,27.1,00000
91.0,27.0,11.0,923,06,03,  Takergaon,2585,3602,1529,1940,1056,1662,41.8,44.1,38.9,00000
91.0,27.0,13.0,127,01,01,  Bhatrai,446,573,232,274,214,299,43.8,45.8,41.7,00000
91.0,27.0,13.0,127,02,01,  Purana Jibonpur,454,655,239,319,215,336,40.9,42.8,39.0,00000
91.0,27.0,13.0,127,03,01,  Larang,21,107,12,57,9,50,16.4,17.4,15.3,00000
91.0,27.0,13.0,127,04,01,  Radhanagar (1),74,418,44,215,30,203,15.0,17.0,12.9,00000
91.0,27.0,13.0,127,05,01,  Radhanagar (2),98,189,45,102,53,87,34.1,30.6,37.9,00000
91.0,27.0,13.0,127,06,01,  Chandranagar,32,388,20,197,12,191,7.6,9.2,5.9,00000
91.0,27.0,13.0,127,07,01,  Kalibari (Part),118,198,64,101,54,97,37.3,38.8,35.8,00000
91.0,27.0,13.0,127,08,01,  Natun Balu Char,117,170,60,74,57,96,40.8,44.8,37.3,00000
91.0,27.0,13.0,127,09,01,  Puran Balu Char,179,949,110,478,69,471,15.9,18.7,12.8,00000
91.0,27.0,13.0,369,01,01,  Natun Zibanpur (Eochehar),393,993,194,527,199,466,28.4,26.9,29.9,00000
91.0,27.0,13.0,369,02,01,  Amertal,31,149,19,72,12,77,17.2,20.9,13.5,00000
91.0,27.0,13.0,369,03,01,  Shibnagar,106,346,67,160,39,186,23.5,29.5,17.3,00000
91.0,27.0,13.0,397,01,01,  Uttar Rajnagar,396,558,225,301,171,257,41.5,42.8,40.0,00000
91.0,27.0,13.0,397,02,01,  Kalibari,554,986,332,509,222,477,36.0,39.5,31.8,00000
91.0,27.0,13.0,397,03,01,  Dakshin Kalabari,667,1290,406,624,261,666,34.1,39.4,28.2,00000
91.0,27.0,13.0,397,04,01,  Uttar Kalabari,448,683,262,329,186,354,39.6,44.3,34.4,00000
91.0,27.0,13.0,397,05,01,  Dhalarpar,955,2964,534,1531,421,1433,24.4,25.9,22.7,00000
91.0,27.0,13.0,397,06,01,  Paschim Meghargaon,152,543,76,268,76,275,21.9,22.1,21.7,00000
91.0,27.0,13.0,781,01,01,  Rangpuri Basti,109,672,66,340,43,332,14.0,16.3,11.5,00000
91.0,27.0,13.0,781,02,01,  Shimultala Nayagaon,447,1395,241,675,206,720,24.3,26.3,22.2,00000
91.0,27.0,13.0,781,03,01,  Madhya Rajnagar,512,834,281,425,231,409,38.0,39.8,36.1,00000
91.0,27.0,13.0,781,04,01,  Dakshin Rajnagar,251,469,140,241,111,228,34.9,36.7,32.7,00000
91.0,27.0,13.0,781,05,01,  Fatakuri,332,397,168,210,164,187,45.5,44.4,46.7,00000
91.0,27.0,13.0,781,06,01,  Khayergaon,332,1060,180,542,152,518,23.9,24.9,22.7,00000
91.0,27.0,13.0,781,07,01,  Mostofa Nagar,332,1166,204,593,128,573,22.2,25.6,18.3,00000
91.0,27.0,17.0,069,01,01,  Baghjor,184,801,106,389,78,412,18.7,21.4,15.9,00000
91.0,27.0,17.0,069,02,01,  Changar Poi,53,348,33,204,20,144,13.2,13.9,12.2,00000
91.0,27.0,17.0,069,03,01,  Jogirgaon,195,288,106,144,89,144,40.4,42.4,38.2,00000
91.0,27.0,17.0,069,04,01,  Kolabari,74,258,42,125,32,133,22.3,25.1,19.4,00000
91.0,27.0,17.0,287,01,01,  Bishnupur,146,394,78,197,68,197,27.0,28.4,25.7,00000
91.0,27.0,17.0,287,02,01,  Durgapur,66,309,37,173,29,136,17.6,17.6,17.6,00000
91.0,27.0,17.0,568,01,01,  Nijgaon,695,2191,382,1006,313,1185,24.1,27.5,20.9,00000
91.0,27.0,17.0,568,02,01,  Chaythanagar,34,131,14,68,20,63,20.6,17.1,24.1,00000
91.0,27.0,47.0,696,01,01,  Purna Chhagram,571,1355,275,659,296,696,29.6,29.4,29.8,00000
91.0,27.0,47.0,696,02,01,  Murarbari,33,292,16,149,17,143,10.2,9.7,10.6,00000
91.0,27.0,47.0,771,01,01,  Paschim Mahish Kher,311,208,162,87,149,121,59.9,65.1,55.2,00000
91.0,27.0,47.0,771,02,01,  Rajapur,87,361,49,178,38,183,19.4,21.6,17.2,00000
91.0,27.0,71.0,170,01,01,  Bilajor,89,366,46,181,43,185,19.6,20.3,18.9,00000
91.0,27.0,71.0,170,02,01,  Chatalpar,79,962,44,487,35,475,7.6,8.3,6.9,00000
91.0,27.0,71.0,170,03,01,  Nayagaon,10,73,5,36,5,37,12.0,12.2,11.9,00000
91.0,27.0,71.0,227,01,01,  Buri Dahar,345,475,174,230,171,245,42.1,43.1,41.1,00000
91.0,27.0,71.0,227,02,01,  Bakhergaon,52,145,28,65,24,80,26.4,30.1,23.1,00000
91.0,27.0,71.0,227,03,01,  Companiganj,321,710,165,346,156,364,31.1,32.3,30.0,00000
91.0,27.0,71.0,497,01,01,  Lamnigaon,102,373,54,196,48,177,21.5,21.6,21.3,00000
91.0,27.0,71.0,497,02,01,  Jagnarpar,16,136,6,73,10,63,10.5,7.6,13.7,00000
91.0,27.0,71.0,497,03,01,  Silakuritila,50,411,30,204,20,207,10.8,12.8,8.8,00000
91.0,27.0,71.0,867,01,01,  Ambari,75,44,35,24,40,20,63.0,59.3,66.7,00000
91.0,27.0,71.0,867,02,01,  Noagaon,87,272,50,132,37,140,24.2,27.5,20.9,00000
91.0,27.0,71.0,867,03,01,  Futkura Tila,41,170,29,83,12,87,19.4,25.9,12.1,00000
91.0,27.0,71.0,867,04,01,  Chati Bahar,833,2486,435,1240,398,1246,25.1,26.0,24.2,00000
91.0,27.0,71.0,867,05,01,  Kachitila,12,280,6,144,6,136,4.1,4.0,4.2,00000
91.0,27.0,71.0,938,01,01,  Taiya Pagla,5,358,3,183,2,175,1.4,1.6,1.1,00000
91.0,27.0,71.0,938,02,01,  Dakatibari,19,218,8,111,11,107,8.0,6.7,9.3,00000
91.0,27.0,71.0,952,01,01,  Telikhal,588,1589,317,745,271,844,27.0,29.8,24.3,00000
91.0,27.0,71.0,952,02,01,  Gaukhal,140,250,73,132,67,118,35.9,35.6,36.2,00000
91.0,27.0,71.0,952,03,01,  Burdeo,95,716,54,369,41,347,11.7,12.8,10.6,00000
91.0,31.0,30.0,262,01,01,  Daulatpur (Rakhalganj Bazar),1543,696,779,323,764,373,68.9,70.7,67.2,00000
91.0,31.0,30.0,262,02,01,  Mirzanagar,486,404,239,172,247,232,54.6,58.2,51.6,00000
91.0,31.0,30.0,262,03,01,  Innat Alipur,565,396,260,185,305,211,58.8,58.4,59.1,00000
91.0,31.0,30.0,262,04,01,  Manikpur,155,167,78,85,77,82,48.1,47.9,48.4,00000
91.0,31.0,30.0,990,01,01,  Turukhala,1526,1098,779,547,747,551,58.2,58.7,57.6,00000
91.0,31.0,30.0,990,02,01,  Hossainpur,202,176,79,74,123,102,53.4,51.6,54.7,00000
91.0,31.0,36.0,113,01,03,  Baraikandi,1912,1362,1100,648,812,714,58.4,62.9,53.2,00000
91.0,31.0,36.0,113,02,03,  Reasat,72,157,40,66,32,91,31.4,37.7,26.0,00000
91.0,31.0,36.0,113,03,03,  Sunampur,333,406,181,212,152,194,45.1,46.1,43.9,00000
91.0,31.0,36.0,113,04,03,  Kazirkhola,559,397,327,208,232,189,58.5,61.1,55.1,00000
91.0,31.0,36.0,270,01,01,  Royergaon,889,583,475,257,414,326,60.4,64.9,55.9,00000
91.0,31.0,36.0,270,02,01,  Lauai,489,77,281,25,208,52,86.4,91.8,80.0,00000
91.0,31.0,36.0,270,03,01,  Ummer Kabul,628,292,386,151,242,141,68.3,71.9,63.2,00000
91.0,31.0,36.0,270,04,01,  Mohammadpur,205,144,112,72,93,72,58.7,60.9,56.4,00000
91.0,31.0,36.0,270,05,01,  Kamu Sena,117,119,55,48,62,71,49.6,53.4,46.6,00000
91.0,31.0,36.0,341,01,03,  Galimpur,218,60,101,33,117,27,78.4,75.4,81.3,00000
91.0,31.0,36.0,341,02,03,  Bakshipur,433,123,232,50,201,73,77.9,82.3,73.4,00000
91.0,31.0,36.0,341,03,03,  Janipur,1746,947,929,443,817,504,64.8,67.7,61.8,00000
91.0,31.0,36.0,341,04,03,  Chandai,595,141,304,61,291,80,80.8,83.3,78.4,00000
91.0,31.0,36.0,341,05,03,  Talukdar Para,404,231,215,102,189,129,63.6,67.8,59.4,00000
91.0,31.0,36.0,341,06,03,  Nazarpur,180,42,110,24,70,18,81.1,82.1,79.5,00000
91.0,31.0,36.0,341,07,03,  Teorgaon,504,382,258,179,246,203,56.9,59.0,54.8,00000
91.0,31.0,36.0,341,08,03,  Paschimpara,295,129,150,56,145,73,69.6,72.8,66.5,00000
91.0,31.0,36.0,341,09,03,  Teli Para,238,181,132,86,106,95,56.8,60.6,52.7,00000
91.0,31.0,36.0,732,01,01,  Pirijpur,1204,996,697,514,507,482,54.7,57.6,51.3,00000
91.0,31.0,36.0,732,02,01,  Parbatipur,707,465,373,223,334,242,60.3,62.6,58.0,00000
91.0,31.0,37.0,004,01,01,  Abdullahpur,107,59,56,23,51,36,64.5,70.9,58.6,00000
91.0,31.0,37.0,004,02,01,  Bara Chak,388,327,160,148,228,179,54.3,51.9,56.0,00000
91.0,31.0,37.0,004,03,01,  Naki Bara Chak,153,46,73,26,80,20,76.9,73.7,80.0,00000
91.0,31.0,37.0,014,01,01,  Alamdin,932,636,477,314,455,322,59.4,60.3,58.6,00000
91.0,31.0,37.0,014,02,01,  Sharlong,116,41,50,18,66,23,73.9,73.5,74.2,00000
91.0,31.0,37.0,044,01,01,  Azmatpur,342,225,165,121,177,104,60.3,57.7,63.0,00000
91.0,31.0,37.0,044,02,01,  Dash Para,169,99,81,44,88,55,63.1,64.8,61.5,00000
91.0,31.0,37.0,044,03,01,  Mirergaon,422,165,200,77,222,88,71.9,72.2,71.6,00000
91.0,31.0,37.0,044,04,01,  Maijbagh,292,188,143,88,149,100,60.8,61.9,59.8,00000
91.0,31.0,37.0,044,05,01,  Daudpur,142,147,74,68,68,79,49.1,52.1,46.3,00000
91.0,31.0,37.0,044,06,01,  Dakshin Takirmura,126,179,58,89,68,90,41.3,39.5,43.0,00000
91.0,31.0,37.0,044,07,01,  Nashir Raji,66,82,34,35,32,47,44.6,49.3,40.5,00000
91.0,31.0,37.0,202,01,01,  Burunda,385,672,189,351,196,321,36.4,35.0,37.9,00000
91.0,31.0,37.0,202,02,01,  Noagaon,29,125,11,60,18,65,18.8,15.5,21.7,00000
91.0,31.0,37.0,202,03,01,  Uttar Karimpur,200,371,95,169,105,202,35.0,36.0,34.2,00000
91.0,31.0,37.0,202,04,01,  Dakshin Karimpur,322,858,155,408,167,450,27.3,27.5,27.1,00000
91.0,31.0,37.0,371,01,01,  Hasampur,522,239,262,105,260,134,68.6,71.4,66.0,00000
91.0,31.0,37.0,371,02,01,  Badeshpur,206,177,103,77,103,100,53.8,57.2,50.7,00000
91.0,31.0,37.0,371,03,01,  Shibar Chak,241,174,110,83,131,91,58.1,57.0,59.0,00000
91.0,31.0,37.0,371,04,01,  Satbila,271,225,134,109,137,116,54.6,55.1,54.2,00000
91.0,31.0,37.0,371,05,01,  Sundar Chak,50,152,18,80,32,72,24.8,18.4,30.8,00000
91.0,31.0,37.0,371,06,01,  Sekhpur,150,203,70,120,80,83,42.5,36.8,49.1,00000
91.0,31.0,37.0,371,07,01,  Mandabaz,96,95,40,52,56,43,50.3,43.5,56.6,00000
91.0,31.0,37.0,371,08,01,  Kona Para,38,48,19,22,19,26,44.2,46.3,42.2,00000
91.0,31.0,37.0,371,09,01,  Dhar Para,189,274,87,131,102,143,40.8,39.9,41.6,00000
91.0,31.0,37.0,371,10,01,  Pirilakona,65,79,39,41,26,38,45.1,48.8,40.6,00000
91.0,31.0,37.0,371,11,01,  Gujarkandi,81,37,43,20,38,17,68.6,68.3,69.1,00000
91.0,31.0,37.0,648,01,01,  Murti,461,527,205,262,256,265,46.7,43.9,49.1,00000
91.0,31.0,37.0,648,02,01,  Brahmangaon,28,40,14,25,14,15,41.2,35.9,48.3,00000
91.0,31.0,37.0,648,03,01,  Samspur,622,373,306,160,316,213,62.5,65.7,59.7,00000
91.0,31.0,37.0,648,04,01,  Malakandi,189,299,83,143,106,156,38.7,36.7,40.5,00000
91.0,31.0,37.0,782,01,01,  Roykhal,532,487,253,237,279,250,52.2,51.6,52.7,00000
91.0,31.0,37.0,782,02,01,  Sikdargaon,107,79,57,32,50,47,57.5,64.0,51.5,00000
91.0,31.0,37.0,782,03,01,  Bhuiyargaon,97,47,42,26,55,21,67.4,61.8,72.4,00000
91.0,31.0,37.0,782,04,01,  Mirgaon,292,115,130,56,162,59,71.7,69.9,73.3,00000
91.0,31.0,37.0,782,05,01,  Uttar Roykhal,175,135,72,69,103,66,56.5,51.1,60.9,00000
91.0,31.0,37.0,806,01,01,  Sabdalpur,812,957,417,470,395,487,45.9,47.0,44.8,00000
91.0,31.0,37.0,806,02,01,  Uttar Takirmura,289,576,151,277,138,299,33.4,35.3,31.6,00000
91.0,31.0,37.0,806,03,01,  Mokam Doar,213,464,89,211,124,253,31.5,29.7,32.9,00000
91.0,31.0,37.0,806,04,01,  Takir Mahal,454,107,217,42,237,65,80.9,83.8,78.5,00000
91.0,31.0,37.0,806,05,01,  Sekh Para,856,511,430,205,426,306,62.6,67.7,58.2,00000
91.0,31.0,37.0,806,06,01,  Jalalpur Bazar,302,277,158,135,144,142,52.2,53.9,50.3,00000
91.0,31.0,37.0,895,01,01,  Sunampur,225,336,99,155,126,181,40.1,39.0,41.0,00000
91.0,31.0,37.0,895,02,01,  Sengram,321,231,165,119,156,112,58.2,58.1,58.2,00000
91.0,31.0,37.0,895,03,01,  Purba Mokam Doar,104,403,48,197,56,206,20.5,19.6,21.4,00000
91.0,31.0,37.0,895,04,01,  Bairagir Bazar,52,94,21,46,31,48,35.6,31.3,39.2,00000
91.0,31.0,45.0,325,01,03,  Habinandi,209,50,123,22,86,28,80.7,84.8,75.4,00000
91.0,31.0,45.0,325,02,03,  Samal Hasan,177,137,84,72,93,65,56.4,53.8,58.9,00000
91.0,31.0,45.0,325,03,03,  Majlishpur,172,113,89,59,83,54,60.4,60.1,60.6,00000
91.0,31.0,45.0,549,01,01,  Kuchai,1655,1058,939,470,716,588,61.0,66.6,54.9,00000
91.0,31.0,45.0,549,02,01,  Sharping,735,190,382,66,353,124,79.5,85.3,74.0,00000
91.0,31.0,45.0,693,01,01,  Palpur Kushighat,577,255,317,108,260,147,69.4,74.6,63.9,00000
91.0,31.0,45.0,693,02,01,  Chita Sreerampur,235,130,125,63,110,67,64.4,66.5,62.1,00000
91.0,31.0,45.0,712,01,01,  Paschimbhag,624,918,315,484,309,434,40.5,39.4,41.6,00000
91.0,31.0,45.0,712,02,01,  Noagaon,1643,852,862,388,781,464,65.9,69.0,62.7,00000
91.0,31.0,45.0,940,01,01,  Sultanpur Chak,527,374,286,164,241,210,58.5,63.6,53.4,00000
91.0,31.0,45.0,940,02,01,  Tayab Kamal,313,306,160,152,153,154,50.6,51.3,49.8,00000
91.0,31.0,45.0,940,03,01,  Sekh Para,348,274,197,119,151,155,55.9,62.3,49.3,00000
91.0,31.0,50.0,009,01,01,  Adityapur,219,211,115,108,104,103,50.9,51.6,50.2,00000
91.0,31.0,50.0,029,02,01,  Nurpur,188,177,118,101,70,76,51.5,53.9,47.9,00000
91.0,31.0,50.0,029,03,01,  Kutubpur,243,92,135,42,108,50,72.5,76.3,68.4,00000
91.0,31.0,50.0,029,04,01,  Jhajar,180,258,98,123,82,135,41.1,44.3,37.8,00000
91.0,31.0,50.0,029,05,01,  Narsingpur,193,192,105,91,88,101,50.1,53.6,46.6,00000
91.0,31.0,50.0,029,06,01,  Sarabazpur,221,280,106,147,115,133,44.1,41.9,46.4,00000
91.0,31.0,50.0,054,01,01,  Badu Haji,248,201,128,102,120,99,55.2,55.7,54.8,00000
91.0,31.0,50.0,054,02,01,  Fuldi,259,297,119,144,140,153,46.6,45.2,47.8,00000
91.0,31.0,50.0,064,01,01,  Bagharkhala,415,174,212,75,203,99,70.5,73.9,67.2,00000
91.0,31.0,50.0,064,03,01,  Doshal,308,235,170,115,138,120,56.7,59.6,53.5,00000
91.0,31.0,50.0,173,01,01,  Bibi Dail,626,729,304,353,322,376,46.2,46.3,46.1,00000
91.0,31.0,50.0,173,02,01,  Khatira,524,570,247,269,277,301,47.9,47.9,47.9,00000
91.0,31.0,50.0,173,03,01,  Kaikari,332,261,165,130,167,131,56.0,55.9,56.0,00000
91.0,31.0,50.0,173,04,01,  Mollarband,69,109,32,51,37,58,38.8,38.6,38.9,00000
91.0,31.0,50.0,301,01,01,  Gulna Khalpar,314,225,151,111,163,114,58.3,57.6,58.8,00000
91.0,31.0,50.0,301,02,01,  Pakhi Tengar 1,274,215,132,113,142,102,56.0,53.9,58.2,00000
91.0,31.0,50.0,301,03,01,  Alinagar,242,188,113,89,129,99,56.3,55.9,56.6,00000
91.0,31.0,50.0,301,04,01,  Paschimbagh,777,386,398,195,379,191,66.8,67.1,66.5,00000
91.0,31.0,50.0,301,05,01,  Faridpur,601,345,319,152,282,193,63.5,67.7,59.4,00000
91.0,31.0,50.0,301,07,01,  Akarnadi,242,115,136,50,106,65,67.8,73.1,62.0,00000
91.0,31.0,50.0,301,08,01,  Jafrabad,380,444,185,230,195,214,46.1,44.6,47.7,00000
91.0,31.0,50.0,301,09,01,  Pakhi Tengar 2,283,240,146,108,137,132,54.1,57.5,50.9,00000
91.0,31.0,50.0,301,10,01,  Bedsandi,201,150,111,80,90,70,57.3,58.1,56.3,00000
91.0,31.0,50.0,415,01,01,  Kaikash,396,211,205,98,191,113,65.2,67.7,62.8,00000
91.0,31.0,50.0,415,02,01,  Senpara,337,103,167,49,170,54,76.6,77.3,75.9,00000
91.0,31.0,50.0,509,01,01,  Khalpar,224,276,97,136,127,140,44.8,41.6,47.6,00000
91.0,31.0,50.0,509,02,01,  Bharsona,377,236,179,118,198,118,61.5,60.3,62.7,00000
91.0,31.0,50.0,534,01,01,  Khozkhalu,307,176,165,89,142,87,63.6,65.0,62.0,00000
91.0,31.0,50.0,534,02,01,  Sahasikandar,211,240,101,108,110,132,46.8,48.3,45.5,00000
91.0,31.0,50.0,534,03,01,  Naziragaon,233,299,119,142,114,157,43.8,45.6,42.1,00000
91.0,31.0,50.0,534,04,01,  Garadika,198,165,100,70,98,95,54.5,58.8,50.8,00000
91.0,31.0,50.0,752,01,01,  Rajapur,315,275,151,140,164,135,53.4,51.9,54.8,00000
91.0,31.0,50.0,752,02,01,  Hakiar Char,193,198,100,93,93,105,49.4,51.8,47.0,00000
91.0,31.0,50.0,752,03,01,  Chakripur,181,199,86,105,95,94,47.6,45.0,50.3,00000
91.0,31.0,50.0,785,01,01,  Lalargaon,178,285,109,162,69,123,38.4,40.2,35.9,00000
91.0,31.0,50.0,785,02,01,  Rajibari (Hilu),244,249,117,132,127,117,49.5,47.0,52.0,00000
91.0,31.0,50.0,785,03,01,  Bhoraut,643,509,333,237,310,272,55.8,58.4,53.3,00000
91.0,31.0,60.0,099,01,01,  Bhagatipur,241,100,127,49,114,51,70.7,72.2,69.1,00000
91.0,31.0,60.0,099,02,01,  Ramjanpur,88,81,57,31,31,50,52.1,64.8,38.3,00000
91.0,31.0,60.0,099,03,01,  Banamalipur(Perer Chak),54,166,22,81,32,85,24.5,21.4,27.4,00000
91.0,31.0,60.0,099,04,01,  Horinathpur,204,112,112,53,92,59,64.6,67.9,60.9,00000
91.0,31.0,60.0,099,05,01,  Birmangal,189,100,100,46,89,54,65.4,68.5,62.2,00000
91.0,31.0,60.0,232,01,01,  Chhatighar,333,610,158,312,175,298,35.3,33.6,37.0,00000
91.0,31.0,60.0,232,02,01,  Nazirer Chak,396,722,216,350,180,372,35.4,38.2,32.6,00000
91.0,31.0,60.0,232,03,01,  Khalmukh Bazar,68,105,36,52,32,53,39.3,40.9,37.6,00000
91.0,31.0,60.0,297,01,01,  Kamdebpur,373,261,179,116,194,145,58.8,60.7,57.2,00000
91.0,31.0,60.0,297,02,01,  Kandigram,560,227,467,103,93,124,71.2,81.9,42.9,00000
91.0,31.0,60.0,297,03,01,  Sajidalad,180,253,92,133,88,120,41.6,40.9,42.3,00000
91.0,31.0,60.0,297,04,01,  Horinathpur,149,347,79,167,70,180,30.0,32.1,28.0,00000
91.0,31.0,60.0,297,05,01,  Noagaon,242,188,125,82,117,106,56.3,60.4,52.5,00000
91.0,31.0,60.0,297,06,01,  Bir Mangal,194,206,97,96,97,110,48.5,50.3,46.9,00000
91.0,31.0,60.0,297,07,01,  Sadatpur,341,330,146,157,195,173,50.8,48.2,53.0,00000
91.0,31.0,60.0,297,08,01,  Sisrakandi,392,569,176,239,216,330,40.8,42.4,39.6,00000
91.0,31.0,60.0,297,09,01,  Dhupakandi,441,308,208,142,233,166,58.9,59.4,58.4,00000
91.0,31.0,60.0,366,01,01,  Hara Gauri,687,403,341,189,346,214,63.0,64.3,61.8,00000
91.0,31.0,60.0,366,02,01,  Mirzapur,273,232,125,114,148,118,54.1,52.3,55.6,00000
91.0,31.0,60.0,366,03,01,  Mahmudabad,579,412,274,209,305,203,58.4,56.7,60.0,00000
91.0,31.0,60.0,366,04,01,  Jahanpur,560,255,290,116,270,139,68.7,71.4,66.0,00000
91.0,31.0,60.0,366,05,01,  Mogla Bazar,248,301,136,144,112,157,45.2,48.6,41.6,00000
91.0,31.0,60.0,475,01,01,  Darampur,569,608,273,285,296,323,48.3,48.9,47.8,00000
91.0,31.0,60.0,475,03,01,  Hajiganj Bazar,188,363,89,179,99,184,34.1,33.2,35.0,00000
91.0,31.0,60.0,658,01,01,  Jalkarkandi,103,120,53,60,50,60,46.2,46.9,45.5,00000
91.0,31.0,60.0,658,02,01,  Kutubpur,438,210,237,93,201,117,67.6,71.8,63.2,00000
91.0,31.0,60.0,658,03,01,  Purbabagh,178,71,84,33,94,38,71.5,71.8,71.2,00000
91.0,31.0,60.0,658,04,01,  Naikhai,1038,408,548,178,490,230,71.8,75.5,68.1,00000
91.0,31.0,60.0,658,05,01,  Mayadharpur,118,12,62,4,56,8,90.8,93.9,87.5,00000
91.0,31.0,60.0,658,06,01,  Madhu Pasari,157,40,80,15,77,25,79.7,84.2,75.5,00000
91.0,31.0,60.0,658,07,01,  Goaspur,47,29,20,15,27,14,61.8,57.1,65.9,00000
91.0,31.0,60.0,658,08,01,  Daudpur,131,104,71,51,60,53,55.7,58.2,53.1,00000
91.0,31.0,65.0,113,01,03,  Majidpur,28,226,17,104,11,122,11.0,14.0,8.3,00000
91.0,31.0,65.0,113,02,03,  Sirajganj,90,169,55,76,35,93,34.7,42.0,27.3,00000
91.0,31.0,65.0,321,01,01,  Goalgaon,556,117,292,44,264,73,82.6,86.9,78.3,00000
91.0,31.0,65.0,321,02,01,  Gopsha Haor,1171,663,619,308,552,355,63.8,66.8,60.9,00000
91.0,31.0,65.0,321,03,01,  Khidirpur,253,176,118,86,135,90,59.0,57.8,60.0,00000
91.0,31.0,65.0,321,04,01,  Niamatpur,407,179,212,103,195,76,69.5,67.3,72.0,00000
91.0,31.0,65.0,321,05,01,  Teliroy,725,278,390,122,335,156,72.3,76.2,68.2,00000
91.0,31.0,65.0,376,01,01,  Krishnapur,235,294,117,147,118,147,44.4,44.3,44.5,00000
91.0,31.0,65.0,376,02,01,  Betuar Muk,377,527,166,264,211,263,41.7,38.6,44.5,00000
91.0,31.0,65.0,376,03,01,  Majh Hajrai,417,388,231,184,186,204,51.8,55.7,47.7,00000
91.0,31.0,65.0,376,04,01,  Lama Hajrai,550,329,300,135,250,194,62.6,69.0,56.3,00000
91.0,31.0,65.0,376,05,01,  Chowdhurygaon,535,646,287,321,248,325,45.3,47.2,43.3,00000
91.0,31.0,65.0,376,06,01,  Upar Hajrai,367,233,167,98,200,135,61.2,63.0,59.7,00000
91.0,31.0,65.0,376,07,01,  Chitta Hajrai,125,130,56,58,69,72,49.0,49.1,48.9,00000
91.0,31.0,65.0,376,08,01,  Sayedpur,303,506,141,254,162,252,37.5,35.7,39.1,00000
91.0,31.0,65.0,564,01,01,  Lakshmi Pasha,299,302,143,139,156,163,49.8,50.7,48.9,00000
91.0,31.0,65.0,564,02,01,  Nobhagi,459,306,241,157,218,149,60.0,60.6,59.4,00000
91.0,31.0,65.0,564,03,01,  Kurigram,612,646,311,303,301,343,48.6,50.7,46.7,00000
91.0,31.0,65.0,564,04,01,  Purangaon,716,621,370,287,346,334,53.6,56.3,50.9,00000
91.0,31.0,65.0,564,05,01,  Lalpur,81,76,43,33,38,43,51.6,56.6,46.9,00000
91.0,31.0,65.0,564,06,01,  Mortashpur,130,198,71,100,59,98,39.6,41.5,37.6,00000
91.0,31.0,65.0,564,07,01,  Munshirgaon,229,231,112,118,117,113,49.8,48.7,50.9,00000
91.0,31.0,65.0,564,08,01,  Guptargaon,327,291,168,148,159,143,52.9,53.2,52.6,00000
91.0,31.0,65.0,564,09,01,  Supur,152,148,80,76,72,72,50.7,51.3,50.0,00000
91.0,31.0,65.0,564,10,01,  Bhatergaon,32,166,14,80,18,86,16.2,14.9,17.3,00000
91.0,31.0,65.0,584,01,01,  Latibpur,183,69,87,27,96,42,72.6,76.3,69.6,00000
91.0,31.0,65.0,584,02,01,  Nidanpur,232,88,124,34,108,54,72.5,78.5,66.7,00000
91.0,31.0,65.0,584,03,01,  Rifatpur,213,107,109,43,104,64,66.6,71.7,61.9,00000
91.0,31.0,65.0,628,01,01,  Tajpur,134,227,67,110,67,117,37.1,37.9,36.4,00000
91.0,31.0,65.0,628,02,01,  Suklampur,312,310,148,147,164,163,50.2,50.2,50.2,00000
91.0,31.0,65.0,628,03,01,  Shunu Para,323,264,154,128,169,136,55.0,54.6,55.4,00000
91.0,31.0,65.0,811,01,01,  Sadharkhala,430,282,242,123,188,159,60.4,66.3,54.2,00000
91.0,31.0,65.0,811,02,01,  Mandirkhola,346,309,174,149,172,160,52.8,53.9,51.8,00000
91.0,31.0,65.0,811,03,01,  Khalpar,646,221,338,81,308,140,74.5,80.7,68.8,00000
91.0,31.0,65.0,811,04,01,  Mollargaon,659,84,356,26,303,58,88.7,93.2,83.9,00000
91.0,31.0,75.0,158,01,01,  Paschimpara,231,144,116,60,115,84,61.6,65.9,57.8,00000
91.0,31.0,75.0,158,02,01,  Purbapara,230,145,122,69,108,76,61.3,63.9,58.7,00000
91.0,31.0,75.0,188,01,01,  Kismat Birahimpur,172,78,81,31,91,47,68.8,72.3,65.9,00000
91.0,31.0,75.0,188,02,01,  Birahimpur,316,261,172,124,144,137,54.8,58.1,51.2,00000
91.0,31.0,75.0,217,01,01,  Fakir Para,141,40,63,14,78,26,77.9,81.8,75.0,00000
91.0,31.0,75.0,217,02,01,  Aga Char,314,296,156,132,158,164,51.5,54.2,49.1,00000
91.0,31.0,75.0,217,03,01,  Char Mohammadpur,456,243,241,102,215,141,65.2,70.3,60.4,00000
91.0,31.0,75.0,217,04,01,  Sahapur,173,101,95,46,78,55,63.1,67.4,58.6,00000
91.0,31.0,75.0,430,01,01,  Hajipur,317,258,177,123,140,135,55.1,59.0,50.9,00000
91.0,31.0,75.0,430,02,01,  Majorgaon,270,263,135,120,135,143,50.7,52.9,48.6,00000
91.0,31.0,75.0,430,03,01,  Akilpur,205,103,121,46,84,57,66.6,72.5,59.6,00000
91.0,31.0,75.0,519,01,01,  Khararia,1213,932,567,421,646,511,56.6,57.4,55.8,00000
91.0,31.0,75.0,519,02,01,  Mollar Chak,469,300,238,149,231,151,61.0,61.5,60.5,00000
91.0,31.0,75.0,737,01,01,  Ulal Mahal,805,293,400,118,405,175,73.3,77.2,69.8,00000
91.0,31.0,75.0,737,02,01,  Gazi Para,372,281,178,122,194,159,57.0,59.3,55.0,00000
91.0,31.0,75.0,737,03,01,  Bhupal,83,26,44,7,39,19,76.1,86.3,67.2,00000
91.0,31.0,75.0,737,04,01,  Inkhai,47,34,21,14,26,20,58.0,60.0,56.5,00000
91.0,31.0,75.0,801,01,01,  Tila Para,381,155,190,71,191,84,71.1,72.8,69.5,00000
91.0,31.0,75.0,801,02,01,  Purbapara,595,281,275,154,320,127,67.9,64.1,71.6,00000
91.0,31.0,75.0,801,03,01,  Thal Para,136,287,68,148,68,139,32.2,31.5,32.9,00000
91.0,31.0,75.0,801,04,01,  Goalgaon,494,370,247,178,247,192,57.2,58.1,56.3,00000
91.0,31.0,75.0,876,01,01,  Paschimpara,531,211,276,89,255,122,71.6,75.6,67.6,00000
91.0,31.0,75.0,876,02,01,  Naya Para,129,183,66,85,63,98,41.3,43.7,39.1,00000
91.0,31.0,75.0,876,03,01,  Khalpar,193,84,91,41,102,43,69.7,68.9,70.3,00000
91.0,31.0,75.0,876,04,01,  Dhali Para,518,502,245,270,273,232,50.8,47.6,54.1,00000
91.0,31.0,75.0,876,05,01,  Sekh Para,581,367,325,165,256,202,61.3,66.3,55.9,00000
91.0,31.0,75.0,876,06,01,  Majh Para,291,290,152,147,139,143,50.1,50.8,49.3,00000
91.0,31.0,75.0,876,07,01,  Tila Para,756,521,366,235,390,286,59.2,60.9,57.7,00000
91.0,31.0,75.0,876,08,01,  Tekor Para,583,438,270,205,313,233,57.1,56.8,57.3,00000
91.0,31.0,75.0,876,09,01,  Sarkar Chak,234,145,115,67,119,78,61.7,63.2,60.4,00000
91.0,31.0,75.0,876,10,01,  Teli Para,602,239,305,104,297,135,71.6,74.6,68.8,00000
91.0,31.0,75.0,876,11,01,  Nij Silam,389,357,194,187,195,170,52.1,50.9,53.4,00000
91.0,31.0,75.0,876,12,01,  Char Katir Chak,320,330,158,155,162,175,49.2,50.5,48.1,00000
91.0,31.0,75.0,876,13,01,  Brahman Para,179,61,99,29,80,32,74.6,77.3,71.4,00000
91.0,31.0,75.0,905,01,01,  Purbapara,730,702,354,333,376,369,51.0,51.5,50.5,00000
91.0,31.0,75.0,905,02,01,  Paschimpara,631,654,314,322,317,332,49.1,49.4,48.8,00000
91.0,31.0,85.0,089,01,01,  Baldi,1307,601,710,298,597,303,68.5,70.4,66.3,00000
91.0,31.0,85.0,089,02,01,  Badikona,693,301,374,147,319,154,69.7,71.8,67.4,00000
91.0,31.0,85.0,089,03,01,  Dhupaghat,313,212,171,105,142,107,59.6,62.0,57.0,00000
91.0,31.0,85.0,089,04,01,  Purakastapur,379,265,179,123,200,142,58.9,59.3,58.5,00000
91.0,31.0,85.0,153,01,01,  Nijgaon,259,262,137,127,122,135,49.7,51.9,47.5,00000
91.0,31.0,85.0,153,02,01,  Bhalki,395,675,184,343,211,332,36.9,34.9,38.9,00000
91.0,31.0,85.0,270,01,01,  Dharadharpur,935,555,483,262,452,293,62.8,64.8,60.7,00000
91.0,31.0,85.0,270,02,01,  Mirer Para (Sanarpur),139,288,66,146,73,142,32.6,31.1,34.0,00000
91.0,31.0,85.0,584,01,01,  Beturpar,332,262,176,145,156,117,55.9,54.8,57.1,00000
91.0,31.0,85.0,584,02,01,  Latifpur,246,158,127,71,119,87,60.9,64.1,57.8,00000
91.0,31.0,85.0,584,03,01,  Baraikandi,384,147,289,63,95,84,72.3,82.1,53.1,00000
91.0,31.0,85.0,584,04,01,  Kheder Pur,318,185,147,84,171,101,63.2,63.6,62.9,00000
91.0,31.0,85.0,785,01,01,  Razibari Lalagaon,380,257,180,131,200,126,59.7,57.9,61.3,00000
91.0,31.0,85.0,785,02,01,  Dhargaon,225,132,130,68,95,64,63.0,65.7,59.7,00000
91.0,31.0,85.0,785,04,01,  Gangpar,261,219,143,98,118,121,54.4,59.3,49.4,00000
91.0,31.0,85.0,785,05,01,  Bongaon,187,210,95,99,92,111,47.1,49.0,45.3,00000
91.0,31.0,85.0,785,06,01,  Somipur,237,282,111,133,126,149,45.7,45.5,45.8,00000
91.0,31.0,85.0,785,07,01,  Gakulpur,151,268,68,146,83,122,36.0,31.8,40.5,00000
91.0,31.0,85.0,785,08,01,  Akilpur,304,240,152,117,152,123,55.9,56.5,55.3,00000
91.0,31.0,85.0,785,09,01,  Sunampur,331,147,163,69,168,78,69.2,70.3,68.3,00000
91.0,31.0,85.0,785,11,01,  Lalar Chak,247,91,138,40,109,51,73.1,77.5,68.1,00000
91.0,31.0,85.0,930,01,01,  Nischintapur,285,310,127,155,158,155,47.9,45.0,50.5,00000
91.0,31.0,85.0,930,02,01,  Talibpur,243,272,130,140,113,132,47.2,48.1,46.1,00000
91.0,31.0,85.0,930,03,01,  Tila Para,236,215,115,100,121,115,52.3,53.5,51.3,00000
91.0,31.0,85.0,955,01,01,  Mandalpur,369,73,199,29,170,44,83.5,87.3,79.4,00000
91.0,31.0,85.0,955,02,01,  Reyasadpur,364,196,199,88,165,108,65.0,69.3,60.4,00000
91.0,31.0,85.0,955,03,01,  Ahmedpur,507,532,253,269,254,263,48.8,48.5,49.1,00000
91.0,31.0,85.0,955,04,01,  Tetli,1093,726,571,367,522,359,60.1,60.9,59.3,00000
91.0,31.0,85.0,955,05,01,  Puran Tetli,341,171,176,80,165,91,66.6,68.8,64.5,00000
91.0,31.0,85.0,955,06,01,  Sitabaldi,206,176,111,75,95,101,53.9,59.7,48.5,00000
91.0,35.0,23.0,066,01,01,  Pathan Chak,393,639,176,281,217,358,38.1,38.5,37.7,00000
91.0,35.0,23.0,066,02,01,  Fakir Para,527,760,248,365,279,395,40.9,40.5,41.4,00000
91.0,35.0,23.0,066,03,01,  Katalpur,897,1512,402,707,495,805,37.2,36.2,38.1,00000
91.0,35.0,23.0,066,04,01,  Atghar,185,183,91,83,94,100,50.3,52.3,48.5,00000
91.0,35.0,23.0,066,05,01,  Dinpur,505,623,229,290,276,333,44.8,44.1,45.3,00000
91.0,35.0,23.0,066,06,01,  Khil Para,737,839,351,432,386,407,46.8,44.8,48.7,00000
91.0,35.0,23.0,066,07,01,  Elashpur,867,466,408,202,459,264,65.0,66.9,63.5,00000
91.0,35.0,23.0,066,08,01,  Mahidpur,615,748,297,326,318,422,45.1,47.7,43.0,00000
91.0,35.0,23.0,066,09,01,  Salehpur,168,114,69,54,99,60,59.6,56.1,62.3,00000
91.0,35.0,23.0,066,10,01,  Gazipur,104,232,49,110,55,122,31.0,30.8,31.1,00000
91.0,35.0,23.0,066,11,01,  Purbakandi,110,321,53,150,57,171,25.5,26.1,25.0,00000
91.0,35.0,23.0,066,12,01,  Dandipara,234,338,100,166,134,172,40.9,37.6,43.8,00000
91.0,35.0,23.0,132,01,03,  Islmapur,825,313,410,138,415,175,72.5,74.8,70.3,00000
91.0,35.0,23.0,132,02,03,  Kazibari,140,135,62,73,78,62,50.9,45.9,55.7,00000
91.0,35.0,23.0,132,03,03,  Pathantila,319,219,173,94,146,125,59.3,64.8,53.9,00000
91.0,35.0,23.0,132,04,03,  Mogalpur,313,112,157,60,156,52,73.6,72.4,75.0,00000
91.0,35.0,23.0,132,05,03,  Niz Chhatish,353,557,213,314,140,243,38.8,40.4,36.6,00000
91.0,35.0,23.0,132,06,03,  Tafadar Tila,150,116,61,53,89,63,56.4,53.5,58.6,00000
91.0,35.0,23.0,132,07,03,  Naya Tila,125,170,66,89,59,81,42.4,42.6,42.1,00000
91.0,35.0,23.0,132,08,03,  Golaghat,134,126,55,49,79,77,51.5,52.9,50.6,00000
91.0,35.0,23.0,132,09,03,  K.M.Tila,184,131,101,67,83,64,58.4,60.1,56.5,00000
91.0,35.0,23.0,132,10,03,  Baidyanathpur,135,284,55,148,80,136,32.2,27.1,37.0,00000
91.0,35.0,23.0,132,11,03,  Rajanpur,923,555,485,231,438,324,62.4,67.7,57.5,00000
91.0,35.0,23.0,132,12,03,  Fenchuganj Bazar,1158,845,630,457,528,388,57.8,58.0,57.6,00000
91.0,35.0,23.0,132,13,03,  Jahaj Gudam,193,125,104,65,89,60,60.7,61.5,59.7,00000
91.0,35.0,23.0,132,14,03,  Manur Tuk,77,50,39,23,38,27,60.6,62.9,58.5,00000
91.0,35.0,23.0,132,15,03,  Pitai Tikar,1177,1710,587,861,590,849,40.8,40.5,41.0,00000
91.0,35.0,23.0,132,16,03,  Chhattish,1485,2842,769,1315,716,1527,34.3,36.9,31.9,00000
91.0,35.0,23.0,132,17,03,  Badar Tila,122,124,57,58,65,66,49.6,49.6,49.6,00000
91.0,35.0,23.0,895,01,01,  Gangapur,177,262,84,113,93,149,40.3,42.6,38.4,00000
91.0,35.0,23.0,895,02,01,  Lama Gangapur,509,453,214,200,295,253,52.9,51.7,53.8,00000
91.0,35.0,23.0,895,03,01,  Ujan Gangapur,117,377,47,194,70,183,23.7,19.5,27.7,00000
91.0,35.0,23.0,895,04,01,  Uttar Islampur,206,272,104,125,102,147,43.1,45.4,41.0,00000
91.0,35.0,23.0,895,05,01,  Kurchuchir Pur,68,145,31,72,37,73,31.9,30.1,33.6,00000
91.0,35.0,47.0,165,01,01,  Sailkandi,198,130,88,60,110,70,60.4,59.5,61.1,00000
91.0,35.0,47.0,165,02,01,  Krishnapur,12,3,8,1,4,2,80.0,88.9,66.7,00000
91.0,35.0,47.0,165,03,01,  Bade Deuli,1687,1744,782,852,905,892,49.2,47.9,50.4,00000
91.0,35.0,47.0,198,01,01,  Dakshin Dharan,121,335,56,166,65,169,26.5,25.2,27.8,00000
91.0,35.0,47.0,198,02,01,  Barabari,63,8,32,5,31,3,88.7,86.5,91.2,00000
91.0,35.0,47.0,198,03,01,  Mirzapur,237,265,102,152,135,113,47.2,40.2,54.4,00000
91.0,35.0,47.0,198,04,01,  Kurbanpur,364,148,175,63,189,85,71.1,73.5,69.0,00000
91.0,35.0,47.0,198,05,01,  Dharan,252,123,119,58,133,65,67.2,67.2,67.2,00000
91.0,35.0,47.0,198,06,01,  Dhaluchhara,11,96,9,44,2,52,10.3,17.0,3.7,00000
91.0,35.0,47.0,431,01,01,  Purba Judhishthipur,507,1620,261,764,246,856,23.8,25.5,22.3,00000
91.0,35.0,47.0,431,02,01,  Judhishthipur,1864,1497,887,709,977,788,55.5,55.6,55.4,00000
91.0,35.0,47.0,795,01,01,  Morapur Chabagan,241,313,153,130,88,183,43.5,54.1,32.5,00000
91.0,35.0,47.0,795,02,01,  Manipur,532,1224,269,586,263,638,30.3,31.5,29.2,00000
91.0,35.0,47.0,928,01,01,  Manik Kona,372,293,177,127,195,166,55.9,58.2,54.0,00000
91.0,35.0,47.0,928,02,01,  Ambari,562,565,262,254,300,311,49.9,50.8,49.1,00000
91.0,35.0,71.0,099,01,01,  Purangaon,379,176,185,89,194,87,68.3,67.5,69.0,00000
91.0,35.0,71.0,099,02,01,  Sharifganj,676,384,311,199,365,185,63.8,61.0,66.4,00000
91.0,35.0,71.0,099,03,01,  Fulbari,203,315,82,164,121,151,39.2,33.3,44.5,00000
91.0,35.0,71.0,232,01,01,  Faridpur,554,248,257,113,297,135,69.1,69.5,68.8,00000
91.0,35.0,71.0,232,02,01,  Brahman Para,221,57,115,29,106,28,79.5,79.9,79.1,00000
91.0,35.0,71.0,232,03,01,  Uttargaon,225,85,101,43,124,42,72.6,70.1,74.7,00000
91.0,35.0,71.0,232,04,01,  Majhergaon,366,135,170,57,196,78,73.1,74.9,71.5,00000
91.0,35.0,71.0,464,01,01,  Kachua Bahar,1115,1017,564,486,551,531,52.3,53.7,50.9,00000
91.0,35.0,71.0,464,02,01,  Mirzapur,203,92,115,40,88,52,68.8,74.2,62.9,00000
91.0,35.0,71.0,464,03,01,  Barhal,171,288,77,150,94,138,37.3,33.9,40.5,00000
91.0,35.0,71.0,663,01,01,  Maijgram,755,614,340,289,415,325,55.1,54.1,56.1,00000
91.0,35.0,71.0,663,02,01,  Fakir Para,495,159,240,61,255,98,75.7,79.7,72.2,00000
91.0,35.0,71.0,663,03,01,  Karimpur,247,102,118,54,129,48,70.8,68.6,72.9,00000
91.0,35.0,71.0,663,04,01,  Cheragi,226,43,114,17,112,26,84.0,87.0,81.2,00000
91.0,35.0,71.0,663,05,01,  Kumar Para,104,80,53,36,51,44,56.5,59.6,53.7,00000
91.0,35.0,71.0,663,06,01,  Hatubhanga,160,362,79,166,81,196,30.7,32.2,29.2,00000
91.0,35.0,71.0,663,07,01,  Noorpur,1471,838,723,404,748,434,63.7,64.2,63.3,00000
91.0,35.0,71.0,829,01,01,  Rokanpur,157,61,75,23,82,38,72.0,76.5,68.3,00000
91.0,35.0,71.0,829,02,01,  Narayanpur,233,138,112,74,121,64,62.8,60.2,65.4,00000
91.0,35.0,71.0,829,03,01,  Noagaon,280,494,116,254,164,240,36.2,31.4,40.6,00000
91.0,35.0,71.0,829,04,01,  Danaram,329,336,153,172,176,164,49.5,47.1,51.8,00000
91.0,35.0,71.0,829,05,01,  Chandpur,563,454,268,212,295,242,55.4,55.8,54.9,00000
91.0,35.0,71.0,862,01,01,  Nizampur,631,462,334,225,297,237,57.7,59.7,55.6,00000
91.0,35.0,71.0,862,02,01,  Sarkarkhana,3312,516,1774,202,1538,314,86.5,89.8,83.0,00000
91.0,35.0,71.0,862,03,01,  Puran Bazar,267,208,135,97,132,111,56.2,58.2,54.3,00000
91.0,38.0,13.0,069,01,01,  Amura,1087,821,579,389,508,432,57.0,59.8,54.0,00000
91.0,38.0,13.0,069,02,01,  Dampal,519,260,236,114,283,146,66.6,67.4,66.0,00000
91.0,38.0,13.0,069,03,01,  Islamtul,391,416,188,201,203,215,48.5,48.3,48.6,00000
91.0,38.0,13.0,388,01,01,  Upar Ghagua,459,561,226,261,233,300,45.0,46.4,43.7,00000
91.0,38.0,13.0,388,02,01,  Ghagua,477,727,243,365,234,362,39.6,40.0,39.3,00000
91.0,38.0,13.0,945,01,01,  Silghat,1528,1047,715,514,813,533,59.3,58.2,60.4,00000
91.0,38.0,13.0,945,02,01,  Shikpur,355,340,182,163,173,177,51.1,52.8,49.4,00000
91.0,38.0,15.0,119,01,01,  Lalnagar,936,838,497,360,439,478,52.8,58.0,47.9,00000
91.0,38.0,15.0,119,02,01,  Tudugaon,510,102,268,41,242,61,83.3,86.7,79.9,00000
91.0,38.0,15.0,119,03,01,  Daulatpur,385,77,180,33,205,44,83.3,84.5,82.3,00000
91.0,38.0,15.0,119,04,01,  Gaurabari,629,490,347,222,282,268,56.2,61.0,51.3,00000
91.0,38.0,15.0,119,05,01,  Gandamara,199,267,111,121,88,146,42.7,47.8,37.6,00000
91.0,38.0,15.0,119,06,01,  Islamabad,215,396,110,195,105,201,35.2,36.1,34.3,00000
91.0,38.0,15.0,119,07,01,  Ansar Mahallah,481,245,260,113,221,132,66.3,69.7,62.6,00000
91.0,38.0,15.0,119,08,01,  Fakir Para,126,43,60,16,66,27,74.6,78.9,71.0,00000
91.0,38.0,15.0,119,09,01,  Dakshin Bagha,336,302,187,134,149,168,52.7,58.3,47.0,00000
91.0,38.0,15.0,119,10,01,  Majher Mahallah,651,893,310,440,341,453,42.2,41.3,42.9,00000
91.0,38.0,15.0,119,11,01,  Saber Mahallah,423,172,228,64,195,108,71.1,78.1,64.4,00000
91.0,38.0,15.0,447,01,01,  Paschimgaon,716,576,324,281,392,295,55.4,53.6,57.1,00000
91.0,38.0,15.0,447,02,01,  Talamara,282,559,145,282,137,277,33.5,34.0,33.1,00000
91.0,38.0,15.0,447,03,01,  Uttar Golabnagar,749,861,370,359,379,502,46.5,50.8,43.0,00000
91.0,38.0,15.0,447,04,01,  Kandigaon,785,1217,400,573,385,644,39.2,41.1,37.4,00000
91.0,38.0,15.0,447,05,01,  Uttargaon,173,245,91,106,82,139,41.4,46.2,37.1,00000
91.0,38.0,15.0,447,06,01,  Upar Aglaspur,229,384,94,180,135,204,37.4,34.3,39.8,00000
91.0,38.0,15.0,447,07,01,  Purbagaon,326,453,165,201,161,252,41.8,45.1,39.0,00000
91.0,38.0,15.0,557,01,01,  Kalakona,1085,831,535,389,550,442,56.6,57.9,55.4,00000
91.0,38.0,15.0,557,02,01,  Ramganj,105,133,54,67,51,66,44.1,44.6,43.6,00000
91.0,38.0,15.0,557,03,01,  Lama Aglaspur,320,539,140,270,180,269,37.3,34.1,40.1,00000
91.0,38.0,15.0,557,04,01,  Betlarpar,148,295,63,146,85,149,33.4,30.1,36.3,00000
91.0,38.0,15.0,777,01,01,  Naluagram,498,366,253,164,245,202,57.6,60.7,54.8,00000
91.0,38.0,15.0,777,02,01,  Turukbhag,1101,719,543,354,558,365,60.5,60.5,60.5,00000
91.0,38.0,15.0,777,03,01,  Khalpar,520,1140,259,552,261,588,31.3,31.9,30.7,00000
91.0,38.0,15.0,777,04,01,  Majidpur,246,288,114,144,132,144,46.1,44.2,47.8,00000
91.0,38.0,15.0,777,05,01,  Jalalnagar,527,119,275,59,252,60,81.6,82.3,80.8,00000
91.0,38.0,15.0,777,06,01,  Rustampur,779,588,409,268,370,320,57.0,60.4,53.6,00000
91.0,38.0,15.0,777,07,01,  Kandigram,103,69,49,36,54,33,59.9,57.6,62.1,00000
91.0,38.0,17.0,189,01,01,  Sing Kapan,498,262,234,110,264,152,65.5,68.0,63.5,00000
91.0,38.0,17.0,189,02,01,  Silimkhani,169,129,91,62,78,67,56.7,59.5,53.8,00000
91.0,38.0,17.0,189,03,01,  Fatehkhali,625,324,298,142,327,182,65.9,67.7,64.2,00000
91.0,38.0,17.0,189,04,01,  Rajapur,521,321,264,145,257,176,61.9,64.5,59.4,00000
91.0,38.0,17.0,189,05,01,  Kalashur,1000,499,505,208,495,291,66.7,70.8,63.0,00000
91.0,38.0,17.0,189,06,01,  Maijbagh,1009,218,488,92,521,126,82.2,84.1,80.5,00000
91.0,38.0,17.0,189,07,01,  Dakshin Gaon (Fishary Para),899,866,453,408,446,458,50.9,52.6,49.3,00000
91.0,38.0,17.0,189,08,01,  Paschimbagh,1307,407,663,167,644,240,76.3,79.9,72.9,00000
91.0,38.0,17.0,189,09,01,  Murarkhir,143,382,62,197,81,185,27.2,23.9,30.5,00000
91.0,38.0,17.0,189,10,01,  Sekh Para,221,65,106,28,115,37,77.3,79.1,75.7,00000
91.0,38.0,17.0,189,11,01,  Dakhair Para,616,390,283,166,333,224,61.2,63.0,59.8,00000
91.0,38.0,17.0,189,12,01,  Dakshinbagh,1426,604,706,264,720,340,70.2,72.8,67.9,00000
91.0,38.0,17.0,189,13,01,  Uttargaon,368,354,174,162,194,192,51.0,51.8,50.3,00000
91.0,38.0,17.0,189,14,01,  Tera Goli,123,75,54,34,69,41,62.1,61.4,62.7,00000
91.0,38.0,17.0,189,15,01,  Dargah Dair,976,290,481,116,495,174,77.1,80.6,74.0,00000
91.0,38.0,17.0,189,16,01,  Bakar Pur,129,53,74,21,55,32,70.9,77.9,63.2,00000
91.0,38.0,17.0,189,17,01,  Fakirtul,356,176,178,82,178,94,66.9,68.5,65.4,00000
91.0,38.0,17.0,228,01,01,  Katakhaler Par,191,163,93,83,98,80,54.0,52.8,55.1,00000
91.0,38.0,17.0,228,02,01,  Khulia,108,98,54,48,54,50,52.4,52.9,51.9,00000
91.0,38.0,17.0,228,03,01,  Kauatiki,392,302,197,134,195,168,56.5,59.5,53.7,00000
91.0,38.0,17.0,268,01,01,  Gayashpur,484,381,218,193,266,188,56.0,53.0,58.6,00000
91.0,38.0,17.0,268,02,01,  Niaghol,111,76,51,32,60,44,59.4,61.4,57.7,00000
91.0,38.0,17.0,786,01,01,  Naliuri,918,465,419,211,499,254,66.4,66.5,66.3,00000
91.0,38.0,17.0,786,02,01,  Meherpur,519,404,246,179,273,225,56.2,57.9,54.8,00000
91.0,38.0,17.0,786,03,01,  Krishnapur,141,117,63,58,78,59,54.7,52.1,56.9,00000
91.0,38.0,17.0,786,04,01,  Nurpur,146,205,56,106,90,99,41.6,34.6,47.6,00000
91.0,38.0,17.0,786,05,01,  Terapur,205,173,88,76,117,97,54.2,53.7,54.7,00000
91.0,38.0,20.0,009,01,01,  Ahai,169,177,93,84,76,93,48.8,52.5,45.0,00000
91.0,38.0,20.0,009,02,01,  Hajipur,27,46,12,28,15,18,37.0,30.0,45.5,00000
91.0,38.0,20.0,149,01,01,  Konagram,218,252,102,121,116,131,46.4,45.7,47.0,00000
91.0,38.0,20.0,149,02,01,  Kargram,160,173,79,75,81,98,48.0,51.3,45.3,00000
91.0,38.0,20.0,149,03,01,  Baniagram,596,198,289,79,307,119,75.1,78.5,72.1,00000
91.0,38.0,20.0,208,01,01,  Baghirghat,418,151,202,60,216,91,73.5,77.1,70.4,00000
91.0,38.0,20.0,208,02,01,  Banagram,606,380,303,164,303,216,61.5,64.9,58.4,00000
91.0,38.0,20.0,208,03,01,  Kali Dahar,327,105,151,38,176,67,75.7,79.9,72.4,00000
91.0,38.0,20.0,208,04,01,  Bani Gazi,534,431,238,183,296,248,55.3,56.5,54.4,00000
91.0,38.0,20.0,208,05,01,  Chandarpur,1169,1025,580,498,589,527,53.3,53.8,52.8,00000
91.0,38.0,20.0,208,06,01,  Lama Chandarpur,434,437,200,215,234,222,49.8,48.2,51.3,00000
91.0,38.0,20.0,208,07,01,  Baithakhai,277,146,128,74,149,72,65.5,63.4,67.4,00000
91.0,38.0,20.0,567,01,01,  Chhattris,325,691,156,332,169,359,32.0,32.0,32.0,00000
91.0,38.0,20.0,567,02,01,  Kalijuri,893,1366,452,621,441,745,39.5,42.1,37.2,00000
91.0,38.0,20.0,567,03,01,  Kalijuri Bagirghat,139,125,90,84,49,41,52.7,51.7,54.4,00000
91.0,38.0,25.0,159,01,01,  Upar Barakut,2206,809,1123,335,1083,474,73.2,77.0,69.6,00000
91.0,38.0,25.0,159,02,01,  Lama Barakut,489,235,259,115,230,120,67.5,69.3,65.7,00000
91.0,38.0,25.0,308,01,01,  Dattarail,2290,2025,1170,952,1120,1073,53.1,55.1,51.1,00000
91.0,38.0,25.0,308,02,01,  Misra Para,832,390,407,184,425,206,68.1,68.9,67.4,00000
91.0,38.0,25.0,308,03,01,  Nagar,1507,749,753,319,754,430,66.8,70.2,63.7,00000
91.0,38.0,25.0,308,04,01,  Ahmidpur,63,56,27,23,36,33,52.9,54.0,52.2,00000
91.0,38.0,25.0,895,01,01,  Royghar,3648,1788,1774,809,1874,979,67.1,68.7,65.7,00000
91.0,38.0,25.0,895,02,01,  Sunampur,1389,964,670,434,719,530,59.0,60.7,57.6,00000
91.0,38.0,25.0,895,03,01,  Islampur,348,445,160,208,188,237,43.9,43.5,44.2,00000
91.0,38.0,36.0,169,01,01,  Basantapur,548,561,246,261,302,300,49.4,48.5,50.2,00000
91.0,38.0,36.0,169,02,01,  Kadupur,894,667,417,305,477,362,57.3,57.8,56.9,00000
91.0,38.0,36.0,169,03,01,  Rampur,22,29,10,16,12,13,43.1,38.5,48.0,00000
91.0,38.0,36.0,547,01,01,  Kadipur,610,432,281,197,329,235,58.5,58.8,58.3,00000
91.0,38.0,36.0,547,02,01,  Sener Chak,205,114,104,54,101,60,64.3,65.8,62.7,00000
91.0,38.0,36.0,547,03,01,  Nurjahanpur,207,239,92,97,115,142,46.4,48.7,44.7,00000
91.0,38.0,36.0,547,04,01,  Kalikrishnapur,1031,1924,486,960,545,964,34.9,33.6,36.1,00000
91.0,38.0,36.0,646,01,01,  Khatkhai,1402,1152,702,526,700,626,54.9,57.2,52.8,00000
91.0,38.0,36.0,646,02,01,  Punair Chak,938,941,388,435,550,506,49.9,47.1,52.1,00000
91.0,38.0,36.0,646,03,01,  Meherpur,1049,757,464,343,585,414,58.1,57.5,58.6,00000
91.0,38.0,43.0,497,01,01,  Hilalpur,890,545,448,256,442,289,62.0,63.6,60.5,00000
91.0,38.0,43.0,497,02,01,  Singpur,163,251,83,118,80,133,39.4,41.3,37.6,00000
91.0,38.0,43.0,497,03,01,  Bara Kapan,219,151,118,87,101,64,59.2,57.6,61.2,00000
91.0,38.0,43.0,736,01,01,  Uttar Maijbhag,450,1059,268,507,182,552,29.8,34.6,24.8,00000
91.0,38.0,43.0,736,02,01,  Dakshin Maijbhag,1045,1245,522,632,523,613,45.6,45.2,46.0,00000
91.0,38.0,51.0,199,01,01,  Chandanbhag,599,292,297,137,302,155,67.2,68.4,66.1,00000
91.0,38.0,51.0,199,02,01,  Tahirpur,326,256,148,172,178,84,56.0,46.3,67.9,00000
91.0,38.0,51.0,199,03,01,  Chhay Tikar,292,188,132,90,160,98,60.8,59.5,62.0,00000
91.0,38.0,51.0,218,01,01,  Satkhanda,280,107,132,50,148,57,72.4,72.5,72.2,00000
91.0,38.0,51.0,218,02,01,  Chhattish,684,254,364,100,320,154,72.9,78.4,67.5,00000
91.0,38.0,51.0,218,03,01,  Buti Tikar,139,86,67,42,72,44,61.8,61.5,62.1,00000
91.0,38.0,51.0,407,01,01,  Ghoga,235,82,109,36,126,46,74.1,75.2,73.3,00000
91.0,38.0,51.0,407,02,01,  Royghar,86,14,42,8,44,6,86.0,84.0,88.0,00000
91.0,38.0,51.0,437,01,01,  Girda,385,407,193,179,192,228,48.6,51.9,45.7,00000
91.0,38.0,51.0,437,02,01,  Akadum,212,41,103,18,109,23,83.8,85.1,82.6,00000
91.0,38.0,51.0,437,03,01,  Chowgharia,51,5,29,1,22,4,91.1,96.7,84.6,00000
91.0,38.0,51.0,935,01,01,  Nij Sherpur,228,58,105,25,123,33,79.7,80.8,78.8,00000
91.0,38.0,51.0,935,02,01,  Sherpur Khalagram,902,1405,445,678,457,727,39.1,39.6,38.6,00000
91.0,38.0,51.0,990,01,01,  Dakshin Gayeshpur,627,377,315,173,312,204,62.5,64.5,60.5,00000
91.0,38.0,51.0,990,02,01,  Ruigar,300,271,133,141,167,130,52.5,48.5,56.2,00000
91.0,38.0,51.0,990,03,01,  Kaitikar,206,149,89,70,117,79,58.0,56.0,59.7,00000
91.0,38.0,51.0,990,04,01,  Pattiura,180,101,80,56,100,45,64.1,58.8,69.0,00000
91.0,38.0,69.0,258,01,01,  Chandi Para,87,38,47,19,40,19,69.6,71.2,67.8,00000
91.0,38.0,69.0,258,02,01,  Fultala,390,147,192,60,198,87,72.6,76.2,69.5,00000
91.0,38.0,69.0,258,03,01,  Deopara,310,188,149,95,161,93,62.2,61.1,63.4,00000
91.0,38.0,69.0,258,04,01,  Puran Para,265,67,136,30,129,37,79.8,81.9,77.7,00000
91.0,38.0,69.0,258,05,01,  Sekh Para,170,67,85,31,85,36,71.7,73.3,70.2,00000
91.0,38.0,69.0,258,06,01,  Kandi Para,156,112,71,58,85,54,58.2,55.0,61.2,00000
91.0,38.0,69.0,258,07,01,  Noai Dakshinbagh,557,341,260,172,297,169,62.0,60.2,63.7,00000
91.0,38.0,69.0,258,08,01,  Hajrabari,35,17,12,10,23,7,67.3,54.5,76.7,00000
91.0,38.0,69.0,258,09,01,  Lechra Para,132,194,67,92,65,102,40.5,42.1,38.9,00000
91.0,38.0,69.0,258,10,01,  Chowdhury Para,308,474,141,230,167,244,39.4,38.0,40.6,00000
91.0,38.0,69.0,258,11,01,  Noai Chak,412,1162,193,556,219,606,26.2,25.8,26.5,00000
91.0,38.0,69.0,258,12,01,  Daulatpur,19,191,15,90,4,101,9.0,14.3,3.8,00000
91.0,38.0,69.0,318,01,01,  Bidya Tikar,779,411,393,191,386,220,65.5,67.3,63.7,00000
91.0,38.0,69.0,318,02,01,  Motherkha Para,279,296,160,135,119,161,48.5,54.2,42.5,00000
91.0,38.0,69.0,318,03,01,  Bakhtiar Ghat,198,239,91,116,107,123,45.3,44.0,46.5,00000
91.0,38.0,69.0,318,04,01,  Chakrabarti Para,197,124,97,54,100,70,61.4,64.2,58.8,00000
91.0,38.0,69.0,318,05,01,  Purakaista Para,170,98,82,45,88,53,63.4,64.6,62.4,00000
91.0,38.0,69.0,318,06,01,  Main Para,172,172,90,76,82,96,50.0,54.2,46.1,00000
91.0,38.0,69.0,318,07,01,  Munshi Para,274,304,118,165,156,139,47.4,41.7,52.9,00000
91.0,38.0,69.0,318,08,01,  Muslim Para,160,110,77,57,83,53,59.3,57.5,61.0,00000
91.0,38.0,69.0,318,09,01,  Chandi Para,106,118,46,54,60,64,47.3,46.0,48.4,00000
91.0,38.0,69.0,587,01,01,  Taher Para,12,46,5,22,7,24,20.7,18.5,22.6,00000
91.0,38.0,69.0,587,02,01,  Ujan Para,129,109,64,55,65,54,54.2,53.8,54.6,00000
91.0,38.0,69.0,587,03,01,  Puratan Para,52,100,27,47,25,53,34.2,36.5,32.1,00000
91.0,38.0,69.0,587,04,01,  Kargaon,31,22,18,11,13,11,58.5,62.1,54.2,00000
91.0,38.0,69.0,587,05,01,  Nama Para,86,100,37,43,49,57,46.2,46.3,46.2,00000
91.0,38.0,69.0,587,06,01,  Bangaon,54,159,31,76,23,83,25.4,29.0,21.7,00000
91.0,38.0,69.0,587,07,01,  Debpara,26,40,9,20,17,20,39.4,31.0,45.9,00000
91.0,38.0,69.0,587,08,01,  Lalpara,201,45,102,19,99,26,81.7,84.3,79.2,00000
91.0,38.0,69.0,587,09,01,  Adam Para,133,71,66,37,67,34,65.2,64.1,66.3,00000
91.0,38.0,69.0,587,10,01,  Maltila,229,94,101,51,128,43,70.9,66.4,74.9,00000
91.0,38.0,69.0,587,11,01,  Paschimtul,234,98,101,49,133,49,70.5,67.3,73.1,00000
91.0,38.0,69.0,587,12,01,  Mahendra Tila,76,110,42,64,34,46,40.9,39.6,42.5,00000
91.0,38.0,69.0,587,13,01,  Chapra Tila,18,9,14,4,4,5,66.7,77.8,44.4,00000
91.0,38.0,69.0,706,01,01,  Mirer Chak,73,35,36,15,37,20,67.6,70.6,64.9,00000
91.0,38.0,69.0,706,02,01,  Uttargaon,820,297,427,125,393,172,73.4,77.4,69.6,00000
91.0,38.0,69.0,706,03,01,  Hajipur,169,62,84,29,85,33,73.2,74.3,72.0,00000
91.0,38.0,69.0,706,04,01,  Purbabagh,309,275,141,136,168,139,52.9,50.9,54.7,00000
91.0,38.0,69.0,706,05,01,  Islamabad,419,303,193,146,226,157,58.0,56.9,59.0,00000
91.0,38.0,69.0,706,06,01,  Noagaon,63,26,32,12,31,14,70.8,72.7,68.9,00000
91.0,38.0,69.0,706,07,01,  Nilam Para,659,505,317,237,342,268,56.6,57.2,56.1,00000
91.0,38.0,69.0,706,08,01,  Chita Lakshanaband,49,60,25,32,24,28,45.0,43.9,46.2,00000
91.0,38.0,69.0,706,09,01,  Butra Para,626,371,303,171,323,200,62.8,63.9,61.8,00000
91.0,38.0,69.0,706,10,01,  Mollah Tikar,349,142,173,67,176,75,71.1,72.1,70.1,00000
91.0,38.0,69.0,855,01,01,  Nij Phulsaind,2468,1308,1174,609,1294,699,65.4,65.8,64.9,00000
91.0,38.0,69.0,855,02,01,  Purba Phulsaind,1188,1084,566,490,622,594,52.3,53.6,51.2,00000
91.0,38.0,77.0,029,01,01,  Dakshin Alampur,148,94,73,41,75,53,61.2,64.0,58.6,00000
91.0,38.0,77.0,029,02,01,  Alampur,147,200,72,89,75,111,42.4,44.7,40.3,00000
91.0,38.0,77.0,029,03,01,  Alampur Mandartala,61,69,30,34,31,35,46.9,46.9,47.0,00000
91.0,38.0,77.0,049,01,01,  Amkona,1647,1003,789,469,858,534,62.2,62.7,61.6,00000
91.0,38.0,77.0,049,02,01,  Khash,195,125,88,60,107,65,60.9,59.5,62.2,00000
91.0,38.0,77.0,049,03,01,  Debrai,41,15,18,7,23,8,73.2,72.0,74.2,00000
91.0,38.0,77.0,129,01,01,  Bagla,1172,1191,520,536,652,655,49.6,49.2,49.9,00000
91.0,38.0,77.0,129,02,01,  Chhalikona,325,546,125,268,200,278,37.3,31.8,41.8,00000
91.0,38.0,77.0,129,03,01,  Chhoyghari,331,143,139,59,192,84,69.8,70.2,69.6,00000
91.0,38.0,77.0,129,04,01,  Mirer Chak,225,335,88,165,137,170,40.2,34.8,44.6,00000
91.0,38.0,77.0,129,05,01,  Pitalkuri,39,100,12,49,27,51,28.1,19.7,34.6,00000
91.0,38.0,77.0,260,01,01,  Choarkandi,89,51,47,21,42,30,63.6,69.1,58.3,00000
91.0,38.0,77.0,260,02,01,  Anandapur,150,57,67,23,83,34,72.5,74.4,70.9,00000
91.0,38.0,77.0,358,01,01,  Satan Mardan,395,166,189,72,206,94,70.4,72.4,68.7,00000
91.0,38.0,77.0,358,02,01,  Hajirkona,236,160,101,82,135,78,59.6,55.2,63.4,00000
91.0,38.0,77.0,517,01,01,  Jamira,154,79,72,37,82,42,66.1,66.1,66.1,00000
91.0,38.0,77.0,517,02,01,  Kalaim,198,114,100,46,98,68,63.5,68.5,59.0,00000
91.0,38.0,77.0,686,01,01,  Konagaon,184,213,78,94,106,119,46.3,45.3,47.1,00000
91.0,38.0,77.0,686,02,01,  Uttar Alampur,292,429,127,196,165,233,40.5,39.3,41.5,00000
91.0,38.0,77.0,825,01,01,  Nohai,277,292,128,141,149,151,48.7,47.6,49.7,00000
91.0,38.0,77.0,825,02,01,  Mollar Chak,521,485,224,218,297,267,51.8,50.7,52.7,00000
91.0,38.0,77.0,975,01,01,  Supatek,748,746,352,352,396,394,50.1,50.0,50.1,00000
91.0,38.0,77.0,975,02,01,  Golapnagar,77,84,44,36,33,48,47.8,55.0,40.7,00000
91.0,41.0,31.0,089,01,01,  Baurbhag,502,416,273,179,229,237,54.7,60.4,49.1,00000
91.0,41.0,31.0,089,02,01,  Naya Gangerpar,401,381,200,175,201,206,51.3,53.3,49.4,00000
91.0,41.0,31.0,107,01,01,  Bhitrikhel,526,340,260,155,266,185,60.7,62.7,59.0,00000
91.0,41.0,31.0,107,02,01,  Kapaura,237,215,123,106,114,109,52.4,53.7,51.1,00000
91.0,41.0,31.0,107,03,01,  Radhanagar Bazar,252,74,161,49,91,25,77.3,76.7,78.4,00000
91.0,41.0,31.0,107,04,01,  Gangpar,89,26,48,10,41,16,77.4,82.8,71.9,00000
91.0,41.0,31.0,150,01,01,  Ashtam Khanda (Chailakhel),1135,1246,551,603,584,643,47.7,47.7,47.6,00000
91.0,41.0,31.0,150,02,01,  Purba Lakherpar,733,1414,386,702,347,712,34.1,35.5,32.8,00000
91.0,41.0,31.0,150,03,01,  Mali Para,216,236,116,118,100,118,47.8,49.6,45.9,00000
91.0,41.0,31.0,150,04,01,  Kayakandirpur,161,444,67,222,94,222,26.6,23.2,29.7,00000
91.0,41.0,31.0,150,05,01,  Mominpur,120,200,65,95,55,105,37.5,40.6,34.4,00000
91.0,41.0,31.0,153,01,01,  Shantinagar,322,984,169,508,153,476,24.7,25.0,24.3,00000
91.0,41.0,31.0,153,02,01,  Sonatila,123,291,68,144,55,147,29.7,32.1,27.2,00000
91.0,41.0,31.0,153,03,01,  Tama Bil,238,194,153,104,85,90,55.1,59.5,48.6,00000
91.0,41.0,31.0,159,01,01,  Sangram Basti,130,624,76,313,54,311,17.2,19.5,14.8,00000
91.0,41.0,31.0,159,02,01,  Sangram Punji,107,347,60,168,47,179,23.6,26.3,20.8,00000
91.0,41.0,31.0,159,03,01,  Naksiya Punji,244,217,127,105,117,112,52.9,54.7,51.1,00000
91.0,41.0,31.0,159,04,01,  Nama Punji,94,125,48,56,46,69,42.9,46.2,40.0,00000
91.0,41.0,31.0,168,01,01,  Muslimnagar,267,385,143,179,124,206,41.0,44.4,37.6,00000
91.0,41.0,31.0,168,02,01,  Kalinagar,671,1059,364,499,307,560,38.8,42.2,35.4,00000
91.0,41.0,31.0,168,03,01,  Pathar Tila,488,883,283,464,205,419,35.6,37.9,32.9,00000
91.0,41.0,31.0,168,04,01,  Balla Punji,105,494,61,255,44,239,17.5,19.3,15.5,00000
91.0,41.0,31.0,168,05,01,  Guchchhagram,248,352,150,175,98,177,41.3,46.2,35.6,00000
91.0,41.0,31.0,168,06,01,  Mohammadpur,964,1884,554,877,410,1007,33.8,38.7,28.9,00000
91.0,41.0,31.0,205,01,01,  Jaflong Basti,617,337,323,157,294,180,64.7,67.3,62.0,00000
91.0,41.0,31.0,205,02,01,  Naya Basti,456,406,232,212,224,194,52.9,52.3,53.6,00000
91.0,41.0,31.0,205,03,01,  Kandu Basti,220,271,109,136,111,135,44.8,44.5,45.1,00000
91.0,41.0,31.0,205,05,01,  Paschim Lakherpar,182,451,93,239,89,212,28.8,28.0,29.6,00000
91.0,41.0,31.0,407,01,01,  Islampur,536,526,273,252,263,274,50.5,52.0,49.0,00000
91.0,41.0,31.0,407,02,01,  Tripura Basti,160,262,82,143,78,119,37.9,36.4,39.6,00000
91.0,41.0,31.0,407,03,01,  Dubagh Basti,252,461,116,231,136,230,35.3,33.4,37.2,00000
91.0,41.0,31.0,407,04,01,  Alamnagar,442,895,213,452,229,443,33.1,32.0,34.1,00000
91.0,41.0,52.0,040,01,01,  Baleshwar,153,433,100,201,53,232,26.1,33.2,18.6,00000
91.0,41.0,52.0,040,02,01,  Deami,290,296,156,129,134,167,49.5,54.7,44.5,00000
91.0,41.0,52.0,345,01,01,  Ghoshgram,143,792,87,387,56,405,15.3,18.4,12.1,00000
91.0,41.0,52.0,345,02,01,  Datari,127,400,91,193,36,207,24.1,32.0,14.8,00000
91.0,41.0,52.0,345,03,01,  Sreenathpur,40,137,21,67,19,70,22.6,23.9,21.3,00000
91.0,41.0,63.0,014,01,01,  Angarjur,991,1872,523,879,468,993,34.6,37.3,32.0,00000
91.0,41.0,63.0,014,02,01,  Damarirpar,48,52,27,30,21,22,48.0,47.4,48.8,00000
91.0,41.0,63.0,182,01,01,  Chowdhurykandi,8,196,4,108,4,88,3.9,3.6,4.3,00000
91.0,41.0,63.0,182,02,01,  Kachuarpar,22,128,13,68,9,60,14.7,16.0,13.0,00000
91.0,41.0,63.0,559,01,01,  Lakshmi Haor,102,209,62,113,40,96,32.8,35.4,29.4,00000
91.0,41.0,63.0,559,02,01,  Zalur Mukh,51,332,34,178,17,154,13.3,16.0,9.9,00000
91.0,41.0,63.0,591,01,01,  Lama Para,133,423,73,202,60,221,23.9,26.5,21.4,00000
91.0,41.0,63.0,591,02,01,  Kadamtala,91,120,56,56,35,64,43.1,50.0,35.4,00000
91.0,41.0,63.0,876,01,01,  Raniganj,96,512,56,273,40,239,15.8,17.0,14.3,00000
91.0,41.0,63.0,876,02,01,  Kurerbari,42,225,31,120,11,105,15.7,20.5,9.5,00000
91.0,41.0,63.0,876,03,01,  Talarpar,58,134,30,62,28,72,30.2,32.6,28.0,00000
91.0,41.0,63.0,876,04,01,  Salu Tikar,62,30,50,16,12,14,67.4,75.8,46.2,00000
91.0,53.0,27.0,085,01,01,  Lama Para,612,572,340,277,272,295,51.7,55.1,48.0,00000
91.0,53.0,27.0,085,02,01,  Khadabul Banpara,333,543,175,230,158,313,38.0,43.2,33.5,00000
91.0,53.0,27.0,163,01,01,  Ajgram,49,246,20,125,29,121,16.6,13.8,19.3,00000
91.0,53.0,27.0,163,02,01,  Gauri,179,535,92,260,87,275,25.1,26.1,24.0,00000
91.0,53.0,27.0,295,01,01,  Lala,221,282,108,133,113,149,43.9,44.8,43.1,00000
91.0,53.0,27.0,295,02,01,  Balidara,174,177,95,82,79,95,49.6,53.7,45.4,00000
91.0,53.0,27.0,598,01,01,  Lalakhal Grant,345,417,228,170,117,247,45.3,57.3,32.1,00000
91.0,53.0,27.0,598,02,01,  Gangajuri,47,229,23,108,24,121,17.0,17.6,16.6,00000
91.0,53.0,27.0,738,01,01,  Nayakhel Purba,62,566,36,270,26,296,9.9,11.8,8.1,00000
91.0,53.0,27.0,738,02,01,  Balidara,160,434,88,213,72,221,26.9,29.2,24.6,00000
91.0,53.0,31.0,318,01,01,  Darbasta,400,227,216,98,184,129,63.8,68.8,58.8,00000
91.0,53.0,31.0,318,02,01,  Fandu,306,450,193,216,113,234,40.5,47.2,32.6,00000
91.0,53.0,31.0,458,01,01,  Sutarigram,94,660,51,316,43,344,12.5,13.9,11.1,00000
91.0,53.0,31.0,458,02,01,  Hazari Sengram,410,744,206,348,204,396,35.5,37.2,34.0,00000
91.0,53.0,45.0,394,01,01,  Hemu Head Para,460,764,265,356,195,408,37.6,42.7,32.3,00000
91.0,53.0,45.0,394,02,01,  Hemu Jowartul,199,257,113,109,86,148,43.6,50.9,36.8,00000
91.0,53.0,45.0,394,03,01,  Hemu Majartul,296,238,148,104,148,134,55.4,58.7,52.5,00000
91.0,53.0,45.0,394,04,01,  Hemu Namasudra Para,140,165,81,70,59,95,45.9,53.6,38.3,00000
91.0,53.0,45.0,394,05,01,  Hemu Bhat Para,496,370,283,157,213,213,57.3,64.3,50.0,00000
91.0,53.0,45.0,394,06,01,  Hemu Mokam Para,110,72,58,30,52,42,60.4,65.9,55.3,00000
91.0,53.0,45.0,394,07,01,  Hemu Majh Para,764,433,384,213,380,220,63.8,64.3,63.3,00000
91.0,53.0,45.0,394,08,01,  Hemu Datta Para,101,488,58,218,43,270,17.1,21.0,13.7,00000
91.0,53.0,52.0,077,01,01,  Baurbhag Molli Faud,375,417,186,182,189,235,47.3,50.5,44.6,00000
91.0,53.0,52.0,077,02,01,  Kandi,442,479,236,207,206,272,48.0,53.3,43.1,00000
91.0,53.0,52.0,077,03,01,  Kantakhal,144,143,75,63,69,80,50.2,54.3,46.3,00000
91.0,53.0,52.0,139,01,01,  Bhitrikhel Kanakhai,196,639,115,317,81,322,23.5,26.6,20.1,00000
91.0,53.0,52.0,139,02,01,  Gofrajan,124,230,64,112,60,118,35.0,36.4,33.7,00000
91.0,53.0,52.0,139,03,01,  Bhitrikhel Paschim Bhaber Band,115,162,56,80,59,82,41.5,41.2,41.8,00000
91.0,53.0,52.0,178,01,01,  Birakhai,237,617,113,300,124,317,27.8,27.4,28.1,00000
91.0,53.0,52.0,178,02,01,  Satigram,113,273,61,123,52,150,29.3,33.2,25.7,00000
91.0,53.0,63.0,326,01,01,  Daudig,178,351,86,173,92,178,33.6,33.2,34.1,00000
91.0,53.0,63.0,326,02,01,  Indrajure,332,360,171,172,161,188,48.0,49.9,46.1,00000
91.0,53.0,63.0,326,03,01,  Paschimpara,326,428,164,214,162,214,43.2,43.4,43.1,00000
91.0,53.0,63.0,357,01,01,  Dhupi,174,308,94,141,80,167,36.1,40.0,32.4,00000
91.0,53.0,63.0,357,02,01,  Kumar Para,144,172,70,83,74,89,45.6,45.8,45.4,00000
91.0,53.0,63.0,427,01,01,  Gauri Shankar,513,612,263,294,250,318,45.6,47.2,44.0,00000
91.0,53.0,63.0,427,02,01,  Fulbari,185,124,93,50,92,74,59.9,65.0,55.4,00000
91.0,53.0,63.0,450,01,01,  Noagram,201,270,96,142,105,128,42.7,40.3,45.1,00000
91.0,53.0,63.0,450,02,01,  Harni Mayna Basti,56,194,21,101,35,93,22.4,17.2,27.3,00000
91.0,53.0,63.0,466,01,01,  Helirai,93,89,43,46,50,43,51.1,48.3,53.8,00000
91.0,53.0,63.0,466,02,01,  Lutmail,185,190,89,84,96,106,49.3,51.4,47.5,00000
91.0,53.0,63.0,474,01,03,  Jaspur,366,429,197,208,169,221,46.0,48.6,43.3,00000
91.0,53.0,63.0,474,02,03,  Kamlabari,406,558,194,257,212,301,42.1,43.0,41.3,00000
91.0,53.0,63.0,474,03,03,  Bazar,296,170,178,80,118,90,63.5,69.0,56.7,00000
91.0,53.0,63.0,474,04,03,  Paniarahati,152,73,84,29,68,44,67.6,74.3,60.7,00000
91.0,53.0,63.0,474,05,03,  Mastinghati,239,122,127,54,112,68,66.2,70.2,62.2,00000
91.0,53.0,63.0,474,06,03,  Mauthihati,206,177,112,71,94,106,53.8,61.2,47.0,00000
91.0,53.0,63.0,474,07,03,  Ujaninagar,396,305,208,119,188,186,56.5,63.6,50.3,00000
91.0,53.0,63.0,474,08,03,  Toasihati,231,117,116,50,115,67,66.4,69.9,63.2,00000
91.0,53.0,63.0,474,09,03,  Majumdar Para,206,189,111,98,95,91,52.2,53.1,51.1,00000
91.0,53.0,63.0,474,10,03,  Kuli Para Jungle Hati,253,272,125,132,128,140,48.2,48.6,47.8,00000
91.0,53.0,63.0,474,11,03,  Chunahati,309,53,159,22,150,31,85.4,87.8,82.9,00000
91.0,53.0,63.0,474,12,03,  Lama Para,305,106,154,49,151,57,74.2,75.9,72.6,00000
91.0,53.0,63.0,474,13,03,  Bandarhati,218,183,108,79,110,104,54.4,57.8,51.4,00000
91.0,53.0,63.0,474,14,03,  Murgahati,101,41,56,16,45,25,71.1,77.8,64.3,00000
91.0,53.0,63.0,474,15,03,  Nijpat,159,28,80,6,79,22,85.0,93.0,78.2,00000
91.0,59.0,13.0,306,01,01,  Nayagram,134,376,65,182,69,194,26.3,26.3,26.2,00000
91.0,59.0,13.0,306,02,01,  Jamira,55,156,30,72,25,84,26.1,29.4,22.9,00000
91.0,59.0,13.0,728,01,01,  Ag Faud,40,184,27,97,13,87,17.9,21.8,13.0,00000
91.0,59.0,13.0,728,02,01,  Rangarai,105,374,54,180,51,194,21.9,23.1,20.8,00000
91.0,59.0,13.0,728,03,01,  Kadirgram,153,343,67,166,86,177,30.8,28.8,32.7,00000
91.0,59.0,13.0,740,01,01,  Parbatpur,433,482,218,202,215,280,47.3,51.9,43.4,00000
91.0,59.0,13.0,740,02,01,  Ratanpur,319,183,175,97,144,86,63.5,64.3,62.6,00000
91.0,59.0,13.0,740,03,01,  Naya Faud,111,200,52,110,59,90,35.7,32.1,39.6,00000
91.0,59.0,13.0,740,04,01,  Dungragram,240,282,116,133,124,149,46.0,46.6,45.4,00000
91.0,59.0,13.0,945,01,01,  Kazir Patan,141,520,75,207,66,313,21.3,26.6,17.4,00000
91.0,59.0,13.0,945,02,01,  Bagaragan,187,277,120,123,67,154,40.3,49.4,30.3,00000
91.0,59.0,13.0,945,03,01,  Uparbarai,180,467,103,239,77,228,27.8,30.1,25.2,00000
91.0,59.0,13.0,945,04,01,  Majhbarai,74,324,42,150,32,174,18.6,21.9,15.5,00000
91.0,59.0,13.0,945,05,01,  Betu,178,534,110,234,68,300,25.0,32.0,18.5,00000
91.0,59.0,13.0,980,01,01,  Ag Faud,485,260,271,113,214,147,65.1,70.6,59.3,00000
91.0,59.0,13.0,980,02,01,  Naya Faud,96,175,49,84,47,91,35.4,36.8,34.1,00000
91.0,59.0,13.0,980,03,01,  Mulli Faud,130,219,67,98,63,121,37.2,40.6,34.2,00000
91.0,59.0,13.0,980,04,01,  Haru Faud,553,552,275,261,278,291,50.0,51.3,48.9,00000
91.0,59.0,19.0,296,01,01,  Mazarhara,106,121,54,51,52,70,46.7,51.4,42.6,00000
91.0,59.0,19.0,296,02,01,  Khalerpar,336,456,167,210,169,246,42.4,44.3,40.7,00000
91.0,59.0,19.0,296,03,01,  Dakshin Bardesh,154,332,91,146,63,186,31.7,38.4,25.3,00000
91.0,59.0,19.0,569,01,01,  Purbagram,271,330,116,165,155,165,45.1,41.3,48.4,00000
91.0,59.0,19.0,569,02,01,  Majhergram,205,167,96,77,109,90,55.1,55.5,54.8,00000
91.0,59.0,19.0,569,03,01,  Paschimgram,175,221,89,102,86,119,44.2,46.6,42.0,00000
91.0,59.0,19.0,620,01,01,  Akuni,115,369,54,159,61,210,23.8,25.4,22.5,00000
91.0,59.0,19.0,620,02,01,  Golal Para,221,146,97,63,124,83,60.2,60.6,59.9,00000
91.0,59.0,19.0,620,03,01,  Gachhbari,222,473,98,229,124,244,31.9,30.0,33.7,00000
91.0,59.0,19.0,620,04,01,  Nayagram,745,803,357,388,388,415,48.1,47.9,48.3,00000
91.0,59.0,19.0,985,01,01,  Harampur,522,236,264,110,258,126,68.9,70.6,67.2,00000
91.0,59.0,19.0,985,02,01,  Panchaghari,293,248,153,129,140,119,54.2,54.3,54.1,00000
91.0,59.0,19.0,985,03,01,  Nayagaon,227,285,99,133,128,152,44.3,42.7,45.7,00000
91.0,59.0,38.0,254,01,01,  Merar Chati,191,286,82,140,109,146,40.0,36.9,42.7,00000
91.0,59.0,38.0,254,02,01,  Bakhairpar,156,531,75,238,81,293,22.7,24.0,21.7,00000
91.0,59.0,38.0,254,03,01,  Goailjur,411,826,196,372,215,454,33.2,34.5,32.1,00000
91.0,59.0,38.0,254,04,01,  Bhadra Chati,192,293,100,119,92,174,39.6,45.7,34.6,00000
91.0,59.0,38.0,254,05,01,  Fakra Chati,148,376,83,163,65,213,28.2,33.7,23.4,00000
91.0,59.0,38.0,254,06,01,  Khalagaon,159,665,80,301,79,364,19.3,21.0,17.8,00000
91.0,59.0,38.0,573,01,01,  Lama Jhingabari,652,432,322,175,330,257,60.1,64.8,56.2,00000
91.0,59.0,38.0,573,02,01,  Miahgul,258,438,105,209,153,229,37.1,33.4,40.1,00000
91.0,59.0,38.0,573,03,01,  Purbagram,323,163,170,59,153,104,66.5,74.2,59.5,00000
91.0,59.0,38.0,785,01,01,  Ganikandi,321,870,149,386,172,484,27.0,27.9,26.2,00000
91.0,59.0,38.0,785,02,01,  Ag Taluk,526,857,261,388,265,469,38.0,40.2,36.1,00000
91.0,59.0,38.0,785,03,01,  Majh Taluk,101,344,52,161,49,183,22.7,24.4,21.1,00000
91.0,59.0,38.0,785,04,01,  Yarkandi,22,47,10,23,12,24,31.9,30.3,33.3,00000
91.0,59.0,38.0,951,01,01,  Bhararimati,232,229,117,103,115,126,50.3,53.2,47.7,00000
91.0,59.0,38.0,951,02,01,  Darjimati,413,623,183,281,230,342,39.9,39.4,40.2,00000
91.0,59.0,38.0,951,03,01,  Nayagram,331,179,179,78,152,101,64.9,69.6,60.1,00000
91.0,59.0,38.0,951,04,01,  Tinchati Narayanpur,955,664,527,300,428,364,59.0,63.7,54.0,00000
91.0,59.0,66.0,692,01,01,  Eraligul,17,156,10,78,7,78,9.8,11.4,8.2,00000
91.0,59.0,66.0,692,02,01,  Assam Para,166,350,89,177,77,173,32.2,33.5,30.8,00000
91.0,59.0,66.0,692,03,01,  Nihalpur,77,483,41,238,36,245,13.8,14.7,12.8,00000
91.0,59.0,70.0,179,01,01,  Agdi,561,428,278,174,283,254,56.7,61.5,52.7,00000
91.0,59.0,70.0,179,02,01,  Majardi-1,47,89,21,43,26,46,34.6,32.8,36.1,00000
91.0,59.0,70.0,179,03,01,  Majardi,191,193,105,84,86,109,49.7,55.6,44.1,00000
91.0,59.0,70.0,179,04,01,  Kardi,243,249,138,136,105,113,49.4,50.4,48.2,00000
91.0,59.0,70.0,445,01,01,  Agar Chati,300,394,163,181,137,213,43.2,47.4,39.1,00000
91.0,59.0,70.0,445,02,01,  Majher Chati,362,300,182,131,180,169,54.7,58.1,51.6,00000
91.0,59.0,70.0,445,03,01,  Konagram,39,78,16,41,23,37,33.3,28.1,38.3,00000
91.0,59.0,70.0,445,04,01,  Nayamati (Part),155,245,83,127,72,118,38.8,39.5,37.9,00000
91.0,59.0,70.0,445,05,01,  Paschim Julai,140,408,69,180,71,228,25.5,27.7,23.7,00000
91.0,59.0,70.0,445,06,01,  Dakshin Julai,102,186,52,74,50,112,35.4,41.3,30.9,00000
91.0,59.0,76.0,798,01,01,  Zitpur,128,216,80,108,48,108,37.2,42.6,30.8,00000
91.0,59.0,76.0,798,02,01,  Nalupara,243,345,140,165,103,180,41.3,45.9,36.4,00000
91.0,59.0,76.0,798,03,01,  Ballagram,161,100,76,41,85,59,61.7,65.0,59.0,00000
91.0,59.0,76.0,798,04,01,  Noagram,123,315,58,170,65,145,28.1,25.4,31.0,00000
91.0,59.0,76.0,798,05,01,  Karchhati,287,344,138,175,149,169,45.5,44.1,46.9,00000
91.0,59.0,76.0,798,06,01,  Paschim Kunagram,224,396,133,193,91,203,36.1,40.8,31.0,00000
91.0,59.0,76.0,798,07,01,  Purba Kunagram,106,96,48,44,58,52,52.5,52.2,52.7,00000
91.0,59.0,85.0,334,01,01,  Bara Faljur,461,1202,226,614,235,588,27.7,26.9,28.6,00000
91.0,59.0,85.0,334,02,01,  Chhota Faljur,242,580,107,284,135,296,29.4,27.4,31.3,00000
91.0,59.0,85.0,342,01,01,  Dewan Chak,214,101,88,58,126,43,67.9,60.3,74.6,00000
91.0,59.0,85.0,342,02,01,  Lama Para,202,352,85,174,117,178,36.5,32.8,39.7,00000
91.0,59.0,85.0,342,03,01,  Lalar Chak,710,1133,338,526,372,607,38.5,39.1,38.0,00000
91.0,59.0,85.0,342,04,01,  Fatehganj,386,691,175,332,211,359,35.8,34.5,37.0,00000
91.0,59.0,85.0,644,01,01,  Chhota Mirzarghar,348,184,181,94,167,90,65.4,65.8,65.0,00000
91.0,59.0,85.0,644,02,01,  Khowazpur,139,255,60,104,79,151,35.3,36.6,34.3,00000
91.0,59.0,85.0,644,03,01,  Nij Mirzarghar,418,601,217,284,201,317,41.0,43.3,38.8,00000
91.0,59.0,85.0,747,01,01,  Ag Kufa,676,618,334,253,342,365,52.2,56.9,48.4,00000
91.0,59.0,85.0,747,02,01,  Majh Kufa,324,492,128,239,196,253,39.7,34.9,43.7,00000
91.0,59.0,85.0,747,03,01,  Ansarpur,127,289,58,129,69,160,30.5,31.0,30.1,00000
91.0,59.0,85.0,831,01,01,  Rajaganj,360,970,218,493,142,477,27.1,30.7,22.9,00000
91.0,59.0,85.0,831,02,01,  Mayna,697,820,338,396,359,424,45.9,46.0,45.8,00000
91.0,59.0,85.0,831,03,01,  Gazipur,329,532,176,234,153,298,38.2,42.9,33.9,00000
91.0,59.0,85.0,831,04,01,  Parkul,566,442,262,213,304,229,56.2,55.2,57.0,00000
91.0,59.0,85.0,939,01,01,  Nij Talbari,553,627,256,277,297,350,46.9,48.0,45.9,00000
91.0,59.0,85.0,939,02,01,  Dawadari,151,382,97,158,54,224,28.3,38.0,19.4,00000
91.0,59.0,85.0,939,03,01,  Dalai Chati,170,339,108,129,62,210,33.4,45.6,22.8,00000
91.0,59.0,85.0,939,04,01,  Hamidpur,53,278,21,138,32,140,16.0,13.2,18.6,00000
91.0,59.0,85.0,939,05,01,  Lakshmipur,98,360,43,176,55,184,21.4,19.6,23.0,00000
91.0,62.0,32.0,118,01,01,  Bara Kapan,367,982,167,485,200,497,27.2,25.6,28.7,00000
91.0,62.0,32.0,118,02,01,  Dhokrey,70,879,30,417,40,462,7.4,6.7,8.0,00000
91.0,62.0,32.0,292,01,01,  Fakirergaon,723,688,356,335,367,353,51.2,51.5,51.0,00000
91.0,62.0,32.0,292,02,01,  Paikraj,296,574,142,288,154,286,34.0,33.0,35.0,00000
91.0,62.0,32.0,292,03,01,  Jangail,615,306,302,147,313,159,66.8,67.3,66.3,00000
91.0,62.0,32.0,633,01,01,  Meghergaon,125,465,66,228,59,237,21.2,22.4,19.9,00000
91.0,62.0,32.0,633,02,01,  Kalengirpar,155,74,80,32,75,42,67.7,71.4,64.1,00000
91.0,62.0,32.0,633,03,01,  Bara Faud,475,509,261,245,214,264,48.3,51.6,44.8,00000
91.0,62.0,32.0,762,01,01,  Pagail,643,981,316,491,327,490,39.6,39.2,40.0,00000
91.0,62.0,32.0,762,02,01,  Noapara,50,230,27,115,23,115,17.9,19.0,16.7,00000
91.0,62.0,32.0,762,03,01,  Baburagaon,338,409,182,202,156,207,45.2,47.4,43.0,00000
91.0,62.0,32.0,762,04,01,  Majh Para Paschim,220,507,102,254,118,253,30.3,28.7,31.8,00000
91.0,62.0,32.0,762,05,01,  Dighirpar,355,306,193,123,162,183,53.7,61.1,47.0,00000
91.0,62.0,32.0,851,01,01,  Satra,1604,1118,844,530,760,588,58.9,61.4,56.4,00000
91.0,62.0,32.0,851,02,01,  Hatkhola,1196,1644,622,796,574,848,42.1,43.9,40.4,00000
91.0,62.0,32.0,883,01,01,  Noagaon,365,480,174,214,191,266,43.2,44.8,41.8,00000
91.0,62.0,32.0,883,02,01,  Nandirgaon,234,862,105,423,129,439,21.4,19.9,22.7,00000
91.0,62.0,32.0,994,01,01,  Umairgaon (Paschimpara),354,851,161,414,193,437,29.4,28.0,30.6,00000
91.0,62.0,32.0,994,02,01,  Jangali Faud,649,433,332,203,317,230,60.0,62.1,58.0,00000
91.0,62.0,32.0,994,03,01,  Majh Para,235,304,119,142,116,162,43.6,45.6,41.7,00000
91.0,62.0,34.0,435,01,01,  Paschim Kalaruka,752,884,363,416,389,468,46.0,46.6,45.4,00000
91.0,62.0,34.0,435,02,01,  Purba Kalaruka,685,728,353,345,332,383,48.5,50.6,46.4,00000
91.0,62.0,34.0,435,03,01,  Noagaon,330,637,161,295,169,342,34.1,35.3,33.1,00000
91.0,62.0,34.0,435,04,01,  Kurirgaon,146,136,73,65,73,71,51.8,52.9,50.7,00000
91.0,62.0,34.0,435,05,01,  Khasergaon,68,179,26,88,42,91,27.5,22.8,31.6,00000
91.0,62.0,34.0,690,01,01,  Alinagar,400,792,174,384,226,408,33.6,31.2,35.6,00000
91.0,62.0,34.0,690,02,01,  Dakshin Alinagar,90,318,48,153,42,165,22.1,23.9,20.3,00000
91.0,62.0,34.0,690,03,01,  Henglakandi,155,129,81,62,74,67,54.6,56.6,52.5,00000
91.0,62.0,34.0,690,04,01,  Palpur,89,325,53,155,36,170,21.5,25.5,17.5,00000
91.0,62.0,34.0,690,05,01,  Noagaon,36,139,24,73,12,66,20.6,24.7,15.4,00000
91.0,62.0,34.0,915,01,01,  Badairpar,318,507,149,254,169,253,38.5,37.0,40.0,00000
91.0,62.0,34.0,915,02,01,  Daradakandi,38,458,27,240,11,218,7.7,10.1,4.8,00000
91.0,62.0,34.0,915,03,01,  Sardargaon,80,124,43,68,37,56,39.2,38.7,39.8,00000
91.0,62.0,34.0,915,04,01,  Royergaon,482,838,235,409,247,429,36.5,36.5,36.5,00000
91.0,62.0,38.0,039,01,01,  Dhanpur,196,252,101,115,95,137,43.8,46.8,40.9,00000
91.0,62.0,38.0,039,02,01,  Gobindapur,305,544,159,265,146,279,35.9,37.5,34.4,00000
91.0,62.0,38.0,039,03,01,  Mirpur,574,900,281,440,293,460,38.9,39.0,38.9,00000
91.0,62.0,38.0,049,01,01,  Bade Ali,384,188,197,86,187,102,67.1,69.6,64.7,00000
91.0,62.0,38.0,049,02,01,  Basiakhai,293,120,158,50,135,70,70.9,76.0,65.9,00000
91.0,62.0,38.0,049,03,01,  Anantapur,409,198,202,99,207,99,67.4,67.1,67.6,00000
91.0,62.0,38.0,049,04,01,  Paikargaon,184,174,97,95,87,79,51.4,50.5,52.4,00000
91.0,62.0,38.0,222,01,01,  Lamargaon,605,774,312,405,293,369,43.9,43.5,44.3,00000
91.0,62.0,38.0,222,02,01,  Sonatala,984,1075,512,525,472,550,47.8,49.4,46.2,00000
91.0,62.0,38.0,222,03,01,  Chamaurakandi,411,674,215,342,196,332,37.9,38.6,37.1,00000
91.0,62.0,38.0,222,04,01,  Jhainkarkandi,81,385,36,196,45,189,17.4,15.5,19.2,00000
91.0,62.0,38.0,222,05,01,  Lilgaon (Noagoan),194,316,100,157,94,159,38.0,38.9,37.2,00000
91.0,62.0,38.0,222,06,01,  Noirput,138,358,66,232,72,126,27.8,22.1,36.4,00000
91.0,62.0,38.0,222,07,01,  Nalkot,230,845,124,430,106,415,21.4,22.4,20.3,00000
91.0,62.0,38.0,252,01,01,  Purba Darsa,454,466,230,247,224,219,49.3,48.2,50.6,00000
91.0,62.0,38.0,252,02,01,  Paschim Darsa,1224,793,582,369,642,424,60.7,61.2,60.2,00000
91.0,62.0,38.0,277,01,01,  Mollargaon,494,503,248,237,246,266,49.5,51.1,48.0,00000
91.0,62.0,38.0,277,02,01,  Lakshmipur,195,223,95,105,100,118,46.7,47.5,45.9,00000
91.0,62.0,38.0,277,03,01,  Tilakpur,182,281,98,130,84,151,39.3,43.0,35.7,00000
91.0,62.0,38.0,277,04,01,  Fulkuchi,119,274,61,133,58,141,30.3,31.4,29.1,00000
91.0,62.0,38.0,316,01,01,  Bagarpar,160,429,78,209,82,220,27.2,27.2,27.2,00000
91.0,62.0,38.0,316,02,01,  Kandigaon,501,704,250,361,251,343,41.6,40.9,42.3,00000
91.0,62.0,38.0,465,01,01,  Kaskalika,785,879,397,402,388,477,47.2,49.7,44.9,00000
91.0,62.0,38.0,465,02,01,  Purba Jangail,456,594,245,284,211,310,43.4,46.3,40.5,00000
91.0,62.0,38.0,465,03,01,  Paschim Jangail,623,423,328,193,295,230,59.6,63.0,56.2,00000
91.0,62.0,38.0,514,01,01,  Sreepur,215,301,106,147,109,154,41.7,41.9,41.4,00000
91.0,62.0,38.0,514,02,01,  Inatyabad,451,733,225,382,226,351,38.1,37.1,39.2,00000
91.0,62.0,38.0,628,01,01,  Basantagaon,257,345,127,178,130,167,42.7,41.6,43.8,00000
91.0,62.0,38.0,628,02,01,  Dighirpar,302,215,128,111,174,104,58.4,53.6,62.6,00000
91.0,62.0,38.0,628,03,01,  Medini Mahal,495,172,253,82,242,90,74.2,75.5,72.9,00000
91.0,62.0,38.0,628,04,01,  Kanaiada,20,37,8,21,12,16,35.1,27.6,42.9,00000
91.0,62.0,38.0,946,01,01,  Gopal,573,599,286,298,287,301,48.9,49.0,48.8,00000
91.0,62.0,38.0,946,02,01,  Herakhala,150,219,84,105,66,114,40.7,44.4,36.7,00000
91.0,62.0,38.0,946,03,01,  Manoharpur,395,232,199,112,196,120,63.0,64.0,62.0,00000
91.0,62.0,38.0,946,04,01,  Mirergaon,570,1179,299,600,271,579,32.6,33.3,31.9,00000
91.0,62.0,38.0,946,05,01,  Basirpur,292,376,147,191,145,185,43.7,43.5,43.9,00000
91.0,62.0,38.0,946,06,01,  Sujatpur,298,228,158,102,140,126,56.7,60.8,52.6,00000
91.0,62.0,40.0,024,01,01,  Khagria,311,265,177,134,134,131,54.0,56.9,50.6,00000
91.0,62.0,40.0,024,02,01,  Tintila,115,99,61,53,54,46,53.7,53.5,54.0,00000
91.0,62.0,40.0,024,03,01,  Nalia,138,169,78,74,60,95,45.0,51.3,38.7,00000
91.0,62.0,40.0,024,04,01,  Baghmara,60,77,42,37,18,40,43.8,53.2,31.0,00000
91.0,62.0,40.0,024,05,01,  Bhata,197,268,91,145,106,123,42.4,38.6,46.3,00000
91.0,62.0,40.0,024,06,01,  Purabari,384,364,207,176,177,188,51.3,54.0,48.5,00000
91.0,62.0,40.0,024,07,01,  Pitakara,191,217,111,97,80,120,46.8,53.4,40.0,00000
91.0,62.0,40.0,024,08,01,  Lakhaura,373,319,206,156,167,163,53.9,56.9,50.6,00000
91.0,62.0,40.0,024,09,01,  Pirergaon,259,486,150,241,109,245,34.8,38.4,30.8,00000
91.0,62.0,40.0,024,10,01,  Garauti,56,150,31,74,25,76,27.2,29.5,24.8,00000
91.0,62.0,40.0,024,11,01,  Baraikandi,26,250,12,123,14,127,9.4,8.9,9.9,00000
91.0,62.0,40.0,024,12,01,  Shimulkandi,105,178,53,73,52,105,37.1,42.1,33.1,00000
91.0,62.0,40.0,024,13,01,  Pukuriarkandi,33,41,17,19,16,22,44.6,47.2,42.1,00000
91.0,62.0,40.0,024,14,01,  Baliakandi,88,196,48,101,40,95,31.0,32.2,29.6,00000
91.0,62.0,40.0,024,15,01,  Modhu Tila,110,428,63,208,47,220,20.4,23.2,17.6,00000
91.0,62.0,40.0,128,01,01,  Salehpur,243,350,131,181,112,169,41.0,42.0,39.9,00000
91.0,62.0,40.0,128,02,01,  Purba Baish Tila,141,158,77,76,64,82,47.2,50.3,43.8,00000
91.0,62.0,40.0,128,03,01,  Char Charikandi,57,126,28,72,29,54,31.1,28.0,34.9,00000
91.0,62.0,40.0,128,04,01,  Paschim Baish Tila,290,368,170,175,120,193,44.1,49.3,38.3,00000
91.0,62.0,40.0,128,05,01,  Bacha Tila,105,64,49,29,56,35,62.1,62.8,61.5,00000
91.0,62.0,40.0,128,06,01,  Lalbagh,171,297,88,155,83,142,36.5,36.2,36.9,00000
91.0,62.0,40.0,128,07,01,  Borshola,1547,1276,914,607,633,669,54.8,60.1,48.6,00000
91.0,62.0,40.0,128,08,01,  Manglirpar,767,610,402,277,365,333,55.7,59.2,52.3,00000
91.0,62.0,40.0,128,09,01,  Bagaiura,171,108,96,52,75,56,61.3,64.9,57.3,00000
91.0,62.0,40.0,128,10,01,  Kalaiura,164,105,84,53,80,52,61.0,61.3,60.6,00000
91.0,62.0,40.0,128,11,01,  Atkeary,88,156,35,85,53,71,36.1,29.2,42.7,00000
91.0,62.0,40.0,128,12,01,  Pukoria Par,474,165,256,70,218,95,74.2,78.5,69.6,00000
91.0,62.0,40.0,128,13,01,  Biman Bandar,552,53,359,23,193,30,91.2,94.0,86.5,00000
91.0,62.0,40.0,128,14,01,  Cadet College,597,15,441,5,156,10,97.5,98.9,94.0,00000
91.0,62.0,40.0,128,15,01,  Ban Bidyalay,187,30,117,10,70,20,86.2,92.1,77.8,00000
91.0,62.0,40.0,222,01,01,  Chatliban,507,632,265,309,242,323,44.5,46.2,42.8,00000
91.0,62.0,40.0,222,02,01,  Moulatikor,275,266,123,127,152,139,50.8,49.2,52.2,00000
91.0,62.0,40.0,222,03,01,  Chatul,1091,942,567,465,524,477,53.7,54.9,52.3,00000
91.0,62.0,40.0,222,04,01,  Bauarkandi,84,376,58,193,26,183,18.3,23.1,12.4,00000
91.0,62.0,40.0,222,05,01,  Sarisharkandi,6,109,3,57,3,52,5.2,5.0,5.5,00000
91.0,62.0,40.0,222,06,01,  Kama Tila,214,189,114,93,100,96,53.1,55.1,51.0,00000
91.0,62.0,40.0,227,01,01,  Chhalia,905,1118,556,653,349,465,44.7,46.0,42.9,00000
91.0,62.0,40.0,227,02,01,  Naya Tila,110,138,64,72,46,66,44.4,47.1,41.1,00000
91.0,62.0,40.0,227,03,01,  Rangi Tila,546,479,296,218,250,261,53.3,57.6,48.9,00000
91.0,62.0,40.0,227,04,01,  Nakchhapra,207,150,111,73,96,77,58.0,60.3,55.5,00000
91.0,62.0,40.0,227,05,01,  Dhapna Tila,164,115,94,53,70,62,58.8,63.9,53.0,00000
91.0,62.0,40.0,227,06,01,  Dhupagul,744,317,459,150,285,167,70.1,75.4,63.1,00000
91.0,62.0,40.0,227,07,01,  Vmdar Para,492,204,273,86,219,118,70.7,76.0,65.0,00000
91.0,62.0,40.0,227,08,01,  Babhairbari,84,51,51,24,33,27,62.2,68.0,55.0,00000
91.0,62.0,40.0,227,09,01,  Babhairgul,81,16,69,5,12,11,83.5,93.2,52.2,00000
91.0,62.0,40.0,306,01,01,  Faringura,366,397,186,181,180,216,48.0,50.7,45.5,00000
91.0,62.0,40.0,306,02,01,  Aolartuk,191,451,98,226,93,225,29.8,30.2,29.2,00000
91.0,62.0,40.0,306,03,01,  Puainkata,104,76,55,35,49,41,57.8,61.1,54.4,00000
91.0,62.0,40.0,306,04,01,  Kandirpath,228,192,109,95,119,97,54.3,53.4,55.1,00000
91.0,62.0,40.0,306,05,01,  Chandai,151,204,73,95,78,109,42.5,43.5,41.7,00000
91.0,62.0,40.0,306,06,01,  Ghoramara,306,413,171,199,135,214,42.6,46.2,38.7,00000
91.0,62.0,40.0,306,07,01,  Rampur,143,267,74,126,69,141,34.9,37.0,32.9,00000
91.0,62.0,40.0,306,08,01,  Fatehghar,182,136,92,62,90,74,57.2,59.7,54.9,00000
91.0,62.0,40.0,306,09,01,  Bazartal,128,301,66,145,62,156,29.8,31.3,28.4,00000
91.0,62.0,40.0,306,10,01,  Rakhalgul,32,240,18,133,14,107,11.8,11.9,11.6,00000
91.0,62.0,40.0,306,11,01,  Debair Bahar,61,272,33,135,28,137,18.3,19.6,17.0,00000
91.0,62.0,40.0,306,12,01,  Kunatila,89,155,43,71,46,84,36.5,37.7,35.4,00000
91.0,62.0,40.0,420,01,01,  Hana Para,73,102,32,57,41,45,41.7,36.0,47.7,00000
91.0,62.0,40.0,420,02,01,  Lila Para,151,178,71,76,80,102,45.9,48.3,44.0,00000
91.0,62.0,40.0,420,03,01,  Batrikona,48,50,28,19,20,31,49.0,59.6,39.2,00000
91.0,62.0,40.0,420,04,01,  Kalagol,138,600,74,301,64,299,18.7,19.7,17.6,00000
91.0,62.0,40.0,420,05,01,  Sidairgol,131,120,79,53,52,67,52.2,59.8,43.7,00000
91.0,62.0,40.0,420,06,01,  Bhararhat,56,60,33,26,23,34,48.3,55.9,40.4,00000
91.0,62.0,40.0,420,07,01,  Kushal,60,91,37,34,23,57,39.7,52.1,28.8,00000
91.0,62.0,40.0,420,08,01,  Pathan Tila,57,89,32,33,25,56,39.0,49.2,30.9,00000
91.0,62.0,40.0,420,09,01,  Dhadarani,6,28,3,13,3,15,17.6,18.8,16.7,00000
91.0,62.0,40.0,420,10,01,  Makharkhala,45,276,25,140,20,136,14.0,15.2,12.8,00000
91.0,62.0,40.0,420,11,01,  Tila Para,211,656,111,328,100,328,24.3,25.3,23.4,00000
91.0,62.0,40.0,420,12,01,  Lusain,215,151,107,69,108,82,58.7,60.8,56.8,00000
91.0,62.0,40.0,420,13,01,  Kandi Para,216,284,93,140,123,144,43.2,39.9,46.1,00000
91.0,62.0,40.0,420,14,01,  Pathangaon,129,308,70,147,59,161,29.5,32.3,26.8,00000
91.0,62.0,40.0,420,15,01,  Satgachhi,45,151,24,74,21,77,23.0,24.5,21.4,00000
91.0,62.0,40.0,420,16,01,  Tukergaon,3,92,2,41,1,51,3.2,4.7,1.9,00000
91.0,62.0,40.0,420,17,01,  Gankirtuk,24,44,8,27,16,17,35.3,22.9,48.5,00000
91.0,62.0,40.0,420,18,01,  Baraban,150,134,71,60,79,74,52.8,54.2,51.6,00000
91.0,62.0,40.0,420,19,01,  Chhalir Mahal,61,88,37,41,24,47,40.9,47.4,33.8,00000
91.0,62.0,40.0,485,01,01,  Mahaldik,350,384,199,194,151,190,47.7,50.6,44.3,00000
91.0,62.0,40.0,485,02,01,  Murargaon,172,193,90,86,82,107,47.1,51.1,43.4,00000
91.0,62.0,40.0,485,03,01,  Kata Digha,17,73,8,37,9,36,18.9,17.8,20.0,00000
91.0,62.0,40.0,485,04,01,  Alai Bohor,69,211,39,115,30,96,24.6,25.3,23.8,00000
91.0,62.0,40.0,499,01,01,  Khadimnagar T.G.,945,1200,580,528,365,672,44.1,52.3,35.2,00000
91.0,62.0,40.0,499,02,01,  Bit Office,5,0,5,0,0,0,100.0,100.0,0.0,00000
91.0,62.0,40.0,554,01,01,  Tiorbari,109,74,59,31,50,43,59.6,65.6,53.8,00000
91.0,62.0,40.0,554,02,01,  Tilargaon,552,431,371,221,181,210,56.2,62.7,46.3,00000
91.0,62.0,40.0,554,03,01,  Dalia,628,210,308,88,320,122,74.9,77.8,72.4,00000
91.0,62.0,40.0,598,01,01,  Kurbain Tila,83,145,48,77,35,68,36.4,38.4,34.0,00000
91.0,62.0,40.0,598,02,01,  Dalia T.G.,0,5,0,3,0,2,0.0,0.0,0.0,00000
91.0,62.0,40.0,727,01,01,  Pirergaon,116,264,56,132,60,132,30.5,29.8,31.3,00000
91.0,62.0,40.0,727,02,01,  Kuni Para,76,189,33,92,43,97,28.7,26.4,30.7,00000
91.0,62.0,40.0,727,03,01,  Chanpur,57,159,32,87,25,72,26.4,26.9,25.8,00000
91.0,62.0,40.0,727,04,01,  Laugul,291,320,162,150,129,170,47.6,51.9,43.1,00000
91.0,62.0,42.0,034,01,01,  Daspara,1159,456,611,215,548,241,71.8,74.0,69.5,00000
91.0,62.0,42.0,034,02,01,  Harpara,183,56,94,21,89,35,76.6,81.7,71.8,00000
91.0,62.0,42.0,034,03,01,  Dhalaipara,1129,937,619,438,510,499,54.6,58.6,50.5,00000
91.0,62.0,42.0,034,04,01,  Noaga,800,442,407,198,393,244,64.4,67.3,61.7,00000
91.0,62.0,42.0,034,05,01,  Dewaner Chak,579,393,305,197,274,196,59.6,60.8,58.3,00000
91.0,62.0,42.0,034,06,01,  Keoa,226,210,115,105,111,105,51.8,52.3,51.4,00000
91.0,62.0,42.0,034,07,01,  Teli Para,54,66,28,34,26,32,45.0,45.2,44.8,00000
91.0,62.0,42.0,034,08,01,  Kunir Chak,268,261,146,115,122,146,50.7,55.9,45.5,00000
91.0,62.0,42.0,034,09,01,  Mukamergul,373,752,218,361,155,391,33.2,37.7,28.4,00000
91.0,62.0,42.0,034,10,01,  Kulautti,62,76,38,29,24,47,44.9,56.7,33.8,00000
91.0,62.0,42.0,034,11,01,  Kusirgul,274,224,149,101,125,123,55.0,59.6,50.4,00000
91.0,62.0,42.0,034,12,01,  Hatura,617,818,304,402,313,416,43.0,43.1,42.9,00000
91.0,62.0,42.0,034,13,01,  Gaila Para,278,138,145,70,133,68,66.8,67.4,66.2,00000
91.0,62.0,42.0,034,14,01,  Shyampur,124,184,67,81,57,103,40.3,45.3,35.6,00000
91.0,62.0,42.0,034,15,01,  Pirer Chak,1329,811,707,367,622,444,62.1,65.8,58.3,00000
91.0,62.0,42.0,034,16,01,  Malai Tila,617,246,338,110,279,136,71.5,75.4,67.2,00000
91.0,62.0,42.0,034,17,01,  Chowdhury Para,335,162,174,69,161,93,67.4,71.6,63.4,00000
91.0,62.0,42.0,034,18,01,  Tikir Patti,521,913,278,456,243,457,36.3,37.9,34.7,00000
91.0,62.0,42.0,034,19,01,  Sukurartuk,210,308,115,144,95,164,40.5,44.4,36.7,00000
91.0,62.0,42.0,034,20,01,  Talopara,378,390,187,188,191,202,49.2,49.9,48.6,00000
91.0,62.0,42.0,034,21,01,  Mubarakpur,322,345,166,162,156,183,48.3,50.6,46.0,00000
91.0,62.0,42.0,034,22,01,  Maligaon,78,67,46,32,32,35,53.8,59.0,47.8,00000
91.0,62.0,42.0,034,23,01,  Mollar Char,150,54,77,18,73,36,73.5,81.1,67.0,00000
91.0,62.0,42.0,034,24,01,  Malipara,43,61,27,29,16,32,41.3,48.2,33.3,00000
91.0,62.0,42.0,034,25,01,  Totarami Char,255,210,127,98,128,112,54.8,56.4,53.3,00000
91.0,62.0,42.0,034,26,01,  Chak Daspara,561,316,354,136,207,180,64.0,72.2,53.5,00000
91.0,62.0,42.0,034,27,01,  Chak Gram Atgaon,582,487,296,252,286,235,54.4,54.0,54.9,00000
91.0,62.0,42.0,079,01,03,  Khadim Para,1616,931,845,412,771,519,63.4,67.2,59.8,00000
91.0,62.0,42.0,079,02,03,  Mir Mahallah,303,301,182,122,121,179,50.2,59.9,40.3,00000
91.0,62.0,42.0,079,03,03,  Kalatikar,853,281,444,105,409,176,75.2,80.9,69.9,00000
91.0,62.0,42.0,079,04,03,  Manipuri Para Basti,352,129,192,53,160,76,73.2,78.4,67.8,00000
91.0,62.0,42.0,079,05,03,  Daspara Bhaur,300,83,156,33,144,50,78.3,82.5,74.2,00000
91.0,62.0,42.0,079,06,03,  B.I.D.C.,205,82,121,35,84,47,71.4,77.6,64.1,00000
91.0,62.0,42.0,079,07,03,  Bahar Colony,1448,965,738,453,710,512,60.0,62.0,58.1,00000
91.0,62.0,42.0,079,08,03,  Bahubal,1290,334,654,150,636,184,79.4,81.3,77.6,00000
91.0,62.0,42.0,079,09,03,  T.T.D.C.,51,4,27,3,24,1,92.7,90.0,96.0,00000
91.0,62.0,42.0,079,10,03,  Bahubal Colony,298,221,161,105,137,116,57.4,60.5,54.2,00000
91.0,62.0,42.0,079,11,03,  Uddinar Tila,400,113,205,54,195,59,78.0,79.2,76.8,00000
91.0,62.0,42.0,079,12,03,  R.D.T.I.,56,13,34,8,22,5,81.2,81.0,81.5,00000
91.0,62.0,42.0,079,13,03,  Shah Paran,376,572,218,282,158,290,39.7,43.6,35.3,00000
91.0,62.0,42.0,079,14,03,  Islamabad,515,301,274,141,241,160,63.1,66.0,60.1,00000
91.0,62.0,42.0,079,15,03,  Dhanakandi,403,303,198,148,205,155,57.1,57.2,56.9,00000
91.0,62.0,42.0,079,16,03,  Panchghari,110,322,51,171,59,151,25.5,23.0,28.1,00000
91.0,62.0,42.0,079,17,03,  Bhawal Tila,333,279,173,138,160,141,54.4,55.6,53.2,00000
91.0,62.0,42.0,079,18,03,  Bahar Noagaon,358,213,187,96,171,117,62.7,66.1,59.4,00000
91.0,62.0,42.0,079,19,03,  Lalkha Tongi,502,429,270,213,232,216,53.9,55.9,51.8,00000
91.0,62.0,42.0,079,21,03,  A.T.I.,51,5,28,0,23,5,91.1,100.0,82.1,00000
91.0,62.0,42.0,133,01,01,  Bateshwar Jalalnagar,821,338,431,150,390,188,70.8,74.2,67.5,00000
91.0,62.0,42.0,133,02,01,  Nairgol Contonment Area,190,30,98,16,92,14,86.4,86.0,86.8,00000
91.0,62.0,42.0,133,03,01,  Hairohora,110,41,60,14,50,27,72.8,81.1,64.9,00000
91.0,62.0,42.0,133,04,01,  Kanugul,287,246,134,107,153,139,53.8,55.6,52.4,00000
91.0,62.0,42.0,138,01,01,  Bateshwar Chuabahar,1110,190,567,82,543,108,85.4,87.4,83.4,00000
91.0,62.0,42.0,138,02,01,  Poranbari Bateswar,111,134,59,66,52,68,45.3,47.2,43.3,00000
91.0,62.0,42.0,138,03,01,  Bowerper Bateswar,417,25,219,13,198,12,94.3,94.4,94.3,00000
91.0,62.0,42.0,356,01,01,  Pirer Chak,420,235,218,110,202,125,64.1,66.5,61.8,00000
91.0,62.0,42.0,356,02,01,  Muradpur,508,900,242,529,266,371,36.1,31.4,41.8,00000
91.0,62.0,42.0,358,01,03,  Islampur-1,741,419,406,195,335,224,63.9,67.6,59.9,00000
91.0,62.0,42.0,358,02,03,  Islampur-2,422,117,235,42,187,75,78.3,84.8,71.4,00000
91.0,62.0,42.0,358,03,03,  Muslimnagar,107,63,53,19,54,44,62.9,73.6,55.1,00000
91.0,62.0,42.0,358,04,03,  Islampur Colony,538,826,258,391,280,435,39.4,39.8,39.2,00000
91.0,62.0,42.0,358,05,03,  Sayedpur,1291,412,647,189,644,223,75.8,77.4,74.3,00000
91.0,62.0,42.0,358,06,03,  Alutal,418,474,233,229,185,245,46.9,50.4,43.0,00000
91.0,62.0,42.0,358,07,03,  Buri Basti,374,181,199,75,175,106,67.4,72.6,62.3,00000
91.0,62.0,42.0,358,08,03,  Jahanpur,560,243,289,120,271,123,69.7,70.7,68.8,00000
91.0,62.0,42.0,358,09,03,  Goalgaon,452,188,258,75,194,113,70.6,77.5,63.2,00000
91.0,62.0,42.0,358,10,03,  Purba Islampur,1324,388,691,160,633,228,77.3,81.2,73.5,00000
91.0,62.0,42.0,358,11,03,  Mohammadpur,1192,381,598,162,594,219,75.8,78.7,73.1,00000
91.0,62.0,42.0,358,12,03,  Mugir Para,307,153,164,69,143,84,66.7,70.4,63.0,00000
91.0,62.0,42.0,358,13,03,  Kandihota,3,18,2,11,1,7,14.3,15.4,12.5,00000
91.0,62.0,42.0,358,14,03,  Sonapur,241,282,117,150,124,132,46.1,43.8,48.4,00000
91.0,62.0,42.0,358,15,03,  Purba Bhat Para,250,269,153,128,97,141,48.2,54.4,40.8,00000
91.0,62.0,42.0,358,16,03,  Krishi Khamar,23,21,14,10,9,11,52.3,58.3,45.0,00000
91.0,62.0,42.0,358,17,03,  Nath Para,1068,220,534,104,534,116,82.9,83.7,82.2,00000
91.0,62.0,42.0,358,18,03,  Paschim Bhat Para,663,460,351,201,312,259,59.0,63.6,54.6,00000
91.0,62.0,42.0,358,19,03,  Nurpur,678,317,343,156,335,161,68.1,68.7,67.5,00000
91.0,62.0,42.0,358,20,03,  Murila,241,65,138,23,103,42,78.8,85.7,71.0,00000
91.0,62.0,42.0,358,21,03,  Detarkendro Debpur,28,8,13,3,15,5,77.8,81.3,75.0,00000
91.0,62.0,42.0,358,22,03,  Chamelibagh Debpur,682,162,347,66,335,96,80.8,84.0,77.7,00000
91.0,62.0,42.0,358,23,03,  Shamoli Debpur,944,302,503,146,441,156,75.8,77.5,73.9,00000
91.0,62.0,42.0,358,24,03,  Sylhet Textile Debpur,308,21,288,8,20,13,93.6,97.3,60.6,00000
91.0,62.0,42.0,529,01,01,  Dattagram Khidirpur,1463,858,819,375,644,483,63.0,68.6,57.1,00000
91.0,62.0,42.0,529,02,01,  Rustampur,1127,664,751,432,376,232,62.9,63.5,61.8,00000
91.0,62.0,42.0,529,03,01,  Kallogram,1645,1137,889,532,756,605,59.1,62.6,55.5,00000
91.0,62.0,42.0,529,04,01,  Chak Daspara,126,13,65,5,61,8,90.6,92.9,88.4,00000
91.0,62.0,42.0,841,01,01,  Balutikar,550,449,278,215,272,234,55.1,56.4,53.8,00000
91.0,62.0,42.0,841,03,01,  Palia (Chandpur),306,500,147,245,159,255,38.0,37.5,38.4,00000
91.0,62.0,42.0,841,04,01,  Bangshidhar,536,466,285,223,251,243,53.5,56.1,50.8,00000
91.0,62.0,42.0,891,01,01,  Mirer Chak,521,555,268,318,253,237,48.4,45.7,51.6,00000
91.0,62.0,42.0,891,02,01,  Naya Basti,375,273,194,122,181,151,57.9,61.4,54.5,00000
91.0,62.0,55.0,039,01,01,  Ausa,656,754,310,346,346,408,46.5,47.3,45.9,00000
91.0,62.0,55.0,039,02,01,  Sekhergaon,256,208,131,98,125,110,55.2,57.2,53.2,00000
91.0,62.0,55.0,039,03,01,  Bakhlia,223,158,117,69,106,89,58.5,62.9,54.4,00000
91.0,62.0,55.0,039,04,01,  Chandpur,406,439,200,205,206,234,48.0,49.4,46.8,00000
91.0,62.0,55.0,094,01,01,  Banagaon,286,444,134,234,152,210,39.2,36.4,42.0,00000
91.0,62.0,55.0,094,02,01,  Bhagatipur,312,189,167,92,145,97,62.3,64.5,59.9,00000
91.0,62.0,55.0,094,03,01,  Galamsar,379,321,188,162,191,159,54.1,53.7,54.6,00000
91.0,62.0,55.0,094,04,01,  Khasergaon,173,253,79,126,94,127,40.6,38.5,42.5,00000
91.0,62.0,55.0,094,05,01,  Khosharpur,162,324,84,163,78,161,33.3,34.0,32.6,00000
91.0,62.0,55.0,094,06,01,  Dakshin Moglargaon,632,762,337,343,295,419,45.3,49.6,41.3,00000
91.0,62.0,55.0,094,07,01,  Paschim Moglargaon,290,459,129,209,161,250,38.7,38.2,39.2,00000
91.0,62.0,55.0,094,08,01,  Purba Moglargaon,306,106,163,37,143,69,74.3,81.5,67.5,00000
91.0,62.0,55.0,102,01,01,  Lamagaon,379,172,208,77,171,95,68.8,73.0,64.3,00000
91.0,62.0,55.0,102,02,01,  Dhumkhal,71,44,37,18,34,26,61.7,67.3,56.7,00000
91.0,62.0,55.0,277,01,01,  Kazirgaon,309,642,160,307,149,335,32.5,34.3,30.8,00000
91.0,62.0,55.0,277,02,01,  Sataro,231,496,96,242,135,254,31.8,28.4,34.7,00000
91.0,62.0,55.0,311,01,01,  Fatehpur,323,590,182,301,141,289,35.4,37.7,32.8,00000
91.0,62.0,55.0,311,02,01,  Phulkuchi,207,384,105,193,102,191,35.0,35.2,34.8,00000
91.0,62.0,55.0,400,01,01,  Mirgaon,349,625,189,321,160,304,35.8,37.1,34.5,00000
91.0,62.0,55.0,400,02,01,  Khalpar,680,897,359,412,321,485,43.1,46.6,39.8,00000
91.0,62.0,55.0,400,03,01,  Taluk Para,231,158,117,82,114,76,59.4,58.8,60.0,00000
91.0,62.0,55.0,480,01,01,  Kemidpur,507,461,241,217,266,244,52.4,52.6,52.2,00000
91.0,62.0,55.0,480,02,01,  Pirgaon,205,311,93,158,112,153,39.7,37.1,42.3,00000
91.0,62.0,55.0,490,01,01,  Lalkha,117,216,52,110,65,106,35.1,32.1,38.0,00000
91.0,62.0,55.0,490,02,01,  Nowagaon,132,266,62,123,70,143,33.2,33.5,32.9,00000
91.0,62.0,55.0,490,03,01,  Amanatpur,136,420,80,204,56,216,24.5,28.2,20.6,00000
91.0,62.0,55.0,678,01,01,  Madhya Noagaon,206,331,113,172,93,159,38.4,39.6,36.9,00000
91.0,62.0,55.0,678,02,01,  Lama Para,94,219,52,107,42,112,30.0,32.7,27.3,00000
91.0,62.0,55.0,836,01,01,  Saidpur,171,287,93,131,78,156,37.3,41.5,33.3,00000
91.0,62.0,55.0,836,02,01,  Mobarakpur,102,446,55,208,47,238,18.6,20.9,16.5,00000
91.0,62.0,55.0,836,03,01,  Maulvirgaon,177,352,93,158,84,194,33.5,37.1,30.2,00000
91.0,62.0,55.0,861,01,01,  Lalargaon,487,421,237,204,250,217,53.6,53.7,53.5,00000
91.0,62.0,55.0,861,02,01,  Chowdhurygaon,228,305,113,145,115,160,42.8,43.8,41.8,00000
91.0,62.0,55.0,861,03,01,  Khittargaon,293,186,143,87,150,99,61.2,62.2,60.2,00000
91.0,62.0,90.0,445,01,01,  Kashbaakhalia University Area,1739,126,1261,84,478,42,93.2,93.8,91.9,00000
91.0,62.0,90.0,445,02,01,  Akhaliaghat,1216,321,661,153,555,168,79.1,81.2,76.8,00000
91.0,62.0,90.0,445,03,01,  Khala Para,410,144,204,74,206,70,74.0,73.4,74.6,00000
91.0,62.0,90.0,445,04,01,  Chandi Ali,759,257,406,114,353,143,74.7,78.1,71.2,00000
91.0,62.0,90.0,445,05,01,  B.D.R.Area,334,26,260,15,74,11,92.8,94.5,87.1,00000
91.0,62.0,90.0,445,06,01,  Noapara,273,217,149,106,124,111,55.7,58.4,52.8,00000
91.0,62.0,90.0,544,01,01,  Shahpur,696,904,328,443,368,461,43.5,42.5,44.4,00000
91.0,62.0,90.0,544,03,01,  Naya Khurumkhola,749,497,399,243,350,254,60.1,62.1,57.9,00000
91.0,62.0,90.0,544,05,01,  Shahpur Khurumkhola,899,780,468,364,431,416,53.5,56.3,50.9,00000
91.0,62.0,90.0,544,06,01,  Pirpur,1144,779,619,355,525,424,59.5,63.6,55.3,00000
91.0,62.0,90.0,554,01,01,  Kumargaon,753,957,394,459,359,498,44.0,46.2,41.9,00000
91.0,62.0,90.0,554,02,01,  Najirgaon,746,744,395,354,351,390,50.1,52.7,47.4,00000
91.0,62.0,90.0,554,03,01,  Kumargaon Wapda,451,98,254,39,197,59,82.1,86.7,77.0,00000
91.0,62.0,90.0,554,04,01,  Sekh Para,1264,725,681,352,583,373,63.5,65.9,61.0,00000
91.0,62.0,90.0,554,05,01,  Shaheb Gaon,255,291,137,137,118,154,46.7,50.0,43.4,00000
91.0,62.0,90.0,554,06,01,  Choree Gaon,398,267,186,129,212,138,59.8,59.0,60.6,00000
91.0,62.0,90.0,554,07,01,  Haidarpur,847,922,475,377,372,545,47.9,55.8,40.6,00000
91.0,62.0,90.0,554,08,01,  Khaligaon,305,428,159,203,146,225,41.6,43.9,39.4,00000
91.0,62.0,90.0,554,09,01,  Upar Para,966,596,515,283,451,313,61.8,64.5,59.0,00000
91.0,62.0,90.0,554,10,01,  Duski,625,221,337,107,288,114,73.9,75.9,71.6,00000
91.0,62.0,90.0,554,11,01,  Jugipara,637,349,366,170,271,179,64.6,68.3,60.2,00000
91.0,62.0,90.0,554,12,01,  Maulvi Bazar,619,238,373,94,246,144,72.2,79.9,63.1,00000
91.0,62.0,90.0,554,13,01,  Baragul,526,98,330,27,196,71,84.3,92.4,73.4,00000
91.0,62.0,90.0,554,14,01,  Goa Bari,1186,60,676,20,510,40,95.2,97.1,92.7,00000
91.0,62.0,90.0,554,15,01,  Dhamali Para,539,70,322,26,217,44,88.5,92.5,83.1,00000
91.0,62.0,90.0,594,01,01,  Mair Char,993,884,536,397,457,487,52.9,57.4,48.4,00000
91.0,62.0,90.0,594,02,01,  Noapara,220,293,112,136,108,157,42.9,45.2,40.8,00000
91.0,62.0,90.0,594,03,01,  Talukdar Para,360,433,200,195,160,238,45.4,50.6,40.2,00000
91.0,62.0,90.0,946,01,01,  Tukergaon,1251,1496,688,790,563,706,45.5,46.5,44.4,00000
91.0,62.0,90.0,946,02,01,  Noagaon (Natun Tuker Bazar),676,600,377,260,299,340,53.0,59.2,46.8,00000
91.0,62.0,90.0,946,03,01,  Gouri Pur,20,180,19,166,1,14,10.0,10.3,6.7,00000
91.0,62.0,95.0,264,01,01,  Mira Para Part,484,331,261,160,223,171,59.4,62.0,56.6,00000
91.0,62.0,95.0,264,02,01,  Kalyanpur Part,338,334,176,166,162,168,50.3,51.5,49.1,00000
91.0,62.0,95.0,816,01,01,  Sadipur,1056,417,659,183,397,234,71.7,78.3,62.9,00000
91.0,62.0,95.0,816,02,01,  Tultikar Part,65,19,38,9,27,10,77.4,80.9,73.0,00000
91.0,62.0,95.0,816,03,01,  Kaylanpur Part,87,35,43,20,44,15,71.3,68.3,74.6,00000
91.0,62.0,95.0,821,01,01,  Uttar Baluchar,7536,7111,4347,3549,3189,3562,51.5,55.1,47.2,00000
91.0,62.0,95.0,821,02,01,  Arampag,1075,519,579,227,496,292,67.4,71.8,62.9,00000
91.0,62.0,95.0,821,03,01,  Durga Bari,348,99,191,45,157,54,77.9,80.9,74.4,00000
91.0,62.0,95.0,985,01,01,  Tultikar,553,331,275,153,278,178,62.6,64.3,61.0,00000
91.0,62.0,95.0,985,02,01,  Kusighat Part,432,269,281,163,151,106,61.6,63.3,58.8,00000
91.0,94.0,15.0,436,01,01,  Kachua,790,567,392,267,398,300,58.2,59.5,57.0,00000
91.0,94.0,15.0,436,02,01,  Putijuri,277,159,142,70,135,89,63.5,67.0,60.3,00000
91.0,94.0,15.0,558,01,01,  Chagli Bazar,100,103,83,68,17,35,49.3,55.0,32.7,00000
91.0,94.0,15.0,558,02,01,  Uttar Khilgram,301,84,161,39,140,45,78.2,80.5,75.7,00000
91.0,94.0,15.0,558,03,01,  Khilgram,1815,1600,916,748,899,852,53.1,55.0,51.3,00000
91.0,94.0,15.0,558,04,01,  Bilbari,196,62,103,24,93,38,76.0,81.1,71.0,00000
91.0,94.0,15.0,558,05,01,  Samamkhani,363,462,182,218,181,244,44.0,45.5,42.6,00000
91.0,94.0,15.0,558,06,01,  Pachali,4,143,3,77,1,66,2.7,3.8,1.5,00000
91.0,94.0,15.0,558,07,01,  Kudalia,75,76,33,33,42,43,49.7,50.0,49.4,00000
91.0,94.0,15.0,558,08,01,  Purba Kaista Para,50,30,27,14,23,16,62.5,65.9,59.0,00000
91.0,94.0,15.0,558,09,01,  Akhab,35,63,14,27,21,36,35.7,34.1,36.8,00000
91.0,94.0,15.0,558,10,01,  Pail,87,267,36,118,51,149,24.6,23.4,25.5,00000
91.0,94.0,15.0,733,01,01,  Nidanpur,578,340,295,159,283,181,63.0,65.0,61.0,00000
91.0,94.0,15.0,733,02,01,  Maijgram,764,578,381,270,383,308,56.9,58.5,55.4,00000
91.0,94.0,15.0,733,03,01,  Mantail,187,772,94,358,93,414,19.5,20.8,18.3,00000
91.0,94.0,15.0,733,04,01,  Keshabpur,213,96,102,45,111,51,68.9,69.4,68.5,00000
91.0,94.0,15.0,733,05,01,  Fatehpur,157,230,85,114,72,116,40.6,42.7,38.3,00000
91.0,94.0,15.0,759,01,01,  Nayagram,249,275,125,123,124,152,47.5,50.4,44.9,00000
91.0,94.0,15.0,759,02,01,  Premnagar,195,219,88,97,107,122,47.1,47.6,46.7,00000
91.0,94.0,15.0,759,03,01,  Kunagram,527,562,282,263,245,299,48.4,51.7,45.0,00000
91.0,94.0,15.0,759,04,01,  Barakuli,465,426,219,231,246,195,52.2,48.7,55.8,00000
91.0,94.0,15.0,811,01,01,  Parchak,565,200,266,76,299,124,73.9,77.8,70.7,00000
91.0,94.0,15.0,811,02,01,  Pali Para,92,219,48,108,44,111,29.6,30.8,28.4,00000
91.0,94.0,15.0,811,03,01,  Balitaka,686,951,332,492,354,459,41.9,40.3,43.5,00000
91.0,94.0,15.0,811,04,01,  Bataisail,421,986,203,476,218,510,29.9,29.9,29.9,00000
91.0,94.0,19.0,034,01,01,  Amalshid,1418,358,786,133,632,225,79.8,85.5,73.7,00000
91.0,94.0,19.0,034,02,01,  Daulatpur,250,152,138,71,112,81,62.2,66.0,58.0,00000
91.0,94.0,19.0,041,01,01,  Anandapur,156,74,81,33,75,41,67.8,71.1,64.7,00000
91.0,94.0,19.0,041,02,01,  Debuttar,179,81,106,38,73,43,68.8,73.6,62.9,00000
91.0,94.0,19.0,226,01,01,  Dariapur,624,481,331,228,293,253,56.5,59.2,53.7,00000
91.0,94.0,19.0,226,02,01,  Gardishpur,203,178,110,81,93,97,53.3,57.6,48.9,00000
91.0,94.0,19.0,372,01,01,  Tilagram,51,66,22,25,29,41,43.6,46.8,41.4,00000
91.0,94.0,19.0,372,02,01,  Kharija,264,155,133,77,131,78,63.0,63.3,62.7,00000
91.0,94.0,19.0,372,03,01,  Dashgram,130,63,67,34,63,29,67.4,66.3,68.5,00000
91.0,94.0,19.0,372,04,01,  Chandpur,214,145,135,56,79,89,59.6,70.7,47.0,00000
91.0,94.0,19.0,986,01,01,  Hasitala,650,333,350,145,300,188,66.1,70.7,61.5,00000
91.0,94.0,19.0,986,02,01,  Bara Thakuri,1119,658,542,294,577,364,63.0,64.8,61.3,00000
91.0,94.0,19.0,986,03,01,  Kashir Chak,95,353,54,187,41,166,21.2,22.4,19.8,00000
91.0,94.0,19.0,986,04,01,  Uttarbhag,386,415,191,235,195,180,48.2,44.8,52.0,00000
91.0,94.0,19.0,986,05,01,  Bhagpara,205,272,107,131,98,141,43.0,45.0,41.0,00000
91.0,94.0,19.0,994,01,01,  Uttarkul,467,514,258,237,209,277,47.6,52.1,43.0,00000
91.0,94.0,19.0,994,02,01,  Kazir Para,203,276,104,128,99,148,42.4,44.8,40.1,00000
91.0,94.0,19.0,994,03,01,  Mina Para,130,298,68,142,62,156,30.4,32.4,28.4,00000
91.0,94.0,19.0,994,04,01,  Kachatail,86,294,41,158,45,136,22.6,20.6,24.9,00000
91.0,94.0,19.0,994,05,01,  Kamargram,100,82,44,38,56,44,54.9,53.7,56.0,00000
91.0,94.0,19.0,994,06,01,  Salapur,406,359,232,160,174,199,53.1,59.2,46.6,00000
91.0,94.0,19.0,994,07,01,  Dighaligram,73,328,34,162,39,166,18.2,17.3,19.0,00000
91.0,94.0,19.0,994,08,01,  Sreekul,62,113,36,57,26,56,35.4,38.7,31.7,00000
91.0,94.0,19.0,994,09,01,  Rarigram,166,229,93,114,73,115,42.0,44.9,38.8,00000
91.0,94.0,19.0,994,10,01,  Kazapur,133,301,71,145,62,156,30.6,32.9,28.4,00000
91.0,94.0,19.0,994,11,01,  Chhoygory,62,86,35,44,27,42,41.9,44.3,39.1,00000
91.0,94.0,28.0,052,02,01,  Piarpur,272,237,149,101,123,136,53.4,59.6,47.5,00000
91.0,94.0,28.0,078,01,01,  Baligram,219,169,112,64,107,105,56.4,63.6,50.5,00000
91.0,94.0,28.0,078,02,01,  Ragurashi,133,195,71,103,62,92,40.5,40.8,40.3,00000
91.0,94.0,28.0,141,01,01,  Uttar Bipak,253,612,144,307,109,305,29.2,31.9,26.3,00000
91.0,94.0,28.0,141,02,01,  Dhalurpar,272,280,128,152,144,128,49.3,45.7,52.9,00000
91.0,94.0,28.0,141,03,01,  Barkatpur,224,234,107,99,117,135,48.9,51.9,46.4,00000
91.0,94.0,28.0,141,04,01,  Nankar,75,37,41,19,34,18,67.0,68.3,65.4,00000
91.0,94.0,28.0,141,05,01,  Tingari,12,19,8,7,4,12,38.7,53.3,25.0,00000
91.0,94.0,28.0,141,06,01,  Dakshin Bipak,198,590,90,289,108,301,25.1,23.7,26.4,00000
91.0,94.0,28.0,141,07,01,  Khalpar,273,190,136,90,137,100,59.0,60.2,57.8,00000
91.0,94.0,28.0,181,01,01,  Muyakhali,190,454,93,220,97,234,29.5,29.7,29.3,00000
91.0,94.0,28.0,181,02,01,  Konargaon,282,255,150,120,132,135,52.5,55.6,49.4,00000
91.0,94.0,28.0,181,03,01,  Barajani,189,116,106,48,83,68,62.0,68.8,55.0,00000
91.0,94.0,28.0,181,04,01,  Ujirpur,461,368,249,143,212,225,55.6,63.5,48.5,00000
91.0,94.0,28.0,181,05,01,  Bara Chalia,317,269,149,132,168,137,54.1,53.0,55.1,00000
91.0,94.0,28.0,181,06,01,  Goyergram,347,775,189,369,158,406,30.9,33.9,28.0,00000
91.0,94.0,28.0,181,07,01,  Majargram,182,318,86,140,96,178,36.4,38.1,35.0,00000
91.0,94.0,28.0,181,08,01,  Lafarkona,306,684,139,326,167,358,30.9,29.9,31.8,00000
91.0,94.0,28.0,181,09,01,  Paschim Jamdhar,352,701,164,343,188,358,33.4,32.3,34.4,00000
91.0,94.0,28.0,181,10,01,  Purba Jamdhar,347,328,172,158,175,170,51.4,52.1,50.7,00000
91.0,94.0,28.0,181,11,01,  Konarband,20,154,9,75,11,79,11.5,10.7,12.2,00000
91.0,94.0,28.0,288,01,01,  Gadadhar,297,360,172,164,125,196,45.2,51.2,38.9,00000
91.0,94.0,28.0,288,02,01,  Sonapur,305,205,159,89,146,116,59.8,64.1,55.7,00000
91.0,94.0,28.0,488,01,01,  Karimpur,111,317,56,159,55,158,25.9,26.0,25.8,00000
91.0,94.0,28.0,488,02,01,  Kandirband,28,148,15,73,13,75,15.9,17.0,14.8,00000
91.0,94.0,28.0,514,01,01,  Keshar Kapan,258,327,135,154,123,173,44.1,46.7,41.6,00000
91.0,94.0,28.0,514,02,01,  Swkra Kandi,229,176,101,79,128,97,56.5,56.1,56.9,00000
91.0,94.0,38.0,126,01,01,  Maulvi Chak,385,1050,167,472,218,578,26.8,26.1,27.4,00000
91.0,94.0,38.0,126,02,01,  Chinir Chak,86,76,39,32,47,44,53.1,54.9,51.6,00000
91.0,94.0,38.0,126,03,01,  Ior,288,350,136,154,152,196,45.1,46.9,43.7,00000
91.0,94.0,38.0,126,04,01,  Balaramer Chak,563,592,255,259,308,333,48.7,49.6,48.0,00000
91.0,94.0,38.0,126,05,01,  Pukra,237,128,111,41,126,87,64.9,73.0,59.2,00000
91.0,94.0,38.0,126,06,01,  Mamarkhali,497,297,237,134,260,163,62.6,63.9,61.5,00000
91.0,94.0,38.0,126,07,01,  Niagoal,1012,578,529,227,483,351,63.6,70.0,57.9,00000
91.0,94.0,38.0,126,08,01,  Lakshim Chak,97,63,45,23,52,40,60.6,66.2,56.5,00000
91.0,94.0,38.0,192,01,01,  Chhattish,183,89,91,29,92,60,67.3,75.8,60.5,00000
91.0,94.0,38.0,192,02,01,  Gandarghar,211,304,108,143,103,161,41.0,43.0,39.0,00000
91.0,94.0,38.0,445,01,01,  Kaista Kapan,612,571,280,261,332,310,51.7,51.8,51.7,00000
91.0,94.0,38.0,445,02,01,  Inamoti,50,6,50,2,0,4,89.3,96.2,0.0,00000
91.0,94.0,38.0,506,01,01,  Paschim Kashkanakpur,750,660,380,308,370,352,53.2,55.2,51.2,00000
91.0,94.0,38.0,506,02,01,  Purba Kashkanakpur,691,790,319,358,372,432,46.7,47.1,46.3,00000
91.0,94.0,38.0,506,03,01,  Sajapur,382,317,195,143,187,174,54.6,57.7,51.8,00000
91.0,94.0,38.0,506,04,01,  Noagram,405,487,171,222,234,265,45.4,43.5,46.9,00000
91.0,94.0,38.0,506,05,01,  Uttar Kashkanakpur,226,94,137,33,89,61,70.6,80.6,59.3,00000
91.0,94.0,38.0,506,06,01,  Hani Gram,317,194,143,81,174,113,62.0,63.8,60.6,00000
91.0,94.0,47.0,174,01,01,  Charigram,2666,2434,1300,1128,1366,1306,52.3,53.5,51.1,00000
91.0,94.0,47.0,174,02,01,  Nayagram,670,526,330,246,340,280,56.0,57.3,54.8,00000
91.0,94.0,47.0,174,03,01,  Baraband,185,395,104,171,81,224,31.9,37.8,26.6,00000
91.0,94.0,57.0,113,01,01,  Purba Beur,280,492,128,229,152,263,36.3,35.9,36.6,00000
91.0,94.0,57.0,113,02,01,  Paschim Beur,310,667,175,294,135,373,31.7,37.3,26.6,00000
91.0,94.0,57.0,113,03,01,  Ambari,132,243,60,107,72,136,35.2,35.9,34.6,00000
91.0,94.0,57.0,113,04,01,  Dubrirpar,96,315,49,148,47,167,23.4,24.9,22.0,00000
91.0,94.0,57.0,165,01,01,  Uttar Lohar Mahal,111,390,58,191,53,199,22.2,23.3,21.0,00000
91.0,94.0,57.0,165,02,01,  Dakshin Lohar Mahal,175,415,90,205,85,210,29.7,30.5,28.8,00000
91.0,94.0,57.0,165,03,01,  Purba Lohar Mahal,118,180,67,83,51,97,39.6,44.7,34.5,00000
91.0,94.0,57.0,165,04,01,  Kapna,260,552,136,242,124,310,32.0,36.0,28.6,00000
91.0,94.0,57.0,165,05,01,  Doligaon,119,239,65,111,54,128,33.2,36.9,29.7,00000
91.0,94.0,57.0,165,06,01,  Bhuiyarmura,166,303,91,154,75,149,35.4,37.1,33.5,00000
91.0,94.0,57.0,165,07,01,  Chand Sreekona Noabari,86,44,42,14,44,30,66.2,75.0,59.5,00000
91.0,94.0,57.0,165,08,01,  Gaglajur,164,224,99,106,65,118,42.3,48.3,35.5,00000
91.0,94.0,57.0,165,09,01,  Sekhpara,130,293,71,143,59,150,30.7,33.2,28.2,00000
91.0,94.0,57.0,165,10,01,  Paschim Lohar Mahal,212,528,109,247,103,281,28.6,30.6,26.8,00000
91.0,94.0,57.0,165,11,01,  Islampur,78,302,48,147,30,155,20.5,24.6,16.2,00000
91.0,94.0,57.0,305,01,03,  Degree,91,119,52,58,39,61,43.3,47.3,39.0,00000
91.0,94.0,57.0,305,02,03,  Hamidpur,152,278,82,133,70,145,35.3,38.1,32.6,00000
91.0,94.0,57.0,305,03,03,  Band Tarapur,74,244,36,128,38,116,23.3,22.0,24.7,00000
91.0,94.0,57.0,305,04,03,  Haldirpar,25,205,7,95,18,110,10.9,6.9,14.1,00000
91.0,94.0,57.0,305,05,03,  Garpur,30,94,16,49,14,45,24.2,24.6,23.7,00000
91.0,94.0,57.0,305,06,03,  Lamargram,574,530,379,255,195,275,52.0,59.8,41.5,00000
91.0,94.0,57.0,305,07,03,  Kadamtala,46,171,28,89,18,82,21.2,23.9,18.0,00000
91.0,94.0,57.0,305,10,03,  Noagram,129,124,67,56,62,68,51.0,54.5,47.7,00000
91.0,94.0,57.0,305,11,03,  Tarapur,118,152,59,75,59,77,43.7,44.0,43.4,00000
91.0,94.0,57.0,632,01,01,  Purba Khala Chhara,125,179,58,86,67,93,41.1,40.3,41.9,00000
91.0,94.0,57.0,632,02,01,  Paschim Khala Chhara,82,86,41,37,41,49,48.8,52.6,45.6,00000
91.0,94.0,57.0,632,03,01,  Madarkhal,547,1425,307,685,240,740,27.7,30.9,24.5,00000
91.0,94.0,57.0,632,04,01,  Noagaon,46,139,29,69,17,70,24.9,29.6,19.5,00000
91.0,94.0,57.0,872,01,01,  Dighirpar,18,114,11,51,7,63,13.6,17.7,10.0,00000
91.0,94.0,57.0,872,02,01,  Mulikandi,251,439,149,205,102,234,36.4,42.1,30.4,00000
91.0,94.0,57.0,872,03,01,  Bangram,158,300,99,143,59,157,34.5,40.9,27.3,00000
91.0,94.0,57.0,872,04,01,  Telikandi,92,220,54,119,38,101,29.5,31.2,27.3,00000
91.0,94.0,57.0,872,05,01,  Sadarpur,195,81,98,45,97,36,70.7,68.5,72.9,00000
91.0,94.0,57.0,872,06,01,  Khil Sadarpur,68,277,40,136,28,141,19.7,22.7,16.6,00000
91.0,94.0,66.0,017,01,01,  Raghur Chak,168,259,87,125,81,134,39.3,41.0,37.7,00000
91.0,94.0,66.0,017,02,01,  Chandar Chak,97,158,48,86,49,72,38.0,35.8,40.5,00000
91.0,94.0,66.0,157,01,01,  Bhatpara,27,6,18,2,9,4,81.8,90.0,69.2,00000
91.0,94.0,66.0,157,02,01,  Parbunagram Kandi,67,50,37,33,30,17,57.3,52.9,63.8,00000
91.0,94.0,66.0,157,03,01,  Parduna,115,130,57,65,58,65,46.9,46.7,47.2,00000
91.0,94.0,66.0,270,01,01,  Eolasar,338,505,182,229,156,276,40.1,44.3,36.1,00000
91.0,94.0,66.0,270,02,01,  Daudpur,379,459,229,202,150,257,45.2,53.1,36.9,00000
91.0,94.0,66.0,279,01,01,  Nandersree,419,255,199,109,220,146,62.2,64.6,60.1,00000
91.0,94.0,66.0,279,02,01,  Fultala,1089,683,807,544,282,139,61.5,59.7,67.0,00000
91.0,94.0,66.0,349,01,01,  Shib Chak,176,193,89,94,87,99,47.7,48.6,46.8,00000
91.0,94.0,66.0,349,02,01,  Dudher Chak,151,168,84,93,67,75,47.3,47.5,47.2,00000
91.0,94.0,66.0,349,03,01,  Harai Trilochan,122,147,63,59,59,88,45.4,51.6,40.1,00000
91.0,94.0,66.0,427,01,01,  Mangalpur,88,5,47,3,41,2,94.6,94.0,95.3,00000
91.0,94.0,66.0,427,02,01,  Pagliarpar,239,167,124,68,115,99,58.9,64.6,53.7,00000
91.0,94.0,66.0,427,03,01,  Jeapur,189,161,104,71,85,90,54.0,59.4,48.6,00000
91.0,94.0,66.0,549,01,01,  Dewan Chak,222,220,118,115,104,105,50.2,50.6,49.8,00000
91.0,94.0,66.0,549,02,01,  Topkhana,493,582,230,278,263,304,45.9,45.3,46.4,00000
91.0,94.0,66.0,549,03,01,  Islampur,599,275,312,115,287,160,68.5,73.1,64.2,00000
91.0,94.0,66.0,549,04,01,  Nayagram,701,455,344,231,357,224,60.6,59.8,61.4,00000
91.0,94.0,66.0,845,01,01,  Purba Mansurpur,693,435,372,218,321,217,61.4,63.1,59.7,00000
91.0,94.0,66.0,845,02,01,  Kandipara,268,124,124,45,144,79,68.4,73.4,64.6,00000
91.0,94.0,66.0,881,01,01,  Kalakuta,381,315,194,130,187,185,54.7,59.9,50.3,00000
91.0,94.0,66.0,881,02,01,  Shahajhl Pur,592,527,287,235,305,292,52.9,55.0,51.1,00000
91.0,94.0,66.0,907,01,01,  Brahmangram,374,206,169,80,205,126,64.5,67.9,61.9,00000
91.0,94.0,66.0,907,02,01,  Hajir Chak,411,332,232,167,179,165,55.3,58.1,52.0,00000
91.0,94.0,66.0,933,01,01,  Sirajpur,179,65,81,31,98,34,73.4,72.3,74.2,00000
91.0,94.0,66.0,933,02,01,  Kear Chandan,51,44,24,24,27,20,53.7,50.0,57.4,00000
91.0,94.0,76.0,043,01,01,  Anandapur,338,295,166,132,172,163,53.4,55.7,51.3,00000
91.0,94.0,76.0,043,02,01,  Kandigram,93,62,46,23,47,39,60.0,66.7,54.7,00000
91.0,94.0,76.0,261,01,01,  Elabaj,745,552,398,234,347,318,57.4,63.0,52.2,00000
91.0,94.0,76.0,261,02,01,  Hajari Chak,96,23,58,8,38,15,80.7,87.9,71.7,00000
91.0,94.0,76.0,261,03,01,  Pathan Chak,655,304,341,143,314,161,68.3,70.5,66.1,00000
91.0,94.0,76.0,261,04,01,  Flahat,236,160,131,69,105,91,59.6,65.5,53.6,00000
91.0,94.0,76.0,261,05,01,  Shitaljori,180,91,90,39,90,52,66.4,69.8,63.4,00000
91.0,94.0,76.0,261,06,01,  Satgauri,110,93,54,44,56,49,54.2,55.1,53.3,00000
91.0,94.0,76.0,296,01,01,  Islampur,124,62,71,28,53,34,66.7,71.7,60.9,00000
91.0,94.0,76.0,296,02,01,  Gajkapan,118,91,75,29,43,62,56.5,72.1,41.0,00000
91.0,94.0,76.0,296,03,01,  Galaikandi,116,192,57,93,59,99,37.7,38.0,37.3,00000
91.0,94.0,76.0,314,01,01,  Majli,635,525,344,247,291,278,54.7,58.2,51.1,00000
91.0,94.0,76.0,314,02,01,  Siraj Para,248,107,137,37,111,70,69.9,78.7,61.3,00000
91.0,94.0,76.0,314,03,01,  Halghat,146,93,78,43,68,50,61.1,64.5,57.6,00000
91.0,94.0,76.0,314,04,01,  Paschim Gangajal,72,24,42,13,30,11,75.0,76.4,73.2,00000
91.0,94.0,76.0,314,05,01,  Guabari,422,344,222,164,200,180,55.1,57.5,52.6,00000
91.0,94.0,76.0,314,06,01,  Khachar Chak,514,446,293,202,221,244,53.5,59.2,47.5,00000
91.0,94.0,76.0,314,07,01,  Chhayghari,236,142,122,61,114,81,62.4,66.7,58.5,00000
91.0,94.0,76.0,314,08,01,  Gachhua,772,633,427,303,345,330,54.9,58.5,51.1,00000
91.0,94.0,76.0,314,09,01,  Gazirkandi,80,54,51,25,29,29,59.7,67.1,50.0,00000
91.0,94.0,76.0,314,10,01,  Uttar Gangajal,235,112,132,46,103,66,67.7,74.2,60.9,00000
91.0,94.0,76.0,314,11,01,  Nalur Chak,100,108,48,51,52,57,48.1,48.5,47.7,00000
91.0,94.0,76.0,314,12,01,  Charigram,91,53,51,22,40,31,63.2,69.9,56.3,00000
91.0,94.0,76.0,322,01,01,  Ganipur,813,613,430,261,383,352,57.0,62.2,52.1,00000
91.0,94.0,76.0,322,02,01,  Noagram,148,130,75,55,73,75,53.2,57.7,49.3,00000
91.0,94.0,76.0,375,01,01,  Tirashi,386,499,228,243,158,256,43.6,48.4,38.2,00000
91.0,94.0,76.0,375,02,01,  Mirzar Chak,101,388,52,198,49,190,20.7,20.8,20.5,00000
91.0,94.0,76.0,375,03,01,  Bilpar,244,214,128,99,116,115,53.3,56.4,50.2,00000
91.0,94.0,76.0,375,04,01,  Badajama,142,207,74,100,68,107,40.7,42.5,38.9,00000
91.0,94.0,76.0,625,01,01,  Majhband,111,171,54,86,57,85,39.4,38.6,40.1,00000
91.0,94.0,76.0,625,02,01,  Subhanpur,35,22,15,13,20,9,61.4,53.6,69.0,00000
91.0,94.0,76.0,625,03,01,  Brahmangram Chak,210,108,118,43,92,65,66.0,73.3,58.6,00000
91.0,94.0,76.0,625,04,01,  Alongjuri,99,72,54,31,45,41,57.9,63.5,52.3,00000
91.0,94.0,76.0,625,05,01,  Sakhra,194,135,104,62,90,73,59.0,62.7,55.2,00000
91.0,94.0,76.0,957,01,01,  Sayedabad,679,639,344,289,335,350,51.5,54.3,48.9,00000
91.0,94.0,76.0,957,02,01,  Bhaktipur,148,67,71,25,77,42,68.8,74.0,64.7,00000
91.0,94.0,76.0,957,03,01,  Rahimpur,139,69,74,32,65,37,66.8,69.8,63.7,00000
91.0,94.0,76.0,957,04,01,  Sonargram,100,164,47,66,53,98,37.9,41.6,35.1,00000
91.0,94.0,76.0,957,05,01,  Jayfarpur,104,105,51,45,53,60,49.8,53.1,46.9,00000
91.0,94.0,76.0,957,06,01,  Khadiman,538,253,302,96,236,157,68.0,75.9,60.1,00000
91.0,94.0,76.0,957,07,01,  Ajargram,122,160,63,76,59,84,43.3,45.3,41.3,00000
91.0,94.0,76.0,957,08,01,  Ichhapur,395,180,224,84,171,96,68.7,72.7,64.0,00000
91.0,94.0,76.0,957,09,01,  Sultanpur,443,349,213,133,230,216,55.9,61.6,51.6,00000
91.0,94.0,76.0,957,10,01,  Gangajal,286,251,144,115,142,136,53.3,55.6,51.1,00000
91.0,94.0,85.0,061,01,01,  Bakarshal,273,539,135,254,138,285,33.6,34.7,32.6,00000
91.0,94.0,85.0,061,02,01,  Manikpur,484,745,225,356,259,389,39.4,38.7,40.0,00000
91.0,94.0,85.0,061,03,01,  Sarisha,84,132,42,66,42,66,38.9,38.9,38.9,00000
91.0,94.0,85.0,366,01,01,  Husnabad(Sabujbagh),370,451,204,218,166,233,45.1,48.3,41.6,00000
91.0,94.0,85.0,366,02,01,  Rahimkhar Chak,358,424,190,207,168,217,45.8,47.9,43.6,00000
91.0,94.0,85.0,384,01,01,  Gadirashi,138,178,74,87,64,91,43.7,46.0,41.3,00000
91.0,94.0,85.0,384,02,01,  Hail,441,421,206,190,235,231,51.2,52.0,50.4,00000
91.0,94.0,85.0,384,03,01,  Anarashi,197,642,93,328,104,314,23.5,22.1,24.9,00000
91.0,94.0,85.0,628,01,01,  Shimarband,66,104,36,50,30,54,38.8,41.9,35.7,00000
91.0,94.0,85.0,628,02,01,  Paschimband,115,187,60,89,55,98,38.1,40.3,35.9,00000
91.0,94.0,85.0,960,01,01,  Mominpur,386,424,190,193,196,231,47.7,49.6,45.9,00000
91.0,94.0,85.0,960,02,01,  Rarai,349,325,173,142,176,183,51.8,54.9,49.0,00000
91.0,94.0,85.0,960,03,01,  Lalgram,233,126,135,32,98,94,64.9,80.8,51.0,00000
91.0,94.0,85.0,960,04,01,  Fewa,65,19,39,8,26,11,77.4,83.0,70.3,00000
91.0,94.0,85.0,960,05,01,  Sanapat Chak,541,475,263,240,278,235,53.2,52.3,54.2,00000
91.0,94.0,85.0,960,06,01,  Sundarar Chak,199,64,117,29,82,35,75.7,80.1,70.1,00000
91.0,94.0,85.0,960,07,01,  Dariabad,145,196,67,94,78,102,42.5,41.6,43.3,00000
58.0,14.0,13.0,006,01,03,  Nayagram,228,224,112,118,116,106,50.4,48.7,52.3,00000
58.0,14.0,13.0,006,02,03,  Miar Patan,148,54,65,27,83,27,73.3,70.7,75.5,00000
58.0,14.0,13.0,006,03,03,  Shingher Mahal,155,28,71,15,84,13,84.7,82.6,86.6,00000
58.0,14.0,13.0,006,04,03,  Rangauti,307,365,125,172,182,193,45.7,42.1,48.5,00000
58.0,14.0,13.0,402,01,01,  Karargram,408,260,187,122,221,138,61.1,60.5,61.6,00000
58.0,14.0,13.0,402,02,01,  Brahmangram,197,131,95,72,102,59,60.1,56.9,63.4,00000
58.0,14.0,13.0,538,01,01,  Kechhrigul,1380,1278,653,603,727,675,51.9,52.0,51.9,00000
58.0,14.0,13.0,538,02,01,  Satkarakandi,414,521,187,245,227,276,44.3,43.3,45.1,00000
58.0,14.0,13.0,602,01,03,  Mahuband (Part),64,19,33,11,31,8,77.1,75.0,79.5,00000
58.0,14.0,13.0,602,02,03,  Maij Para (Part),72,66,32,31,40,35,52.2,50.8,53.3,00000
58.0,14.0,15.0,145,01,01,  Barni,897,729,410,298,487,431,55.2,57.9,53.1,00000
58.0,14.0,15.0,145,02,01,  Barni Chak,431,735,173,377,258,358,37.0,31.5,41.9,00000
58.0,14.0,15.0,145,03,01,  Barni Chhaga,145,111,70,50,75,61,56.6,58.3,55.1,00000
58.0,14.0,15.0,145,04,01,  Ganeshram Chak,323,241,138,113,185,128,57.3,55.0,59.1,00000
58.0,14.0,15.0,145,05,01,  Barhal,164,281,66,130,98,151,36.9,33.7,39.4,00000
58.0,14.0,15.0,145,06,01,  Nayagram,94,547,48,250,46,297,14.7,16.1,13.4,00000
58.0,14.0,15.0,145,07,01,  Ahammedpur,22,42,9,23,13,19,34.4,28.1,40.6,00000
58.0,14.0,15.0,323,01,01,  Faringa,133,130,57,61,76,69,50.6,48.3,52.4,00000
58.0,14.0,15.0,323,02,01,  Faringa Bazar,107,36,52,15,55,21,74.8,77.6,72.4,00000
58.0,14.0,15.0,621,01,01,  Manarai,462,366,226,172,236,194,55.8,56.8,54.9,00000
58.0,14.0,15.0,621,02,01,  Rangpur,86,89,51,42,35,47,49.1,54.8,42.7,00000
58.0,14.0,15.0,627,01,01,  Mehari,231,76,115,29,116,47,75.2,79.9,71.2,00000
58.0,14.0,15.0,627,02,01,  Kandigram,61,57,35,26,26,31,51.7,57.4,45.6,00000
58.0,14.0,15.0,627,03,01,  Shilkura,104,235,52,104,52,131,30.7,33.3,28.4,00000
58.0,14.0,15.0,627,04,01,  Nayagram,105,95,45,44,60,51,52.5,50.6,54.1,00000
58.0,14.0,15.0,690,01,01,  Pakshail,1090,560,487,238,603,322,66.1,67.2,65.2,00000
58.0,14.0,15.0,690,02,01,  Monadi,144,206,67,94,77,112,41.1,41.6,40.7,00000
58.0,14.0,15.0,836,01,01,  Satpur,1126,1041,526,481,600,560,52.0,52.2,51.7,00000
58.0,14.0,15.0,836,02,01,  Mudatpur,217,332,80,161,137,171,39.5,33.2,44.5,00000
58.0,14.0,15.0,956,01,01,  Salia,266,319,130,148,136,171,45.5,46.8,44.3,00000
58.0,14.0,15.0,956,02,01,  Kazir Ban,416,658,197,310,219,348,38.7,38.9,38.6,00000
58.0,14.0,29.0,199,01,01,  Gandai,653,660,342,328,311,332,49.7,51.0,48.4,00000
58.0,14.0,29.0,199,02,01,  Paku,93,319,39,154,54,165,22.6,20.2,24.7,00000
58.0,14.0,29.0,199,03,01,  Islamnagar,430,544,207,249,223,295,44.1,45.4,43.1,00000
58.0,14.0,29.0,199,04,01,  Shatghari,222,106,112,42,110,64,67.7,72.7,63.2,00000
58.0,14.0,29.0,199,05,01,  Bobartal,216,91,112,38,104,53,70.4,74.7,66.2,00000
58.0,14.0,29.0,199,06,01,  Karia Chhara,132,97,67,45,65,52,57.6,59.8,55.6,00000
58.0,14.0,29.0,240,01,01,  Chhota Lekha T.E.,157,239,99,109,58,130,39.6,47.6,30.9,00000
58.0,14.0,29.0,240,02,01,  Nalikhai Panpungi,142,278,80,141,62,137,33.8,36.2,31.2,00000
58.0,14.0,29.0,399,01,01,  Gramtala,404,135,196,62,208,73,75.0,76.0,74.0,00000
58.0,14.0,29.0,399,02,01,  Bouler Chak,457,148,210,59,247,89,75.5,78.1,73.5,00000
58.0,14.0,29.0,709,01,01,  Shariao,150,158,59,72,91,86,48.7,45.0,51.4,00000
58.0,14.0,29.0,709,02,01,  Sikaruni,23,71,8,25,15,46,24.5,24.2,24.6,00000
58.0,14.0,29.0,709,03,01,  Baliskuna,64,87,26,48,38,39,42.4,35.1,49.4,00000
58.0,14.0,29.0,709,04,01,  Chandergul,279,300,142,145,137,155,48.2,49.5,46.9,00000
58.0,14.0,29.0,709,05,01,  Bisraband Part,224,83,105,36,119,47,73.0,74.5,71.7,00000
58.0,14.0,29.0,903,01,01,  Banikona,311,167,144,76,167,91,65.1,65.5,64.7,00000
58.0,14.0,29.0,903,02,01,  Tajpur,63,112,27,57,36,55,36.0,32.1,39.6,00000
58.0,14.0,29.0,903,03,01,  Ramchandrapur,45,33,21,11,24,22,57.7,65.6,52.2,00000
58.0,14.0,29.0,903,04,01,  Bagatikar Part,68,143,27,67,41,76,32.2,28.7,35.0,00000
58.0,14.0,29.0,912,01,01,  Garua,130,208,51,107,79,101,38.5,32.3,43.9,00000
58.0,14.0,29.0,912,02,01,  Deoul,202,125,92,54,110,71,61.8,63.0,60.8,00000
58.0,14.0,29.0,912,03,01,  Sujaul,640,446,312,185,328,261,58.9,62.8,55.7,00000
58.0,14.0,29.0,912,04,01,  Kayesthaman,53,31,25,14,28,17,63.1,64.1,62.2,00000
58.0,14.0,29.0,912,05,01,  Panch Para,377,153,185,66,192,87,71.1,73.7,68.8,00000
58.0,14.0,29.0,912,06,01,  Bisraband (Part),282,344,104,167,178,177,45.0,38.4,50.1,00000
58.0,14.0,31.0,253,01,01,  Dakshinbhag,376,496,179,236,197,260,43.1,43.1,43.1,00000
58.0,14.0,31.0,253,02,01,  Nij Dakshinbhag,876,769,423,374,453,395,53.3,53.1,53.4,00000
58.0,14.0,31.0,253,03,01,  Arengabad,392,132,182,49,210,83,74.8,78.8,71.7,00000
58.0,14.0,31.0,253,04,01,  Purba Daskhinbhag,536,551,264,241,272,310,49.3,52.3,46.7,00000
58.0,14.0,31.0,253,05,01,  Paschim Dakshinbhag,594,679,312,329,282,350,46.7,48.7,44.6,00000
58.0,14.0,31.0,253,06,01,  Dashkin Bhag Bazar,83,38,48,19,35,19,68.6,71.6,64.8,00000
58.0,14.0,31.0,278,01,01,  Paschim Hatlia,307,227,159,103,148,124,57.5,60.7,54.4,00000
58.0,14.0,31.0,278,02,01,  Purba Hatlia,484,206,220,81,264,125,70.1,73.1,67.9,00000
58.0,14.0,31.0,278,03,01,  Putadhar,88,14,43,5,45,9,86.3,89.6,83.3,00000
58.0,14.0,31.0,329,01,01,  Pachim Hatilia(Part),225,93,106,40,119,53,70.8,72.6,69.2,00000
58.0,14.0,31.0,329,02,01,  Purba Hatlia(Part),327,102,145,41,182,61,76.2,78.0,74.9,00000
58.0,14.0,31.0,373,01,01,  Haripur,1132,292,531,122,601,170,79.5,81.3,78.0,00000
58.0,14.0,31.0,373,02,01,  Sonatanpur,233,85,107,34,126,51,73.3,75.9,71.2,00000
58.0,14.0,31.0,665,01,01,  Madhab Panpungi,310,231,180,104,130,127,57.3,63.4,50.6,00000
58.0,14.0,31.0,665,02,01,  Patharia T.G.,375,1551,218,765,157,786,19.5,22.2,16.6,00000
58.0,14.0,31.0,665,03,01,  Mukam T.G.,144,683,96,329,48,354,17.4,22.6,11.9,00000
58.0,14.0,31.0,665,04,01,  Samanbagh T.G.,787,1580,459,704,328,876,33.2,39.5,27.2,00000
58.0,14.0,31.0,665,05,01,  Hakaiti 8,170,119,76,53,94,66,58.8,58.9,58.8,00000
58.0,14.0,31.0,665,06,01,  Hakaiti 10,294,561,116,273,178,288,34.4,29.8,38.2,00000
58.0,14.0,31.0,665,07,01,  Hakaiti 7,728,575,348,289,380,286,55.9,54.6,57.1,00000
58.0,14.0,31.0,804,01,01,  Safarpur,609,285,282,107,327,178,68.1,72.5,64.8,00000
58.0,14.0,31.0,804,02,01,  Penagul,501,128,225,47,276,81,79.7,82.7,77.3,00000
58.0,14.0,39.0,411,01,01,  Gulua,539,396,254,174,285,222,57.6,59.3,56.2,00000
58.0,14.0,39.0,411,02,01,  Talukdar Para,104,44,57,23,47,21,70.3,71.3,69.1,00000
58.0,14.0,39.0,576,01,01,  Uttar Lamatia,606,454,290,218,316,236,57.2,57.1,57.2,00000
58.0,14.0,39.0,576,02,01,  Dakshin Lamatia,268,110,130,45,138,65,70.9,74.3,68.0,00000
58.0,14.0,39.0,576,03,01,  Purba Lamatia,444,93,208,39,236,54,82.7,84.2,81.4,00000
58.0,14.0,39.0,576,04,01,  Dasher Bazar,164,63,78,20,86,43,72.2,79.6,66.7,00000
58.0,14.0,39.0,595,01,01,  Maharani,330,303,173,124,157,179,52.1,58.2,46.7,00000
58.0,14.0,39.0,595,02,01,  Tuka,395,186,203,71,192,115,68.0,74.1,62.5,00000
58.0,14.0,39.0,823,01,01,  Sarikandi,835,366,420,165,415,201,69.5,71.8,67.4,00000
58.0,14.0,39.0,823,02,01,  Dhalirpar,95,55,45,25,50,30,63.3,64.3,62.5,00000
58.0,14.0,39.0,823,03,01,  Dakshin Bagirpar,204,232,99,109,105,123,46.8,47.6,46.1,00000
58.0,14.0,39.0,823,04,01,  Malisree,190,148,92,67,98,81,56.2,57.9,54.7,00000
58.0,14.0,39.0,823,05,01,  Maizamjuri,124,106,61,60,63,46,53.9,50.4,57.8,00000
58.0,14.0,39.0,823,06,01,  Bangaon,65,50,27,18,38,32,56.5,60.0,54.3,00000
58.0,14.0,39.0,823,07,01,  Chularkuri,139,100,64,50,75,50,58.2,56.1,60.0,00000
58.0,14.0,39.0,823,08,01,  Kudali,74,142,39,77,35,65,34.3,33.6,35.0,00000
58.0,14.0,39.0,823,09,01,  Narakandi,13,78,7,36,6,42,14.3,16.3,12.5,00000
58.0,14.0,39.0,823,10,01,  Uttar Bagirpar,193,160,91,72,102,88,54.7,55.8,53.7,00000
58.0,14.0,39.0,868,01,01,  Purba Shankarpur,693,342,366,147,327,195,67.0,71.3,62.6,00000
58.0,14.0,39.0,868,02,01,  Paschim Shankarpur,368,657,184,332,184,325,35.9,35.7,36.1,00000
58.0,14.0,63.0,462,01,01,  Itauri,988,271,520,111,468,160,78.5,82.4,74.5,00000
58.0,14.0,63.0,462,02,01,  Kandigram,284,418,128,203,156,215,40.5,38.7,42.0,00000
58.0,14.0,63.0,608,01,01,  Maijgram,1144,734,570,332,574,402,60.9,63.2,58.8,00000
58.0,14.0,63.0,608,02,01,  Adampur,545,551,279,274,266,277,49.7,50.5,49.0,00000
58.0,14.0,63.0,671,01,01,  Nij Bahadurpur,1139,1297,577,623,562,674,46.8,48.1,45.5,00000
58.0,14.0,63.0,671,02,01,  Galla Shangal,1515,720,768,343,747,377,67.8,69.1,66.5,00000
58.0,14.0,77.0,063,01,01,  Kutalpur,134,342,52,174,82,168,28.2,23.0,32.8,00000
58.0,14.0,77.0,063,02,01,  Baghmara,314,274,146,129,168,145,53.4,53.1,53.7,00000
58.0,14.0,77.0,063,03,01,  Uttar Baghmara,166,150,75,72,91,78,52.5,51.0,53.8,00000
58.0,14.0,77.0,063,04,01,  Bhadda,150,308,77,155,73,153,32.8,33.2,32.3,00000
58.0,14.0,77.0,063,05,01,  Jhagri,153,167,71,69,82,98,47.8,50.7,45.6,00000
58.0,14.0,77.0,063,06,01,  Barhali,96,252,35,122,61,130,27.6,22.3,31.9,00000
58.0,14.0,77.0,063,07,01,  Charkuna,136,188,52,96,84,92,42.0,35.1,47.7,00000
58.0,14.0,77.0,063,08,01,  Najir Kha,64,108,32,49,32,59,37.2,39.5,35.2,00000
58.0,14.0,77.0,247,01,01,  Hashimpur,263,322,106,143,157,179,45.0,42.6,46.7,00000
58.0,14.0,77.0,247,02,01,  Chintapur,284,258,135,120,149,138,52.4,52.9,51.9,00000
58.0,14.0,77.0,486,01,01,  Dashghari,102,420,37,217,65,203,19.5,14.6,24.3,00000
58.0,14.0,77.0,486,02,01,  Rangi Nagar,54,49,24,26,30,23,52.4,48.0,56.6,00000
58.0,14.0,77.0,861,01,01,  Bhularkandi,201,1024,108,564,93,460,16.4,16.1,16.8,00000
58.0,14.0,77.0,861,02,01,  Saldigha,1305,759,601,330,704,429,63.2,64.6,62.1,00000
58.0,14.0,77.0,861,03,01,  Rafinagar,809,360,358,143,451,217,69.2,71.5,67.5,00000
58.0,14.0,77.0,874,01,01,  Bagherkona,153,102,61,47,92,55,60.0,56.5,62.6,00000
58.0,14.0,77.0,874,02,01,  Brahmaner Chak,295,126,130,65,165,61,70.1,66.7,73.0,00000
58.0,14.0,77.0,874,03,01,  Sujanagar Uttar,1340,918,590,449,750,469,59.3,56.8,61.5,00000
58.0,14.0,77.0,874,04,01,  Sujanagar Dakshin,610,502,347,255,263,247,54.9,57.6,51.6,00000
58.0,14.0,77.0,944,01,01,  Terakuri,352,103,176,34,176,69,77.4,83.8,71.8,00000
58.0,14.0,77.0,944,02,01,  Kashlia,73,83,29,39,44,44,46.8,42.6,50.0,00000
58.0,14.0,80.0,139,01,01,  Barkhola,647,236,333,105,314,131,73.3,76.0,70.6,00000
58.0,14.0,80.0,139,02,01,  Barkhola Panpungi,123,67,55,32,68,35,64.7,63.2,66.0,00000
58.0,14.0,80.0,259,01,01,  Keramatnagar T.G.,109,298,71,138,38,160,26.8,34.0,19.2,00000
58.0,14.0,80.0,259,02,01,  Keramatnagar Basti,66,121,33,60,33,61,35.3,35.5,35.1,00000
58.0,14.0,80.0,367,01,01,  Matgodam,161,143,86,74,75,69,53.0,53.8,52.1,00000
58.0,14.0,80.0,367,02,01,  Lakshmichhara Panpungi,31,65,15,33,16,32,32.3,31.3,33.3,00000
58.0,14.0,80.0,367,03,01,  Kathajangal Panpungi,29,23,17,9,12,14,55.8,65.4,46.2,00000
58.0,14.0,80.0,373,01,01,  Gauranagar,554,870,231,408,323,462,38.9,36.2,41.1,00000
58.0,14.0,80.0,373,02,01,  Lakshmichhara,46,233,23,112,23,121,16.5,17.0,16.0,00000
58.0,14.0,80.0,373,03,01,  Kathajangal,86,212,61,100,25,112,28.9,37.9,18.2,00000
58.0,14.0,80.0,532,01,01,  Kanthaltali Dashkin,1107,661,532,332,575,329,62.6,61.6,63.6,00000
58.0,14.0,80.0,532,02,01,  Chukarpungi,464,942,199,464,265,478,33.0,30.0,35.7,00000
58.0,14.0,80.0,532,03,01,  Shimulia )Part),442,153,207,77,235,76,74.3,72.9,75.6,00000
58.0,14.0,80.0,532,04,01,  Kathaltali Uttar,978,645,472,283,506,362,60.3,62.5,58.3,00000
58.0,14.0,80.0,532,05,01,  Sheola Digha,73,49,37,23,36,26,59.8,61.7,58.1,00000
58.0,14.0,85.0,044,01,01,  Atua,468,209,238,92,230,117,69.1,72.1,66.3,00000
58.0,14.0,85.0,044,02,01,  Islampur,133,288,63,142,70,146,31.6,30.7,32.4,00000
58.0,14.0,85.0,171,01,01,  Bhatauchi,309,424,149,202,160,222,42.2,42.5,41.9,00000
58.0,14.0,85.0,171,02,01,  Pabijuripar,326,160,161,64,165,96,67.1,71.6,63.2,00000
58.0,14.0,85.0,171,03,01,  Ujan Para,193,72,98,29,95,43,72.8,77.2,68.8,00000
58.0,14.0,85.0,171,04,01,  Mukarrabari,105,31,53,14,52,17,77.2,79.1,75.4,00000
58.0,14.0,85.0,171,05,01,  Bhabanipur,211,266,105,125,106,141,44.2,45.7,42.9,00000
58.0,14.0,85.0,171,06,01,  Alapur,33,68,17,31,16,37,32.7,35.4,30.2,00000
58.0,14.0,85.0,196,01,01,  Boali,443,209,234,104,209,105,67.9,69.2,66.6,00000
58.0,14.0,85.0,196,02,01,  Satarkhai,151,87,73,32,78,55,63.4,69.5,58.6,00000
58.0,14.0,85.0,196,03,01,  Napitkhai,135,69,58,34,77,35,66.2,63.0,68.8,00000
58.0,14.0,85.0,196,04,01,  Elamjanpur,182,69,87,28,95,41,72.5,75.7,69.9,00000
58.0,14.0,85.0,570,01,01,  Kumarshail T.G.,24,205,15,105,9,100,10.5,12.5,8.3,00000
58.0,14.0,85.0,570,02,01,  Panpunji,64,186,29,96,35,90,25.6,23.2,28.0,00000
58.0,14.0,85.0,659,01,01,  Nandua,589,389,279,173,310,216,60.2,61.7,58.9,00000
58.0,14.0,85.0,659,02,01,  Pabania,207,69,101,26,106,43,75.0,79.5,71.1,00000
58.0,14.0,85.0,703,01,01,  Pallathal T.G.,83,343,54,167,29,176,19.5,24.4,14.1,00000
58.0,14.0,85.0,703,02,01,  Pallapunji,57,63,29,35,28,28,47.5,45.3,50.0,00000
58.0,14.0,85.0,760,01,01,  Purba Daulatpur,360,651,189,292,171,359,35.6,39.3,32.3,00000
58.0,14.0,85.0,760,02,01,  Bade Pukaria,256,214,133,92,123,122,54.5,59.1,50.2,00000
58.0,14.0,85.0,760,03,01,  Rajpur,306,144,158,56,148,88,68.0,73.8,62.7,00000
58.0,14.0,85.0,849,01,01,  Shaipur,1142,834,561,398,581,436,57.8,58.5,57.1,00000
58.0,14.0,85.0,849,02,01,  Alampur,123,72,68,30,55,42,63.1,69.4,56.7,00000
58.0,14.0,85.0,849,03,01,  Noagaon,49,11,23,3,26,8,81.7,88.5,76.5,00000
58.0,14.0,85.0,893,01,01,  Aladad T.G.,48,132,29,66,19,66,26.7,30.5,22.4,00000
58.0,14.0,85.0,893,02,01,  Panpunji,144,65,75,31,69,34,68.9,70.8,67.0,00000
58.0,14.0,85.0,899,01,01,  Sreedharpur,168,431,72,224,96,207,28.0,24.3,31.7,00000
58.0,14.0,85.0,899,02,01,  Chargram,174,59,81,21,93,38,74.7,79.4,71.0,00000
58.0,14.0,85.0,899,03,01,  Khalpar,165,56,85,30,80,26,74.7,73.9,75.5,00000
58.0,14.0,85.0,899,04,01,  Mahanpur,65,80,26,42,39,38,44.8,38.2,50.6,00000
58.0,14.0,85.0,899,05,01,  Charkandi,24,40,7,19,17,21,37.5,26.9,44.7,00000
58.0,14.0,85.0,899,06,01,  Pukuria,193,129,80,63,113,66,59.9,55.9,63.1,00000
58.0,14.0,94.0,126,01,01,  Gopalpur,427,148,206,60,221,88,74.3,77.4,71.5,00000
58.0,14.0,94.0,126,02,01,  Kalartali,158,164,87,102,71,62,49.1,46.0,53.4,00000
58.0,14.0,94.0,126,03,01,  Telimeli,347,104,167,40,180,64,76.9,80.7,73.8,00000
58.0,14.0,94.0,126,04,01,  Choiarkandi,19,2,11,0,8,2,90.5,100.0,80.0,00000
58.0,14.0,94.0,126,05,01,  Bara Maidan,1254,1516,656,737,598,779,45.3,47.1,43.4,00000
58.0,14.0,94.0,481,01,01,  Sreerampur,277,300,131,157,146,143,48.0,45.5,50.5,00000
58.0,14.0,94.0,481,02,01,  Pabijuri,120,189,55,91,65,98,38.8,37.7,39.9,00000
58.0,14.0,94.0,652,01,01,  Kmtaura,178,413,83,179,95,234,30.1,31.7,28.9,00000
58.0,14.0,94.0,652,02,01,  Ahmadpur,99,216,47,110,52,106,31.4,29.9,32.9,00000
58.0,14.0,94.0,652,03,01,  Halla,172,336,67,160,105,176,33.9,29.5,37.4,00000
58.0,14.0,94.0,652,04,01,  Nonua,108,96,45,45,63,51,52.9,50.0,55.3,00000
58.0,14.0,94.0,652,05,01,  Murshidabad Kura,1123,2278,564,1080,559,1198,33.0,34.3,31.8,00000
58.0,14.0,94.0,826,01,01,  Akhalimura,76,91,34,44,42,47,45.5,43.6,47.2,00000
58.0,14.0,94.0,826,02,01,  Kanchanpur,518,256,238,110,280,146,66.9,68.4,65.7,00000
58.0,35.0,23.0,258,01,01,  Fultala Bazar,623,409,328,193,295,216,60.4,63.0,57.7,00000
58.0,35.0,23.0,258,02,01,  Fultala T.E.,910,1791,502,861,408,930,33.7,36.8,30.5,00000
58.0,35.0,23.0,258,03,01,  Elbintila,435,1239,259,602,176,637,26.0,30.1,21.6,00000
58.0,35.0,23.0,258,04,01,  Fultala Basti,322,629,151,302,171,327,33.9,33.3,34.3,00000
58.0,35.0,23.0,638,01,01,  Matinpur,6,30,4,16,2,14,16.7,20.0,12.5,00000
58.0,35.0,23.0,638,02,01,  Barua Kandi,82,140,42,83,40,57,36.9,33.6,41.2,00000
58.0,35.0,23.0,638,03,01,  Chunga Bari,56,223,40,108,16,115,20.1,27.0,12.2,00000
58.0,35.0,23.0,828,01,01,  Rahimpur,21,192,11,103,10,89,9.9,9.6,10.1,00000
58.0,35.0,23.0,828,02,01,  Dholi Haor,150,457,89,228,61,229,24.7,28.1,21.0,00000
58.0,35.0,29.0,287,01,01,  Goalbari,413,180,197,70,216,110,69.6,73.8,66.3,00000
58.0,35.0,29.0,287,02,01,  Goalbari Purbo,407,185,198,75,209,110,68.8,72.5,65.5,00000
58.0,35.0,29.0,287,03,01,  Goalbari Pashim,221,120,104,52,117,68,64.8,66.7,63.2,00000
58.0,35.0,29.0,442,01,01,  Kachurgul (Purba),675,620,309,269,366,351,52.1,53.5,51.0,00000
58.0,35.0,29.0,442,02,01,  Kachurgul Paschim,509,227,256,93,253,134,69.2,73.4,65.4,00000
58.0,35.0,29.0,557,01,01,  Latichhara,61,92,32,39,29,53,39.9,45.1,35.4,00000
58.0,35.0,29.0,557,02,01,  Jorichhara,44,65,23,40,21,25,40.4,36.5,45.7,00000
58.0,35.0,29.0,575,01,01,  Magura,623,352,303,164,320,188,63.9,64.9,63.0,00000
58.0,35.0,29.0,575,02,01,  Eraligul,294,207,125,97,169,110,58.7,56.3,60.6,00000
58.0,35.0,29.0,626,01,01,  Mantrigaon,437,275,221,129,216,146,61.4,63.1,59.7,00000
58.0,35.0,29.0,626,02,01,  Jogimura,163,97,74,41,89,56,62.7,64.3,61.4,00000
58.0,35.0,29.0,695,01,01,  Latitila (Domabar),297,175,145,78,152,97,62.9,65.0,61.0,00000
58.0,35.0,29.0,695,02,01,  Domabari,171,157,71,79,100,78,52.1,47.3,56.2,00000
58.0,35.0,29.0,695,03,01,  Nalapunji,71,84,27,35,44,49,45.8,43.5,47.3,00000
58.0,35.0,29.0,764,01,01,  Paschim Shilua,319,262,147,129,172,133,54.9,53.3,56.4,00000
58.0,35.0,29.0,764,02,01,  Sohagirpar,69,27,37,9,32,18,71.9,80.4,64.0,00000
58.0,35.0,29.0,862,01,01,  Ratna T.E.,523,1088,300,496,223,592,32.5,37.7,27.4,00000
58.0,35.0,29.0,862,02,01,  Elapur,423,346,256,134,167,212,55.0,65.6,44.1,00000
58.0,35.0,29.0,862,03,01,  Putichhara,180,191,92,80,88,111,48.5,53.5,44.2,00000
58.0,35.0,29.0,879,01,01,  Belbari,7,41,5,18,2,23,14.6,21.7,8.0,00000
58.0,35.0,29.0,879,02,01,  Suknachhara,162,66,80,28,82,38,71.1,74.1,68.3,00000
58.0,35.0,29.0,879,03,01,  Hayachara,96,79,56,36,40,43,54.9,60.9,48.2,00000
58.0,35.0,29.0,879,04,01,  Rupa Chhara,85,82,46,38,39,44,50.9,54.8,47.0,00000
58.0,35.0,29.0,879,05,01,  Lal Chhara,74,79,42,42,32,37,48.4,50.0,46.4,00000
58.0,35.0,29.0,937,01,01,  Shilua T.G. Boroline,473,324,266,160,207,164,59.3,62.4,55.8,00000
58.0,35.0,29.0,937,02,01,  Shiluat..G.12 No.Line,198,199,117,81,81,118,49.9,59.1,40.7,00000
58.0,35.0,29.0,937,03,01,  Shiluat.G.09 No.Line,110,422,69,213,41,209,20.7,24.5,16.4,00000
58.0,35.0,29.0,937,04,01,  Shiluat.G.Chamru Tila,26,70,10,37,16,33,27.1,21.3,32.7,00000
58.0,35.0,29.0,937,05,01,  Pathor Tila,118,314,72,162,46,152,27.3,30.8,23.2,00000
58.0,35.0,29.0,937,06,01,  Kutchi T.G.,483,440,306,157,177,283,52.3,66.1,38.5,00000
58.0,35.0,29.0,937,07,01,  Kutchi Jalie,146,334,83,154,63,180,30.4,35.0,25.9,00000
58.0,35.0,29.0,937,08,01,  Fualbari Line,67,74,34,38,33,36,47.5,47.2,47.8,00000
58.0,35.0,29.0,989,01,01,  Uttar Kuchiathal,185,179,92,80,93,99,50.8,53.5,48.4,00000
58.0,35.0,29.0,989,02,01,  Islamabad,86,62,45,29,41,33,58.1,60.8,55.4,00000
58.0,35.0,47.0,149,01,01,  Chatera,287,298,129,151,158,147,49.1,46.1,51.8,00000
58.0,35.0,47.0,149,02,01,  Champaklata,415,623,207,301,208,322,40.0,40.7,39.2,00000
58.0,35.0,47.0,189,01,01,  Dakshin Bhabanipur,1228,614,598,275,630,339,66.7,68.5,65.0,00000
58.0,35.0,47.0,189,02,01,  Biswanathpur,226,148,105,64,121,84,60.4,62.1,59.0,00000
58.0,35.0,47.0,425,01,03,  Jangirai,2577,1328,1277,618,1300,710,66.0,67.4,64.7,00000
58.0,35.0,47.0,425,02,03,  Sonapur,79,235,34,124,45,111,25.2,21.5,28.8,00000
58.0,35.0,47.0,425,03,03,  Belagaon,2654,2607,1282,1295,1372,1312,50.4,49.7,51.1,00000
58.0,35.0,47.0,425,04,03,  Kaminiganj Bazar,613,243,360,124,253,119,71.6,74.4,68.0,00000
58.0,35.0,47.0,425,05,03,  Gharergaon,220,191,108,98,112,93,53.5,52.4,54.6,00000
58.0,35.0,47.0,580,01,01,  Mantail,805,433,406,182,399,251,65.0,69.0,61.4,00000
58.0,35.0,47.0,580,02,01,  Kalinagar,615,719,258,371,357,348,46.1,41.0,50.6,00000
58.0,35.0,47.0,580,03,01,  Mohammadnagar,222,330,98,162,124,168,40.2,37.7,42.5,00000
58.0,35.0,47.0,713,01,01,  Naya Gram,712,881,344,448,368,433,44.7,43.4,45.9,00000
58.0,35.0,47.0,713,02,01,  Shimultala,289,152,158,68,131,84,65.5,69.9,60.9,00000
58.0,35.0,47.0,713,03,01,  Yusuf Nagar,317,323,158,159,159,164,49.5,49.8,49.2,00000
58.0,35.0,47.0,920,01,01,  Shahapur,1048,1205,475,597,573,608,46.5,44.3,48.5,00000
58.0,35.0,47.0,920,02,01,  Monohor Pur,99,34,47,14,52,20,74.4,77.0,72.2,00000
58.0,35.0,47.0,920,03,01,  Rajpur,95,46,49,23,46,23,67.4,68.1,66.7,00000
58.0,35.0,47.0,920,05,01,  Hakimpur,40,63,21,32,19,31,38.8,39.6,38.0,00000
58.0,35.0,47.0,920,06,01,  Kankoir Chock,147,105,69,50,78,55,58.3,58.0,58.6,00000
58.0,35.0,47.0,920,07,01,  Nishchintapur,610,201,310,90,300,111,75.2,77.5,73.0,00000
58.0,35.0,47.0,920,08,01,  Digholback,109,212,50,108,59,104,34.0,31.6,36.2,00000
58.0,35.0,47.0,920,09,01,  Bhuai,257,51,124,20,133,31,83.4,86.1,81.1,00000
58.0,35.0,47.0,920,10,01,  Prohalladpur,174,132,96,92,78,40,56.9,51.1,66.1,00000
58.0,35.0,47.0,920,11,01,  Hasnabad,283,70,147,27,136,43,80.2,84.5,76.0,00000
58.0,35.0,47.0,920,12,01,  Nurpur,179,70,83,35,96,35,71.9,70.3,73.3,00000
58.0,35.0,47.0,920,13,01,  Hamidpur,638,274,309,111,329,163,70.0,73.6,66.9,00000
58.0,35.0,55.0,278,01,01,  Krishnanagar,724,786,397,374,327,412,47.9,51.5,44.2,00000
58.0,35.0,55.0,278,02,01,  Naldari,74,296,52,142,22,154,20.0,26.8,12.5,00000
58.0,35.0,55.0,278,03,01,  Futanitila,102,174,67,69,35,105,37.0,49.3,25.0,00000
58.0,35.0,55.0,278,04,01,  Babutila,182,316,115,135,67,181,36.5,46.0,27.0,00000
58.0,35.0,55.0,278,05,01,  Dhamai T.G.,308,392,197,149,111,243,44.0,56.9,31.4,00000
58.0,35.0,55.0,278,06,01,  Tanti Para,151,165,95,57,56,108,47.8,62.5,34.1,00000
58.0,35.0,55.0,285,01,01,  Baishnab Para,73,115,46,45,27,70,38.8,50.5,27.8,00000
58.0,35.0,55.0,285,02,01,  Amuli Basti,71,222,45,112,26,110,24.2,28.7,19.1,00000
58.0,35.0,55.0,285,03,01,  Dakshintila,200,127,115,48,85,79,61.2,70.6,51.8,00000
58.0,35.0,55.0,285,04,01,  Muraritila,69,168,48,77,21,91,29.1,38.4,18.8,00000
58.0,35.0,55.0,285,05,01,  Kalitila,108,172,80,64,28,108,38.6,55.6,20.6,00000
58.0,35.0,55.0,285,06,01,  Shilghat Garden,96,168,60,69,36,99,36.4,46.5,26.7,00000
58.0,35.0,55.0,507,01,01,  Kalanigar,473,456,218,229,255,227,50.9,48.8,52.9,00000
58.0,35.0,55.0,507,02,01,  Dakshin Kalanigar,48,164,26,76,22,88,22.6,25.5,20.0,00000
58.0,35.0,55.0,551,01,01,  Khagteka,588,144,291,58,297,86,80.3,83.4,77.5,00000
58.0,35.0,55.0,551,02,01,  Taltala,146,150,70,73,76,77,49.3,49.0,49.7,00000
58.0,35.0,55.0,963,01,01,  Uttar Bhabanipur,1031,999,541,465,490,534,50.8,53.8,47.9,00000
58.0,35.0,55.0,963,02,01,  Bhabanipur Bazar,576,234,304,116,272,118,71.1,72.4,69.7,00000
58.0,35.0,67.0,095,01,01,  Bara Dhamai,1679,811,761,377,918,434,67.4,66.9,67.9,00000
58.0,35.0,67.0,095,02,01,  Choto Dhamai,896,187,439,45,457,142,82.7,90.7,76.3,00000
58.0,35.0,67.0,788,01,01,  Mali Para,65,171,43,79,22,92,27.5,35.2,19.3,00000
58.0,35.0,67.0,788,02,01,  Shikari Basti,198,174,124,63,74,111,53.2,66.3,40.0,00000
58.0,35.0,67.0,788,03,01,  P.Bara Dhamai,561,260,274,126,287,134,68.3,68.5,68.2,00000
58.0,35.0,67.0,788,04,01,  Gurangobasti,117,70,70,18,47,52,62.6,79.5,47.5,00000
58.0,35.0,67.0,887,01,01,  Sonarupa T.G.,1422,1012,875,371,547,641,58.4,70.2,46.0,00000
58.0,35.0,67.0,887,02,01,  Sukubasti,122,78,78,20,44,58,61.0,79.6,43.1,00000
58.0,35.0,83.0,362,01,01,  Babusingaon,645,509,312,233,333,276,55.9,57.2,54.7,00000
58.0,35.0,83.0,362,02,01,  Purba Bara Dohar,124,102,52,49,72,53,54.9,51.5,57.6,00000
58.0,35.0,83.0,362,03,01,  Dakshin Bara Dohar,638,650,303,330,335,320,49.5,47.9,51.1,00000
58.0,35.0,83.0,362,04,01,  Uttar Bara Dohar,780,1064,352,535,428,529,42.3,39.7,44.7,00000
58.0,35.0,83.0,362,05,01,  Jangalia,714,776,330,384,384,392,47.9,46.2,49.5,00000
58.0,35.0,83.0,471,01,01,  Kapna Pahar T.E.,1074,1688,662,760,412,928,38.9,46.6,30.7,00000
58.0,35.0,83.0,471,02,01,  Birgugali,122,331,63,174,59,157,26.9,26.6,27.3,00000
58.0,56.0,17.0,264,01,01,  Bhanu Bil,653,686,341,311,312,375,48.8,52.3,45.4,00000
58.0,56.0,17.0,264,02,01,  Uttargaon,515,362,282,135,233,227,58.7,67.6,50.7,00000
58.0,56.0,17.0,264,03,01,  Majhergaon,157,96,89,22,68,74,62.1,80.2,47.9,00000
58.0,56.0,17.0,264,04,01,  Songaon,361,499,191,216,170,283,42.0,46.9,37.5,00000
58.0,56.0,17.0,413,01,01,  Adkani,1256,1660,623,792,633,868,43.1,44.0,42.2,00000
58.0,56.0,17.0,413,02,01,  Purba Jalalpur,987,1169,503,573,484,596,45.8,46.7,44.8,00000
58.0,56.0,17.0,413,03,01,  Paschim Jalalpur,220,121,114,44,106,77,64.5,72.2,57.9,00000
58.0,56.0,17.0,413,04,01,  Jalalpur,621,624,298,277,323,347,49.9,51.8,48.2,00000
58.0,56.0,17.0,484,01,01,  Konagaon,717,378,378,152,339,226,65.5,71.3,60.0,00000
58.0,56.0,17.0,484,02,01,  Kouargola,390,490,202,222,188,268,44.3,47.6,41.2,00000
58.0,56.0,17.0,554,01,01,  Bangaon,331,434,156,212,175,222,43.3,42.4,44.1,00000
58.0,56.0,17.0,554,02,01,  Madhyabhag,690,1044,328,503,362,541,39.8,39.5,40.1,00000
58.0,56.0,17.0,950,01,01,  Tilakpur,440,341,225,136,215,205,56.3,62.3,51.2,00000
58.0,56.0,17.0,950,02,01,  Homerjani,488,350,259,150,229,200,58.2,63.3,53.4,00000
58.0,56.0,17.0,950,03,01,  Ghoramara,610,381,304,146,306,235,61.6,67.6,56.6,00000
58.0,56.0,17.0,950,04,01,  Kandigaon,523,358,265,119,258,239,59.4,69.0,51.9,00000
58.0,56.0,17.0,950,05,01,  Tantetaigaon,607,229,334,88,273,141,72.6,79.1,65.9,00000
58.0,56.0,17.0,950,06,01,  Nayapatan,220,123,114,49,106,74,64.1,69.9,58.9,00000
58.0,56.0,17.0,950,07,01,  Bandar Gaon,231,97,123,33,108,64,70.4,78.8,62.8,00000
58.0,56.0,17.0,968,01,01,  Nayagaon,52,42,25,17,27,25,55.3,59.5,51.9,00000
58.0,56.0,17.0,968,02,01,  Uttarbhag,1040,791,521,365,519,426,56.8,58.8,54.9,00000
58.0,56.0,17.0,968,03,01,  Kewalighat,161,140,86,60,75,80,53.5,58.9,48.4,00000
58.0,56.0,17.0,968,04,01,  Hoktiarkhola,204,74,121,10,83,64,73.4,92.4,56.5,00000
58.0,56.0,19.0,017,01,01,  Khamarchhara Panpanji,178,116,91,52,87,64,60.5,63.6,57.6,00000
58.0,56.0,19.0,017,02,01,  Khamarchhara T.G.,183,419,122,191,61,228,30.4,39.0,21.1,00000
58.0,56.0,19.0,026,01,01,  Alinagar T.G.,1939,2167,1168,899,771,1268,47.2,56.5,37.8,00000
58.0,56.0,19.0,026,02,01,  Alinagar Basti,85,224,54,97,31,127,27.5,35.8,19.6,00000
58.0,56.0,19.0,281,01,01,  Moturapur,143,108,74,49,69,59,57.0,60.2,53.9,00000
58.0,56.0,19.0,281,02,01,  Gokulnagar,312,212,154,89,158,123,59.5,63.4,56.2,00000
58.0,56.0,19.0,308,01,01,  Kamudpur,862,976,417,476,445,500,46.9,46.7,47.1,00000
58.0,56.0,19.0,308,02,01,  Gobindapur,134,222,69,112,65,110,37.6,38.1,37.1,00000
58.0,56.0,19.0,783,01,01,  Rameshwarpur,465,291,230,121,235,170,61.5,65.5,58.0,00000
58.0,56.0,19.0,783,02,01,  Mangalpur,191,124,100,47,91,77,60.6,68.0,54.2,00000
58.0,56.0,19.0,906,01,01,  Sreenathpur,905,845,442,423,463,422,51.7,51.1,52.3,00000
58.0,56.0,19.0,906,02,01,  Barampur,127,319,63,140,64,179,28.5,31.0,26.3,00000
58.0,56.0,19.0,906,03,01,  Jogi Bil,1052,1061,529,470,523,591,49.8,53.0,46.9,00000
58.0,56.0,19.0,950,01,01,  Fultali,123,54,71,22,52,32,69.5,76.3,61.9,00000
58.0,56.0,19.0,950,02,01,  Tilakpur,685,180,358,50,327,130,79.2,87.7,71.6,00000
58.0,56.0,19.0,959,01,01,  Sunchharat.G.,487,554,278,224,209,330,46.8,55.4,38.8,00000
58.0,56.0,19.0,959,02,01,  Chitalia,1808,1999,908,947,900,1052,47.5,48.9,46.1,00000
58.0,56.0,28.0,158,01,01,  Sharisha Bil,31,183,17,88,14,95,14.5,16.2,12.8,00000
58.0,56.0,28.0,158,02,01,  Sona Roy,240,431,146,195,94,236,35.8,42.8,28.5,00000
58.0,56.0,28.0,158,03,01,  Kalaban,64,137,35,63,29,74,31.8,35.7,28.2,00000
58.0,56.0,28.0,158,04,01,  Sushamanagar,16,56,11,24,5,32,22.2,31.4,13.5,00000
58.0,56.0,28.0,158,05,01,  Champa Roy,800,1137,493,475,307,662,41.3,50.9,31.7,00000
58.0,56.0,28.0,334,01,01,  Kurmaghat,155,185,91,99,64,86,45.6,47.9,42.7,00000
58.0,56.0,28.0,334,02,01,  Dakshin Guler Haor,442,698,205,332,237,366,38.8,38.2,39.3,00000
58.0,56.0,28.0,334,03,01,  Uttar Guler Haor,206,233,111,95,95,138,46.9,53.9,40.8,00000
58.0,56.0,28.0,334,04,01,  Bhadragaon,173,61,89,17,84,44,73.9,84.0,65.6,00000
58.0,56.0,28.0,334,05,01,  Tilagaon,472,509,245,269,227,240,48.1,47.7,48.6,00000
58.0,56.0,28.0,369,01,01,  Rajkandi,224,565,106,275,118,290,28.4,27.8,28.9,00000
58.0,56.0,28.0,369,02,01,  Kanaideshi,1732,2863,834,1355,898,1508,37.7,38.1,37.3,00000
58.0,56.0,28.0,369,03,01,  Patharigaon,67,21,34,4,33,17,76.1,89.5,66.0,00000
58.0,56.0,28.0,466,01,01,  Uttar Kanthalkandi,309,271,178,117,131,154,53.3,60.3,46.0,00000
58.0,56.0,28.0,466,02,01,  Dakshin Kanthalkandi,467,577,220,285,247,292,44.7,43.6,45.8,00000
58.0,56.0,28.0,507,01,01,  Kurma (Itkhola),91,41,46,19,45,22,68.9,70.8,67.2,00000
58.0,56.0,28.0,507,02,01,  Kurmati,1716,1301,1010,505,706,796,56.9,66.7,47.0,00000
58.0,56.0,28.0,507,03,01,  Kurunjee,329,415,199,181,130,234,44.2,52.4,35.7,00000
58.0,56.0,28.0,507,04,01,  Kashiabari,44,38,18,17,26,21,53.7,51.4,55.3,00000
58.0,56.0,28.0,915,01,01,  Bhandarigaon,125,78,65,32,60,46,61.6,67.0,56.6,00000
58.0,56.0,28.0,915,02,01,  Sreepur,609,848,316,400,293,448,41.8,44.1,39.5,00000
58.0,56.0,28.0,915,03,01,  Konagaon,236,275,122,129,114,146,46.2,48.6,43.8,00000
58.0,56.0,28.0,915,04,01,  Ganganagar,109,71,61,24,48,47,60.6,71.8,50.5,00000
58.0,56.0,28.0,989,01,01,  Noagaon,81,77,35,32,46,45,51.3,52.2,50.5,00000
58.0,56.0,28.0,989,02,01,  Saughar,295,393,160,177,135,216,42.9,47.5,38.5,00000
58.0,56.0,38.0,008,01,03,  Tilakipur,763,525,387,229,376,296,59.2,62.8,56.0,00000
58.0,56.0,38.0,008,02,03,  Jamirkona,95,387,39,199,56,188,19.7,16.4,23.0,00000
58.0,56.0,38.0,035,01,01,  Bade Ubahata,600,534,278,249,322,285,52.9,52.8,53.0,00000
58.0,56.0,38.0,035,02,01,  Charia,81,110,39,49,42,61,42.4,44.3,40.8,00000
58.0,56.0,38.0,343,01,01,  Sharaibari,545,637,270,317,275,320,46.1,46.0,46.2,00000
58.0,56.0,38.0,343,02,01,  Kalachhara,37,74,21,30,16,44,33.3,41.2,26.7,00000
58.0,56.0,38.0,343,03,01,  Koratia,27,32,14,17,13,15,45.8,45.2,46.4,00000
58.0,56.0,38.0,501,01,03,  Rajtila,498,335,259,140,239,195,59.8,64.9,55.1,00000
58.0,56.0,38.0,501,02,03,  Mokamtila,365,325,181,154,184,171,52.9,54.0,51.8,00000
58.0,56.0,38.0,501,03,03,  Baghmara,447,908,227,415,220,493,33.0,35.4,30.9,00000
58.0,56.0,38.0,501,04,03,  Magur Sarapan Punji,164,11,82,6,82,5,93.7,93.2,94.3,00000
58.0,56.0,38.0,501,05,03,  Bali Gaon,1311,1009,661,436,650,573,56.5,60.3,53.1,00000
58.0,56.0,38.0,501,06,03,  Lungurpar,332,211,183,102,149,109,61.1,64.2,57.8,00000
58.0,56.0,38.0,501,07,03,  Uzir Pur Razar Gaon,267,212,138,106,129,106,55.7,56.6,54.9,00000
58.0,56.0,38.0,501,08,03,  Ballar Par,246,288,124,125,122,163,46.1,49.8,42.8,00000
58.0,56.0,38.0,501,09,03,  Wes Komra Kapan,219,81,110,40,109,41,73.0,73.3,72.7,00000
58.0,56.0,38.0,792,01,03,  Rampasha(Vera Chara),303,584,125,282,178,302,34.2,30.7,37.1,00000
58.0,56.0,38.0,792,02,03,  Chatakchara,265,131,142,64,123,67,66.9,68.9,64.7,00000
58.0,56.0,38.0,792,03,03,  Bongaon,212,245,99,127,113,118,46.4,43.8,48.9,00000
58.0,56.0,38.0,792,04,03,  Kandigaon,78,263,40,134,38,129,22.9,23.0,22.8,00000
58.0,56.0,38.0,810,01,01,  Rampur,134,78,63,38,71,40,63.2,62.4,64.0,00000
58.0,56.0,38.0,810,02,01,  Gandamara,114,74,54,40,60,34,60.6,57.4,63.8,00000
58.0,56.0,47.0,361,01,01,  Baghbari,158,89,90,26,68,63,64.0,77.6,51.9,00000
58.0,56.0,47.0,361,02,01,  Parua Bil,115,261,71,129,44,132,30.6,35.5,25.0,00000
58.0,56.0,47.0,361,03,01,  Gokulsing,96,64,51,20,45,44,60.0,71.8,50.6,00000
58.0,56.0,47.0,361,04,01,  Soychhari,253,381,120,176,133,205,39.9,40.5,39.3,00000
58.0,56.0,47.0,361,05,01,  Hiramati,259,179,133,69,126,110,59.1,65.8,53.4,00000
58.0,56.0,47.0,361,06,01,  Madhappur Bazar,288,125,160,51,128,74,69.7,75.8,63.4,00000
58.0,56.0,47.0,537,01,01,  Langurpar,423,340,221,166,202,174,55.4,57.1,53.7,00000
58.0,56.0,47.0,537,02,01,  Telagaon,189,154,90,75,99,79,55.1,54.5,55.6,00000
58.0,56.0,47.0,537,03,01,  Bhandarigaon,233,90,128,40,105,50,72.1,76.2,67.7,00000
58.0,56.0,47.0,537,04,01,  Dalairpar,533,420,265,205,268,215,55.9,56.4,55.5,00000
58.0,56.0,47.0,537,05,01,  Bhashanigaon,623,519,321,241,302,278,54.6,57.1,52.1,00000
58.0,56.0,47.0,537,06,01,  Bangaon,179,156,97,63,82,93,53.4,60.6,46.9,00000
58.0,56.0,47.0,537,07,01,  Shimultala,111,109,52,50,59,59,50.5,51.0,50.0,00000
58.0,56.0,47.0,537,08,01,  Bamangaon,82,12,47,1,35,11,87.2,97.9,76.1,00000
58.0,56.0,47.0,537,09,01,  Majhergaon,270,151,133,58,137,93,64.1,69.6,59.6,00000
58.0,56.0,47.0,537,10,01,  Japerpar,85,89,52,41,33,48,48.9,55.9,40.7,00000
58.0,56.0,47.0,537,11,01,  Badlergaon,188,42,110,8,78,34,81.7,93.2,69.6,00000
58.0,56.0,47.0,537,12,01,  Gobindabari,93,12,48,1,45,11,88.6,98.0,80.4,00000
58.0,56.0,47.0,537,13,01,  Sukur Ullahgaon (Bangaon),159,253,86,121,73,132,38.6,41.5,35.6,00000
58.0,56.0,47.0,537,14,01,  Joblarpar,76,35,40,12,36,23,68.5,76.9,61.0,00000
58.0,56.0,47.0,537,15,01,  Nayagaon,522,250,269,126,253,124,67.6,68.1,67.1,00000
58.0,56.0,47.0,545,01,01,  Madhabpur T.G.,1155,1423,663,616,492,807,44.8,51.8,37.9,00000
58.0,56.0,47.0,545,02,01,  Padmachhara,186,827,111,394,75,433,18.4,22.0,14.8,00000
58.0,56.0,47.0,713,01,01,  Patroki Tola T.G.,2283,3313,1295,1495,988,1818,40.8,46.4,35.2,00000
58.0,56.0,47.0,713,02,01,  Sreegobindapur T.G.,381,685,232,293,149,392,35.7,44.2,27.5,00000
58.0,56.0,47.0,968,01,01,  Majherchhara,89,256,58,118,31,138,25.8,33.0,18.3,00000
58.0,56.0,47.0,968,02,01,  Puranbari,184,181,101,92,83,89,50.4,52.3,48.3,00000
58.0,56.0,47.0,968,03,01,  Khanchipan Punji,34,17,19,10,15,7,66.7,65.5,68.2,00000
58.0,56.0,47.0,968,04,01,  Bazlu Bhag T.G.Nasirabad,1,0,1,0,0,0,100.0,100.0,0.0,00000
58.0,56.0,57.0,088,01,01,  Basudebpur,205,406,105,202,100,204,33.6,34.2,32.9,00000
58.0,56.0,57.0,088,02,01,  Bade Karimpur,62,123,28,59,34,64,33.5,32.2,34.7,00000
58.0,56.0,57.0,184,01,01,  Dakshin Ramchandrapur,254,567,117,282,137,285,30.9,29.3,32.5,00000
58.0,56.0,57.0,184,02,01,  Narayan Ketra,165,321,80,170,85,151,34.0,32.0,36.0,00000
58.0,56.0,57.0,572,01,01,  Maidail,355,428,187,192,168,236,45.3,49.3,41.6,00000
58.0,56.0,57.0,572,02,01,  Jalalpurr,138,268,64,133,74,135,34.0,32.5,35.4,00000
58.0,56.0,57.0,736,01,01,  Munshi Bazar,187,208,104,137,83,71,47.3,43.2,53.9,00000
58.0,56.0,57.0,736,02,01,  Harishwran,263,558,134,258,129,300,32.0,34.2,30.1,00000
58.0,56.0,57.0,801,01,01,  Rampur,195,247,93,132,102,115,44.1,41.3,47.0,00000
58.0,56.0,57.0,801,02,01,  Roynagar,118,100,60,51,58,49,54.1,54.1,54.2,00000
58.0,56.0,66.0,132,01,01,  Niz Brindabanpur,105,47,59,22,46,25,69.1,72.8,64.8,00000
58.0,56.0,66.0,132,02,01,  Gopinagar,371,199,166,92,205,107,65.1,64.3,65.7,00000
58.0,56.0,66.0,132,03,01,  Radhagobinadapur,129,73,61,33,68,40,63.9,64.9,63.0,00000
58.0,56.0,66.0,132,04,01,  Kandigaon,104,192,44,93,60,99,35.1,32.1,37.7,00000
58.0,56.0,66.0,132,05,01,  Nayanagar,228,207,112,100,116,107,52.4,52.8,52.0,00000
58.0,56.0,66.0,132,06,01,  Majhgaon,118,246,50,116,68,130,32.4,30.1,34.3,00000
58.0,56.0,66.0,132,07,01,  Konagaon,167,339,70,175,97,164,33.0,28.6,37.2,00000
58.0,56.0,66.0,132,08,01,  Palitkona,258,346,120,167,138,179,42.7,41.8,43.5,00000
58.0,56.0,66.0,132,09,01,  Nondagram,186,231,67,118,119,113,44.6,36.2,51.3,00000
58.0,56.0,66.0,132,10,01,  Bairagir Chak,217,56,111,25,106,31,79.5,81.6,77.4,00000
58.0,56.0,66.0,167,01,01,  Chandpur,84,85,32,38,52,47,49.7,45.7,52.5,00000
58.0,56.0,66.0,167,02,01,  Jagannathpur,508,365,244,164,264,201,58.2,59.8,56.8,00000
58.0,56.0,66.0,299,01,01,  Gobindapur,256,247,117,115,139,132,50.9,50.4,51.3,00000
58.0,56.0,66.0,299,02,01,  Dargahpur,66,47,34,21,32,26,58.4,61.8,55.2,00000
58.0,56.0,66.0,519,01,01,  Lakshmipur,197,200,93,101,104,99,49.6,47.9,51.2,00000
58.0,56.0,66.0,519,02,01,  Laksmi,114,73,61,29,53,44,61.0,67.8,54.6,00000
58.0,56.0,66.0,581,01,01,  Mansurpur,273,64,144,26,129,38,81.0,84.7,77.2,00000
58.0,56.0,66.0,581,02,01,  Afsalgati,57,34,27,14,30,20,62.6,65.9,60.0,00000
58.0,56.0,66.0,607,01,01,  Mirzapur,86,66,41,23,45,43,56.6,64.1,51.1,00000
58.0,56.0,66.0,607,02,01,  Sreematpur,107,57,46,25,61,32,65.2,64.8,65.6,00000
58.0,56.0,66.0,607,03,01,  Anantapur,50,34,22,17,28,17,59.5,56.4,62.2,00000
58.0,56.0,66.0,607,04,01,  Minaroy,75,52,32,22,43,30,59.1,59.3,58.9,00000
58.0,56.0,66.0,607,05,01,  Dakshin Palki,69,58,25,26,44,32,54.3,49.0,57.9,00000
58.0,56.0,66.0,607,06,01,  Ramchandrapur,58,36,28,14,30,22,61.7,66.7,57.7,00000
58.0,56.0,66.0,607,07,01,  Brahmansher,98,69,43,26,55,43,58.7,62.3,56.1,00000
58.0,56.0,66.0,889,01,01,  Sonargaon,131,45,66,27,65,18,74.4,71.0,78.3,00000
58.0,56.0,66.0,889,02,01,  Balarampur,485,218,290,100,195,118,69.0,74.4,62.3,00000
58.0,56.0,66.0,933,01,01,  Gounjerkandi,104,95,47,40,57,55,52.3,54.0,50.9,00000
58.0,56.0,66.0,933,02,01,  Sreesurja,1134,307,542,146,592,161,78.7,78.8,78.6,00000
58.0,56.0,66.0,933,03,01,  Tilaghar,483,127,240,50,243,77,79.2,82.8,75.9,00000
58.0,56.0,66.0,933,04,01,  Baidyanathpur,116,284,48,148,68,136,29.0,24.5,33.3,00000
58.0,56.0,66.0,933,05,01,  Nayagaon,316,440,165,196,151,244,41.8,45.7,38.2,00000
58.0,56.0,66.0,933,06,01,  Dupatila,444,519,196,240,248,279,46.1,45.0,47.1,00000
58.0,56.0,66.0,933,07,01,  Khabiraji,117,159,55,71,62,88,42.4,43.7,41.3,00000
58.0,56.0,66.0,933,08,01,  Paku Para,86,144,45,58,41,86,37.4,43.7,32.3,00000
58.0,56.0,66.0,933,09,01,  Halabadi,71,39,38,14,33,25,64.5,73.1,56.9,00000
58.0,56.0,66.0,933,10,01,  Chak Kabiraji,195,187,95,85,100,102,51.0,52.8,49.5,00000
58.0,56.0,76.0,149,01,01,  Chaitraghat,250,185,120,119,130,66,57.5,50.2,66.3,00000
58.0,56.0,76.0,149,02,01,  Hamidia T.E.,0,24,0,10,0,14,0.0,0.0,0.0,00000
58.0,56.0,76.0,228,01,01,  Deorachhara T.E.,1080,1271,647,544,433,727,45.9,54.3,37.3,00000
58.0,56.0,76.0,228,02,01,  Kalenga,2612,3670,1387,1738,1225,1932,41.6,44.4,38.8,00000
58.0,56.0,76.0,510,01,01,  Lakshmipur,186,248,105,116,81,132,42.9,47.5,38.0,00000
58.0,56.0,76.0,510,02,01,  Sreeghar,143,338,69,173,74,165,29.7,28.5,31.0,00000
58.0,56.0,85.0,096,01,01,  Badar Deul(Northzeast),2096,1457,1024,689,1072,768,59.0,59.8,58.3,00000
58.0,56.0,85.0,096,02,01,  Kachuliti,543,485,254,235,289,250,52.8,51.9,53.6,00000
58.0,56.0,85.0,193,01,01,  Bara Chak,831,360,425,162,406,198,69.8,72.4,67.2,00000
58.0,56.0,85.0,193,02,01,  Singrauli,1626,1179,804,531,822,648,58.0,60.2,55.9,00000
58.0,56.0,85.0,302,01,01,  Gobindapur,386,152,193,61,193,91,71.7,76.0,68.0,00000
58.0,56.0,85.0,302,02,01,  Sangkarpur,180,52,88,26,92,26,77.6,77.2,78.0,00000
58.0,56.0,85.0,302,03,01,  Ghoshpur,230,58,111,24,119,34,79.9,82.2,77.8,00000
58.0,56.0,85.0,352,01,01,  Satijergram,648,964,332,464,316,500,40.2,41.7,38.7,00000
58.0,56.0,85.0,352,02,01,  Hajinagar,151,61,75,26,76,35,71.2,74.3,68.5,00000
58.0,56.0,85.0,493,01,01,  Krishnapur,438,218,200,97,238,121,66.8,67.3,66.3,00000
58.0,56.0,85.0,493,02,01,  Baidyanathpur,32,13,13,10,19,3,71.1,56.5,86.4,00000
58.0,56.0,85.0,493,03,01,  Haripur,112,114,49,55,63,59,49.6,47.1,51.6,00000
58.0,56.0,85.0,493,04,01,  Bharatpur,127,50,52,21,75,29,71.8,71.2,72.1,00000
58.0,56.0,85.0,493,05,01,  Raghunathpur,189,201,93,99,96,102,48.5,48.4,48.5,00000
58.0,56.0,85.0,493,06,01,  Narsingapur,194,80,101,33,93,47,70.8,75.4,66.4,00000
58.0,56.0,85.0,730,01,01,  Radhanagar,516,1152,242,553,274,599,30.9,30.4,31.4,00000
58.0,56.0,85.0,730,02,01,  Nityanandapur,134,76,65,36,69,40,63.8,64.4,63.3,00000
58.0,56.0,85.0,730,03,01,  Marajhanerpar,191,256,93,122,98,134,42.7,43.3,42.2,00000
58.0,56.0,85.0,845,01,01,  Samshernagar Bazar,1508,745,774,329,734,416,66.9,70.2,63.8,00000
58.0,56.0,85.0,845,02,01,  Samshernagar T.G.,2189,2945,1231,1297,958,1648,42.6,48.7,36.8,00000
58.0,56.0,85.0,845,03,01,  Deyachhara (Kanihatit.G),753,1565,460,703,293,862,32.5,39.6,25.4,00000
58.0,56.0,85.0,845,04,01,  Sonechhara (Daublechhara T.G),325,1154,223,569,102,585,22.0,28.2,14.8,00000
58.0,56.0,85.0,880,01,01,  Sonapur,267,105,130,37,137,68,71.8,77.8,66.8,00000
58.0,56.0,85.0,880,02,01,  Sarongpur,108,68,47,32,61,36,61.4,59.5,62.9,00000
58.0,65.0,10.0,523,01,01,  Jalalpur,240,137,115,68,125,69,63.7,62.8,64.4,00000
58.0,65.0,10.0,523,02,01,  Madangauri,327,295,148,135,179,160,52.6,52.3,52.8,00000
58.0,65.0,10.0,523,03,01,  Maheshgauri,377,459,184,207,193,252,45.1,47.1,43.4,00000
58.0,65.0,10.0,523,04,01,  Gaurkaran,430,266,197,124,233,142,61.8,61.4,62.1,00000
58.0,65.0,10.0,523,05,01,  Korbanpur,410,549,168,263,242,286,42.8,39.0,45.8,00000
58.0,65.0,10.0,523,06,01,  Nabipur,49,36,17,20,32,16,57.6,45.9,66.7,00000
58.0,65.0,10.0,655,01,01,  Shadipur,716,1366,317,666,399,700,34.4,32.2,36.3,00000
58.0,65.0,10.0,655,02,01,  Mirsankar,710,725,337,350,373,375,49.5,49.1,49.9,00000
58.0,65.0,10.0,678,01,01,  Moktajipur,418,521,180,251,238,270,44.5,41.8,46.9,00000
58.0,65.0,10.0,678,02,01,  Jabda,559,503,244,243,315,260,52.6,50.1,54.8,00000
58.0,65.0,10.0,678,03,01,  Khalesar,291,372,114,203,177,169,43.9,36.0,51.2,00000
58.0,65.0,10.0,678,04,01,  Chilarkandi,363,311,175,153,188,158,53.9,53.4,54.3,00000
58.0,65.0,10.0,678,05,01,  Bhukshimail,2118,1392,1003,651,1115,741,60.3,60.6,60.1,00000
58.0,65.0,10.0,678,06,01,  Bade Bhukshimail,1129,1104,512,528,617,576,50.6,49.2,51.7,00000
58.0,65.0,10.0,810,01,01,  Khanehath,379,316,184,153,195,163,54.5,54.6,54.5,00000
58.0,65.0,10.0,810,02,01,  Baradal,369,484,161,244,208,240,43.3,39.8,46.4,00000
58.0,65.0,10.0,931,01,01,  Shasharkandi,417,455,180,213,237,242,47.8,45.8,49.5,00000
58.0,65.0,10.0,931,02,01,  Bade Bhukshimail (Lamapara),224,253,96,114,128,139,47.0,45.7,47.9,00000
58.0,65.0,11.0,379,01,01,  Ichhlachhara Panpunji,135,77,78,43,57,34,63.7,64.5,62.6,00000
58.0,65.0,11.0,379,02,01,  Sing Gurpanpunji,116,68,68,34,48,34,63.0,66.7,58.5,00000
58.0,65.0,11.0,379,03,01,  Nandannagar(Mission),88,15,43,8,45,7,85.4,84.3,86.5,00000
58.0,65.0,11.0,437,01,01,  Nandanagar(Tikra),413,144,204,70,209,74,74.1,74.5,73.9,00000
58.0,65.0,11.0,437,02,01,  Nandanagar(Akilpur),264,491,115,243,149,248,35.0,32.1,37.5,00000
58.0,65.0,11.0,437,03,01,  Mohlal,89,18,39,8,50,10,83.2,83.0,83.3,00000
58.0,65.0,11.0,437,04,01,  Station,80,9,69,5,11,4,89.9,93.2,73.3,00000
58.0,65.0,11.0,437,05,01,  Nandannagar (Bhutiura),60,57,28,30,32,27,51.3,48.3,54.2,00000
58.0,65.0,11.0,437,06,01,  Nandannagar (Islamabad),420,370,195,186,225,184,53.2,51.2,55.0,00000
58.0,65.0,11.0,437,07,01,  Nandannagar (Lamapara),137,41,72,15,65,26,77.0,82.8,71.4,00000
58.0,65.0,11.0,437,08,01,  Nandannagar (Khadimpara),375,282,178,137,197,145,57.1,56.5,57.6,00000
58.0,65.0,11.0,437,09,01,  Nandannagar (Dholipara),66,81,33,46,33,35,44.9,41.8,48.5,00000
58.0,65.0,11.0,437,10,01,  Nandannagar (Chandrakhola),145,58,81,26,64,32,71.4,75.7,66.7,00000
58.0,65.0,11.0,437,11,01,  Nandannagar (Islamabad Dakshin,133,93,65,39,68,54,58.8,62.5,55.7,00000
58.0,65.0,11.0,437,12,01,  Nandannagar (Kaliarghar),100,98,49,56,51,42,50.5,46.7,54.8,00000
58.0,65.0,11.0,437,13,01,  Nandannagar Uttar,57,33,28,16,29,17,63.3,63.6,63.0,00000
58.0,65.0,11.0,437,14,01,  Nandannagar Uttar (Jalalpur),50,6,25,3,25,3,89.3,89.3,89.3,00000
58.0,65.0,11.0,437,15,01,  Nandannagar Uttar(Konagaon),96,64,50,32,46,32,60.0,61.0,59.0,00000
58.0,65.0,11.0,437,16,01,  Nandannagar Uttar(Lamapara),40,66,20,30,20,36,37.7,40.0,35.7,00000
58.0,65.0,11.0,437,17,01,  Nandannagar Uttar (Musepur),68,15,32,2,36,13,81.9,94.1,73.5,00000
58.0,65.0,11.0,437,18,01,  Nandannagar Uttar (Birimepur),125,47,49,23,76,24,72.7,68.1,76.0,00000
58.0,65.0,11.0,437,19,01,  Rafinagar,174,97,98,40,76,57,64.2,71.0,57.1,00000
58.0,65.0,11.0,437,20,01,  Dakshin Rauthgaon (Madhabpur),343,106,153,47,190,59,76.4,76.5,76.3,00000
58.0,65.0,11.0,437,21,01,  Dakshin Rauthgaon (Lamapara),74,83,41,38,33,45,47.1,51.9,42.3,00000
58.0,65.0,11.0,437,22,01,  Dakshin Rauthgaon (Ujanpara),444,171,210,71,234,100,72.2,74.7,70.1,00000
58.0,65.0,11.0,437,23,01,  Dakshin Rauthgaon (Morujpur),110,38,56,21,54,17,74.3,72.7,76.1,00000
58.0,65.0,11.0,868,01,01,  Itakhola (Part),206,214,105,106,101,108,49.0,49.8,48.3,00000
58.0,65.0,11.0,868,02,01,  Rauthgaon Uttar (Mazipara),74,150,31,72,43,78,33.0,30.1,35.5,00000
58.0,65.0,11.0,868,03,01,  Rauthgaon Uttar (Pathanpara),42,27,18,12,24,15,60.9,60.0,61.5,00000
58.0,65.0,11.0,868,04,01,  Rauthgaon Uttar,376,306,175,139,201,167,55.1,55.7,54.6,00000
58.0,65.0,11.0,868,05,01,  Ali Nagar,591,811,334,373,257,438,42.2,47.2,37.0,00000
58.0,65.0,11.0,868,06,01,  Rauthgaon Uttar (Uttar Bhag),204,233,91,113,113,120,46.7,44.6,48.5,00000
58.0,65.0,11.0,868,07,01,  Rauthgaon Uttar (Akramnagar),300,222,133,114,167,108,57.5,53.8,60.7,00000
58.0,65.0,11.0,868,08,01,  Dakshin Rauthgaon Ujanpara,126,91,60,45,66,46,58.1,57.1,58.9,00000
58.0,65.0,11.0,868,09,01,  Dakshin Rauthgaon Fakir Para,123,48,63,20,60,28,71.9,75.9,68.2,00000
58.0,65.0,11.0,868,10,01,  Alinagar (Usmanpur),421,181,207,75,214,106,69.9,73.4,66.9,00000
58.0,65.0,11.0,954,01,01,  Purba Singur,177,124,87,60,90,64,58.8,59.2,58.4,00000
58.0,65.0,11.0,954,02,01,  Singur,170,54,74,23,96,31,75.9,76.3,75.6,00000
58.0,65.0,11.0,954,03,01,  Paschim Singur,321,136,169,67,152,69,70.2,71.6,68.8,00000
58.0,65.0,11.0,954,04,01,  Singur Grazing,204,393,121,184,83,209,34.2,39.7,28.4,00000
58.0,65.0,13.0,046,01,01,  Berkuri,120,217,55,102,65,115,35.6,35.0,36.1,00000
58.0,65.0,13.0,046,02,01,  Bhabanipur,287,207,135,97,152,110,58.1,58.2,58.0,00000
58.0,65.0,13.0,046,03,01,  Dakshinbagh,299,384,133,192,166,192,43.8,40.9,46.4,00000
58.0,65.0,13.0,046,04,01,  Tulapur,236,171,109,80,127,91,58.0,57.7,58.3,00000
58.0,65.0,13.0,046,05,01,  Deulkapon,191,130,78,64,113,66,59.5,54.9,63.1,00000
58.0,65.0,13.0,350,01,01,  Khatgaon,110,77,56,33,54,44,58.8,62.9,55.1,00000
58.0,65.0,13.0,350,02,01,  Baragaon,209,140,103,69,106,71,59.9,59.9,59.9,00000
58.0,65.0,13.0,350,03,01,  Merabhuion,264,301,123,146,141,155,46.7,45.7,47.6,00000
58.0,65.0,13.0,350,04,01,  Barammateka,73,109,33,59,40,50,40.1,35.9,44.4,00000
58.0,65.0,13.0,350,05,01,  Hosenpur,216,156,107,65,109,91,58.1,62.2,54.5,00000
58.0,65.0,13.0,460,01,01,  Kalimabad (Part),429,474,209,222,220,252,47.5,48.5,46.6,00000
58.0,65.0,13.0,460,02,01,  Rabar Bagan,119,26,87,10,32,16,82.1,89.7,66.7,00000
58.0,65.0,13.0,816,01,01,  Radhanagar,334,226,152,107,182,119,59.6,58.7,60.5,00000
58.0,65.0,13.0,816,02,01,  Kharparar,430,312,213,152,217,160,58.0,58.4,57.6,00000
58.0,65.0,13.0,868,01,01,  Haripur,169,67,78,29,91,38,71.6,72.9,70.5,00000
58.0,65.0,13.0,868,02,01,  Karaitala,149,79,67,45,82,34,65.4,59.8,70.7,00000
58.0,65.0,13.0,874,01,01,  Shahamir,135,96,61,50,74,46,58.4,55.0,61.7,00000
58.0,65.0,13.0,874,02,01,  Khamaura,139,237,51,117,88,120,37.0,30.4,42.3,00000
58.0,65.0,17.0,339,01,01,  Manoharpur,146,75,71,35,75,40,66.1,67.0,65.2,00000
58.0,65.0,17.0,339,02,01,  Noagaon,89,62,41,28,48,34,58.9,59.4,58.5,00000
58.0,65.0,17.0,339,03,01,  Palokona,203,46,97,18,106,28,81.5,84.3,79.1,00000
58.0,65.0,17.0,339,04,01,  Khumia,312,100,146,37,166,63,75.7,79.8,72.5,00000
58.0,65.0,17.0,339,05,01,  Helapur,351,241,161,129,190,112,59.3,55.5,62.9,00000
58.0,65.0,17.0,339,06,01,  Uttar Hingaljia,487,606,223,290,264,316,44.6,43.5,45.5,00000
58.0,65.0,17.0,339,07,01,  Tilagaon,195,214,94,108,101,106,47.7,46.5,48.8,00000
58.0,65.0,17.0,339,08,01,  Adampur,137,195,66,100,71,95,41.3,39.8,42.8,00000
58.0,65.0,17.0,339,09,01,  Basudebpur,51,43,28,23,23,20,54.3,54.9,53.5,00000
58.0,65.0,17.0,339,10,01,  Madhya Hingaljia,508,613,233,315,275,298,45.3,42.5,48.0,00000
58.0,65.0,17.0,339,11,01,  Dakshin Hingaljia,867,653,416,311,451,342,57.0,57.2,56.9,00000
58.0,65.0,17.0,339,12,01,  Gazipur,323,615,142,317,181,298,34.4,30.9,37.8,00000
58.0,65.0,17.0,339,13,01,  Tatura,24,38,11,20,13,18,38.7,35.5,41.9,00000
58.0,65.0,17.0,339,14,01,  Moka Bil,18,30,7,15,11,15,37.5,31.8,42.3,00000
58.0,65.0,17.0,345,01,01,  Hingajia T.E.,643,1163,357,582,286,581,35.6,38.0,33.0,00000
58.0,65.0,17.0,345,02,01,  Ainachhara Punji,8,20,5,11,3,9,28.6,31.3,25.0,00000
58.0,65.0,17.0,408,01,01,  Harinagar,101,87,56,41,45,46,53.7,57.7,49.5,00000
58.0,65.0,17.0,408,02,01,  Konagaon,181,120,86,64,95,56,60.1,57.3,62.9,00000
58.0,65.0,17.0,408,03,01,  Gobindapur,382,249,176,100,206,149,60.5,63.8,58.0,00000
58.0,65.0,17.0,408,04,01,  Maulvigaon,270,111,136,45,134,66,70.9,75.1,67.0,00000
58.0,65.0,17.0,408,05,01,  Nachni,419,200,206,89,213,111,67.7,69.8,65.7,00000
58.0,65.0,17.0,408,06,01,  Rajapur,286,129,142,55,144,74,68.9,72.1,66.1,00000
58.0,65.0,17.0,408,07,01,  Satra,204,328,77,169,127,159,38.3,31.3,44.4,00000
58.0,65.0,17.0,408,08,01,  Purba Jalalabad,458,168,230,87,228,81,73.2,72.6,73.8,00000
58.0,65.0,17.0,408,09,01,  Paschim Jalalabad,388,293,199,141,189,152,57.0,58.5,55.4,00000
58.0,65.0,17.0,408,10,01,  Mirzapur,830,562,414,286,416,276,59.6,59.1,60.1,00000
58.0,65.0,17.0,408,11,01,  Gurabhui,1503,1221,755,573,748,648,55.2,56.9,53.6,00000
58.0,65.0,17.0,408,12,01,  Brahman Bazar,211,186,109,106,102,80,53.1,50.7,56.0,00000
58.0,65.0,17.0,408,13,01,  Kanopattri,142,75,77,38,65,37,65.4,67.0,63.7,00000
58.0,65.0,17.0,408,14,01,  Islampur,21,8,8,3,13,5,72.4,72.7,72.2,00000
58.0,65.0,17.0,684,01,01,  Chakergram,460,757,192,378,268,379,37.8,33.7,41.4,00000
58.0,65.0,17.0,684,02,01,  Sreepur,151,385,76,186,75,199,28.2,29.0,27.4,00000
58.0,65.0,17.0,684,03,01,  Sherpur,233,79,104,37,129,42,74.7,73.8,75.4,00000
58.0,65.0,17.0,684,04,01,  Daudpur,416,309,199,149,217,160,57.4,57.2,57.6,00000
58.0,65.0,17.0,684,05,01,  Lama Para,221,337,100,161,121,176,39.6,38.3,40.7,00000
58.0,65.0,17.0,684,06,01,  Dakshinpara,214,94,104,45,110,49,69.5,69.8,69.2,00000
58.0,65.0,17.0,684,07,01,  Nasirabad,381,301,176,146,205,155,55.9,54.7,56.9,00000
58.0,65.0,17.0,684,08,01,  Nabinagar,388,469,185,242,203,227,45.3,43.3,47.2,00000
58.0,65.0,35.0,063,01,01,  Uttar Baraigaon,312,60,150,25,162,35,83.9,85.7,82.2,00000
58.0,65.0,35.0,063,02,01,  Dakshin Baraigaon,336,273,162,127,174,146,55.2,56.1,54.4,00000
58.0,65.0,35.0,063,03,01,  Hari Chak,310,45,159,17,151,28,87.3,90.3,84.4,00000
58.0,65.0,35.0,063,04,01,  Uttar Palki,253,72,120,28,133,44,77.8,81.1,75.1,00000
58.0,65.0,35.0,063,05,01,  Fulpur,91,17,49,8,42,9,84.3,86.0,82.4,00000
58.0,65.0,35.0,063,06,01,  Sadanpur,190,71,86,33,104,38,72.8,72.3,73.2,00000
58.0,65.0,35.0,080,01,01,  Basree,103,66,48,35,55,31,60.9,57.8,64.0,00000
58.0,65.0,35.0,080,02,01,  Nayagaon,42,36,26,16,16,20,53.8,61.9,44.4,00000
58.0,65.0,35.0,120,01,01,  Bhuigaon,610,918,323,448,287,470,39.9,41.9,37.9,00000
58.0,65.0,35.0,120,02,01,  Mozampur,227,174,119,92,108,82,56.6,56.4,56.8,00000
58.0,65.0,35.0,155,01,01,  Chandgaon,405,475,207,227,198,248,46.0,47.7,44.4,00000
58.0,65.0,35.0,155,02,01,  Katairpar,117,175,61,92,56,83,40.1,39.9,40.3,00000
58.0,65.0,35.0,155,03,01,  Mirergaon,95,217,48,117,47,100,30.4,29.1,32.0,00000
58.0,65.0,35.0,494,01,01,  Katarkona,922,667,458,340,464,327,58.0,57.4,58.7,00000
58.0,65.0,35.0,494,02,01,  Hashimpur,400,368,232,173,168,195,52.1,57.3,46.3,00000
58.0,65.0,35.0,494,03,01,  Mandira,116,104,55,54,61,50,52.7,50.5,55.0,00000
58.0,65.0,35.0,494,04,01,  Tukli,66,182,26,95,40,87,26.6,21.5,31.5,00000
58.0,65.0,35.0,494,05,01,  Bara Kharbari,53,24,28,10,25,14,68.8,73.7,64.1,00000
58.0,65.0,35.0,511,01,01,  Keolakandi,604,424,319,187,285,237,58.8,63.0,54.6,00000
58.0,65.0,35.0,511,02,01,  Billerpar,716,1397,302,686,414,711,33.9,30.6,36.8,00000
58.0,65.0,35.0,632,01,01,  Mathabpur,458,201,231,86,227,115,69.5,72.9,66.4,00000
58.0,65.0,35.0,632,02,01,  Manu Bazar,70,40,36,24,34,16,63.6,60.0,68.0,00000
58.0,65.0,35.0,730,01,01,  Pabai,716,636,347,300,369,336,53.0,53.6,52.3,00000
58.0,65.0,35.0,730,02,01,  Dakshin Pabai,248,337,109,181,139,156,42.4,37.6,47.1,00000
58.0,65.0,35.0,730,03,01,  Rajanpur,247,379,119,176,128,203,39.5,40.3,38.7,00000
58.0,65.0,35.0,730,04,01,  Rampur,88,147,42,66,46,81,37.4,38.9,36.2,00000
58.0,65.0,35.0,730,05,01,  Gopalpur,78,112,47,58,31,54,41.1,44.8,36.5,00000
58.0,65.0,35.0,730,06,01,  Mitragaon,35,29,15,15,20,14,54.7,50.0,58.8,00000
58.0,65.0,35.0,730,07,01,  Balia,263,262,120,129,143,133,50.1,48.2,51.8,00000
58.0,65.0,35.0,730,08,01,  Chwsala,142,133,80,63,62,70,51.6,55.9,47.0,00000
58.0,65.0,35.0,845,01,01,  Ranchap,902,200,439,80,463,120,81.9,84.6,79.4,00000
58.0,65.0,35.0,845,02,01,  Chak Ranchap,244,131,125,60,119,71,65.1,67.6,62.6,00000
58.0,65.0,35.0,845,03,01,  Sultanpur,105,58,57,29,48,29,64.4,66.3,62.3,00000
58.0,65.0,35.0,977,01,01,  Urpibhag,23,23,13,10,10,13,50.0,56.5,43.5,00000
58.0,65.0,35.0,977,02,01,  Madanagar,203,212,77,118,126,94,48.9,39.5,57.3,00000
58.0,65.0,41.0,184,01,01,  Clevadon T.E.,546,1132,339,527,207,605,32.5,39.1,25.5,00000
58.0,65.0,41.0,184,02,01,  Janki Jalie,199,332,127,144,72,188,37.5,46.9,27.7,00000
58.0,65.0,41.0,218,01,01,  Durgapur,385,204,178,95,207,109,65.4,65.2,65.5,00000
58.0,65.0,41.0,218,02,01,  Begamanpur,379,247,183,114,196,133,60.5,61.6,59.6,00000
58.0,65.0,41.0,218,03,01,  Mithupur,163,48,80,14,83,34,77.3,85.1,70.9,00000
58.0,65.0,41.0,218,04,01,  Abu Talebpur,293,146,154,55,139,91,66.7,73.7,60.4,00000
58.0,65.0,41.0,218,05,01,  Rampasha,317,210,140,95,177,115,60.2,59.6,60.6,00000
58.0,65.0,41.0,218,06,01,  Joychandi,470,266,226,128,244,138,63.9,63.8,63.9,00000
58.0,65.0,41.0,281,01,01,  Dakshin Giasnagar,620,510,253,270,367,240,54.9,48.4,60.5,00000
58.0,65.0,41.0,281,02,01,  Uttar Giasnagar,254,308,110,159,144,149,45.2,40.9,49.1,00000
58.0,65.0,41.0,747,01,01,  Panchpir Jalai,622,696,305,323,317,373,47.2,48.6,45.9,00000
58.0,65.0,41.0,747,02,01,  Bithang Jalai,48,360,31,178,17,182,11.8,14.8,8.5,00000
58.0,65.0,41.0,807,01,01,  Pusainagar,549,653,259,285,290,368,45.7,47.6,44.1,00000
58.0,65.0,41.0,807,02,01,  Roygram,193,69,84,37,109,32,73.7,69.4,77.3,00000
58.0,65.0,41.0,807,03,01,  Hariharpur,218,108,113,50,105,58,66.9,69.3,64.4,00000
58.0,65.0,41.0,807,04,01,  Layerhigh,153,261,72,114,81,147,37.0,38.7,35.5,00000
58.0,65.0,41.0,807,05,01,  Gaurisankar,475,685,230,339,245,346,40.9,40.4,41.5,00000
58.0,65.0,41.0,856,01,01,  Rangirkul,854,817,410,388,444,429,51.1,51.4,50.9,00000
58.0,65.0,41.0,856,02,01,  Dildarpur,509,180,244,83,265,97,73.9,74.6,73.2,00000
58.0,65.0,41.0,891,01,01,  Gazipur,425,519,192,295,233,224,45.0,39.4,51.0,00000
58.0,65.0,41.0,891,02,01,  Mir Bakspur,119,157,57,80,62,77,43.1,41.6,44.6,00000
58.0,65.0,41.0,891,03,01,  Rajapur,93,94,47,45,46,49,49.7,51.1,48.4,00000
58.0,65.0,41.0,891,04,01,  Ghagtiea,397,607,156,319,241,288,39.5,32.8,45.6,00000
58.0,65.0,41.0,891,05,01,  Purondhorpur,42,43,20,22,22,21,49.4,47.6,51.2,00000
58.0,65.0,41.0,891,06,01,  Kuta Goan,228,195,101,105,127,90,53.9,49.0,58.5,00000
58.0,65.0,41.0,891,07,01,  Danapur,415,393,206,194,209,199,51.4,51.5,51.2,00000
58.0,65.0,41.0,891,08,01,  Kamer Kandhi,626,969,283,504,343,465,39.2,36.0,42.5,00000
58.0,65.0,53.0,176,01,01,  Chhakapan,794,468,392,222,402,246,62.9,63.8,62.0,00000
58.0,65.0,53.0,176,02,01,  Kiatala,374,110,184,51,190,59,77.3,78.3,76.3,00000
58.0,65.0,53.0,176,03,01,  Faridpur,501,143,260,55,241,88,77.8,82.5,73.3,00000
58.0,65.0,53.0,176,04,01,  Rafinagar,191,79,103,37,88,42,70.7,73.6,67.7,00000
58.0,65.0,53.0,176,05,01,  Gopinathpur,64,26,33,14,31,12,71.1,70.2,72.1,00000
58.0,65.0,53.0,506,01,01,  Kadipur,395,263,185,136,210,127,60.0,57.6,62.3,00000
58.0,65.0,53.0,506,02,01,  Kawla Rashi,760,381,362,179,398,202,66.6,66.9,66.3,00000
58.0,65.0,53.0,506,03,01,  Gobindapur,403,98,189,40,214,58,80.4,82.5,78.7,00000
58.0,65.0,53.0,506,04,01,  Lakshmipur,159,287,80,140,79,147,35.7,36.4,35.0,00000
58.0,65.0,53.0,506,05,01,  Uchail,165,44,90,20,75,24,78.9,81.8,75.8,00000
58.0,65.0,53.0,598,01,01,  Hashimpur,178,54,84,27,94,27,76.7,75.7,77.7,00000
58.0,65.0,53.0,598,02,01,  Maintaim,177,118,94,56,83,62,60.0,62.7,57.2,00000
58.0,65.0,53.0,598,03,01,  Guptagram,395,509,190,270,205,239,43.7,41.3,46.2,00000
58.0,65.0,53.0,598,04,01,  Tilakpur,84,97,47,51,37,46,46.4,48.0,44.6,00000
58.0,65.0,53.0,598,05,01,  Bhagmatpur,154,41,75,18,79,23,79.0,80.6,77.5,00000
58.0,65.0,53.0,621,01,01,  Amtali,395,93,172,50,223,43,80.9,77.5,83.8,00000
58.0,65.0,53.0,621,02,01,  Mansur,1889,1982,985,1024,904,958,48.8,49.0,48.5,00000
58.0,65.0,53.0,981,01,01,  Uttar Kawla,516,319,247,152,269,167,61.8,61.9,61.7,00000
58.0,65.0,53.0,981,02,01,  Kadirpur,131,281,69,126,62,155,31.8,35.4,28.6,00000
58.0,65.0,53.0,981,03,01,  Chunghar,886,1067,396,524,490,543,45.4,43.0,47.4,00000
58.0,65.0,53.0,981,04,01,  Kaki Char,306,262,159,134,147,128,53.9,54.3,53.5,00000
58.0,65.0,53.0,981,05,01,  Noagaon,49,73,26,29,23,44,40.2,47.3,34.3,00000
58.0,65.0,53.0,981,06,01,  Alipur,40,27,23,13,17,14,59.7,63.9,54.8,00000
58.0,65.0,53.0,981,07,01,  Sultan Pur,115,89,53,51,62,38,56.4,51.0,62.0,00000
58.0,65.0,53.0,981,08,01,  Ningiray,57,81,30,43,27,38,41.3,41.1,41.5,00000
58.0,65.0,59.0,005,01,01,  Asgarabad T.G.,56,141,39,66,17,75,28.4,37.1,18.5,00000
58.0,65.0,59.0,005,02,01,  Katabari Punji (High Hill),16,7,6,3,10,4,69.6,66.7,71.4,00000
58.0,65.0,59.0,005,03,01,  Gutum Chhara Punji  Do,13,12,8,6,5,6,52.0,57.1,45.5,00000
58.0,65.0,59.0,005,04,01,  Sona Chhara Punji   Do,181,38,103,13,78,25,82.6,88.8,75.7,00000
58.0,65.0,59.0,143,01,01,  Fatikuli,369,376,175,165,194,211,49.5,51.5,47.9,00000
58.0,65.0,59.0,143,02,01,  Purba Fatikuli (High Hill),554,777,264,393,290,384,41.6,40.2,43.0,00000
58.0,65.0,59.0,327,01,01,  Hashimpur,968,812,472,363,496,449,54.4,56.5,52.5,00000
58.0,65.0,59.0,327,02,01,  Beri,164,82,74,40,90,42,66.7,64.9,68.2,00000
58.0,65.0,59.0,327,03,01,  Gutumpur,113,142,50,64,63,78,44.3,43.9,44.7,00000
58.0,65.0,59.0,477,01,01,  Karmoda,1090,743,548,374,542,369,59.5,59.4,59.5,00000
58.0,65.0,59.0,477,02,01,  Babnia,356,351,177,159,179,192,50.4,52.7,48.2,00000
58.0,65.0,59.0,477,03,01,  Purba Karmoda,663,600,272,277,391,323,52.5,49.5,54.8,00000
58.0,65.0,59.0,477,04,01,  Mahishmara,190,272,90,141,100,131,41.1,39.0,43.3,00000
58.0,65.0,59.0,477,05,01,  Naldari,828,625,393,304,435,321,57.0,56.4,57.5,00000
58.0,65.0,59.0,477,06,01,  Hasnabad,304,119,139,48,165,71,71.9,74.3,69.9,00000
58.0,65.0,59.0,477,07,01,  Bahattia,219,212,107,99,112,113,50.8,51.9,49.8,00000
58.0,65.0,59.0,477,08,01,  Pattai,423,397,196,173,227,224,51.6,53.1,50.3,00000
58.0,65.0,59.0,477,09,01,  Mansurpur,736,946,342,469,394,477,43.8,42.2,45.2,00000
58.0,65.0,59.0,477,10,01,  Nuna,172,241,80,130,92,111,41.6,38.1,45.3,00000
58.0,65.0,59.0,477,11,01,  Baruakandi,20,24,9,12,11,12,45.5,42.9,47.8,00000
58.0,65.0,59.0,477,12,01,  Bhandarigaon,120,15,63,3,57,12,88.9,95.5,82.6,00000
58.0,65.0,59.0,609,01,01,  Mansura Basti,92,121,45,60,47,61,43.2,42.9,43.5,00000
58.0,65.0,59.0,609,02,01,  Manchara Punji,158,134,70,70,88,64,54.1,50.0,57.9,00000
58.0,65.0,59.0,609,03,01,  Jhimai Punji,14,8,7,3,7,5,63.6,70.0,58.3,00000
58.0,65.0,59.0,672,01,01,  Murai Chhara T.E.,201,355,134,159,67,196,36.2,45.7,25.5,00000
58.0,65.0,59.0,672,02,01,  Murai Chhara Basti,90,489,36,251,54,238,15.5,12.5,18.5,00000
58.0,65.0,59.0,672,03,01,  Murai Chhara Punji (High Hill),174,120,88,58,86,62,59.2,60.3,58.1,00000
58.0,65.0,59.0,672,04,01,  Ewala Chhara Punji (Hill Hill),92,21,50,7,42,14,81.4,87.7,75.0,00000
58.0,65.0,59.0,672,05,01,  Ugar Chhara Punji (High Hill),46,19,27,7,19,12,70.8,79.4,61.3,00000
58.0,65.0,59.0,672,06,01,  Icha Chhara Punji (Hill Hill),83,88,47,44,36,44,48.5,51.6,45.0,00000
58.0,65.0,59.0,672,07,01,  Ranynagar,33,40,24,14,9,26,45.2,63.2,25.7,00000
58.0,65.0,59.0,718,01,01,  Nun Chhara (Hill Hill),103,215,55,117,48,98,32.4,32.0,32.9,00000
58.0,65.0,59.0,718,02,01,  Ichi Punji (High Hill),47,53,23,22,24,31,47.0,51.1,43.6,00000
58.0,65.0,59.0,718,03,01,  Puti Chhara Punji (High Hill),82,242,42,119,40,123,25.3,26.1,24.5,00000
58.0,65.0,59.0,718,04,01,  Amuli Punji (High Hill),29,70,13,33,16,37,29.3,28.3,30.2,00000
58.0,65.0,59.0,718,05,01,  Chalta Chhara Punji,112,21,61,9,51,12,84.2,87.1,81.0,00000
58.0,65.0,59.0,718,06,01,  Mokam Chhara Punji,1,51,1,29,0,22,1.9,3.3,0.0,00000
58.0,65.0,59.0,842,01,01,  Bad Pasha,1080,1125,505,559,575,566,49.0,47.5,50.4,00000
58.0,65.0,59.0,842,02,01,  Tatroli,959,1251,444,616,515,635,43.4,41.9,44.8,00000
58.0,65.0,59.0,842,03,01,  Dighalkandi,560,808,258,406,302,402,40.9,38.9,42.9,00000
58.0,65.0,59.0,842,04,01,  Rajanagar,65,80,27,35,38,45,44.8,43.5,45.8,00000
58.0,65.0,59.0,842,05,01,  Purba Tatruli,651,918,310,443,341,475,41.5,41.2,41.8,00000
58.0,65.0,59.0,851,01,01,  Rangi Chhara T.E.,524,594,297,248,227,346,46.9,54.5,39.6,00000
58.0,65.0,59.0,851,02,01,  Magatila Punji(High Hill),42,34,19,15,23,19,55.3,55.9,54.8,00000
58.0,65.0,59.0,851,03,01,  Rangi Chhara Punji (High Hill),53,80,30,44,23,36,39.8,40.5,39.0,00000
58.0,65.0,59.0,851,04,01,  Lamba Chhara Punji,10,13,6,7,4,6,43.5,46.2,40.0,00000
58.0,65.0,59.0,851,05,01,  Yeorinagar T.E,94,145,59,56,35,89,39.3,51.3,28.2,00000
58.0,65.0,59.0,885,01,01,  Belkuma Punji (High Hill),319,108,164,54,155,54,74.7,75.2,74.2,00000
58.0,65.0,59.0,885,02,01,  Luthijuri Punji(High Hill),115,18,66,8,49,10,86.5,89.2,83.1,00000
58.0,65.0,59.0,885,03,01,  Kukijuri Punji (High Hill),104,71,59,35,45,36,59.4,62.8,55.6,00000
58.0,65.0,65.0,011,01,01,  Shankarpur,218,134,100,69,118,65,61.9,59.2,64.5,00000
58.0,65.0,65.0,011,02,01,  Pratabi,761,459,331,206,430,253,62.4,61.6,63.0,00000
58.0,65.0,65.0,011,03,01,  Gutguti,427,241,187,124,240,117,63.9,60.1,67.2,00000
58.0,65.0,65.0,011,04,01,  Lakshmipur,378,304,160,153,218,151,55.4,51.1,59.1,00000
58.0,65.0,65.0,011,05,01,  Bangaon-2,329,261,158,115,171,146,55.8,57.9,53.9,00000
58.0,65.0,65.0,011,06,01,  Balichri,128,328,50,166,78,162,28.1,23.1,32.5,00000
58.0,65.0,65.0,011,07,01,  Nazirer Chak,201,146,101,71,100,75,57.9,58.7,57.1,00000
58.0,65.0,65.0,011,08,01,  Haripur,55,166,15,86,40,80,24.9,14.9,33.3,00000
58.0,65.0,65.0,011,09,01,  Bagajura,96,70,36,29,60,41,57.8,55.4,59.4,00000
58.0,65.0,65.0,011,10,01,  Dasher Mahal,99,66,49,35,50,31,60.0,58.3,61.7,00000
58.0,65.0,65.0,011,11,01,  Puranderpur,33,11,13,3,20,8,75.0,81.3,71.4,00000
58.0,65.0,65.0,011,12,01,  Sreepur,96,52,41,19,55,33,64.9,68.3,62.5,00000
58.0,65.0,65.0,011,13,01,  Karergram,506,449,250,223,256,226,53.0,52.9,53.1,00000
58.0,65.0,65.0,011,14,01,  Bangaon-1,229,143,117,57,112,86,61.6,67.2,56.6,00000
58.0,65.0,65.0,011,15,01,  Gazipur,425,334,212,147,213,187,56.0,59.1,53.3,00000
58.0,65.0,65.0,011,16,01,  Saiyadpur,60,47,28,22,32,25,56.1,56.0,56.1,00000
58.0,65.0,65.0,665,01,01,  Bara Kapan,583,217,290,92,293,125,72.9,75.9,70.1,00000
58.0,65.0,65.0,665,02,01,  Hasanpur,137,58,58,24,79,34,70.3,70.7,69.9,00000
58.0,65.0,65.0,665,03,01,  Minar Mahal,320,163,162,76,158,87,66.3,68.1,64.5,00000
58.0,65.0,65.0,665,04,01,  Mirer Gram,37,11,20,5,17,6,77.1,80.0,73.9,00000
58.0,65.0,71.0,023,01,01,  Dhalia,267,56,137,20,130,36,82.7,87.3,78.3,00000
58.0,65.0,71.0,023,02,01,  Alinagar,823,505,417,250,406,255,62.0,62.5,61.4,00000
58.0,65.0,71.0,224,01,01,  Pursai,298,192,155,88,143,104,60.8,63.8,57.9,00000
58.0,65.0,71.0,224,02,01,  Barabari,334,137,167,56,167,81,70.9,74.9,67.3,00000
58.0,65.0,71.0,224,03,01,  Deogaon,391,108,198,55,193,53,78.4,78.3,78.5,00000
58.0,65.0,71.0,224,04,01,  Tokigaon,258,145,137,82,121,63,64.0,62.6,65.8,00000
58.0,65.0,71.0,586,01,01,  Bhatgaon,315,106,153,44,162,62,74.8,77.7,72.3,00000
58.0,65.0,71.0,586,02,01,  Mudipur,298,116,147,55,151,61,72.0,72.8,71.2,00000
58.0,65.0,71.0,586,03,01,  Daulatpur,451,119,234,50,217,69,79.1,82.4,75.9,00000
58.0,65.0,71.0,586,04,01,  Hashanpur,173,113,67,57,106,56,60.5,54.0,65.4,00000
58.0,65.0,71.0,776,01,01,  Sultanpur,971,345,502,151,469,194,73.8,76.9,70.7,00000
58.0,65.0,71.0,776,02,01,  Ganipur,202,230,94,115,108,115,46.8,45.0,48.4,00000
58.0,65.0,71.0,776,03,01,  Ghorer Gaon,203,261,98,125,105,136,43.8,43.9,43.6,00000
58.0,65.0,71.0,776,05,01,  Prithim Pasha-2,1630,1128,855,538,775,590,59.1,61.4,56.8,00000
58.0,65.0,71.0,776,06,01,  Kanikiyari,530,125,277,48,253,77,80.9,85.2,76.7,00000
58.0,65.0,71.0,776,07,01,  Robi Bazar,322,172,191,90,131,82,65.2,68.0,61.5,00000
58.0,65.0,71.0,839,01,01,  Rajnagar-1,818,504,419,235,399,269,61.9,64.1,59.7,00000
58.0,65.0,71.0,839,02,01,  Rajnagar-2,766,486,363,223,403,263,61.2,61.9,60.5,00000
58.0,65.0,71.0,839,03,01,  Bakhernagar,119,42,56,22,63,20,73.9,71.8,75.9,00000
58.0,65.0,71.0,839,04,01,  Nandirgaon,539,257,263,117,276,140,67.7,69.2,66.3,00000
58.0,65.0,71.0,839,05,01,  Karaigaon,249,78,118,22,131,56,76.1,84.3,70.1,00000
58.0,65.0,71.0,839,06,01,  Amuli,268,207,131,86,137,121,56.4,60.4,53.1,00000
58.0,65.0,71.0,839,07,01,  Luta Bil,106,104,44,53,62,51,50.5,45.4,54.9,00000
58.0,65.0,71.0,953,01,01,  Shad Pasha,277,102,139,40,138,62,73.1,77.7,69.0,00000
58.0,65.0,71.0,953,02,01,  Itahari,459,281,230,130,229,151,62.0,63.9,60.3,00000
58.0,65.0,71.0,953,03,01,  Yusuf Sadar,448,251,205,122,243,129,64.1,62.7,65.3,00000
58.0,65.0,71.0,953,04,01,  Kanai Tikar,531,371,261,166,270,205,58.9,61.1,56.8,00000
58.0,65.0,71.0,953,05,01,  Sujapur,128,57,76,24,52,33,69.2,76.0,61.2,00000
58.0,65.0,71.0,953,06,01,  Kolirkona-1,117,25,62,4,55,21,82.4,93.9,72.4,00000
58.0,65.0,71.0,953,07,01,  Kolirkona-2,199,164,93,73,106,91,54.8,56.0,53.8,00000
58.0,65.0,71.0,953,08,01,  Rajapur,142,43,59,20,83,23,76.8,74.7,78.3,00000
58.0,65.0,71.0,953,09,01,  Sanman,626,269,298,114,328,155,69.9,72.3,67.9,00000
58.0,65.0,71.0,953,10,01,  Salikha,225,105,105,44,120,61,68.2,70.5,66.3,00000
58.0,65.0,71.0,953,11,01,  Gajbhag,341,231,166,103,175,128,59.6,61.7,57.8,00000
58.0,65.0,71.0,953,12,01,  Sydol Bazar,22,6,11,2,11,4,78.6,84.6,73.3,00000
58.0,65.0,77.0,454,01,01,  Kalijuri,54,208,27,106,27,102,20.6,20.3,20.9,00000
58.0,65.0,77.0,454,02,01,  Rautgaon,650,634,305,319,345,315,50.6,48.9,52.3,00000
58.0,65.0,77.0,454,03,01,  Abda,109,117,57,59,52,58,48.2,49.1,47.3,00000
58.0,65.0,77.0,454,04,01,  Sutarkandi,41,74,20,37,21,37,35.7,35.1,36.2,00000
58.0,65.0,77.0,454,05,01,  Bangaon,40,86,22,45,18,41,31.7,32.8,30.5,00000
58.0,65.0,77.0,454,06,01,  Lalpur,160,291,74,148,86,143,35.5,33.3,37.6,00000
58.0,65.0,77.0,454,07,01,  Barmapur,28,50,14,26,14,24,35.9,35.0,36.8,00000
58.0,65.0,77.0,529,01,01,  Kowla,924,1537,436,739,488,798,37.5,37.1,37.9,00000
58.0,65.0,77.0,529,02,01,  Najatpur,7,92,6,90,1,2,7.1,6.3,33.3,00000
58.0,65.0,77.0,540,01,01,  Kabiraji,307,388,113,182,194,206,44.2,38.3,48.5,00000
58.0,65.0,77.0,540,02,01,  Palgram,569,770,240,356,329,414,42.5,40.3,44.3,00000
58.0,65.0,77.0,540,03,01,  Rostampur,69,54,32,25,37,29,56.1,56.1,56.1,00000
58.0,65.0,77.0,540,04,01,  Bagajura,127,51,64,20,63,31,71.3,76.2,67.0,00000
58.0,65.0,77.0,540,05,01,  Barabari,74,23,32,13,42,10,76.3,71.1,80.8,00000
58.0,65.0,77.0,583,01,01,  Monraj,1146,1295,526,657,620,638,46.9,44.5,49.3,00000
58.0,65.0,77.0,583,02,01,  Hasampur,98,128,50,64,48,64,43.4,43.9,42.9,00000
58.0,65.0,77.0,603,01,01,  Maisajuri,228,395,103,222,125,173,36.6,31.7,41.9,00000
58.0,65.0,77.0,603,02,01,  Sreerampur,64,53,35,25,29,28,54.7,58.3,50.9,00000
58.0,65.0,77.0,603,03,01,  Batuthgram,398,463,192,228,206,235,46.2,45.7,46.7,00000
58.0,65.0,77.0,667,01,01,  Mukundapur,708,467,317,225,391,242,60.3,58.5,61.8,00000
58.0,65.0,77.0,667,02,01,  Ekidattapur,309,321,142,152,167,169,49.0,48.3,49.7,00000
58.0,65.0,77.0,667,03,01,  Minar Mahal,63,30,37,11,26,19,67.7,77.1,57.8,00000
58.0,65.0,77.0,667,04,01,  Abdulpur,259,331,123,153,136,178,43.9,44.6,43.3,00000
58.0,65.0,77.0,701,01,01,  Nartan,673,538,313,272,360,266,55.6,53.5,57.5,00000
58.0,65.0,77.0,701,02,01,  Hadbarua,53,91,23,45,30,46,36.8,33.8,39.5,00000
58.0,65.0,77.0,701,03,01,  Tilashijura,301,285,128,147,173,138,51.4,46.5,55.6,00000
58.0,65.0,77.0,701,04,01,  Bhimbasu,132,66,66,33,66,33,66.7,66.7,66.7,00000
58.0,65.0,89.0,172,01,01,  Chatlapur T.E.,589,1689,364,798,225,891,25.9,31.3,20.2,00000
58.0,65.0,89.0,172,02,01,  44-Patta,196,452,123,216,73,236,30.2,36.3,23.6,00000
58.0,65.0,89.0,172,03,01,  Tilakpur T.E.,620,725,355,288,265,437,46.1,55.2,37.7,00000
58.0,65.0,89.0,172,04,01,  Palki Chhara,422,453,271,176,151,277,48.2,60.6,35.3,00000
58.0,65.0,89.0,207,01,01,  Dattagram,364,349,175,167,189,182,51.1,51.2,50.9,00000
58.0,65.0,89.0,207,02,01,  Nischintapur,391,331,168,149,223,182,54.2,53.0,55.1,00000
58.0,65.0,89.0,207,03,01,  Madanagar,130,106,53,46,77,60,55.1,53.5,56.2,00000
58.0,65.0,89.0,615,01,01,  Mangaon,391,224,201,104,190,120,63.6,65.9,61.3,00000
58.0,65.0,89.0,615,02,01,  Tilokpur,364,99,174,47,190,52,78.6,78.7,78.5,00000
58.0,65.0,89.0,615,03,01,  Changua,93,72,41,37,52,35,56.4,52.6,59.8,00000
58.0,65.0,89.0,661,01,01,  Manoharpur,432,337,211,176,221,161,56.2,54.5,57.9,00000
58.0,65.0,89.0,661,02,01,  Interghat,196,240,80,106,116,134,45.0,43.0,46.4,00000
58.0,65.0,89.0,661,03,01,  Chariarghat,6,129,5,62,1,67,4.4,7.5,1.5,00000
58.0,65.0,89.0,661,04,01,  Kalaroyer Char,111,276,55,131,56,145,28.7,29.6,27.9,00000
58.0,65.0,89.0,805,01,01,  Teli Bil,616,689,276,331,340,358,47.2,45.5,48.7,00000
58.0,65.0,89.0,805,02,01,  Chandpur,402,362,198,169,204,193,52.6,54.0,51.4,00000
58.0,65.0,89.0,805,03,01,  Purbabhag,442,546,213,233,229,313,44.7,47.8,42.3,00000
58.0,65.0,89.0,805,04,01,  Baghjur,292,271,145,126,147,145,51.9,53.5,50.3,00000
58.0,65.0,89.0,914,01,01,  Sharifpur,748,434,348,198,400,236,63.3,63.7,62.9,00000
58.0,65.0,89.0,914,02,01,  Khidirpur,93,17,41,8,52,9,84.5,83.7,85.2,00000
58.0,65.0,95.0,040,01,01,  Ashroygram,508,760,244,369,264,391,40.1,39.8,40.3,00000
58.0,65.0,95.0,040,02,01,  Jadhabpur,10,20,4,9,6,11,33.3,30.8,35.3,00000
58.0,65.0,95.0,040,03,01,  Lalbag,18,7,12,3,6,4,72.0,80.0,60.0,00000
58.0,65.0,95.0,057,01,01,  Tajpur,163,89,86,39,77,50,64.7,68.8,60.6,00000
58.0,65.0,95.0,057,02,01,  Gondargar,177,115,92,54,85,61,60.6,63.0,58.2,00000
58.0,65.0,95.0,057,03,01,  Shalan,170,113,88,50,82,63,60.1,63.8,56.6,00000
58.0,65.0,95.0,057,04,01,  Purigram,19,24,7,12,12,12,44.2,36.8,50.0,00000
58.0,65.0,95.0,057,05,01,  Dudlalpur,76,60,41,24,35,36,55.9,63.1,49.3,00000
58.0,65.0,95.0,057,06,01,  Khonda Kargram,78,71,30,33,48,38,52.3,47.6,55.8,00000
58.0,65.0,95.0,057,07,01,  Balakandi,13,30,4,14,9,16,30.2,22.2,36.0,00000
58.0,65.0,95.0,057,08,01,  Shahajadapur,39,63,19,31,20,32,38.2,38.0,38.5,00000
58.0,65.0,95.0,057,09,01,  Jalalpur,23,25,12,12,11,13,47.9,50.0,45.8,00000
58.0,65.0,95.0,057,10,01,  Chak Shalan,112,119,64,57,48,62,48.5,52.9,43.6,00000
58.0,65.0,95.0,057,11,01,  Shanorabaj,106,136,40,58,66,78,43.8,40.8,45.8,00000
58.0,65.0,95.0,057,12,01,  Miar Para,160,498,70,244,90,254,24.3,22.3,26.2,00000
58.0,65.0,95.0,057,13,01,  Dari Tajpur,185,713,69,365,116,348,20.6,15.9,25.0,00000
58.0,65.0,95.0,057,14,01,  Yusufpur,133,33,75,16,58,17,80.1,82.4,77.3,00000
58.0,65.0,95.0,057,15,01,  Bade Shalan,47,11,26,4,21,7,81.0,86.7,75.0,00000
58.0,65.0,95.0,057,16,01,  Balihara,26,14,14,6,12,8,65.0,70.0,60.0,00000
58.0,65.0,95.0,057,17,01,  Balia,252,109,117,48,135,61,69.8,70.9,68.9,00000
58.0,65.0,95.0,057,18,01,  Tilagaon,8,2,5,1,3,1,80.0,83.3,75.0,00000
58.0,65.0,95.0,132,01,01,  Bijli,920,1267,444,585,476,682,42.1,43.1,41.1,00000
58.0,65.0,95.0,132,02,01,  Shahpur,62,141,27,72,35,69,30.5,27.3,33.7,00000
58.0,65.0,95.0,132,03,01,  Chandpur,354,268,171,118,183,150,56.9,59.2,55.0,00000
58.0,65.0,95.0,132,04,01,  Sujapur,327,131,167,57,160,74,71.4,74.6,68.4,00000
58.0,65.0,95.0,563,01,01,  Langla T.E.,1165,2410,648,1150,517,1260,32.6,36.0,29.1,00000
58.0,65.0,95.0,563,02,01,  Lalpur,620,995,308,484,312,511,38.4,38.9,37.9,00000
58.0,65.0,95.0,563,03,01,  Tadra Pasha T.E.,391,1110,223,522,168,588,26.0,29.9,22.2,00000
58.0,65.0,95.0,563,04,01,  Bagrihal,639,1213,283,621,356,592,34.5,31.3,37.6,00000
58.0,65.0,95.0,563,05,01,  Mohibnagar(Longla Khas Notonb.,156,1160,77,580,79,580,11.9,11.7,12.0,00000
58.0,65.0,95.0,649,01,01,  Salamatpur,51,112,25,50,26,62,31.3,33.3,29.5,00000
58.0,65.0,95.0,649,02,01,  Mirpur,193,145,83,68,110,77,57.1,55.0,58.8,00000
58.0,65.0,95.0,649,03,01,  Kamalpur,239,312,116,147,123,165,43.4,44.1,42.7,00000
58.0,65.0,95.0,649,04,01,  Salamatpur (Part-2),56,117,26,63,30,54,32.4,29.2,35.7,00000
58.0,65.0,95.0,649,05,01,  Laharajpur,408,558,179,270,229,288,42.2,39.9,44.3,00000
58.0,65.0,95.0,690,01,01,  Baidya Shasan,503,351,238,173,265,178,58.9,57.9,59.8,00000
58.0,65.0,95.0,690,02,01,  Naimpur,147,340,56,168,91,172,30.2,25.0,34.6,00000
58.0,65.0,95.0,690,03,01,  Mobarakpur,164,171,100,101,64,70,49.0,49.8,47.8,00000
58.0,65.0,95.0,690,04,01,  Kazirgaon,211,130,105,65,106,65,61.9,61.8,62.0,00000
58.0,65.0,95.0,690,05,01,  Amanipur,246,860,115,419,131,441,22.2,21.5,22.9,00000
58.0,65.0,95.0,690,06,01,  Balishindi,188,223,84,109,104,114,45.7,43.5,47.7,00000
58.0,65.0,95.0,690,07,01,  Pallakandi,201,293,98,129,103,164,40.7,43.2,38.6,00000
58.0,74.0,13.0,041,01,01,  Akhaikura,390,353,194,159,196,194,52.5,55.0,50.3,00000
58.0,74.0,13.0,041,02,01,  Dhanpur,4,5,2,3,2,2,44.4,40.0,50.0,00000
58.0,74.0,13.0,041,03,01,  Akhailkura Bazar,21,33,9,13,12,20,38.9,40.9,37.5,00000
58.0,74.0,13.0,217,01,01,  Bekamura,1346,1566,668,709,678,857,46.2,48.5,44.2,00000
58.0,74.0,13.0,217,02,01,  Dakshin Kakerkona,57,35,21,16,36,19,62.0,56.8,65.5,00000
58.0,74.0,13.0,217,03,01,  Omarpur,144,139,63,67,81,72,50.9,48.5,52.9,00000
58.0,74.0,13.0,217,04,01,  Paschim Sreepati,18,6,7,1,11,5,75.0,87.5,68.8,00000
58.0,74.0,13.0,217,05,01,  Kazir Bazar,40,52,27,40,13,12,43.5,40.3,52.0,00000
58.0,74.0,13.0,217,06,01,  Karma Chetta,87,114,44,44,43,70,43.3,50.0,38.1,00000
58.0,74.0,13.0,217,07,01,  Patantola,128,176,74,78,54,98,42.1,48.7,35.5,00000
58.0,74.0,13.0,217,08,01,  Golapgong,146,83,68,39,78,44,63.8,63.6,63.9,00000
58.0,74.0,13.0,321,01,01,  Sampasi,370,430,182,211,188,219,46.3,46.3,46.2,00000
58.0,74.0,13.0,321,02,01,  Kamargaon,46,52,21,37,25,15,46.9,36.2,62.5,00000
58.0,74.0,13.0,380,01,01,  Durgapur,364,239,185,104,179,135,60.4,64.0,57.0,00000
58.0,74.0,13.0,380,02,01,  Jumapur,79,134,37,65,42,69,37.1,36.3,37.8,00000
58.0,74.0,13.0,380,03,01,  Jamalpur,58,90,21,48,37,42,39.2,30.4,46.8,00000
58.0,74.0,13.0,715,01,01,  Mirpur,1029,889,519,438,510,451,53.6,54.2,53.1,00000
58.0,74.0,13.0,715,02,01,  Majleshpur,25,13,16,7,9,6,65.8,69.6,60.0,00000
58.0,74.0,13.0,766,01,01,  Noarai,105,63,61,29,44,34,62.5,67.8,56.4,00000
58.0,74.0,13.0,766,02,01,  Sabaspur,16,6,8,2,8,4,72.7,80.0,66.7,00000
58.0,74.0,13.0,777,01,01,  Paguria,185,461,97,220,88,241,28.6,30.6,26.7,00000
58.0,74.0,13.0,777,02,01,  Mobarakpur,74,89,40,37,34,52,45.4,51.9,39.5,00000
58.0,74.0,13.0,787,01,01,  Palpur,301,436,168,208,133,228,40.8,44.7,36.8,00000
58.0,74.0,13.0,787,02,01,  Amoya,203,141,104,68,99,73,59.0,60.5,57.6,00000
58.0,74.0,13.0,855,01,01,  Rasulpur,179,137,98,61,81,76,56.6,61.6,51.6,00000
58.0,74.0,13.0,855,02,01,  Khoishwra,162,297,67,143,95,154,35.3,31.9,38.2,00000
58.0,74.0,13.0,855,03,01,  Kharpur,38,20,17,8,21,12,65.5,68.0,63.6,00000
58.0,74.0,14.0,046,01,01,  Aloha,837,671,461,358,376,313,55.5,56.3,54.6,00000
58.0,74.0,14.0,046,02,01,  Jaduraloha,112,138,59,63,53,75,44.8,48.4,41.4,00000
58.0,74.0,14.0,046,03,01,  Bhabanipur,84,44,43,17,41,27,65.6,71.7,60.3,00000
58.0,74.0,14.0,046,04,01,  Bara Harmanik,97,198,53,100,44,98,32.9,34.6,31.0,00000
58.0,74.0,14.0,046,05,01,  Ataismal,43,109,20,52,23,57,28.3,27.8,28.8,00000
58.0,74.0,14.0,046,06,01,  Ronokeli,42,95,23,42,19,53,30.7,35.4,26.4,00000
58.0,74.0,14.0,046,07,01,  Pathuli,128,157,61,76,67,81,44.9,44.5,45.3,00000
58.0,74.0,14.0,051,01,01,  Amtail,776,449,361,211,415,238,63.3,63.1,63.6,00000
58.0,74.0,14.0,051,02,01,  Dora,18,67,8,30,10,37,21.2,21.1,21.3,00000
58.0,74.0,14.0,051,03,01,  Haripur,156,57,74,17,82,40,73.2,81.3,67.2,00000
58.0,74.0,14.0,051,04,01,  Khujar Bondapur,139,31,63,14,76,17,81.8,81.8,81.7,00000
58.0,74.0,14.0,051,05,01,  Khilgaon,27,10,15,4,12,6,73.0,78.9,66.7,00000
58.0,74.0,14.0,072,01,01,  Atgaon,832,169,430,98,402,71,83.1,81.4,85.0,00000
58.0,74.0,14.0,072,02,01,  Potka,196,139,105,69,91,70,58.5,60.3,56.5,00000
58.0,74.0,14.0,072,03,01,  Sreechandra Raghu,22,10,11,5,11,5,68.8,68.8,68.8,00000
58.0,74.0,14.0,072,04,01,  Pangjanaki,15,7,9,3,6,4,68.2,75.0,60.0,00000
58.0,74.0,14.0,072,05,01,  Mukundapur,32,20,15,9,17,11,61.5,62.5,60.7,00000
58.0,74.0,14.0,153,01,01,  Barahal,386,236,189,121,197,115,62.1,61.0,63.1,00000
58.0,74.0,14.0,153,02,01,  Pongdhorai,59,88,32,32,27,56,40.1,50.0,32.5,00000
58.0,74.0,14.0,155,01,01,  Bara Haratilak,257,83,126,33,131,50,75.6,79.2,72.4,00000
58.0,74.0,14.0,155,02,01,  Barahar,82,12,38,4,44,8,87.2,90.5,84.6,00000
58.0,74.0,14.0,155,03,01,  Fultail,23,38,11,18,12,20,37.7,37.9,37.5,00000
58.0,74.0,14.0,155,04,01,  Poransena,54,81,25,37,29,44,40.0,40.3,39.7,00000
58.0,74.0,14.0,155,05,01,  Durgapur,9,54,4,26,5,28,14.3,13.3,15.2,00000
58.0,74.0,14.0,155,06,01,  Adapasha,124,81,66,37,58,44,60.5,64.1,56.9,00000
58.0,74.0,14.0,290,01,01,  Chamatkar Uttar,224,57,112,28,112,29,79.7,80.0,79.4,00000
58.0,74.0,14.0,290,02,01,  Chamatkar Daksoin,306,242,145,123,161,119,55.8,54.1,57.5,00000
58.0,74.0,14.0,290,03,01,  Kalyanpur,13,8,10,3,3,5,61.9,76.9,37.5,00000
58.0,74.0,14.0,310,01,01,  Bagargaon,128,112,72,47,56,65,53.3,60.5,46.3,00000
58.0,74.0,14.0,310,02,01,  Shathal,212,82,134,52,78,30,72.1,72.0,72.2,00000
58.0,74.0,14.0,310,03,01,  Shampadpur,283,87,152,32,131,55,76.5,82.6,70.4,00000
58.0,74.0,14.0,310,04,01,  Khushalpur,915,210,430,81,485,129,81.3,84.1,79.0,00000
58.0,74.0,14.0,378,01,01,  Chondibar,50,27,25,13,25,14,64.9,65.8,64.1,00000
58.0,74.0,14.0,378,02,01,  Ponglilai,36,18,16,12,20,6,66.7,57.1,76.9,00000
58.0,74.0,14.0,378,03,01,  Mallikpur Dughar,98,56,44,24,54,32,63.6,64.7,62.8,00000
58.0,74.0,14.0,378,04,01,  Shamamodpur,101,41,47,17,54,24,71.1,73.4,69.2,00000
58.0,74.0,14.0,378,05,01,  Dhogar(Part),266,199,117,98,149,101,57.2,54.4,59.6,00000
58.0,74.0,14.0,516,01,01,  Jagatsi (Part),133,26,51,9,82,17,83.6,85.0,82.8,00000
58.0,74.0,14.0,516,02,01,  Lama Jagatsi,349,99,162,49,187,50,77.9,76.8,78.9,00000
58.0,74.0,14.0,516,03,01,  Debai Jagatsi,254,163,132,71,122,92,60.9,65.0,57.0,00000
58.0,74.0,14.0,678,01,01,  Ishipur,181,49,91,24,90,25,78.7,79.1,78.3,00000
58.0,74.0,14.0,678,02,01,  Maskandi,611,797,337,399,274,398,43.4,45.8,40.8,00000
58.0,74.0,14.0,678,03,01,  Balarampur,117,88,62,39,55,49,57.1,61.4,52.9,00000
58.0,74.0,14.0,678,04,01,  Gabindapur,51,35,30,12,21,23,59.3,71.4,47.7,00000
58.0,74.0,21.0,119,01,01,  Baliarbagh,718,503,350,277,368,226,58.8,55.8,62.0,00000
58.0,74.0,21.0,119,02,01,  Nurpur,43,34,15,17,28,17,55.8,46.9,62.2,00000
58.0,74.0,21.0,461,01,01,  Gujarai,1345,1221,750,625,595,596,52.4,54.5,50.0,00000
58.0,74.0,21.0,461,02,01,  Chandighat,939,534,534,272,405,262,63.7,66.3,60.7,00000
58.0,74.0,21.0,461,03,01,  Dakshin Molaim,393,356,214,187,179,169,52.5,53.4,51.4,00000
58.0,74.0,21.0,502,01,01,  Islampur,177,382,82,199,95,183,31.7,29.2,34.2,00000
58.0,74.0,21.0,502,02,01,  Kither Mahal,101,316,54,161,47,155,24.2,25.1,23.3,00000
58.0,74.0,21.0,668,01,01,  Mamrujpur,542,207,261,96,281,111,72.4,73.1,71.7,00000
58.0,74.0,21.0,668,02,01,  Ashia,212,74,109,40,103,34,74.1,73.2,75.2,00000
58.0,74.0,21.0,782,01,01,  Pahar Barsijura,805,650,408,308,397,342,55.3,57.0,53.7,00000
58.0,74.0,21.0,782,02,01,  Gajemara,205,84,99,42,106,42,70.9,70.2,71.6,00000
58.0,74.0,21.0,782,03,01,  Mokter Chak,66,352,43,180,23,172,15.8,19.3,11.8,00000
58.0,74.0,21.0,782,04,01,  Digal Gazi,742,801,400,387,342,414,48.1,50.8,45.2,00000
58.0,74.0,21.0,782,05,01,  Salami Tilla,494,528,226,264,268,264,48.3,46.1,50.4,00000
58.0,74.0,21.0,870,01,01,  Sabia,707,550,379,271,328,279,56.2,58.3,54.0,00000
58.0,74.0,21.0,870,02,01,  Mathabpur,118,39,59,16,59,23,75.2,78.7,72.0,00000
58.0,74.0,21.0,896,01,01,  Badi Sampasi,179,71,101,29,78,42,71.6,77.7,65.0,00000
58.0,74.0,21.0,896,02,01,  Sampasi,38,14,20,6,18,8,73.1,76.9,69.2,00000
58.0,74.0,21.0,896,03,01,  Roysar,21,7,10,4,11,3,75.0,71.4,78.6,00000
58.0,74.0,21.0,896,04,01,  Gadadharbagh,94,10,46,4,48,6,90.4,92.0,88.9,00000
58.0,74.0,29.0,139,01,01,  Barabari,93,183,40,100,53,83,33.7,28.6,39.0,00000
58.0,74.0,29.0,139,02,01,  Sadatpur,23,45,9,29,14,16,33.8,23.7,46.7,00000
58.0,74.0,29.0,181,01,01,  Barkapan,534,518,284,266,250,252,50.8,51.6,49.8,00000
58.0,74.0,29.0,181,02,01,  Burikona,191,199,101,90,90,109,49.0,52.9,45.2,00000
58.0,74.0,29.0,253,01,01,  Birahimabad,307,338,156,167,151,171,47.6,48.3,46.9,00000
58.0,74.0,29.0,253,02,01,  Karimullapur,146,251,65,133,81,118,36.8,32.8,40.7,00000
58.0,74.0,29.0,316,01,01,  Dakshin Singkapan,13,14,9,6,4,8,48.1,60.0,33.3,00000
58.0,74.0,29.0,316,02,01,  Dakshin Bali,357,173,154,95,203,78,67.4,61.8,72.2,00000
58.0,74.0,29.0,316,03,01,  Telkar,44,22,25,6,19,16,66.7,80.6,54.3,00000
58.0,74.0,29.0,316,04,01,  Nider Mahal,166,128,78,58,88,70,56.5,57.4,55.7,00000
58.0,74.0,29.0,357,01,01,  Digambarpur,48,55,25,20,23,35,46.6,55.6,39.7,00000
58.0,74.0,29.0,357,02,01,  Quishar,104,64,55,32,49,32,61.9,63.2,60.5,00000
58.0,74.0,29.0,357,03,01,  Khujar Gaon,307,552,129,288,178,264,35.7,30.9,40.3,00000
58.0,74.0,29.0,362,01,01,  Disaluk,192,163,95,77,97,86,54.1,55.2,53.0,00000
58.0,74.0,29.0,362,02,01,  Bairidalon,113,103,48,46,65,57,52.3,51.1,53.3,00000
58.0,74.0,29.0,362,03,01,  Kania,138,379,66,194,72,185,26.7,25.4,28.0,00000
58.0,74.0,29.0,362,04,01,  Ghanasam Pur,16,33,7,11,9,22,32.7,38.9,29.0,00000
58.0,74.0,29.0,658,01,01,  Malliksarai,595,332,364,162,231,170,64.2,69.2,57.6,00000
58.0,74.0,29.0,658,02,01,  Khelgaon,136,40,66,21,70,19,77.3,75.9,78.7,00000
58.0,74.0,29.0,725,01,01,  Nabinagar,336,264,162,127,174,137,56.0,56.1,55.9,00000
58.0,74.0,29.0,725,02,01,  Narayan Pur,46,41,21,21,25,20,52.9,50.0,55.6,00000
58.0,74.0,29.0,865,01,01,  Dari Barman,19,10,7,6,12,4,65.5,53.8,75.0,00000
58.0,74.0,29.0,865,02,01,  Kamar Kapan,62,11,30,3,32,8,84.9,90.9,80.0,00000
58.0,74.0,29.0,865,03,01,  Roysree,688,458,336,210,352,248,60.0,61.5,58.7,00000
58.0,74.0,29.0,865,04,01,  Manoharkona,379,207,195,93,184,114,64.7,67.7,61.7,00000
58.0,74.0,29.0,865,05,01,  Singkapan Dakshin,50,13,26,5,24,8,79.4,83.9,75.0,00000
58.0,74.0,29.0,989,01,01,  Uluail,690,332,374,162,316,170,67.5,69.8,65.0,00000
58.0,74.0,29.0,989,02,01,  Matherpur,140,106,83,51,57,55,56.9,61.9,50.9,00000
58.0,74.0,29.0,989,03,01,  Bad Uluail,131,187,69,87,62,100,41.2,44.2,38.3,00000
58.0,74.0,29.0,994,01,01,  Uttar Molaim,344,214,179,99,165,115,61.6,64.4,58.9,00000
58.0,74.0,29.0,994,02,01,  Salamatpur,25,6,13,3,12,3,80.6,81.3,80.0,00000
58.0,74.0,29.0,994,03,01,  Dasahal,47,24,26,13,21,11,66.2,66.7,65.6,00000
58.0,74.0,36.0,062,01,01,  Anikelibuda,400,605,172,300,228,305,39.8,36.4,42.8,00000
58.0,74.0,36.0,062,02,01,  Sarakhali,53,79,21,51,32,28,40.2,29.2,53.3,00000
58.0,74.0,36.0,134,01,01,  Banika,105,242,68,203,37,39,30.3,25.1,48.7,00000
58.0,74.0,36.0,134,02,01,  Goyala,47,29,22,10,25,19,61.8,68.8,56.8,00000
58.0,74.0,36.0,134,03,01,  Daria Mahal,33,56,19,23,14,33,37.1,45.2,29.8,00000
58.0,74.0,36.0,559,01,01,  Barabim,373,144,189,67,184,77,72.1,73.8,70.5,00000
58.0,74.0,36.0,559,02,01,  Kaliargaon,132,99,64,48,68,51,57.1,57.1,57.1,00000
58.0,74.0,36.0,559,03,01,  Nijbag,89,51,46,19,43,32,63.6,70.8,57.3,00000
58.0,74.0,36.0,813,01,01,  Radhakantapur,513,334,262,145,251,189,60.6,64.4,57.0,00000
58.0,74.0,36.0,813,02,01,  Karimnagar,229,54,136,30,93,24,80.9,81.9,79.5,00000
58.0,74.0,43.0,010,01,01,  Abdalpur,765,461,380,195,385,266,62.4,66.1,59.1,00000
58.0,74.0,43.0,010,02,01,  Ainpur,63,77,29,36,34,41,45.0,44.6,45.3,00000
58.0,74.0,43.0,010,03,01,  Azmani,121,77,57,26,64,51,61.1,68.7,55.7,00000
58.0,74.0,43.0,010,04,01,  Ramergaon,134,170,66,86,68,84,44.1,43.4,44.7,00000
58.0,74.0,43.0,176,01,01,  Uttar Baranti,655,550,321,251,334,299,54.4,56.1,52.8,00000
58.0,74.0,43.0,176,02,01,  Uttar Nandipur,198,105,106,41,92,64,65.3,72.1,59.0,00000
58.0,74.0,43.0,176,03,01,  Taipati,78,42,37,19,41,23,65.0,66.1,64.1,00000
58.0,74.0,43.0,176,04,01,  Maij Baranti,328,223,155,110,173,113,59.5,58.5,60.5,00000
58.0,74.0,43.0,176,05,01,  Dakshin Baranti,323,316,157,141,166,175,50.5,52.7,48.7,00000
58.0,74.0,43.0,176,06,01,  Pabiura,160,86,75,33,85,53,65.0,69.4,61.6,00000
58.0,74.0,43.0,176,07,01,  Dayalnagar,195,103,108,44,87,59,65.4,71.1,59.6,00000
58.0,74.0,43.0,176,08,01,  Sunampur,236,223,117,106,119,117,51.4,52.5,50.4,00000
58.0,74.0,43.0,176,09,01,  Radhanagar,84,63,38,25,46,38,57.1,60.3,54.8,00000
58.0,74.0,43.0,176,10,01,  Chintamoni,131,91,67,39,64,52,59.0,63.2,55.2,00000
58.0,74.0,43.0,176,11,01,  Paschim Baranti,65,319,34,168,31,151,16.9,16.8,17.0,00000
58.0,74.0,43.0,176,12,01,  Palkapan,158,75,84,40,74,35,67.8,67.7,67.9,00000
58.0,74.0,43.0,196,01,01,  Basudebsree (Part),533,431,257,191,276,240,55.3,57.4,53.5,00000
58.0,74.0,43.0,196,02,01,  Kalishpur,424,325,217,168,207,157,56.6,56.4,56.9,00000
58.0,74.0,43.0,570,01,01,  Kamalpur,672,555,367,286,305,269,54.8,56.2,53.1,00000
58.0,74.0,43.0,570,02,01,  Dakshin Pailbhag,208,135,109,58,99,77,60.6,65.3,56.3,00000
58.0,74.0,43.0,570,03,01,  Uttar Pailbhag,71,32,31,17,40,15,68.9,64.6,72.7,00000
58.0,74.0,43.0,570,04,01,  Fazelpur,26,8,13,5,13,3,76.5,72.2,81.3,00000
58.0,74.0,43.0,570,05,01,  Paschim Pailbhag,96,103,44,63,52,40,48.2,41.1,56.5,00000
58.0,74.0,43.0,570,06,01,  Roypur,166,171,80,90,86,81,49.3,47.1,51.5,00000
58.0,74.0,43.0,899,01,01,  Mantala,19,19,8,9,11,10,50.0,47.1,52.4,00000
58.0,74.0,43.0,899,02,01,  Sampashi,306,181,177,77,129,104,62.8,69.7,55.4,00000
58.0,74.0,43.0,899,03,01,  Goalgaon,33,38,18,18,15,20,46.5,50.0,42.9,00000
58.0,74.0,43.0,974,01,01,  Trailokhya Bijoy,525,343,264,164,261,179,60.5,61.7,59.3,00000
58.0,74.0,43.0,974,02,01,  Karmacheta,31,19,15,7,16,12,62.0,68.2,57.1,00000
58.0,74.0,43.0,974,03,01,  Omarpur,164,174,82,81,82,93,48.5,50.3,46.9,00000
58.0,74.0,43.0,974,04,01,  Sharapur,174,57,90,19,84,38,75.3,82.6,68.9,00000
58.0,74.0,43.0,974,05,01,  Paschim Sarapur,79,14,41,4,38,10,84.9,91.1,79.2,00000
58.0,74.0,43.0,974,06,01,  Naliura,317,172,151,90,166,82,64.8,62.7,66.9,00000
58.0,74.0,43.0,974,07,01,  Shabnaliura,55,45,26,23,29,22,55.0,53.1,56.9,00000
58.0,74.0,43.0,974,08,01,  Gaygar,587,772,295,372,292,400,43.2,44.2,42.2,00000
58.0,74.0,43.0,974,09,01,  Uttar Nandipur,177,122,97,48,80,74,59.2,66.9,51.9,00000
58.0,74.0,51.0,005,01,01,  Abda,420,330,223,153,197,177,56.0,59.3,52.7,00000
58.0,74.0,51.0,005,02,01,  Sawnia,70,198,38,96,32,102,26.1,28.4,23.9,00000
58.0,74.0,51.0,005,03,01,  Bachendar,194,112,90,42,104,70,63.4,68.2,59.8,00000
58.0,74.0,51.0,005,04,01,  Sattyapur,34,28,16,16,18,12,54.8,50.0,60.0,00000
58.0,74.0,51.0,150,01,01,  Barahal,305,269,157,128,148,141,53.1,55.1,51.2,00000
58.0,74.0,51.0,150,02,01,  Halgar,96,28,52,17,44,11,77.4,75.4,80.0,00000
58.0,74.0,51.0,150,03,01,  Haridatta,98,91,57,39,41,52,51.9,59.4,44.1,00000
58.0,74.0,51.0,150,04,01,  Raka,93,47,47,20,46,27,66.4,70.1,63.0,00000
58.0,74.0,51.0,150,05,01,  Nagra,83,28,37,11,46,17,74.8,77.1,73.0,00000
58.0,74.0,51.0,150,06,01,  Auodatta,80,87,40,35,40,52,47.9,53.3,43.5,00000
58.0,74.0,51.0,150,07,01,  Ballabh Datta,49,36,21,17,28,19,57.6,55.3,59.6,00000
58.0,74.0,51.0,246,01,01,  Binasona,209,77,99,34,110,43,73.1,74.4,71.9,00000
58.0,74.0,51.0,246,02,01,  Rangdash,208,242,108,128,100,114,46.2,45.8,46.7,00000
58.0,74.0,51.0,246,03,01,  Kabiraji,128,76,67,33,61,43,62.7,67.0,58.7,00000
58.0,74.0,51.0,246,04,01,  Dojbali,87,45,38,19,49,26,65.9,66.7,65.3,00000
58.0,74.0,51.0,246,05,01,  Pail Para,86,102,42,51,44,51,45.7,45.2,46.3,00000
58.0,74.0,51.0,246,06,01,  Chandi Bhandar,39,10,22,6,17,4,79.6,78.6,81.0,00000
58.0,74.0,51.0,285,01,01,  Budhimantapur,1217,1234,621,564,596,670,49.7,52.4,47.1,00000
58.0,74.0,51.0,285,02,01,  Kagrakandi,139,289,58,149,81,140,32.5,28.0,36.7,00000
58.0,74.0,51.0,285,03,01,  Baghmara,44,59,19,25,25,34,42.7,43.2,42.4,00000
58.0,74.0,51.0,285,04,01,  Maij Para,214,169,112,72,102,97,55.9,60.9,51.3,00000
58.0,74.0,51.0,285,05,01,  Kandi Para,47,97,27,45,20,52,32.6,37.5,27.8,00000
58.0,74.0,51.0,285,06,01,  Bidyar Mahal,52,55,30,21,22,34,48.6,58.8,39.3,00000
58.0,74.0,51.0,285,07,01,  Islampur,74,93,41,39,33,54,44.3,51.3,37.9,00000
58.0,74.0,51.0,388,01,01,  Fatehpur,128,96,68,39,60,57,57.1,63.6,51.3,00000
58.0,74.0,51.0,388,02,01,  Datta Binesona,141,86,75,45,66,41,62.1,62.5,61.7,00000
58.0,74.0,51.0,388,03,01,  Bhanudupi,60,13,30,6,30,7,82.2,83.3,81.1,00000
58.0,74.0,51.0,388,04,01,  Dipia,80,28,53,23,27,5,74.1,69.7,84.4,00000
58.0,74.0,51.0,388,05,01,  Teknalia,74,37,38,17,36,20,66.7,69.1,64.3,00000
58.0,74.0,51.0,388,06,01,  Harmahal,52,34,37,17,15,17,60.5,68.5,46.9,00000
58.0,74.0,51.0,388,07,01,  Dhoupasha,551,321,294,125,257,196,63.2,70.2,56.7,00000
58.0,74.0,51.0,428,01,01,  Khamarikona,157,131,81,66,76,65,54.5,55.1,53.9,00000
58.0,74.0,51.0,428,02,01,  Dulia,48,29,25,16,23,13,62.3,61.0,63.9,00000
58.0,74.0,51.0,430,01,01,  Sreerampur,209,133,108,62,101,71,61.1,63.5,58.7,00000
58.0,74.0,51.0,430,02,01,  Sreeroynagar,162,147,90,81,72,66,52.4,52.6,52.2,00000
58.0,74.0,51.0,430,03,01,  Patan,453,254,228,121,225,133,64.1,65.3,62.8,00000
58.0,74.0,51.0,430,04,01,  Bajakarati,22,10,14,3,8,7,68.8,82.4,53.3,00000
58.0,74.0,51.0,575,01,01,  Kanakpur,600,402,308,192,292,210,59.9,61.6,58.2,00000
58.0,74.0,51.0,575,02,01,  Saria,98,107,55,45,43,62,47.8,55.0,41.0,00000
58.0,74.0,51.0,575,03,01,  Gaygar,105,155,58,76,47,79,40.4,43.3,37.3,00000
58.0,74.0,51.0,829,01,01,  Rajapur,120,244,50,151,70,93,33.0,24.9,42.9,00000
58.0,74.0,51.0,829,02,01,  Bara Kapan,126,81,56,37,70,44,60.9,60.2,61.4,00000
58.0,74.0,51.0,920,01,01,  Roypur,457,122,224,59,233,63,78.9,79.2,78.7,00000
58.0,74.0,51.0,920,02,01,  Mamkarpur,128,151,70,69,58,82,45.9,50.4,41.4,00000
58.0,74.0,51.0,920,03,01,  Nandipur,10,3,6,0,4,3,76.9,100.0,57.1,00000
58.0,74.0,58.0,093,01,01,  Bagharai,355,203,170,90,185,113,63.6,65.4,62.1,00000
58.0,74.0,58.0,093,02,01,  Sreechandpur,290,255,140,119,150,136,53.2,54.1,52.4,00000
58.0,74.0,58.0,269,01,01,  Brahmangoan,695,766,373,358,322,408,47.6,51.0,44.1,00000
58.0,74.0,58.0,269,02,01,  Natun Basti,322,751,178,366,144,385,30.0,32.7,27.2,00000
58.0,74.0,58.0,269,03,01,  Afrozganj Bazar,169,66,95,31,74,35,71.9,75.4,67.9,00000
58.0,74.0,58.0,383,01,01,  Mobarakpur,229,220,111,106,118,114,51.0,51.2,50.9,00000
58.0,74.0,58.0,383,02,01,  Fatehpur,336,430,161,187,175,243,43.9,46.3,41.9,00000
58.0,74.0,58.0,471,01,01,  Halimpur,282,353,128,165,154,188,44.4,43.7,45.0,00000
58.0,74.0,58.0,471,02,01,  Barbaya,112,89,58,34,54,55,55.7,63.0,49.5,00000
58.0,74.0,58.0,471,03,01,  Dewan Nagar,253,317,118,161,135,156,44.4,42.3,46.4,00000
58.0,74.0,58.0,476,01,01,  Hamarkona,570,1469,284,725,286,744,28.0,28.1,27.8,00000
58.0,74.0,58.0,476,02,01,  Daudpur,211,219,107,92,104,127,49.1,53.8,45.0,00000
58.0,74.0,58.0,476,03,01,  Kalargaon,203,71,111,35,92,36,74.1,76.0,71.9,00000
58.0,74.0,58.0,632,01,01,  Lamua,662,800,330,390,332,410,45.3,45.8,44.7,00000
58.0,74.0,58.0,632,02,01,  Chandpur,497,541,236,279,261,262,47.9,45.8,49.9,00000
58.0,74.0,58.0,730,01,01,  Nachirpur,356,343,166,163,190,180,50.9,50.5,51.4,00000
58.0,74.0,58.0,730,02,01,  Alampur,496,624,239,329,257,295,44.3,42.1,46.6,00000
58.0,74.0,65.0,295,01,01,  Chandpur,184,327,88,154,96,173,36.0,36.4,35.7,00000
58.0,74.0,65.0,295,02,01,  Manumukh Bazar,106,201,59,91,47,110,34.5,39.3,29.9,00000
58.0,74.0,65.0,440,01,01,  Ghorakhal,800,465,413,208,387,257,63.2,66.5,60.1,00000
58.0,74.0,65.0,440,02,01,  Islampur,246,54,120,27,126,27,82.0,81.6,82.4,00000
58.0,74.0,65.0,585,01,01,  Karimpur,171,326,78,161,93,165,34.4,32.6,36.0,00000
58.0,74.0,65.0,585,02,01,  Bahadurpur,309,528,152,257,157,271,36.9,37.2,36.7,00000
58.0,74.0,65.0,585,03,01,  Sreedharpur,248,493,134,242,114,251,33.5,35.6,31.2,00000
58.0,74.0,65.0,652,01,01,  Bazrakona,322,212,158,105,164,107,60.3,60.1,60.5,00000
58.0,74.0,65.0,652,02,01,  Arihal,182,120,89,49,93,71,60.3,64.5,56.7,00000
58.0,74.0,65.0,652,03,01,  Paygampur,110,67,56,23,54,44,62.1,70.9,55.1,00000
58.0,74.0,65.0,652,04,01,  Nath Para,90,38,45,11,45,27,70.3,80.4,62.5,00000
58.0,74.0,65.0,720,01,01,  Muzaffarabad,644,758,343,364,301,394,45.9,48.5,43.3,00000
58.0,74.0,65.0,720,02,01,  Sarker Bazar,183,251,89,126,94,125,42.2,41.4,42.9,00000
58.0,74.0,65.0,720,03,01,  Bade Fatehpur,341,543,169,272,172,271,38.6,38.3,38.8,00000
58.0,74.0,65.0,875,01,01,  Sadhuhati,807,665,397,334,410,331,54.8,54.3,55.3,00000
58.0,74.0,65.0,875,02,01,  Purba Sadhuhati,1215,815,577,395,638,420,59.9,59.4,60.3,00000
58.0,74.0,65.0,875,03,01,  Sharbpur,131,470,61,226,70,244,21.8,21.3,22.3,00000
58.0,74.0,65.0,875,04,01,  Kamodpur,214,104,102,44,112,60,67.3,69.9,65.1,00000
58.0,74.0,65.0,875,05,01,  Rafinagar,133,97,59,50,74,47,57.8,54.1,61.2,00000
58.0,74.0,65.0,963,01,01,  Sumarai,305,97,157,40,148,57,75.9,79.7,72.2,00000
58.0,74.0,65.0,963,02,01,  Kakairkona,165,100,90,45,75,55,62.3,66.7,57.7,00000
58.0,74.0,80.0,170,01,01,  Harinarayan,56,22,31,11,25,11,71.8,73.8,69.4,00000
58.0,74.0,80.0,170,02,01,  Srebaur,165,86,74,48,91,38,65.7,60.7,70.5,00000
58.0,74.0,80.0,212,01,01,  Baurgharia,460,138,236,65,224,73,76.9,78.4,75.4,00000
58.0,74.0,80.0,212,02,01,  Chand Pur,54,8,26,4,28,4,87.1,86.7,87.5,00000
58.0,74.0,80.0,314,01,01,  Dakshin Gayghar,473,573,214,268,259,305,45.2,44.4,45.9,00000
58.0,74.0,80.0,314,02,01,  Roma Ballab,51,5,21,2,30,3,91.1,91.3,90.9,00000
58.0,74.0,80.0,393,01,01,  Bade Sampasi,21,9,14,6,7,3,70.0,70.0,70.0,00000
58.0,74.0,80.0,393,02,01,  Dakshin Sampasi,667,227,344,93,323,134,74.6,78.7,70.7,00000
58.0,74.0,80.0,393,03,01,  Jhinaikiasta,32,14,15,5,17,9,69.6,75.0,65.4,00000
58.0,74.0,80.0,404,01,01,  Kuter Mohal,116,108,62,55,54,53,51.8,53.0,50.5,00000
58.0,74.0,80.0,404,02,01,  Gandharbapur,447,234,240,119,207,115,65.6,66.9,64.3,00000
58.0,74.0,80.0,432,01,01,  Kuchar Mahal,145,68,77,27,68,41,68.1,74.0,62.4,00000
58.0,74.0,80.0,432,02,01,  Gharua,393,173,209,84,184,89,69.4,71.3,67.4,00000
58.0,74.0,80.0,432,03,01,  Hilal Pur,1149,408,572,204,577,204,73.8,73.7,73.9,00000
58.0,74.0,80.0,507,01,01,  Jagannathpur,1923,421,1008,194,915,227,82.0,83.9,80.1,00000
58.0,74.0,80.0,507,02,01,  Uttar Jagannathpur,287,268,133,141,154,127,51.7,48.5,54.8,00000
58.0,74.0,80.0,507,03,01,  Dakshin Jagannathpur,626,368,316,192,310,176,63.0,62.2,63.8,00000
58.0,74.0,80.0,507,04,01,  Lama Jaganath Pur,603,307,315,139,288,168,66.3,69.4,63.2,00000
58.0,74.0,80.0,518,01,01,  Fatehpur,128,22,54,9,74,13,85.3,85.7,85.1,00000
58.0,74.0,80.0,518,02,01,  Kamla Kalas,37,4,20,1,17,3,90.2,95.2,85.0,00000
58.0,74.0,80.0,518,03,01,  Jagatsi,669,558,346,253,323,305,54.5,57.8,51.4,00000
58.0,74.0,80.0,518,04,01,  Folaun,168,152,80,74,88,78,52.5,51.9,53.0,00000
58.0,74.0,80.0,637,01,01,  Lauragar R.F,276,136,159,63,117,73,67.0,71.6,61.6,00000
58.0,74.0,80.0,637,02,01,  Goala Bari,66,142,35,72,31,70,31.7,32.7,30.7,00000
58.0,74.0,80.0,684,01,01,  Mostafapur,1199,528,602,226,597,302,69.4,72.7,66.4,00000
58.0,74.0,80.0,684,02,01,  Islambagh,553,150,285,79,268,71,78.7,78.3,79.1,00000
58.0,74.0,80.0,684,04,01,  Pagolya,755,340,382,148,373,192,68.9,72.1,66.0,00000
58.0,74.0,80.0,684,05,01,  Pachim Mostafa Pur,258,359,121,174,137,185,41.8,41.0,42.5,00000
58.0,74.0,87.0,077,01,01,  Uttar Atghar,210,283,118,152,92,131,42.6,43.7,41.3,00000
58.0,74.0,87.0,077,02,01,  Natonchak Atghar,115,89,56,43,59,46,56.4,56.6,56.2,00000
58.0,74.0,87.0,077,03,01,  Puranchak Atghar,140,134,65,65,75,69,51.1,50.0,52.1,00000
58.0,74.0,87.0,077,04,01,  Dararpar,327,167,154,74,173,93,66.2,67.5,65.0,00000
58.0,74.0,87.0,077,05,01,  Purba Atghar,124,26,58,10,66,16,82.7,85.3,80.5,00000
58.0,74.0,87.0,077,06,01,  Kalyanpur,231,405,111,187,120,218,36.3,37.2,35.5,00000
58.0,74.0,87.0,077,07,01,  Jatorpur,181,179,98,87,83,92,50.3,53.0,47.4,00000
58.0,74.0,87.0,077,08,01,  Daspara,241,159,112,75,129,84,60.3,59.9,60.6,00000
58.0,74.0,87.0,077,09,01,  Maijpara,177,196,94,96,83,100,47.5,49.5,45.4,00000
58.0,74.0,87.0,108,01,01,  Baidyajanti,227,128,115,61,112,67,63.9,65.3,62.6,00000
58.0,74.0,87.0,108,02,01,  Sreepur,101,42,42,16,59,26,70.6,72.4,69.4,00000
58.0,74.0,87.0,165,01,01,  Baraiuri,458,219,223,117,235,102,67.7,65.6,69.7,00000
58.0,74.0,87.0,165,02,01,  Haji Miskin,296,280,133,138,163,142,51.4,49.1,53.4,00000
58.0,74.0,87.0,300,01,01,  Chhikarail,528,253,241,121,287,132,67.6,66.6,68.5,00000
58.0,74.0,87.0,300,02,01,  Shun Gori,63,46,31,20,32,26,57.8,60.8,55.2,00000
58.0,74.0,87.0,326,01,01,  Dashkahania,275,327,121,165,154,162,45.7,42.3,48.7,00000
58.0,74.0,87.0,326,02,01,  Baraikhali,99,91,49,43,50,48,52.1,53.3,51.0,00000
58.0,74.0,87.0,326,03,01,  Damdasi,18,25,9,15,9,10,41.9,37.5,47.4,00000
58.0,74.0,87.0,367,01,01,  Birampur,27,34,15,13,12,21,44.3,53.6,36.4,00000
58.0,74.0,87.0,367,02,01,  Dughar,395,286,179,136,216,150,58.0,56.8,59.0,00000
58.0,74.0,87.0,435,01,01,  Ghorachhao,365,210,173,90,192,120,63.5,65.8,61.5,00000
58.0,74.0,87.0,435,02,01,  Bhugor Kangsail,51,32,25,16,26,16,61.4,61.0,61.9,00000
58.0,74.0,87.0,435,03,01,  Ramkona,74,44,33,20,41,24,62.7,62.3,63.1,00000
58.0,74.0,87.0,528,01,01,  Jhakandi,867,380,440,173,427,207,69.5,71.8,67.4,00000
58.0,74.0,87.0,528,02,01,  Swalpajhakandi,208,188,91,97,117,91,52.5,48.4,56.3,00000
58.0,74.0,87.0,627,01,01,  Lambadharpur,262,190,132,90,130,100,58.0,59.5,56.5,00000
58.0,74.0,87.0,627,02,01,  Gobindapur,152,86,73,54,79,32,63.9,57.5,71.2,00000
58.0,74.0,87.0,627,03,01,  Mordonhal,188,123,86,60,102,63,60.5,58.9,61.8,00000
58.0,74.0,87.0,627,04,01,  Batuakhali,67,38,27,16,40,22,63.8,62.8,64.5,00000
58.0,74.0,87.0,746,01,01,  Narayan Pasha(Purba),370,183,198,68,172,115,66.9,74.4,59.9,00000
58.0,74.0,87.0,746,02,01,  Narayan Pasha(Pashim),179,223,88,88,91,135,44.5,50.0,40.3,00000
58.0,74.0,87.0,746,03,01,  Uttar Narayan Pasha,139,205,69,101,70,104,40.4,40.6,40.2,00000
58.0,74.0,87.0,746,04,01,  Noagaon,183,409,64,231,119,178,30.9,21.7,40.1,00000
58.0,74.0,94.0,088,01,01,  Goahori,85,56,38,30,47,26,60.3,55.9,64.4,00000
58.0,74.0,94.0,088,02,01,  Athangiri Nij,173,510,79,238,94,272,25.3,24.9,25.7,00000
58.0,74.0,94.0,088,03,01,  Athangiri,863,1250,409,595,454,655,40.8,40.7,40.9,00000
58.0,74.0,94.0,088,04,01,  Weshankar,162,254,71,136,91,118,38.9,34.3,43.5,00000
58.0,74.0,94.0,248,01,01,  Binnigram,361,568,165,279,196,289,38.9,37.2,40.4,00000
58.0,74.0,94.0,248,02,01,  Shekherezra,283,208,133,98,150,110,57.6,57.6,57.7,00000
58.0,74.0,94.0,248,03,01,  Simulia,169,496,76,234,93,262,25.4,24.5,26.2,00000
58.0,74.0,94.0,248,04,01,  Melanpur,94,57,41,24,53,33,62.3,63.1,61.6,00000
58.0,74.0,94.0,248,05,01,  Lakair Kandi,34,129,15,63,19,66,20.9,19.2,22.4,00000
58.0,74.0,94.0,554,01,01,  Kagabala,989,1047,494,474,495,573,48.6,51.0,46.3,00000
58.0,74.0,94.0,554,02,01,  Boratala,196,365,100,176,96,189,34.9,36.2,33.7,00000
58.0,74.0,94.0,554,03,01,  Upper Kagabala,255,707,119,352,136,355,26.5,25.3,27.7,00000
58.0,74.0,94.0,772,01,01,  Metopur,132,160,56,73,76,87,45.2,43.4,46.6,00000
58.0,74.0,94.0,772,02,01,  Elash Pur,85,155,40,83,45,72,35.4,32.5,38.5,00000
58.0,74.0,94.0,772,03,01,  Padunapur,520,389,254,193,266,196,57.2,56.8,57.6,00000
58.0,80.0,10.0,049,01,01,  Antehari,955,370,470,176,485,194,72.1,72.8,71.4,00000
58.0,80.0,10.0,049,02,01,  Sonapur,180,240,101,115,79,125,42.9,46.8,38.7,00000
58.0,80.0,10.0,127,01,01,  Purba Berkuri,713,330,343,140,370,190,68.4,71.0,66.1,00000
58.0,80.0,10.0,127,02,01,  Pachim Berkuri,571,194,303,80,268,114,74.6,79.1,70.2,00000
58.0,80.0,10.0,127,03,01,  Hamidpur,950,431,481,180,469,251,68.8,72.8,65.1,00000
58.0,80.0,10.0,127,04,01,  Bilbari,449,104,218,44,231,60,81.2,83.2,79.4,00000
58.0,80.0,10.0,127,05,01,  Lamabil Bari,186,49,89,21,97,28,79.1,80.9,77.6,00000
58.0,80.0,10.0,127,06,01,  Jatrapur,183,34,89,16,94,18,84.3,84.8,83.9,00000
58.0,80.0,10.0,127,07,01,  Muniarpur,528,505,251,237,277,268,51.1,51.4,50.8,00000
58.0,80.0,10.0,127,08,01,  Purba Tulapur,321,94,148,39,173,55,77.3,79.1,75.9,00000
58.0,80.0,10.0,127,09,01,  Pachim Tulapur,469,183,232,78,237,105,71.9,74.8,69.3,00000
58.0,80.0,10.0,127,10,01,  Mokam Bazar,525,118,274,51,251,67,81.6,84.3,78.9,00000
58.0,80.0,10.0,341,01,01,  Fatehpur,552,487,271,248,281,239,53.1,52.2,54.0,00000
58.0,80.0,10.0,341,02,01,  Sabazpur,408,210,198,110,210,100,66.0,64.3,67.7,00000
58.0,80.0,10.0,831,01,01,  Sadapur,344,365,151,180,193,185,48.5,45.6,51.1,00000
58.0,80.0,10.0,831,02,01,  Barigaon,399,251,187,103,212,148,61.4,64.5,58.9,00000
58.0,80.0,10.0,831,03,01,  Chuabali,466,453,210,200,256,253,50.7,51.2,50.3,00000
58.0,80.0,10.0,831,04,01,  Gobindapur,363,140,176,57,187,83,72.2,75.5,69.3,00000
58.0,80.0,21.0,021,01,01,  Metipur,319,546,141,252,178,294,36.9,35.9,37.7,00000
58.0,80.0,21.0,021,02,01,  Bholanagar,75,180,33,85,42,95,29.4,28.0,30.7,00000
58.0,80.0,21.0,021,03,01,  Kamar Chak,302,430,142,209,160,221,41.3,40.5,42.0,00000
58.0,80.0,21.0,021,04,01,  Adampur,305,428,149,194,156,234,41.6,43.4,40.0,00000
58.0,80.0,21.0,021,05,01,  Gobindapur,285,191,122,83,163,108,59.9,59.5,60.1,00000
58.0,80.0,21.0,021,06,01,  Dastidarer Chak,208,229,101,123,107,106,47.6,45.1,50.2,00000
58.0,80.0,21.0,028,01,01,  Islampur,533,1227,212,611,321,616,30.3,25.8,34.3,00000
58.0,80.0,21.0,028,02,01,  Hatikaria,483,591,214,296,269,295,45.0,42.0,47.7,00000
58.0,80.0,21.0,028,03,01,  Dakshin Karia,308,454,119,211,189,243,40.4,36.1,43.8,00000
58.0,80.0,21.0,028,04,01,  Teghari,135,182,51,82,84,100,42.6,38.3,45.7,00000
58.0,80.0,21.0,227,01,01,  Chati,313,424,143,210,170,214,42.5,40.5,44.3,00000
58.0,80.0,21.0,227,02,01,  Malaghar,201,254,93,122,108,132,44.2,43.3,45.0,00000
58.0,80.0,21.0,227,03,01,  Konagoan,42,56,19,21,23,35,42.9,47.5,39.7,00000
58.0,80.0,21.0,326,01,01,  Ekasantosh,115,208,48,105,67,103,35.6,31.4,39.4,00000
58.0,80.0,21.0,326,02,01,  Tupir Mahal+Tikarpara,90,111,39,50,51,61,44.8,43.8,45.5,00000
58.0,80.0,21.0,472,01,01,  Jalalpur,98,133,51,68,47,65,42.4,42.9,42.0,00000
58.0,80.0,21.0,472,02,01,  Shyamerkona,348,493,158,229,190,264,41.4,40.8,41.9,00000
58.0,80.0,21.0,472,03,01,  Noagaon,228,200,108,107,120,93,53.3,50.2,56.3,00000
58.0,80.0,21.0,472,04,01,  Gobindapur,72,70,36,27,36,43,50.7,57.1,45.6,00000
58.0,80.0,21.0,596,01,01,  Lamakandi,93,41,45,18,48,23,69.4,71.4,67.6,00000
58.0,80.0,21.0,596,02,01,  Mohondas Pur,42,12,17,6,25,6,77.8,73.9,80.6,00000
58.0,80.0,21.0,596,03,01,  Kashipur,14,6,7,1,7,5,70.0,87.5,58.3,00000
58.0,80.0,21.0,625,01,01,  Mahatabpur,130,120,62,55,68,65,52.0,53.0,51.1,00000
58.0,80.0,21.0,625,02,01,  Santakul,117,50,50,23,67,27,70.1,68.5,71.3,00000
58.0,80.0,21.0,653,01,01,  Maricha,596,415,285,187,311,228,59.0,60.4,57.7,00000
58.0,80.0,21.0,653,02,01,  Maulvir Chak,497,519,209,237,288,282,48.9,46.9,50.5,00000
58.0,80.0,21.0,653,03,01,  Palpur,156,169,70,84,86,85,48.0,45.5,50.3,00000
58.0,80.0,21.0,781,01,01,  Premnagar,119,326,46,151,73,175,26.7,23.4,29.4,00000
58.0,80.0,21.0,781,02,01,  Khas Premnagar,422,778,193,371,229,407,35.2,34.2,36.0,00000
58.0,80.0,21.0,945,01,01,  Tara Pasha,237,187,114,84,123,103,55.9,57.6,54.4,00000
58.0,80.0,21.0,945,02,01,  Abdha Dasghari,380,177,197,73,183,104,68.2,73.0,63.8,00000
58.0,80.0,21.0,945,03,01,  Jangali,182,171,78,73,104,98,51.6,51.7,51.5,00000
58.0,80.0,21.0,945,04,01,  Kazir Chak,118,76,59,31,59,45,60.8,65.6,56.7,00000
58.0,80.0,31.0,476,01,01,  Jaua,95,173,45,88,50,85,35.4,33.8,37.0,00000
58.0,80.0,31.0,476,02,01,  Banarai,504,759,231,375,273,384,39.9,38.1,41.6,00000
58.0,80.0,31.0,540,01,01,  Huraria,167,231,76,124,91,107,42.0,38.0,46.0,00000
58.0,80.0,31.0,540,02,01,  Katajuri,376,271,192,145,184,126,58.1,57.0,59.4,00000
58.0,80.0,31.0,540,03,01,  Gobindabati,137,53,70,20,67,33,72.1,77.8,67.0,00000
58.0,80.0,31.0,611,01,01,  Mahalal,450,357,221,191,229,166,55.8,53.6,58.0,00000
58.0,80.0,31.0,611,02,01,  Dakshin Mahalal,223,156,111,91,112,65,58.8,55.0,63.3,00000
58.0,80.0,31.0,611,03,01,  Dhaniura,70,49,41,28,29,21,58.8,59.4,58.0,00000
58.0,80.0,31.0,646,01,01,  Mansurnagar,713,619,331,298,382,321,53.5,52.6,54.3,00000
58.0,80.0,31.0,646,02,01,  Modipur,245,424,114,217,131,207,36.6,34.4,38.8,00000
58.0,80.0,31.0,646,03,01,  Chikka,39,356,16,187,23,169,9.9,7.9,12.0,00000
58.0,80.0,31.0,646,04,01,  Tarachunga,250,695,98,322,152,373,26.5,23.3,29.0,00000
58.0,80.0,31.0,760,01,01,  Parchakra,300,811,153,381,147,430,27.0,28.7,25.5,00000
58.0,80.0,31.0,760,02,01,  Fakirtala,90,185,41,83,49,102,32.7,33.1,32.5,00000
58.0,80.0,31.0,874,01,01,  Sasmahal,368,251,179,123,189,128,59.5,59.3,59.6,00000
58.0,80.0,31.0,874,02,01,  Premnagar,230,332,115,145,115,187,40.9,44.2,38.1,00000
58.0,80.0,31.0,888,01,01,  Bara Kapan,295,378,143,181,152,197,43.8,44.1,43.6,00000
58.0,80.0,31.0,888,02,01,  Pan Sansar,607,171,320,84,287,87,78.0,79.2,76.7,00000
58.0,80.0,42.0,042,01,01,  Anchhargaon,340,305,177,137,163,168,52.7,56.4,49.2,00000
58.0,80.0,42.0,042,02,01,  Bangali,321,192,161,92,160,100,62.6,63.6,61.5,00000
58.0,80.0,42.0,187,01,01,  Kazirhati,196,221,81,110,115,111,47.0,42.4,50.9,00000
58.0,80.0,42.0,187,02,01,  Tikar Para,95,50,48,23,47,27,65.5,67.6,63.5,00000
58.0,80.0,42.0,255,01,01,  Sonatiki,409,263,185,120,224,143,60.9,60.7,61.0,00000
58.0,80.0,42.0,255,02,01,  Pathergaon,131,454,53,233,78,221,22.4,18.5,26.1,00000
58.0,80.0,42.0,255,03,01,  Islampur Miarkandi,251,155,128,71,123,84,61.8,64.3,59.4,00000
58.0,80.0,42.0,255,04,01,  Uttar Khalagaon,575,406,282,205,293,201,58.6,57.9,59.3,00000
58.0,80.0,42.0,255,05,01,  Noatilla Dakshin Khalagaon,644,567,298,286,346,281,53.2,51.0,55.2,00000
58.0,80.0,42.0,255,06,01,  Madhya Khalagaon,983,243,504,124,479,119,80.2,80.3,80.1,00000
58.0,80.0,42.0,255,07,01,  Karimpur,817,757,369,366,448,391,51.9,50.2,53.4,00000
58.0,80.0,42.0,255,09,01,  Suprakandi,232,400,105,198,127,202,36.7,34.7,38.6,00000
58.0,80.0,42.0,255,10,01,  Barapathar,322,407,163,190,159,217,44.2,46.2,42.3,00000
58.0,80.0,42.0,255,11,01,  Miarpara,159,52,76,28,83,24,75.4,73.1,77.6,00000
58.0,80.0,42.0,717,01,01,  Jamura,252,383,115,171,137,212,39.7,40.2,39.3,00000
58.0,80.0,42.0,717,02,01,  Nidanpur,623,808,274,390,349,418,43.5,41.3,45.5,00000
58.0,80.0,52.0,099,01,01,  Banait,17,71,7,28,10,43,19.3,20.0,18.9,00000
58.0,80.0,52.0,099,02,01,  Badekubjar,103,175,55,80,48,95,37.1,40.7,33.6,00000
58.0,80.0,52.0,163,01,01,  Bhumiura,479,279,260,121,219,158,63.2,68.2,58.1,00000
58.0,80.0,52.0,163,02,01,  Surnanda,489,389,231,177,258,212,55.7,56.6,54.9,00000
58.0,80.0,52.0,163,03,01,  Bageshwar,204,228,99,111,105,117,47.2,47.1,47.3,00000
58.0,80.0,52.0,547,01,01,  Keola,148,319,59,156,89,163,31.7,27.4,35.3,00000
58.0,80.0,52.0,547,02,01,  Dheurband,108,185,37,98,71,87,36.9,27.4,44.9,00000
58.0,80.0,52.0,547,03,01,  Mokua Shuta,194,181,92,90,102,91,51.7,50.5,52.8,00000
58.0,80.0,52.0,575,01,01,  Sasyasuta,41,24,20,9,21,15,63.1,69.0,58.3,00000
58.0,80.0,52.0,575,02,01,  Kubjhar,264,219,122,108,142,111,54.7,53.0,56.1,00000
58.0,80.0,52.0,746,01,01,  Jalalpur,391,198,167,84,224,114,66.4,66.5,66.3,00000
58.0,80.0,52.0,746,02,01,  Panchgaon,761,603,383,287,378,316,55.8,57.2,54.5,00000
58.0,80.0,52.0,746,03,01,  Petgaon (Part),277,288,128,146,149,142,49.0,46.7,51.2,00000
58.0,80.0,52.0,767,01,01,  Kanikiari,193,193,81,99,112,94,50.0,45.0,54.4,00000
58.0,80.0,52.0,767,02,01,  Paschimbagh,691,618,339,326,352,292,52.8,51.0,54.7,00000
58.0,80.0,52.0,881,01,01,  Rajkhla,464,286,234,130,230,156,61.9,64.3,59.6,00000
58.0,80.0,52.0,881,02,01,  Satru Mardan,303,250,142,116,161,134,54.8,55.0,54.6,00000
58.0,80.0,52.0,902,01,01,  Sreebhog,157,300,75,136,82,164,34.4,35.5,33.3,00000
58.0,80.0,52.0,902,02,01,  Khanikhul,47,62,26,26,21,36,43.1,50.0,36.8,00000
58.0,80.0,63.0,262,01,01,  Uttar Daspara,152,236,72,113,80,123,39.2,38.9,39.4,00000
58.0,80.0,63.0,262,02,01,  Dakshin Daspara,561,596,261,299,300,297,48.5,46.6,50.3,00000
58.0,80.0,63.0,355,01,03,  Gargoan Main,605,1427,336,685,269,742,29.8,32.9,26.6,00000
58.0,80.0,63.0,355,02,03,  Uttar Gargoan,489,791,239,371,250,420,38.2,39.2,37.3,00000
58.0,80.0,63.0,355,03,03,  Khar Para,515,211,263,81,252,130,70.9,76.5,66.0,00000
58.0,80.0,63.0,355,04,03,  Sahebpur,87,164,34,79,53,85,34.7,30.1,38.4,00000
58.0,80.0,63.0,355,05,03,  Dakshin Gargaon,665,679,341,320,324,359,49.5,51.6,47.4,00000
58.0,80.0,63.0,355,06,03,  Lamapara,29,96,13,53,16,43,23.2,19.7,27.1,00000
58.0,80.0,63.0,355,07,03,  Manir Para,129,61,71,26,58,35,67.9,73.2,62.4,00000
58.0,80.0,63.0,540,01,01,  Goyghar,45,78,28,42,17,36,36.6,40.0,32.1,00000
58.0,80.0,63.0,540,02,01,  Harina Changa,312,220,189,113,123,107,58.6,62.6,53.5,00000
58.0,80.0,63.0,618,01,03,  Patantuli,287,62,150,29,137,33,82.2,83.8,80.6,00000
58.0,80.0,63.0,618,02,03,  Mahasahasra,426,391,216,193,210,198,52.1,52.8,51.5,00000
58.0,80.0,63.0,618,03,03,  Padinapur,402,114,201,58,201,56,77.9,77.6,78.2,00000
58.0,80.0,63.0,632,01,01,  Majidpur,394,148,193,60,201,88,72.7,76.3,69.6,00000
58.0,80.0,63.0,632,02,01,  Bhabaninagar,125,110,57,52,68,58,53.2,52.3,54.0,00000
58.0,80.0,63.0,710,01,01,  Nandiura,931,740,422,391,509,349,55.7,51.9,59.3,00000
58.0,80.0,63.0,710,02,01,  Murali,286,203,126,95,160,108,58.5,57.0,59.7,00000
58.0,80.0,63.0,795,01,01,  Rajnagar,366,474,165,225,201,249,43.6,42.3,44.7,00000
58.0,80.0,63.0,795,02,01,  Bajua,187,154,100,80,87,74,54.8,55.6,54.0,00000
58.0,80.0,63.0,795,03,01,  Premnagar,134,60,71,21,63,39,69.1,77.2,61.8,00000
58.0,80.0,63.0,795,04,01,  Parshi Para,149,344,71,173,78,171,30.2,29.1,31.3,00000
58.0,80.0,73.0,014,01,01,  Adamabad,119,158,63,75,56,83,43.0,45.7,40.3,00000
58.0,80.0,73.0,014,02,01,  Konagoan,200,252,85,115,115,137,44.2,42.5,45.6,00000
58.0,80.0,73.0,014,03,01,  Togarpur,77,294,43,138,34,156,20.8,23.8,17.9,00000
58.0,80.0,73.0,319,01,01,  Ekamadhu,187,685,81,340,106,345,21.4,19.2,23.5,00000
58.0,80.0,73.0,319,02,01,  Akua,176,259,78,120,98,139,40.5,39.4,41.4,00000
58.0,80.0,73.0,319,03,01,  Kandirkul,141,274,67,120,74,154,34.0,35.8,32.5,00000
58.0,80.0,73.0,319,05,01,  Ganeshpur,285,168,134,66,151,102,62.9,67.0,59.7,00000
58.0,80.0,73.0,419,01,01,  Hari Pasha,302,485,147,244,155,241,38.4,37.6,39.1,00000
58.0,80.0,73.0,419,02,01,  Ibrahimpur,169,185,71,93,98,92,47.7,43.3,51.6,00000
58.0,80.0,73.0,433,01,03,  Ilaspur,493,409,247,204,246,205,54.7,54.8,54.5,00000
58.0,80.0,73.0,433,02,03,  Daibasti,260,741,121,374,139,367,26.0,24.4,27.5,00000
58.0,80.0,73.0,433,03,03,  Dahkin Ilas Pur,195,416,108,190,87,226,31.9,36.2,27.8,00000
58.0,80.0,73.0,483,01,01,  Kachhari,298,546,142,274,156,272,35.3,34.1,36.4,00000
58.0,80.0,73.0,483,02,01,  Rubari,67,373,28,164,39,209,15.2,14.6,15.7,00000
58.0,80.0,73.0,525,01,01,  Kashipur,295,367,140,164,155,203,44.6,46.1,43.3,00000
58.0,80.0,73.0,525,02,01,  Badar Pur,2,42,0,17,2,25,4.5,0.0,7.4,00000
58.0,80.0,73.0,739,01,01,  Paik Para,202,300,99,149,103,151,40.2,39.9,40.6,00000
58.0,80.0,73.0,739,02,01,  Karatal,197,219,107,103,90,116,47.4,51.0,43.7,00000
58.0,80.0,73.0,739,03,01,  Hariharpur,305,219,156,113,149,106,58.2,58.0,58.4,00000
58.0,80.0,73.0,739,04,01,  Rambadra Pur,270,210,132,96,138,114,56.3,57.9,54.8,00000
58.0,80.0,73.0,803,01,01,  Rajnagar T.G.,826,2613,496,1256,330,1357,24.0,28.3,19.6,00000
58.0,80.0,73.0,803,02,01,  Panditnagar,161,816,61,387,100,429,16.5,13.6,18.9,00000
58.0,80.0,73.0,845,01,01,  Saidnagar,349,486,149,270,200,216,41.8,35.6,48.1,00000
58.0,80.0,73.0,845,02,01,  Dala,99,166,70,121,29,45,37.4,36.6,39.2,00000
58.0,80.0,73.0,852,01,01,  Salan,311,344,142,176,169,168,47.5,44.7,50.1,00000
58.0,80.0,73.0,852,02,01,  Royngichara,181,430,71,224,110,206,29.6,24.1,34.8,00000
58.0,80.0,73.0,852,03,01,  Hurarai,212,329,84,146,128,183,39.2,36.5,41.2,00000
58.0,80.0,84.0,078,01,01,  Baksipur,218,170,107,92,111,78,56.2,53.8,58.7,00000
58.0,80.0,84.0,078,02,01,  Sikkagaon,90,414,45,205,45,209,17.9,18.0,17.7,00000
58.0,80.0,84.0,078,03,01,  Shimultala,115,67,57,27,58,40,63.2,67.9,59.2,00000
58.0,80.0,84.0,191,01,01,  Chandbhag,500,509,229,261,271,248,49.6,46.7,52.2,00000
58.0,80.0,84.0,191,02,01,  Maidlong,176,182,78,98,98,84,49.2,44.3,53.8,00000
58.0,80.0,84.0,191,03,01,  Tegharia,219,166,99,77,120,89,56.9,56.3,57.4,00000
58.0,80.0,84.0,383,01,01,  Haldigol,484,371,238,170,246,201,56.6,58.3,55.0,00000
58.0,80.0,84.0,383,02,01,  Nayatila,72,325,36,151,36,174,18.1,19.3,17.1,00000
58.0,80.0,84.0,383,03,01,  Ganga Dasergol,323,396,176,197,147,199,44.9,47.2,42.5,00000
58.0,80.0,84.0,440,01,01,  Indanagar T.G.,1304,1809,678,854,626,955,41.9,44.3,39.6,00000
58.0,80.0,84.0,440,02,01,  Panpunji,275,561,131,280,144,281,32.9,31.9,33.9,00000
58.0,80.0,84.0,554,01,01,  Keshor Para,242,530,112,258,130,272,31.3,30.3,32.3,00000
58.0,80.0,84.0,554,02,01,  Jogikona,264,49,139,26,125,23,84.3,84.2,84.5,00000
58.0,80.0,84.0,724,01,01,  Nijgaon,723,312,356,130,367,182,69.9,73.3,66.8,00000
58.0,80.0,84.0,724,02,01,  Chheler Chak,253,231,120,125,133,106,52.3,49.0,55.6,00000
58.0,80.0,84.0,788,01,01,  Rajapur,310,365,151,176,159,189,45.9,46.2,45.7,00000
58.0,80.0,84.0,788,02,01,  Kaliargul,251,196,117,97,134,99,56.2,54.7,57.5,00000
58.0,80.0,84.0,831,01,01,  Rampur,290,347,131,168,159,179,45.5,43.8,47.0,00000
58.0,80.0,84.0,831,02,01,  Galimpur,362,342,168,156,194,186,51.4,51.9,51.1,00000
58.0,80.0,84.0,831,03,01,  Jorapur,291,262,139,131,152,131,52.6,51.5,53.7,00000
58.0,80.0,84.0,831,04,01,  Rostampur,109,123,46,48,63,75,47.0,48.9,45.7,00000
58.0,80.0,84.0,831,05,01,  Kolnar Char,47,43,18,18,29,25,52.2,50.0,53.7,00000
58.0,80.0,84.0,909,01,01,  Sunampur,475,561,212,280,263,281,45.8,43.1,48.3,00000
58.0,80.0,84.0,909,02,01,  Omarpur,456,577,215,262,241,315,44.1,45.1,43.3,00000
58.0,80.0,84.0,909,03,01,  Kandigaon,549,647,243,281,306,366,45.9,46.4,45.5,00000
58.0,80.0,84.0,909,04,01,  Safatpur,66,213,26,95,40,118,23.7,21.5,25.3,00000
58.0,80.0,84.0,980,01,01,  Uttarbhag,673,275,325,127,348,148,71.0,71.9,70.2,00000
58.0,80.0,84.0,980,02,01,  Haipur,498,386,239,170,259,216,56.3,58.4,54.5,00000
58.0,80.0,84.0,980,03,01,  Ular Kapan,54,77,26,39,28,38,41.2,40.0,42.4,00000
58.0,80.0,84.0,980,04,01,  Surpakandi,323,557,142,281,181,276,36.7,33.6,39.6,00000
58.0,83.0,15.0,036,01,01,  Ashidron(Purba),451,360,248,169,203,191,55.6,59.5,51.5,00000
58.0,83.0,15.0,036,02,01,  Pashim Ashidron,506,397,261,187,245,210,56.0,58.3,53.8,00000
58.0,83.0,15.0,036,03,01,  Noabari,148,221,84,109,64,112,40.1,43.5,36.4,00000
58.0,83.0,15.0,036,04,01,  Khosbus,600,469,312,204,288,265,56.1,60.5,52.1,00000
58.0,83.0,15.0,036,05,01,  Dattagram,95,41,44,16,51,25,69.9,73.3,67.1,00000
58.0,83.0,15.0,036,06,01,  Amanatpur,268,176,138,74,130,102,60.4,65.1,56.0,00000
58.0,83.0,15.0,036,07,01,  Titpur,180,306,89,147,91,159,37.0,37.7,36.4,00000
58.0,83.0,15.0,081,01,01,  Mohaziarbad,1090,885,530,395,560,490,55.2,57.3,53.3,00000
58.0,83.0,15.0,081,02,01,  M.R.Khan T.G.,85,147,57,52,28,95,36.6,52.3,22.8,00000
58.0,83.0,15.0,081,03,01,  Hosanabad T.G.,658,869,413,356,245,513,43.1,53.7,32.3,00000
58.0,83.0,15.0,081,04,01,  Tahara T.G. (Jangalbari T.G,238,715,164,319,74,396,25.0,34.0,15.7,00000
58.0,83.0,15.0,081,05,01,  Habrasar,50,39,31,16,19,23,56.2,66.0,45.2,00000
58.0,83.0,15.0,208,01,01,  Bhojpur,289,264,139,111,150,153,52.3,55.6,49.5,00000
58.0,83.0,15.0,208,02,01,  Noagaon,197,269,93,132,104,137,42.3,41.3,43.2,00000
58.0,83.0,15.0,434,01,01,  Jamsi,753,924,377,473,376,451,44.9,44.4,45.5,00000
58.0,83.0,15.0,434,02,01,  Debipur,180,103,81,45,99,58,63.6,64.3,63.1,00000
58.0,83.0,15.0,434,03,01,  Mangriat,225,204,97,101,128,103,52.4,49.0,55.4,00000
58.0,83.0,15.0,434,04,01,  Tapashi Para,313,200,157,90,156,110,61.0,63.6,58.6,00000
58.0,83.0,15.0,434,05,01,  Kazirgaon,108,134,49,57,59,77,44.6,46.2,43.4,00000
58.0,83.0,15.0,434,06,01,  Raghunathpur,117,147,62,69,55,78,44.3,47.3,41.4,00000
58.0,83.0,15.0,452,01,01,  Jiladpur,545,289,261,125,284,164,65.3,67.6,63.4,00000
58.0,83.0,15.0,452,02,01,  Matiganj,131,117,63,52,68,65,52.8,54.8,51.1,00000
58.0,83.0,15.0,452,03,01,  Horianakandi,303,231,162,104,141,127,56.7,60.9,52.6,00000
58.0,83.0,15.0,452,04,01,  Belasarpar,553,727,307,366,246,361,43.2,45.6,40.5,00000
58.0,83.0,15.0,452,05,01,  Underpar,418,478,214,231,204,247,46.7,48.1,45.2,00000
58.0,83.0,15.0,488,01,01,  Khalilpur,243,289,120,132,123,157,45.7,47.6,43.9,00000
58.0,83.0,15.0,488,02,01,  Karaitala,338,156,187,72,151,84,68.4,72.2,64.3,00000
58.0,83.0,15.0,768,01,01,  Ramnagar,2598,1043,1397,432,1201,611,71.4,76.4,66.3,00000
58.0,83.0,15.0,768,02,01,  Gazipur,493,286,244,143,249,143,63.3,63.0,63.5,00000
58.0,83.0,15.0,768,03,01,  Kawarban,191,165,79,86,112,79,53.7,47.9,58.6,00000
58.0,83.0,15.0,768,04,01,  Atghar Basti,118,128,66,62,52,66,48.0,51.6,44.1,00000
58.0,83.0,15.0,768,05,01,  Darjirkul,203,40,97,20,106,20,83.5,82.9,84.1,00000
58.0,83.0,15.0,823,01,01,  Shaitala,166,136,84,62,82,74,55.0,57.5,52.6,00000
58.0,83.0,15.0,823,02,01,  Dangarban,157,176,74,83,83,93,47.1,47.1,47.2,00000
58.0,83.0,15.0,949,01,01,  Tikria,1281,341,679,144,602,197,79.0,82.5,75.3,00000
58.0,83.0,15.0,949,02,01,  Fatki,277,160,134,68,143,92,63.4,66.3,60.9,00000
58.0,83.0,15.0,949,03,01,  Manipur Para,387,193,200,95,187,98,66.7,67.8,65.6,00000
58.0,83.0,15.0,949,04,01,  Budhair Chak,350,367,167,174,183,193,48.8,49.0,48.7,00000
58.0,83.0,15.0,949,05,01,  Dhansing Basti,2,5,1,4,1,1,28.6,20.0,50.0,00000
58.0,83.0,15.0,949,06,01,  Khondakargol,165,352,87,189,78,163,31.9,31.5,32.4,00000
58.0,83.0,19.0,018,01,01,  Alisarkul,1982,1896,973,897,1009,999,51.1,52.0,50.2,00000
58.0,83.0,19.0,018,02,01,  Rustampur,575,457,313,205,262,252,55.7,60.4,51.0,00000
58.0,83.0,28.0,578,01,01,  Maijdi,1948,1518,1004,720,944,798,56.2,58.2,54.2,00000
58.0,83.0,28.0,578,02,01,  Moainpur Guchchhagram,46,156,25,82,21,74,22.8,23.4,22.1,00000
58.0,83.0,28.0,578,03,01,  Hudar Pahar,871,1837,550,919,321,918,32.2,37.4,25.9,00000
58.0,83.0,38.0,162,01,01,  Bharaura T.G.,1156,1999,707,891,449,1108,36.6,44.2,28.8,00000
58.0,83.0,38.0,162,02,01,  Khaichhara T.G.,529,719,336,293,193,426,42.4,53.4,31.2,00000
58.0,83.0,38.0,307,01,01,  Fulchhara T.G.,677,1109,418,454,259,655,37.9,47.9,28.3,00000
58.0,83.0,38.0,307,02,01,  Kakiachhara T.G.,676,765,400,318,276,447,46.9,55.7,38.2,00000
58.0,83.0,38.0,470,01,01,  Kalighat T.G.,1196,2925,787,1295,409,1630,29.0,37.8,20.1,00000
58.0,83.0,38.0,470,02,01,  Bilaschhara Model Firm,161,425,115,163,46,262,27.5,41.4,14.9,00000
58.0,83.0,47.0,045,01,01,  Baban,151,229,86,108,65,121,39.7,44.3,34.9,00000
58.0,83.0,47.0,045,02,01,  Chatal,122,169,58,82,64,87,41.9,41.4,42.4,00000
58.0,83.0,47.0,293,01,01,  Dubarhat,670,211,332,101,338,110,76.0,76.7,75.4,00000
58.0,83.0,47.0,293,02,01,  Suilpur,420,1021,181,520,239,501,29.1,25.8,32.3,00000
58.0,83.0,47.0,443,01,01,  Kashipur,117,220,62,107,55,113,34.7,36.7,32.7,00000
58.0,83.0,47.0,443,02,01,  Jatra Pasha,474,217,236,104,238,113,68.6,69.4,67.8,00000
58.0,83.0,47.0,615,01,01,  Nischintapur,384,112,189,55,195,57,77.4,77.5,77.4,00000
58.0,83.0,47.0,615,02,01,  Mirzapur,1072,1006,513,508,559,498,51.6,50.2,52.9,00000
58.0,83.0,47.0,669,01,01,  Pahartali,263,284,133,143,130,141,48.1,48.2,48.0,00000
58.0,83.0,47.0,669,02,01,  Dinerpur T.G.,128,359,87,171,41,188,26.3,33.7,17.9,00000
58.0,83.0,47.0,795,01,01,  Shaharsree,546,931,274,448,272,483,37.0,38.0,36.0,00000
58.0,83.0,47.0,795,02,01,  Jotarpur,134,787,75,399,59,388,14.5,15.8,13.2,00000
58.0,83.0,47.0,976,01,01,  Baulachhara,443,643,243,291,200,352,40.8,45.5,36.2,00000
58.0,83.0,47.0,976,02,01,  Ramnagar (Baulachara T.G.),442,963,291,426,151,537,31.5,40.6,21.9,00000
58.0,83.0,47.0,976,03,01,  Patakhauri,167,558,113,247,54,311,23.0,31.4,14.8,00000
58.0,83.0,47.0,985,01,01,  Uttar Pachaun,317,276,152,138,165,138,53.5,52.4,54.5,00000
58.0,83.0,47.0,985,02,01,  Madubpur,212,89,106,44,106,45,70.4,70.7,70.2,00000
58.0,83.0,57.0,497,01,01,  Khejuri Chhara T.G.,1572,1661,959,660,613,1001,48.6,59.2,38.0,00000
58.0,83.0,57.0,497,02,01,  Harin Chhara T.G.,821,1248,494,560,327,688,39.7,46.9,32.2,00000
58.0,83.0,57.0,967,01,01,  Udnachhara T.G.,571,2047,365,932,206,1115,21.8,28.1,15.6,00000
58.0,83.0,57.0,967,02,01,  Bidya Bil T.G.,351,809,231,363,120,446,30.3,38.9,21.2,00000
58.0,83.0,76.0,244,01,01,  Nirala T.G.,98,487,57,250,41,237,16.8,18.6,14.7,00000
58.0,83.0,76.0,244,02,01,  Nahir T.G.,61,165,33,86,28,79,27.0,27.7,26.2,00000
58.0,83.0,76.0,244,03,01,  Chaltachhara,17,54,6,29,11,25,23.9,17.1,30.6,00000
58.0,83.0,76.0,289,01,01,  Dakshin Tok,261,400,144,193,117,207,39.5,42.7,36.1,00000
58.0,83.0,76.0,289,02,01,  Khariz Zama,351,351,194,146,157,205,50.0,57.1,43.4,00000
58.0,83.0,76.0,289,03,01,  Mandirgaon,304,230,163,119,141,111,56.9,57.8,56.0,00000
58.0,83.0,76.0,289,04,01,  Beltali,306,518,162,226,144,292,37.1,41.8,33.0,00000
58.0,83.0,76.0,289,05,01,  Ijragaon,72,96,37,41,35,55,42.9,47.4,38.9,00000
58.0,83.0,76.0,289,06,01,  Kunjaban,549,711,283,335,266,376,43.6,45.8,41.4,00000
58.0,83.0,76.0,289,07,01,  Kamargaon,463,587,223,288,240,299,44.1,43.6,44.5,00000
58.0,83.0,76.0,298,01,01,  Durganagar,751,826,398,419,353,407,47.6,48.7,46.4,00000
58.0,83.0,76.0,298,02,01,  Nolarpar,89,268,50,126,39,142,24.9,28.4,21.5,00000
58.0,83.0,76.0,298,03,01,  Birubasti,26,215,12,119,14,96,10.8,9.2,12.7,00000
58.0,83.0,76.0,379,01,01,  Hoglia,62,74,34,33,28,41,45.6,50.7,40.6,00000
58.0,83.0,76.0,379,02,01,  Tilagaon,223,424,104,208,119,216,34.5,33.3,35.5,00000
58.0,83.0,76.0,379,03,01,  Satparia,137,137,68,67,69,70,50.0,50.4,49.6,00000
58.0,83.0,76.0,379,04,01,  Sarkarergaon,115,59,53,29,62,30,66.1,64.6,67.4,00000
58.0,83.0,76.0,379,05,01,  Tiputila,28,53,15,25,13,28,34.6,37.5,31.7,00000
58.0,83.0,76.0,379,06,01,  Gangdhar,68,61,36,26,32,35,52.7,58.1,47.8,00000
58.0,83.0,76.0,379,07,01,  Katiarkona,179,185,84,78,95,107,49.2,51.9,47.0,00000
58.0,83.0,76.0,420,01,01,  Jalikanagar T.G.,114,584,70,292,44,292,16.3,19.3,13.1,00000
58.0,83.0,76.0,420,02,01,  Langliasara,203,465,127,215,76,250,30.4,37.1,23.3,00000
58.0,83.0,76.0,506,01,01,  Khoazpur,273,213,149,112,124,101,56.2,57.1,55.1,00000
58.0,83.0,76.0,506,02,01,  Gazipur,120,188,60,83,60,105,39.0,42.0,36.4,00000
58.0,83.0,76.0,506,03,01,  Kurerpar,48,91,30,39,18,52,34.5,43.5,25.7,00000
58.0,83.0,76.0,524,01,01,  Laharpur,595,401,298,176,297,225,59.7,62.9,56.9,00000
58.0,83.0,76.0,524,02,01,  Chandmari Basti,439,267,224,121,215,146,62.2,64.9,59.6,00000
58.0,83.0,76.0,524,03,01,  Dighirpar,324,243,156,110,168,133,57.1,58.6,55.8,00000
58.0,83.0,76.0,524,04,01,  Udnarpar,210,188,92,78,118,110,52.8,54.1,51.8,00000
58.0,83.0,76.0,524,05,01,  Dattergaon,178,55,95,24,83,31,76.4,79.8,72.8,00000
58.0,83.0,76.0,524,06,01,  Sikka,255,270,129,126,126,144,48.6,50.6,46.7,00000
58.0,83.0,76.0,524,07,01,  Gulgaon,323,210,171,86,152,124,60.6,66.5,55.1,00000
58.0,83.0,76.0,524,08,01,  Khilgaon,326,177,154,82,172,95,64.8,65.3,64.4,00000
58.0,83.0,76.0,524,09,01,  Bihari Basti,191,191,104,81,87,110,50.0,56.2,44.2,00000
58.0,83.0,76.0,524,10,01,  Karu Majhi Basti,83,221,34,108,49,113,27.3,23.9,30.2,00000
58.0,83.0,76.0,524,11,01,  Dogangaon,100,36,58,15,42,21,73.5,79.5,66.7,00000
58.0,83.0,76.0,524,12,01,  Rabar Bagan,110,18,84,7,26,11,85.9,92.3,70.3,00000
58.0,83.0,76.0,805,01,01,  Sarergaz,329,431,163,225,166,206,43.3,42.0,44.6,00000
58.0,83.0,76.0,805,02,01,  Sindur Khan Bazar Basti,228,84,125,32,103,52,73.1,79.6,66.5,00000
58.0,83.0,76.0,805,03,01,  Noagaon,423,642,208,324,215,318,39.7,39.1,40.3,00000
58.0,83.0,76.0,805,04,01,  Purangaon,276,370,148,166,128,204,42.7,47.1,38.6,00000
58.0,83.0,76.0,805,05,01,  Majhergaon,176,112,86,61,90,51,61.1,58.5,63.8,00000
58.0,83.0,76.0,805,06,01,  Sreegoan,185,109,86,49,99,60,62.9,63.7,62.3,00000
58.0,83.0,76.0,805,07,01,  Islampur,84,36,44,13,40,23,70.0,77.2,63.5,00000
58.0,83.0,76.0,805,08,01,  Sindur Khan Bazar,229,57,113,25,116,32,80.1,81.9,78.4,00000
58.0,83.0,76.0,823,01,01,  Shaitala,569,559,292,263,277,296,50.4,52.6,48.3,00000
58.0,83.0,76.0,823,02,01,  Ghatibasti (Ghatibasti),140,382,73,193,67,189,26.8,27.4,26.2,00000
58.0,83.0,76.0,940,01,01,  Teliabad,62,18,28,8,34,10,77.5,77.8,77.3,00000
58.0,83.0,76.0,940,02,01,  Hamidpur,216,247,103,119,113,128,46.7,46.4,46.9,00000
58.0,83.0,76.0,940,03,01,  Konagaon,61,65,26,30,35,35,48.4,46.4,50.0,00000
58.0,83.0,76.0,940,04,01,  Dighaligaon,287,180,147,68,140,112,61.5,68.4,55.6,00000
58.0,83.0,76.0,940,05,01,  Dobagaon,121,251,59,117,62,134,32.5,33.5,31.6,00000
58.0,83.0,85.0,125,01,01,  Radhanagar,459,532,256,235,203,297,46.3,52.1,40.6,00000
58.0,83.0,85.0,125,02,01,  Jarin T.G.,429,884,273,380,156,504,32.7,41.8,23.6,00000
58.0,83.0,85.0,125,03,01,  Bishamani Punji,694,485,373,205,321,280,58.9,64.5,53.4,00000
58.0,83.0,85.0,125,04,01,  Dalu Chhara,374,286,226,114,148,172,56.7,66.5,46.3,00000
58.0,83.0,85.0,125,05,01,  Dilbarnagar,241,202,136,77,105,125,54.4,63.8,45.7,00000
58.0,83.0,85.0,125,06,01,  Laua Chhara,26,77,13,37,13,40,25.2,26.0,24.5,00000
58.0,83.0,85.0,153,01,03,  Bharaura-1,938,804,489,355,449,449,53.8,57.9,50.0,00000
58.0,83.0,85.0,153,02,03,  Beraimalpur,4229,2386,2175,1107,2054,1279,63.9,66.3,61.6,00000
58.0,83.0,85.0,153,03,03,  Dakshin Bharaura,2506,1013,1360,479,1146,534,71.2,74.0,68.2,00000
58.0,83.0,85.0,153,04,03,  Bharaura-2,1540,905,795,421,745,484,63.0,65.4,60.6,00000
58.0,83.0,85.0,913,01,01,  Sreemangal (Part)Purba,3796,1314,1976,621,1820,693,74.3,76.1,72.4,00000
58.0,83.0,85.0,913,02,01,  Sreemangal (Paschim),559,1064,295,529,264,535,34.4,35.8,33.0,00000
58.0,83.0,85.0,994,01,01,  Uttarsur (Uttar),1990,1638,1049,790,941,848,54.9,57.0,52.6,00000
58.0,83.0,85.0,994,02,01,  Uttarsur (Daskin),1858,1237,959,581,899,656,60.0,62.3,57.8,00000
