thana_Name,Shukhi,Apon,Pill_total,Condom,Inj_vial,Inj_siringe,IUD_normal,IUD_partum,IUD_total,IUD_remove,Imp_normal,Imp_Jadel,Imp_total,implant_remove,ecp,misoprostol,mrm_pack,inj_mgs4,mnp_saset,ifa_number,sanitary_pad,per_male,femalenormal,femalepn,female_total,Permanent_method,Year,Month,District,Division,program
Bhola Sadar,2033705,13961,2047666,2197812,944542,520367,8857,448,9305,270,13495,148,13643,1570,6015,27935,3566,6280,177321,1224888,289,12279,771,195,951,13230,2018,12,0305,03,distributionGO_thanaconsuprocess
Daulatkhan,1170943,5931,1176874,1683632,523945,305899,3635,34,3669,50,2869,18,2887,233,4343,9703,0,0,0,158250,1,186,293,19,310,496,2018,12,0305,03,distributionGO_thanaconsuprocess
Tajumuddin,764903,3274,768177,1101356,411956,239922,1946,0,1946,19,1946,0,1946,34,6157,8018,0,0,0,0,0,859,227,2,229,1088,2018,12,0305,03,distributionGO_thanaconsuprocess
Borhanuddin,1363617,7640,1371257,803312,367333,195240,4047,84,4131,53,6314,33,6347,1030,4620,15280,0,0,0,0,3,1136,532,63,590,1726,2018,12,0305,03,distributionGO_thanaconsuprocess
Lalmohan,2019211,9325,2028536,2445112,804332,500964,5205,243,5448,89,5364,26,5390,206,9506,25547,43297,990,623045,1211204,3006,3548,567,99,672,4220,2018,12,0305,03,distributionGO_thanaconsuprocess
Charfashion,2764716,11124,2775840,3676772,1022089,627860,7315,11,7326,29,8064,0,8064,119,6966,25957,0,0,0,0,0,1827,942,120,1050,2877,2018,12,0305,03,distributionGO_thanaconsuprocess
Monpura,454654,3568,458222,744611,260020,150613,1758,0,1758,78,875,0,875,30,469,1123,2,0,0,1767,2,152,123,0,123,275,2018,12,0305,03,distributionGO_thanaconsuprocess
Baraigram,3191564,9666,3201230,3867210,429992,222105,5029,69,5098,423,9246,16,9262,2563,5175,8436,19,0,0,0,344,116,6287,474,6759,6875,2018,12,0114,01,distributionGO_thanaconsuprocess
Natore Sadar,3761547,16460,3778007,5177320,313152,148399,11137,887,12024,1049,11634,730,12364,2666,4393,11539,139,0,0,0,149,2316,6766,2034,8703,11019,2018,12,0114,01,distributionGO_thanaconsuprocess
Bagatipara,1199429,5105,1204534,1589451,83594,36075,1583,0,1583,151,3677,84,3761,1133,1966,6225,0,0,0,118514,74,107,2249,389,2638,2745,2018,12,0114,01,distributionGO_thanaconsuprocess
Singra,4720245,19494,4739739,4451269,339146,192373,6406,11,6417,526,9594,784,10378,3134,5235,11932,0,0,0,0,113,1294,3796,284,4074,5368,2018,12,0114,01,distributionGO_thanaconsuprocess
Lalpur,2724479,5951,2730430,2904130,311031,154015,3387,34,3421,366,7245,100,7345,1910,3059,5508,0,0,0,0,299,47,4068,986,5054,5101,2018,12,0114,01,distributionGO_thanaconsuprocess
Gurudashpur,2723451,9019,2732470,3003758,218143,118098,2386,8,2394,78,6664,559,7223,1555,2516,5306,0,0,0,202459,18,965,3466,869,4335,5300,2018,12,0114,01,distributionGO_thanaconsuprocess
Bagerhat Sadar,2765521,10382,2775903,3439947,300292,157380,8439,0,8439,399,7370,47,7417,1929,4471,8703,1,0,0,0,278,1931,2328,437,2747,4678,2018,12,0209,02,distributionGO_thanaconsuprocess
Fakirhat,1290192,8685,1298877,1595097,122295,61550,3079,1,3080,366,2989,66,3055,616,2245,6152,5,0,0,174299,119,1141,1497,49,1535,2676,2018,12,0209,02,distributionGO_thanaconsuprocess
Sarankhola,1482779,4071,1486850,1780445,183997,106117,3519,12,3531,271,1501,10,1511,297,1979,3724,0,0,0,24168,29,1688,217,153,370,2058,2018,12,0209,02,distributionGO_thanaconsuprocess
Morralganj,4099972,9321,4109293,3349587,358947,180584,8695,122,8817,333,3134,100,3234,62,3926,6223,2,0,0,63850,288,3571,819,32,849,4420,2018,12,0209,02,distributionGO_thanaconsuprocess
Kachua,1311022,4060,1315082,1853902,102236,58465,2570,16,2586,176,3094,198,3292,647,1169,9326,26,0,0,151,5,702,815,0,816,1518,2018,12,0209,02,distributionGO_thanaconsuprocess
Mollahat,1495897,5691,1501588,1568078,90654,41500,2990,8,2998,144,1763,0,1763,46,1633,6252,51,0,13,52,0,782,1429,149,1576,2358,2018,12,0209,02,distributionGO_thanaconsuprocess
Rampal,1781735,4391,1786126,2652889,87860,43079,3661,8,3669,106,3025,152,3177,19,2032,2531,0,0,0,77,26,1048,1478,0,1478,2526,2018,12,0209,02,distributionGO_thanaconsuprocess
Chitalmari,1688678,13587,1702265,2735771,189981,100952,2444,1,2445,97,2811,3,2814,948,1332,6403,0,0,0,29400,0,525,999,124,1122,1647,2018,12,0209,02,distributionGO_thanaconsuprocess
Mongla,1651453,5759,1657212,2819281,188674,114317,3178,0,3178,212,2533,4,2537,208,1052,5498,0,0,0,0,50,1855,925,0,925,2780,2018,12,0209,02,distributionGO_thanaconsuprocess
Sripur,1939448,7345,1946793,1468112,218471,96664,3791,2,3793,415,4680,20,4700,1148,3476,3753,60,0,0,0,35,617,2322,5,2327,2944,2018,12,0205,02,distributionGO_thanaconsuprocess
Magura Sadar,4722424,10811,4733235,3644821,451734,257437,9465,417,9882,536,10949,100,11049,3469,8216,4446,256,0,0,0,8,369,6098,3744,9841,10210,2018,12,0205,02,distributionGO_thanaconsuprocess
Shalikha,1235083,5478,1240561,742820,81380,46186,3001,4,3005,31,4232,4,4236,1135,3630,3713,0,0,0,0,22,446,2249,91,2340,2786,2018,12,0205,02,distributionGO_thanaconsuprocess
Mohammadpur,1456173,6087,1462260,765137,138615,68127,4337,0,4337,426,5462,100,5562,1365,3024,2244,0,0,0,1344,569,517,1999,10,2009,2526,2018,12,0205,02,distributionGO_thanaconsuprocess
Lalmonirhat Sadar,2784134,9940,2794074,1447744,631827,305118,3323,4,3327,512,11087,118,11205,2357,2924,9203,101,0,0,0,10,5722,2634,1031,3648,9370,2018,12,0108,07,distributionGO_thanaconsuprocess
Hatibandha,2596236,5715,2601951,1759817,259962,173229,5811,34,5845,1270,12845,5,12850,1972,1225,2797,17,0,0,171,5,3555,2096,614,2703,6258,2018,12,0108,07,distributionGO_thanaconsuprocess
Kaliganj,2437218,5120,2442338,1002206,347135,166643,3966,2,3968,599,10274,0,10274,1159,2603,6294,0,0,0,0,10,2980,2216,260,2472,5452,2018,12,0108,07,distributionGO_thanaconsuprocess
Patgram,1976919,7655,1984574,919833,239213,140766,2008,0,2008,465,5183,5,5188,616,1975,5412,4,0,2,96,20,2695,1110,1,1110,3805,2018,12,0108,07,distributionGO_thanaconsuprocess
Aditmari,2275118,6703,2281821,1556844,340950,196799,6152,354,6506,2228,10995,115,11110,1531,2068,5586,0,0,0,3690,224,3735,1713,426,2137,5872,2018,12,0108,07,distributionGO_thanaconsuprocess
Manikganj Sadar,2579610,20765,2600375,4158216,323788,208730,5712,1,5713,2,11968,0,11968,2575,3289,10226,92,0,0,5882,5,5195,3068,16,3082,8277,2018,12,0411,04,distributionGO_thanaconsuprocess
Saturia,1231043,5543,1236586,1047693,128837,61917,4550,2,4552,340,5791,121,5912,624,2232,3892,0,12,0,11600,18,1233,2770,0,2719,3952,2018,12,0411,04,distributionGO_thanaconsuprocess
Singair,2072065,11216,2083281,2923651,188933,93997,5351,12,5363,518,5658,14,5672,2250,2376,3107,0,0,0,0,42,3424,3972,161,4134,7558,2018,12,0411,04,distributionGO_thanaconsuprocess
Daulatpur,1911217,4717,1915934,2065348,164128,86341,4035,77,4112,757,5109,0,5109,576,2361,3035,4,0,0,277283,106,2632,2743,83,2811,5443,2018,12,0411,04,distributionGO_thanaconsuprocess
Harirampur,895949,5079,901028,1827252,122034,63254,3252,6,3258,181,4143,0,4143,941,2034,2664,0,0,0,508,97,1082,2252,0,2236,3318,2018,12,0411,04,distributionGO_thanaconsuprocess
Shibalaya,1380546,5793,1386339,2398214,219860,120418,3099,0,3099,231,4868,6,4874,1739,1955,2202,2,0,0,0,172,1840,2927,0,2930,4770,2018,12,0411,04,distributionGO_thanaconsuprocess
Ghior,1702703,5012,1707715,3193150,183013,84519,3136,2,3138,262,4128,0,4128,1121,6919,5033,100,0,0,0,10,643,3020,0,2897,3540,2018,12,0411,04,distributionGO_thanaconsuprocess
Palong (Sadar),1351205,9887,1361092,1867527,220577,104909,9332,17,9349,884,4232,32,4264,934,1923,4878,2,0,0,0,29,701,1227,84,1304,2005,2018,12,0403,04,distributionGO_thanaconsuprocess
Naria,1502376,10450,1512826,1294592,136440,70126,5208,0,5208,405,2651,69,2720,487,1484,5520,5,0,0,81552,0,720,1555,114,1642,2362,2018,12,0403,04,distributionGO_thanaconsuprocess
Bhedarganj,1698590,12082,1710672,1855672,331701,167020,5378,2,5380,620,3753,0,3753,1802,2570,9751,0,0,0,0,46,991,1457,30,1457,2448,2018,12,0403,04,distributionGO_thanaconsuprocess
Damoddya,794092,4956,799048,1015905,110150,51143,3219,0,3219,410,1486,0,1486,606,1499,6216,6,0,0,0,6,471,943,19,962,1433,2018,12,0403,04,distributionGO_thanaconsuprocess
Goshairhat,1533942,6329,1540271,2069314,145329,83289,9422,66,9488,890,1931,0,1931,718,1873,6532,0,0,0,19263,55,671,449,14,449,1120,2018,12,0403,04,distributionGO_thanaconsuprocess
Janjira,1535407,12136,1547543,2031698,147973,77959,6163,23,6186,393,3488,87,3575,1718,1713,9107,60,0,10,961,597,516,2084,14,2098,2614,2018,12,0403,04,distributionGO_thanaconsuprocess
Jaldhaka,4514842,10034,4524876,1750185,430908,271054,5418,2,5420,1602,8754,0,8754,570,2285,9019,0,0,0,0,66,3467,2975,36,3011,6478,2018,12,0104,07,distributionGO_thanaconsuprocess
Domar,2567718,9919,2577637,991004,310678,177682,3913,5,3918,237,6287,249,6536,1739,1665,6564,0,0,0,0,0,2939,3003,225,3228,6167,2018,12,0104,07,distributionGO_thanaconsuprocess
Syadpur,2252120,7469,2259589,3003732,248266,146951,5402,7,5409,1457,6213,7,6220,1770,1542,5718,55,0,0,0,286,1781,2436,72,2509,4290,2018,12,0104,07,distributionGO_thanaconsuprocess
Dimla,3139346,8002,3147348,832861,311025,206007,5453,1,5454,1028,8808,2,8810,2163,2036,7047,0,0,0,0,34,3541,2426,57,2469,6010,2018,12,0104,07,distributionGO_thanaconsuprocess
Nilphamari Sadar,5233096,16814,5249910,2088469,591426,310240,15280,161,15441,1984,9849,55,9904,4431,3141,11586,51,0,0,0,51,14897,3042,405,3423,18320,2018,12,0104,07,distributionGO_thanaconsuprocess
Kishoreganj,3367413,9358,3376771,815063,301966,185603,4238,1,4239,1131,8575,64,8639,2891,2637,5028,0,0,2,238,77,1940,2143,0,2143,4083,2018,12,0104,07,distributionGO_thanaconsuprocess
Nakla,2188884,7053,2195937,1345668,228374,124558,4835,11,4846,239,7193,331,7524,2008,1587,5603,3,0,0,0,5,733,679,493,1172,1905,2018,12,0414,08,distributionGO_thanaconsuprocess
Sribordi,2893945,8049,2901994,2375149,261761,144334,4767,7,4774,142,7440,1,7441,2622,2530,9923,0,0,0,0,276,1119,432,307,738,1857,2018,12,0414,08,distributionGO_thanaconsuprocess
Sherpur Sadar,5127997,14635,5142632,4653353,797527,569199,10703,43,10746,36,14890,0,14890,47,1410,12806,114,0,0,44808,706,2212,1761,1605,3366,5578,2018,12,0414,08,distributionGO_thanaconsuprocess
Nalitabari,2890313,7742,2898055,2383600,217166,113890,2691,10,2701,210,7146,0,7146,2473,2011,6517,3,0,0,813,258,1588,652,398,1050,2638,2018,12,0414,08,distributionGO_thanaconsuprocess
Jhenaigati,2326034,4568,2330602,1430730,180177,98334,1896,0,1896,101,4841,7,4848,988,705,6824,0,0,0,0,0,898,399,259,658,1556,2018,12,0414,08,distributionGO_thanaconsuprocess
Sharasti,993096,8389,1001485,699788,333101,183158,3711,0,3711,229,2143,8,2151,300,1956,12594,0,0,0,0,10,193,1657,411,2068,2261,2018,12,0503,05,distributionGO_thanaconsuprocess
Matlab (South),1119918,11573,1131491,1689952,380705,180266,3479,8,3487,138,2790,177,2967,841,6360,17596,2,0,0,0,0,303,1455,670,2123,2426,2018,12,0503,05,distributionGO_thanaconsuprocess
Hajiganj,1332790,11510,1344300,1304411,342485,185004,5263,22,5285,630,2464,109,2573,622,2143,9700,0,0,0,0,204,411,1705,1204,2909,3320,2018,12,0503,05,distributionGO_thanaconsuprocess
Chandpur Sadar,2266647,12584,2279231,2471632,452937,226092,9882,538,10420,705,7874,179,8053,2945,3495,12722,19,0,0,0,2,4471,2268,1684,3952,8423,2018,12,0503,05,distributionGO_thanaconsuprocess
Kachua,1995348,11321,2006669,3855982,525625,289779,5441,10,5451,67,3857,0,3857,16,3193,8785,0,0,0,0,0,929,1916,319,2235,3164,2018,12,0503,05,distributionGO_thanaconsuprocess
Faridganj,1955367,19992,1975359,2812529,401483,579478,5784,3,5787,461,5851,351,6202,1200,4344,16251,17,0,0,62,22,404,2556,471,2984,3388,2018,12,0503,05,distributionGO_thanaconsuprocess
Hemchar,692786,4363,697149,361839,105096,59545,1641,0,1641,660,1188,0,1188,437,633,11111,0,0,0,485,46,247,509,0,509,756,2018,12,0503,05,distributionGO_thanaconsuprocess
Motlab (North),2056426,10331,2066757,2911294,281746,143467,5236,51,5287,335,5204,133,5337,450,1494,11115,0,0,0,0,0,144,2807,158,2965,3109,2018,12,0503,05,distributionGO_thanaconsuprocess
Bandarban Sadar,564358,9141,573499,587931,90457,58414,2689,225,2914,402,2805,11,2816,628,2280,8070,134,0,2500,0,62,1272,508,20,528,1800,2018,12,0511,05,distributionGO_thanaconsuprocess
Rowangchhari,218279,1887,220166,332398,20481,13723,697,3,700,127,1564,0,1564,266,821,2461,0,0,0,0,3,248,72,0,72,320,2018,12,0511,05,distributionGO_thanaconsuprocess
Ruma,185199,1753,186952,662334,12211,7482,1307,36,1343,76,1155,11,1166,118,526,1275,0,0,2700,86583,70,100,26,2,28,128,2018,12,0511,05,distributionGO_thanaconsuprocess
Thanchi,213935,1879,215814,237645,12698,6707,997,5,1002,39,1276,0,1276,147,842,2293,0,0,270,5905,8,139,106,0,106,245,2018,12,0511,05,distributionGO_thanaconsuprocess
Lama,649518,5869,655387,724320,103173,52666,3628,163,3791,317,1964,12,1976,169,2231,3048,90,0,0,224,0,844,582,8,582,1426,2018,12,0511,05,distributionGO_thanaconsuprocess
Alikadam,284721,2740,287461,448307,142254,72733,2051,42,2093,539,2034,0,2034,211,1085,2531,10,0,0,0,36,1320,339,0,349,1669,2018,12,0511,05,distributionGO_thanaconsuprocess
Naikhongchhari,615547,4169,619716,847129,67231,43547,1266,2,1268,24,1024,14,1038,7,1375,5014,1,0,0,52,0,1323,96,22,118,1441,2018,12,0511,05,distributionGO_thanaconsuprocess
Bhurungamari,3551265,6528,3557793,2710032,474296,246658,4841,199,5040,97,4958,0,4958,7,2187,8560,0,0,0,20,0,2632,4401,468,4860,7492,2018,12,0106,07,distributionGO_thanaconsuprocess
Roumari,1840904,5376,1846280,4436870,326126,175974,3585,0,3585,577,3796,3,3799,478,1138,18226,0,0,0,197,0,3809,557,3,560,4369,2018,12,0106,07,distributionGO_thanaconsuprocess
Kurigram Sadar,3273951,9531,3283482,1697236,535874,293057,4157,8,4165,485,5485,81,5566,491,3349,12413,0,0,0,0,32,2993,1810,0,1797,4790,2018,12,0106,07,distributionGO_thanaconsuprocess
Ulipur,6026217,9983,6036200,1858042,685993,372589,7822,0,7822,1353,6718,0,6718,1528,7964,11080,0,0,0,515,256,1425,1174,32,1208,2633,2018,12,0106,07,distributionGO_thanaconsuprocess
Nageswari,5639400,10509,5649909,1364943,630321,379453,8211,251,8462,1743,9108,141,9249,2123,3065,13915,0,0,0,546,36,6857,2508,58,2566,9423,2018,12,0106,07,distributionGO_thanaconsuprocess
Chilmari,2370611,6500,2377111,1209909,180649,83326,3588,40,3628,289,4788,95,4883,630,1520,7097,14,0,0,0,66,1152,885,16,893,2045,2018,12,0106,07,distributionGO_thanaconsuprocess
Fulbari,2061346,6952,2068298,714326,317278,188915,4370,8,4378,840,4954,65,5019,1724,3166,8351,16,0,0,0,30,1541,694,0,694,2235,2018,12,0106,07,distributionGO_thanaconsuprocess
Char Rajibpur,976485,4905,981390,4526910,208989,101987,1293,95,1388,67,2030,200,2230,170,638,3444,0,0,0,4610,5,2964,56,53,108,3072,2018,12,0106,07,distributionGO_thanaconsuprocess
Rajarhat,2513087,4739,2517826,2484273,406295,225621,5282,409,5691,646,5790,0,5790,2110,1835,7947,38,0,0,0,178,1533,902,9,909,2442,2018,12,0106,07,distributionGO_thanaconsuprocess
Azmiriganj,606978,4585,611563,362045,33619,21649,904,130,1034,35,973,25,998,88,380,15389,91,0,0,403,71,260,2171,17,2185,2445,2018,12,0602,06,distributionGO_thanaconsuprocess
Bahubal,923131,5435,928566,1201927,68890,42905,2525,0,2525,89,1818,0,1818,214,825,25241,19,0,14,15913,312,964,1837,0,1837,2801,2018,12,0602,06,distributionGO_thanaconsuprocess
Madhabpur,2484455,11345,2495800,1650978,115459,69385,4285,9,4294,333,4038,6,4044,1479,4534,37509,12,32,20,24,937,2435,2538,286,2820,5255,2018,12,0602,06,distributionGO_thanaconsuprocess
Lakhai,867602,5076,872678,687312,48381,29934,600,28,628,57,1463,0,1463,10,2066,18411,2,6,0,0,1,406,1956,2,1958,2364,2018,12,0602,06,distributionGO_thanaconsuprocess
Habiganj Sadar,1899201,15345,1914546,2205756,203972,122239,6425,861,7286,632,3220,182,3402,657,1863,23042,141,42,5,20763,302,2115,3865,922,4745,6860,2018,12,0602,06,distributionGO_thanaconsuprocess
Baniachhong,1681984,13975,1695959,1702609,94773,64928,2077,28,2105,68,1610,0,1610,55,1279,41415,0,0,0,5,3,1844,3164,19,3182,5026,2018,12,0602,06,distributionGO_thanaconsuprocess
Chunarughat,2270905,8362,2279267,1337563,149141,95036,3369,5,3374,311,1943,0,1943,555,253,35100,5,175,1,14435,160,3150,2077,0,2077,5227,2018,12,0602,06,distributionGO_thanaconsuprocess
Nabiganj,1713016,11344,1724360,927981,94548,55738,5499,22,5521,1965,4331,6,4337,1872,1013,34057,82,8,0,179248,290,3123,2645,2,2647,5770,2018,12,0602,06,distributionGO_thanaconsuprocess
Gopalganj Sadar,2537749,12325,2550074,3946951,181627,103090,7108,55,7163,40,5067,0,5067,422,1790,0,0,0,89,0,1,12420,7627,584,8211,20631,2018,12,0401,04,distributionGO_thanaconsuprocess
Muksudpur,3787019,10384,3797403,4361753,304161,171858,6601,205,6806,89,2946,98,3044,51,1584,4733,1,0,0,0,0,1016,3517,216,3735,4751,2018,12,0401,04,distributionGO_thanaconsuprocess
Tungipara,1441718,5085,1446803,2016441,98176,54155,1812,5,1817,64,1870,0,1870,600,1821,3036,1,0,0,0,22,534,1786,5,1791,2325,2018,12,0401,04,distributionGO_thanaconsuprocess
Kotalipara,2239418,11441,2250859,1562203,114126,61721,4242,21,4263,564,5500,287,5787,1146,1800,9924,14,0,2,0,116,305,3195,1413,4608,4913,2018,12,0401,04,distributionGO_thanaconsuprocess
Kasiani,2090073,9593,2099666,3112336,191158,110298,3749,271,4020,511,3761,3,3764,823,3122,3956,17,1,61,17428,61,570,2961,205,3154,3724,2018,12,0401,04,distributionGO_thanaconsuprocess
Brahmanbaria Sadar,2667139,15804,2682943,6893125,504224,260262,13529,62,13591,883,7500,317,7817,1570,4620,9923,0,0,0,0,16,1381,4430,548,4922,6303,2018,12,0501,05,distributionGO_thanaconsuprocess
Nasirnagar,1668491,10450,1678941,3777641,189846,112577,2769,1,2770,27,2829,153,2982,158,1997,6934,0,4,0,201,47,1098,2891,0,2848,3946,2018,12,0501,05,distributionGO_thanaconsuprocess
Nabinagar,2210080,18134,2228214,8658615,449723,249377,7537,7,7544,249,3348,0,3348,42,4030,7554,1,0,0,0,419,781,3415,335,3750,4531,2018,12,0501,05,distributionGO_thanaconsuprocess
Kashba,2648064,11352,2659416,6561723,215673,92741,7559,0,7559,126,3383,112,3495,8,2346,7936,2,0,0,0,145,461,2271,5,2276,2737,2018,12,0501,05,distributionGO_thanaconsuprocess
Sarail,1661033,7777,1668810,4190624,261657,155237,5495,0,5495,37,5746,0,5746,50,1939,7154,0,0,55,0,20,178,1479,13,1493,1671,2018,12,0501,05,distributionGO_thanaconsuprocess
Bancharampur,1519472,9592,1529064,3486308,450310,229344,9670,8,9678,583,5509,215,5724,2438,2712,9408,13,0,0,0,23,156,2329,539,2848,3004,2018,12,0501,05,distributionGO_thanaconsuprocess
Akhaura,861221,5730,866951,1203534,131671,70332,1921,5,1926,129,1693,376,2069,708,769,6698,1,1,1,68775,266,1023,662,0,666,1689,2018,12,0501,05,distributionGO_thanaconsuprocess
Ashuganj,724042,6517,730559,1779129,124131,70963,5200,0,5200,69,1977,6,1983,0,1586,4033,0,0,0,0,0,194,1824,24,1848,2042,2018,12,0501,05,distributionGO_thanaconsuprocess
Bijoy Nagar,1032440,12081,1044521,2064782,178724,152863,2000,1,2001,133,1716,0,1716,30,215,8883,0,0,0,31150,45,424,803,0,803,1227,2018,12,0501,05,distributionGO_thanaconsuprocess
Kazipur,2430634,10745,2441379,3751265,367389,148133,8777,0,8777,25,4128,103,4231,0,4519,12448,0,0,0,0,0,1573,824,13,833,2406,2018,12,0116,01,distributionGO_thanaconsuprocess
Rayganj,3147990,12167,3160157,2363046,342449,160712,6870,36,6906,48,3228,0,3228,115,5000,17683,0,0,0,0,59,1023,1231,28,1261,2284,2018,12,0116,01,distributionGO_thanaconsuprocess
Tarash,2457124,8094,2465218,1929604,181493,74512,5335,140,5475,436,3475,92,3567,452,4105,17788,0,0,0,0,47,1568,1356,255,1611,3179,2018,12,0116,01,distributionGO_thanaconsuprocess
Sirajganj Sadar,3959347,10313,3969660,5382869,701720,336177,7209,99,7308,628,4867,2,4869,966,5950,4325,9,0,0,24696,152,1846,1625,662,2287,4133,2018,12,0116,01,distributionGO_thanaconsuprocess
Kamarkhand,1254007,6303,1260310,1102036,164741,87167,2446,0,2446,760,2819,100,2919,968,1334,10284,1,0,0,0,29,463,261,293,554,1017,2018,12,0116,01,distributionGO_thanaconsuprocess
Chouhali,1228706,3753,1232459,1832250,147680,71402,3985,66,4051,199,2176,73,2249,132,1507,4677,14,0,0,94817,26,479,1307,38,1336,1815,2018,12,0116,01,distributionGO_thanaconsuprocess
Ullahpara,6318405,18485,6336890,7038518,736558,383048,9874,17,9891,1019,6157,14,6171,1190,5838,23899,2,16,27,0,26,2034,1964,3,1967,4001,2018,12,0116,01,distributionGO_thanaconsuprocess
Belkuchi,3461244,8862,3470106,5440246,301886,157755,4060,62,4122,240,2342,6,2348,386,2944,18585,12,2,0,0,62,1108,590,399,989,2097,2018,12,0116,01,distributionGO_thanaconsuprocess
Shazadpur,4927404,16557,4943961,6955384,1009152,565607,17268,23,17291,2261,5259,0,5259,52,3391,22348,0,0,0,20,430,1400,1244,20,1263,2663,2018,12,0116,01,distributionGO_thanaconsuprocess
Jhikarghachha,2089978,9164,2099142,2728699,420987,195803,9602,49,9651,938,6739,116,6855,2160,3469,5027,91,0,0,0,10,2849,2852,694,3543,6392,2018,12,0207,02,distributionGO_thanaconsuprocess
Jessore Sadar,5967570,14096,5981666,9603212,1039924,592486,12760,256,13016,1057,16346,203,16549,2634,6368,5165,300,0,0,0,35,10177,6339,1519,7890,18067,2018,12,0207,02,distributionGO_thanaconsuprocess
Sarsa,2920272,5436,2925708,4626665,611031,296404,6717,0,6717,1396,6800,92,6892,2216,4089,4979,9,0,0,0,2,1622,1566,1503,3066,4688,2018,12,0207,02,distributionGO_thanaconsuprocess
Keshobpur,1708116,7481,1715597,1923150,368337,181302,4720,0,4720,288,6990,6,6996,660,2273,3219,78,10,2,5156,2382,1296,1540,1140,2667,3963,2018,12,0207,02,distributionGO_thanaconsuprocess
Bagherpara,1907680,6820,1914500,3538065,259638,153381,7598,37,7635,1168,8995,96,9091,2064,1955,4023,66,2,0,90480,22,821,1819,581,2400,3221,2018,12,0207,02,distributionGO_thanaconsuprocess
Monirampur,3815173,7962,3823135,4178234,965962,495592,16949,69,17018,2966,9616,13,9629,2938,5659,4583,242,63,0,0,89,3166,2600,27,2629,5795,2018,12,0207,02,distributionGO_thanaconsuprocess
Abhaynagar,1626450,7311,1633761,2652546,415475,213013,5889,9,5898,149,5771,216,5987,828,2746,3450,70,0,0,0,0,1862,2610,190,2781,4643,2018,12,0207,02,distributionGO_thanaconsuprocess
Chowgachha,1815577,9031,1824608,2703112,263406,128178,3299,165,3464,815,5888,99,5987,2256,4128,6599,18,0,0,538232,122,1396,2081,209,2290,3686,2018,12,0207,02,distributionGO_thanaconsuprocess
Senbag,1237071,10303,1247374,2310908,212982,108879,3971,38,4009,324,2338,320,2658,462,3340,26540,110,0,0,109,31,517,1548,427,1966,2483,2018,12,0505,05,distributionGO_thanaconsuprocess
Begumganj,2282491,21006,2303497,3569320,401542,183863,11281,900,12181,464,4533,300,4833,680,6086,43889,0,0,0,0,59,364,3532,1259,4791,5155,2018,12,0505,05,distributionGO_thanaconsuprocess
Companiganj,1284567,6442,1291009,2097884,246120,119508,3706,216,3922,252,1871,139,2010,556,2873,10724,0,0,0,0,0,944,1254,199,1453,2397,2018,12,0505,05,distributionGO_thanaconsuprocess
Sudharam (Sadar),2595119,14160,2609279,4995895,579000,295168,8548,67,8615,565,7688,0,7688,1746,4176,15766,31,32,0,0,0,3020,5367,1892,7207,10227,2018,12,0505,05,distributionGO_thanaconsuprocess
Hatiya,1993360,12728,2006088,2152258,385519,210320,3856,93,3949,361,4727,1091,5818,649,3523,19563,0,0,0,0,57,2139,414,109,523,2662,2018,12,0505,05,distributionGO_thanaconsuprocess
Chatkhil,767828,6915,774743,786811,132008,68932,2991,6,2997,166,2679,0,2679,465,3140,10262,0,0,0,0,64,250,1914,935,2847,3097,2018,12,0505,05,distributionGO_thanaconsuprocess
Subarna Char,1235762,17038,1252800,2266439,225406,112469,2344,17,2361,87,3173,91,3264,155,826,12738,77,0,0,0,0,529,959,12,970,1499,2018,12,0505,05,distributionGO_thanaconsuprocess
Sonaimuri,1074219,9496,1083715,1441476,225599,123703,3129,88,3217,222,1797,357,2154,257,3384,16061,32,0,0,0,153,122,2459,153,2612,2734,2018,12,0505,05,distributionGO_thanaconsuprocess
Kabirhat,646522,10159,656681,908229,117170,99304,1414,28,1442,287,1710,260,1970,125,203,13283,0,5,0,0,24,17,350,826,1166,1183,2018,12,0505,05,distributionGO_thanaconsuprocess
Langadu,656775,2420,659195,967625,64318,37365,771,105,876,67,2665,39,2704,226,3884,279,8,0,0,366,17,806,144,3,147,953,2018,12,0509,05,distributionGO_thanaconsuprocess
Kawkhali,398226,3118,401344,609339,62343,39910,1220,0,1220,74,3011,0,3011,547,2942,99,1,0,0,0,0,261,293,0,289,550,2018,12,0509,05,distributionGO_thanaconsuprocess
Rangamati Sadar,954441,2175,956616,1369865,87981,48897,4056,312,4368,552,5331,4,5335,1478,6327,908,90,0,0,10550,121,1095,353,46,382,1477,2018,12,0509,05,distributionGO_thanaconsuprocess
Baghaichhari,832871,1536,834407,1132577,47452,29390,803,0,803,20,976,3,979,10,2312,83,24,0,0,63497,0,51,280,0,279,330,2018,12,0509,05,distributionGO_thanaconsuprocess
Barkal,380664,1352,382016,559821,44607,28842,614,2,616,52,161,0,161,3,2649,178,4,0,0,0,6,157,48,3,51,208,2018,12,0509,05,distributionGO_thanaconsuprocess
Naniarchar,568984,1988,570972,826379,30263,18105,612,4,616,209,1481,3,1484,225,3233,202,5,0,0,79,55,408,130,2,132,540,2018,12,0509,05,distributionGO_thanaconsuprocess
Jurachhari,268287,978,269265,224106,15720,9786,604,0,604,135,414,0,414,4,999,129,0,0,0,447,24,235,62,0,62,297,2018,12,0509,05,distributionGO_thanaconsuprocess
Kaptai,359302,1454,360756,666006,50212,28552,598,3,601,20,1986,18,2004,84,2117,0,0,0,0,0,0,119,572,14,586,705,2018,12,0509,05,distributionGO_thanaconsuprocess
Rajasthali,214515,557,215072,223920,18661,9049,541,0,541,47,1450,51,1501,253,1675,107,0,0,0,0,19,347,69,0,69,416,2018,12,0509,05,distributionGO_thanaconsuprocess
Belaichhari,307706,1549,309255,236756,18786,9424,503,0,503,9,683,23,706,6,335,72,0,0,0,0,0,73,159,1,156,229,2018,12,0509,05,distributionGO_thanaconsuprocess
Rupganj,4706347,14785,4721132,5126580,433123,249324,11354,91,11445,835,7889,142,8031,2418,1709,7613,218,0,0,6976,0,4846,2863,500,3355,8201,2018,12,0409,04,distributionGO_thanaconsuprocess
Sonargaon,3187661,11326,3198987,4004048,409063,229323,8216,4,8220,277,8282,134,8416,2471,3040,5212,12,0,0,0,0,3300,2414,931,3330,6630,2018,12,0409,04,distributionGO_thanaconsuprocess
Narayanganj Sadar,8565975,25086,8591061,15566653,1450953,727805,21091,688,21779,627,17284,499,17783,3022,6661,9170,108,0,1,0,51,21466,3675,3036,6812,28278,2018,12,0409,04,distributionGO_thanaconsuprocess
Araihazar,2883968,13669,2897637,1873207,424072,244897,14289,74,14363,1133,8090,0,8090,858,1402,8843,12,0,0,0,187,1685,2492,1111,3582,5267,2018,12,0409,04,distributionGO_thanaconsuprocess
Bandar,2545325,8712,2554037,6628903,287756,167477,7216,30,7246,336,6624,99,6723,1088,2881,2479,0,18,0,80,2,3237,2073,810,2857,6094,2018,12,0409,04,distributionGO_thanaconsuprocess
Pirganj,2581103,15368,2596471,848222,272698,153431,2962,107,3069,349,4740,235,4975,797,2898,14057,0,0,0,0,8,2478,767,363,1127,3605,2018,12,0102,07,distributionGO_thanaconsuprocess
Haripur,1385480,4525,1390005,766743,186519,84199,1073,150,1223,2,2359,0,2359,0,1667,5437,0,0,0,4350,5,1462,424,106,530,1992,2018,12,0102,07,distributionGO_thanaconsuprocess
Thakurgaon Sadar,5392633,21392,5414025,2416530,825506,443550,4941,1507,6448,205,17671,273,17944,870,6828,17871,51,0,0,0,0,6566,5724,4742,10463,17029,2018,12,0102,07,distributionGO_thanaconsuprocess
Baliadangi,1720229,5655,1725884,595708,366720,198392,2299,43,2342,191,2337,55,2392,583,2666,10175,1,0,0,0,27,2459,765,397,1162,3621,2018,12,0102,07,distributionGO_thanaconsuprocess
Ranisankail,2062070,8574,2070644,649604,271485,131919,2730,119,2849,285,5586,313,5899,2095,3282,12275,72,0,0,957,37,2690,483,496,979,3669,2018,12,0102,07,distributionGO_thanaconsuprocess
Rajbari Sadar,2446090,16965,2463055,3274254,351017,191755,11461,88,11549,1086,17834,638,18472,9688,5425,13086,99,340,0,0,0,3998,3156,1491,4602,8600,2018,12,0405,04,distributionGO_thanaconsuprocess
Baliakandi,2408880,9979,2418859,3798724,210811,102375,4535,2,4537,1119,4957,100,5057,2082,1827,9083,0,0,0,5872,10,1522,1575,669,2228,3750,2018,12,0405,04,distributionGO_thanaconsuprocess
Goalunda Ghat,1014368,4577,1018945,3009751,218248,120348,2053,4,2057,316,5173,62,5235,1750,818,4129,0,0,0,0,43,1191,1810,33,1832,3023,2018,12,0405,04,distributionGO_thanaconsuprocess
Pangsha,4433327,16633,4449960,5249862,379057,209689,7521,91,7612,447,10313,56,10369,1579,5068,7474,23,1,0,381,103,5273,2099,0,2094,7367,2018,12,0405,04,distributionGO_thanaconsuprocess
Chuadanga Sadar,2325868,9018,2334886,3099440,492481,270708,6390,331,6721,561,5696,19,5715,1275,3584,8715,80,0,344,0,70,1105,5225,1446,6673,7778,2018,12,0203,02,distributionGO_thanaconsuprocess
Jiban Nagar,1547796,3507,1551303,1726939,247020,148743,5406,44,5450,711,6146,100,6246,2287,1789,2437,0,0,0,0,116,87,2423,1433,3856,3943,2018,12,0203,02,distributionGO_thanaconsuprocess
Damurhuda,1873486,6919,1880405,2380535,497708,233733,5736,0,5736,215,6440,0,6440,1686,3270,5835,0,0,0,0,90,115,4635,1443,6073,6188,2018,12,0203,02,distributionGO_thanaconsuprocess
Alamdanga,2968561,9707,2978268,1934965,423915,230401,5344,5,5349,167,9656,0,9656,3294,4497,5536,0,0,0,0,0,786,3974,1316,5290,6076,2018,12,0203,02,distributionGO_thanaconsuprocess
Barisal Sadar,2897917,14967,2912884,3709044,585203,287152,11512,434,11946,527,11532,471,12003,2588,1719,12843,111,0,101029,65046,38,12617,2516,2791,5307,17924,2018,12,0303,03,distributionGO_thanaconsuprocess
Uzirpur,2160077,9666,2169743,1908702,181769,91685,4182,31,4213,264,8457,0,8457,1662,2064,11641,56,0,0,0,15,709,1823,50,1873,2582,2018,12,0303,03,distributionGO_thanaconsuprocess
Bakerganj,2254038,17606,2271644,2013221,439452,205732,11986,15,12001,1445,4628,22,4650,0,5072,10837,19,0,84696,385479,1630,1624,2235,3,2238,3862,2018,12,0303,03,distributionGO_thanaconsuprocess
Babuganj,1002120,4412,1006532,676373,121101,58490,4525,0,4525,292,3543,33,3576,1192,634,6290,0,0,0,0,0,749,1094,5,1099,1848,2018,12,0303,03,distributionGO_thanaconsuprocess
Mehendiganj,1633744,10290,1644034,2010197,574176,369485,6940,24,6964,685,3807,0,3807,1217,2393,13956,0,0,0,378954,0,1541,122,25,147,1688,2018,12,0303,03,distributionGO_thanaconsuprocess
Gournadi,1380819,8233,1389052,1014279,142039,84488,3846,3,3849,164,4108,0,4108,865,1924,9335,75,0,0,0,8,307,2369,1,2370,2677,2018,12,0303,03,distributionGO_thanaconsuprocess
Muladi,1020358,3837,1024195,1234747,283707,170593,5171,0,5171,1418,1601,0,1601,300,1728,3352,0,0,27482,96701,186,455,657,12,675,1130,2018,12,0303,03,distributionGO_thanaconsuprocess
Hizla,951385,6225,957610,1439138,351022,219472,3581,19,3600,438,1191,0,1191,266,4697,7921,0,0,0,103519,405,679,200,1,201,880,2018,12,0303,03,distributionGO_thanaconsuprocess
Agailjhara,1311079,5111,1316190,1183405,89184,47306,3034,5,3039,334,2774,420,3194,668,1405,9632,3,0,0,41070,13,301,1019,270,1280,1581,2018,12,0303,03,distributionGO_thanaconsuprocess
Banaripara,1374008,7332,1381340,945368,108480,54251,3350,23,3373,298,4446,1,4447,244,888,3752,0,0,0,0,23,533,1061,26,1087,1620,2018,12,0303,03,distributionGO_thanaconsuprocess
Nachol,928926,2179,931105,1385714,145289,85159,839,0,839,182,1585,119,1704,499,1186,2263,0,0,0,0,33,795,2660,2,2662,3457,2018,12,0112,01,distributionGO_thanaconsuprocess
Gomostapur,2125281,5585,2130866,2683019,225788,112028,2609,4,2613,92,1670,484,2154,401,3385,5600,3,0,0,0,167,3596,4521,0,4521,8117,2018,12,0112,01,distributionGO_thanaconsuprocess
Shibganj,3744555,13099,3757654,4098260,433989,222021,5577,65,5642,213,3667,1016,4683,547,3544,6998,7,0,1,0,158,2471,6718,38,6753,9224,2018,12,0112,01,distributionGO_thanaconsuprocess
Chapai Nawabganj (Sadar),3279199,10599,3289798,5202214,543949,311575,5581,24,5605,46,2332,629,2961,28,3556,11132,59,0,0,0,287,2923,5862,24,5886,8809,2018,12,0112,01,distributionGO_thanaconsuprocess
Bholahat,733190,5239,738429,948316,104346,52789,1154,3,1157,78,1147,432,1579,305,1298,5017,32,0,3,0,132,1074,1220,220,1438,2512,2018,12,0112,01,distributionGO_thanaconsuprocess
Daulatpur,3518149,14248,3532397,5237153,546385,200674,2218,0,2218,24,2614,0,2614,8,2663,7841,12,0,0,0,0,93,8492,1492,9985,10078,2018,12,0201,02,distributionGO_thanaconsuprocess
Kushtia Sadar,5026664,13835,5040499,4677050,668601,378004,7336,17,7353,1319,15300,183,15483,3325,9807,3497,49,0,0,0,9,2240,3665,993,4572,6812,2018,12,0201,02,distributionGO_thanaconsuprocess
Kumarkhali,2443347,7675,2451022,5296537,447588,223190,2903,0,2903,74,4185,14,4199,424,4907,1437,8,7,0,0,0,3601,3214,13,3229,6830,2018,12,0201,02,distributionGO_thanaconsuprocess
Bheramara,1545280,4200,1549480,2907638,245698,135525,1499,0,1499,231,1506,0,1506,658,2589,3317,5,0,0,0,259,54,2914,1158,4058,4112,2018,12,0201,02,distributionGO_thanaconsuprocess
Mirpur,2608160,8302,2616462,3001385,361843,186775,2225,0,2225,189,3752,0,3752,765,3424,6702,0,0,0,0,0,463,4094,273,4363,4826,2018,12,0201,02,distributionGO_thanaconsuprocess
Khoksa,1279106,3360,1282466,2193624,80011,41746,1951,0,1951,66,3283,0,3283,852,2015,4458,45,0,0,198,7,652,906,39,945,1597,2018,12,0201,02,distributionGO_thanaconsuprocess
Khetlal,923167,3008,926175,889787,55303,24455,1660,0,1660,251,3291,45,3336,968,2160,3727,17,3,5,8,26,1679,647,320,965,2644,2018,12,0110,01,distributionGO_thanaconsuprocess
Akkelpur,1308939,4010,1312949,720074,96315,45381,1544,0,1544,205,6227,102,6329,1966,2179,3603,0,0,0,0,0,1312,773,1,774,2086,2018,12,0110,01,distributionGO_thanaconsuprocess
Panchbibi,1960088,6806,1966894,1928819,138345,45076,2236,0,2236,283,8553,0,8553,2421,3565,5032,0,0,0,0,0,2311,1368,0,1368,3679,2018,12,0110,01,distributionGO_thanaconsuprocess
Joypurhat Sadar,2370039,14180,2384219,3132660,225517,120195,7343,23,7366,567,10990,158,11148,3594,3173,4815,0,0,0,0,0,11832,4395,2668,7006,18838,2018,12,0110,01,distributionGO_thanaconsuprocess
Kalai,1394888,4493,1399381,1006063,131129,55965,1801,0,1801,230,3095,152,3247,972,2607,4013,0,5,0,0,82,1537,932,0,932,2469,2018,12,0110,01,distributionGO_thanaconsuprocess
Patharghata,1106043,8670,1114713,749413,238055,118321,2946,3,2949,234,4649,298,4947,1295,3078,16918,0,0,71735,18820,176,2375,107,644,751,3126,2018,12,0301,03,distributionGO_thanaconsuprocess
Bmna,491341,4565,495906,359182,39222,18543,1701,1,1702,188,4438,60,4498,1352,1333,5699,34,0,44940,129048,1850,1219,55,279,334,1553,2018,12,0301,03,distributionGO_thanaconsuprocess
Amtali,2299477,14506,2313983,1179524,334720,170534,3206,5,3211,87,10431,20,10451,1870,3975,16770,64,0,78588,0,6253,4371,713,0,713,5084,2018,12,0301,03,distributionGO_thanaconsuprocess
Betagi,738550,6199,744749,492270,122273,61396,4377,0,4377,104,2866,22,2888,272,2842,11401,150,0,30187,50004,7,1794,297,33,330,2124,2018,12,0301,03,distributionGO_thanaconsuprocess
Barguna Sadar,2036537,16163,2052700,1172226,515319,292446,9786,4,9790,64,11678,150,11828,365,4689,17268,115,9,12241,0,40,3659,298,514,812,4471,2018,12,0301,03,distributionGO_thanaconsuprocess
Panchlaish,1988240,4208,1992448,8768368,668351,304793,15028,212,15240,964,14155,531,14686,2802,12147,7213,339,0,0,5298,0,11757,2589,1757,4331,16088,2018,12,0507,05,distributionGO_thanaconsuprocess
Rangunia,2542026,10572,2552598,3167214,240460,129582,8990,15,9005,993,6724,8,6732,2973,6594,4683,18,0,0,0,0,729,1738,101,1834,2563,2018,12,0507,05,distributionGO_thanaconsuprocess
Doublemooring,2770749,7663,2778412,11647362,951207,443668,18591,361,18952,1599,18647,849,19496,4771,10619,5854,0,0,0,0,0,13305,2959,2112,5034,18339,2018,12,0507,05,distributionGO_thanaconsuprocess
Fatichhari,2668809,16591,2685400,3947571,362400,199424,9086,2,9088,1205,13545,0,13545,6395,7154,11144,0,0,0,0,0,633,3067,124,3191,3824,2018,12,0507,05,distributionGO_thanaconsuprocess
Hathazari,2266688,8864,2275552,4052157,173962,99383,7194,20,7214,295,5905,0,5905,1884,4714,6006,0,14,0,0,137,1203,1993,117,2073,3276,2018,12,0507,05,distributionGO_thanaconsuprocess
Sitakunda,2780049,7716,2787765,3876983,314915,146979,10336,15,10351,112,7226,0,7226,404,5133,7743,0,0,0,0,1,542,2066,0,2066,2608,2018,12,0507,05,distributionGO_thanaconsuprocess
Mirsharai,2151205,8815,2160020,1809867,403673,192750,10183,32,10215,210,6832,22,6854,1987,5912,5970,0,0,0,0,0,153,1845,271,2116,2269,2018,12,0507,05,distributionGO_thanaconsuprocess
Rawzan,2292338,11573,2303911,4248429,202371,98792,10020,36,10056,370,4965,80,5045,1345,7260,4044,46,10,0,0,124,1508,2044,9,2051,3559,2018,12,0507,05,distributionGO_thanaconsuprocess
Sandwip,1789715,10683,1800398,1362189,272920,139309,10206,3,10209,1989,3406,6,3412,891,2554,7095,38,0,0,0,0,380,593,88,673,1053,2018,12,0507,05,distributionGO_thanaconsuprocess
Boalkhali,1639165,5371,1644536,1155147,73113,40114,4824,26,4850,110,5915,125,6040,1168,2317,3869,1,5,0,0,34,869,1244,56,1292,2161,2018,12,0507,05,distributionGO_thanaconsuprocess
Chandlaish,1601111,7408,1608519,1635086,124834,67966,6349,6,6355,741,3664,0,3664,427,3413,7351,4,0,20,2977,578,636,1702,80,1780,2416,2018,12,0507,05,distributionGO_thanaconsuprocess
Banshkhali,2456405,11375,2467780,3091630,340439,181158,5915,0,5915,6,6211,479,6690,0,4187,6737,4,0,0,208,33,946,2751,0,2736,3682,2018,12,0507,05,distributionGO_thanaconsuprocess
Satkania,1661803,10423,1672226,1591012,203292,92715,6515,18,6533,208,5697,59,5756,564,5663,5345,50,0,0,0,0,693,1877,35,1895,2588,2018,12,0507,05,distributionGO_thanaconsuprocess
Anwara,1866990,5063,1872053,1871880,127545,71146,6008,124,6132,865,5090,0,5090,1627,2954,7620,5,0,0,0,36,922,1774,24,1790,2712,2018,12,0507,05,distributionGO_thanaconsuprocess
Patiya,3142109,17866,3159975,2701450,314507,176413,15491,917,16408,1516,14372,32,14404,4525,7166,15272,0,0,0,0,0,1554,3395,122,3460,5014,2018,12,0507,05,distributionGO_thanaconsuprocess
Lohagora,1755272,5204,1760476,1503556,227335,112849,4127,6,4133,374,3916,50,3966,838,2985,8075,0,0,0,99054,109,477,1690,86,1760,2237,2018,12,0507,05,distributionGO_thanaconsuprocess
Kaliakair,3365968,8623,3374591,2984172,135548,75375,6455,63,6518,210,5309,0,5309,2085,3719,10860,390,0,45,67883,677,1214,3141,1049,4193,5407,2018,12,0407,04,distributionGO_thanaconsuprocess
Sreepur,4451217,15213,4466430,5896308,269516,153008,9726,147,9873,870,8196,29,8225,2728,3299,11366,104,0,0,96307,1110,860,3268,598,3862,4722,2018,12,0407,04,distributionGO_thanaconsuprocess
Gazipur Sadar,5361608,13608,5375216,8106007,463471,241113,21111,156,21267,1233,10487,0,10487,2571,3468,12312,0,0,0,0,42,3421,3979,957,4915,8336,2018,12,0407,04,distributionGO_thanaconsuprocess
Kapasia,2707607,9751,2717358,2964352,164906,77623,7991,5,7996,698,3430,9,3439,1085,1100,4163,0,0,0,63430,119,632,3404,746,4151,4783,2018,12,0407,04,distributionGO_thanaconsuprocess
Kaliganj,2445515,7816,2453331,4344497,153732,86234,6009,12,6021,513,2260,58,2318,471,3687,9740,0,0,0,0,27,337,1679,332,2011,2348,2018,12,0407,04,distributionGO_thanaconsuprocess
Tongi,2284282,3730,2288012,5395453,243687,123077,7876,246,8122,361,8490,2,8492,543,1468,5082,251,0,3,0,0,9738,1842,806,2648,12386,2018,12,0407,04,distributionGO_thanaconsuprocess
Dherai,1669723,12269,1681992,3692424,96167,72566,3882,43,3925,648,3490,0,3490,918,3346,12738,95,0,738350,166920,10,2036,2778,2,2780,4816,2018,12,0604,06,distributionGO_thanaconsuprocess
Sunamganj Sadar,1511022,10348,1521370,2343698,169609,110605,4721,383,5104,1909,5980,0,5980,3349,3028,8722,96,0,0,73508,92,1199,3077,617,3694,4893,2018,12,0604,06,distributionGO_thanaconsuprocess
Dharmapasa,2195443,6800,2202243,2223861,188106,132859,3686,2,3688,291,3284,670,3954,116,2612,12871,41,0,0,39680,54,480,2743,34,2777,3257,2018,12,0604,06,distributionGO_thanaconsuprocess
Sulla,829844,4162,834006,1305714,41337,30980,1614,39,1653,157,1141,0,1141,343,1901,4914,16,0,0,15583,25,567,1053,1,1054,1621,2018,12,0604,06,distributionGO_thanaconsuprocess
Tahirpur,1442401,9129,1451530,2040029,72430,42374,4008,53,4061,1529,3478,81,3559,885,1605,12312,0,0,0,262036,0,1667,1842,45,1885,3552,2018,12,0604,06,distributionGO_thanaconsuprocess
Chhatak,1233053,8046,1241099,1839396,78737,47324,6903,31,6934,744,1109,7,1116,196,4250,7641,41,0,1350,299809,336,1891,3248,30,3278,5169,2018,12,0604,06,distributionGO_thanaconsuprocess
Jogonnathpur,1086884,7641,1094525,1740203,40707,27167,2458,1,2459,125,2962,0,2962,515,370,9520,0,0,0,0,3,2119,2640,0,2640,4759,2018,12,0604,06,distributionGO_thanaconsuprocess
Jamalganj,1529436,5732,1535168,1851352,172988,93718,1967,0,1967,837,1441,81,1522,280,1615,11821,3,0,0,175546,86,524,1424,0,1425,1949,2018,12,0604,06,distributionGO_thanaconsuprocess
Bishwamvarpur,959331,6440,965771,966414,63631,39466,1898,12,1910,128,2019,1,2020,228,2166,6503,0,0,0,31418,836,1671,1283,1,1284,2955,2018,12,0604,06,distributionGO_thanaconsuprocess
Dowara Bazar,1494997,58119,1553116,1304409,138169,85747,2067,10,2077,235,2603,73,2676,316,991,4264,59,0,363058,87214,991,2292,1532,17,1548,3840,2018,12,0604,06,distributionGO_thanaconsuprocess
Sadar (South),929745,12149,941894,1414241,74825,55274,2068,2,2070,180,2037,0,2037,502,1475,9654,0,0,4,180119,131,795,1767,0,1766,2561,2018,12,0604,06,distributionGO_thanaconsuprocess
Adarsho Sadar,2640712,10867,2651579,6170632,602990,291920,13381,1284,14665,951,13057,485,13542,3588,3889,18403,113,0,43180,0,48,6413,4428,2711,7135,13548,2018,12,0502,05,distributionGO_thanaconsuprocess
Chouddagram,2700744,13425,2714169,2568318,604265,331802,8696,298,8994,377,4160,420,4580,777,3741,10374,5,0,32690,0,20,1407,2863,712,3575,4982,2018,12,0502,05,distributionGO_thanaconsuprocess
Barura,3227455,12045,3239500,4819041,483621,255628,7756,220,7976,275,5238,237,5475,975,4448,16038,0,0,0,0,1,1909,1553,677,2230,4139,2018,12,0502,05,distributionGO_thanaconsuprocess
Laksham,1481148,7269,1488417,2174538,309770,142014,5522,0,5522,14,2978,320,3298,0,1026,12001,87,0,0,15,15,421,2738,373,3107,3528,2018,12,0502,05,distributionGO_thanaconsuprocess
Burichong,2863841,11831,2875672,5418847,293983,166549,8252,124,8376,331,7339,915,8254,1235,2436,16038,390,170,514833,301288,864,1812,1500,239,1722,3534,2018,12,0502,05,distributionGO_thanaconsuprocess
Brahmanpara,1193588,9112,1202700,1441224,168106,75982,4096,16,4112,44,2842,299,3141,244,2006,14728,0,0,0,0,1,364,2199,180,2369,2733,2018,12,0502,05,distributionGO_thanaconsuprocess
Homna,1188421,6845,1195266,3456880,214343,118035,4160,0,4160,268,1666,18,1684,391,2166,14019,4401,0,22849,28485,142,356,1371,704,2073,2429,2018,12,0502,05,distributionGO_thanaconsuprocess
Muradnagar,3987792,16565,4004357,9204717,624980,333474,11551,27,11578,1158,8448,18,8466,44,4392,20580,0,84,0,6,79,473,4552,644,5176,5649,2018,12,0502,05,distributionGO_thanaconsuprocess
Debidwar,3091664,19180,3110844,4332618,432231,236688,13365,2339,15704,1183,4045,106,4151,272,3087,16569,0,0,6270,0,3,895,3039,1704,4679,5574,2018,12,0502,05,distributionGO_thanaconsuprocess
Daudkandi,1881950,13593,1895543,3980266,360712,190440,10667,397,11064,692,4206,89,4295,1415,4869,14932,0,2,62874,0,0,1264,4234,953,5189,6453,2018,12,0502,05,distributionGO_thanaconsuprocess
Chandina,2299372,9728,2309100,4153682,408734,220160,5512,365,5877,505,1971,109,2080,589,1802,9800,0,0,0,0,0,2211,1211,1100,2311,4522,2018,12,0502,05,distributionGO_thanaconsuprocess
Nangolkot,1588932,12954,1601886,5413374,466918,228713,4893,108,5001,120,5652,2,5654,103,3617,14684,0,0,40437,82100,26,52,3433,28,3461,3513,2018,12,0502,05,distributionGO_thanaconsuprocess
Meghna,590913,4206,595119,817766,145343,77796,1653,17,1670,120,906,8,914,251,1305,14341,1,11,10269,12796,417,86,1534,0,1534,1620,2018,12,0502,05,distributionGO_thanaconsuprocess
Titash,742872,6199,749071,1970251,176228,97726,3643,84,3727,34,1966,22,1988,265,2309,8933,0,0,210,0,2,307,1692,785,2477,2784,2018,12,0502,05,distributionGO_thanaconsuprocess
Comilla Sadar South,2449147,14127,2463274,2142900,375531,209364,6075,295,6370,252,4122,135,4257,903,1858,11535,0,0,0,0,0,1581,2344,504,2831,4412,2018,12,0502,05,distributionGO_thanaconsuprocess
Monohargonj,1124974,9256,1134230,1435190,239741,105631,3208,128,3336,242,2138,283,2421,39,1070,11485,23,0,2820,3108,204,313,2263,315,2555,2868,2018,12,0502,05,distributionGO_thanaconsuprocess
Dighinala,1080032,4246,1084278,1153078,145362,88160,2116,41,2157,420,994,0,994,129,1676,3367,0,0,0,0,85,938,307,5,310,1248,2018,12,0510,05,distributionGO_thanaconsuprocess
Khagrachhari Sadar,896946,4326,901272,1133240,116021,66440,1572,1318,2890,198,2811,37,2848,1282,1798,3825,98,0,0,6300,223,1007,388,325,708,1715,2018,12,0510,05,distributionGO_thanaconsuprocess
Mahalchhari,558561,1520,560081,648567,55558,30801,1645,0,1645,106,1089,19,1108,365,600,817,0,0,0,75,77,971,110,2,112,1083,2018,12,0510,05,distributionGO_thanaconsuprocess
Panchhari,704149,2237,706386,403031,40791,21999,770,12,782,103,1033,97,1130,273,867,224,0,0,0,0,7,397,133,2,135,532,2018,12,0510,05,distributionGO_thanaconsuprocess
Ramgarh,536714,1686,538400,575750,39056,20253,1129,138,1267,183,1486,7,1493,488,1402,1504,0,0,0,1102,85,294,173,6,179,473,2018,12,0510,05,distributionGO_thanaconsuprocess
Manikchhari,286656,778,287434,235245,66603,37516,550,0,550,70,1205,0,1205,206,757,525,0,0,0,94,64,272,609,0,609,881,2018,12,0510,05,distributionGO_thanaconsuprocess
Matiranga,1116211,4601,1120812,1300582,142240,75998,3051,14,3065,18,2296,0,2296,12,1253,4248,0,0,0,0,0,1846,966,3,969,2815,2018,12,0510,05,distributionGO_thanaconsuprocess
Lakshmichhari,333683,819,334502,229471,17979,8994,1448,64,1512,146,342,0,342,79,1110,783,3,0,0,0,0,199,208,1,208,407,2018,12,0510,05,distributionGO_thanaconsuprocess
Narshingdi Sadar,6176328,7901,6184229,7986958,975747,638360,12874,56,12930,59,10273,0,10273,50,2212,112,0,0,0,0,0,9516,7792,2314,10121,19637,2018,12,0410,04,distributionGO_thanaconsuprocess
Raipura,3237168,16634,3253802,9850344,588796,330717,18079,57,18136,856,2929,0,2929,78,5606,914,0,0,0,0,60,275,6077,5,6068,6343,2018,12,0410,04,distributionGO_thanaconsuprocess
Monohordi,2153285,2998,2156283,3416344,351057,184890,10280,0,10280,0,2566,0,2566,0,1975,9677,0,0,0,0,0,106,4305,55,4359,4465,2018,12,0410,04,distributionGO_thanaconsuprocess
Shibpur,2441223,10535,2451758,3219628,311914,196711,11487,0,11487,374,7367,69,7436,1977,2058,4421,0,0,0,1197,487,684,2673,22,2695,3379,2018,12,0410,04,distributionGO_thanaconsuprocess
Palash,1651364,5744,1657108,1317426,239758,106543,5173,10,5183,232,3861,0,3861,1533,674,4144,0,0,0,105590,9,842,1601,19,1619,2461,2018,12,0410,04,distributionGO_thanaconsuprocess
Belaboo,1625519,7017,1632536,1965617,188792,105081,6666,51,6717,451,5129,0,5129,1714,1511,3516,0,0,0,0,0,275,2719,221,2937,3212,2018,12,0410,04,distributionGO_thanaconsuprocess
Mymensingh Sadar,7651258,44840,7696098,8180636,426218,256573,16033,759,16792,726,28229,118,28347,5676,2557,7111,0,0,0,0,0,22395,2598,2720,5244,27639,2018,12,0415,08,distributionGO_thanaconsuprocess
Trisal,5885406,15281,5900687,3627659,277273,155388,6056,3,6059,523,7232,1233,8465,2529,1597,10597,0,0,1,0,8,4107,604,0,599,4706,2018,12,0415,08,distributionGO_thanaconsuprocess
Fulbaria,5657701,25219,5682920,2367928,192622,117110,6889,15,6904,404,5571,105,5676,1115,273,409,0,0,0,0,0,3725,308,11,319,4044,2018,12,0415,08,distributionGO_thanaconsuprocess
Bhaluka,4581819,14161,4595980,3804158,221871,138888,11277,39,11316,888,7229,16,7245,1385,1045,5042,8,0,0,0,25,4048,1032,1274,2288,6336,2018,12,0415,08,distributionGO_thanaconsuprocess
Muktagacha,6496850,12212,6509062,4661784,289493,164880,6230,13,6243,232,7146,36,7182,942,1304,6963,0,0,0,0,3,4625,224,1,216,4841,2018,12,0415,08,distributionGO_thanaconsuprocess
Gafargaon,5264412,20518,5284930,5111788,260986,160493,8519,0,8519,1866,3934,65,3999,1402,2668,11773,0,0,0,0,0,2378,2033,0,2032,4410,2018,12,0415,08,distributionGO_thanaconsuprocess
Phulpur,6883537,22983,6906520,3149415,275406,153158,14518,7,14525,2481,15736,48,15784,4456,3250,9297,8,0,0,0,0,4677,2372,316,2675,7352,2018,12,0415,08,distributionGO_thanaconsuprocess
Gouripur,3426910,9008,3435918,2588193,252377,146592,6205,16,6221,831,5908,100,6008,1469,919,4016,13,0,0,0,4,1392,1673,0,1673,3065,2018,12,0415,08,distributionGO_thanaconsuprocess
Ishwarganj,6201302,5959,6207261,2688471,226273,122549,3646,4,3650,208,7514,19,7533,2088,1491,8445,37,0,0,0,52,1853,1410,6,1416,3269,2018,12,0415,08,distributionGO_thanaconsuprocess
Nandail,6903001,10184,6913185,1765812,344831,205987,8322,2,8324,694,5945,16,5961,1848,1534,10708,0,0,0,0,10,1883,586,5,589,2472,2018,12,0415,08,distributionGO_thanaconsuprocess
Haluaghat,4552145,7075,4559220,3151739,281801,144295,3792,3,3795,29,8369,54,8423,1,1091,4666,20,0,0,3402,468,1890,1197,649,1795,3685,2018,12,0415,08,distributionGO_thanaconsuprocess
Dhubaura,2139200,4935,2144135,2617481,191538,105338,2810,33,2843,345,2426,38,2464,634,1676,3702,13,0,0,7508,210,1502,707,0,707,2209,2018,12,0415,08,distributionGO_thanaconsuprocess
Fenchuganj,403739,4168,407907,935779,46716,25615,2587,37,2624,211,1938,23,1961,713,406,4546,0,0,0,0,0,676,1522,20,1540,2216,2018,12,0601,06,distributionGO_thanaconsuprocess
Gowainghat,1391077,16658,1407735,2959014,305750,196776,4335,1,4336,547,2976,37,3013,1047,7509,16013,104,0,109,7495,217,865,2933,0,2933,3798,2018,12,0601,06,distributionGO_thanaconsuprocess
Jakiganj,1442548,8358,1450906,5337636,161410,108825,3883,2,3885,426,4560,200,4760,1822,1625,5426,8,0,0,0,9,1563,1010,0,1010,2573,2018,12,0601,06,distributionGO_thanaconsuprocess
Jaintapur,914507,5626,920133,3072094,267713,161857,5482,39,5521,484,2556,12,2568,559,1838,8886,128,0,0,0,240,1036,1435,0,1435,2471,2018,12,0601,06,distributionGO_thanaconsuprocess
Balaganj,1655969,12284,1668253,4918915,265998,166718,3627,4,3631,795,5727,45,5772,2422,3243,10453,1,0,0,0,86,895,4277,0,4260,5155,2018,12,0601,06,distributionGO_thanaconsuprocess
Golapganj,1141598,7812,1149410,3599422,105796,58289,4394,5,4399,398,4396,31,4427,1942,2718,6011,18,0,0,0,3,848,2008,0,2008,2856,2018,12,0601,06,distributionGO_thanaconsuprocess
Sylhet Sadar,4418782,19636,4438418,7684401,796984,577181,10571,1077,11648,781,19757,406,20163,4249,3718,5707,15,0,0,0,257,8928,17658,7381,25028,33956,2018,12,0601,06,distributionGO_thanaconsuprocess
Biani Bazar,1094571,14146,1108717,2817074,87381,53291,8298,20,8318,408,1495,0,1495,433,795,3314,8,0,80,58788,398,811,700,207,907,1718,2018,12,0601,06,distributionGO_thanaconsuprocess
Kanaighat,1579072,12906,1591978,4504292,278721,171093,3550,13,3563,1086,2784,29,2813,894,3059,4403,0,0,0,310174,179,1794,1335,0,1334,3128,2018,12,0601,06,distributionGO_thanaconsuprocess
Biswanath,634945,4637,639582,1284151,64360,38074,3733,2,3735,141,3356,0,3356,1520,345,8117,0,77,0,15554,239,880,3476,0,3426,4306,2018,12,0601,06,distributionGO_thanaconsuprocess
Companiganj,982141,8587,990728,2319041,177981,108429,2567,3,2570,861,2966,110,3076,759,1518,3914,0,0,0,866,347,157,2270,0,2270,2427,2018,12,0601,06,distributionGO_thanaconsuprocess
South Shurma,1712979,33872,1746851,4178106,148724,103587,2580,6,2586,84,1753,1,1754,127,981,4365,29,0,0,0,98,1574,3983,2,3981,5555,2018,12,0601,06,distributionGO_thanaconsuprocess
Gangachara,2964329,9635,2973964,1146442,502665,298203,5396,13,5409,620,11527,164,11691,3277,2536,8528,0,0,0,47960,66,10702,837,41,878,11580,2018,12,0105,07,distributionGO_thanaconsuprocess
Pirganj,5677416,13202,5690618,3678985,623688,292993,9764,72,9836,1211,7019,0,7019,1685,1961,13376,0,0,0,0,6,1517,1665,8,1673,3190,2018,12,0105,07,distributionGO_thanaconsuprocess
Pirgachha,3538758,6165,3544923,2775548,568924,308842,10175,38,10213,741,6943,278,7221,1082,2618,5226,49,2,847000,392891,149,3476,1359,0,1353,4829,2018,12,0105,07,distributionGO_thanaconsuprocess
Badarganj,3546562,11198,3557760,1430020,300497,175112,5029,24,5053,80,8193,0,8193,2626,1936,8172,0,18,511815,309810,115,9329,1282,0,1282,10611,2018,12,0105,07,distributionGO_thanaconsuprocess
Mithapukur,5578885,12364,5591249,3540400,655880,303973,4544,0,4544,104,13456,201,13657,4515,4679,12944,0,0,0,0,7,1918,1400,6,1400,3318,2018,12,0105,07,distributionGO_thanaconsuprocess
Kaunia,2148550,5770,2154320,1832511,455071,231399,5415,217,5632,634,7887,50,7937,1632,2062,6225,3,0,0,0,31,3701,914,3,920,4621,2018,12,0105,07,distributionGO_thanaconsuprocess
Rangpur Sadar,5015462,17790,5033252,5179103,977079,481466,12843,526,13369,1055,23325,279,23604,5981,3821,17766,56,0,0,0,31,22158,15643,5532,21175,43333,2018,12,0105,07,distributionGO_thanaconsuprocess
Taraganj,1493925,6133,1500058,929862,166785,92202,1837,1,1838,185,8640,0,8640,5046,1962,5642,2,16,215,5906,636,6678,1380,0,1370,8048,2018,12,0105,07,distributionGO_thanaconsuprocess
Rajoir,2556538,11280,2567818,2583864,256916,131963,5340,0,5340,12,5349,30,5379,13,1222,5368,1,0,0,0,23,112,2307,62,2252,2364,2018,12,0402,04,distributionGO_thanaconsuprocess
Kalkini,2211531,11807,2223338,1566692,213169,106771,6469,0,6469,433,7870,200,8070,576,2769,11047,0,0,0,0,44,815,1307,0,1300,2115,2018,12,0402,04,distributionGO_thanaconsuprocess
Shibchar,3594155,14861,3609016,3915699,434833,217419,5888,0,5888,557,7273,0,7273,0,4800,10692,0,0,0,0,7,425,1358,100,1456,1881,2018,12,0402,04,distributionGO_thanaconsuprocess
Madaripur Sadar,2729927,17196,2747123,2782879,582004,345583,11794,125,11919,963,9566,571,10137,1776,2917,12303,113,1,18,27,45,727,2853,1253,4106,4833,2018,12,0402,04,distributionGO_thanaconsuprocess
Digholia,3233637,7727,3241364,9660780,664563,430931,6405,12,6417,10,8064,719,8783,1241,1672,7302,46,0,5,0,83,2753,2173,560,2720,5473,2018,12,0208,02,distributionGO_thanaconsuprocess
Dumuria,2908282,5865,2914147,3256530,261687,176438,8667,0,8667,156,11789,100,11889,1866,3901,8989,139,0,0,0,81,1864,4485,29,4510,6374,2018,12,0208,02,distributionGO_thanaconsuprocess
Khulna Sadar,5455931,2820,5458751,15353685,772691,366566,11370,2252,13622,762,10366,70,10436,1927,5936,1897,66,0,0,966,276,36402,3367,1167,4434,40836,2018,12,0208,02,distributionGO_thanaconsuprocess
Dacope,1586537,4383,1590920,892845,106601,55083,3181,1,3182,36,4306,401,4707,588,1404,4164,46,0,0,0,12,1667,1933,22,1954,3621,2018,12,0208,02,distributionGO_thanaconsuprocess
Terokhada,1379566,3495,1383061,1800458,50011,32791,3059,2,3061,118,4301,13,4314,684,1727,3966,55,0,0,0,33,579,911,59,958,1537,2018,12,0208,02,distributionGO_thanaconsuprocess
Fultala,1174807,3550,1178357,2787747,145456,79748,5474,0,5474,148,3646,128,3774,890,1571,5198,4,0,0,0,0,994,1233,150,1383,2377,2018,12,0208,02,distributionGO_thanaconsuprocess
Batiaghata,1701870,6847,1708717,1684409,112172,67982,5272,4,5276,537,3283,50,3333,824,2144,6639,11,0,0,0,5,2188,929,58,979,3167,2018,12,0208,02,distributionGO_thanaconsuprocess
Paikgachha,2937100,7277,2944377,1733423,156879,88387,3359,5,3364,269,8029,161,8190,1371,1422,4440,17,0,0,0,7,1458,3418,462,3879,5337,2018,12,0208,02,distributionGO_thanaconsuprocess
Rupsha,1609418,4411,1613829,1735030,111815,55718,6327,7,6334,261,3469,807,4276,769,1835,4566,76,21,1,0,72,1632,2350,386,2736,4368,2018,12,0208,02,distributionGO_thanaconsuprocess
Koyra,2792109,9414,2801523,1641887,86773,47638,1751,6,1757,80,4083,44,4127,708,1877,5356,4,0,0,1849,152,1144,1576,5,1581,2725,2018,12,0208,02,distributionGO_thanaconsuprocess
Harinakunda,2235181,8141,2243322,793557,147399,81296,4066,149,4215,520,8639,165,8804,2577,1374,5075,474,71,13,41,10,64,1899,914,2813,2877,2018,12,0204,02,distributionGO_thanaconsuprocess
Moheshpur,2300010,8428,2308438,2835852,474325,260018,6409,37,6446,251,5819,49,5868,181,3638,5856,213,96,0,0,0,302,3043,855,3896,4198,2018,12,0204,02,distributionGO_thanaconsuprocess
Jhenaidaha Sadar,4064407,11236,4075643,3797196,478772,258708,10070,105,10175,589,11186,225,11411,1181,6980,6700,288,1,0,0,0,262,2877,1876,4753,5015,2018,12,0204,02,distributionGO_thanaconsuprocess
Kotchandpur,1211699,4066,1215765,1063028,140352,88475,1775,14,1789,100,3325,39,3364,424,1166,2727,63,14,0,0,0,148,1105,637,1742,1890,2018,12,0204,02,distributionGO_thanaconsuprocess
Kaliganj,2565582,8490,2574072,2074352,190841,119005,2979,0,2979,356,4550,18,4568,1481,4443,8325,191,72,11,0,0,155,2227,1361,3588,3743,2018,12,0204,02,distributionGO_thanaconsuprocess
Sailkupa,3964322,10311,3974633,3472614,258155,136516,3762,53,3815,434,11609,212,11821,2786,7077,8554,396,0,0,0,0,1142,2992,944,3936,5078,2018,12,0204,02,distributionGO_thanaconsuprocess
Kathalia,937920,4917,942837,1002368,135012,58359,3280,0,3280,3,1604,0,1604,0,7179,6351,0,0,0,0,81,1275,238,19,257,1532,2018,12,0304,03,distributionGO_thanaconsuprocess
Jhalakati Sadar,1479689,9564,1489253,1380247,159597,76697,4189,62,4251,301,6909,237,7146,2140,1869,7086,141,0,0,0,64,1063,1752,681,2429,3492,2018,12,0304,03,distributionGO_thanaconsuprocess
Rajapur,889682,5728,895410,1219351,101846,52806,1444,0,1444,148,1333,0,1333,421,2091,5128,56,2,0,0,40,1095,280,371,651,1746,2018,12,0304,03,distributionGO_thanaconsuprocess
Nalchhiti,1166504,10428,1176932,933798,223662,123043,5106,5,5111,529,4123,114,4237,1966,3720,11242,24,0,0,36172,174,1333,1915,0,1915,3248,2018,12,0304,03,distributionGO_thanaconsuprocess
Atghoria,1486618,4664,1491282,1238524,113099,50017,4309,5,4314,152,3740,50,3790,879,3052,5853,28,0,0,0,4,388,608,2,609,997,2018,12,0115,01,distributionGO_thanaconsuprocess
Pabna Sadar,8354783,18927,8373710,8941580,1362005,757092,19189,2541,21730,2855,10709,129,10838,4011,14634,8014,23,0,33,0,73,11751,2870,1606,4420,16171,2018,12,0115,01,distributionGO_thanaconsuprocess
Chatmohor,3880519,13699,3894218,3976367,148238,83638,10355,1,10356,297,4993,0,4993,1034,4662,15636,0,0,0,251,668,744,1747,0,1746,2490,2018,12,0115,01,distributionGO_thanaconsuprocess
Ishwardi,2713748,11906,2725654,4408687,376757,184584,8738,28,8766,1077,8939,308,9247,3882,3781,10201,0,0,0,0,0,932,2044,417,2461,3393,2018,12,0115,01,distributionGO_thanaconsuprocess
Faridpur,855451,4730,860181,1149919,187925,96913,3838,104,3942,384,3109,0,3109,434,3018,6335,0,0,0,0,28,905,415,100,515,1420,2018,12,0115,01,distributionGO_thanaconsuprocess
Sujanagar,2457772,10012,2467784,2682890,314205,187893,11138,0,11138,497,3217,200,3417,671,4514,12665,0,0,0,0,51,92,710,1,711,803,2018,12,0115,01,distributionGO_thanaconsuprocess
Santhia,3930565,14657,3945222,2677380,611638,345893,9235,4,9239,812,6055,87,6142,3124,4977,13400,2,0,0,0,0,1570,2017,297,2314,3884,2018,12,0115,01,distributionGO_thanaconsuprocess
Bera,2350925,10929,2361854,1997551,261905,124017,9818,0,9818,505,4788,0,4788,1339,3261,8061,0,0,0,0,0,1128,1270,0,1270,2398,2018,12,0115,01,distributionGO_thanaconsuprocess
Bhangoora,1338086,4419,1342505,1287072,44919,20491,3577,12,3589,276,1830,0,1830,649,3170,5727,0,0,0,0,3,832,405,0,405,1237,2018,12,0115,01,distributionGO_thanaconsuprocess
Kalia,1530039,15131,1545170,2181638,121311,66147,5969,0,5969,16,1707,0,1707,0,3575,12696,162,0,1034076,151444,28,590,3296,10,3303,3893,2018,12,0206,02,distributionGO_thanaconsuprocess
Lohagara,2119270,9038,2128308,2848922,240344,127562,5406,62,5468,136,4732,34,4766,74,5303,7127,19,0,522393,452424,0,1163,2363,261,2620,3783,2018,12,0206,02,distributionGO_thanaconsuprocess
Narail Sadar,3208273,11304,3219577,3770994,328499,167322,6407,67,6474,735,6190,61,6251,1238,4469,9030,82,5,409,78921,0,752,3594,738,4328,5080,2018,12,0206,02,distributionGO_thanaconsuprocess
Sariakandi,1519496,9422,1528918,1941214,219628,116053,5666,24,5690,512,11822,253,12075,3925,3488,6329,0,0,0,0,19,3570,2063,0,2063,5633,2018,12,0109,01,distributionGO_thanaconsuprocess
Sherpur,3123704,5848,3129552,3486228,276174,139761,6283,4,6287,628,8968,135,9103,2944,4038,5237,0,0,0,0,11,1724,3946,354,4297,6021,2018,12,0109,01,distributionGO_thanaconsuprocess
Shibganj,3871315,8614,3879929,3836998,460806,280509,4461,33,4494,244,8998,216,9214,937,6349,8953,0,0,0,0,32,2937,3319,285,3604,6541,2018,12,0109,01,distributionGO_thanaconsuprocess
Dhunot,3292593,14382,3306975,3305198,391532,174477,5896,47,5943,404,7435,243,7678,1778,2776,6565,0,0,0,0,68,1398,1734,35,1763,3161,2018,12,0109,01,distributionGO_thanaconsuprocess
Dupchanchia,1356118,7808,1363926,1117068,144394,66581,4089,16,4105,244,7878,201,8079,2051,2201,6173,71,0,0,0,109,1511,1576,777,2353,3864,2018,12,0109,01,distributionGO_thanaconsuprocess
Nandigram,2483322,2924,2486246,1250076,82500,34437,2562,0,2562,54,3392,100,3492,585,1690,6700,0,0,0,1080,15,1358,1520,402,1922,3280,2018,12,0109,01,distributionGO_thanaconsuprocess
Adamdighi,1533173,9619,1542792,1700857,104600,46389,3909,47,3956,379,4333,0,4333,1090,2627,4477,15,0,1,0,24,1594,2119,42,2160,3754,2018,12,0109,01,distributionGO_thanaconsuprocess
Bogra Sadar,3580196,5753,3585949,8542377,437047,224904,9861,902,10763,907,23942,819,24761,5631,7204,2221,9,24,19,0,0,6790,3452,1913,5378,12168,2018,12,0109,01,distributionGO_thanaconsuprocess
Kahaloo,1931995,9587,1941582,2289949,121887,63204,3989,36,4025,168,11751,219,11970,2427,3329,6012,42,0,0,0,4,2290,830,0,829,3119,2018,12,0109,01,distributionGO_thanaconsuprocess
Gabtali,2699598,8532,2708130,4106227,454234,218203,3596,15,3611,360,11608,396,12004,4903,3935,5005,0,0,0,0,116,654,777,4,776,1430,2018,12,0109,01,distributionGO_thanaconsuprocess
Sonatola,2606984,7704,2614688,2838915,194095,94149,7048,55,7103,427,7106,0,7106,2978,2461,6288,0,0,0,0,15,1127,1035,145,1180,2307,2018,12,0109,01,distributionGO_thanaconsuprocess
Shajahanpur,3427536,6983,3434519,5732158,216682,100505,5203,5,5208,425,9653,81,9734,2964,4843,4688,0,0,0,0,28,6390,2805,246,3054,9444,2018,12,0109,01,distributionGO_thanaconsuprocess
Mathbaria,2504302,14083,2518385,1454196,240724,123832,9750,0,9750,813,3033,0,3033,819,2955,8848,0,0,0,766377,155,1440,921,122,1027,2467,2018,12,0306,03,distributionGO_thanaconsuprocess
Nazirpur,1534306,15693,1549999,1531008,163508,94537,3925,37,3962,219,3124,91,3215,1033,1509,11095,0,0,0,475589,137,728,1167,134,1301,2029,2018,12,0306,03,distributionGO_thanaconsuprocess
Bhandaria,1035808,11162,1046970,1590004,136440,75315,3757,0,3757,68,3183,76,3259,1013,1925,9773,0,18,0,359997,13,754,206,471,680,1434,2018,12,0306,03,distributionGO_thanaconsuprocess
Pirojpur Sadar,1265290,7865,1273155,1502964,170302,82446,7687,127,7814,363,5624,161,5785,1752,3728,6786,53,0,0,657595,248,847,1134,1091,2201,3048,2018,12,0306,03,distributionGO_thanaconsuprocess
Nesarabad,1541387,11310,1552697,931071,136087,76229,4779,57,4836,466,4594,45,4639,1081,2588,7440,0,0,0,523088,134,545,979,46,1025,1570,2018,12,0306,03,distributionGO_thanaconsuprocess
Kawkhali,553893,3977,557870,550591,49899,27681,2814,59,2873,348,1945,66,2011,299,1659,2786,0,0,2480,212877,660,313,235,26,261,574,2018,12,0306,03,distributionGO_thanaconsuprocess
Indurkani,521282,7411,528693,405016,89026,43554,2769,2,2771,147,1910,0,1910,389,1704,6396,0,0,0,261544,0,242,161,167,322,564,2018,12,0306,03,distributionGO_thanaconsuprocess
Atpara,1751186,4409,1755595,1392550,107101,59229,2760,1,2761,250,3991,110,4101,538,1177,4945,0,0,0,0,39,1680,730,3,728,2408,2018,12,0417,08,distributionGO_thanaconsuprocess
Kalmakanda,2824551,4116,2828667,3322055,179550,103913,3526,3,3529,81,3427,214,3641,137,1093,2271,0,0,0,273,108,1842,956,2,956,2798,2018,12,0417,08,distributionGO_thanaconsuprocess
Modan,1783935,5161,1789096,1555042,90085,53212,2906,15,2921,110,3426,219,3645,1041,787,5853,0,0,0,0,91,1558,520,74,594,2152,2018,12,0417,08,distributionGO_thanaconsuprocess
Purbadhala,3440103,5561,3445664,2291647,293278,170622,5716,2,5718,402,7918,398,8316,910,1028,3904,3,0,0,0,163,1898,2060,0,2055,3953,2018,12,0417,08,distributionGO_thanaconsuprocess
Kendua,3201814,11483,3213297,1864604,181886,100637,8617,29,8646,1686,5284,650,5934,1983,1775,7246,0,0,0,1697,1,1990,1944,9,1953,3943,2018,12,0417,08,distributionGO_thanaconsuprocess
Netrokona Sadar,3444744,10753,3455497,3885847,339657,200976,6301,7,6308,510,9398,1473,10871,2492,1877,7167,250,0,0,1115,1181,3868,2425,1870,4264,8132,2018,12,0417,08,distributionGO_thanaconsuprocess
Durgapur,2448424,4169,2452593,2491270,267373,160709,4372,10,4382,238,4968,7,4975,517,859,1134,10,0,0,26862,882,1405,1601,0,1587,2992,2018,12,0417,08,distributionGO_thanaconsuprocess
Barhatta,1920801,8360,1929161,1868227,166522,108365,2890,8,2898,310,2850,0,2850,1057,960,3950,0,0,0,0,41,1411,1667,9,1676,3087,2018,12,0417,08,distributionGO_thanaconsuprocess
Mohonganj,2370425,3969,2374394,1572575,133634,82371,5546,10,5556,315,3227,100,3327,962,1095,4118,32,0,0,1460,229,1557,2024,9,2020,3577,2018,12,0417,08,distributionGO_thanaconsuprocess
Khaliajhuri,764802,3525,768327,907229,64357,35170,988,0,988,114,1593,0,1593,22,1666,1036,0,0,0,0,2,337,1418,3,1414,1751,2018,12,0417,08,distributionGO_thanaconsuprocess
Gobindaganj,6826170,11722,6837892,4725815,553036,306613,8676,24,8700,628,11717,0,11717,754,4299,5038,2,0,0,0,33,4409,3526,14,3503,7912,2018,12,0107,07,distributionGO_thanaconsuprocess
Sundarganj,6275841,12414,6288255,3646856,750265,440958,18004,0,18004,3307,21078,0,21078,9064,3446,8933,0,0,0,698339,218,5126,5102,6,5101,10227,2018,12,0107,07,distributionGO_thanaconsuprocess
Fulchhari,1824305,6351,1830656,2074764,340815,196444,4657,5,4662,1241,4924,103,5027,1152,2145,4624,21,0,0,36652,264,1276,1163,1,1162,2438,2018,12,0107,07,distributionGO_thanaconsuprocess
Sadullahpur,3765974,8213,3774187,3327693,513784,295423,8130,0,8130,1177,7525,7,7532,1664,3887,8177,0,0,20,0,49,4831,3365,0,3365,8196,2018,12,0107,07,distributionGO_thanaconsuprocess
Palashbari,2900721,8193,2908914,1227088,365477,190347,6899,40,6939,316,11382,102,11484,1394,4429,8175,0,0,0,0,64,3047,1550,93,1642,4689,2018,12,0107,07,distributionGO_thanaconsuprocess
Shaghata,3316810,7896,3324706,1322968,243602,126356,6155,0,6155,839,5568,2,5570,730,3519,7302,0,0,0,0,4,1602,2738,78,2809,4411,2018,12,0107,07,distributionGO_thanaconsuprocess
Gaibandha Sadar,4734083,14025,4748108,2581620,728392,357536,9975,485,10460,924,22453,685,23138,7540,4264,19411,11,0,0,934,114,4053,3852,1009,4838,8891,2018,12,0107,07,distributionGO_thanaconsuprocess
Sreemongal,2072697,11270,2083967,2173156,245984,136727,6321,37,6358,761,8285,220,8505,2865,5934,9784,0,0,0,42850,8,3913,1958,63,2021,5934,2018,12,0603,06,distributionGO_thanaconsuprocess
Barlekha,1303459,7658,1311117,1394371,85559,53622,3221,0,3221,315,4162,2,4164,826,2101,4341,0,3,0,12258,1140,1207,3429,85,3515,4722,2018,12,0603,06,distributionGO_thanaconsuprocess
Moulavi Bazar Sadar,1504155,13734,1517889,1772306,180504,102507,7087,307,7394,791,5744,10,5754,3053,5836,8146,86,0,0,0,12,8268,4360,901,5250,13518,2018,12,0603,06,distributionGO_thanaconsuprocess
Kulaura,1647262,9781,1657043,1900273,332388,193262,4240,1,4241,29,5010,71,5081,1030,14192,4212,0,1,0,23410,41,1984,2675,0,2675,4659,2018,12,0603,06,distributionGO_thanaconsuprocess
Rajnagar,1335945,7985,1343930,1283816,243265,120056,4649,0,4649,27,5116,80,5196,2561,3141,3518,127,0,0,307,799,565,1937,9,1946,2511,2018,12,0603,06,distributionGO_thanaconsuprocess
Komolganj,2371373,10120,2381493,2307370,176939,110167,5002,129,5131,1244,3444,74,3518,1629,3406,9227,81,0,0,0,22,1593,1178,20,1198,2791,2018,12,0603,06,distributionGO_thanaconsuprocess
Juri,781066,9316,790382,982091,58173,38472,4085,11,4096,466,2711,7,2718,183,815,6350,0,1,0,0,88,1583,2621,0,2587,4170,2018,12,0603,06,distributionGO_thanaconsuprocess
Mirzapur,4387935,15499,4403434,3762952,134052,78896,7929,175,8104,248,4004,198,4202,192,3186,17111,2,44,13,63948,65,1358,3969,587,4353,5711,2018,12,0412,04,distributionGO_thanaconsuprocess
Nagarpur,3509524,15410,3524934,3070507,279296,173133,8262,1,8263,697,9105,1,9106,2480,2584,13959,146,4,0,0,0,896,1751,697,2446,3342,2018,12,0412,04,distributionGO_thanaconsuprocess
Bhuapur,3117994,10589,3128583,3571969,278084,140169,4279,0,4279,405,7179,0,7179,2732,1312,13570,0,0,0,0,26,1423,250,341,591,2014,2018,12,0412,04,distributionGO_thanaconsuprocess
Ghatail,6140172,12761,6152933,6559483,488542,284530,6011,5,6016,279,8311,600,8911,1481,2386,16389,1,0,0,0,13,3032,1054,420,1465,4497,2018,12,0412,04,distributionGO_thanaconsuprocess
Basail,1947188,4641,1951829,4789119,162057,98505,4734,22,4756,387,4472,293,4765,1267,1851,7314,0,11,0,54759,583,1381,2313,521,2833,4214,2018,12,0412,04,distributionGO_thanaconsuprocess
Tangail Sadar,4631361,14001,4645362,7856491,514316,282314,9488,377,9865,908,20407,315,20722,4579,5323,32502,10,0,0,0,0,9697,2801,4246,7042,16739,2018,12,0412,04,distributionGO_thanaconsuprocess
Kalihati,5549115,22746,5571861,6253328,709670,456807,9293,53,9346,743,11587,207,11794,5746,2899,21514,4,0,0,7554,357,1542,804,958,1753,3295,2018,12,0412,04,distributionGO_thanaconsuprocess
Modhupur,7176041,16406,7192447,4452963,567432,299100,4252,83,4335,717,7080,483,7563,2106,2676,24140,196,0,0,223468,882,3320,611,1256,1862,5182,2018,12,0412,04,distributionGO_thanaconsuprocess
Gopalpur,3000832,8913,3009745,3122013,369173,164755,5900,35,5935,841,4961,386,5347,1876,2716,18795,0,0,8,0,145,1921,475,1362,1837,3758,2018,12,0412,04,distributionGO_thanaconsuprocess
Shakhipur,3736168,12660,3748828,2491032,123178,74237,3406,10,3416,49,2809,99,2908,707,2406,17390,80,0,0,847,143,2255,1031,865,1893,4148,2018,12,0412,04,distributionGO_thanaconsuprocess
Delduar,2873625,6163,2879788,4480467,183963,98778,5703,3,5706,442,5962,65,6027,1983,2506,8055,0,0,0,0,256,2016,958,312,1270,3286,2018,12,0412,04,distributionGO_thanaconsuprocess
Patuakhali Sadar,2382963,15945,2398908,2495033,529318,276701,9997,833,10830,499,10457,234,10691,2142,6163,18166,50,0,0,0,2,2421,2683,819,3484,5905,2018,12,0302,03,distributionGO_thanaconsuprocess
Kalapara,2078753,7458,2086211,1214111,413247,246893,5184,0,5184,517,7123,48,7171,1631,2389,11033,0,0,0,0,0,3507,805,450,1222,4729,2018,12,0302,03,distributionGO_thanaconsuprocess
Mirzaganj,1049809,5585,1055394,924724,114874,47684,3759,0,3759,97,4599,21,4620,977,3030,9868,0,0,0,259645,54,648,891,46,934,1582,2018,12,0302,03,distributionGO_thanaconsuprocess
Golachipa,3596297,14731,3611028,1374736,559654,306938,2723,0,2723,95,12430,62,12492,3627,4422,16643,0,0,0,0,10,1769,1849,559,2400,4169,2018,12,0302,03,distributionGO_thanaconsuprocess
Bauphal,2222665,14895,2237560,1176539,407184,180115,7607,88,7695,292,7170,0,7170,1473,8449,7395,12,0,0,0,0,1255,2172,422,2594,3849,2018,12,0302,03,distributionGO_thanaconsuprocess
Dashmina,782775,9926,792701,347066,132668,66698,3297,0,3297,132,6615,36,6651,1164,1511,6781,101,20,7,0,15,1280,587,1,590,1870,2018,12,0302,03,distributionGO_thanaconsuprocess
Dumki,411380,3355,414735,317814,79838,36146,1785,8,1793,104,2742,0,2742,847,1070,3051,0,0,0,0,5,627,418,214,632,1259,2018,12,0302,03,distributionGO_thanaconsuprocess
Durgapur,1495590,3666,1499256,2339902,128908,57404,1193,0,1193,277,5546,98,5644,1418,2032,7690,124,0,0,137,131,112,2387,120,2507,2619,2018,12,0113,01,distributionGO_thanaconsuprocess
Poba (Sadar),2108506,5225,2113731,4866158,539336,286268,2494,1,2495,97,4157,442,4599,317,3212,2626,0,0,0,0,0,117,2026,24,2048,2165,2018,12,0113,01,distributionGO_thanaconsuprocess
Mohanpur,1910011,2787,1912798,2371902,289301,153539,2007,1,2008,125,5522,217,5739,1402,2577,5739,0,0,0,0,65,451,1301,24,1326,1777,2018,12,0113,01,distributionGO_thanaconsuprocess
Puthiya,2005308,6376,2011684,3093542,208484,113512,1643,0,1643,151,4961,118,5079,1762,2435,5837,63,0,0,99,103,54,2495,486,2981,3035,2018,12,0113,01,distributionGO_thanaconsuprocess
Bagmara,5050302,8290,5058592,6661040,421420,207411,9120,101,9221,1027,10770,225,10995,1304,4743,7187,24,0,0,0,16,1843,4080,277,4357,6200,2018,12,0113,01,distributionGO_thanaconsuprocess
Charghat,2122022,4668,2126690,2641351,237640,100541,3274,59,3333,230,5168,0,5168,1359,3347,4910,9,0,0,0,91,212,2437,274,2710,2922,2018,12,0113,01,distributionGO_thanaconsuprocess
Boalia,1639132,10832,1649964,12746029,440576,257508,7304,614,7918,781,16826,90,16916,5931,8870,6556,227,0,0,158,0,31475,13081,2605,15681,47156,2018,12,0113,01,distributionGO_thanaconsuprocess
Tanore,2152005,6085,2158090,1781460,150263,84852,3992,38,4030,424,16171,0,16171,4741,2579,7413,160,32,0,0,0,919,4505,235,4740,5659,2018,12,0113,01,distributionGO_thanaconsuprocess
Godagari,2771463,10296,2781759,3833370,488977,254398,5555,83,5638,621,3598,600,4198,1407,5033,7603,32,8,0,0,0,624,3712,1165,4875,5499,2018,12,0113,01,distributionGO_thanaconsuprocess
Bagha,1667956,5037,1672993,3255871,288183,138130,1567,17,1584,163,5571,98,5669,2096,1715,3450,13,0,0,3228,100,279,4344,260,4521,4800,2018,12,0113,01,distributionGO_thanaconsuprocess
Tala,2682238,9512,2691750,1849313,344843,167518,8159,273,8432,484,6308,0,6308,1336,3925,10569,11,9,9,13,72,1006,2229,265,2492,3498,2018,12,0210,02,distributionGO_thanaconsuprocess
Satkhira Sadar,4060882,11864,4072746,6667647,594213,327972,7515,75,7590,280,9192,602,9794,1970,3977,7233,11,0,72930,2370,573,2636,2834,1623,4443,7079,2018,12,0210,02,distributionGO_thanaconsuprocess
Kolaroa,1576681,7014,1583695,2726767,227352,123218,2696,89,2785,56,4124,0,4124,358,2819,9036,0,0,0,882536,0,3053,2622,396,3015,6068,2018,12,0210,02,distributionGO_thanaconsuprocess
Debhata,1169261,5560,1174821,1397070,93101,42378,1101,0,1101,147,3016,84,3100,1000,1667,4367,0,0,759497,96295,23,599,1763,374,2136,2735,2018,12,0210,02,distributionGO_thanaconsuprocess
Shyamnagar,3718254,7569,3725823,2261924,170310,87311,4093,8,4101,154,6102,35,6137,346,3017,7453,0,0,940617,579570,150,1905,1843,120,1960,3865,2018,12,0210,02,distributionGO_thanaconsuprocess
Kaliganj,2656984,9176,2666160,2630690,213744,97772,3086,77,3163,432,5527,670,6197,1755,3218,11564,34,0,771451,290230,101,672,3293,496,3790,4462,2018,12,0210,02,distributionGO_thanaconsuprocess
Asasuni,3096000,12013,3108013,2147061,200218,110914,2176,0,2176,86,5188,271,5459,758,2104,10549,1538,0,777671,548654,38,609,2165,359,3478,4087,2018,12,0210,02,distributionGO_thanaconsuprocess
Meherpur Sadar,1671188,5144,1676332,3785495,487264,223680,3500,44,3544,432,3759,177,3936,1537,3208,8095,228,0,40,3034,757,191,4143,1842,5982,6173,2018,12,0202,02,distributionGO_thanaconsuprocess
Gagni,2960415,5039,2965454,4638522,763205,402231,4802,94,4896,266,3923,70,3993,1829,3412,4650,0,0,0,0,0,63,2278,1158,3432,3495,2018,12,0202,02,distributionGO_thanaconsuprocess
Mujibnagar,446398,2412,448810,979122,176396,101934,1002,6,1008,13,1634,48,1682,8,1553,7255,0,0,0,30,100,14,1616,566,2182,2196,2018,12,0202,02,distributionGO_thanaconsuprocess
Katiadi,2801278,9496,2810774,4607866,305556,165274,8770,6,8776,936,6987,75,7062,2417,1460,9830,3,0,72,13116,4928,1363,2817,744,3538,4901,2018,12,0416,04,distributionGO_thanaconsuprocess
Bhariab Bazar,2892836,5526,2898362,4555250,265046,150324,8418,10,8428,626,7998,299,8297,2224,1688,14259,11,0,0,3,21,1122,5000,2436,7092,8214,2018,12,0416,04,distributionGO_thanaconsuprocess
Austagram,1556708,5797,1562505,2316743,159829,88807,4184,18,4202,576,2831,0,2831,637,759,9882,0,0,0,209167,73,313,2731,0,2731,3044,2018,12,0416,04,distributionGO_thanaconsuprocess
Kishoreganj Sadar,3883696,9084,3892780,4495652,279266,168160,10317,279,10596,1405,10731,55,10786,3913,2858,16604,174,0,2,0,100,2628,3894,3437,7325,9953,2018,12,0416,04,distributionGO_thanaconsuprocess
Hossainpur,2552716,5965,2558681,2188856,195771,102617,5798,2,5800,77,5446,0,5446,449,1210,8215,14,398,26,3722,230,459,1505,1496,3001,3460,2018,12,0416,04,distributionGO_thanaconsuprocess
Nikli,1254516,6693,1261209,2086583,134796,59430,5758,28,5786,1821,4198,97,4295,1646,933,9170,0,0,190,69490,0,154,2481,157,2631,2785,2018,12,0416,04,distributionGO_thanaconsuprocess
Bazitpur,2136261,10224,2146485,2432866,142963,79206,5967,13,5980,364,5326,0,5326,1712,1362,9910,6,0,0,133161,41,803,2567,408,2974,3777,2018,12,0416,04,distributionGO_thanaconsuprocess
Pakundia,2994322,8882,3003204,2847926,183575,100314,5239,6,5245,558,5655,0,5655,2180,2120,9761,0,0,0,0,4,1713,1536,407,1942,3655,2018,12,0416,04,distributionGO_thanaconsuprocess
Itna,2127846,4747,2132593,1974953,102871,49264,3976,0,3976,502,3992,7,3999,569,911,6058,0,0,0,258070,50,869,2691,42,2733,3602,2018,12,0416,04,distributionGO_thanaconsuprocess
Kuliarchar,1987370,5191,1992561,2638753,166380,90639,3659,2,3661,385,6255,30,6285,409,1066,13011,0,0,0,29530,75,1303,2402,389,2791,4094,2018,12,0416,04,distributionGO_thanaconsuprocess
Tarail,1923790,6428,1930218,2473029,118217,58804,4675,0,4675,914,5420,51,5471,1462,1392,9090,0,0,0,243956,36,1063,1956,268,2222,3285,2018,12,0416,04,distributionGO_thanaconsuprocess
Karimganj,3592776,8892,3601668,2912522,209597,98627,6601,11,6612,390,10815,281,11096,1287,1778,13737,0,0,0,0,38,1771,4573,336,4903,6674,2018,12,0416,04,distributionGO_thanaconsuprocess
Mithamoin,1216078,5275,1221353,1516032,78773,24663,2604,0,2604,250,1942,0,1942,253,1202,5474,0,0,0,98250,21,910,1627,1,1628,2538,2018,12,0416,04,distributionGO_thanaconsuprocess
Tongibari,1412946,5323,1418269,1522636,84173,41104,4178,0,4178,402,2027,0,2027,819,1496,1513,0,0,0,324,90,371,1392,689,2067,2438,2018,12,0408,04,distributionGO_thanaconsuprocess
Gazaria,1102592,4574,1107166,1064469,88278,48809,3548,16,3564,171,1319,0,1319,298,1515,469,0,0,0,0,10,154,1302,317,1619,1773,2018,12,0408,04,distributionGO_thanaconsuprocess
Serajdikhan,2610314,7403,2617717,2778167,204358,127436,6481,11,6492,237,2663,850,3513,760,2224,3942,0,0,0,0,1,545,2436,710,3145,3690,2018,12,0408,04,distributionGO_thanaconsuprocess
Munshiganj Sadar,3046133,14184,3060317,4223199,260974,146949,4724,324,5048,450,3820,601,4421,1394,2539,5460,103,0,0,0,27,570,2495,1941,4436,5006,2018,12,0408,04,distributionGO_thanaconsuprocess
Srinagar,2641846,35175,2677021,3672412,180379,125076,7938,13,7951,1519,3360,237,3597,857,1323,1832,870,2,84,159923,850,1444,1717,234,1943,3387,2018,12,0408,04,distributionGO_thanaconsuprocess
Lohajong,1582252,5919,1588171,3058405,127182,70207,5639,20,5659,441,3472,8,3480,1392,1338,2688,8,0,0,11630,0,688,1514,0,1513,2201,2018,12,0408,04,distributionGO_thanaconsuprocess
Faridpur Sadar,3140703,19564,3160267,6890360,479163,255937,10286,67,10353,194,10357,128,10485,1009,2462,11543,87,100,0,0,136,3567,5214,2014,7167,10734,2018,12,0404,04,distributionGO_thanaconsuprocess
Boalmari,2366417,11880,2378297,3698173,258037,127728,8022,0,8022,165,3061,0,3061,10,2334,9630,0,0,0,105,61,1052,2825,0,2807,3859,2018,12,0404,04,distributionGO_thanaconsuprocess
Bhanga,2253841,9828,2263669,2525280,102577,63502,7808,73,7881,834,3959,3,3962,746,2143,10192,155,0,0,0,0,804,6059,0,6032,6836,2018,12,0404,04,distributionGO_thanaconsuprocess
Char Bhadrashion,369137,2301,371438,1060120,37161,19651,2341,12,2353,144,1949,10,1959,100,808,3113,0,0,0,0,0,128,892,232,1124,1252,2018,12,0404,04,distributionGO_thanaconsuprocess
Nagarkanda,2727015,8450,2735465,3053557,158882,53355,7960,6,7966,30,3640,0,3640,127,2388,6359,0,18,0,404,92,1533,3716,49,3682,5215,2018,12,0404,04,distributionGO_thanaconsuprocess
Sadarpur,1021093,8826,1029919,1697611,107192,57233,4329,0,4329,265,3067,7,3074,1274,1600,9370,76,0,0,0,6,178,2953,2,2954,3132,2018,12,0404,04,distributionGO_thanaconsuprocess
Alphadanga,1027768,2212,1029980,2638330,121735,63026,2356,29,2385,218,1806,0,1806,390,851,2687,1,0,0,36117,29,526,1576,17,1593,2119,2018,12,0404,04,distributionGO_thanaconsuprocess
Modhukhali,2260624,10845,2271469,1627860,167454,106287,5470,8,5478,402,4414,209,4623,407,1786,8252,0,0,0,0,37,1042,2260,247,2494,3536,2018,12,0404,04,distributionGO_thanaconsuprocess
Saltha,779317,7962,787279,1035848,58436,56849,2569,4,2573,213,1866,0,1866,25,127,7484,0,0,0,0,1,380,788,10,789,1169,2018,12,0404,04,distributionGO_thanaconsuprocess
Boda,2845768,8781,2854549,759011,314969,175133,4489,231,4720,654,14674,247,14921,4070,3059,12835,201,0,21,34548,5550,6173,1492,665,2157,8330,2018,12,0103,07,distributionGO_thanaconsuprocess
Panchgarh Sadar,2600664,8534,2609198,1206825,375961,206133,5060,125,5185,1120,6641,236,6877,2227,3137,13120,23,0,0,0,255,2810,1241,937,2173,4983,2018,12,0103,07,distributionGO_thanaconsuprocess
Tetulia,1339066,5583,1344649,676217,100517,46497,4368,56,4424,475,3939,104,4043,1363,1795,7957,36,0,0,0,68,1520,676,119,791,2311,2018,12,0103,07,distributionGO_thanaconsuprocess
Atowari,1817207,3940,1821147,1009943,143417,80510,2642,85,2727,301,3753,54,3807,1555,3156,5555,0,0,0,0,0,3227,345,399,744,3971,2018,12,0103,07,distributionGO_thanaconsuprocess
Debiganj,3617555,9997,3627552,1626257,419382,251903,6344,134,6478,825,8090,219,8309,2408,3683,14799,0,0,0,0,107,9330,1078,122,1199,10529,2018,12,0103,07,distributionGO_thanaconsuprocess
Jamalpur Sadar,6681808,28489,6710297,6922862,787009,423621,9995,169,10164,586,13744,0,13744,586,4801,31449,54,1330,117802,76154,107,4911,3173,1040,4207,9118,2018,12,0413,08,distributionGO_thanaconsuprocess
Melandaha,3530320,10127,3540447,3742636,432032,234696,8069,0,8069,174,7688,0,7688,2849,2969,11373,0,0,0,0,102,2857,529,585,1112,3969,2018,12,0413,08,distributionGO_thanaconsuprocess
Dewanganj,2359391,7721,2367112,3182158,421293,246808,4881,3,4884,117,6854,0,6854,491,1136,9501,5,1,15,381,79,1133,977,11,989,2122,2018,12,0413,08,distributionGO_thanaconsuprocess
Islampur,3980203,12317,3992520,4511627,378952,193487,6709,4,6713,593,5814,0,5814,1139,2013,14220,128,0,894476,235789,4,1527,1213,392,1591,3118,2018,12,0413,08,distributionGO_thanaconsuprocess
Sharishabari,3849376,5682,3855058,3866345,356764,157351,11234,93,11327,162,8583,11,8594,1229,2040,8249,7051,2610,831424,260049,1,2930,1740,73,1813,4743,2018,12,0413,08,distributionGO_thanaconsuprocess
Madarganj,1986920,8482,1995402,1779858,177696,82497,7237,412,7649,431,8050,168,8218,2557,901,11151,0,6,0,0,0,2076,835,633,1444,3520,2018,12,0413,08,distributionGO_thanaconsuprocess
Bakshiganj,2410937,8795,2419732,2481419,183196,73638,5376,35,5411,285,5275,231,5506,1888,1533,9470,12,0,6602,82311,892,1600,1410,521,1930,3530,2018,12,0413,08,distributionGO_thanaconsuprocess
Parshuram,699390,4050,703440,1342929,116499,63287,2011,1,2012,397,1952,27,1979,269,1980,1519,0,13,0,0,0,154,737,245,981,1135,2018,12,0504,05,distributionGO_thanaconsuprocess
Chhagalnaiya,1102199,6284,1108483,1223112,162983,88144,2852,2,2854,92,2096,110,2206,808,2588,5177,0,0,0,64440,200,94,808,316,1114,1208,2018,12,0504,05,distributionGO_thanaconsuprocess
Feni Sadar,2518013,18761,2536774,6120186,588759,296645,10558,783,11341,1074,6517,431,6948,1318,5419,4264,0,0,0,0,0,732,5974,1897,7840,8572,2018,12,0504,05,distributionGO_thanaconsuprocess
Sonagazi,1299595,9759,1309354,2037711,364334,200665,4181,4,4185,68,3001,175,3176,1127,2169,7696,6,0,0,0,0,453,2166,61,2186,2639,2018,12,0504,05,distributionGO_thanaconsuprocess
Dagonbhuiyan,1225697,8665,1234362,2257330,188938,99100,3805,21,3826,350,2691,130,2821,914,2265,9047,0,0,0,0,53,228,2067,457,2524,2752,2018,12,0504,05,distributionGO_thanaconsuprocess
Fulgazi,643958,5843,649801,1206120,92823,50343,2397,4,2401,238,1389,62,1451,319,1437,5948,0,0,0,0,2,179,815,150,963,1142,2018,12,0504,05,distributionGO_thanaconsuprocess
Kutubdia,843883,3586,847469,818704,263848,113807,1941,2,1943,66,3128,6,3134,101,602,8532,0,0,0,0,34,420,393,4,397,817,2018,12,0508,05,distributionGO_thanaconsuprocess
Moheshkhali,2633971,20032,2654003,862741,347599,193732,5003,259,5262,127,5505,110,5615,352,3566,23039,270,0,926214,396460,83,2722,526,180,702,3424,2018,12,0508,05,distributionGO_thanaconsuprocess
Coxs Bazar Sadar,2344837,19062,2363899,4053450,449009,248560,7249,892,8141,745,8187,223,8410,2210,3621,12735,13216,0,811721,266468,4057,6086,1224,1135,2251,8337,2018,12,0508,05,distributionGO_thanaconsuprocess
Ramu,1714005,13760,1727765,1829546,409553,241403,3245,29,3274,225,4603,129,4732,848,3148,7160,0,0,0,0,554,2374,822,196,1011,3385,2018,12,0508,05,distributionGO_thanaconsuprocess
Chakaria,2965521,16198,2981719,2524330,641409,330241,10148,72,10220,493,8882,197,9079,1677,5945,20324,30,0,0,215,11,1779,1462,424,1876,3655,2018,12,0508,05,distributionGO_thanaconsuprocess
Ukhiya,787617,4856,792473,567494,163243,97667,1354,31,1385,68,3591,52,3643,618,985,5929,0,0,0,0,9,877,326,82,408,1285,2018,12,0508,05,distributionGO_thanaconsuprocess
Teknaf,1908190,6665,1914855,2265481,618053,389606,3969,365,4334,103,3649,29,3678,153,3319,10286,469,8,5,98472,69,1569,655,123,602,2171,2018,12,0508,05,distributionGO_thanaconsuprocess
Pekua,713534,7956,721490,469301,244357,120750,1531,0,1531,232,2844,33,2877,241,1332,13171,29,0,0,0,10,715,521,4,521,1236,2018,12,0508,05,distributionGO_thanaconsuprocess
Bochaganj,1931830,6406,1938236,752567,147868,70044,3930,61,3991,261,5874,175,6049,668,3711,6978,0,0,0,0,69,2015,2436,174,2610,4625,2018,12,0101,07,distributionGO_thanaconsuprocess
Kaharole,1386972,8223,1395195,391074,152319,69234,4215,0,4215,272,5763,127,5890,0,2602,6265,0,0,0,0,0,1683,2942,2,2944,4627,2018,12,0101,07,distributionGO_thanaconsuprocess
Fulbari,1531478,4242,1535720,753057,67717,28027,3722,1,3723,371,6147,109,6256,1908,2535,8076,0,0,0,0,88,2791,1644,533,2177,4968,2018,12,0101,07,distributionGO_thanaconsuprocess
Khanshama,2116404,6791,2123195,712951,210489,100508,2882,79,2961,151,8710,154,8864,1730,2466,6754,0,0,0,0,55,1651,2971,135,3106,4757,2018,12,0101,07,distributionGO_thanaconsuprocess
Dinajpur Sadar,3939231,13654,3952885,3640720,553183,318712,6825,431,7256,736,19658,161,19819,4367,12285,6448,75,0,0,0,16,11205,4126,3647,7773,18978,2018,12,0101,07,distributionGO_thanaconsuprocess
Hakimpur,850226,3660,853886,1051379,73543,42154,2808,1,2809,99,4058,99,4157,784,3202,3824,0,0,0,14450,0,2458,925,3,928,3386,2018,12,0101,07,distributionGO_thanaconsuprocess
Birganj,3346909,9795,3356704,1145270,262633,135668,5217,0,5217,461,17166,135,17301,3596,3725,4850,1,0,0,0,234,2933,5169,583,5752,8685,2018,12,0101,07,distributionGO_thanaconsuprocess
Ghoraghat,1138628,6633,1145261,752042,77001,38568,4674,0,4674,391,4470,28,4498,1455,2138,3111,0,0,0,0,0,1807,1464,0,1464,3271,2018,12,0101,07,distributionGO_thanaconsuprocess
Birol,2544993,9844,2554837,1501502,205045,111492,4761,6,4767,659,7594,62,7656,2149,3435,5153,0,0,0,0,0,1841,3944,22,3966,5807,2018,12,0101,07,distributionGO_thanaconsuprocess
Chirir Bandar,2492540,9713,2502253,841383,213602,105032,3803,31,3834,343,6164,268,6432,1019,3612,9736,0,0,0,0,123,2808,3238,56,3288,6096,2018,12,0101,07,distributionGO_thanaconsuprocess
Parbatipur,3694941,13211,3708152,3802426,455740,242800,11536,14,11550,1503,10976,60,11036,1953,4591,11274,15,0,94,0,72,5669,4966,0,4808,10477,2018,12,0101,07,distributionGO_thanaconsuprocess
Nawabganj,2328492,8988,2337480,1192732,254993,130354,3755,14,3769,207,5741,149,5890,898,3619,7807,0,0,0,0,153,3453,1810,14,1824,5277,2018,12,0101,07,distributionGO_thanaconsuprocess
Birampur,1178659,5323,1183982,798316,76953,36397,5274,5,5279,291,4710,30,4740,1402,2883,4849,0,0,0,0,211,3873,1652,256,1901,5774,2018,12,0101,07,distributionGO_thanaconsuprocess
Dhamrai,3471992,14776,3486768,3152079,308418,152576,18692,2,18694,472,9780,0,9780,430,3148,1080,0,0,0,53,12,1555,1780,1218,2962,4517,2018,12,0406,04,distributionGO_thanaconsuprocess
Mirpur,8391448,27243,8418691,25919097,2153472,1113811,56441,1770,58211,4439,33597,1503,35100,7314,3584,4538,0,194,0,0,46,50346,5984,5675,11646,61992,2018,12,0406,04,distributionGO_thanaconsuprocess
Keraniganj,4195162,20281,4215443,5916059,624934,315959,18125,149,18274,1694,12024,1096,13120,3886,11414,4484,0,0,0,0,0,11827,1810,2105,3915,15742,2018,12,0406,04,distributionGO_thanaconsuprocess
Savar,6186863,11814,6198677,9114069,625729,255247,11816,10,11826,255,9168,745,9913,1251,5751,5574,4,0,0,0,0,10306,1898,1554,3417,13723,2018,12,0406,04,distributionGO_thanaconsuprocess
Nawabganj,1771988,13980,1785968,2152260,145168,68143,4148,23,4171,279,5750,585,6335,3126,2282,2675,4,0,0,0,0,3751,1729,1958,3671,7422,2018,12,0406,04,distributionGO_thanaconsuprocess
Tejgaon,17332466,105794,17438260,36328940,2991438,1584548,63702,1982,65684,3540,36549,468,37017,6225,11092,977,142,516,3,8,88,83240,12819,9443,22055,105295,2018,12,0406,04,distributionGO_thanaconsuprocess
Dohar,1025445,6387,1031832,1709447,83471,45808,2744,4,2748,126,5433,16,5449,1893,322,435,0,0,0,462076,720,2045,930,1527,2455,4500,2018,12,0406,04,distributionGO_thanaconsuprocess
Ramgoti,1599859,4563,1604422,1431164,585716,236579,5531,19,5550,239,4388,74,4462,264,2790,14801,19,8,0,0,51,2636,533,274,807,3443,2018,12,0506,05,distributionGO_thanaconsuprocess
Raipur,1095211,10214,1105425,586445,243424,126447,5937,800,6737,347,5891,189,6080,527,2808,19521,55,244,57,417,180,1103,895,821,1715,2818,2018,12,0506,05,distributionGO_thanaconsuprocess
Lakshmipur Sadar,2814263,19798,2834061,3273161,871069,448025,16381,1515,17896,997,12109,867,12976,2591,8359,21648,226,88,0,0,200,663,4275,2123,6337,7000,2018,12,0506,05,distributionGO_thanaconsuprocess
Ramganj,845241,4875,850116,1029527,278485,137785,8446,52,8498,567,3954,258,4212,1575,3621,9820,0,4,0,0,3,525,1716,1562,3278,3803,2018,12,0506,05,distributionGO_thanaconsuprocess
Kamalnagar,556339,2601,558940,996880,230846,208997,908,279,1187,243,3140,242,3382,828,146,11766,30,38,10,0,121,271,433,216,649,920,2018,12,0506,05,distributionGO_thanaconsuprocess
Naogaon Sadar,3649970,10884,3660854,3708203,296927,148430,4847,472,5319,339,7913,241,8154,635,3676,8569,1,0,0,0,0,584,4665,1727,6382,6966,2018,12,0111,01,distributionGO_thanaconsuprocess
Mohadebpur,3760257,10493,3770750,1709728,180944,86161,4380,5,4385,900,6268,267,6535,1482,2477,5361,0,0,0,13440,34,1553,5455,566,5967,7520,2018,12,0111,01,distributionGO_thanaconsuprocess
Manda,4979947,16039,4995986,1866580,304134,148442,11566,427,11993,1095,6188,14,6202,1670,2675,7431,8,0,15,0,52,1015,3494,110,3600,4615,2018,12,0111,01,distributionGO_thanaconsuprocess
Badalgachhi,2313432,4744,2318176,1758577,296245,148644,2144,1,2145,229,3040,0,3040,728,3329,2068,0,0,0,0,124,1038,2271,25,2269,3307,2018,12,0111,01,distributionGO_thanaconsuprocess
Rani Nagar,2274958,6221,2281179,1882221,91459,50697,1627,0,1627,128,3457,133,3590,408,2519,4524,1,9,0,5248,71,920,945,5,948,1868,2018,12,0111,01,distributionGO_thanaconsuprocess
Patnitola,1560576,9914,1570490,901033,79959,38378,2024,110,2134,103,5309,1,5310,1016,2068,7880,0,0,0,0,2,1793,5183,553,5734,7527,2018,12,0111,01,distributionGO_thanaconsuprocess
Atrai,1934937,6265,1941202,1924501,77780,37697,2459,12,2471,311,2872,139,3011,421,2956,6012,0,0,0,65110,98,840,1693,486,2179,3019,2018,12,0111,01,distributionGO_thanaconsuprocess
Dhamoirhat,1583931,5815,1589746,1384361,160298,90580,1838,0,1838,530,1960,36,1996,550,2979,5359,0,0,0,0,40,2064,1327,0,1327,3391,2018,12,0111,01,distributionGO_thanaconsuprocess
Niamatpur,2089605,9171,2098776,1406147,133684,68305,3541,0,3541,587,5481,7,5488,2176,2132,4567,9,0,6,10375,86,1066,2868,653,3521,4587,2018,12,0111,01,distributionGO_thanaconsuprocess
Porsa,1544959,5144,1550103,1481100,89092,41839,1787,1,1788,98,2151,0,2151,988,1108,5980,0,0,0,0,56,1212,1316,177,1493,2705,2018,12,0111,01,distributionGO_thanaconsuprocess
Sapahar,1621134,6110,1627244,1018072,134248,66056,686,0,686,164,3130,13,3143,1304,2038,5686,1,0,0,0,201,2160,1126,230,1355,3515,2018,12,0111,01,distributionGO_thanaconsuprocess
